match_id,rad_pos1,rad_pos2,rad_pos3,rad_pos4,rad_pos5,rad_pos1_gold,rad_pos2_gold,rad_pos3_gold,rad_pos4_gold,rad_pos5_gold,rad_pos1_last_gold,rad_pos2_last_gold,rad_pos3_last_gold,rad_pos4_last_gold,rad_pos5_last_gold,dire_pos1,dire_pos2,dire_pos3,dire_pos4,dire_pos5,dire_pos1_gold,dire_pos2_gold,dire_pos3_gold,dire_pos4_gold,dire_pos5_gold,dire_pos1_last_gold,dire_pos2_last_gold,dire_pos3_last_gold,dire_pos4_last_gold,dire_pos5_last_gold,pos1_diff,pos2_diff,pos3_diff,pos4_diff,pos5_diff,team_diff,minute,winner
7517420109,80,70,23,63,100,"[0, 245, 482, 901, 1226, 1720, 2196, 2613, 3126, 3656, 4014, 4528, 4977, 5336, 5917, 6395, 6848, 7327, 8373, 9297, 10054, 10486, 11137, 11806, 12258, 13003, 13464, 14271, 14624, 15204]","[0, 243, 397, 859, 1111, 1554, 2117, 2596, 3049, 3540, 4104, 4610, 5209, 5650, 6235, 6793, 7770, 8486, 9295, 10298, 10943, 11802, 12722, 13446, 14602, 15606, 16768, 17948, 18379, 19010]","[0, 244, 633, 916, 1375, 1957, 2416, 2835, 3416, 3789, 4416, 4825, 5508, 6145, 6524, 6690, 7507, 8147, 9165, 9953, 11042, 11517, 12034, 12808, 13348, 13837, 13932, 14948, 15537, 15842]","[0, 216, 331, 513, 649, 779, 914, 1004, 1219, 1309, 1756, 2115, 2559, 2654, 2798, 2893, 3194, 3554, 3854, 4275, 4622, 4716, 5056, 5330, 5425, 5519, 5908, 6349, 6625, 6852]","[0, 170, 331, 421, 511, 885, 1020, 1110, 1408, 1498, 1643, 1842, 2223, 2488, 2628, 2760, 2900, 3449, 3749, 4039, 4386, 4528, 4740, 4873, 5000, 5293, 5426, 6189, 6285, 6428]",15204,19010,15842,6852,6428,2,25,17,45,110,"[0, 209, 581, 1066, 1871, 2316, 3128, 3595, 4274, 4660, 5366, 6146, 6956, 8281, 9055, 10054, 10649, 11486, 12422, 12984, 13647, 14371, 14628, 15214, 16040, 17042, 17702, 17988, 18976, 19709]","[0, 170, 410, 740, 1025, 1332, 1593, 1938, 2183, 2739, 3308, 3845, 4458, 5380, 6276, 6947, 7714, 8515, 9174, 10029, 11021, 11688, 12988, 13825, 14583, 15598, 16771, 18200, 19295, 20270]","[0, 313, 606, 767, 1056, 1285, 1531, 1977, 2372, 2805, 3283, 3798, 4333, 4945, 5429, 5994, 6894, 7373, 8178, 8491, 8979, 9774, 10318, 10974, 11650, 12444, 13442, 14205, 14984, 15431]","[0, 170, 260, 350, 549, 639, 774, 1002, 1223, 1387, 1738, 2038, 2151, 2682, 2866, 3249, 3682, 4207, 4419, 4725, 5357, 5526, 5982, 6224, 6504, 7371, 7757, 8423, 9014, 9569]","[0, 270, 411, 501, 591, 681, 816, 996, 1086, 1424, 1728, 2084, 2222, 2614, 2798, 3738, 3975, 4389, 4758, 5093, 5492, 5769, 6060, 6227, 6634, 7233, 7544, 7974, 8427, 8651]",19709,20270,15431,9569,8651,-4505,-1260,411,-2717,-2223,-10294,30,radiant
7517437309,10,104,19,45,64,"[0, 197, 439, 738, 1066, 1445, 2121, 2750, 3379, 3855, 4435, 4961, 5608, 6047, 6944, 7509, 8094, 8821, 9614, 10307, 11283, 12202, 12790, 14081, 14901, 15597, 16710, 17398, 17568, 18107]","[0, 290, 549, 944, 1402, 1785, 2309, 2676, 3152, 3554, 4027, 4319, 4878, 5442, 5849, 6219, 6536, 7560, 8085, 8727, 9323, 9891, 10151, 11688, 12305, 13009, 13607, 14232, 14328, 14644]","[0, 256, 589, 718, 1033, 1536, 1798, 2094, 2630, 2720, 3508, 4073, 4657, 5176, 5584, 5679, 6703, 7381, 8259, 8667, 9032, 9127, 9489, 10864, 11248, 11522, 11953, 12406, 12941, 13464]","[0, 173, 263, 742, 832, 969, 1207, 1400, 1688, 1830, 2022, 2345, 2698, 2984, 3521, 3616, 4229, 4697, 5113, 5504, 5891, 6219, 6575, 6912, 7304, 7703, 8320, 8641, 8829, 9291]","[0, 129, 219, 357, 496, 631, 721, 855, 990, 1080, 1358, 1448, 1701, 1962, 2260, 2355, 2719, 2814, 3679, 3836, 4425, 4720, 5130, 5224, 5454, 5549, 6474, 7003, 7229, 7567]",18107,14644,13464,9291,7567,7,67,53,71,102,"[0, 356, 826, 1268, 1545, 2033, 2482, 2857, 3265, 3841, 4145, 4632, 5162, 6245, 6690, 7219, 7897, 8298, 9388, 10404, 11069, 11978, 12681, 13426, 14465, 15669, 16516, 18273, 18986, 20010]","[0, 282, 483, 803, 1085, 1413, 1801, 2196, 2865, 3306, 4158, 4378, 4743, 5136, 5570, 6396, 7057, 7487, 8449, 9117, 9555, 9946, 10896, 11262, 11740, 13195, 14063, 15356, 15840, 17717]","[0, 246, 523, 1224, 1556, 1724, 1853, 2033, 2369, 2722, 3084, 3298, 3470, 4161, 4643, 5202, 5632, 5819, 6326, 6585, 7500, 8177, 8881, 9383, 9810, 10706, 11229, 11956, 12371, 13749]","[0, 209, 299, 684, 818, 948, 1038, 1218, 1353, 1543, 1925, 2015, 2226, 2457, 2700, 2878, 3362, 3866, 4472, 5088, 5540, 6034, 6712, 6879, 7938, 8714, 9139, 9651, 10041, 10728]","[0, 209, 299, 435, 606, 815, 1015, 1243, 1458, 1606, 1943, 2033, 2413, 2803, 3026, 3504, 4109, 4204, 4490, 4953, 5712, 6121, 6631, 6725, 6820, 7388, 7593, 8438, 8690, 9513]",20010,17717,13749,10728,9513,-1903,-3073,-285,-1437,-1946,-8644,30,dire
7517480603,1,33,11,100,30,"[0, 242, 587, 827, 1334, 1784, 2217, 3051, 3456, 3867, 4618, 5183, 5810, 6431, 7209, 7788, 8620, 8968, 9737, 10920, 12297, 12981, 13531, 14827, 15643, 16167, 16920, 18399, 20572, 21251]","[0, 244, 898, 1268, 1718, 2173, 2632, 3024, 3418, 4234, 4879, 5331, 5828, 6160, 6843, 7419, 7960, 8999, 9427, 10380, 10677, 11496, 11630, 12029, 12443, 12647, 12955, 13696, 14972, 15468]","[0, 289, 454, 837, 1306, 1601, 1904, 2157, 2694, 3889, 4419, 4813, 5453, 5963, 6734, 7084, 7453, 7891, 8342, 8728, 9100, 9660, 10544, 10991, 11205, 11405, 11690, 12105, 13097, 13644]","[0, 169, 325, 415, 535, 670, 805, 895, 985, 1325, 1588, 1754, 1998, 2093, 2371, 2676, 3150, 3630, 3850, 4523, 5313, 5761, 6177, 6536, 6881, 6976, 7166, 7306, 7994, 8225]","[0, 169, 259, 349, 518, 652, 834, 1089, 1179, 1314, 1854, 2238, 2433, 2566, 2771, 3040, 3553, 3648, 3792, 4131, 4673, 5087, 5182, 5612, 6157, 6439, 6609, 6837, 7199, 7639]",21251,15468,13644,8225,7639,44,19,57,21,5,"[0, 242, 515, 1000, 1337, 1662, 2086, 2452, 2711, 3036, 3574, 4068, 4617, 5042, 5637, 6121, 6842, 7882, 8718, 9586, 10694, 11102, 12188, 12963, 14956, 15816, 16879, 18687, 18783, 19405]","[0, 278, 550, 1004, 1410, 1826, 2182, 2642, 2732, 2945, 3557, 3979, 4783, 5253, 5659, 7164, 8498, 8941, 9198, 9738, 10283, 11605, 12211, 12305, 13340, 13883, 14997, 16133, 16351, 16447]","[0, 204, 490, 765, 1059, 1351, 1713, 1803, 2490, 2866, 3172, 3426, 3859, 4598, 5180, 6259, 6417, 7581, 8030, 8326, 8645, 9519, 10034, 10968, 11270, 11698, 12162, 13035, 13131, 13682]","[0, 169, 398, 488, 625, 759, 945, 1035, 1125, 1476, 1746, 1836, 2072, 2644, 3095, 3335, 4037, 4686, 4866, 5023, 5911, 6632, 7078, 7621, 8060, 8920, 9728, 10183, 10834, 11575]","[0, 169, 259, 395, 533, 623, 773, 923, 1049, 1139, 1409, 1499, 1700, 2073, 2296, 2444, 2602, 2945, 3084, 3241, 3883, 4092, 4259, 4504, 4659, 4826, 5187, 5566, 5678, 5774]",19405,16447,13682,11575,5774,1846,-979,-38,-3350,1865,-656,30,radiant
7517586007,46,42,97,50,86,"[0, 205, 463, 746, 1132, 1436, 2130, 2573, 2948, 3718, 4211, 4888, 5658, 5752, 6468, 7653, 7962, 8641, 9989, 10785, 11520, 12630, 13511, 14759, 16136, 16632, 16727, 17468, 18039, 20325]","[0, 223, 526, 1060, 1398, 1820, 2422, 2597, 2906, 3324, 4037, 4355, 4829, 5488, 5912, 6451, 6889, 7340, 7845, 8196, 8663, 9504, 10346, 11098, 11884, 12808, 14042, 14511, 14742, 15813]","[0, 173, 500, 818, 981, 1405, 2047, 2400, 3229, 3728, 4450, 5242, 5604, 6033, 6536, 6949, 7519, 7787, 8474, 8632, 8857, 9215, 9420, 9830, 10160, 10595, 11193, 11803, 12175, 12849]","[0, 356, 689, 992, 1130, 1548, 2128, 2339, 2584, 2825, 3064, 3265, 3628, 3722, 3871, 4317, 4574, 4977, 5189, 5554, 5648, 5851, 6684, 7020, 7353, 7590, 7685, 7908, 8139, 9130]","[0, 169, 259, 395, 564, 762, 947, 1134, 1378, 1859, 2279, 2417, 2653, 2803, 3133, 3612, 3933, 4247, 5069, 5461, 5590, 5948, 6392, 6559, 6729, 6997, 7092, 7315, 7613, 7828]",20325,15813,12849,9130,7828,22,29,71,14,26,"[0, 405, 687, 1095, 1538, 1792, 2021, 2651, 3174, 3539, 4088, 4354, 4744, 5525, 5875, 6498, 7168, 7451, 8231, 9421, 10273, 11154, 11705, 11890, 13081, 14731, 15465, 16647, 17217, 18901]","[0, 616, 865, 1199, 1661, 1957, 2278, 3006, 3441, 3621, 4143, 4233, 5369, 6024, 6695, 7327, 7713, 8214, 8568, 9047, 9958, 10423, 11081, 11266, 11864, 12787, 13927, 14103, 14620, 15242]","[0, 210, 348, 487, 912, 1193, 1328, 1756, 2342, 2564, 3228, 3370, 4225, 5159, 5732, 5917, 6359, 7046, 7750, 8069, 8949, 9666, 10105, 10542, 10836, 11865, 12137, 13036, 13527, 13762]","[0, 328, 526, 798, 1306, 1670, 1985, 2415, 2915, 3466, 3978, 4317, 5107, 6027, 6306, 6600, 7171, 7393, 7739, 8646, 8842, 9686, 9893, 10254, 10790, 11585, 11862, 12262, 13044, 13461]","[0, 268, 358, 587, 762, 852, 1072, 1388, 1478, 1568, 1703, 1793, 2059, 2606, 2701, 3094, 3298, 3393, 3955, 4607, 4800, 5283, 5520, 6003, 6245, 6743, 7093, 7282, 7734, 8151]",18901,15242,13762,13461,8151,1424,571,-913,-4331,-323,-3572,30,radiant
7519064617,6,25,129,7,84,"[0, 216, 378, 775, 1220, 1590, 2038, 2676, 3186, 3650, 4107, 4562, 5056, 5555, 6296, 6892, 7494, 8173, 8859, 10370, 11927, 12447, 13574, 14875, 16597, 17558, 18757, 19751, 20457, 22256]","[0, 367, 644, 1020, 1309, 1627, 2120, 2645, 3162, 3532, 3777, 4143, 4698, 5175, 5892, 6387, 7198, 7743, 8580, 8912, 10247, 11394, 12145, 13035, 15377, 16223, 16517, 17586, 19738, 21293]","[0, 251, 503, 790, 1040, 1377, 1818, 2468, 2914, 3751, 4216, 4592, 5160, 5370, 5750, 6118, 6592, 6752, 7548, 7867, 8724, 9180, 9540, 9770, 10250, 10556, 10898, 11146, 12126, 13053]","[0, 169, 259, 349, 439, 529, 663, 978, 1117, 1289, 1574, 1709, 2241, 2584, 2787, 3096, 3383, 3807, 4193, 4350, 5230, 5429, 5614, 6053, 6474, 6833, 7127, 7375, 7869, 8909]","[0, 169, 259, 446, 536, 672, 811, 1125, 1215, 1305, 1444, 1583, 1673, 1768, 1971, 2065, 2513, 2673, 2768, 2925, 3356, 3772, 4188, 4418, 4695, 4925, 5266, 5361, 5855, 6386]",22256,21293,13053,8909,6386,104,101,44,53,85,"[0, 368, 728, 1261, 1672, 2021, 2465, 2816, 3352, 3908, 4347, 4904, 5479, 6088, 6571, 7464, 8127, 8424, 9426, 10490, 10585, 11610, 11988, 12587, 12682, 13767, 14429, 15990, 16815, 16911]","[0, 316, 708, 1074, 1488, 1926, 2416, 2794, 3213, 3716, 4510, 5001, 5469, 5879, 6419, 7057, 7575, 8707, 9098, 9463, 10176, 10500, 11211, 12409, 12687, 13813, 14324, 15338, 16015, 16111]","[0, 354, 679, 1008, 1347, 1694, 1858, 2105, 2485, 3055, 3397, 3890, 4364, 4890, 5272, 5656, 6337, 6895, 7719, 7876, 8710, 9100, 9765, 10606, 10812, 11527, 11750, 13480, 14479, 14575]","[0, 244, 334, 424, 560, 650, 740, 902, 1090, 1364, 1630, 1950, 2429, 2759, 3085, 3658, 4102, 4421, 4858, 5413, 6222, 6317, 7039, 7671, 8066, 8667, 9321, 9650, 10123, 10410]","[0, 244, 334, 471, 599, 689, 826, 983, 1084, 1196, 1296, 1697, 1787, 1996, 2091, 2318, 2594, 3011, 3155, 3516, 3686, 4244, 4646, 5106, 5276, 5716, 5885, 6583, 7226, 7397]",16911,16111,14575,10410,7397,5345,5182,-1522,-1501,-1011,6493,30,radiant
7519118314,53,10,20,136,51,"[0, 250, 378, 653, 1061, 1371, 1809, 2009, 2504, 2909, 3633, 4609, 4871, 5506, 5910, 6332, 7103, 7803, 8659, 9407, 9838, 11044, 11523, 11715, 12567, 13391, 14057, 15242, 16241, 16513]","[0, 291, 568, 865, 1278, 1721, 2135, 2419, 3015, 3438, 4120, 4761, 5247, 5897, 6445, 6612, 7935, 8931, 9392, 9549, 10334, 11280, 11561, 11731, 12167, 12576, 12973, 13642, 13879, 13975]","[0, 239, 368, 723, 1136, 1958, 2287, 2538, 3248, 3515, 3823, 4397, 4870, 5478, 5961, 6191, 6754, 7282, 7930, 8087, 8638, 8993, 9271, 9365, 9795, 10082, 10339, 10532, 11089, 12082]","[0, 230, 320, 410, 592, 859, 1012, 1102, 1603, 1783, 2109, 2537, 2786, 3051, 3146, 3240, 3791, 4138, 4634, 4791, 5175, 5531, 5698, 5792, 6069, 6436, 6603, 6845, 7223, 7992]","[0, 429, 519, 624, 762, 892, 982, 1072, 1236, 1656, 1881, 2214, 2304, 2681, 2776, 2870, 3208, 3616, 4115, 4272, 4455, 4846, 5160, 5329, 5499, 5836, 6078, 6398, 6840, 7221]",16513,13975,12082,7992,7221,48,80,23,112,83,"[0, 209, 450, 657, 851, 1013, 1223, 1708, 1934, 2239, 2655, 2993, 3380, 3974, 4735, 5564, 6105, 6408, 7106, 7887, 8457, 8990, 9649, 10800, 11510, 12298, 13270, 14103, 14996, 15425]","[0, 283, 519, 754, 1151, 1543, 1895, 2243, 2471, 2818, 3231, 3726, 4054, 4594, 5065, 5638, 6187, 6778, 7387, 8250, 8376, 8549, 9108, 10143, 10589, 11168, 11726, 12299, 13283, 15128]","[0, 243, 515, 768, 1050, 1339, 1854, 2438, 2895, 3453, 4263, 4923, 5538, 6159, 6548, 7133, 7828, 8157, 8839, 9794, 10298, 10774, 11284, 12328, 12771, 13037, 13311, 13792, 14613, 16071]","[0, 209, 299, 471, 611, 763, 932, 1022, 1418, 1508, 1839, 2087, 2177, 2794, 2969, 3316, 3411, 3601, 3913, 4647, 5162, 5438, 5706, 6496, 7122, 7716, 8266, 8871, 9312, 9408]","[0, 209, 299, 441, 561, 688, 813, 1142, 1232, 1358, 1794, 2004, 2094, 2382, 2571, 2869, 2964, 3225, 3949, 4357, 4482, 4829, 5377, 6060, 6276, 6654, 6977, 7283, 7735, 8399]",15425,15128,16071,9408,8399,1088,-1153,-3989,-1416,-1178,-6648,30,dire
7519175015,54,14,96,5,79,"[0, 217, 612, 1047, 1568, 2083, 2758, 3014, 3646, 4211, 4809, 5524, 6269, 7004, 7759, 8602, 9356, 10011, 10590, 11638, 12640, 12734, 13527, 14902, 16618, 17497, 18554, 20361, 20960, 22012]","[0, 250, 871, 1656, 2116, 2874, 3311, 3943, 4470, 5191, 5690, 6320, 7167, 7826, 8472, 9109, 10023, 11333, 11780, 12845, 13705, 14845, 15012, 15789, 15884, 16516, 17247, 18147, 18658, 19140]","[0, 243, 543, 985, 1347, 1747, 2148, 2559, 3069, 3460, 4198, 4764, 5069, 5256, 5771, 6323, 7066, 7832, 8414, 9017, 9353, 9633, 10537, 10832, 11250, 11895, 12543, 13297, 13636, 14079]","[0, 130, 316, 454, 897, 1087, 1328, 1621, 1813, 2139, 2394, 2720, 2989, 3250, 3536, 3811, 4491, 4903, 5023, 5355, 5616, 5943, 6334, 6502, 6832, 7345, 7774, 8457, 8678, 8819]","[0, 130, 220, 358, 544, 682, 772, 907, 1086, 1220, 1310, 1503, 2006, 2318, 2413, 2762, 3010, 3456, 3752, 4003, 4365, 4588, 5137, 5489, 5584, 5966, 6363, 6981, 7202, 7298]",22012,19140,14079,8819,7298,10,17,2,88,20,"[0, 326, 618, 962, 1215, 1725, 2141, 2648, 3175, 3749, 4481, 4873, 5498, 6434, 7018, 7778, 8238, 8456, 9097, 9748, 9963, 11203, 12074, 12944, 13715, 14700, 15407, 16386, 18085, 18834]","[0, 327, 600, 690, 1110, 1485, 1956, 2820, 3368, 3885, 4277, 4704, 5253, 5818, 6349, 6943, 7327, 8370, 8774, 9586, 10678, 10883, 11835, 12926, 13728, 14753, 15541, 15823, 16929, 17628]","[0, 249, 423, 751, 1074, 1330, 1637, 1823, 2323, 2720, 3315, 3885, 4529, 5146, 5834, 6357, 7152, 7829, 8576, 8927, 9022, 10768, 11417, 12210, 12451, 12804, 13356, 13451, 14464, 15092]","[0, 259, 349, 473, 645, 735, 954, 1411, 1699, 2042, 2271, 2653, 3048, 3427, 3607, 3702, 4571, 5300, 5999, 6157, 6488, 7106, 7486, 8151, 8637, 8803, 8988, 9499, 10808, 11111]","[0, 210, 300, 390, 480, 713, 848, 938, 1104, 1259, 1597, 1687, 1982, 2280, 2375, 2470, 2653, 3016, 3211, 3369, 3547, 3767, 4092, 4547, 4788, 4954, 5139, 5234, 5997, 6308]",18834,17628,15092,11111,6308,3178,1512,-1013,-2292,990,2375,30,radiant
7519190619,65,113,47,136,66,"[0, 367, 695, 1355, 1741, 2154, 3095, 3759, 4336, 4917, 5553, 5973, 7249, 7556, 7968, 8907, 9894, 11184, 11892, 12930, 13503, 14853, 16146, 16958, 17945, 18644, 19619, 20767, 21373, 23177]","[0, 257, 541, 791, 1054, 1182, 1545, 2124, 2725, 2992, 3558, 3796, 4198, 4834, 5496, 6057, 7042, 7513, 8285, 8630, 9420, 10255, 11054, 11956, 12819, 13227, 14128, 14678, 14994, 15455]","[0, 205, 366, 647, 948, 1287, 1615, 2027, 2209, 2570, 3050, 3459, 3929, 4644, 5062, 5532, 5924, 6435, 6615, 7178, 7454, 7849, 8160, 8422, 9466, 9633, 10055, 10721, 11143, 12063]","[0, 170, 260, 578, 668, 805, 940, 1286, 1527, 1769, 1938, 2112, 2413, 2810, 3396, 3887, 4595, 4780, 5350, 5828, 6005, 6494, 6724, 7094, 7330, 7497, 9119, 9568, 9800, 11286]","[0, 170, 260, 370, 512, 693, 1174, 1497, 1682, 1968, 2240, 2458, 2724, 3386, 3834, 4240, 4776, 5537, 5667, 6189, 6340, 6925, 7314, 7556, 8024, 8324, 9067, 9435, 9763, 10455]",23177,15455,12063,11286,10455,109,93,96,5,85,"[0, 469, 711, 1275, 1481, 1923, 2123, 2462, 2891, 3159, 3483, 4039, 4646, 5022, 5497, 6006, 7084, 7564, 8026, 8592, 9548, 10315, 11388, 12268, 12872, 13744, 13839, 14595, 15820, 17238]","[0, 609, 1014, 1215, 1632, 1990, 2300, 2845, 3345, 3861, 4237, 4810, 5302, 6828, 7575, 7983, 8611, 9302, 10115, 10914, 11501, 12022, 12622, 13082, 13487, 14403, 14898, 15642, 16025, 16776]","[0, 307, 468, 876, 1052, 1582, 1792, 2065, 2529, 2917, 3119, 3439, 4085, 4584, 5104, 5684, 6009, 6813, 7103, 7756, 8610, 8999, 9369, 9551, 9717, 10069, 10475, 11326, 11502, 11691]","[0, 299, 435, 634, 724, 921, 1100, 1253, 1588, 1678, 1860, 2003, 2349, 2978, 3127, 3779, 4083, 4571, 4856, 5076, 5667, 5810, 6499, 6776, 7102, 7658, 7753, 8159, 8537, 8707]","[0, 299, 389, 885, 1011, 1187, 1326, 1507, 1695, 1913, 2003, 2201, 2474, 2900, 3135, 3320, 3748, 4068, 4494, 4905, 5152, 5471, 6081, 6381, 6560, 6979, 7132, 7545, 7721, 8230]",17238,16776,11691,8707,8230,5939,-1321,372,2579,2225,9794,30,radiant
7519467519,21,25,14,121,51,"[0, 301, 705, 916, 1252, 1578, 2003, 2335, 2977, 3493, 3838, 4013, 4879, 5524, 6118, 6590, 7846, 8222, 9055, 10383, 10778, 11174, 11875, 12959, 13735, 14622, 15414, 16428, 18382, 19368]","[0, 298, 493, 827, 1281, 1661, 2384, 2567, 3026, 3377, 4206, 4296, 5116, 5564, 6051, 6615, 7976, 8691, 9148, 9805, 11217, 11365, 11756, 12613, 13513, 14310, 15169, 15373, 16221, 16522]","[0, 337, 780, 952, 1288, 1680, 2225, 2803, 3279, 3575, 4197, 4301, 4769, 5223, 5575, 6335, 6917, 7584, 8081, 8593, 9050, 9506, 9601, 10193, 10726, 11170, 11712, 12273, 13056, 13152]","[0, 210, 578, 929, 1063, 1318, 1474, 1732, 1867, 2146, 2715, 2805, 3130, 3403, 3634, 3729, 4540, 4770, 5357, 5863, 6321, 6671, 7092, 8328, 8989, 9544, 9907, 10552, 12006, 12177]","[0, 210, 300, 390, 480, 570, 705, 840, 982, 1072, 1481, 1692, 1920, 2205, 2390, 2720, 3373, 3603, 3887, 4156, 4842, 4937, 5032, 5752, 6029, 6306, 6638, 7067, 7619, 7715]",19368,16522,13152,12177,7715,94,69,80,66,5,"[0, 285, 605, 1052, 1246, 1693, 2027, 2352, 2780, 3079, 3369, 3959, 4339, 5244, 5777, 6410, 6623, 7243, 7802, 8198, 8676, 9279, 9796, 10671, 11195, 11675, 12941, 14021, 14502, 15257]","[0, 239, 453, 1023, 1553, 2039, 2275, 2597, 3300, 3805, 4350, 5233, 6016, 6578, 7138, 8108, 8362, 8520, 8816, 9678, 10360, 10455, 10982, 11236, 11460, 12064, 13012, 13715, 13821, 15282]","[0, 234, 488, 690, 900, 1274, 1664, 2319, 2692, 3074, 3164, 3891, 4179, 4739, 5496, 5777, 5916, 6193, 6804, 7706, 8063, 8158, 8876, 9450, 10377, 11045, 12015, 12499, 13219, 13617]","[0, 199, 289, 443, 552, 751, 958, 1143, 1381, 1624, 1844, 2163, 2481, 2913, 3478, 3857, 4019, 4655, 5235, 5935, 6395, 6784, 7373, 7874, 8119, 8479, 9052, 9146, 9627, 10090]","[0, 467, 601, 850, 1076, 1335, 1480, 1697, 2107, 2234, 2756, 3376, 3476, 4103, 4450, 4791, 4885, 5043, 5249, 5700, 6060, 6155, 7049, 7143, 7238, 7567, 7792, 8009, 8928, 9024]",15257,15282,13617,10090,9024,4111,1240,-465,2087,-1309,5664,30,radiant
7519553415,59,76,23,112,20,"[0, 290, 470, 689, 1074, 1586, 2107, 2402, 2791, 3365, 3926, 4456, 4991, 6026, 6844, 7553, 8575, 9614, 10156, 10763, 11306, 11821, 12908, 13444, 13656, 14735, 15221, 16414, 17315, 18626]","[0, 209, 467, 841, 1322, 1611, 1967, 2348, 2607, 3097, 3600, 4240, 4749, 5115, 5882, 6443, 7427, 8508, 9242, 9878, 10201, 10831, 11575, 11892, 12711, 12932, 13767, 14780, 15590, 16410]","[0, 335, 534, 926, 1211, 1374, 2168, 2378, 3006, 3281, 3605, 4027, 4369, 4865, 5374, 6366, 6895, 7623, 7963, 8057, 8718, 9587, 10338, 11015, 11110, 11742, 12017, 12186, 12883, 13729]","[0, 170, 260, 398, 488, 773, 1001, 1164, 1374, 1630, 1950, 2511, 2713, 2979, 3130, 3346, 3922, 4424, 4575, 5085, 5233, 5645, 6093, 6291, 6490, 6920, 7074, 7586, 8035, 8705]","[0, 170, 260, 350, 456, 634, 797, 920, 1169, 1779, 1914, 2182, 2272, 2598, 2891, 3082, 3343, 3878, 4057, 4241, 4337, 4664, 5320, 5574, 5958, 6495, 6673, 7221, 8092, 8419]",18626,16410,13729,8705,8419,53,106,96,51,5,"[0, 219, 500, 1047, 1425, 1829, 2159, 2350, 2630, 3380, 3821, 4146, 5262, 6071, 6729, 7132, 8120, 8215, 9429, 11706, 12541, 13699, 14251, 15915, 16832, 18140, 18788, 19540, 19741, 21327]","[0, 204, 567, 812, 1022, 1301, 1609, 1750, 2673, 2975, 3194, 3581, 3773, 4259, 4649, 4832, 5214, 5309, 6327, 6944, 7240, 8038, 8774, 10096, 10812, 11335, 12023, 12720, 12921, 13614]","[0, 206, 529, 978, 1299, 1874, 2217, 2354, 2813, 3155, 3596, 4300, 4970, 5332, 5579, 5927, 6302, 6397, 7289, 8035, 9123, 9572, 10137, 10775, 11300, 11605, 11910, 12491, 12797, 13686]","[0, 270, 360, 461, 708, 798, 933, 1200, 1416, 1701, 1879, 2075, 2317, 2504, 2835, 3177, 3763, 3858, 4239, 5045, 5449, 5944, 6329, 7210, 7472, 8289, 8656, 9139, 9826, 10665]","[0, 170, 260, 423, 559, 1015, 1443, 1533, 1917, 2142, 2277, 2453, 2543, 2692, 2822, 3170, 3662, 3860, 4540, 4992, 5369, 5773, 6188, 6716, 7047, 7498, 7857, 8137, 8769, 9785]",21327,13614,13686,10665,9785,-2701,2796,43,-1960,-1366,-3188,30,dire
7519735705,10,39,129,79,83,"[0, 288, 573, 892, 1347, 1620, 2031, 2445, 2706, 3241, 3697, 4533, 4659, 5096, 5433, 5985, 6846, 7696, 8434, 8910, 9488, 9887, 11118, 12156, 12772, 13410, 14358, 14617, 15520, 15661]","[0, 290, 543, 797, 1243, 1586, 1919, 2595, 3248, 3692, 4439, 5001, 5091, 5615, 5823, 6149, 6946, 7339, 7905, 8241, 8954, 9458, 9909, 10189, 10639, 11095, 11706, 12226, 12643, 13167]","[0, 258, 642, 923, 1335, 1683, 1975, 2391, 2791, 3201, 3558, 4108, 4375, 4739, 4884, 5257, 5763, 5969, 6316, 6603, 6968, 7726, 8094, 8224, 8647, 9080, 10018, 10453, 11034, 11202]","[0, 170, 260, 398, 534, 624, 714, 976, 1131, 1269, 1775, 1952, 2277, 2846, 3740, 3935, 4084, 4259, 4811, 4906, 5271, 5544, 5851, 6021, 6422, 6889, 7184, 7425, 7727, 7959]","[0, 272, 362, 452, 542, 749, 927, 1151, 1275, 1365, 1455, 1678, 1768, 1907, 2084, 2179, 2488, 2740, 3076, 3171, 3411, 3987, 4154, 4249, 4482, 4625, 4810, 4904, 5382, 5478]",15661,13167,11202,7959,5478,113,22,104,86,102,"[0, 260, 505, 883, 1292, 1416, 1883, 2294, 2674, 3092, 3345, 3806, 4842, 5510, 6546, 7155, 7801, 8798, 9474, 10467, 10984, 11770, 12381, 12850, 13911, 14321, 15228, 15791, 16619, 17676]","[0, 295, 700, 1023, 1324, 1707, 2149, 2413, 2753, 3045, 3620, 4325, 5623, 6062, 7154, 7558, 8240, 8754, 9144, 9912, 10162, 10737, 11451, 12141, 12835, 13402, 14366, 14872, 15504, 15710]","[0, 208, 455, 703, 1033, 1370, 1747, 2063, 2476, 2669, 3145, 3421, 3980, 4798, 5356, 5741, 6112, 6938, 7388, 8117, 8356, 8887, 9170, 9487, 9825, 10313, 10574, 11012, 11576, 12003]","[0, 170, 309, 399, 600, 739, 913, 1094, 1231, 1391, 1481, 1822, 2174, 2485, 3002, 3258, 3550, 3834, 4122, 4614, 5099, 5413, 5795, 6242, 6560, 7114, 7483, 7932, 8893, 9257]","[0, 170, 262, 398, 576, 701, 1149, 1239, 1329, 1453, 1543, 1633, 2142, 2465, 3137, 3322, 3655, 3956, 4085, 4561, 4789, 4956, 5263, 5430, 5812, 6085, 6289, 6599, 7078, 7404]",17676,15710,12003,9257,7404,-2015,-2543,-801,-1298,-1926,-8583,30,radiant
7520266915,109,114,84,123,30,"[0, 323, 521, 965, 1379, 1828, 2299, 2808, 3491, 3871, 4538, 5258, 6098, 6623, 7254, 7930, 8543, 8797, 9409, 10123, 10941, 11924, 12693, 13446, 14436, 15371, 16548, 17309, 18863, 20104]","[0, 358, 717, 1151, 1589, 2056, 2604, 3142, 3796, 4402, 4896, 5588, 6235, 6676, 7160, 7601, 8379, 8765, 9346, 10686, 11425, 12281, 13196, 13783, 14280, 15238, 16305, 17109, 18124, 19278]","[0, 291, 571, 926, 1346, 1753, 2115, 2601, 3285, 3772, 4615, 5249, 5888, 6227, 6677, 6871, 7295, 7544, 8280, 8756, 9325, 10386, 11049, 11539, 12094, 12971, 13140, 13846, 14989, 16005]","[0, 169, 275, 395, 531, 1106, 1245, 1555, 1720, 2017, 2387, 2793, 3296, 3987, 4235, 4701, 5166, 5791, 6151, 6621, 6761, 7327, 7765, 8138, 8341, 8799, 9190, 9540, 10816, 11387]","[0, 169, 259, 534, 690, 827, 966, 1056, 1404, 1683, 1865, 2099, 2356, 2638, 2871, 3189, 3436, 3644, 3848, 4062, 4746, 5122, 5485, 5580, 5698, 6158, 7055, 7285, 8835, 9348]",20104,19278,16005,11387,9348,17,10,21,97,5,"[0, 331, 701, 1240, 1687, 2194, 2744, 3255, 3771, 3861, 4425, 4893, 5594, 6307, 7032, 7693, 9275, 10129, 11380, 12008, 13069, 13953, 15533, 17060, 17697, 19079, 19800, 20242, 20945, 21708]","[0, 205, 444, 819, 1029, 1325, 1814, 2084, 2386, 2704, 3040, 3480, 3919, 4439, 5281, 5957, 6824, 7503, 8181, 8855, 9761, 10405, 11336, 11937, 12897, 13925, 14572, 14746, 15040, 15246]","[0, 206, 419, 662, 1003, 1170, 1390, 1738, 2133, 2395, 2753, 2843, 3056, 3522, 4276, 4943, 5506, 6182, 6835, 7485, 7625, 8019, 9061, 9530, 10121, 11097, 11191, 11866, 12446, 13060]","[0, 205, 344, 482, 612, 778, 955, 1294, 1478, 1744, 2166, 2315, 2787, 3040, 3502, 3651, 4589, 4916, 5369, 5579, 5919, 6421, 6822, 6917, 7012, 7612, 8048, 8830, 9186, 9840]","[0, 169, 300, 416, 546, 692, 868, 1092, 1285, 1544, 1679, 1807, 2033, 2128, 2590, 2739, 3253, 3766, 3968, 4176, 4316, 4508, 4800, 5487, 5582, 5821, 6053, 6315, 6609, 6886]",21708,15246,13060,9840,6886,-1604,4032,2945,1547,2462,9382,30,radiant
7520505806,10,120,78,51,26,"[0, 248, 375, 738, 942, 1352, 1647, 2032, 2227, 2944, 3458, 3985, 4924, 5332, 5806, 6261, 6906, 7917, 8646, 9381, 9813, 10610, 11576, 12424, 13149, 13910, 14907, 15569, 16845, 17601]","[0, 282, 677, 999, 1374, 2096, 2344, 2577, 3225, 3747, 4608, 4942, 5860, 5991, 6784, 7426, 7760, 8718, 9297, 9966, 11323, 11669, 12244, 12786, 13521, 13998, 14724, 15156, 15871, 16322]","[0, 318, 593, 910, 1221, 1555, 1933, 2435, 2952, 3398, 4018, 4519, 4910, 5213, 5990, 6331, 7060, 7700, 8170, 8785, 9044, 9139, 9485, 9725, 10132, 10608, 10933, 11463, 11799, 12081]","[0, 210, 348, 484, 574, 774, 864, 1099, 1334, 1606, 2163, 2541, 2922, 3017, 3522, 3662, 4229, 4773, 5040, 5744, 6186, 6356, 6634, 6961, 7445, 7687, 7857, 8333, 8741, 9127]","[0, 210, 350, 488, 651, 839, 1022, 1451, 1671, 1943, 2078, 2172, 2424, 2721, 3103, 3333, 3880, 4392, 4831, 5340, 5565, 5660, 5872, 6076, 6470, 6728, 6872, 7150, 7481, 7577]",17601,16322,12081,9127,7577,13,41,71,20,68,"[0, 239, 558, 932, 1354, 1630, 2079, 2930, 3395, 3706, 4048, 4497, 5023, 6242, 6408, 7112, 7877, 8133, 8828, 9406, 10055, 10754, 11328, 12218, 12913, 13433, 14111, 14918, 15512, 16148]","[0, 164, 444, 684, 853, 1213, 1444, 1900, 2189, 2608, 3177, 4023, 4548, 4923, 5572, 6284, 6942, 7488, 8045, 8560, 8783, 9512, 10156, 10806, 11688, 12201, 12904, 13211, 13882, 14097]","[0, 164, 397, 595, 1083, 1250, 1830, 2274, 2613, 2779, 2956, 3385, 3693, 4152, 4617, 5183, 5430, 5920, 6510, 7491, 7834, 8628, 9661, 10306, 11168, 11739, 12118, 12561, 12836, 13146]","[0, 130, 402, 492, 746, 870, 1008, 1439, 1750, 1840, 2017, 2161, 2299, 3013, 3526, 3927, 4150, 4335, 4539, 4724, 5015, 5992, 6306, 6610, 6878, 7120, 7372, 7626, 7797, 7968]","[0, 130, 220, 310, 445, 535, 640, 805, 985, 1075, 1252, 1576, 1846, 2198, 2458, 2810, 3147, 3332, 3597, 3867, 3961, 4238, 4477, 4706, 4801, 4968, 5063, 5607, 5703, 5834]",16148,14097,13146,7968,5834,1453,2225,-1065,1159,1743,5515,30,dire
7520536407,93,7,104,45,100,"[0, 658, 1232, 1607, 1977, 2268, 2862, 3196, 3842, 4337, 5121, 5742, 6098, 6689, 7229, 7994, 8993, 9628, 10329, 10841, 11751, 12448, 12874, 13549, 14391, 14735, 14830, 14979, 15075, 15516]","[0, 281, 565, 887, 1166, 1849, 2219, 2566, 2977, 3192, 3533, 4073, 4543, 5141, 5330, 6115, 6712, 7185, 7878, 8485, 8858, 9805, 10478, 11479, 11970, 13224, 13765, 14243, 14586, 14801]","[0, 256, 537, 834, 1056, 1431, 1853, 2308, 2698, 3041, 3588, 4195, 4463, 5078, 5438, 5995, 6741, 7141, 7946, 8041, 8716, 9276, 9911, 11021, 11399, 12189, 12614, 12829, 12980, 14215]","[0, 169, 294, 444, 534, 638, 805, 1034, 1141, 1324, 1460, 1820, 2103, 2448, 2635, 3290, 3870, 4356, 4907, 5233, 5390, 6041, 6364, 6939, 7773, 7940, 8147, 8241, 8337, 9116]","[0, 234, 388, 523, 658, 865, 1077, 1212, 1388, 1543, 1673, 1954, 2044, 2275, 2370, 2841, 3266, 3739, 4203, 4298, 4784, 4879, 5481, 6056, 6479, 6646, 6741, 7286, 7382, 7773]",15516,14801,14215,9116,7773,53,18,84,52,88,"[0, 169, 259, 401, 805, 944, 1508, 1728, 1863, 2346, 2894, 3207, 3992, 4792, 5396, 6219, 6657, 7205, 8222, 8839, 10412, 11012, 11707, 12854, 12948, 13944, 14639, 15984, 18207, 19625]","[0, 215, 625, 992, 1249, 1658, 1919, 2243, 2760, 3273, 3725, 4167, 4653, 5236, 5842, 6160, 6661, 7482, 8374, 9181, 10305, 10693, 11214, 11771, 12632, 13713, 14889, 16427, 17563, 18570]","[0, 169, 368, 647, 1138, 1266, 1727, 2164, 2467, 2703, 2838, 3529, 4194, 4526, 5096, 5301, 5975, 6784, 7582, 8032, 8770, 9516, 9805, 10612, 11893, 12961, 13367, 14463, 15514, 15610]","[0, 288, 589, 953, 1245, 1669, 2304, 2780, 3218, 3918, 4189, 4830, 5087, 5702, 6338, 6612, 7039, 7595, 7989, 8911, 9294, 9807, 9964, 10935, 11078, 12087, 13239, 14199, 15022, 15535]","[0, 169, 259, 349, 607, 697, 787, 1105, 1240, 1375, 1759, 1935, 2025, 2506, 2806, 2901, 2995, 3255, 3686, 3844, 4193, 4757, 4852, 5159, 6449, 6784, 6989, 7772, 8617, 9211]",19625,18570,15610,15535,9211,-4109,-3769,-1395,-6419,-1438,-17130,30,dire
7520694012,81,52,135,20,75,"[0, 328, 652, 1122, 1471, 2040, 2542, 2867, 3411, 3865, 4310, 4715, 5108, 5669, 6187, 6967, 7549, 8308, 9274, 9885, 10585, 11298, 12652, 12992, 13187, 14017, 14331, 14789, 15404, 15647]","[0, 331, 718, 1117, 1497, 1815, 2278, 2847, 3517, 4059, 4784, 5120, 5956, 6383, 6774, 7130, 7609, 8154, 8737, 9245, 9744, 10038, 11120, 11476, 11642, 12181, 12735, 13398, 13701, 14116]","[0, 292, 495, 789, 1283, 1576, 2238, 2647, 2981, 3621, 4172, 4634, 4949, 5343, 5638, 6154, 6761, 7532, 7983, 8626, 9169, 9612, 10275, 10814, 11268, 11812, 12541, 12748, 12989, 13085]","[0, 170, 364, 532, 670, 936, 1300, 1613, 2050, 2287, 2754, 2933, 3509, 3642, 4280, 4375, 4684, 5241, 5523, 5872, 6496, 6696, 7287, 7512, 7678, 7968, 8394, 9202, 9685, 9996]","[0, 170, 297, 387, 523, 706, 1040, 1175, 1400, 1619, 1913, 2003, 2676, 3007, 3274, 3609, 3848, 4214, 4496, 5100, 5304, 5714, 6262, 6523, 6796, 7404, 8220, 8315, 8572, 8799]",15647,14116,13085,9996,8799,18,42,97,9,101,"[0, 252, 1000, 1394, 1774, 2141, 2423, 2921, 3232, 3776, 4227, 4792, 5522, 6277, 6889, 7794, 8696, 9762, 11034, 11864, 12877, 13533, 14095, 15747, 16177, 16777, 17605, 18020, 20300, 20986]","[0, 205, 476, 636, 998, 1207, 1583, 1800, 1924, 2014, 2493, 2915, 3278, 3823, 4307, 4824, 5405, 6153, 6740, 7237, 7805, 8147, 9066, 9842, 10966, 11534, 12031, 12689, 13876, 14743]","[0, 279, 442, 721, 1092, 1409, 1851, 2106, 2420, 2944, 3196, 4051, 4452, 5369, 5841, 6376, 6879, 7510, 8134, 8841, 9834, 10437, 10793, 11500, 11837, 12552, 13050, 13199, 14377, 14971]","[0, 170, 395, 566, 924, 1379, 1558, 1817, 1971, 2425, 2578, 2858, 3139, 3347, 3610, 3936, 4218, 4670, 4950, 5265, 5640, 5738, 5989, 6597, 7249, 7530, 8015, 8134, 9165, 9367]","[0, 170, 364, 454, 814, 904, 1034, 1124, 1752, 2061, 2299, 2479, 2623, 2916, 3367, 3555, 3712, 4071, 4337, 4558, 4832, 5212, 5642, 6389, 6693, 7014, 7495, 7779, 8829, 9081]",20986,14743,14971,9367,9081,-5339,-627,-1886,629,-282,-7505,30,dire
7520723202,76,28,71,58,40,"[0, 169, 560, 877, 1075, 1486, 1824, 2340, 2805, 3206, 3808, 4311, 4809, 5331, 5689, 6204, 6935, 7892, 8745, 9303, 10273, 11093, 11687, 11781, 12289, 13133, 14402, 15223, 16041, 16322]","[0, 215, 574, 947, 1164, 1652, 2014, 2378, 2739, 3517, 4119, 4508, 5488, 6413, 6834, 7364, 7728, 8093, 8863, 9010, 9278, 10460, 11022, 11389, 11885, 11980, 12891, 13381, 13558, 13925]","[100, 299, 603, 864, 1144, 1369, 1672, 2012, 2363, 2920, 3558, 4197, 5027, 5759, 6052, 6610, 7532, 8321, 8812, 9386, 10027, 10632, 11559, 12274, 12440, 13078, 13478, 14274, 14826, 15320]","[78, 207, 297, 400, 501, 666, 813, 1409, 1577, 1667, 1941, 2646, 3171, 3851, 4253, 4408, 4841, 5099, 5574, 5781, 6079, 6514, 6895, 7083, 7245, 7722, 8203, 9370, 9775, 9960]","[211, 340, 430, 566, 656, 910, 1102, 1272, 1491, 1834, 2358, 2768, 3063, 3726, 4062, 4157, 4314, 4913, 5221, 5316, 5489, 5825, 6226, 6427, 6952, 7080, 7338, 7752, 7929, 8025]",16322,13925,15320,9960,8025,10,98,61,79,136,"[62, 271, 509, 819, 1159, 1646, 2238, 2697, 3196, 3536, 3795, 4075, 4514, 5185, 6106, 6477, 7097, 7653, 8162, 8762, 9646, 10453, 11599, 12180, 13021, 14286, 15056, 16859, 17696, 19427]","[330, 695, 982, 1393, 1719, 1929, 2436, 2896, 3320, 4060, 4655, 5410, 6237, 6600, 7252, 8106, 8899, 9621, 10473, 11150, 12015, 12868, 13954, 14735, 15786, 17321, 18036, 18723, 18819, 19416]","[62, 271, 622, 910, 1228, 1380, 1673, 1838, 2038, 2202, 2414, 2758, 3119, 3451, 4012, 4677, 5329, 6160, 6979, 7683, 8591, 8971, 9429, 10052, 10891, 12203, 12935, 13964, 14159, 15264]","[162, 416, 506, 677, 767, 897, 1049, 1236, 1407, 1785, 1905, 2103, 2694, 2989, 3119, 3456, 3814, 4350, 4968, 5126, 5799, 5966, 6771, 7000, 7438, 8173, 8268, 8867, 9325, 10113]","[62, 271, 361, 500, 594, 795, 978, 1068, 1158, 1248, 1592, 1812, 2095, 2513, 2784, 2879, 3036, 3221, 3586, 3744, 4172, 4438, 5093, 5482, 6198, 6728, 6823, 7200, 7437, 8153]",19427,19416,15264,10113,8153,-3105,-5491,56,-153,-128,-8821,30,dire
7520855809,98,21,96,121,112,"[0, 331, 648, 1142, 1475, 1776, 2314, 2722, 3284, 3586, 4122, 4623, 5076, 5378, 5685, 6449, 6997, 7369, 8177, 9094, 9281, 9816, 10528, 11150, 12435, 13000, 14158, 15032, 15483, 15667]","[0, 257, 593, 878, 1228, 1811, 2184, 2606, 2909, 3499, 3751, 4383, 4851, 5061, 5782, 6237, 6512, 6860, 7479, 8258, 8731, 9380, 10059, 10248, 10553, 10772, 11448, 11689, 12490, 12661]","[0, 205, 333, 622, 1103, 1324, 1414, 1825, 2145, 2482, 3105, 3406, 3619, 3887, 4421, 5082, 5529, 5998, 6451, 7004, 7435, 7640, 8111, 8680, 9166, 9951, 10045, 10401, 11167, 11714]","[0, 218, 308, 398, 567, 703, 835, 925, 1015, 1239, 1491, 1873, 1963, 2093, 2260, 2647, 2833, 2966, 3476, 4060, 4448, 4668, 5186, 5356, 5924, 6296, 6611, 6927, 7364, 7535]","[0, 169, 259, 349, 519, 649, 775, 984, 1074, 1164, 1416, 1588, 1810, 1932, 2536, 2720, 2906, 3333, 3760, 3973, 4235, 4510, 4811, 5032, 5320, 5529, 5769, 6010, 7132, 7228]",15667,12661,11714,7535,7228,47,61,129,91,26,"[0, 297, 531, 914, 1373, 2018, 2591, 3113, 3702, 4114, 5165, 5584, 6330, 7637, 8241, 9022, 9815, 11084, 11749, 12586, 12807, 13496, 14794, 15880, 16894, 17879, 19178, 19990, 21005, 22183]","[0, 169, 414, 816, 1036, 1455, 1747, 2299, 2838, 3384, 3865, 4430, 4861, 5614, 6254, 6575, 7638, 8375, 9051, 10294, 10818, 12154, 12841, 13243, 13940, 14309, 15080, 15986, 16520, 16791]","[0, 169, 499, 756, 1343, 1516, 1848, 2052, 2577, 2956, 3436, 3853, 4019, 4878, 5271, 5891, 6121, 6895, 7196, 8011, 8743, 9098, 10157, 10362, 11104, 11480, 11793, 12162, 12535, 13504]","[0, 169, 259, 396, 612, 799, 951, 1180, 1363, 1557, 1943, 2131, 2480, 3248, 3404, 3588, 3822, 4349, 4443, 4960, 5256, 5612, 6156, 6937, 7261, 7620, 7924, 8219, 8608, 8854]","[0, 169, 277, 415, 576, 666, 764, 944, 1153, 1243, 1489, 1677, 1767, 2281, 2505, 2789, 3020, 3334, 3482, 4271, 4492, 4896, 5269, 5454, 5698, 6150, 6336, 6431, 7072, 7378]",22183,16791,13504,8854,7378,-6516,-4130,-1790,-1319,-150,-13905,30,dire
7521011714,10,102,59,112,66,"[0, 242, 531, 864, 1188, 1516, 1887, 2300, 2724, 3094, 3641, 4185, 4716, 5603, 6421, 6980, 7562, 8111, 8673, 9100, 9216, 9617, 11300, 11973, 12594, 13359, 13714, 15525, 15621, 16110]","[0, 254, 522, 1001, 1351, 1479, 1940, 2262, 2648, 2809, 3334, 3730, 4308, 4728, 5442, 5878, 6108, 6529, 6820, 7277, 7743, 8080, 8899, 9549, 10168, 10650, 11318, 11682, 12403, 13175]","[0, 313, 566, 859, 1376, 1836, 2334, 2945, 3246, 3711, 3963, 4635, 5243, 5576, 5848, 6111, 6953, 7160, 7662, 7948, 8173, 8795, 9090, 9316, 9464, 9997, 10789, 11049, 11329, 12678]","[0, 207, 297, 818, 1026, 1116, 1297, 1432, 1699, 1835, 2269, 2749, 3062, 3450, 3729, 4032, 4308, 4499, 4801, 4896, 5121, 5372, 5830, 6013, 6448, 6705, 7137, 7415, 8091, 8660]","[0, 272, 362, 499, 633, 821, 942, 1178, 1473, 1640, 1974, 2425, 2899, 3071, 3447, 3646, 3876, 4175, 4493, 4733, 5009, 5371, 5877, 6281, 6682, 6841, 7130, 7900, 8391, 8945]",16110,13175,12678,8660,8945,44,17,43,71,5,"[0, 205, 630, 921, 1201, 1414, 1577, 1913, 2336, 2865, 3343, 3784, 4330, 4808, 5195, 5696, 6279, 7380, 7959, 8775, 9820, 10594, 11580, 11990, 12924, 13950, 14882, 16314, 16729, 17286]","[0, 327, 534, 965, 1215, 1398, 1738, 2000, 2878, 3053, 3538, 4129, 4673, 4994, 5570, 6178, 7053, 8002, 8945, 10509, 11243, 11752, 12318, 12865, 13310, 14010, 14628, 16004, 16511, 16799]","[0, 208, 543, 866, 1161, 1439, 1775, 2138, 2818, 3294, 4162, 4676, 5384, 5976, 6682, 7226, 7775, 9022, 9528, 10231, 11296, 11943, 12604, 13490, 14171, 14543, 15005, 15617, 16474, 16570]","[0, 170, 365, 542, 769, 859, 962, 1100, 1508, 1873, 2243, 2382, 2582, 2903, 3185, 3431, 3752, 4191, 4491, 5316, 5618, 6102, 6439, 7098, 7448, 8139, 8334, 9078, 9830, 9926]","[0, 170, 260, 574, 704, 840, 992, 1131, 1266, 1458, 1835, 1925, 2149, 2930, 3078, 3413, 3748, 4316, 4410, 4568, 5072, 5417, 5749, 6236, 6331, 6569, 6664, 7099, 7611, 8196]",17286,16799,16570,9926,8196,-1176,-3624,-3892,-1266,749,-9209,30,radiant
7521225303,46,49,76,58,26,"[368, 681, 858, 1228, 1579, 1976, 2422, 2675, 3301, 3852, 4455, 5006, 5747, 6165, 6953, 7396, 8201, 8789, 9451, 9898, 10552, 11295, 12256, 12771, 13651, 14162, 14352, 15069, 15579, 16309]","[283, 620, 863, 1278, 1488, 1689, 1906, 2355, 2795, 3223, 3899, 4198, 4619, 5196, 5291, 5946, 6597, 7305, 7959, 8878, 9354, 9819, 10359, 11179, 11982, 12470, 13299, 13395, 13741, 14313]","[288, 580, 995, 1374, 1730, 2292, 2865, 3138, 3568, 3795, 4149, 4593, 5076, 5332, 5828, 6645, 6921, 7105, 7345, 8106, 8365, 8657, 9201, 9575, 10020, 10218, 10531, 11124, 11220, 11350]","[210, 300, 508, 659, 836, 943, 1237, 1468, 1595, 2014, 2228, 2428, 2614, 2725, 2930, 3545, 3767, 4235, 4732, 5208, 5459, 5942, 6387, 6528, 6856, 6951, 7046, 7433, 7691, 8335]","[254, 344, 451, 631, 721, 811, 991, 1402, 1536, 1626, 1960, 2280, 2492, 2987, 3290, 3725, 3864, 4764, 5221, 5507, 5737, 5831, 6125, 6265, 6612, 6754, 6849, 7105, 7201, 7457]",16309,14313,11350,8335,7457,82,14,69,63,123,"[274, 562, 809, 1103, 1578, 2235, 2540, 3309, 3822, 4471, 5134, 5624, 6209, 7343, 8294, 9156, 10070, 10430, 11184, 11659, 12389, 13155, 14087, 15299, 16117, 17070, 18626, 20078, 20708, 21719]","[130, 544, 862, 1095, 1462, 1807, 2462, 2841, 3608, 4177, 4725, 5283, 5824, 6290, 6748, 7482, 8827, 9313, 10402, 11121, 11216, 12197, 13120, 13604, 14783, 15729, 16919, 18119, 19015, 19720]","[202, 530, 903, 1131, 1782, 2003, 2663, 3298, 3588, 4350, 4845, 5891, 6481, 7264, 7867, 8695, 9108, 9671, 10749, 11109, 11589, 12272, 12959, 13290, 13925, 14548, 15273, 15859, 16211, 16644]","[166, 256, 879, 969, 1186, 1276, 1448, 1647, 1821, 2204, 2316, 2406, 2677, 3205, 3567, 3799, 4021, 4275, 4740, 5423, 5821, 6321, 6887, 7143, 7713, 8127, 9229, 9916, 10464, 10770]","[181, 271, 413, 599, 867, 1225, 1360, 1614, 1788, 2035, 2125, 2394, 2794, 3148, 3412, 3631, 3913, 4171, 4653, 5330, 5515, 5957, 6319, 6653, 7116, 7567, 8168, 8578, 8831, 9052]",21719,19720,16644,10770,9052,-5410,-5407,-5294,-2435,-1595,-20141,30,dire
7521480417,12,107,21,85,138,"[0, 281, 630, 988, 1483, 1718, 1981, 2071, 2224, 2581, 2769, 3497, 4065, 4595, 5251, 5805, 6428, 7439, 8103, 8565, 8891, 9518, 10204, 10976, 11553, 12148, 12898, 14008, 14610, 14944]","[0, 319, 602, 1087, 1448, 1720, 2083, 2483, 2861, 3150, 3361, 3800, 4104, 4532, 5545, 6078, 6873, 7316, 8049, 8443, 9509, 10039, 10609, 11341, 12214, 13177, 13839, 15007, 15637, 16013]","[0, 282, 615, 1019, 1485, 1781, 2206, 2964, 3455, 4059, 4488, 5235, 5764, 6372, 7425, 7602, 8604, 9093, 9842, 9937, 10374, 10641, 11054, 11629, 12079, 12208, 12324, 12852, 12970, 13201]","[0, 170, 260, 397, 532, 628, 763, 952, 1170, 1471, 1787, 2209, 2299, 2533, 2903, 2998, 3189, 3962, 4153, 4421, 4788, 5407, 5682, 6026, 6509, 6949, 7565, 8232, 8513, 8979]","[0, 170, 304, 439, 575, 665, 800, 890, 1141, 1346, 1531, 1999, 2089, 2284, 2941, 3206, 3855, 4607, 4959, 5054, 5211, 5600, 5844, 6157, 6493, 6677, 6867, 7184, 7390, 7928]",14944,16013,13201,8979,7928,10,129,137,26,100,"[0, 285, 589, 871, 1395, 1609, 2078, 2609, 2952, 3503, 4137, 4505, 5043, 5563, 6187, 7078, 7771, 8490, 9184, 10056, 10627, 11593, 12371, 13200, 13931, 14708, 15386, 16554, 17379, 18064]","[0, 240, 562, 824, 1144, 1468, 1938, 2369, 2622, 3151, 3703, 4308, 4864, 5257, 5538, 6015, 6365, 6771, 7465, 8737, 9516, 9745, 10290, 10930, 11250, 11819, 12360, 12544, 12988, 13904]","[0, 170, 420, 741, 996, 1408, 1858, 2717, 3361, 3629, 4248, 4338, 4967, 5489, 6273, 6755, 7181, 7646, 8029, 9306, 9636, 10351, 11436, 11997, 12212, 12838, 13608, 13930, 14216, 14559]","[0, 170, 619, 709, 858, 992, 1082, 1513, 1675, 1765, 2023, 2113, 2220, 2413, 2692, 3047, 3292, 3515, 3735, 4239, 4686, 5030, 5354, 5524, 6031, 6273, 6565, 6824, 7275, 7624]","[0, 170, 260, 350, 572, 676, 766, 946, 1104, 1251, 1431, 1728, 1818, 2217, 2447, 2640, 2797, 3007, 3156, 3628, 3722, 3892, 4307, 4611, 5090, 5350, 5675, 5997, 6380, 6476]",18064,13904,14559,7624,6476,-3120,2109,-1358,1355,1452,438,30,dire
7522292402,1,35,14,22,64,"[0, 286, 662, 1088, 1419, 1782, 2178, 2672, 3693, 4237, 4688, 5139, 5611, 6536, 7296, 7809, 8592, 9207, 10574, 10976, 11609, 12560, 13347, 14064, 15219, 16187, 17118, 17935, 18138, 18608]","[0, 360, 770, 1170, 1570, 2010, 2478, 2990, 3470, 4110, 4633, 5258, 5725, 6471, 7252, 8035, 8784, 9293, 9920, 10718, 11678, 12445, 13299, 14191, 15109, 16251, 16577, 16745, 17145, 17241]","[0, 331, 638, 967, 1413, 1835, 2257, 2620, 2981, 3548, 4024, 4187, 4703, 5467, 6091, 6545, 7221, 7839, 8327, 9074, 9439, 10162, 11730, 12131, 12639, 13014, 13954, 14632, 14867, 14963]","[0, 210, 330, 475, 748, 949, 1086, 1242, 1528, 1752, 1971, 2477, 2629, 3112, 3387, 3904, 4062, 4203, 4380, 4750, 5206, 5668, 6062, 6456, 7588, 7960, 9161, 9325, 9503, 9906]","[0, 210, 300, 492, 601, 754, 864, 954, 1044, 1273, 1497, 1622, 1712, 1997, 2200, 2591, 2749, 2843, 3408, 3677, 4024, 4328, 4756, 5126, 5471, 5713, 6604, 6989, 7209, 7380]",18608,17241,14963,9906,7380,44,11,129,84,86,"[0, 167, 535, 862, 1190, 1486, 1950, 2325, 2747, 3027, 3439, 4058, 4715, 5362, 5908, 6773, 7482, 8255, 8942, 9713, 10471, 11354, 12114, 13043, 13938, 14641, 15358, 15453, 17057, 18152]","[0, 286, 617, 1062, 1452, 1951, 2521, 3074, 3877, 4620, 5175, 5727, 6455, 7273, 7948, 8043, 8780, 9507, 10221, 11118, 11680, 12231, 13609, 14594, 15557, 16085, 16820, 16988, 18303, 19505]","[0, 203, 444, 802, 1178, 1622, 1903, 2547, 2916, 3237, 3604, 4137, 4761, 5217, 5690, 6351, 6606, 7256, 7712, 7981, 8280, 8973, 9739, 9962, 10091, 10186, 10979, 11380, 12061, 13047]","[0, 130, 220, 366, 502, 592, 729, 897, 1032, 1122, 1212, 1348, 1600, 1694, 1872, 2119, 2214, 2462, 2845, 3045, 3444, 3907, 4154, 4659, 4753, 5257, 5352, 5757, 6774, 7164]","[0, 130, 220, 310, 400, 490, 580, 764, 928, 1103, 1275, 1742, 1994, 2170, 2265, 2601, 2944, 3334, 4135, 4230, 4658, 4753, 4848, 5033, 5310, 5405, 6578, 6673, 7310, 7658]",18152,19505,13047,7164,7658,456,-2264,1916,2742,-278,2572,30,radiant
7522384400,95,137,110,97,101,"[0, 262, 575, 803, 1278, 1877, 2253, 2433, 2907, 3359, 3874, 4400, 4978, 5459, 5858, 5952, 6967, 7938, 8930, 9582, 10243, 11650, 12628, 13587, 14921, 15748, 16477, 17593, 18767, 19643]","[0, 158, 317, 558, 801, 1069, 1438, 1892, 2661, 2838, 3312, 3501, 3591, 4391, 5209, 5389, 6617, 7085, 7820, 8585, 8849, 9479, 10296, 10792, 11226, 11507, 12280, 12667, 13349, 13742]","[0, 434, 524, 614, 783, 1179, 1364, 1746, 1836, 2051, 2322, 2558, 2806, 3301, 3666, 4018, 4949, 5306, 6002, 6183, 6370, 6911, 7410, 7851, 8378, 9072, 9428, 9897, 10554, 10746]","[0, 169, 520, 819, 1477, 1768, 2135, 2453, 2852, 3219, 3473, 3775, 4091, 4807, 5258, 5352, 6582, 6852, 7037, 7840, 8187, 8825, 9226, 9995, 10425, 11098, 11192, 11772, 12228, 12469]","[0, 311, 401, 491, 850, 1168, 1393, 1573, 1849, 2074, 2345, 2789, 2924, 3317, 3446, 3540, 4526, 4711, 4896, 5227, 5322, 6051, 6452, 7106, 7201, 7600, 7694, 7789, 8245, 8437]",19643,13742,10746,12469,8437,25,28,135,86,26,"[381, 673, 968, 1446, 1728, 2117, 2523, 3134, 3503, 4097, 4389, 4867, 5373, 5678, 6271, 7202, 7440, 8159, 9114, 9581, 10060, 10229, 10786, 11519, 12025, 13183, 13899, 14427, 15430, 15995]","[246, 565, 850, 1227, 1471, 1969, 2365, 2924, 3419, 3972, 4692, 5245, 5937, 6415, 7266, 8316, 8484, 8685, 9796, 10246, 10884, 11434, 12165, 12259, 12728, 13560, 14343, 14784, 15226, 15446]","[113, 356, 609, 847, 1025, 1199, 1475, 1982, 2397, 3013, 3442, 3962, 4664, 5199, 5627, 6598, 7126, 7384, 7869, 8418, 8892, 9198, 10059, 10391, 10678, 11290, 12032, 12412, 12752, 12903]","[113, 322, 412, 589, 679, 851, 976, 1503, 2322, 2535, 2888, 3126, 3306, 3800, 4168, 4531, 4726, 4971, 5500, 5594, 5794, 5889, 6522, 6973, 7469, 7975, 8204, 8639, 8998, 9266]","[113, 322, 412, 635, 770, 860, 950, 1220, 1518, 1733, 1978, 2305, 2541, 2744, 3250, 3794, 3986, 4128, 4738, 4832, 5032, 5152, 5610, 5763, 6014, 6432, 6682, 6852, 7133, 7304]",15995,15446,12903,9266,7304,3648,-1704,-2157,3203,1133,4123,30,radiant
7522545002,93,47,110,20,14,"[0, 243, 708, 1421, 1631, 2209, 2632, 2874, 3125, 3502, 3997, 5016, 5342, 6086, 6824, 7451, 7929, 9009, 9928, 10791, 11395, 11894, 12126, 12922, 13555, 14274, 14619, 15114, 16413, 16509]","[0, 583, 819, 1080, 1411, 1647, 1811, 2015, 2563, 2927, 3354, 3698, 4228, 4688, 5081, 5321, 5660, 5966, 6366, 6672, 7025, 7120, 7340, 7732, 8198, 8583, 8723, 8817, 9660, 9931]","[0, 170, 369, 459, 549, 639, 831, 921, 1101, 1514, 2538, 2899, 3034, 3335, 3883, 4064, 4537, 4833, 5371, 5730, 5913, 6199, 6328, 6718, 6915, 7100, 7394, 7624, 9191, 9590]","[0, 277, 690, 1059, 1257, 1458, 1548, 1757, 2143, 2347, 2714, 2980, 3382, 3796, 3977, 4172, 4623, 4992, 5302, 5629, 5905, 6000, 6190, 6565, 6846, 7031, 7126, 7370, 8223, 8747]","[0, 239, 532, 874, 1035, 1222, 1395, 1485, 1795, 1984, 2361, 2541, 3148, 3351, 3646, 4186, 4491, 4649, 5003, 5206, 5405, 5506, 5685, 6319, 6414, 6599, 7114, 7375, 8017, 8288]",16509,9931,9590,8747,8288,25,29,70,27,121,"[0, 222, 592, 924, 1316, 1813, 2531, 3073, 3755, 4175, 4419, 4763, 5279, 5664, 6673, 6842, 7766, 8162, 8739, 9472, 9766, 10896, 12774, 13467, 14280, 14843, 16347, 17127, 18401, 19889]","[0, 241, 478, 1014, 1311, 1514, 1812, 2490, 3043, 3714, 4319, 4556, 4923, 5495, 5886, 6297, 6928, 8345, 9021, 9449, 9965, 10493, 11025, 11682, 12424, 12993, 13980, 14383, 14891, 15194]","[0, 244, 668, 871, 1281, 1516, 1985, 2253, 2795, 2968, 3218, 3523, 4220, 4809, 5432, 5798, 6387, 6769, 7273, 7811, 8487, 9518, 9865, 10366, 10914, 11200, 12465, 12813, 13170, 13459]","[0, 272, 379, 560, 690, 780, 915, 1054, 1198, 1329, 1554, 1644, 1778, 2016, 2692, 2794, 2928, 4044, 4145, 4460, 4844, 5814, 6166, 6526, 6790, 7078, 7653, 7933, 8318, 8414]","[0, 170, 462, 768, 943, 1072, 1345, 1505, 1731, 1857, 2082, 2172, 2409, 2656, 3108, 3340, 3679, 4410, 4666, 5351, 5665, 6195, 6475, 6617, 6847, 7052, 7582, 7877, 8466, 8820]",19889,15194,13459,8414,8820,-3380,-5263,-3869,333,-532,-12711,30,dire
7522558918,39,21,15,100,20,"[330, 578, 827, 1078, 1586, 2128, 2703, 3475, 4134, 4722, 5958, 6448, 7200, 7999, 8698, 9522, 10103, 10849, 11199, 11860, 12615, 13714, 14201, 15083, 15249, 16055, 17092, 17761, 18510, 19118]","[62, 389, 938, 1234, 1805, 2182, 2506, 3101, 3841, 4517, 5242, 5884, 6064, 7163, 8056, 8363, 9138, 9681, 9952, 10173, 10423, 12008, 12747, 12946, 13509, 14394, 15756, 16704, 17369, 18252]","[62, 392, 775, 984, 1510, 1854, 2119, 2598, 3015, 3745, 4238, 5597, 6010, 6896, 7270, 7829, 8529, 8948, 9568, 10392, 10984, 11265, 11857, 12516, 13265, 13662, 14741, 15610, 15706, 16374]","[62, 272, 423, 513, 681, 851, 941, 1381, 1597, 1745, 2174, 2354, 2534, 3160, 3507, 3719, 4183, 4977, 5072, 5293, 5522, 5985, 6400, 6777, 6943, 7139, 7758, 8355, 8598, 8886]","[62, 272, 362, 486, 647, 1020, 1110, 1270, 1415, 1641, 1876, 2121, 2446, 3026, 3337, 3757, 3961, 4480, 4623, 4844, 5073, 5440, 5764, 5911, 6077, 6502, 7168, 7717, 7962, 8250]",19118,18252,16374,8886,8250,90,102,29,112,121,"[0, 312, 596, 855, 1028, 1290, 1747, 2088, 2419, 2672, 2925, 3015, 3789, 4084, 4464, 4948, 5372, 6951, 8236, 8948, 9143, 9495, 9791, 10373, 11992, 12778, 12873, 13375, 14057, 14646]","[0, 193, 513, 972, 1311, 1593, 1844, 2204, 2342, 2611, 3139, 3575, 4242, 4951, 5142, 5695, 5894, 6278, 7535, 8168, 8532, 9391, 9671, 10330, 11162, 11987, 12082, 12177, 13632, 14147]","[0, 155, 436, 732, 1012, 1272, 1362, 1542, 1677, 1767, 2140, 2419, 2806, 3163, 3386, 3615, 3973, 4717, 5529, 5960, 6231, 6656, 7055, 8104, 8699, 9312, 9407, 9588, 9954, 10050]","[0, 155, 245, 335, 425, 515, 605, 785, 875, 965, 1182, 1571, 1661, 1966, 2061, 2290, 2471, 3130, 4740, 5278, 5428, 5919, 6067, 6652, 7472, 7754, 7924, 8146, 8920, 9091]","[0, 155, 291, 451, 649, 874, 1013, 1278, 1554, 1726, 2116, 2378, 2821, 2996, 3146, 3428, 3557, 3983, 4757, 4915, 5279, 5499, 5858, 6230, 6678, 7033, 7128, 7428, 8309, 8533]",14646,14147,10050,9091,8533,4472,4105,6324,-205,-283,14413,30,radiant
7522585414,65,48,23,58,112,"[0, 295, 466, 957, 1255, 1782, 2334, 2918, 3661, 4163, 4726, 5616, 6331, 6688, 7566, 7711, 8611, 9283, 10609, 11295, 12299, 13392, 13486, 14456, 14942, 16482, 16751, 17731, 18797, 20072]","[0, 322, 566, 817, 1210, 1385, 1674, 1800, 2036, 2308, 2890, 3386, 4076, 4605, 5356, 5931, 6717, 7281, 8067, 8806, 9966, 10602, 11316, 12273, 12893, 13988, 14082, 14425, 14969, 15969]","[0, 254, 447, 696, 977, 1477, 2034, 2218, 2845, 3157, 3429, 3846, 4282, 4559, 5211, 5716, 6195, 6738, 7159, 7830, 8503, 8890, 10119, 10516, 10995, 11434, 11528, 11638, 12230, 12705]","[0, 169, 363, 536, 889, 1026, 1436, 1777, 1903, 1993, 2253, 2347, 2840, 2935, 3097, 3321, 3639, 3759, 4818, 5223, 6187, 6511, 7076, 7473, 7598, 8152, 8674, 8995, 9149, 9420]","[0, 169, 294, 384, 518, 741, 1003, 1187, 1389, 1838, 2235, 2502, 2706, 2801, 3160, 3341, 3637, 3779, 4627, 4933, 5686, 5883, 6762, 7522, 7617, 7800, 8069, 8439, 8535, 8829]",20072,15969,12705,9420,8829,54,21,20,136,45,"[0, 251, 566, 911, 1186, 1585, 2022, 2530, 3008, 3431, 3925, 4346, 4778, 5047, 5863, 6273, 7081, 7597, 8025, 8883, 9616, 10318, 11055, 11550, 12306, 13697, 14719, 15742, 16439, 17321]","[0, 303, 702, 1026, 1358, 1814, 2360, 2766, 3353, 4114, 4672, 5256, 5756, 6184, 7049, 7860, 8540, 9214, 9418, 10013, 10307, 10554, 11948, 12152, 12778, 13651, 14412, 15071, 15908, 16543]","[0, 542, 791, 1313, 1713, 2108, 2522, 3206, 3931, 4681, 5175, 5524, 5823, 6215, 6666, 7007, 7469, 7850, 8267, 8894, 9303, 9648, 10171, 10811, 11237, 12411, 13132, 13890, 14980, 15224]","[0, 238, 328, 519, 1195, 1367, 2048, 2235, 2588, 2901, 3219, 3367, 4023, 4234, 4472, 4567, 5608, 5752, 5846, 6067, 6242, 6367, 6533, 6737, 6832, 7564, 7997, 9204, 9543, 9639]","[0, 169, 309, 429, 519, 653, 872, 996, 1131, 1303, 1647, 1945, 2295, 2768, 3006, 3421, 4020, 4423, 4627, 5448, 5804, 5899, 6065, 6160, 6366, 6828, 7143, 7734, 8175, 8346]",17321,16543,15224,9639,8346,2751,-574,-2519,-219,483,-78,30,dire
7522659008,25,74,23,102,45,"[0, 284, 679, 1093, 1541, 2179, 2470, 2946, 3516, 3944, 5308, 5961, 6622, 7458, 8703, 9659, 10252, 10678, 11199, 11703, 12077, 12793, 14278, 15086, 15859, 16889, 17794, 18222, 18987, 19646]","[0, 169, 366, 728, 1002, 1457, 1781, 2225, 2641, 3007, 3695, 4319, 4914, 5286, 5886, 6422, 6580, 7306, 8476, 8704, 9697, 10417, 10943, 12312, 12767, 13330, 13870, 14135, 14849, 15331]","[0, 244, 585, 1148, 1276, 1705, 1839, 2043, 2391, 2597, 2948, 3338, 3517, 4105, 4729, 5374, 5996, 6176, 6489, 6813, 7108, 7604, 8130, 8449, 9101, 9614, 10141, 10236, 10362, 10801]","[0, 169, 284, 422, 530, 926, 1071, 1249, 1347, 1519, 2147, 2417, 2575, 2775, 3245, 3578, 3825, 3920, 4114, 4208, 4420, 4866, 5842, 6130, 6711, 7149, 7338, 7508, 7679, 8023]","[0, 219, 334, 569, 721, 873, 963, 1444, 1534, 1671, 2187, 2608, 2794, 2889, 3391, 3718, 3973, 4235, 4429, 4549, 4819, 5084, 5962, 6129, 6333, 6500, 6705, 6898, 6994, 7531]",19646,15331,10801,8023,7531,52,76,14,71,79,"[58, 349, 725, 1098, 1467, 1882, 2228, 2781, 3214, 3422, 3588, 4348, 4609, 5717, 6397, 7246, 8394, 9753, 10048, 11186, 12127, 12638, 13112, 14169, 14962, 15620, 16652, 17187, 18224, 19235]","[326, 533, 893, 1179, 1481, 1853, 2172, 2699, 3154, 3833, 4067, 4365, 4833, 5232, 6000, 6664, 7626, 8690, 9310, 10635, 11680, 12594, 12770, 13310, 13946, 14864, 15827, 16321, 17504, 17856]","[58, 227, 395, 707, 1158, 1322, 1537, 2317, 2653, 2861, 3196, 3750, 4219, 4562, 4949, 5276, 5869, 6908, 7273, 8266, 8944, 9344, 9536, 9997, 10216, 10537, 10874, 11080, 11438, 11993]","[58, 227, 317, 407, 581, 711, 849, 1087, 1286, 1483, 1814, 2112, 2448, 2723, 2818, 3020, 3742, 4264, 4359, 5162, 5659, 5926, 6073, 6321, 6750, 7363, 7875, 8079, 8580, 8917]","[58, 227, 317, 407, 584, 714, 823, 1148, 1283, 1373, 1463, 1679, 2016, 2586, 2964, 3166, 3690, 3878, 4141, 4827, 5385, 5692, 6045, 6495, 6738, 7091, 8020, 8239, 9009, 9261]",19235,17856,11993,8917,9261,411,-2525,-1192,-894,-1730,-5930,30,radiant
7522961618,25,95,104,128,51,"[0, 204, 539, 783, 1242, 1610, 1936, 2581, 2882, 3342, 4334, 4652, 5043, 5902, 6823, 7088, 8223, 8929, 9971, 10477, 11049, 11584, 12286, 12656, 13281, 14900, 15423, 15919, 16677, 18451]","[0, 285, 488, 816, 1187, 1518, 2078, 2474, 2932, 3480, 3660, 4132, 4641, 5026, 5671, 6289, 7147, 7856, 8362, 9145, 9813, 10771, 11458, 12263, 12415, 13010, 13565, 13772, 14052, 15000]","[0, 295, 424, 879, 1155, 1281, 1571, 1698, 1833, 2213, 2491, 2791, 3174, 3555, 3918, 4086, 4785, 5550, 6734, 7080, 7174, 7449, 7697, 7909, 8085, 8677, 8862, 9048, 9476, 9827]","[0, 169, 276, 366, 536, 715, 850, 940, 1075, 1630, 2009, 2201, 2291, 2657, 3169, 3264, 4027, 4408, 4612, 4852, 4946, 5461, 5730, 5941, 6035, 6921, 7016, 7213, 7309, 7747]","[0, 169, 259, 349, 538, 719, 898, 988, 1123, 1561, 1741, 2064, 2154, 2458, 3149, 3254, 3541, 3965, 4368, 4680, 4774, 5321, 5416, 5622, 5821, 6321, 6416, 6510, 6651, 7142]",18451,15000,9827,7747,7142,10,74,129,85,121,"[0, 253, 690, 1216, 1806, 2644, 3167, 3734, 4436, 4720, 5396, 6009, 6547, 6921, 7499, 8184, 8485, 8751, 9550, 10369, 11230, 13009, 13884, 15443, 16702, 17562, 18142, 19552, 20734, 21517]","[0, 240, 376, 703, 993, 1289, 1611, 1953, 2494, 2906, 3295, 3842, 4409, 4953, 5260, 5908, 6357, 6515, 7367, 8220, 8623, 9457, 10225, 10666, 11766, 12293, 13077, 13927, 14667, 15396]","[0, 203, 516, 759, 1094, 1307, 1681, 1987, 2411, 2890, 3769, 4277, 4747, 5274, 5631, 5993, 6499, 6859, 7462, 7759, 8649, 8910, 9656, 10507, 11188, 12258, 12633, 13124, 13821, 14160]","[0, 169, 259, 422, 681, 980, 1074, 1276, 1456, 1657, 2022, 2285, 2528, 2773, 2922, 3092, 3582, 3864, 4164, 4407, 4780, 5093, 5378, 6299, 6833, 7672, 8014, 8453, 8969, 9237]","[0, 169, 259, 349, 487, 577, 667, 864, 1044, 1201, 1626, 1855, 2053, 2495, 2819, 3002, 3303, 3500, 3970, 4206, 4426, 4859, 5155, 5601, 6143, 6970, 7202, 7747, 8181, 8495]",21517,15396,14160,9237,8495,-3066,-396,-4333,-1490,-1353,-10638,30,dire
7523717218,48,74,129,96,26,"[0, 252, 566, 880, 1161, 1521, 2010, 2518, 2987, 3526, 4069, 4698, 5344, 6018, 6815, 7404, 8184, 9544, 10428, 11761, 12524, 14011, 14550, 15470, 16012, 16959, 18048, 19005, 20223, 21880]","[0, 245, 536, 898, 1629, 2009, 2726, 3271, 3415, 3695, 4125, 4314, 4737, 5235, 5527, 6132, 6473, 6928, 7587, 8061, 8617, 9352, 9597, 10052, 10487, 11205, 11877, 12223, 12783, 13503]","[0, 285, 592, 831, 1254, 1434, 1673, 2131, 2447, 2905, 3190, 3705, 4118, 4649, 4919, 5203, 5827, 6520, 6775, 7157, 7474, 8019, 8272, 8434, 8690, 9104, 10193, 10619, 11100, 11952]","[0, 170, 260, 395, 525, 664, 992, 1417, 1507, 1597, 1918, 2342, 2559, 2980, 3413, 3987, 4245, 4645, 4982, 5364, 5661, 6340, 6567, 6918, 7084, 7896, 8652, 8793, 9472, 10017]","[0, 170, 260, 350, 528, 618, 754, 1071, 1330, 1549, 1684, 1873, 2139, 2317, 2507, 2983, 3562, 4054, 4246, 4628, 4798, 5088, 5258, 5578, 5854, 6256, 6812, 7110, 7445, 8037]",21880,13503,11952,10017,8037,46,17,69,20,45,"[0, 256, 525, 936, 1266, 1663, 2064, 2414, 2940, 3520, 4225, 4824, 5244, 6138, 6875, 7648, 8438, 8984, 9739, 11409, 12236, 12731, 13111, 13785, 14810, 15463, 16377, 17110, 17843, 18463]","[0, 355, 559, 848, 1081, 1304, 1745, 1997, 2468, 3057, 3412, 3930, 4286, 4848, 5706, 6296, 6638, 7415, 7807, 8635, 9305, 10335, 11253, 12035, 12509, 13201, 13296, 13726, 14632, 14818]","[0, 170, 402, 529, 973, 1295, 1618, 1960, 2095, 2377, 2759, 3195, 3550, 4133, 4572, 5086, 5636, 5977, 6774, 7593, 8073, 8419, 8788, 9567, 10045, 10557, 11273, 11956, 12779, 13326]","[0, 170, 260, 471, 787, 927, 1027, 1248, 1657, 2015, 2251, 2462, 3056, 3361, 3745, 4248, 4710, 4950, 5173, 6122, 6291, 6477, 6822, 7217, 7672, 7998, 8201, 8522, 8804, 9239]","[0, 259, 400, 577, 770, 956, 1046, 1136, 1348, 1571, 1708, 2043, 2312, 2661, 2939, 3251, 3439, 3623, 4223, 5044, 5139, 5431, 5526, 5765, 6314, 6879, 7273, 7812, 8147, 8639]",18463,14818,13326,9239,8639,3417,-1315,-1374,778,-602,904,30,radiant
7523787713,78,41,76,105,110,"[229, 566, 805, 1289, 1604, 1778, 2081, 2334, 2598, 2932, 3398, 3901, 4355, 4449, 4715, 5260, 5913, 6311, 6814, 7443, 7952, 8118, 8801, 9323, 9597, 10335, 10875, 11734, 12632, 13134]","[168, 576, 824, 1310, 1552, 2062, 2616, 3070, 3593, 3909, 4188, 4619, 4942, 5236, 5616, 6024, 6496, 7071, 7398, 7912, 8502, 9190, 10101, 10563, 10995, 12172, 13223, 13945, 14993, 15465]","[300, 461, 840, 1156, 1448, 2000, 2259, 2682, 3091, 3510, 3978, 4305, 4740, 5139, 5566, 5796, 6228, 6731, 7096, 7675, 8039, 9042, 9412, 9876, 9970, 10609, 11405, 11778, 12283, 12838]","[193, 283, 420, 796, 886, 1072, 1532, 1693, 1938, 2028, 2212, 2302, 2450, 2556, 2675, 2981, 3116, 3578, 3723, 4040, 4766, 5188, 5549, 5927, 6096, 6706, 7387, 7779, 7950, 8668]","[461, 551, 641, 820, 910, 1000, 1348, 1748, 1838, 1984, 2210, 2554, 2974, 3323, 3589, 4324, 4654, 5090, 5504, 5973, 6339, 6679, 7309, 7776, 8031, 8689, 9755, 10260, 11641, 11995]",13134,15465,12838,8668,11995,10,120,129,128,51,"[245, 556, 1046, 1565, 1959, 2460, 2977, 3559, 4032, 4579, 5262, 5832, 6561, 7257, 7778, 8824, 9592, 10279, 10761, 11599, 12363, 12809, 13536, 14408, 15145, 15961, 16137, 17174, 18083, 19099]","[291, 580, 929, 1252, 1574, 1827, 2136, 2620, 3096, 3662, 4313, 4706, 5314, 6155, 6818, 7427, 8042, 8885, 9640, 10597, 11141, 12089, 12527, 13347, 14180, 14801, 15697, 16418, 17104, 17794]","[248, 549, 812, 1049, 1338, 1647, 1943, 2340, 2559, 2990, 3295, 3851, 4239, 4768, 5580, 6336, 7010, 7637, 7982, 8535, 8888, 9708, 10201, 10835, 11398, 11810, 12131, 12840, 13551, 13647]","[210, 325, 450, 580, 736, 874, 1058, 1193, 1283, 1556, 1695, 2075, 2387, 2717, 3203, 4185, 4739, 5063, 5911, 6523, 7176, 7547, 7824, 8600, 9324, 10126, 10782, 11141, 11354, 11753]","[210, 325, 415, 591, 711, 817, 1174, 1309, 1399, 1740, 1874, 2284, 2615, 3034, 3399, 3780, 4238, 4737, 5341, 5589, 6247, 6476, 6829, 7303, 8141, 8674, 9182, 9564, 10065, 10771]",19099,17794,13647,11753,10771,-5965,-2329,-809,-3085,1224,-10964,30,dire
7524037914,46,14,92,5,51,"[0, 206, 655, 1007, 1422, 1923, 2351, 2812, 3369, 3772, 4385, 4975, 5155, 5614, 6003, 6605, 7641, 8273, 8720, 9131, 9545, 10253, 11250, 11815, 12432, 13040, 13348, 14440, 15374, 16125]","[0, 218, 466, 678, 1140, 1676, 1964, 2217, 2656, 3121, 3304, 4429, 4940, 5589, 6420, 6769, 7088, 7856, 8578, 9040, 9513, 10232, 11169, 11798, 12345, 12772, 13420, 13780, 15177, 15354]","[0, 169, 464, 677, 1224, 1348, 1628, 1885, 2045, 2542, 2863, 3339, 3519, 4073, 4549, 5142, 5847, 6639, 7267, 7905, 8114, 8717, 9370, 9895, 10402, 10593, 11304, 11891, 13207, 14686]","[0, 130, 597, 743, 911, 1531, 1634, 1859, 2059, 2327, 2519, 3288, 3647, 3795, 4247, 4472, 4996, 5492, 5943, 6038, 6547, 7182, 7495, 7774, 7868, 8326, 10120, 10763, 11367, 12576]","[0, 130, 245, 412, 660, 750, 840, 1166, 1256, 1435, 1580, 1760, 1940, 2223, 2667, 2762, 3117, 3323, 3555, 3839, 4048, 4801, 5016, 5583, 6111, 6206, 7029, 7204, 7928, 8319]",16125,15354,14686,12576,8319,10,74,96,86,45,"[0, 210, 421, 775, 997, 1697, 1976, 2345, 2818, 3327, 3747, 3996, 4729, 5649, 6608, 7312, 8148, 8712, 9028, 9767, 10922, 11518, 12558, 13259, 14971, 16198, 16965, 18160, 19404, 19500]","[0, 210, 461, 791, 1122, 1338, 1667, 2080, 2456, 2920, 3350, 3695, 4303, 4791, 5624, 5964, 6803, 7658, 8249, 8793, 9608, 10671, 11540, 12015, 13514, 14506, 14916, 15747, 16811, 17592]","[0, 333, 574, 907, 1405, 1833, 2314, 2828, 3334, 3668, 4365, 4515, 4988, 5669, 6648, 7042, 7409, 8278, 8982, 9357, 9623, 10363, 10722, 10917, 11303, 12268, 12620, 13677, 14042, 14502]","[0, 210, 300, 450, 606, 831, 921, 1168, 1303, 1626, 1908, 1998, 2579, 3101, 3997, 4320, 4726, 5125, 5781, 5970, 6361, 7056, 7412, 7553, 8656, 9043, 9739, 10114, 10809, 10980]","[0, 210, 362, 709, 940, 1110, 1262, 1557, 1692, 1858, 2197, 2287, 2608, 3011, 3960, 4236, 4707, 4881, 5236, 5713, 7025, 7213, 7666, 7836, 9227, 9701, 10152, 10686, 10968, 11139]",19500,17592,14502,10980,11139,-3375,-2238,184,1596,-2820,-6653,30,dire
7524401509,13,10,138,30,100,"[0, 239, 415, 728, 818, 1088, 1300, 1644, 2175, 2557, 3052, 3738, 4271, 4786, 5548, 6110, 6680, 7288, 7621, 8169, 9685, 11411, 11577, 12344, 13047, 14170, 16053, 16938, 17522, 17854]","[0, 234, 523, 613, 1017, 1282, 1728, 2019, 2530, 2916, 3399, 3890, 4556, 5102, 5438, 5863, 6567, 7206, 7485, 8889, 9633, 9974, 10712, 11431, 12388, 13177, 14033, 14840, 15017, 15636]","[0, 338, 428, 565, 702, 837, 976, 1439, 1619, 1877, 2217, 3122, 3277, 3472, 3615, 3709, 4067, 4225, 4357, 4667, 5136, 5453, 6250, 6994, 7377, 7778, 8912, 9184, 10354, 10686]","[0, 205, 295, 385, 520, 728, 862, 952, 1181, 1330, 1500, 1798, 1979, 2176, 2319, 2430, 3334, 3492, 3586, 4233, 4385, 5435, 5820, 6558, 6757, 7156, 7899, 8257, 8668, 9075]","[0, 359, 567, 796, 1080, 1384, 1667, 2032, 2318, 2690, 3041, 3509, 4001, 4150, 4612, 5074, 5283, 5735, 5994, 6287, 6790, 7107, 7424, 7519, 8142, 8746, 9482, 10176, 10599, 11224]",17854,15636,10686,9075,11224,1,25,21,112,20,"[60, 308, 617, 973, 1441, 1682, 1932, 2216, 2564, 3253, 3725, 4428, 4983, 5690, 6254, 6719, 7783, 8712, 9511, 10152, 11513, 12799, 13099, 14139, 15065, 16329, 17442, 17537, 17970, 19225]","[328, 857, 1185, 1514, 1960, 2460, 3157, 3612, 3937, 4598, 5103, 5433, 6110, 6702, 7348, 7913, 9119, 9789, 10497, 11946, 12371, 13285, 13778, 14787, 15090, 15860, 16449, 17216, 18243, 20029]","[60, 306, 592, 1235, 1637, 1897, 2379, 2905, 3275, 3655, 3985, 4174, 5046, 5428, 5707, 6240, 6753, 7376, 8129, 8619, 9202, 10052, 10360, 11153, 11712, 12167, 12261, 12489, 12905, 13924]","[60, 269, 359, 449, 873, 963, 1102, 1240, 1449, 1687, 1860, 1987, 2410, 2622, 3171, 3390, 3900, 4074, 4433, 4846, 4977, 5515, 5609, 6030, 6338, 6982, 7076, 7171, 7648, 8797]","[0, 255, 345, 435, 606, 793, 983, 1481, 1571, 1735, 1871, 1961, 2337, 2477, 2626, 2845, 3196, 3370, 3600, 3829, 4003, 4098, 4341, 4602, 4781, 5164, 5306, 5482, 5898, 6302]",19225,20029,13924,8797,6302,-1371,-4393,-3238,278,4922,-3802,30,radiant
7525107118,41,100,74,56,20,"[0, 258, 541, 819, 1100, 1415, 1586, 1841, 2230, 2786, 3252, 4005, 4483, 5047, 5501, 5983, 6373, 7126, 7936, 8643, 9441, 10123, 10922, 11754, 12081, 12778, 13446, 14083, 14179, 15003]","[0, 521, 974, 1184, 1466, 1744, 2379, 2794, 3700, 4249, 4605, 5227, 5775, 6124, 6604, 7211, 7565, 7895, 8217, 8447, 9603, 10358, 11021, 11500, 12034, 12201, 12696, 13352, 13736, 14449]","[0, 295, 541, 839, 1229, 1550, 1812, 2130, 2509, 2694, 3059, 3197, 3782, 4135, 4340, 5018, 5581, 6255, 6510, 6956, 7750, 8252, 8841, 8944, 9271, 9996, 10447, 11354, 12662, 13437]","[0, 207, 740, 945, 1141, 1245, 1497, 1930, 2248, 2537, 3079, 3285, 3535, 3946, 4376, 4903, 5148, 5527, 6053, 6197, 6615, 6777, 7605, 7827, 8123, 8400, 9006, 9799, 10709, 11171]","[0, 130, 268, 358, 497, 721, 856, 988, 1283, 1468, 1848, 2149, 2322, 2861, 3077, 3680, 3918, 4172, 4427, 4786, 5139, 5292, 5723, 6015, 6285, 6549, 6643, 6984, 7368, 7545]",15003,14449,13437,11171,7545,48,61,21,88,66,"[0, 291, 470, 867, 1129, 1405, 1698, 2071, 2431, 2943, 3731, 4616, 5248, 5961, 6751, 7420, 8445, 9125, 10316, 11042, 11274, 12126, 13012, 13773, 15444, 16119, 17111, 18832, 19772, 19868]","[0, 316, 680, 1044, 1465, 1943, 2395, 2833, 3339, 3987, 4518, 5001, 5320, 5915, 6346, 6492, 7087, 7704, 8353, 9177, 10060, 10686, 11310, 11971, 13592, 14167, 15031, 15670, 15981, 16614]","[0, 245, 507, 832, 1491, 1897, 2307, 2695, 3223, 3523, 3821, 4465, 4889, 5439, 5625, 6220, 6905, 7230, 7656, 8387, 8743, 8918, 9143, 9641, 10920, 11797, 12056, 13270, 13852, 14178]","[0, 210, 334, 424, 605, 763, 1100, 1280, 1460, 1598, 2173, 2801, 3053, 3246, 3386, 3480, 3915, 4174, 4367, 4550, 4898, 5130, 5860, 6089, 7331, 7669, 7763, 8269, 8929, 9025]","[0, 210, 335, 472, 648, 771, 1017, 1235, 1499, 1666, 2091, 2419, 2599, 2748, 2981, 3197, 3752, 4132, 4489, 4859, 5155, 5250, 5529, 6093, 6596, 7021, 7365, 7875, 8313, 8621]",19868,16614,14178,9025,8621,-4865,-2165,-741,2146,-1076,-6701,30,dire
7525812113,35,22,69,83,26,"[0, 208, 388, 858, 1260, 1546, 2180, 2386, 2739, 3098, 3792, 4121, 4492, 4729, 5484, 5886, 6674, 7433, 8361, 9356, 9805, 9996, 10671, 11316, 11598, 12178, 12662, 13105, 13686, 14270]","[0, 326, 679, 1083, 1538, 2046, 2544, 2911, 3389, 3980, 4616, 4876, 5365, 5863, 6438, 7032, 7980, 8313, 8838, 9163, 9491, 9979, 10578, 11061, 11490, 11965, 12320, 12511, 12755, 13137]","[0, 274, 712, 1208, 1407, 1810, 2057, 2541, 3142, 3704, 4458, 4765, 5312, 5987, 6602, 7218, 7836, 8253, 8868, 9439, 9603, 10219, 10776, 11282, 11446, 11809, 12686, 13206, 13721, 14165]","[0, 170, 260, 396, 507, 641, 853, 989, 1513, 1980, 2160, 2250, 2340, 2990, 3198, 3467, 3861, 4176, 4361, 4456, 4550, 4645, 5065, 5553, 5647, 5869, 6201, 6296, 6484, 6580]","[0, 170, 351, 529, 619, 803, 1013, 1103, 1332, 1634, 1814, 1904, 2023, 2342, 2624, 2808, 3154, 3339, 3624, 3719, 3813, 4149, 4406, 4501, 4595, 4690, 4785, 4880, 5103, 5373]",14270,13137,14165,6580,5373,6,90,135,136,20,"[330, 577, 894, 1123, 1528, 1728, 2308, 2597, 2915, 3309, 3811, 4502, 5106, 5677, 6245, 6811, 7413, 8004, 8793, 9605, 10286, 10965, 11614, 12581, 13367, 14226, 15059, 16212, 17084, 17925]","[0, 290, 607, 1023, 1383, 1979, 2507, 3123, 3213, 3664, 4259, 4933, 5608, 6004, 6383, 7149, 8343, 9174, 9704, 10132, 10777, 11478, 12237, 12741, 13221, 13847, 14657, 15031, 15900, 16614]","[62, 343, 699, 898, 1185, 1517, 1855, 2670, 3117, 3455, 3688, 4544, 5009, 5769, 6426, 6952, 7767, 8314, 9004, 9503, 10645, 11181, 11398, 12066, 13143, 13911, 14397, 15733, 15978, 16534]","[62, 232, 533, 658, 748, 838, 1019, 1146, 1526, 1741, 2011, 2308, 2466, 3099, 3481, 3652, 4180, 4799, 5238, 5748, 6177, 6272, 6625, 6810, 7495, 8257, 8679, 9011, 9188, 9497]","[62, 276, 576, 666, 820, 957, 1141, 1608, 1742, 1922, 2204, 2534, 2624, 3071, 3195, 3407, 3635, 3793, 3976, 4297, 4726, 4821, 4988, 5173, 5721, 6136, 6356, 6686, 6863, 6959]",17925,16614,16534,9497,6959,-3655,-3477,-2369,-2917,-1586,-14004,30,dire
7525933503,109,65,137,121,26,"[334, 1033, 1391, 1824, 2211, 2689, 2964, 3317, 3676, 3925, 4922, 5089, 5829, 6394, 7270, 7853, 8805, 9435, 10147, 11291, 11958, 12770, 13369, 14458, 15396, 16300, 17530, 18494, 18678, 19798]","[258, 466, 771, 1021, 1233, 1719, 2014, 2596, 3110, 3468, 3958, 4465, 5636, 6260, 6632, 6938, 7489, 8667, 8761, 9859, 10228, 10977, 11071, 11548, 12565, 13080, 13365, 13667, 13763, 14380]","[170, 478, 709, 1051, 1228, 1690, 1780, 2371, 2778, 3301, 3775, 4368, 4670, 5443, 5869, 6073, 6351, 7361, 7574, 8295, 8822, 9206, 9300, 9395, 9888, 10199, 10951, 11703, 12282, 12624]","[213, 350, 651, 837, 927, 1141, 1231, 1519, 1609, 1893, 2303, 2393, 2629, 2862, 3053, 3185, 3456, 3925, 4044, 4674, 4769, 5255, 5349, 5470, 5852, 6047, 6645, 6847, 6943, 7525]","[170, 342, 583, 738, 866, 956, 1285, 1568, 1658, 1748, 2032, 2122, 2217, 2539, 2730, 2825, 3046, 3471, 3739, 4113, 4391, 4692, 4786, 4881, 5177, 5321, 6312, 6477, 6573, 6918]",19798,14380,12624,7525,6918,39,21,69,20,119,"[287, 609, 991, 1443, 2231, 2675, 3316, 3738, 4037, 4693, 5168, 5488, 6074, 6815, 7427, 8027, 8479, 9276, 9954, 11009, 12092, 12796, 13745, 14361, 15660, 16481, 16974, 17611, 19395, 19839]","[257, 620, 1291, 1658, 2097, 2378, 2880, 3166, 3663, 4354, 5316, 5876, 6609, 7124, 7723, 8310, 8803, 9519, 10012, 10677, 11638, 12285, 13084, 13604, 14489, 15526, 16148, 16619, 18034, 18487]","[280, 523, 850, 1291, 1572, 1837, 2430, 3101, 3595, 4317, 4723, 5224, 5932, 6597, 7519, 8114, 8828, 9694, 10271, 10610, 11108, 11696, 12365, 12868, 13675, 14981, 15304, 15676, 16653, 17351]","[170, 260, 427, 576, 905, 1234, 1589, 1811, 1981, 2336, 2906, 3584, 3823, 3983, 4354, 4628, 4726, 4896, 5053, 5367, 5793, 6035, 7117, 7726, 8150, 8484, 8825, 9273, 10062, 10323]","[170, 299, 389, 531, 821, 931, 1159, 1294, 1458, 2053, 2382, 2608, 2852, 3116, 3426, 3744, 3854, 4609, 4908, 5105, 5716, 5984, 6337, 6654, 7071, 7659, 8329, 8731, 9613, 9857]",19839,18487,17351,10323,9857,-41,-4107,-4727,-2798,-2939,-14612,30,dire
7526011301,25,41,129,66,26,"[287, 710, 995, 1404, 1774, 2106, 2763, 3753, 4153, 4711, 5207, 5740, 6527, 7710, 8359, 8697, 9311, 10101, 10905, 11952, 12461, 12730, 13575, 14727, 15693, 16684, 18313, 19508, 20473, 23034]","[208, 461, 749, 1036, 1423, 1825, 2214, 2636, 2990, 3517, 3851, 4580, 5079, 5496, 6201, 6644, 7265, 7963, 8642, 9505, 10194, 10758, 11255, 12457, 13285, 14064, 15158, 15963, 16485, 17545]","[206, 474, 756, 1169, 1457, 1980, 2386, 2831, 3192, 3460, 3920, 4310, 4952, 5368, 5814, 6097, 6435, 6832, 7079, 7620, 8142, 8380, 9062, 9667, 10402, 10669, 11789, 12552, 13011, 13946]","[170, 260, 350, 524, 782, 936, 1142, 1404, 1698, 2109, 2278, 2760, 3028, 3222, 3609, 4173, 4615, 4848, 5522, 6628, 7066, 7984, 8342, 9233, 9969, 10279, 10986, 11233, 11743, 12648]","[170, 260, 433, 569, 659, 749, 931, 1181, 1370, 1619, 1709, 2208, 2416, 2511, 2744, 3062, 3355, 3450, 3750, 4156, 4426, 4916, 5685, 6684, 7103, 7354, 8153, 8389, 8727, 9615]",23034,17545,13946,12648,9615,120,54,61,90,63,"[323, 523, 897, 1150, 1488, 1882, 2276, 2396, 3048, 3702, 4217, 5202, 5624, 6128, 7135, 7538, 8393, 9023, 9612, 9972, 10578, 11126, 11595, 12310, 12924, 13513, 14219, 14315, 14411, 14691]","[206, 447, 733, 1143, 1458, 1866, 2077, 2361, 2605, 3074, 3393, 4089, 4542, 5050, 5550, 6489, 7242, 7793, 8557, 9104, 9734, 9996, 10544, 11436, 11531, 12010, 12639, 12735, 13123, 13274]","[248, 411, 800, 1204, 1505, 1997, 2379, 2944, 3315, 3885, 4237, 4886, 5385, 5755, 6302, 6735, 7693, 8234, 8506, 8764, 8912, 9590, 9835, 10091, 10436, 11344, 12268, 12417, 12863, 13016]","[215, 342, 479, 655, 843, 995, 1355, 1567, 1750, 2205, 2433, 2755, 3135, 3284, 3415, 3808, 4026, 4426, 5470, 5692, 6003, 6259, 7091, 7409, 7504, 7828, 8410, 8632, 8943, 9469]","[170, 260, 350, 547, 727, 857, 1011, 1197, 1495, 1630, 1770, 2092, 2505, 2781, 3085, 3293, 3647, 3815, 4047, 4374, 4574, 5150, 5575, 6014, 6175, 6536, 7220, 7391, 7562, 7781]",14691,13274,13016,9469,7781,8343,4271,930,3179,1834,18557,30,radiant
7526050917,46,98,120,79,83,"[0, 170, 364, 454, 820, 1141, 1388, 1716, 2046, 2479, 2932, 3287, 3876, 4381, 5219, 6014, 7039, 7515, 8813, 9176, 9804, 10233, 11229, 11652, 12573, 13710, 14181, 14804, 16758, 17561]","[0, 170, 449, 693, 817, 1316, 1753, 2121, 2484, 3106, 3861, 4257, 4621, 5222, 6277, 6833, 7451, 8340, 8987, 9298, 10020, 10606, 11642, 12277, 12989, 13681, 14417, 15323, 15729, 16761]","[0, 298, 628, 1043, 1443, 1985, 2351, 2736, 3143, 3938, 4909, 5171, 5814, 6368, 6722, 7027, 7529, 8289, 8910, 9611, 9895, 10501, 11174, 11568, 11895, 12521, 12759, 13144, 13550, 14438]","[0, 170, 260, 397, 487, 577, 940, 1030, 1120, 1532, 2017, 2391, 2685, 2928, 3413, 3755, 3913, 4183, 4450, 4738, 4908, 5167, 5521, 5936, 6357, 6997, 7167, 7632, 8113, 8628]","[0, 170, 310, 434, 524, 659, 749, 887, 1154, 1289, 1698, 1827, 1917, 2016, 2288, 2383, 2699, 3217, 3755, 3978, 4073, 4257, 4492, 4587, 4681, 4920, 5051, 5236, 5636, 5965]",17561,16761,14438,8628,5965,48,21,96,65,85,"[0, 254, 598, 899, 1562, 1806, 2053, 2347, 2660, 3074, 3326, 3971, 4581, 5372, 6264, 6853, 7670, 8504, 10032, 11141, 12277, 13116, 14354, 15437, 15531, 16279, 17495, 19010, 21159, 22662]","[0, 204, 557, 844, 1259, 1621, 2072, 2493, 2989, 3161, 3827, 4715, 5254, 5949, 6765, 7337, 7783, 8663, 9556, 10198, 10714, 12010, 12658, 13865, 14472, 15005, 15732, 17097, 18736, 18832]","[0, 289, 559, 826, 1240, 1413, 2003, 2567, 3088, 3658, 3998, 4709, 5287, 6066, 6329, 6752, 7529, 7881, 8812, 9422, 9811, 10728, 11255, 12192, 12940, 13320, 13747, 14551, 15630, 15798]","[0, 170, 285, 802, 1062, 1222, 1434, 1758, 1992, 2439, 2745, 3280, 3723, 3979, 4467, 4562, 5335, 5593, 6375, 7162, 7676, 8139, 8378, 9426, 9716, 9946, 10334, 11278, 12234, 12446]","[0, 170, 285, 375, 553, 643, 885, 1199, 1334, 1481, 1918, 2413, 2604, 2907, 3417, 3512, 3670, 3936, 5263, 5810, 5905, 6274, 6513, 7470, 7564, 8190, 8403, 9277, 10227, 10440]",22662,18832,15798,12446,10440,-5101,-2071,-1360,-3818,-4475,-16825,30,dire
7526071203,54,74,96,101,83,"[0, 205, 492, 979, 1393, 1620, 2442, 2809, 3107, 3294, 3879, 4549, 5160, 5757, 6076, 6749, 7464, 8183, 9139, 9923, 10676, 11438, 11756, 11941, 12619, 13221, 13715, 15345, 16468, 17072]","[0, 175, 495, 788, 1164, 1415, 1865, 2320, 2899, 3206, 3699, 4092, 4533, 4926, 5403, 5843, 6260, 6431, 6745, 7628, 8263, 8910, 9075, 9523, 9868, 10516, 11129, 12868, 13610, 14696]","[0, 166, 349, 599, 847, 1060, 1333, 1606, 1696, 1951, 2311, 2578, 2865, 3307, 3800, 4145, 4602, 4796, 4997, 5786, 6314, 6408, 6748, 6950, 7154, 7405, 7862, 8456, 8552, 8865]","[0, 130, 220, 549, 639, 749, 1099, 1189, 1323, 1458, 1698, 2264, 2354, 2502, 2806, 2931, 3469, 3563, 3877, 4210, 4632, 4886, 5028, 5213, 5307, 5580, 5775, 6489, 7119, 7269]","[0, 164, 254, 393, 483, 619, 977, 1111, 1201, 1384, 1568, 1850, 1940, 2088, 2273, 2413, 2767, 2918, 3232, 3442, 3663, 3757, 3852, 4037, 4131, 4344, 4539, 5281, 5809, 5905]",17072,14696,8865,7269,5905,107,102,14,105,27,"[0, 293, 493, 834, 1330, 1689, 2339, 2858, 3538, 3928, 4393, 4939, 5416, 5698, 6406, 6931, 7173, 8023, 8938, 9478, 9949, 10656, 11099, 12111, 12499, 13475, 13994, 14225, 14810, 15279]","[0, 291, 614, 866, 1288, 1573, 1958, 2574, 3024, 3404, 3856, 4279, 4751, 5337, 5954, 6587, 6926, 7750, 8418, 9011, 9559, 10707, 11262, 11766, 12126, 12846, 13578, 13971, 14618, 15335]","[0, 210, 451, 616, 937, 1253, 1580, 1844, 2233, 2585, 2853, 3293, 3744, 4330, 4841, 5539, 6111, 6503, 7054, 7561, 8094, 8672, 8955, 9503, 9934, 10442, 11057, 11278, 11702, 12063]","[100, 310, 739, 829, 1002, 1254, 1402, 1582, 1909, 2126, 2419, 2604, 2804, 3044, 3335, 3622, 3940, 4328, 4891, 5151, 5294, 6011, 6329, 6917, 7146, 7618, 7928, 8558, 8955, 9207]","[0, 210, 404, 538, 668, 856, 1188, 1495, 1679, 1902, 2130, 2315, 2452, 2649, 3025, 3378, 3536, 3803, 4189, 4576, 4772, 5200, 5439, 5716, 6217, 6576, 6804, 7247, 7343, 7520]",15279,15335,12063,9207,7520,1793,-639,-3198,-1938,-1615,-5597,30,dire
7526305209,89,96,76,105,68,"[0, 204, 438, 756, 1089, 1559, 1923, 2254, 2719, 3326, 3853, 4252, 5169, 5822, 6517, 6879, 8164, 9182, 10186, 11124, 11730, 12723, 13738, 14594, 15391, 15972, 16689, 18503, 19954, 20706]","[0, 335, 554, 907, 1285, 1572, 2007, 2337, 2924, 3481, 3680, 4179, 4597, 5212, 5532, 6312, 6742, 7135, 7632, 8419, 9000, 9095, 9929, 10458, 10734, 11054, 11418, 12151, 12898, 13296]","[0, 242, 534, 831, 1175, 1494, 1711, 1919, 2339, 2846, 3215, 3711, 3853, 4507, 5004, 5540, 6317, 6499, 6891, 7235, 8157, 8536, 9253, 9529, 10153, 10473, 10568, 10863, 11543, 11952]","[0, 170, 260, 691, 826, 963, 1101, 1428, 1636, 1816, 1906, 2050, 2222, 2416, 2513, 2779, 3421, 3536, 3771, 4314, 4766, 4936, 5178, 5789, 6334, 6950, 7281, 7540, 8270, 8748]","[0, 170, 260, 399, 489, 656, 934, 1215, 1350, 1530, 1649, 1895, 2114, 2312, 2407, 2823, 3194, 3294, 3477, 3849, 4262, 4357, 4616, 4970, 5246, 5819, 5950, 6454, 6806, 7037]",20706,13296,11952,8748,7037,41,43,106,26,110,"[0, 170, 384, 667, 961, 1361, 1779, 2141, 2404, 2591, 3103, 3589, 4051, 4488, 5142, 5693, 6799, 7116, 7651, 8130, 8719, 8978, 9672, 10196, 10406, 11219, 11314, 12535, 13468, 14245]","[0, 242, 578, 895, 1224, 1557, 1870, 2402, 2819, 3228, 3780, 4546, 4989, 5613, 6202, 6795, 7402, 8036, 8454, 9208, 9544, 10852, 11534, 11628, 11894, 12646, 13390, 14705, 15195, 15838]","[0, 325, 636, 886, 1221, 1625, 1940, 2509, 2806, 3271, 3536, 3979, 4945, 5313, 5831, 6177, 7246, 8011, 8812, 9249, 9433, 9901, 10606, 11246, 11511, 11923, 12755, 13617, 14115, 14292]","[0, 174, 266, 360, 542, 638, 996, 1243, 1345, 1575, 1710, 2140, 2498, 2701, 2982, 3178, 3879, 4113, 4256, 4510, 4734, 4999, 5493, 5871, 6069, 6410, 6747, 7744, 8077, 8329]","[0, 170, 260, 350, 498, 607, 955, 1351, 1441, 1579, 1763, 2167, 2442, 2842, 3444, 3609, 4202, 4679, 4820, 5207, 5371, 6083, 6635, 6945, 7040, 7396, 7650, 8118, 8376, 8613]",14245,15838,14292,8329,8613,6461,-2542,-2340,419,-1576,422,30,radiant
7526538514,82,56,14,119,110,"[0, 280, 524, 840, 1408, 1763, 2456, 3161, 3643, 4149, 4805, 5415, 6125, 6765, 7991, 8655, 9806, 10404, 11116, 12341, 13415, 14153, 14955, 15833, 16905, 18073, 18876, 20495, 21213, 22686]","[0, 289, 612, 992, 1274, 1804, 2175, 2594, 3112, 3560, 3929, 4251, 4981, 5350, 5753, 6343, 7116, 7477, 7809, 8223, 8724, 9701, 10702, 11331, 12289, 13553, 14249, 15406, 16597, 18972]","[0, 821, 1072, 1489, 1805, 2368, 2975, 3319, 3830, 4055, 4682, 5268, 6233, 6751, 7257, 7725, 8146, 8748, 9179, 9549, 10186, 10655, 11086, 11468, 12165, 13281, 13600, 14186, 14704, 15856]","[0, 298, 437, 802, 967, 1469, 1685, 1866, 2040, 2209, 2585, 2756, 3222, 3441, 4344, 4474, 5120, 5594, 6301, 6464, 7091, 7476, 7760, 7913, 8634, 9404, 9534, 10175, 10510, 11537]","[0, 170, 260, 350, 570, 799, 991, 1081, 1171, 1306, 1667, 2105, 2538, 2896, 3457, 3621, 3942, 4172, 4601, 4919, 5490, 5822, 6413, 6705, 7466, 7908, 8114, 8449, 9091, 10392]",22686,18972,15856,11537,10392,34,38,21,27,45,"[0, 238, 517, 1057, 1433, 1887, 2253, 2343, 3379, 3868, 4656, 5212, 5685, 6514, 7005, 7147, 7886, 8327, 9004, 9664, 10458, 10834, 11538, 12488, 12927, 13021, 13923, 14448, 14544, 15504]","[0, 285, 520, 941, 1383, 1744, 2077, 2315, 2962, 3394, 3757, 4219, 4971, 5709, 6091, 6366, 6830, 7218, 7637, 7796, 8368, 8813, 9683, 10216, 10564, 10658, 11378, 11681, 12234, 13001]","[0, 238, 519, 764, 1599, 1761, 2089, 2629, 3315, 3810, 4242, 5006, 5397, 5746, 5969, 6464, 7111, 7755, 8081, 8521, 9093, 9411, 10156, 10782, 10928, 11235, 11717, 11981, 12421, 12517]","[0, 170, 310, 437, 788, 968, 1058, 1292, 1749, 1884, 2217, 2454, 2634, 2902, 3034, 3395, 3629, 3935, 4186, 4400, 4495, 4953, 5047, 5142, 5366, 5776, 6051, 6336, 6432, 6528]","[0, 170, 260, 416, 629, 719, 809, 899, 1246, 1401, 1577, 1762, 2123, 2442, 2665, 2809, 3123, 3498, 3748, 3923, 4433, 4676, 4944, 5039, 5134, 5254, 5476, 5741, 5931, 6027]",15504,13001,12517,6528,6027,7182,5971,3339,5009,4365,25866,30,radiant
7526888103,8,106,137,26,20,"[218, 581, 1168, 1351, 1836, 2129, 2536, 2913, 3486, 4129, 4608, 5224, 5726, 6708, 7726, 8811, 9946, 10592, 11554, 12253, 13542, 15168, 16293, 17350, 18625, 19834, 20980, 22335, 23760, 25228]","[284, 685, 936, 1134, 1443, 1775, 2131, 2603, 3285, 3561, 3851, 4273, 4710, 5059, 5446, 5682, 6258, 6825, 7081, 7685, 8397, 9672, 10644, 11319, 12564, 13379, 13740, 14370, 14754, 15651]","[170, 406, 725, 1088, 1676, 2289, 2678, 3135, 3486, 4120, 4781, 5235, 5789, 6388, 6587, 6936, 7356, 7605, 8135, 8485, 8921, 9890, 10309, 10862, 11598, 12404, 12499, 12896, 13332, 14008]","[219, 332, 467, 653, 1145, 1372, 1496, 1638, 1935, 2197, 2311, 2984, 3431, 3670, 4029, 4289, 4468, 4765, 5240, 5634, 6116, 6615, 6892, 7144, 7775, 8186, 8281, 8377, 8563, 9739]","[170, 260, 455, 593, 723, 904, 1043, 1177, 1339, 1495, 1585, 1813, 2042, 2226, 2644, 3061, 3156, 3506, 3856, 4031, 4646, 5067, 5688, 5893, 6466, 7416, 7511, 7817, 8003, 8454]",25228,15651,14008,9739,8454,95,97,23,110,86,"[247, 538, 865, 1217, 1706, 1979, 2200, 2468, 2799, 3530, 3906, 4518, 5090, 5690, 6625, 7494, 8296, 8996, 9985, 10555, 10744, 10913, 11707, 12800, 13346, 14194, 15514, 15781, 16334, 17027]","[207, 514, 685, 1112, 1370, 1719, 2024, 2250, 2539, 2973, 3460, 3814, 4098, 4696, 5211, 6018, 6655, 7352, 7801, 8370, 8834, 9179, 9804, 10084, 10179, 10455, 11129, 11871, 12348, 12599]","[255, 621, 993, 1233, 1887, 2535, 3167, 3813, 4166, 4958, 5283, 5648, 5936, 6231, 6640, 6918, 7584, 7788, 8287, 8827, 9016, 9110, 9412, 9882, 10199, 10846, 11640, 11949, 12045, 12459]","[170, 277, 412, 548, 678, 813, 1305, 1395, 1485, 1620, 2046, 2309, 2404, 2725, 3003, 3496, 3800, 3894, 4474, 4665, 4919, 5296, 5391, 5751, 5846, 6049, 7002, 7506, 7651, 7994]","[170, 260, 350, 578, 970, 1105, 1285, 1435, 1563, 2129, 2470, 2677, 2926, 3043, 3295, 3699, 4195, 4366, 4859, 5010, 5199, 5293, 5538, 5705, 5856, 5950, 6500, 6791, 7013, 7264]",17027,12599,12459,7994,7264,8201,3052,1549,1745,1190,15737,30,radiant
7527329500,46,102,21,26,14,"[599, 1041, 1555, 2028, 2547, 2926, 3661, 4162, 4874, 5229, 6112, 6854, 7128, 8038, 8809, 9484, 9974, 10480, 11308, 12092, 12961, 13759, 14710, 15365, 15709, 16455, 17081, 17763, 18181, 19535]","[484, 776, 1057, 1338, 1780, 2347, 2603, 3033, 3922, 4501, 4902, 5508, 5803, 6647, 7251, 7812, 8733, 9394, 9488, 10370, 11216, 11840, 12357, 12763, 13352, 13840, 14546, 14801, 15429, 17236]","[760, 1041, 1305, 1991, 2437, 2942, 3393, 3925, 4563, 4751, 5345, 6114, 6679, 7393, 8150, 8819, 9382, 10289, 11222, 11632, 11837, 11951, 12608, 13389, 13532, 14066, 14752, 15046, 15311, 16188]","[307, 397, 613, 783, 1094, 1229, 1337, 1496, 1631, 1921, 2510, 2860, 2955, 3310, 3730, 4371, 4619, 5472, 5566, 5868, 6073, 6167, 6854, 7118, 7213, 7766, 8024, 8120, 8347, 9228]","[1111, 1311, 1401, 1616, 1770, 1905, 2011, 2364, 2590, 2815, 3145, 3397, 3540, 3991, 4447, 4875, 5123, 5338, 5691, 5993, 6198, 6292, 6660, 7061, 7156, 7596, 7854, 7950, 8192, 8623]",19535,17236,16188,9228,8623,95,13,97,20,86,"[628, 873, 1263, 1626, 1966, 2232, 2653, 3124, 3736, 4041, 4638, 5252, 5721, 6193, 6860, 7557, 7987, 8787, 9202, 9895, 10602, 11992, 12555, 13277, 15119, 15929, 17267, 19163, 20023, 21519]","[588, 959, 1335, 1743, 1923, 2337, 2632, 2886, 3654, 4148, 4793, 5317, 5698, 5834, 6370, 6806, 6929, 7790, 7884, 8190, 8762, 9575, 10196, 10485, 11544, 12290, 12804, 14217, 14961, 15490]","[539, 740, 1148, 1332, 1741, 1927, 2098, 2390, 3074, 3250, 3621, 4122, 4391, 4650, 5409, 5548, 5643, 6184, 6278, 6693, 7259, 8055, 8150, 8747, 10093, 10947, 11213, 11494, 11846, 12527]","[470, 605, 735, 957, 1187, 1370, 1560, 1734, 2182, 2272, 2647, 2836, 2931, 3108, 3265, 3406, 3671, 4388, 4630, 4831, 4998, 5577, 5954, 6158, 7022, 7256, 7723, 9036, 9222, 9769]","[567, 657, 994, 1372, 1509, 1599, 1689, 1824, 2040, 2410, 2698, 2847, 2965, 3292, 3518, 3738, 3833, 5386, 5510, 5766, 6169, 6388, 6640, 7239, 8103, 8287, 8803, 9542, 9860, 10183]",21519,15490,12527,9769,10183,-1984,1746,3661,-541,-1560,1322,30,radiant
7527512604,10,84,17,27,5,"[0, 282, 657, 897, 1095, 1344, 1645, 1888, 2305, 3172, 3570, 4413, 4643, 5489, 6087, 6554, 6975, 7688, 8519, 9334, 10467, 11542, 12533, 14006, 15074, 15575, 16795, 16890, 17270, 17854]","[0, 280, 642, 1051, 1460, 1825, 2057, 2377, 2626, 3230, 3939, 4735, 5305, 6120, 6869, 7784, 7981, 8930, 10044, 10859, 11652, 12044, 12902, 13197, 14010, 14673, 16194, 16375, 17082, 17381]","[0, 315, 574, 1075, 1769, 2051, 2315, 2665, 3195, 3719, 4177, 4627, 4995, 5699, 6424, 7165, 7307, 8688, 9059, 9811, 10350, 11592, 12025, 13027, 13341, 13865, 14650, 14793, 14889, 14985]","[0, 218, 308, 444, 724, 854, 1101, 1408, 1873, 2501, 2681, 3159, 3249, 3479, 3829, 4288, 4695, 5321, 5727, 6060, 6464, 7226, 7602, 7928, 8404, 9153, 9980, 10324, 11223, 11616]","[0, 170, 260, 366, 496, 626, 764, 963, 1053, 1491, 1715, 2008, 2187, 2378, 2673, 3061, 3342, 3841, 4076, 4355, 4540, 4817, 4959, 5384, 5479, 5758, 6420, 6562, 6868, 7242]",17854,17381,14985,11616,7242,38,1,106,37,30,"[0, 323, 721, 1059, 1351, 1598, 1914, 2656, 3023, 3184, 3602, 3994, 4578, 5015, 5400, 5699, 6257, 6456, 6797, 7283, 7544, 8244, 8941, 10338, 10767, 11980, 13005, 14972, 15698, 17398]","[0, 329, 601, 925, 1212, 1509, 1933, 2265, 2552, 2959, 3450, 3693, 4037, 4338, 4904, 5165, 5438, 5913, 6359, 7130, 7727, 8758, 9442, 10534, 11440, 12512, 12696, 14608, 15916, 16584]","[0, 318, 725, 928, 1370, 1648, 2099, 2434, 2882, 2972, 3193, 4055, 4570, 4925, 5142, 6075, 6515, 7083, 7358, 8142, 8634, 9524, 9618, 10899, 11512, 12003, 12677, 13825, 14861, 16979]","[0, 170, 260, 350, 440, 620, 759, 894, 1032, 1171, 1307, 2009, 2406, 3057, 3233, 4430, 5133, 5325, 5767, 6183, 6322, 7550, 7644, 8038, 8133, 8982, 9367, 11268, 11605, 12098]","[0, 170, 634, 724, 814, 951, 1086, 1323, 1458, 1596, 1732, 1822, 2256, 2400, 2495, 2674, 3700, 3957, 4052, 4646, 4741, 5026, 5120, 5406, 5550, 6041, 6225, 7464, 7890, 8883]",17398,16584,16979,12098,8883,456,797,-1994,-482,-1641,-2864,30,dire
7527537810,53,49,23,79,136,"[239, 671, 1124, 1355, 1481, 2019, 2455, 3009, 3310, 3728, 4021, 4389, 5309, 5926, 6396, 7185, 7757, 8657, 9453, 10132, 11381, 12083, 13207, 14401, 15257, 16665, 18354, 19549, 19924, 21898]","[244, 527, 858, 1259, 1516, 2085, 2762, 3408, 3834, 4459, 4935, 5275, 5755, 6013, 6627, 7731, 7999, 8516, 8766, 9304, 9804, 10521, 11189, 11897, 12259, 13276, 14247, 15245, 15957, 17022]","[291, 961, 1241, 1540, 1877, 2409, 2825, 3276, 3733, 4546, 5080, 5701, 6315, 7146, 7597, 8478, 8766, 9377, 9969, 10778, 11210, 11642, 12096, 12530, 13188, 13509, 14041, 14702, 14798, 15544]","[170, 327, 434, 764, 854, 1070, 1303, 1528, 1698, 2013, 2103, 2473, 3083, 3884, 4150, 4609, 4794, 4889, 5046, 5315, 5410, 5649, 5857, 6336, 6503, 6827, 7747, 7924, 8020, 8660]","[170, 326, 465, 623, 796, 1043, 1168, 1546, 1862, 2125, 2439, 2642, 2862, 3234, 3585, 4214, 4487, 4613, 4943, 5118, 5213, 5452, 5873, 6158, 6351, 6674, 7408, 7660, 7831, 8152]",21898,17022,15544,8660,8152,25,106,129,21,102,"[204, 447, 666, 1012, 1291, 1663, 1982, 2490, 2665, 3201, 3850, 4261, 4759, 5551, 6183, 6992, 7423, 8333, 9122, 9909, 10852, 11330, 12114, 13153, 14367, 15443, 15538, 16085, 17235, 17800]","[242, 478, 814, 1063, 1349, 1633, 2142, 2627, 3200, 3510, 3980, 4662, 4986, 5339, 5860, 6980, 7986, 8672, 9153, 9647, 9832, 10599, 11222, 11905, 12506, 13471, 13832, 14579, 14917, 15136]","[253, 497, 757, 1326, 1600, 2095, 2519, 2792, 3501, 4093, 4545, 5005, 5398, 5631, 5993, 6844, 7644, 8198, 8924, 9672, 9902, 10781, 10921, 11016, 11586, 12202, 12297, 13218, 13508, 13727]","[170, 260, 350, 484, 889, 1108, 1292, 1715, 2288, 2561, 2800, 3007, 3340, 3542, 3658, 4381, 4958, 5264, 5771, 6238, 6423, 6653, 6843, 7024, 7615, 8009, 8104, 8281, 8574, 8670]","[170, 260, 405, 509, 686, 821, 956, 1176, 1268, 1487, 1679, 2004, 2099, 2248, 2349, 2891, 3270, 3677, 4092, 4233, 4462, 4692, 5021, 5116, 5512, 5925, 6020, 6246, 6452, 6724]",17800,15136,13727,8670,6724,4098,1886,1817,-10,1428,9219,30,radiant
7528042208,28,71,38,47,121,"[0, 279, 563, 880, 1201, 1494, 1903, 2434, 2886, 3355, 3907, 4239, 4957, 5810, 6234, 6523, 7068, 7457, 8097, 8919, 9418, 10900, 10995, 11591, 11686, 12132, 12312, 12406, 12612, 13459]","[0, 251, 606, 867, 1066, 1316, 1911, 2136, 2550, 3030, 3432, 3961, 4398, 5008, 5411, 6048, 6603, 6858, 7248, 8133, 8957, 9507, 9602, 10474, 11060, 11394, 11905, 11999, 12095, 12904]","[0, 334, 606, 894, 1442, 2016, 2230, 2641, 2852, 3469, 4266, 4786, 5049, 5395, 5758, 6504, 6743, 6943, 7432, 7845, 8109, 8833, 9358, 9726, 9874, 10121, 10500, 10825, 11064, 11241]","[0, 517, 654, 784, 1027, 1163, 1298, 1951, 2322, 2640, 2865, 3509, 3652, 4124, 5158, 5484, 5839, 6039, 6233, 6613, 6707, 7266, 7580, 7791, 7922, 8381, 8643, 8773, 8961, 9268]","[0, 251, 341, 471, 624, 748, 1008, 1381, 1510, 1780, 2041, 2665, 2837, 3123, 3446, 3735, 4010, 4210, 4305, 4400, 4494, 4589, 4684, 4947, 5042, 5408, 5503, 5597, 5693, 5870]",13459,12904,11241,9268,5870,59,74,62,23,119,"[0, 481, 687, 1029, 1395, 1559, 1717, 1922, 2373, 2848, 3426, 3848, 4631, 5178, 5629, 5893, 6909, 8595, 9208, 10192, 11184, 12439, 12876, 13503, 14389, 15218, 16320, 17804, 18314, 18808]","[0, 747, 982, 1398, 1722, 2007, 2462, 2892, 3281, 3551, 4116, 4288, 5213, 5540, 5732, 6743, 7366, 8579, 9160, 9513, 10648, 11128, 12727, 13058, 13904, 14720, 15501, 16930, 18122, 19104]","[100, 710, 812, 1047, 1304, 1414, 1523, 1733, 2028, 2477, 2911, 3102, 3461, 3753, 4322, 5204, 5730, 7061, 7523, 8169, 8884, 9534, 10643, 10820, 11468, 12163, 12905, 14819, 15409, 16198]","[0, 566, 816, 1482, 1728, 1903, 2310, 2831, 3405, 3811, 4560, 4781, 5243, 5824, 6153, 6403, 6992, 8309, 8868, 9481, 10263, 10688, 10927, 11774, 12778, 13864, 14539, 15331, 15890, 16175]","[0, 334, 424, 677, 767, 879, 1267, 1357, 1529, 1719, 2124, 2297, 2948, 3337, 3766, 4246, 4504, 4694, 5258, 5666, 6633, 7139, 7704, 7798, 8851, 9128, 9779, 10827, 11287, 12298]",18808,19104,16198,16175,12298,-5349,-6200,-4957,-6907,-6428,-29841,30,dire
7528383718,46,32,98,45,20,"[0, 313, 608, 859, 1165, 1567, 1856, 2155, 2542, 2808, 3265, 3783, 4422, 5390, 6041, 6573, 7471, 8687, 9659, 10552, 11325, 11562, 12119, 12890, 14243, 14986, 15623, 15852, 16029, 16590]","[0, 645, 938, 1229, 1559, 1891, 2504, 3057, 3791, 4092, 4638, 4854, 5117, 5821, 6323, 6525, 7483, 7578, 7673, 7992, 9457, 10000, 10835, 11446, 11929, 12801, 13371, 13600, 14298, 15114]","[0, 244, 597, 1062, 1330, 1801, 2089, 2434, 2866, 3072, 3902, 4542, 4722, 5407, 6033, 6384, 7133, 7434, 8073, 8689, 8980, 9234, 10095, 10636, 11781, 13021, 13866, 14386, 14922, 15400]","[0, 772, 923, 1061, 1151, 1281, 1371, 1586, 1765, 1855, 2310, 2454, 2834, 3357, 3685, 3888, 4281, 4425, 4607, 4701, 5006, 5465, 6198, 6474, 7074, 7553, 7910, 8147, 8554, 8815]","[0, 302, 392, 539, 712, 893, 1113, 1203, 1642, 1814, 1949, 2262, 2442, 2735, 2958, 3276, 3853, 4350, 4800, 4923, 5103, 5274, 5582, 6079, 6843, 7407, 7670, 7899, 8223, 8319]",16590,15114,15400,8815,8319,25,13,60,53,87,"[0, 437, 798, 1158, 1572, 1942, 2361, 2875, 3180, 3922, 4445, 4835, 5627, 5935, 6598, 7555, 7936, 8421, 9201, 10174, 10907, 11868, 12752, 13574, 14526, 14713, 15345, 16278, 17337, 17712]","[0, 249, 457, 948, 1316, 1569, 2203, 2840, 3390, 3892, 4203, 4540, 5376, 5762, 6480, 6885, 7322, 8757, 9219, 10120, 10541, 11577, 12612, 13427, 13908, 14003, 15153, 15893, 16620, 17447]","[0, 392, 553, 975, 1365, 1613, 1903, 2729, 3229, 3913, 4532, 4902, 5617, 6206, 6509, 7500, 8124, 8433, 8786, 9284, 9868, 10202, 10508, 10746, 10968, 11480, 11990, 13336, 13904, 14418]","[0, 321, 514, 867, 957, 1082, 1295, 1871, 2006, 2704, 3540, 4194, 5140, 5235, 5445, 6080, 6657, 7060, 7282, 8138, 8854, 9258, 9667, 9886, 10419, 10514, 10690, 11986, 12769, 12999]","[0, 454, 544, 784, 874, 1003, 1216, 1487, 1622, 1965, 2189, 2366, 2868, 2963, 3058, 3916, 4260, 5049, 5144, 5847, 6440, 6581, 6953, 7594, 7940, 8035, 8330, 9444, 9757, 9892]",17712,17447,14418,12999,9892,-1122,-2333,982,-4184,-1573,-8230,30,dire
7528465311,71,104,91,20,86,"[0, 264, 505, 631, 914, 1264, 1510, 1813, 2733, 2929, 3675, 4248, 4995, 5668, 6169, 6746, 7234, 7979, 8965, 9556, 9957, 10544, 11360, 11770, 12451, 12925, 13293, 13673, 14618, 15009]","[0, 300, 612, 1037, 1410, 1953, 2534, 3041, 3482, 4043, 4562, 5125, 6275, 6845, 7320, 7503, 7975, 8528, 9493, 10050, 11088, 11480, 12237, 12331, 12436, 12997, 13263, 14013, 15467, 15563]","[0, 229, 404, 532, 736, 1182, 1317, 1771, 2152, 2408, 2759, 3330, 3698, 4241, 4778, 4992, 5335, 5716, 6109, 6626, 7173, 7910, 8401, 8889, 9059, 9627, 10154, 11007, 11613, 12141]","[0, 316, 724, 1096, 1507, 1833, 2165, 2504, 2953, 3394, 3904, 4473, 4792, 5223, 6039, 6333, 7047, 7653, 8291, 8744, 8965, 9204, 9888, 9982, 10077, 10570, 11037, 11343, 12125, 12754]","[0, 569, 694, 931, 1069, 1286, 1644, 2295, 2385, 2573, 3190, 3442, 4148, 4646, 4831, 5006, 5404, 5653, 6048, 6352, 7460, 7647, 7960, 8054, 8329, 8424, 8680, 8775, 9160, 9256]",15009,15563,12141,12754,9256,18,106,96,101,121,"[0, 231, 620, 919, 1173, 1824, 1914, 2506, 3087, 3618, 4403, 4884, 5652, 5747, 6169, 6756, 7869, 8773, 9379, 10253, 10996, 11527, 12055, 12736, 14224, 15200, 16823, 17339, 18103, 18850]","[0, 356, 570, 867, 1240, 1557, 1877, 2275, 2565, 2830, 3249, 3541, 3849, 4224, 4716, 4810, 5091, 5473, 6116, 6559, 7690, 7967, 9029, 9195, 10159, 10660, 11473, 12054, 12770, 13586]","[0, 230, 438, 956, 1413, 1616, 1939, 2436, 2889, 2979, 3069, 3594, 4013, 4322, 4881, 5425, 6030, 6516, 6859, 7434, 7842, 8292, 9494, 10023, 11228, 11564, 12486, 13126, 13955, 14218]","[0, 272, 362, 604, 795, 885, 975, 1200, 1449, 1584, 1674, 1819, 2041, 2173, 2422, 2894, 3339, 3686, 3819, 4507, 5033, 5211, 6321, 6548, 7261, 7442, 8510, 8605, 8760, 9045]","[0, 405, 495, 585, 675, 902, 992, 1126, 1261, 1351, 1441, 1721, 1943, 2098, 2259, 2528, 2793, 3523, 3673, 4495, 4920, 5195, 7000, 7166, 7825, 8010, 8671, 8805, 9791, 9968]",18850,13586,14218,9045,9968,-3841,1977,-2077,3709,-712,-944,30,dire
7528616403,38,104,114,63,100,"[0, 278, 521, 686, 860, 1305, 1971, 2851, 3365, 3997, 4450, 5193, 6071, 6933, 7774, 8446, 9983, 10573, 11252, 13157, 14058, 14747, 15762, 16211, 16964, 18587, 18981, 19076, 20773, 20994]","[0, 210, 545, 882, 1144, 1307, 1860, 2242, 2565, 2811, 3313, 3955, 4416, 4898, 5311, 6005, 6769, 7141, 7982, 8771, 9559, 10404, 10680, 11400, 11904, 13157, 14036, 14498, 15056, 15770]","[0, 416, 775, 1160, 1528, 1911, 2366, 2879, 3543, 4354, 4824, 5741, 6498, 6946, 7691, 7786, 8292, 8855, 9447, 10137, 10933, 11028, 11672, 11857, 12320, 13084, 13665, 14439, 14616, 14996]","[0, 254, 738, 1101, 1535, 1669, 1803, 1893, 2028, 2235, 2418, 2785, 3138, 3385, 3655, 3789, 4672, 5017, 5212, 5953, 6321, 6548, 7164, 7259, 7584, 8386, 8840, 9133, 9750, 10230]","[0, 210, 320, 410, 500, 590, 933, 1237, 1494, 1640, 1897, 2290, 2748, 3180, 3480, 3732, 4736, 5261, 5502, 6070, 6617, 6712, 7089, 7218, 7593, 7911, 8133, 8327, 8504, 8600]",20994,15770,14996,10230,8600,35,81,28,86,26,"[0, 291, 582, 843, 1243, 1692, 2344, 2738, 3241, 3877, 4419, 4966, 5554, 6321, 7127, 7472, 8425, 8826, 9764, 9922, 10402, 11911, 12935, 14750, 15671, 16445, 17844, 19111, 20228, 20527]","[0, 214, 458, 658, 942, 1106, 1309, 1537, 1957, 2242, 2728, 3136, 3522, 4007, 4626, 5017, 5652, 5912, 6611, 6866, 7285, 7869, 9154, 9935, 10471, 11252, 12882, 14133, 14793, 16655]","[0, 130, 387, 776, 1028, 1435, 1761, 2179, 2584, 3298, 3559, 3964, 4440, 4907, 5374, 6192, 7112, 7631, 8389, 8675, 9028, 10275, 11649, 12137, 12588, 12824, 13454, 14037, 14500, 15660]","[0, 168, 542, 978, 1306, 1573, 1697, 1958, 2142, 2669, 2891, 3123, 3888, 4160, 4386, 5122, 5553, 5711, 5850, 6035, 6179, 7146, 7836, 8836, 9254, 9596, 10443, 11212, 11389, 13369]","[0, 167, 265, 403, 540, 630, 1102, 1282, 1417, 1557, 1647, 2006, 2274, 2423, 2671, 2766, 3084, 3437, 3531, 3689, 3784, 4029, 4514, 5251, 5392, 5791, 6442, 6950, 7465, 8253]",20527,16655,15660,13369,8253,467,-885,-664,-3139,347,-3874,30,dire
7529139904,114,80,129,128,64,"[0, 245, 590, 870, 1155, 1744, 2240, 2702, 3175, 3391, 3757, 4434, 5186, 5551, 6257, 6760, 7374, 8116, 8615, 9325, 9737, 10397, 10865, 10959, 11519, 12070, 12515, 13109, 14090, 14837]","[2, 320, 733, 1139, 1585, 2137, 2784, 3594, 4031, 4403, 4974, 5368, 5709, 6564, 7428, 7894, 8249, 9073, 9730, 10475, 10993, 11834, 12266, 13109, 13663, 14334, 14670, 15715, 16224, 16704]","[0, 245, 567, 829, 1011, 1383, 1994, 2506, 3061, 3441, 3952, 4865, 5329, 6027, 6627, 7346, 8019, 8929, 9216, 9504, 9864, 10345, 11005, 11605, 12284, 12976, 13324, 13499, 14157, 14898]","[0, 247, 374, 472, 648, 1006, 1134, 1642, 1744, 2035, 2499, 2892, 3439, 3795, 4142, 4360, 4558, 5332, 6083, 6223, 6454, 6902, 7293, 8130, 8800, 9118, 9533, 9734, 10119, 10559]","[0, 245, 335, 425, 556, 694, 861, 1161, 1293, 1383, 1891, 2554, 2829, 3215, 3488, 3788, 3973, 4178, 4497, 4800, 4997, 5392, 5869, 6454, 6944, 7541, 7683, 7882, 8229, 8591]",14837,16704,14898,10559,8591,89,13,29,72,62,"[0, 170, 547, 795, 1438, 1930, 2229, 2634, 3047, 3308, 4125, 5138, 5643, 6375, 6829, 7629, 8592, 9087, 9952, 11049, 11576, 12333, 13322, 14057, 14745, 15460, 16264, 17053, 18117, 18416]","[0, 170, 443, 638, 851, 1021, 1272, 1528, 1900, 2351, 2610, 2750, 3451, 3802, 3993, 4560, 5459, 5995, 7358, 8077, 8742, 9125, 9975, 11103, 11779, 12483, 13015, 13643, 14102, 15085]","[0, 253, 378, 746, 963, 1180, 1270, 1654, 2041, 2587, 3229, 3899, 4457, 5109, 5543, 6182, 6759, 7217, 8165, 8881, 9539, 9801, 10544, 10894, 11235, 11621, 11997, 12582, 12950, 13582]","[0, 170, 260, 350, 480, 570, 660, 795, 1097, 1277, 1502, 1642, 1931, 2073, 2253, 2471, 2771, 3186, 4249, 4986, 5103, 5198, 5483, 6038, 6205, 6517, 6612, 6969, 7175, 7624]","[0, 170, 312, 430, 1011, 1236, 1326, 1473, 1802, 1982, 2265, 2405, 2495, 2602, 2934, 3148, 3368, 3589, 4441, 4923, 5022, 5117, 5386, 5746, 5988, 6314, 6484, 6665, 6967, 7312]",18416,15085,13582,7624,7312,-3579,1619,1316,2935,1279,3570,30,radiant
7529241517,89,49,43,110,100,"[521, 871, 1276, 1751, 2167, 2517, 3020, 3681, 4289, 5019, 5845, 6770, 7526, 8136, 8784, 9591, 10400, 11237, 11816, 12926, 13815, 14880, 15742, 15874, 16903, 17380, 18398, 18624, 18754, 19849]","[703, 957, 1490, 1902, 2362, 2918, 3568, 4061, 4837, 5128, 5835, 6406, 6604, 7293, 8119, 8792, 9406, 10373, 11182, 11367, 12290, 12748, 13204, 13752, 14343, 14512, 15400, 16396, 16986, 17246]","[520, 721, 966, 1425, 1975, 2462, 3119, 3649, 4095, 4801, 5321, 5829, 6244, 6666, 7519, 8108, 8824, 9649, 10367, 10552, 11596, 12434, 13137, 13232, 13901, 14368, 14760, 15450, 15981, 16121]","[289, 727, 884, 1309, 1443, 1578, 1758, 1985, 2475, 2761, 2952, 3287, 3614, 3891, 4384, 4617, 4846, 5347, 5759, 6043, 6482, 6868, 6963, 7308, 7403, 7583, 8050, 8229, 8527, 8804]","[353, 443, 570, 720, 883, 1018, 1214, 1394, 1740, 1999, 2243, 2446, 2541, 2636, 3038, 3249, 3778, 4035, 4317, 4538, 5376, 5652, 5965, 6060, 6155, 6249, 6452, 6899, 7148, 7248]",19849,17246,16121,8804,7248,109,106,28,105,68,"[531, 779, 1202, 1329, 1627, 2081, 2377, 2648, 3330, 3673, 4355, 4947, 5411, 6037, 6739, 7488, 8050, 8843, 9906, 11240, 11904, 12464, 13526, 14585, 15623, 16325, 17559, 18452, 19450, 20479]","[476, 690, 1087, 1380, 1627, 2095, 2453, 2837, 3577, 3836, 4322, 4794, 5771, 5866, 6680, 7070, 7268, 8163, 8939, 10028, 10737, 11641, 12470, 13249, 13972, 14253, 15040, 16148, 17177, 17743]","[491, 786, 1072, 1326, 1789, 2194, 2458, 3089, 3564, 4195, 4720, 5241, 5628, 6463, 6710, 7386, 7735, 8240, 8629, 9159, 9576, 10376, 11028, 11514, 11984, 12395, 12719, 13563, 14100, 14502]","[286, 412, 560, 689, 824, 1270, 1417, 1553, 1735, 2097, 2261, 2729, 3226, 3321, 4064, 4237, 4501, 4823, 5227, 5419, 6211, 6350, 7093, 7707, 8087, 8462, 8894, 9218, 9470, 9839]","[259, 395, 571, 706, 841, 1106, 1447, 1588, 1901, 2025, 2439, 2817, 3431, 3802, 4114, 4286, 4736, 5030, 5934, 6416, 6767, 6861, 7636, 7803, 8057, 8329, 8737, 9107, 9475, 9755]",20479,17743,14502,9839,9755,-630,-497,1619,-1035,-2507,-3050,30,dire
7529378713,76,53,43,85,19,"[0, 546, 794, 1324, 1862, 2355, 3005, 3385, 4131, 4686, 5365, 6208, 6874, 7433, 7736, 7831, 8132, 8459, 9881, 10562, 11149, 11854, 12968, 13723, 14469, 15453, 16104, 17584, 18184, 19057]","[0, 267, 466, 848, 1223, 1431, 1823, 2347, 2506, 3282, 3834, 4477, 4695, 4976, 5562, 6117, 7026, 7423, 8517, 9071, 9629, 9985, 10345, 11479, 11672, 12326, 12863, 14386, 14982, 15566]","[0, 210, 426, 553, 844, 1007, 1505, 1789, 2391, 3005, 3444, 3920, 4234, 4638, 5162, 5582, 6000, 6133, 6976, 7731, 8173, 8716, 9116, 9886, 10330, 10613, 11304, 12039, 12419, 13040]","[0, 195, 285, 538, 814, 950, 1182, 1678, 1946, 2236, 2627, 2918, 3098, 3646, 3798, 4049, 4282, 5030, 5782, 6229, 6473, 6751, 6953, 7171, 7546, 7775, 8351, 8824, 9041, 9227]","[0, 195, 285, 375, 465, 555, 955, 1115, 1274, 1510, 1906, 2122, 2302, 2538, 2633, 2728, 2823, 2917, 3397, 3862, 3994, 4237, 4332, 4581, 4911, 5119, 5442, 5932, 6109, 6736]",19057,15566,13040,9227,6736,80,23,112,31,26,"[0, 322, 627, 915, 1005, 1305, 1441, 2108, 2915, 3063, 3275, 4015, 4331, 4822, 5493, 6638, 7586, 8712, 8807, 9296, 10218, 11333, 11666, 12356, 13173, 14179, 15056, 15605, 16575, 16974]","[0, 248, 520, 647, 857, 1082, 1299, 1529, 1829, 2288, 2459, 2624, 2920, 3537, 3898, 4670, 5300, 6047, 6688, 6873, 7325, 7898, 8554, 8893, 9526, 10123, 10613, 10708, 11044, 11345]","[0, 400, 572, 1018, 1399, 1730, 2214, 2596, 3181, 3446, 3721, 3940, 4629, 5413, 5834, 6405, 7082, 8051, 8146, 8668, 9039, 9766, 10414, 10937, 11330, 11992, 12516, 12765, 13013, 13228]","[0, 311, 401, 491, 619, 709, 1098, 1278, 1458, 1548, 1939, 2356, 2446, 2714, 2982, 3933, 4389, 5230, 5325, 5461, 5733, 6326, 6493, 7026, 7449, 7615, 8133, 8382, 8803, 9422]","[0, 210, 345, 435, 567, 657, 747, 927, 1107, 1197, 1552, 1957, 2189, 2386, 2806, 3441, 3689, 4815, 4910, 5096, 5274, 5522, 5689, 5991, 6272, 6613, 6852, 7080, 7447, 7662]",16974,11345,13228,9422,7662,2083,4221,-188,-195,-926,4995,30,dire
7529403415,25,95,69,5,20,"[0, 370, 694, 958, 1216, 1507, 1975, 2421, 3165, 3781, 4406, 4632, 5160, 5697, 6257, 6672, 7582, 8023, 8286, 8479, 8781, 9318, 9994, 10479, 12272, 12844, 13729, 13985, 14370, 14680]","[0, 239, 527, 909, 1243, 1442, 1963, 2416, 2924, 3224, 3682, 3848, 4540, 5370, 5773, 6325, 6974, 7619, 8483, 9258, 10040, 11359, 11453, 12403, 14041, 14135, 14748, 15255, 15936, 16032]","[0, 333, 611, 972, 1427, 1737, 2013, 2500, 2747, 3027, 3399, 3985, 4625, 5118, 5639, 5965, 6571, 7294, 7706, 8051, 8306, 8777, 8871, 9048, 10047, 10547, 11276, 11706, 11846, 12102]","[0, 170, 260, 394, 550, 640, 744, 1132, 1270, 1424, 2039, 2129, 2500, 3065, 3249, 3344, 3911, 4135, 4229, 4590, 4782, 5059, 5153, 5454, 6292, 6386, 6810, 7176, 7272, 7407]","[0, 170, 260, 409, 568, 706, 836, 981, 1071, 1161, 1542, 1681, 2335, 2753, 3046, 3141, 3651, 3817, 3911, 4151, 4408, 4542, 4670, 4810, 5420, 5514, 5754, 5849, 5945, 6041]",14680,16032,12102,7407,6041,32,55,74,121,71,"[0, 170, 693, 838, 1199, 1567, 2384, 2513, 2944, 3420, 4027, 4535, 4834, 5204, 5605, 6062, 6593, 7171, 8230, 9377, 10072, 11452, 11998, 13004, 13535, 13845, 14397, 14818, 16046, 16765]","[0, 207, 568, 803, 1089, 1558, 1813, 1903, 2196, 2511, 2935, 3602, 4239, 5286, 5662, 6622, 6899, 7435, 8489, 9239, 10212, 11144, 12007, 12393, 13657, 14137, 14694, 15002, 15877, 16412]","[0, 206, 422, 512, 882, 1125, 1626, 1856, 2116, 2242, 2801, 3238, 3603, 4044, 4525, 4952, 5246, 5682, 6499, 7379, 7869, 8083, 8956, 9649, 10147, 10985, 11519, 12034, 12682, 13244]","[0, 170, 337, 427, 578, 734, 1032, 1316, 1503, 1747, 2130, 2539, 2674, 3266, 3777, 4390, 4587, 4886, 6151, 6634, 7025, 7939, 8283, 8669, 9071, 9717, 9984, 10223, 11350, 11943]","[0, 219, 347, 437, 527, 773, 953, 1080, 1170, 1427, 1607, 2317, 2407, 2991, 3340, 3656, 3940, 4183, 4919, 5792, 6258, 6464, 7048, 7618, 8587, 9058, 9485, 10006, 10619, 11688]",16765,16412,13244,11943,11688,-2085,-380,-1142,-4536,-5647,-13790,30,dire
7529493512,32,82,78,71,58,"[0, 285, 492, 973, 1330, 1459, 1798, 2127, 2445, 2831, 3367, 3794, 4420, 5010, 5105, 6390, 6574, 6731, 7403, 8558, 9257, 10558, 10725, 11097, 11383, 12305, 13208, 13796, 14621, 15298]","[0, 245, 485, 768, 1054, 1370, 1734, 2270, 2688, 3035, 3413, 3728, 4000, 4874, 5818, 6563, 7383, 7953, 8326, 8948, 9809, 10871, 11632, 12235, 12330, 13301, 13772, 14255, 14537, 15183]","[0, 279, 538, 890, 1275, 1495, 1829, 1953, 2264, 2848, 3623, 3838, 4149, 4533, 4873, 5680, 6021, 6293, 6819, 7345, 7766, 8622, 8878, 9108, 9377, 9739, 10249, 11190, 12168, 12731]","[0, 170, 260, 396, 486, 820, 943, 1071, 1290, 1641, 2048, 2263, 2398, 2666, 3094, 3881, 3976, 4752, 5169, 5792, 6105, 6312, 6606, 6836, 7542, 7889, 8416, 8754, 9254, 9688]","[0, 272, 362, 501, 658, 748, 877, 967, 1086, 1221, 1612, 1827, 2039, 2447, 2790, 3029, 3216, 3495, 4160, 4857, 5153, 5761, 5928, 6513, 6787, 7297, 7563, 7698, 7875, 8349]",15298,15183,12731,9688,8349,17,14,21,51,20,"[57, 379, 746, 1119, 1612, 1894, 2358, 2968, 3447, 3752, 4415, 5140, 5777, 6308, 6995, 7507, 8371, 8739, 9742, 9999, 10411, 11550, 12210, 13347, 14023, 14641, 15422, 15784, 16702, 17062]","[57, 266, 557, 754, 1290, 1590, 2038, 2651, 3115, 3360, 3808, 4118, 4742, 5256, 5712, 6092, 7054, 7574, 8006, 8935, 9822, 10761, 11137, 12309, 12872, 13763, 14442, 14819, 15995, 16639]","[57, 266, 1048, 1295, 1579, 1979, 2321, 2886, 3268, 3686, 4531, 5263, 5852, 6298, 6890, 7154, 7991, 8544, 8639, 8797, 9877, 10738, 11202, 12094, 12578, 13099, 13755, 14330, 15382, 15622]","[57, 227, 443, 581, 804, 1160, 1295, 1474, 1738, 2455, 2806, 3093, 3312, 3521, 3956, 4051, 4381, 4882, 5025, 5327, 5788, 5882, 6233, 6762, 7133, 7739, 7834, 8131, 8623, 8945]","[325, 495, 585, 692, 833, 1000, 1169, 1645, 1870, 2183, 2807, 2966, 3393, 3696, 3888, 3983, 4434, 4662, 4757, 5096, 5330, 5572, 5739, 6663, 6950, 7492, 7738, 8035, 8544, 8761]",17062,16639,15622,8945,8761,-1764,-1456,-2891,743,-412,-5780,30,dire
7529535219,59,41,57,105,110,"[522, 901, 1604, 2063, 2674, 3064, 3472, 4011, 4457, 4948, 5720, 6374, 6911, 7172, 7517, 8017, 8965, 9104, 9717, 10734, 10855, 11882, 12251, 13348, 14202, 14512, 15166, 15909, 16419, 17006]","[498, 916, 1207, 1668, 1953, 2382, 2890, 3316, 3783, 4260, 4960, 5454, 5882, 6230, 6761, 7130, 7647, 8190, 8547, 8797, 9460, 10227, 10486, 10775, 11138, 11571, 12253, 12940, 13629, 14596]","[563, 884, 1287, 1552, 1727, 2301, 2538, 3043, 3663, 4269, 4735, 5155, 5572, 5748, 6443, 6828, 7137, 7277, 7438, 7803, 8117, 8512, 9267, 9787, 10150, 10458, 10663, 11203, 11332, 11669]","[260, 350, 440, 570, 921, 1093, 1228, 1415, 1505, 1857, 2351, 2649, 3235, 3412, 4098, 4193, 5053, 5308, 5439, 5718, 6073, 6462, 6886, 7435, 7605, 8223, 8588, 9071, 9436, 9697]","[358, 448, 584, 808, 1021, 1202, 1460, 1600, 1830, 2042, 2324, 2762, 3036, 3381, 3743, 3980, 4532, 4760, 5022, 5387, 5482, 5996, 6485, 7082, 7445, 7582, 7849, 8117, 8213, 8763]",17006,14596,11669,9697,8763,95,97,106,101,58,"[501, 874, 1261, 1557, 2057, 2242, 2857, 3230, 3802, 4177, 4958, 5368, 6860, 7614, 8416, 9267, 10342, 11110, 11692, 12208, 13530, 14368, 15213, 16095, 17118, 17664, 19094, 20014, 20736, 21627]","[554, 913, 1374, 1605, 1937, 2498, 2940, 3346, 3939, 4420, 5035, 5716, 6577, 7544, 8480, 8830, 9688, 10134, 10228, 10641, 11960, 12415, 13206, 13972, 14748, 15607, 16176, 16820, 17480, 17885]","[805, 982, 1155, 1399, 1584, 1974, 2368, 2814, 3290, 3772, 4083, 4483, 5320, 5754, 6304, 6926, 7492, 7990, 8605, 9425, 10764, 11274, 11739, 12405, 13558, 14237, 15144, 15518, 15874, 16109]","[639, 775, 905, 995, 1085, 1355, 1445, 1535, 1819, 1958, 2141, 2344, 3106, 3291, 3620, 4074, 4339, 4609, 4703, 5329, 5851, 6056, 6714, 6881, 8155, 8701, 8878, 8974, 9393, 9662]","[323, 616, 746, 882, 1071, 1246, 1494, 1737, 1978, 2197, 2370, 2657, 3383, 3655, 4102, 4512, 4687, 4782, 4925, 5248, 5770, 6015, 6414, 6581, 7156, 7960, 8282, 8503, 8850, 9196]",21627,17885,16109,9662,9196,-4621,-3289,-4440,35,-433,-12748,30,dire
7529570918,25,98,114,112,86,"[615, 1015, 1475, 2087, 2518, 2732, 3391, 3988, 4513, 5090, 5459, 6109, 6648, 7383, 8035, 9125, 9782, 10517, 11497, 12091, 12418, 12967, 13613, 14546, 15575, 16131, 16227, 17704, 17800, 18051]","[606, 938, 1256, 2001, 2412, 2921, 3605, 4217, 4384, 5205, 5785, 6162, 6558, 7223, 7849, 8433, 8924, 9620, 10173, 10728, 11561, 11656, 12513, 12843, 13273, 13743, 14161, 14845, 15047, 15244]","[766, 1061, 1595, 1832, 2355, 2779, 2920, 3447, 3652, 4111, 4601, 5007, 5377, 5604, 6198, 6531, 6749, 7785, 8123, 8637, 8827, 9730, 10320, 10873, 11468, 12374, 12767, 13987, 14706, 14919]","[629, 742, 880, 970, 1118, 1208, 1298, 1552, 1687, 2053, 2143, 2408, 2804, 3438, 3686, 3830, 4138, 4510, 4605, 4800, 5177, 5403, 5719, 6020, 6312, 6592, 6755, 7071, 7220, 7320]","[332, 506, 616, 927, 1017, 1107, 1242, 1545, 2002, 2342, 2432, 2694, 3181, 3523, 4121, 4466, 4684, 5028, 5169, 5436, 5646, 5741, 5931, 6332, 6474, 6679, 6775, 6926, 7141, 7404]",18051,15244,14919,7320,7404,56,43,60,26,83,"[525, 736, 1151, 1453, 1704, 2133, 2876, 3256, 4200, 4744, 5200, 5651, 6100, 6560, 7236, 7805, 8429, 9126, 10092, 10550, 10977, 11909, 12693, 13395, 14066, 15021, 15922, 16691, 17593, 18515]","[614, 790, 1244, 1901, 2277, 3244, 3787, 4385, 5096, 5604, 6113, 6356, 6863, 7516, 8272, 8882, 9990, 10211, 10571, 10668, 11555, 12237, 12687, 13334, 13891, 14640, 15067, 16095, 16571, 16966]","[456, 830, 1043, 1508, 1681, 2089, 2521, 2938, 3858, 4235, 4647, 5182, 5738, 6293, 6870, 7110, 8169, 8787, 9369, 9876, 10254, 10696, 10974, 11495, 11934, 12807, 13878, 14379, 15222, 15750]","[260, 350, 440, 625, 760, 1530, 2017, 2269, 2404, 2548, 2815, 2972, 3117, 3387, 3675, 3911, 4609, 4830, 4925, 5071, 5449, 5767, 6010, 6252, 6622, 7201, 7534, 7918, 8079, 8269]","[260, 350, 440, 530, 665, 885, 1244, 1334, 1712, 1856, 2068, 2385, 2491, 2763, 2984, 3085, 3578, 3799, 3894, 3996, 4379, 4913, 5278, 5445, 5539, 5828, 6086, 6410, 6506, 6696]",18515,16966,15750,8269,6696,-464,-1722,-831,-949,708,-3258,30,radiant
7529662500,12,106,96,86,45,"[1420, 1622, 1950, 2223, 2681, 2942, 3614, 3999, 4742, 5234, 6398, 7235, 7653, 8355, 9717, 10687, 11664, 12586, 13725, 14799, 15685, 16833, 18350, 19448, 20498, 21839, 22825, 24682, 25986, 26902]","[1493, 1935, 2189, 2431, 2588, 2852, 3185, 3649, 4076, 4419, 4902, 6007, 6284, 7203, 8139, 9025, 9665, 10079, 11461, 11974, 12893, 13674, 14368, 14864, 15855, 16201, 16667, 17513, 18178, 19338]","[1535, 1742, 2148, 2684, 3083, 3471, 4014, 4408, 4800, 4993, 5404, 5866, 6170, 6620, 7385, 7871, 8217, 8705, 10002, 10187, 10520, 11293, 11882, 12213, 12534, 12790, 13048, 13491, 13737, 14207]","[715, 1077, 1212, 1387, 1654, 1744, 2024, 2149, 2288, 2646, 3090, 3317, 3768, 4211, 4413, 5165, 5506, 5938, 6484, 6702, 7006, 7715, 8427, 9292, 9737, 10281, 10766, 11146, 11321, 11837]","[765, 963, 1098, 1318, 1467, 1557, 1737, 1827, 1922, 2251, 2667, 2960, 3129, 3679, 3973, 4795, 5019, 5467, 6298, 6586, 6890, 7387, 7708, 8215, 8752, 9004, 9381, 9771, 9950, 10174]",26902,19338,14207,11837,10174,41,47,33,19,26,"[1323, 1581, 1840, 1970, 2493, 3054, 3236, 3952, 4407, 4844, 5238, 5779, 6366, 7067, 7696, 8452, 9019, 9390, 9623, 10603, 11282, 12223, 13046, 13142, 13724, 14113, 14250, 14980, 15482, 15672]","[1576, 1889, 2726, 3206, 4015, 4449, 4947, 5383, 6079, 6398, 6628, 7072, 7672, 8289, 8457, 8552, 8948, 9114, 9555, 10226, 10914, 11625, 12164, 12861, 13224, 13648, 14445, 15376, 15722, 15986]","[1988, 2493, 2783, 3191, 3434, 4480, 4668, 5576, 6102, 6692, 6984, 7351, 7821, 8508, 8758, 9122, 9369, 9535, 9936, 10373, 10772, 11151, 11406, 11907, 12196, 12526, 12626, 12939, 13248, 13769]","[803, 1057, 1237, 1373, 1463, 1815, 1905, 2426, 2608, 2743, 3008, 3292, 3671, 4019, 4177, 4273, 4580, 4784, 4954, 5249, 5706, 6118, 6336, 6507, 6688, 6969, 7182, 7357, 7941, 8179]","[829, 1188, 1368, 1458, 1682, 2034, 2124, 2507, 2656, 2923, 3265, 3549, 3689, 3835, 4023, 4510, 4605, 4966, 5189, 5648, 5981, 6076, 6196, 6440, 6755, 6895, 7005, 7125, 7225, 7463]",15672,15986,13769,8179,7463,11230,3352,438,3658,2711,21389,30,radiant
7529668400,15,21,59,19,91,"[0, 205, 452, 746, 1088, 1288, 1629, 1997, 2087, 2448, 2880, 3385, 4182, 4812, 5327, 5871, 6745, 7302, 8128, 8912, 9340, 10170, 10649, 11054, 11544, 12008, 12439, 12961, 13162, 14824]","[0, 170, 607, 930, 1452, 1750, 1879, 2304, 2710, 3178, 3714, 3889, 4446, 5265, 5624, 6057, 6385, 6974, 7616, 8049, 8587, 9328, 10198, 10999, 11561, 12348, 12820, 13919, 14385, 15051]","[0, 258, 633, 980, 1270, 1725, 2378, 2714, 3160, 3681, 4769, 5336, 6187, 6949, 7514, 7921, 8186, 8542, 9389, 9698, 10327, 10479, 11115, 11606, 12062, 12586, 12769, 13373, 13469, 14077]","[0, 270, 432, 552, 745, 993, 1163, 1336, 1594, 1761, 2362, 2665, 3043, 3594, 3894, 4590, 4753, 4848, 5443, 5549, 5803, 6343, 6581, 7104, 7203, 7298, 7392, 7750, 8091, 8387]","[0, 170, 260, 380, 604, 779, 891, 1088, 1227, 1394, 1697, 1835, 2252, 2491, 2640, 2781, 2988, 3083, 3502, 3596, 3840, 4183, 4349, 4531, 4651, 4794, 4888, 4983, 5126, 5584]",14824,15051,14077,8387,5584,1,43,74,51,45,"[0, 582, 1009, 1238, 1528, 2106, 2524, 3039, 3393, 3636, 4085, 4438, 4615, 5284, 5808, 6869, 7901, 8606, 9647, 11049, 11920, 12947, 13702, 14799, 15676, 16791, 17890, 19152, 20312, 21149]","[0, 256, 634, 848, 1141, 1541, 2089, 2282, 2634, 3441, 3913, 4686, 5123, 5933, 6386, 6759, 7446, 7718, 8484, 9738, 10432, 10938, 11355, 11906, 12114, 12627, 13379, 14150, 15070, 15571]","[0, 256, 463, 674, 764, 961, 1097, 1392, 1738, 2064, 2315, 2664, 3081, 3753, 4136, 4704, 5119, 5710, 5805, 6622, 7358, 7963, 8551, 9404, 9703, 10606, 11396, 11998, 12498, 12999]","[0, 170, 285, 375, 510, 630, 1111, 1201, 1438, 1733, 1963, 2268, 2428, 2755, 3002, 3521, 3799, 4145, 4395, 5246, 5482, 5884, 6191, 6383, 6828, 7297, 7767, 8088, 8514, 9288]","[0, 239, 354, 444, 621, 859, 993, 1083, 1320, 1483, 1620, 1909, 2048, 2331, 2470, 2830, 3084, 3597, 3692, 4309, 4545, 4916, 5082, 5288, 5496, 5820, 6108, 6557, 6897, 7822]",21149,15571,12999,9288,7822,-6325,-520,1078,-901,-2238,-8906,30,dire
7529670117,41,13,69,86,3,"[446, 648, 975, 1247, 1898, 2297, 2721, 2977, 3625, 4122, 4493, 5013, 5437, 6193, 6936, 7545, 8181, 8951, 9492, 10325, 11506, 12347, 13308, 14115, 15060, 16468, 16918, 17847, 19090, 20940]","[657, 1027, 1478, 1892, 2376, 3172, 3262, 3519, 3991, 4290, 5016, 5165, 5683, 6231, 6561, 6719, 6956, 7340, 7711, 8322, 9016, 9629, 9998, 11203, 11763, 12883, 13640, 14132, 15129, 16631]","[628, 957, 1367, 1659, 1914, 2288, 2634, 2803, 3238, 3563, 4267, 4932, 5442, 5794, 6422, 7258, 8032, 8398, 8689, 9443, 10043, 10581, 11095, 11687, 11993, 13613, 14401, 14849, 15226, 15871]","[334, 441, 575, 749, 919, 1227, 1317, 1444, 1579, 2213, 2303, 2452, 2945, 3544, 4256, 4389, 4939, 5216, 5504, 5757, 6302, 6723, 7325, 7702, 7871, 8754, 9097, 9297, 9574, 10166]","[260, 456, 563, 720, 941, 1256, 1346, 1680, 2052, 2222, 2312, 2507, 2843, 3073, 3459, 3554, 3648, 4326, 4421, 4786, 5024, 5119, 5336, 5638, 5988, 6709, 6880, 7051, 7953, 8817]",20940,16631,15871,10166,8817,114,90,129,20,26,"[524, 853, 1027, 1455, 1867, 2293, 2593, 3133, 3729, 4383, 4939, 5642, 6384, 7137, 7340, 7950, 8504, 9210, 9468, 10168, 11068, 12008, 12776, 13787, 14668, 15288, 16165, 17078, 18123, 18977]","[625, 951, 1408, 1864, 2484, 3020, 3661, 4379, 5020, 5538, 6048, 6866, 7235, 7542, 8161, 9228, 9426, 9851, 10419, 11060, 11930, 12336, 12784, 13427, 13878, 14245, 14956, 15645, 16295, 16642]","[472, 790, 952, 1371, 1658, 2118, 2288, 2923, 3170, 3695, 4232, 5050, 5515, 5914, 6425, 6778, 7240, 7646, 7943, 8765, 9463, 10204, 11218, 12154, 12612, 13561, 14141, 14948, 15634, 16134]","[375, 596, 760, 944, 1116, 1302, 1514, 1910, 2045, 2567, 2808, 3278, 3526, 3979, 4429, 4954, 5048, 5827, 5956, 6104, 6390, 6615, 6904, 7236, 7528, 7803, 8320, 8722, 9170, 9570]","[260, 350, 440, 929, 1066, 1156, 1246, 1548, 1792, 1929, 2263, 2881, 3177, 3302, 3705, 3952, 4046, 4600, 4695, 4790, 4956, 5051, 5146, 5403, 5634, 6001, 6259, 6539, 6878, 7068]",18977,16642,16134,9570,7068,1963,-11,-263,596,1749,4034,30,radiant
7529800410,94,19,92,72,5,"[0, 286, 568, 883, 1244, 1704, 2119, 2771, 3113, 3579, 4216, 4929, 5507, 6437, 7695, 8842, 9732, 10502, 11409, 12386, 12745, 13381, 15197, 17160, 18391, 19768, 20722, 22096, 23559, 24730]","[0, 286, 533, 783, 1088, 1417, 1699, 2149, 2692, 3232, 3823, 4231, 4592, 4935, 5754, 6110, 6437, 6684, 6985, 7164, 7790, 8475, 9309, 9979, 10473, 10980, 11987, 12273, 13209, 13981]","[0, 208, 459, 811, 1201, 1432, 1832, 2463, 2742, 3196, 3802, 4160, 4813, 5354, 5947, 6567, 6934, 7380, 7974, 8378, 8887, 9178, 9692, 10709, 11142, 11476, 11989, 12365, 13135, 13641]","[0, 167, 339, 815, 905, 1046, 1477, 1910, 2243, 2768, 3305, 3525, 3615, 4207, 4913, 5216, 5526, 5832, 6464, 6559, 6934, 7438, 8025, 8695, 9456, 9826, 10487, 10866, 11703, 12619]","[0, 130, 234, 372, 462, 652, 761, 1006, 1174, 1661, 2051, 2141, 2378, 2638, 3076, 3269, 3710, 3805, 4093, 4248, 4553, 4788, 5789, 6459, 6951, 7219, 7843, 8474, 9100, 9643]",24730,13981,13641,12619,9643,41,69,106,75,86,"[0, 366, 668, 869, 1131, 1492, 1813, 2135, 2455, 2662, 2961, 3707, 4200, 4950, 5398, 5971, 6472, 7305, 8148, 8708, 9498, 9914, 10142, 10648, 11128, 11677, 11926, 12248, 12825, 12921]","[0, 245, 441, 925, 1221, 1384, 1642, 2083, 2526, 2978, 3407, 4209, 4611, 5093, 5584, 5799, 6270, 6938, 7670, 8054, 8867, 9561, 10340, 10794, 11032, 11604, 11792, 12164, 12803, 12899]","[0, 244, 528, 923, 1133, 1381, 1795, 2402, 3021, 3273, 3737, 4138, 4581, 4842, 5128, 5697, 6408, 7094, 7880, 8211, 8673, 9266, 9438, 10001, 10374, 10782, 11055, 11651, 11854, 11996]","[0, 210, 300, 390, 544, 765, 1069, 1159, 1761, 1851, 1986, 2327, 2784, 3082, 3176, 3442, 3828, 4050, 4705, 4869, 5182, 5316, 5636, 6138, 6481, 6905, 7100, 7537, 7744, 7915]","[0, 258, 348, 487, 577, 796, 1062, 1152, 1461, 1551, 1770, 2130, 2302, 2534, 2784, 2928, 3284, 3737, 4189, 4848, 5232, 5581, 6080, 6374, 6569, 7191, 7332, 7427, 7595, 7691]",12921,12899,11996,7915,7691,11809,1082,1645,4704,1952,21192,30,radiant
7530075714,62,18,102,107,26,"[0, 257, 559, 1160, 1530, 1798, 2138, 3073, 3463, 4302, 5089, 5493, 7319, 8128, 8759, 9285, 10096, 10756, 11779, 12119, 12685, 13268, 14959, 15378, 15862, 16451, 16773, 18247, 20359, 22333]","[0, 163, 287, 703, 1152, 1646, 1976, 2413, 3049, 3353, 3968, 4876, 5328, 6261, 6696, 7385, 8343, 8982, 9983, 10880, 11474, 12179, 13125, 13994, 14693, 15859, 16479, 17298, 19201, 20989]","[0, 129, 342, 663, 851, 1666, 1939, 2261, 2804, 3141, 3833, 4389, 4918, 5527, 5780, 6220, 6481, 7046, 7678, 8317, 9007, 9117, 10225, 10608, 10966, 11412, 11739, 12942, 14145, 15990]","[0, 167, 257, 396, 708, 1113, 1250, 2084, 2264, 2667, 3253, 3722, 4312, 4604, 4757, 5048, 5364, 5944, 6312, 6705, 6935, 7030, 7890, 8094, 8346, 9058, 9344, 9956, 11357, 12292]","[0, 129, 266, 400, 534, 704, 858, 997, 1239, 1377, 1731, 2235, 2564, 3077, 3404, 3699, 4140, 4411, 4550, 4770, 5063, 5158, 5994, 6436, 6697, 7110, 7339, 8168, 9387, 10690]",22333,20989,15990,12292,10690,25,71,12,30,84,"[0, 362, 618, 1052, 1501, 1980, 2317, 2718, 3172, 3515, 3818, 4028, 4371, 4783, 5476, 6045, 6306, 6993, 7559, 8510, 9058, 9742, 10568, 10775, 11504, 12146, 12611, 13379, 13548, 13744]","[0, 244, 875, 1084, 1383, 1977, 2224, 2599, 2971, 3395, 3565, 3948, 4088, 4652, 5534, 5731, 5865, 6192, 6937, 7678, 8089, 8797, 9002, 9434, 9649, 9907, 10191, 11130, 11226, 11491]","[0, 320, 564, 763, 979, 1143, 1440, 1863, 2243, 2613, 2984, 3241, 3476, 3799, 4261, 4519, 4692, 5016, 5407, 6111, 6456, 7177, 7599, 7693, 8068, 8584, 9033, 9589, 9685, 9881]","[0, 209, 336, 447, 557, 647, 784, 973, 1153, 1243, 1378, 1507, 1597, 1746, 1985, 2079, 2174, 2416, 3143, 4389, 4484, 4995, 5214, 5308, 5576, 5973, 6067, 6430, 6842, 7204]","[0, 209, 364, 454, 562, 726, 863, 1087, 1267, 1357, 1492, 1775, 1940, 2089, 2349, 2443, 2538, 2799, 2915, 3590, 3755, 4078, 4284, 4378, 4508, 4710, 4851, 5126, 5222, 5448]",13744,11491,9881,7204,5448,8589,9498,6109,5088,5242,34526,30,radiant
7530098507,48,106,65,58,136,"[0, 253, 536, 781, 1249, 1574, 2104, 2479, 3161, 3656, 4270, 4798, 5321, 6166, 7054, 7725, 8590, 9120, 10194, 11578, 12731, 13001, 13520, 14118, 15383, 16207, 16861, 17113, 17561, 18150]","[0, 354, 614, 976, 1352, 1612, 1869, 2300, 2754, 3400, 3826, 4460, 4846, 5288, 5868, 6219, 6844, 7012, 7663, 8154, 8616, 9392, 10093, 10188, 10765, 10931, 11137, 11416, 11632, 12087]","[0, 205, 530, 899, 1461, 1649, 2336, 2833, 3206, 3919, 4210, 4651, 5151, 5652, 6533, 6999, 7412, 8058, 8514, 8762, 9377, 9471, 10187, 10898, 11363, 12072, 12391, 12486, 12582, 13205]","[0, 170, 260, 389, 519, 639, 759, 894, 1076, 1543, 1767, 2029, 2326, 2615, 2896, 3081, 3620, 3714, 4173, 4400, 4973, 5337, 5539, 5847, 6138, 6628, 6805, 6900, 7019, 7516]","[0, 170, 294, 431, 629, 958, 1166, 1426, 1621, 2006, 2141, 2366, 2661, 2909, 3093, 3188, 3395, 3857, 4087, 4505, 4815, 4928, 5407, 5502, 5737, 6088, 6241, 6336, 6640, 7397]",18150,12087,13205,7516,7397,10,96,17,66,86,"[0, 255, 494, 792, 1172, 1527, 2068, 2483, 2931, 3251, 3907, 4496, 4826, 5430, 6216, 6898, 7524, 8532, 9289, 10438, 11355, 12571, 13586, 14860, 15733, 16591, 17872, 18409, 19050, 20063]","[0, 245, 482, 705, 1109, 1473, 1671, 2170, 2630, 3060, 3605, 4156, 4758, 5199, 5707, 6100, 6325, 7141, 7778, 8629, 8724, 9100, 9635, 10369, 11033, 11349, 12086, 12353, 12559, 13037]","[0, 222, 568, 778, 1158, 1248, 1682, 1998, 2296, 2386, 2825, 3513, 4121, 4590, 5199, 5903, 6090, 7165, 7904, 8503, 9087, 9465, 9937, 10532, 10942, 11216, 11788, 12075, 12281, 12735]","[0, 204, 294, 428, 615, 750, 858, 1018, 1241, 1359, 1799, 2167, 2467, 2881, 2976, 3342, 3598, 4070, 4416, 4855, 5172, 5582, 6060, 6286, 6647, 7085, 7439, 7534, 7883, 8321]","[0, 170, 305, 412, 772, 956, 1132, 1222, 1571, 1862, 2192, 2537, 2734, 3139, 3426, 3697, 4316, 4718, 5080, 5828, 6123, 6467, 6972, 7208, 7303, 7612, 8590, 8903, 9318, 9605]",20063,13037,12735,8321,9605,-1913,-950,470,-805,-2208,-5406,30,dire
7530110416,25,28,21,110,100,"[297, 582, 983, 1425, 1827, 2191, 2624, 3072, 3544, 3681, 4146, 4663, 5077, 5377, 6537, 7102, 7915, 8542, 9591, 10331, 10604, 11402, 11876, 12121, 12703, 13495, 14782, 15258, 15736, 16200]","[332, 654, 964, 1381, 1909, 2243, 2587, 3228, 3955, 4541, 4806, 5196, 5344, 5565, 6386, 6719, 7297, 7653, 8096, 8818, 9081, 9605, 10203, 10813, 11015, 11574, 12734, 13049, 13145, 13300]","[248, 514, 805, 1214, 1582, 1861, 2558, 2858, 3322, 3939, 4067, 4866, 5581, 5837, 6944, 7546, 8256, 8601, 9025, 9529, 9623, 9753, 10218, 11304, 12263, 12395, 12999, 13095, 13321, 13417]","[170, 290, 380, 470, 648, 738, 1024, 1114, 1388, 1617, 1828, 2008, 2214, 2772, 2867, 3097, 3364, 3508, 3845, 4209, 4377, 4547, 4876, 5321, 5739, 6043, 6814, 7110, 7281, 7452]","[170, 290, 380, 737, 1127, 1217, 1477, 1567, 1798, 2127, 2217, 2397, 2545, 2766, 3251, 3481, 3792, 3932, 4229, 4593, 4744, 5002, 5172, 5536, 5777, 5947, 6513, 6684, 6855, 7026]",16200,13300,13417,7452,7026,48,22,104,83,86,"[318, 655, 1033, 1251, 1744, 2087, 2390, 2805, 3205, 3885, 4579, 5118, 5952, 6692, 7266, 7681, 8723, 9425, 10237, 11510, 12606, 14051, 15002, 15821, 16727, 17399, 18466, 19433, 20206, 22979]","[318, 639, 912, 1234, 1617, 2333, 2792, 3462, 4081, 4396, 4842, 5288, 6242, 6881, 6976, 7636, 8198, 8546, 8882, 8977, 10163, 10852, 11671, 12015, 13333, 14000, 14423, 15160, 15364, 16307]","[269, 432, 677, 968, 1181, 1336, 1738, 2078, 2741, 3290, 4418, 4722, 5160, 6028, 6197, 6434, 6923, 7471, 7566, 8140, 8543, 9157, 9962, 10260, 10398, 10717, 11154, 11664, 11990, 12934]","[195, 615, 811, 901, 1076, 1283, 1538, 1686, 2095, 2230, 2884, 2974, 3512, 4267, 4436, 4829, 5140, 5588, 6004, 6958, 7723, 8505, 8978, 9527, 10207, 10599, 11093, 11315, 11640, 12538]","[195, 330, 471, 561, 691, 885, 1020, 1191, 1402, 1659, 2211, 2349, 2615, 3274, 3624, 3782, 4266, 4471, 4603, 5566, 6130, 6796, 7054, 7275, 7553, 7783, 8466, 8741, 9255, 10237]",22979,16307,12934,12538,10237,-6779,-3007,483,-5086,-3211,-17600,30,dire
7530159016,41,53,129,97,105,"[326, 530, 728, 1040, 1304, 1818, 2098, 2233, 2532, 3121, 3569, 4017, 4737, 5068, 5710, 6268, 6735, 7456, 7771, 7954, 8459, 9258, 9353, 9592, 10324, 10912, 11412, 11975, 12749, 13555]","[251, 341, 431, 818, 993, 1739, 1950, 2108, 2485, 3121, 3542, 4156, 4641, 4813, 5847, 6068, 7133, 7706, 8180, 8574, 8942, 9612, 9868, 10396, 11109, 11576, 12380, 13065, 13473, 13871]","[511, 762, 1079, 1361, 1562, 1757, 2228, 2515, 3302, 3823, 4251, 4689, 5627, 5829, 6063, 6715, 7421, 7622, 7945, 8173, 8937, 9660, 10132, 10418, 11295, 11954, 12357, 13176, 13513, 13865]","[242, 419, 675, 924, 1415, 2106, 2233, 2695, 3000, 3448, 3963, 4380, 5014, 5146, 5802, 6215, 6566, 7118, 7460, 7678, 8104, 8712, 8963, 9445, 9993, 10168, 10550, 11101, 11662, 12107]","[169, 259, 366, 500, 753, 1147, 1711, 1846, 2329, 2721, 2857, 2996, 3372, 3467, 4121, 4342, 4602, 4865, 5022, 5117, 5280, 5742, 5993, 6232, 6533, 7139, 7398, 7575, 7716, 7861]",13555,13871,13865,12107,7861,25,36,96,100,20,"[264, 652, 1165, 1427, 1811, 2361, 3418, 4010, 4312, 5098, 5439, 6270, 6896, 7946, 8876, 9732, 10515, 11509, 13336, 14319, 15122, 16204, 17785, 19043, 19945, 20949, 21815, 22958, 23776, 24581]","[571, 934, 1275, 1652, 2019, 2477, 2853, 3481, 3938, 4758, 5362, 5982, 6617, 7798, 8168, 9296, 9901, 10687, 11210, 11995, 12620, 13270, 14243, 14930, 15817, 16348, 17135, 18063, 18931, 19621]","[304, 554, 918, 1184, 1669, 1840, 2113, 2772, 3076, 3613, 3823, 4236, 4890, 5342, 5700, 6555, 6997, 7464, 8294, 8774, 9513, 10163, 10998, 11363, 11732, 12450, 13026, 13575, 14003, 14364]","[229, 423, 592, 1015, 1190, 1699, 2135, 2834, 3015, 3335, 3426, 3561, 3826, 4132, 4689, 5210, 5447, 5883, 6476, 7022, 7189, 7529, 8358, 8674, 9069, 9541, 9708, 9965, 10279, 10569]","[229, 319, 457, 593, 777, 867, 957, 1195, 1358, 1956, 2159, 2310, 2597, 2798, 3021, 3542, 3976, 4212, 4804, 5173, 5533, 5950, 6153, 6438, 6760, 7190, 7334, 7515, 7893, 8150]",24581,19621,14364,10569,8150,-11026,-5750,-499,1538,-289,-16026,30,dire
7530428617,69,1,53,19,5,"[0, 250, 608, 771, 1286, 1554, 2271, 2834, 3445, 3718, 4088, 4795, 5473, 6241, 6627, 7285, 7416, 8066, 8690, 9155, 9589, 10658, 10985, 11443, 11690, 12455, 14377, 14722, 16720, 17981]","[0, 252, 696, 941, 1103, 1426, 1851, 2419, 2833, 3233, 3671, 4184, 4679, 5313, 5800, 6119, 6587, 7303, 7992, 8248, 9233, 9867, 10903, 11508, 11693, 11991, 12518, 13458, 13554, 15093]","[0, 170, 260, 350, 516, 606, 835, 1182, 1272, 1924, 2193, 2387, 2531, 2962, 3434, 3901, 4376, 5022, 5394, 6207, 6660, 7584, 8103, 8927, 9377, 10014, 10614, 10986, 11175, 11539]","[0, 280, 599, 854, 1234, 1596, 2045, 2542, 2950, 3285, 3753, 4112, 4372, 5175, 5841, 6218, 6313, 6955, 7620, 7743, 8744, 9043, 9900, 10426, 11006, 11100, 11942, 12287, 12543, 12639]","[0, 170, 284, 374, 469, 598, 782, 996, 1175, 1400, 1584, 1976, 2139, 2278, 2570, 2709, 2804, 2898, 3195, 3462, 3620, 3714, 3881, 3976, 4491, 4840, 5232, 5524, 6615, 7363]",17981,15093,11539,12639,7363,109,25,78,68,21,"[0, 255, 591, 1178, 1623, 2095, 2454, 2852, 3533, 3949, 4698, 5250, 5996, 7157, 7597, 8496, 9149, 10025, 11115, 12120, 13071, 14043, 14897, 15861, 17466, 18301, 19053, 20217, 21458, 21722]","[0, 218, 618, 948, 1197, 1481, 1897, 2348, 2673, 2982, 3512, 3949, 4621, 5355, 6062, 6371, 6965, 8252, 9128, 9664, 10160, 10566, 11584, 12529, 13269, 14811, 15300, 16664, 18169, 18618]","[0, 242, 591, 886, 1208, 1615, 1816, 2048, 2317, 2487, 2967, 3393, 3882, 4554, 5192, 5589, 6622, 7174, 7542, 8095, 8782, 9154, 9566, 10303, 10886, 11924, 12537, 14097, 15074, 15274]","[0, 170, 276, 453, 621, 853, 943, 1200, 1335, 1472, 1856, 2149, 2831, 3197, 3597, 4192, 4889, 5755, 6355, 6740, 7256, 7630, 8158, 8488, 9434, 9713, 10839, 11562, 12553, 12649]","[0, 214, 304, 394, 484, 709, 850, 985, 1233, 1408, 1627, 1928, 2226, 2664, 3001, 3186, 3662, 3967, 4172, 4818, 4976, 5135, 5514, 5785, 6138, 6404, 6912, 7616, 8688, 8784]",21722,18618,15274,12649,8784,-3741,-3525,-3735,-10,-1421,-12432,30,dire
7530463515,114,74,104,84,7,"[0, 253, 417, 837, 1175, 1626, 1955, 2529, 2765, 3298, 3834, 4307, 4861, 5449, 5918, 6831, 7461, 8179, 8652, 9710, 10137, 10505, 11511, 12517, 12900, 13771, 15634, 16609, 17710, 18437]","[0, 239, 513, 835, 1164, 1501, 1664, 2075, 2563, 3178, 3858, 4882, 5358, 6076, 6935, 7705, 8492, 9476, 9793, 10520, 11384, 11973, 12673, 13272, 14381, 15481, 15866, 16759, 17295, 17704]","[0, 330, 492, 760, 1262, 1729, 1979, 2112, 2883, 3170, 3552, 3984, 4506, 5399, 5693, 6482, 6985, 7589, 8432, 9176, 9859, 10444, 10979, 11145, 11572, 12427, 14285, 14490, 15111, 15642]","[0, 208, 385, 521, 660, 798, 936, 1070, 1256, 1395, 1563, 1761, 1895, 2147, 2522, 2964, 3095, 3619, 4157, 5313, 6065, 6394, 7106, 7347, 8077, 8967, 9322, 9922, 10093, 10579]","[0, 169, 259, 349, 484, 619, 709, 799, 1027, 1162, 1371, 1613, 1747, 2012, 2324, 2617, 2779, 3155, 3510, 3799, 4184, 4663, 4758, 4932, 5204, 5481, 6320, 6731, 6956, 7214]",18437,17704,15642,10579,7214,1,19,53,96,5,"[0, 207, 640, 1050, 1497, 1987, 2416, 2872, 3208, 3756, 4030, 4377, 4856, 5326, 5819, 6303, 6811, 7239, 7997, 8863, 9902, 10627, 11376, 12535, 13313, 14329, 15133, 15330, 16644, 17501]","[0, 335, 627, 955, 1327, 1677, 2355, 2704, 3050, 3563, 4202, 4292, 4883, 5453, 5796, 6269, 6839, 7190, 7663, 8204, 8917, 9012, 10345, 10944, 11379, 11673, 12841, 12936, 14827, 15406]","[0, 219, 309, 443, 633, 780, 1007, 1097, 1232, 1412, 1749, 2154, 2588, 3125, 3625, 3969, 4337, 4816, 5748, 6390, 6883, 7927, 9526, 9830, 10213, 10682, 12277, 12430, 13827, 14590]","[0, 241, 483, 925, 1194, 1440, 1907, 2110, 2660, 3152, 3653, 3898, 4522, 4793, 5225, 5713, 5871, 6592, 7579, 8082, 8508, 8966, 9438, 10082, 10267, 10498, 11098, 11482, 12658, 13131]","[0, 169, 285, 461, 551, 687, 866, 1056, 1267, 1447, 1582, 1719, 1986, 2155, 2250, 2344, 2502, 2597, 3172, 3446, 3849, 3944, 4450, 4618, 4957, 5104, 5643, 5738, 6696, 6963]",17501,15406,14590,13131,6963,936,2298,1052,-2552,251,1985,30,dire
7530531515,11,106,7,105,37,"[0, 384, 741, 1027, 1385, 1678, 2224, 2651, 3280, 3739, 4322, 5267, 6091, 6969, 7443, 8103, 8912, 9908, 10658, 11740, 12143, 12584, 13415, 15100, 15195, 15563, 16311, 17631, 17727, 18403]","[0, 298, 660, 939, 1378, 1615, 1907, 2278, 2663, 3002, 3471, 4002, 4681, 5365, 5946, 6375, 6896, 7584, 8257, 8879, 9749, 10086, 10803, 11462, 12131, 12860, 13209, 13701, 13797, 15073]","[0, 261, 629, 846, 1201, 1387, 1667, 1868, 2068, 3066, 3237, 3748, 4162, 4830, 5156, 5863, 6337, 6691, 6988, 7779, 8157, 8520, 8785, 10430, 10655, 11500, 11701, 12152, 12429, 13043]","[0, 539, 629, 749, 967, 1102, 1321, 1411, 1581, 2250, 2771, 3165, 3590, 3685, 3780, 4224, 4425, 4838, 5438, 6077, 6541, 7550, 8084, 8289, 8384, 8755, 8849, 9989, 10577, 10856]","[0, 271, 361, 607, 776, 910, 1362, 1536, 1658, 1998, 2675, 3126, 3513, 4013, 4147, 4555, 4721, 5393, 5802, 6027, 6506, 7304, 7709, 7914, 8257, 8733, 9039, 9134, 9230, 9553]",18403,15073,13043,10856,9553,91,74,97,53,84,"[0, 202, 456, 859, 1273, 1595, 1935, 2328, 2744, 3059, 3346, 3552, 4135, 5104, 5427, 6029, 6666, 7638, 8342, 8499, 9079, 9734, 10439, 11634, 12587, 14135, 14716, 15904, 16980, 17690]","[0, 281, 568, 994, 1462, 1740, 2104, 2412, 2813, 3080, 3606, 3916, 4292, 5118, 5383, 6441, 7396, 7843, 7999, 8290, 8776, 9166, 9875, 10647, 11682, 12753, 12928, 14099, 15608, 16556]","[0, 169, 381, 933, 1358, 1532, 2091, 2322, 2460, 2661, 3086, 3342, 3925, 4532, 5121, 5922, 6661, 7342, 8019, 8363, 9053, 9458, 10231, 10411, 11030, 12177, 12556, 13855, 14231, 14963]","[0, 130, 223, 439, 591, 768, 1234, 1414, 1740, 1967, 2148, 2238, 2503, 2892, 3295, 3887, 4357, 4802, 5578, 6316, 6735, 7433, 8092, 8310, 9455, 10547, 11222, 11945, 12632, 13262]","[0, 130, 220, 393, 571, 705, 841, 1305, 1566, 1656, 2071, 2197, 2403, 2590, 2917, 3479, 4235, 4658, 5086, 5243, 6370, 6688, 7701, 8077, 9486, 10352, 11025, 12063, 13307, 13700]",17690,16556,14963,13262,13700,713,-1483,-1920,-2406,-4147,-9243,30,dire
7530650619,120,41,78,68,123,"[0, 350, 640, 891, 1222, 1501, 1753, 2257, 2887, 3257, 3975, 4841, 5670, 6447, 7570, 8087, 8758, 9223, 9717, 10416, 11395, 12343, 13134, 13603, 14039, 14930, 15514, 16462, 17138, 18010]","[0, 350, 549, 797, 1106, 1514, 1821, 2204, 2576, 2892, 3230, 3740, 4327, 5039, 5582, 5775, 6338, 6888, 7616, 8159, 8835, 9604, 10328, 11061, 11613, 12672, 12930, 13302, 14194, 14685]","[0, 232, 510, 745, 983, 1371, 1703, 2103, 2481, 2983, 3204, 3736, 4264, 4764, 5370, 5464, 5760, 5855, 6236, 6524, 6887, 7182, 7707, 8338, 8521, 8965, 9336, 9827, 10272, 11345]","[0, 195, 285, 375, 549, 684, 819, 1190, 1390, 1652, 1885, 2203, 2546, 2875, 3236, 3389, 4098, 4394, 4979, 5177, 5748, 5926, 6335, 6781, 6912, 7079, 7173, 7645, 8343, 8520]","[0, 195, 285, 499, 731, 966, 1101, 1613, 2116, 2246, 2475, 2747, 3042, 3387, 3821, 4094, 4517, 4686, 5016, 5282, 5435, 5583, 6215, 6685, 6955, 7255, 7524, 7895, 8340, 8829]",18010,14685,11345,8520,8829,25,18,29,66,20,"[61, 308, 640, 1095, 1426, 1820, 2146, 2541, 2958, 3318, 3807, 4386, 4998, 5599, 6038, 6401, 6505, 7367, 8078, 8712, 9246, 9993, 10487, 10977, 11685, 12407, 13394, 13932, 14572, 15174]","[329, 535, 853, 1256, 1631, 1959, 2499, 2913, 3466, 3920, 4507, 5466, 6185, 6788, 7147, 7998, 8340, 9171, 9703, 10324, 10832, 11680, 12058, 12748, 12907, 13958, 14676, 15039, 15399, 15576]","[61, 459, 706, 1162, 1430, 1928, 2289, 2699, 3252, 3534, 4300, 4957, 5311, 5755, 6277, 6772, 7146, 7436, 8112, 8754, 9123, 9427, 9948, 10792, 11252, 11932, 12349, 12794, 13375, 13711]","[61, 290, 380, 564, 654, 857, 1099, 1632, 2192, 2342, 2637, 3007, 3172, 3431, 4048, 4799, 5268, 5558, 6171, 6788, 7117, 7368, 7908, 8347, 8617, 9197, 9600, 9879, 10214, 10741]","[61, 290, 380, 470, 560, 666, 756, 923, 1221, 1311, 1446, 1774, 2105, 2411, 2506, 3162, 3257, 3583, 4298, 4544, 4947, 5218, 5562, 5815, 5910, 6232, 6510, 6811, 7025, 7207]",15174,15576,13711,10741,7207,2836,-891,-2366,-2221,1622,-1020,30,dire
7530728311,48,39,96,79,26,"[0, 245, 442, 929, 1259, 1582, 2034, 2633, 3089, 3490, 3937, 4704, 5377, 5943, 6720, 7553, 9016, 9734, 10241, 10735, 11873, 12683, 13139, 13981, 14781, 15772, 16701, 17272, 17536, 18115]","[0, 244, 468, 783, 1061, 1375, 1906, 2041, 2564, 2914, 3499, 3932, 4442, 4681, 5175, 6198, 6939, 7370, 8259, 8705, 9264, 10384, 11325, 12260, 13192, 14013, 14736, 15183, 15718, 15814]","[0, 163, 443, 852, 1364, 1690, 2070, 2318, 2934, 3402, 4002, 4533, 5018, 5540, 5727, 6321, 7045, 7453, 7880, 8211, 8441, 9068, 9305, 9658, 10020, 10620, 10923, 11110, 11495, 11591]","[0, 129, 219, 346, 537, 627, 855, 983, 1118, 1263, 1398, 1673, 1801, 2075, 2456, 3016, 3562, 3847, 3942, 4374, 4743, 5421, 5769, 6311, 6406, 6770, 7011, 7344, 7971, 8067]","[0, 129, 219, 433, 572, 696, 921, 1288, 1519, 1664, 1799, 1916, 2373, 2507, 2846, 3395, 4221, 4355, 4596, 5046, 5452, 5763, 5857, 6072, 6543, 7170, 7374, 7469, 7646, 7787]",18115,15814,11591,8067,7787,8,17,98,121,45,"[0, 281, 518, 756, 1165, 1486, 1935, 2406, 2776, 3214, 3990, 4382, 4836, 5463, 6036, 6848, 7676, 8548, 9340, 10309, 11093, 11531, 11685, 12380, 12965, 13132, 14361, 15258, 16471, 17573]","[0, 325, 548, 913, 1087, 1254, 1555, 2016, 2582, 2772, 3373, 3885, 4446, 4862, 5290, 5715, 6374, 7085, 7742, 8193, 8402, 8569, 9485, 10207, 10933, 11414, 12229, 13009, 13618, 14164]","[0, 248, 573, 882, 1264, 1462, 1720, 1985, 2336, 2710, 3117, 3689, 3860, 4365, 4741, 5039, 5569, 6663, 7366, 8005, 8269, 8670, 9125, 9951, 10124, 10852, 11651, 12210, 12961, 13994]","[0, 209, 421, 553, 727, 908, 998, 1542, 1838, 2051, 2445, 2814, 3176, 3501, 3695, 3986, 4285, 4735, 5120, 5411, 5569, 6036, 6139, 6532, 6633, 6831, 7468, 7719, 8182, 8827]","[0, 209, 379, 856, 1141, 1283, 1373, 1594, 1767, 2021, 2427, 2521, 3012, 3590, 3760, 4276, 4587, 4920, 5261, 5427, 5585, 5824, 5920, 6305, 6625, 7142, 7478, 7690, 8185, 8974]",17573,14164,13994,8827,8974,542,1650,-2403,-760,-1187,-2158,30,dire
7530771503,38,61,129,90,65,"[1805, 2075, 2680, 3134, 3998, 4309, 5008, 5616, 6158, 6533, 7643, 8297, 8946, 9107, 9633, 10580, 11262, 12108, 13275, 14376, 15055, 15775, 16928, 17973, 19388, 19565, 20264, 21055, 21498, 22408]","[1022, 1417, 1666, 1974, 2314, 2953, 3704, 4132, 4887, 5565, 6345, 7147, 8428, 9041, 9862, 10721, 11375, 11738, 12386, 12981, 13593, 13996, 14555, 15178, 16543, 16850, 17623, 18294, 18586, 18964]","[1559, 2104, 2378, 2811, 3529, 3707, 4646, 5229, 5745, 6315, 6743, 7192, 7776, 8250, 8753, 9323, 9951, 10410, 11045, 11668, 12136, 12932, 13511, 14305, 15637, 16356, 17253, 17799, 18367, 19282]","[797, 905, 1211, 1436, 1743, 2013, 2302, 2392, 2700, 3189, 3524, 3830, 4455, 4614, 5208, 5989, 6214, 6581, 7184, 7583, 8023, 8686, 9300, 10326, 11321, 11878, 12770, 13219, 13394, 13632]","[541, 717, 1039, 1174, 1395, 1485, 1832, 2004, 2518, 2827, 3379, 3784, 4148, 4249, 4617, 5044, 5341, 5481, 6060, 6460, 6662, 7156, 7608, 7973, 8954, 9644, 10150, 10865, 11105, 11385]",22408,18964,19282,13632,11385,48,22,78,119,66,"[1530, 1820, 2395, 2835, 3292, 3819, 4269, 5002, 5607, 6032, 6641, 7314, 7967, 8761, 9541, 10699, 11257, 11954, 12970, 13690, 13937, 14231, 14977, 15280, 15763, 16974, 17804, 18822, 19346, 19623]","[1603, 1935, 2517, 3050, 3721, 4165, 4851, 5432, 5868, 6284, 6802, 7204, 8079, 9086, 9861, 10545, 11108, 11304, 12102, 12565, 13313, 14021, 14783, 15130, 15226, 16028, 16617, 16848, 17126, 17274]","[1153, 1385, 1676, 2099, 2254, 2671, 3327, 3748, 4367, 4676, 5164, 6007, 6408, 7232, 7895, 8200, 8660, 9231, 9526, 10343, 10971, 11286, 11933, 12075, 12174, 13258, 13657, 13757, 14346, 14924]","[502, 774, 904, 1040, 1181, 1278, 1529, 1999, 2285, 2490, 3155, 3379, 3556, 4073, 4231, 4417, 4586, 4777, 5054, 5358, 5537, 5914, 6129, 6298, 6469, 6961, 7286, 7445, 7675, 7775]","[753, 942, 1183, 1315, 1686, 2025, 2422, 2760, 2985, 3313, 3537, 4093, 4560, 4871, 5345, 5851, 6163, 6315, 6682, 7065, 7780, 8375, 8769, 8927, 9084, 9858, 10061, 10356, 10493, 10674]",19623,17274,14924,7775,10674,2785,1690,4358,5857,711,15401,30,radiant
7531040410,73,106,33,86,19,"[413, 839, 1110, 1671, 1885, 2457, 3252, 4049, 4580, 5259, 6157, 6788, 7445, 7957, 8805, 10156, 11119, 12194, 13566, 14673, 15985, 17342, 17757, 18110, 19767, 20480, 21303, 22719, 23608, 24452]","[284, 697, 1061, 1468, 1949, 2252, 2844, 3380, 4060, 4311, 4491, 4657, 5294, 5868, 6498, 7023, 7422, 7775, 9111, 9614, 9888, 10744, 11650, 12645, 13403, 14169, 14840, 15545, 16235, 16812]","[285, 673, 1019, 1335, 1656, 2159, 2605, 2933, 3308, 3899, 4953, 5274, 5923, 6259, 6651, 7266, 7870, 8197, 8871, 9586, 10553, 11367, 11916, 13073, 13605, 14414, 14850, 15370, 16061, 16788]","[209, 299, 433, 612, 726, 863, 1124, 1214, 1405, 1495, 1796, 2202, 2504, 2668, 2949, 3236, 3585, 3679, 4088, 4311, 4625, 5285, 5503, 5931, 6173, 6587, 6838, 7300, 7901, 8177]","[209, 299, 437, 618, 812, 1176, 1356, 1446, 1593, 1683, 1999, 2354, 2812, 3314, 3744, 4299, 4485, 4579, 5035, 5220, 5538, 6068, 6163, 6412, 6579, 7151, 7358, 7535, 7879, 8165]",24452,16812,16788,8177,8165,89,23,21,26,68,"[164, 483, 759, 961, 1129, 1536, 1797, 2192, 2582, 3106, 3552, 4149, 4953, 5552, 6214, 6976, 8077, 8673, 9723, 10575, 12133, 13227, 14253, 15071, 15799, 16976, 17509, 18821, 19362, 19850]","[179, 469, 770, 980, 1177, 1482, 2156, 2537, 3077, 3964, 4484, 5034, 5419, 5817, 6508, 7453, 8035, 8898, 9421, 10287, 10870, 11292, 11598, 12239, 12623, 13397, 14077, 14855, 15143, 15739]","[314, 583, 832, 1300, 1465, 1867, 2290, 2663, 3192, 4097, 5022, 5480, 6005, 6475, 7065, 7619, 8307, 8798, 8893, 9064, 9577, 10135, 10809, 11568, 12114, 12920, 13200, 13666, 14191, 14552]","[129, 219, 676, 1001, 1103, 1193, 1404, 1539, 1731, 2219, 2470, 3004, 3506, 3615, 3811, 4102, 4359, 4903, 4998, 5093, 5350, 5522, 5934, 6801, 7138, 7445, 7540, 8031, 8237, 8710]","[129, 219, 374, 464, 554, 704, 828, 1012, 1138, 1407, 1497, 1858, 2054, 2384, 2539, 2992, 3647, 3991, 4258, 4537, 4949, 5043, 5261, 5682, 5777, 6042, 6137, 6323, 6529, 6793]",19850,15739,14552,8710,6793,4602,1073,2236,-533,1372,8750,30,radiant
7531077704,95,106,98,121,103,"[236, 563, 1000, 1368, 1728, 2302, 2665, 3236, 3864, 4624, 5065, 5847, 6420, 7380, 8044, 8677, 9719, 10491, 11044, 11941, 12883, 13547, 14876, 15663, 16540, 17300, 18647, 19957, 20405, 21846]","[281, 629, 1085, 1247, 1417, 1705, 1892, 2250, 2746, 3455, 4038, 4551, 5098, 5659, 5985, 6400, 6849, 7720, 8089, 8928, 9192, 10412, 11300, 12332, 12773, 13381, 14611, 15396, 15622, 16083]","[278, 565, 1060, 1361, 1718, 1965, 2349, 2742, 3306, 4330, 4857, 5390, 5930, 6220, 6640, 6950, 7342, 7727, 8151, 8831, 9356, 10037, 10263, 10844, 11251, 11706, 12104, 12661, 12757, 12955]","[504, 594, 804, 1016, 1180, 1355, 1664, 2012, 2157, 2808, 3018, 3198, 3626, 3872, 4089, 4560, 4901, 5320, 5478, 5904, 6000, 6301, 6465, 6745, 7097, 7391, 8335, 8832, 9187, 9660]","[236, 329, 433, 539, 629, 719, 854, 1035, 1307, 1901, 2143, 2372, 2643, 2796, 2972, 3187, 3557, 3866, 4024, 4452, 4548, 4849, 5398, 5798, 6075, 6294, 6669, 7091, 7297, 7393]",21846,16083,12955,9660,7393,114,53,62,129,45,"[170, 507, 828, 1205, 1578, 2113, 2367, 2806, 3014, 3339, 4019, 4414, 4952, 5303, 6222, 6610, 7146, 7630, 7968, 8480, 9131, 9387, 9897, 10400, 11018, 11560, 12390, 12826, 13239, 13758]","[286, 419, 549, 724, 863, 1063, 1364, 1680, 1891, 2427, 2650, 2854, 3456, 3722, 4172, 4485, 4888, 5040, 5548, 5835, 6089, 6975, 7272, 7867, 8307, 8788, 9590, 9971, 10547, 10643]","[302, 745, 1214, 1722, 2121, 2724, 3250, 3430, 3710, 4466, 4768, 5033, 5230, 5521, 5830, 6145, 6550, 6705, 6901, 7344, 7855, 8417, 9062, 9183, 9595, 9845, 10515, 10983, 11188, 11284]","[170, 523, 827, 1084, 1284, 1904, 2240, 2651, 2891, 3130, 3220, 3630, 3976, 4361, 4813, 5385, 6370, 6520, 6678, 7036, 7279, 7848, 8118, 8487, 9014, 9193, 9663, 10097, 10441, 10537]","[208, 298, 388, 581, 719, 1263, 1443, 1533, 1682, 2091, 2181, 2488, 2583, 2677, 2772, 2930, 3452, 3877, 4035, 4176, 4462, 4800, 5030, 5266, 5701, 5868, 6042, 6219, 6528, 6624]",13758,10643,11284,10537,6624,8088,5440,1671,-877,769,15091,30,radiant
7531469911,76,21,28,91,83,"[0, 291, 509, 802, 1208, 1455, 1791, 2156, 2575, 3011, 3339, 4135, 4726, 5351, 5948, 6494, 6607, 7322, 8085, 8875, 9264, 10771, 11290, 11863, 13290, 14138, 14957, 15477, 16714, 17433]","[0, 285, 519, 859, 1060, 1547, 1940, 2576, 2925, 3500, 3961, 4496, 5062, 6184, 6896, 7348, 8363, 8985, 9974, 10679, 11127, 11654, 12284, 13207, 13801, 14767, 15335, 16889, 17606, 18407]","[0, 207, 379, 591, 1049, 1367, 1698, 2263, 2849, 3764, 4134, 4669, 5140, 5713, 6295, 6916, 7288, 7944, 8517, 8886, 9199, 10696, 11117, 11763, 12185, 12937, 13470, 14171, 15232, 16251]","[0, 170, 260, 350, 544, 718, 860, 1007, 1246, 1707, 1844, 1934, 2311, 2925, 3200, 3664, 3767, 4226, 4972, 5489, 5691, 6422, 6589, 6780, 7281, 7997, 8374, 9141, 9631, 10946]","[0, 170, 365, 501, 591, 1072, 1262, 1469, 1840, 2089, 2179, 2507, 3008, 3434, 4050, 4282, 4538, 4745, 5410, 5794, 5889, 7005, 7172, 7266, 7527, 8220, 8538, 8837, 9428, 9821]",17433,18407,16251,10946,9821,113,109,96,100,68,"[0, 313, 565, 851, 1311, 1604, 2000, 2333, 2904, 3605, 4259, 5164, 5677, 6221, 7067, 7437, 8488, 9046, 9621, 10909, 12387, 12867, 14104, 14519, 15317, 15704, 16446, 16987, 17993, 18161]","[0, 272, 868, 1260, 1574, 1966, 2414, 3030, 3203, 3436, 4442, 5042, 5694, 6076, 6336, 6940, 7916, 8566, 8998, 9584, 10400, 10680, 11376, 12659, 13360, 13913, 14607, 15334, 15620, 16841]","[0, 205, 520, 846, 1247, 1374, 1722, 1965, 2219, 2602, 3133, 3776, 4183, 4706, 4952, 5508, 6423, 6939, 7124, 7988, 8246, 8341, 8824, 9090, 9185, 9333, 9477, 9654, 9750, 10248]","[0, 505, 870, 976, 1066, 1205, 1385, 1551, 1686, 1815, 2168, 2420, 2511, 2660, 3087, 3182, 3712, 4077, 4301, 4766, 5317, 5443, 5845, 6135, 6305, 6475, 6848, 7189, 7360, 7531]","[0, 237, 327, 464, 639, 767, 892, 1025, 1196, 1286, 1636, 1888, 1987, 2136, 2285, 2563, 2966, 3169, 3354, 3592, 3908, 4056, 4492, 4870, 5040, 5370, 5700, 6278, 6449, 6937]",18161,16841,10248,7531,6937,-728,1566,6003,3415,2884,13140,30,radiant
7531515518,4,102,19,105,45,"[275, 627, 871, 1416, 1726, 2252, 2757, 3151, 3637, 4146, 4789, 5554, 6367, 6932, 7626, 8437, 9220, 9861, 11149, 12183, 13178, 14319, 15274, 15987, 16740, 17850, 19188, 19909, 20731, 21695]","[355, 711, 836, 1198, 1518, 1794, 2215, 2772, 3293, 3778, 4546, 5121, 5669, 6198, 6950, 7356, 7895, 7990, 8377, 9132, 9663, 10194, 11199, 11610, 12147, 12909, 13188, 13565, 14725, 15445]","[345, 677, 1015, 1315, 1615, 1943, 2423, 2660, 3031, 3317, 3734, 4220, 4577, 5038, 5420, 6268, 6474, 6686, 7193, 7767, 8262, 8889, 9615, 10002, 10362, 10950, 11333, 11961, 12681, 13373]","[195, 285, 375, 531, 946, 1088, 1702, 1866, 2234, 2416, 3132, 3436, 3855, 4127, 4225, 4729, 4870, 4965, 5958, 6388, 6605, 7109, 7777, 8220, 8915, 9473, 9892, 10144, 10778, 11399]","[195, 285, 375, 510, 632, 767, 1301, 1391, 1644, 1994, 2505, 2799, 2995, 3347, 3724, 4070, 4389, 4531, 4688, 4820, 4915, 5248, 5706, 5801, 5896, 6321, 6474, 7024, 7723, 8228]",21695,15445,13373,11399,8228,73,21,13,65,100,"[430, 724, 966, 1302, 1786, 2280, 2504, 3042, 3447, 4021, 4781, 5780, 6551, 7524, 8325, 9210, 10800, 11579, 12507, 12728, 13735, 15604, 16653, 17583, 18361, 19354, 19893, 20741, 20977, 21461]","[170, 530, 943, 1361, 1723, 2202, 2579, 2875, 3038, 3885, 4290, 4798, 5514, 6077, 6483, 7247, 7535, 8327, 8822, 9274, 9595, 10363, 11229, 11976, 12629, 13377, 13925, 14553, 14649, 14745]","[289, 517, 829, 1112, 1482, 1743, 2270, 2525, 2912, 3262, 3769, 4025, 4405, 4729, 5212, 5388, 5999, 6975, 7460, 8096, 8800, 9522, 9827, 10334, 10975, 11604, 12193, 12704, 13017, 13113]","[170, 285, 490, 658, 1205, 1295, 1471, 1576, 1693, 1936, 2413, 2768, 2971, 3448, 3542, 4314, 4472, 4896, 5382, 5615, 6025, 6516, 6685, 7034, 7727, 8365, 8534, 8948, 9119, 9520]","[170, 285, 405, 621, 751, 841, 978, 1113, 1203, 1429, 1631, 2034, 2403, 2766, 3131, 3562, 3779, 4083, 4445, 4669, 5017, 5567, 5770, 6189, 6387, 6749, 7338, 7931, 8102, 8239]",21461,14745,13113,9520,8239,234,700,260,1879,-11,3062,30,radiant
7531643102,41,114,128,5,100,"[0, 208, 409, 703, 1257, 1593, 1861, 2483, 3039, 3443, 3940, 4345, 4708, 5169, 5795, 6384, 6945, 7174, 7936, 8162, 8257, 8525, 9466, 9777, 10039, 10383, 10962, 11365, 11551, 11832]","[0, 325, 667, 1073, 1358, 1659, 2238, 2922, 3350, 3817, 4285, 4465, 5051, 5348, 5788, 6003, 6572, 6795, 7272, 7376, 7644, 7861, 8237, 8331, 8797, 8892, 9628, 10454, 10640, 10789]","[0, 294, 959, 1201, 1481, 1984, 2515, 2650, 3126, 3564, 3745, 3835, 4140, 4587, 4871, 5097, 5264, 5895, 6880, 6974, 7069, 7290, 7588, 7682, 7841, 8148, 9361, 9657, 10307, 10716]","[0, 169, 352, 493, 724, 858, 1270, 1489, 1805, 1985, 2395, 2495, 2715, 3103, 3397, 3821, 4100, 4441, 4918, 5186, 5281, 5558, 5739, 5886, 6214, 6346, 7015, 7253, 7439, 7545]","[0, 169, 325, 415, 505, 735, 935, 1199, 1429, 1899, 2080, 2170, 2260, 2514, 2799, 3045, 3487, 3801, 3896, 3990, 4085, 4360, 4455, 4549, 4767, 5031, 5497, 5794, 5980, 6076]",11832,10789,10716,7545,6076,70,69,106,72,121,"[0, 284, 488, 1031, 1478, 2021, 2433, 3230, 3572, 3832, 4959, 5450, 6050, 6731, 6826, 8180, 9152, 10098, 10541, 11424, 12037, 12974, 13546, 14520, 15603, 16890, 16985, 17460, 18522, 19645]","[0, 273, 552, 698, 1279, 1643, 2014, 2376, 2749, 3257, 3809, 4382, 5103, 5621, 6336, 7104, 8120, 9093, 9348, 10571, 11759, 12552, 13507, 14411, 15007, 15742, 16337, 16713, 17478, 18807]","[0, 207, 419, 795, 1113, 1376, 1718, 1847, 1989, 2574, 3486, 3730, 4206, 4832, 5171, 5685, 6287, 7060, 7691, 8523, 9053, 10017, 10396, 11088, 11942, 12999, 13228, 13925, 14599, 15420]","[0, 215, 350, 476, 650, 784, 1249, 1455, 1834, 2230, 2757, 2847, 2937, 3573, 3668, 4251, 5103, 5556, 5819, 6475, 6732, 7414, 8094, 8834, 9376, 10143, 10494, 10917, 11585, 12357]","[0, 169, 305, 521, 763, 1145, 1572, 1946, 2167, 2361, 2541, 2631, 2762, 3241, 3336, 4026, 4874, 5435, 5997, 6392, 6829, 7222, 7465, 7929, 8558, 9230, 9325, 9732, 10048, 10821]",19645,18807,15420,12357,10821,-7813,-8018,-4704,-4812,-4745,-30092,30,dire
7531673702,95,69,106,121,79,"[0, 343, 708, 959, 1286, 1570, 2027, 2521, 3121, 3784, 4280, 4767, 5642, 6301, 6845, 7211, 8349, 9115, 9394, 9823, 10406, 11070, 11935, 12540, 14356, 15330, 16388, 17153, 18093, 18942]","[0, 328, 704, 987, 1393, 1750, 2456, 2705, 3369, 3966, 4498, 5056, 5796, 6135, 6792, 7290, 7698, 8621, 9521, 10305, 10588, 10843, 11038, 11777, 12334, 12662, 13027, 13417, 13829, 14286]","[0, 205, 600, 852, 1251, 1628, 1835, 2497, 2998, 3178, 3925, 4277, 4811, 5277, 5567, 6035, 6283, 6676, 7372, 7788, 8071, 8166, 8782, 9703, 10307, 10763, 11197, 11921, 12456, 12929]","[0, 170, 360, 450, 587, 778, 1029, 1274, 1858, 2200, 3094, 3544, 3724, 3873, 4412, 4851, 5222, 5679, 6203, 6474, 6859, 7169, 7383, 8230, 8708, 9060, 9387, 9748, 10123, 10650]","[0, 505, 662, 833, 977, 1088, 1407, 1846, 2169, 2383, 3263, 3481, 3752, 3948, 4344, 4822, 5252, 5485, 5764, 5928, 6402, 6497, 6652, 7500, 7978, 8330, 8783, 9410, 9740, 10154]",18942,14286,12929,10650,10154,25,67,104,26,83,"[0, 328, 558, 803, 1234, 1665, 2034, 2532, 2965, 3876, 3976, 4544, 5103, 5566, 5957, 6492, 7241, 7607, 8415, 9797, 10106, 11427, 12013, 12831, 13100, 13371, 14123, 14853, 15844, 16328]","[0, 240, 567, 894, 1144, 1557, 1897, 2280, 2534, 3064, 3202, 3421, 4058, 4153, 5694, 6229, 6799, 7495, 7829, 8489, 8977, 10545, 11296, 12120, 13325, 14132, 14688, 15446, 16125, 16802]","[0, 170, 481, 698, 1003, 1294, 1655, 2005, 2219, 2610, 2773, 3368, 3745, 4432, 5510, 5604, 6405, 6500, 7342, 7907, 8151, 9211, 9306, 9482, 10059, 10548, 10831, 11396, 11668, 11764]","[0, 170, 728, 856, 946, 1076, 1166, 1344, 1488, 1840, 1930, 2199, 2397, 2629, 3476, 3570, 4299, 4394, 4690, 5646, 6235, 6854, 6949, 7115, 7658, 7753, 7929, 8505, 8922, 9338]","[0, 170, 260, 407, 497, 760, 898, 1027, 1117, 1454, 1544, 1814, 2095, 2190, 3107, 3252, 3678, 4009, 4230, 5085, 5398, 6387, 6779, 6945, 7040, 7303, 7587, 7758, 8197, 8368]",16328,16802,11764,9338,8368,2614,-2516,1165,1312,1786,4361,30,radiant
7531796410,54,25,55,21,5,"[0, 293, 698, 1108, 1433, 1831, 2213, 2746, 3284, 3912, 4494, 4960, 5614, 6261, 6823, 7429, 8279, 8561, 9062, 9367, 10268, 11519, 12567, 13456, 14769, 15673, 17140, 17509, 17605, 19384]","[0, 204, 372, 802, 1162, 1462, 1950, 2498, 2799, 3525, 4308, 4942, 5742, 6369, 6896, 7583, 8959, 9664, 9913, 10533, 10754, 12146, 12636, 13194, 13363, 14161, 15449, 16206, 16302, 16632]","[0, 240, 665, 1160, 1603, 2040, 2428, 3072, 3699, 4316, 5087, 5731, 6465, 6770, 7250, 8081, 8747, 9214, 9760, 10582, 11262, 12345, 12783, 13316, 14491, 14695, 15587, 15977, 16110, 16440]","[0, 170, 272, 407, 545, 696, 786, 923, 1013, 1193, 1333, 1469, 1667, 1896, 2272, 2727, 3037, 3397, 3705, 4105, 4539, 5333, 5769, 6043, 6844, 7161, 7881, 8294, 8484, 9238]","[0, 170, 268, 404, 511, 601, 764, 854, 1024, 1204, 1398, 1488, 1721, 1916, 2058, 2243, 2783, 2924, 3076, 3311, 3532, 4052, 4219, 4386, 4791, 5061, 5400, 5712, 5847, 6353]",19384,16632,16440,9238,6353,8,2,13,114,84,"[0, 253, 624, 989, 1509, 2085, 2664, 3342, 3933, 4665, 5335, 6127, 6702, 7451, 8248, 9111, 9782, 11274, 11940, 12862, 14417, 15438, 17250, 18237, 19231, 20288, 20923, 22445, 23851, 26323]","[0, 200, 407, 861, 1280, 1525, 2325, 2798, 3302, 3911, 4536, 5170, 5816, 6612, 7208, 7788, 8557, 9471, 10067, 11273, 12617, 12806, 13156, 13804, 14928, 15094, 15547, 15751, 16705, 18208]","[0, 240, 603, 895, 1260, 1660, 2171, 2824, 3367, 3837, 4431, 4951, 5345, 5950, 6540, 7322, 7417, 8275, 8924, 9815, 11063, 11622, 11717, 12829, 13459, 13924, 14451, 14635, 15212, 17172]","[0, 179, 273, 409, 550, 695, 895, 1246, 1336, 1672, 2016, 2177, 2402, 2954, 3258, 3526, 3621, 4018, 4113, 4555, 4776, 4870, 5273, 5570, 5665, 5831, 6061, 6775, 7727, 8553]","[0, 130, 220, 310, 447, 583, 801, 1114, 1248, 1387, 1563, 1653, 1743, 1938, 2032, 2252, 2347, 2576, 2671, 2856, 3162, 3256, 3351, 3446, 3576, 3742, 3972, 5227, 6076, 6735]",26323,18208,17172,8553,6735,-6939,-1576,-732,685,-382,-8944,30,dire
7531926406,46,13,121,71,5,"[0, 325, 650, 1073, 1355, 1783, 2182, 2864, 3280, 3940, 4798, 5248, 5875, 6566, 7369, 8226, 8987, 10323, 11312, 12309, 13643, 16356, 17780, 18871, 20141, 20774, 21381, 21476, 22368, 22524]","[0, 328, 698, 1147, 1517, 1892, 2562, 3076, 3721, 4269, 4760, 5174, 5889, 6107, 6691, 7637, 7940, 8485, 9100, 9505, 10376, 11051, 12571, 12885, 13106, 14142, 16016, 16111, 16361, 16457]","[0, 169, 259, 779, 943, 1152, 1298, 1434, 1669, 2061, 2151, 2343, 2687, 2782, 3047, 3231, 3528, 3910, 4122, 4366, 4792, 5498, 6207, 6592, 7170, 8851, 9387, 9734, 9905, 10076]","[0, 278, 513, 940, 1127, 1693, 1978, 2197, 3018, 3561, 3889, 4153, 4794, 5052, 5238, 5422, 5517, 5963, 6344, 7080, 7826, 8577, 9338, 9602, 9837, 10927, 11774, 12323, 12553, 12649]","[0, 169, 293, 435, 525, 646, 741, 831, 941, 1072, 1206, 1385, 2091, 2226, 2442, 2795, 2897, 3201, 3296, 3611, 4095, 4331, 4965, 5651, 5807, 6606, 7252, 7347, 7672, 7768]",22524,16457,10076,12649,7768,4,106,55,86,83,"[0, 296, 649, 1098, 1746, 2066, 2563, 3566, 4046, 4364, 5257, 6243, 6805, 7447, 7988, 9062, 10141, 11361, 12292, 13006, 13580, 13675, 14033, 15357, 15654, 15953, 17626, 18904, 21335, 22629]","[0, 326, 776, 1119, 1581, 1990, 2479, 3311, 3827, 4297, 4937, 5338, 5855, 6412, 7195, 8297, 9420, 9758, 10427, 10969, 11282, 11740, 11883, 12321, 13177, 13455, 13716, 14815, 16368, 17222]","[0, 245, 476, 681, 1160, 1487, 1733, 2118, 2422, 2512, 2852, 3114, 3489, 3798, 4603, 5155, 5634, 6506, 6901, 7335, 7522, 7732, 8384, 8515, 10189, 10284, 11622, 12013, 13801, 15036]","[0, 169, 307, 444, 625, 822, 912, 1344, 1434, 1681, 1975, 2323, 2577, 2901, 3070, 3425, 3832, 4336, 4431, 4612, 4996, 5091, 5242, 5917, 6475, 6570, 6664, 7055, 7899, 8195]","[0, 169, 259, 349, 577, 667, 757, 1309, 1518, 1608, 1925, 2198, 2288, 2484, 2602, 2696, 2980, 3318, 3413, 3507, 3636, 3889, 3984, 4285, 4931, 5026, 5721, 5816, 6074, 6370]",22629,17222,15036,8195,6370,-105,-765,-4960,4454,1398,22,30,dire
7532057903,54,11,104,19,84,"[0, 244, 611, 1018, 1382, 1908, 2320, 2587, 3232, 3762, 4315, 4801, 5126, 5785, 6354, 6910, 7539, 8233, 8896, 9479, 11551, 13290, 13566, 14296, 14569, 16080, 16174, 17528, 18163, 19014]","[0, 252, 619, 863, 1231, 1487, 1822, 2068, 2520, 2955, 3297, 3839, 3953, 4518, 4960, 5480, 6187, 6750, 7330, 7714, 8412, 9037, 9474, 9793, 10426, 10759, 11109, 12487, 12854, 13782]","[0, 336, 700, 1014, 1389, 1668, 1908, 2260, 2732, 3274, 3618, 3973, 4253, 4870, 5136, 5454, 6104, 6479, 7315, 7759, 8712, 9088, 9584, 9903, 10259, 11097, 11191, 12490, 12725, 13311]","[0, 209, 299, 457, 589, 679, 769, 859, 949, 1129, 1256, 1346, 1651, 1848, 2063, 2242, 2620, 2970, 3164, 3632, 4592, 4805, 4899, 5218, 5698, 6488, 6981, 8020, 8116, 8634]","[0, 209, 299, 457, 563, 1083, 1221, 1311, 1401, 1654, 1761, 1944, 2034, 2363, 2458, 2635, 2990, 3230, 3406, 4037, 4267, 4891, 4985, 5561, 5700, 6123, 6403, 7096, 7192, 7346]",19014,13782,13311,8634,7346,48,22,14,114,20,"[0, 310, 593, 984, 1294, 1845, 2433, 3047, 3526, 4176, 5107, 5698, 6499, 7246, 8012, 8882, 10085, 10627, 11365, 12650, 14042, 15551, 16693, 17787, 19539, 21079, 21902, 22561, 22787, 24240]","[0, 275, 691, 1070, 1516, 1898, 2272, 2911, 3554, 4300, 4992, 5337, 5717, 6536, 7352, 7993, 8607, 9610, 9866, 11099, 11778, 12581, 13357, 14396, 15262, 16094, 16188, 16716, 17367, 18194]","[0, 229, 594, 927, 1378, 1659, 1942, 2218, 2663, 2982, 3305, 3816, 4185, 4908, 5431, 5995, 6701, 7255, 7814, 8272, 8628, 9104, 9700, 10918, 11587, 11682, 12109, 12542, 12833, 13378]","[0, 154, 244, 334, 627, 765, 900, 1035, 1125, 1320, 1663, 1753, 1843, 2100, 2195, 2497, 2813, 3053, 3195, 3506, 3980, 4237, 4503, 4974, 5371, 5665, 5759, 5967, 6248, 6746]","[0, 154, 294, 431, 561, 746, 885, 1020, 1110, 1244, 1592, 1825, 1959, 2216, 2311, 2561, 3028, 3433, 3742, 4149, 4505, 4762, 4928, 5148, 5545, 5640, 5734, 5876, 5972, 6313]",24240,18194,13378,6746,6313,-5226,-4412,-67,1888,1033,-6784,30,dire
7532211815,11,17,60,19,102,"[0, 256, 622, 840, 1190, 1461, 1771, 1990, 2355, 2760, 3023, 3543, 3980, 4581, 5283, 6137, 6691, 7230, 8161, 9335, 10037, 10655, 11337, 12262, 13024, 13857, 14441, 14642, 15097, 16028]","[0, 290, 666, 956, 1349, 1773, 2077, 2431, 2934, 3670, 4176, 4653, 4856, 5464, 6090, 7073, 7496, 8021, 9142, 9756, 10273, 11668, 12399, 13322, 13888, 14527, 15509, 15638, 16481, 17719]","[0, 244, 384, 680, 933, 1100, 1344, 1672, 1874, 2211, 2375, 3245, 3736, 4081, 4383, 4844, 5302, 5576, 6078, 6577, 7311, 8434, 8876, 9200, 9638, 10379, 11042, 11265, 11442, 12033]","[0, 170, 298, 418, 548, 678, 768, 1093, 1183, 1468, 1558, 1981, 2071, 2265, 2364, 2745, 2962, 3448, 3684, 3842, 4155, 5386, 5967, 6062, 6157, 6526, 6816, 7045, 7222, 7857]","[0, 170, 260, 380, 549, 679, 791, 881, 991, 1276, 1366, 1720, 1962, 2156, 2416, 2877, 3002, 3264, 3766, 3924, 4109, 4910, 5149, 5276, 5446, 5744, 6353, 6523, 6984, 7473]",16028,17719,12033,7857,7473,76,21,23,79,58,"[60, 303, 521, 882, 1222, 1483, 1857, 2273, 2841, 3214, 4268, 4556, 5180, 5782, 6447, 7122, 7823, 8710, 9863, 10627, 11882, 12467, 13166, 14149, 14631, 14929, 15718, 16028, 16996, 18180]","[328, 569, 850, 1190, 1595, 2049, 2401, 2866, 3394, 3529, 4255, 5186, 5990, 6730, 7218, 7391, 7721, 8300, 8723, 9525, 9933, 10027, 11088, 11588, 11966, 12413, 13448, 14600, 15976, 16783]","[60, 267, 553, 1019, 1318, 1591, 2017, 2369, 2782, 3228, 3756, 4336, 4910, 5847, 6472, 7160, 7622, 8573, 9111, 9774, 10795, 11049, 11660, 11954, 12502, 12900, 13515, 14322, 15086, 15788]","[60, 230, 320, 457, 577, 1104, 1414, 1549, 1729, 1999, 2089, 2377, 2718, 2921, 3316, 3924, 4082, 4288, 4445, 4738, 5018, 5112, 5311, 5406, 5501, 5686, 6204, 6577, 7031, 7387]","[60, 230, 320, 455, 575, 665, 873, 1008, 1143, 1278, 1532, 1858, 2077, 2427, 2770, 2956, 3397, 3556, 4047, 4340, 4691, 4785, 4946, 5333, 5544, 5729, 6122, 6816, 7499, 8084]",18180,16783,15788,7387,8084,-2152,936,-3755,470,-611,-5112,30,radiant
7532381012,113,120,97,128,45,"[0, 291, 797, 926, 1335, 1676, 2008, 2213, 2468, 2634, 2899, 3194, 3936, 4110, 4700, 4894, 5396, 6220, 6712, 7850, 8706, 9845, 10512, 11401, 12067, 12710, 13519, 14428, 15082, 16026]","[0, 222, 434, 801, 1185, 1444, 1688, 2045, 2495, 3139, 3229, 3627, 4254, 4550, 4726, 5039, 5419, 6518, 7019, 7606, 7763, 8794, 9524, 9866, 10486, 11076, 11431, 11719, 12407, 13038]","[0, 243, 449, 809, 1042, 1530, 1928, 2224, 2433, 2756, 3157, 3473, 4098, 4755, 4984, 5544, 5791, 6853, 7338, 8472, 9394, 9855, 10216, 10559, 11285, 12126, 12306, 12842, 12938, 13463]","[0, 170, 335, 459, 764, 873, 1044, 1219, 1344, 1565, 1655, 1745, 2344, 2779, 2874, 3053, 3183, 3968, 4144, 4615, 4872, 5256, 5453, 6034, 6128, 6439, 6534, 6888, 7059, 7479]","[0, 170, 304, 693, 783, 943, 1053, 1143, 1320, 1665, 1920, 2059, 2413, 2579, 2791, 3091, 3200, 3864, 4098, 4412, 4774, 5395, 5490, 5788, 5882, 6426, 6521, 6668, 6764, 6941]",16026,13038,13463,7479,6941,106,69,93,66,110,"[0, 254, 764, 988, 1402, 1821, 2343, 2725, 3210, 3546, 3960, 4373, 5263, 5636, 6076, 6513, 7541, 7962, 8551, 9207, 9477, 9970, 10630, 11307, 12044, 12465, 13337, 14262, 15254, 16060]","[0, 170, 755, 953, 1390, 1759, 2226, 2782, 3353, 3963, 4853, 5129, 5698, 6243, 6915, 7373, 8044, 8778, 9188, 9740, 10643, 11019, 11375, 11944, 12433, 12740, 13403, 14122, 14921, 15588]","[0, 242, 494, 694, 902, 1145, 1636, 1973, 2575, 3003, 3516, 4008, 4367, 5189, 5639, 6171, 6446, 7354, 7882, 8491, 9187, 9561, 10464, 10812, 11713, 12232, 12652, 13027, 14143, 14766]","[0, 170, 294, 384, 585, 742, 944, 1227, 1510, 1798, 2042, 2528, 2789, 3107, 3519, 3997, 4470, 5178, 5668, 6162, 6357, 7176, 7487, 7672, 8140, 8561, 9055, 9515, 10139, 10356]","[0, 170, 340, 430, 608, 738, 828, 963, 1191, 1351, 1908, 2033, 2251, 2658, 2902, 3153, 3643, 4142, 4769, 5454, 5887, 6246, 6691, 7009, 7528, 7770, 8033, 8371, 8696, 8916]",16060,15588,14766,10356,8916,-34,-2550,-1303,-2877,-1975,-8739,30,dire
7532385315,70,112,102,31,105,"[0, 237, 473, 614, 1041, 1279, 1844, 2038, 2508, 2669, 2870, 3386, 3780, 4198, 4540, 5298, 5695, 6299, 6671, 7177, 8054, 8415, 9329, 12190, 12997, 13092, 13648, 14181, 14468, 14564]","[0, 129, 377, 755, 1135, 1356, 1730, 2077, 2402, 2606, 2696, 3074, 3838, 4256, 4906, 5234, 5692, 5964, 6480, 6835, 7116, 7974, 8326, 9268, 10238, 10909, 11308, 12173, 12813, 13442]","[0, 204, 596, 921, 1207, 1569, 1924, 2050, 2387, 2741, 2831, 3085, 3298, 3581, 4154, 4638, 4899, 5084, 5424, 5861, 6055, 6467, 6888, 7270, 7437, 7777, 8263, 8715, 8881, 8977]","[0, 129, 219, 309, 444, 574, 834, 924, 1166, 1256, 1381, 1525, 1615, 1917, 2012, 2273, 2368, 2553, 2647, 2805, 2934, 3029, 3195, 3849, 4107, 4401, 4580, 5032, 5128, 5306]","[0, 129, 566, 656, 746, 957, 1047, 1137, 1227, 1317, 1539, 1771, 1861, 2046, 2141, 2343, 2477, 2667, 2850, 3243, 3636, 3936, 4155, 4280, 4491, 4586, 4740, 4884, 4980, 5136]",14564,13442,8977,5306,5136,48,128,29,53,26,"[0, 258, 455, 857, 1182, 1595, 1846, 2284, 2648, 3062, 3867, 4392, 5016, 5731, 6487, 7490, 8169, 9278, 10683, 11573, 12446, 12866, 13699, 15322, 16813, 18474, 19212, 20230, 21231, 24092]","[0, 287, 850, 1143, 1472, 2034, 2530, 2910, 3903, 4401, 5242, 5681, 5887, 6371, 6973, 7369, 8123, 8866, 9333, 9684, 10276, 10592, 10847, 11441, 12270, 12869, 13411, 14104, 14932, 16016]","[0, 283, 551, 885, 1356, 1766, 2309, 2769, 3236, 3431, 4115, 4421, 5129, 5653, 6480, 6748, 7091, 7718, 8159, 8691, 8943, 9173, 9649, 10301, 11097, 11789, 12128, 12337, 13031, 14395]","[0, 209, 299, 438, 548, 917, 1007, 1206, 1587, 1791, 2679, 2769, 3068, 3388, 4161, 4333, 4884, 5560, 5918, 6213, 6816, 7672, 8094, 9380, 9475, 10289, 10700, 10983, 11589, 12882]","[0, 209, 299, 389, 528, 961, 1158, 1516, 1833, 2165, 2713, 2803, 3541, 3752, 4201, 4570, 5036, 5661, 5853, 6106, 6439, 6669, 6919, 7574, 7773, 8568, 8743, 8943, 9120, 10374]",24092,16016,14395,12882,10374,-9528,-2574,-5418,-7576,-5238,-30334,30,dire
7532416205,48,15,17,114,110,"[683, 1051, 1227, 1728, 2187, 2672, 2995, 3445, 3976, 4703, 5300, 6030, 6409, 7161, 8359, 9091, 9954, 11156, 12155, 13311, 13810, 14942, 15979, 17263, 18520, 19825, 21314, 22766, 24174, 25683]","[513, 802, 1142, 1516, 2193, 2522, 3086, 3505, 4038, 4821, 5170, 5782, 6573, 7249, 7947, 8594, 9597, 10156, 10293, 10940, 11666, 13013, 13444, 13814, 14407, 14845, 15600, 16000, 16505, 17735]","[730, 900, 1215, 1460, 1945, 2384, 2756, 3316, 3699, 4251, 4341, 4624, 5497, 5987, 6393, 6949, 7462, 8230, 8610, 8705, 9275, 9958, 10514, 10906, 11987, 12233, 12693, 13324, 14033, 14801]","[597, 687, 1007, 1210, 1634, 1770, 2059, 2149, 2845, 3119, 3209, 3441, 3819, 4280, 4573, 4731, 5196, 5510, 5604, 5738, 6010, 6818, 7111, 7278, 7593, 7933, 8477, 8820, 9530, 10685]","[310, 446, 536, 711, 1095, 1185, 1535, 1625, 1821, 2397, 2688, 3001, 3241, 3598, 3845, 4125, 4864, 5004, 5148, 5605, 6397, 7185, 7518, 7760, 8301, 8572, 9071, 9404, 9975, 10773]",25683,17735,14801,10685,10773,73,19,112,105,136,"[726, 1076, 1477, 1987, 2171, 2704, 3071, 3799, 4323, 4994, 5502, 6133, 7132, 8196, 9156, 10102, 10636, 11546, 13123, 14958, 15406, 15501, 16200, 17039, 18051, 18959, 19366, 19983, 20366, 20501]","[676, 923, 1219, 1594, 1962, 2572, 3052, 3355, 3858, 3948, 4418, 5015, 5218, 5748, 5916, 6490, 6853, 7423, 8239, 8747, 9138, 9233, 9907, 10358, 11423, 11784, 12110, 12349, 12897, 13618]","[449, 758, 1314, 1444, 1649, 2001, 2279, 2523, 3163, 3270, 3636, 4280, 4924, 5264, 5358, 5860, 6819, 7182, 7733, 8056, 8544, 8892, 9815, 10232, 10722, 11413, 11602, 11826, 12018, 12117]","[404, 494, 816, 966, 1056, 1236, 1370, 1946, 2081, 2226, 2543, 2913, 3215, 3310, 3539, 3711, 4339, 4651, 4938, 5072, 5167, 5532, 5963, 6308, 6624, 7144, 7272, 7568, 7989, 8124]","[290, 424, 813, 943, 1033, 1213, 1448, 1680, 1982, 2194, 2546, 2840, 3043, 3138, 3232, 3327, 3708, 3911, 4737, 4997, 5092, 5618, 6099, 6509, 7006, 7101, 7197, 7383, 7694, 7829]",20501,13618,12117,8124,7829,5182,4117,2684,2561,2944,17488,30,radiant
7532553807,10,126,98,86,72,"[0, 205, 523, 731, 1136, 1295, 1706, 1948, 2316, 2665, 3202, 3776, 4430, 4822, 5398, 5770, 6327, 6786, 7655, 8023, 8597, 8997, 9516, 9922, 10413, 11272, 11942, 12643, 13398, 13847]","[0, 280, 497, 823, 1237, 1652, 1941, 2578, 3289, 3663, 4235, 4909, 5544, 6153, 6803, 7628, 7945, 8773, 9275, 9755, 10336, 10554, 11176, 11876, 11971, 12698, 13345, 13976, 14823, 15469]","[0, 167, 569, 1093, 1414, 1592, 1995, 2338, 2863, 3273, 3663, 4016, 4645, 4949, 5854, 6218, 6899, 7530, 7934, 8322, 9196, 9740, 10711, 11678, 11889, 12315, 12928, 13878, 14326, 15123]","[0, 130, 270, 439, 613, 703, 793, 921, 1011, 1231, 1502, 1787, 2044, 2609, 3075, 3345, 3968, 4425, 4519, 4702, 5448, 5977, 6228, 6669, 7112, 7759, 8324, 8600, 9131, 9227]","[0, 130, 220, 330, 509, 636, 726, 912, 1180, 1315, 1786, 1930, 2512, 2812, 3722, 3951, 4465, 5369, 5568, 5751, 6184, 6583, 6799, 7310, 7405, 8159, 8402, 8497, 8925, 9235]",13847,15469,15123,9227,9235,4,13,112,19,26,"[0, 244, 485, 728, 1173, 1591, 2021, 2396, 2676, 3069, 3464, 3997, 4483, 5040, 5399, 5904, 6528, 7123, 7713, 8938, 9402, 9751, 10007, 10819, 12323, 13029, 13569, 14731, 15491, 16688]","[0, 289, 644, 1032, 1274, 1693, 2095, 2384, 2671, 3047, 3485, 3753, 4159, 4834, 4928, 5405, 5605, 6107, 6324, 7449, 8153, 9065, 9845, 10135, 11047, 11142, 11640, 12388, 13271, 13957]","[0, 210, 498, 770, 1061, 1416, 1791, 2155, 2646, 2974, 3354, 3444, 3627, 4075, 4611, 5031, 5513, 5732, 6412, 7310, 7884, 8118, 8826, 8993, 9907, 10757, 11109, 11768, 12292, 13194]","[0, 210, 300, 390, 607, 932, 1067, 1202, 1571, 1915, 2333, 2506, 2632, 3335, 3466, 4350, 4514, 4824, 5566, 6270, 6365, 6734, 7133, 8112, 8663, 9231, 9572, 10225, 10492, 11207]","[100, 310, 442, 583, 708, 1105, 1244, 1430, 1619, 1781, 2144, 2488, 2578, 2781, 3172, 3671, 4255, 4626, 4995, 5449, 5544, 5893, 6093, 6598, 7054, 7558, 7652, 8001, 8268, 8451]",16688,13957,13194,11207,8451,-2841,1512,1929,-1980,784,-596,30,radiant
7532722008,63,114,96,110,26,"[674, 1124, 1604, 1943, 2350, 2871, 3477, 3727, 4649, 4977, 5157, 5443, 6303, 6956, 7624, 8319, 8649, 9589, 10330, 11206, 11638, 12317, 12918, 13676, 14892, 15487, 16445, 17319, 18441, 20758]","[730, 1032, 1445, 1778, 2623, 3144, 3620, 3887, 4239, 4803, 5251, 5551, 5979, 6701, 6967, 7508, 7931, 8498, 9090, 9562, 9759, 10429, 11214, 11767, 12429, 12779, 13619, 14398, 14858, 15694]","[709, 942, 1261, 1544, 2013, 2525, 2952, 3388, 3931, 4440, 5060, 5498, 5764, 6353, 6800, 7057, 7683, 8569, 8752, 9220, 9408, 9985, 10748, 11429, 11523, 12042, 12574, 13614, 13903, 15444]","[324, 482, 833, 972, 1107, 1356, 1526, 1661, 1987, 2077, 2556, 2835, 2990, 3481, 3710, 3805, 4063, 4315, 4626, 4870, 4964, 5230, 5610, 5973, 6067, 6207, 6653, 7013, 7199, 8032]","[530, 681, 815, 905, 1181, 1552, 1709, 1967, 2195, 2523, 2703, 2843, 2937, 3542, 3818, 3913, 4171, 4493, 4588, 4683, 4777, 4959, 5296, 5463, 5601, 5696, 6319, 6496, 6682, 7332]",20758,15694,15444,8032,7332,106,54,69,86,58,"[915, 1085, 1329, 1732, 2029, 2516, 2860, 3364, 3781, 4362, 4680, 5544, 6200, 6506, 7385, 8395, 9182, 9599, 9894, 10524, 10913, 11485, 12257, 13067, 13774, 14413, 15125, 15807, 16067, 16639]","[559, 996, 1402, 1806, 2214, 2567, 3379, 3844, 4461, 5174, 5625, 6736, 7320, 7884, 8290, 8984, 9784, 10486, 11164, 11830, 12127, 13278, 13508, 14161, 15099, 15785, 16256, 16884, 17575, 17918]","[508, 598, 926, 1122, 1488, 2083, 2487, 2975, 3301, 3834, 4304, 4827, 5764, 6211, 6821, 7672, 8337, 9390, 9814, 10144, 10551, 11178, 11462, 12073, 12899, 13326, 13744, 13932, 14307, 14696]","[336, 537, 742, 916, 1128, 1313, 1529, 1759, 1992, 2178, 2745, 3136, 3452, 3636, 4084, 4422, 4895, 5191, 5361, 5583, 6041, 6588, 6930, 7536, 7961, 8131, 8464, 8731, 9340, 9882]","[350, 458, 629, 768, 858, 1061, 1280, 1509, 1724, 1947, 2392, 3047, 3318, 3696, 4018, 4356, 4673, 5050, 5524, 5748, 6761, 7177, 7568, 8004, 8546, 8737, 8995, 9342, 9716, 10093]",16639,17918,14696,9882,10093,4119,-2224,748,-1850,-2761,-1968,30,radiant
7532848119,14,74,15,5,100,"[62, 267, 549, 836, 1252, 1732, 2253, 2807, 3152, 3622, 4104, 4641, 5244, 5501, 5768, 6416, 7279, 7638, 7733, 9000, 9466, 10148, 10728, 11056, 11190, 11741, 12645, 13124, 13220, 13938]","[62, 264, 471, 838, 1177, 1551, 2036, 2463, 2942, 3330, 3604, 4041, 4737, 4832, 5062, 5686, 6381, 7207, 7762, 8456, 8822, 9492, 9857, 10130, 10225, 10722, 11076, 11255, 11689, 12265]","[62, 191, 426, 705, 1163, 1322, 1571, 1774, 2260, 2783, 3159, 3706, 4248, 4796, 5052, 5454, 5964, 6507, 7045, 7793, 8240, 8911, 9319, 9681, 9776, 10428, 10522, 11062, 11892, 12118]","[430, 604, 714, 804, 980, 1156, 1347, 1654, 2029, 2119, 2209, 2346, 2608, 2796, 3199, 3331, 3677, 4206, 4301, 4730, 5254, 5421, 5588, 5682, 5946, 6041, 6135, 6279, 6375, 6471]","[62, 243, 333, 423, 650, 740, 875, 1010, 1332, 1422, 1512, 1744, 1926, 2021, 2236, 2330, 2488, 2736, 3017, 3605, 4157, 4324, 4491, 4585, 4824, 5041, 5135, 5384, 5480, 5576]",13938,12265,12118,6471,5576,120,41,137,64,26,"[0, 291, 622, 1001, 1486, 1906, 2393, 2788, 3320, 3718, 4618, 5204, 5792, 6752, 7108, 7938, 8485, 9628, 10586, 10743, 11786, 12408, 12782, 13765, 14983, 15659, 16740, 17714, 18086, 19215]","[0, 254, 485, 729, 1044, 1320, 1609, 2018, 2622, 3119, 3781, 4335, 4859, 6024, 6119, 6492, 7470, 7855, 8225, 8849, 9747, 10858, 11031, 11383, 12431, 13167, 14444, 15206, 15710, 16683]","[0, 243, 454, 725, 1009, 1294, 1498, 1830, 2170, 2956, 3562, 3962, 4230, 4687, 4890, 5628, 6277, 6969, 7759, 8566, 9113, 9823, 10035, 10772, 11732, 12511, 12992, 13354, 13616, 14655]","[0, 209, 338, 465, 595, 746, 962, 1097, 1417, 1586, 2131, 2620, 2744, 3180, 3721, 4024, 4417, 5004, 5563, 5755, 6227, 6428, 6674, 7236, 7822, 8379, 9041, 9924, 10464, 11163]","[100, 309, 435, 759, 889, 979, 1195, 1330, 1802, 2262, 2617, 2901, 3103, 3624, 3758, 4089, 4394, 4819, 5108, 5265, 5759, 5854, 5949, 6301, 6955, 7266, 7666, 7894, 7990, 8600]",19215,16683,14655,11163,8600,-5277,-4418,-2537,-4692,-3024,-19948,30,dire
7532959919,48,120,60,26,91,"[0, 174, 424, 757, 1040, 1555, 1766, 2741, 3284, 3704, 4193, 4894, 5501, 6127, 6336, 6943, 7546, 7830, 8574, 9363, 10268, 11001, 11732, 13036, 14334, 14904, 15695, 16466, 17112, 17808]","[0, 200, 489, 823, 1223, 1399, 1602, 2205, 2597, 3213, 3753, 4034, 4825, 5149, 5244, 6002, 6557, 7179, 7843, 8204, 8841, 9345, 9776, 10430, 11089, 11329, 12152, 12464, 13142, 13802]","[0, 166, 444, 702, 878, 1124, 1408, 2046, 2328, 2662, 3148, 3431, 3932, 4279, 4456, 5383, 5862, 6245, 6801, 7282, 8015, 8210, 8611, 9352, 9734, 10271, 10366, 10677, 11102, 11328]","[0, 130, 566, 852, 942, 1032, 1122, 1675, 1765, 1940, 2154, 2244, 2616, 2809, 2904, 3133, 3291, 3737, 3970, 4086, 4287, 4382, 4549, 5105, 5255, 5350, 5479, 6074, 6499, 6725]","[0, 130, 220, 310, 400, 535, 625, 1352, 1571, 1706, 2038, 2128, 2680, 2873, 2968, 3153, 3311, 3495, 3680, 3775, 3932, 4027, 4194, 4693, 4832, 4976, 5115, 5502, 6002, 6596]",17808,13802,11328,6725,6596,72,74,55,112,19,"[0, 334, 948, 1226, 1596, 1892, 2451, 2588, 3043, 3558, 4120, 4883, 5302, 5902, 7222, 7793, 8819, 9417, 10272, 10951, 12081, 12688, 13225, 13908, 15043, 15631, 16353, 17271, 18050, 18680]","[0, 328, 687, 970, 1377, 1706, 1987, 2077, 2375, 2465, 2635, 2939, 3188, 3486, 4306, 4464, 4897, 5163, 5526, 5867, 6503, 7034, 7984, 8494, 9003, 9841, 10138, 10998, 12582, 13162]","[0, 244, 497, 822, 1044, 1259, 1487, 1777, 2042, 2435, 3011, 3357, 3898, 4353, 5323, 6087, 6791, 7585, 8056, 8599, 9014, 9300, 9857, 10276, 10578, 10935, 11185, 11552, 12611, 13457]","[0, 210, 369, 666, 756, 894, 1194, 1284, 1541, 1762, 1932, 2116, 2406, 2747, 3840, 3935, 4634, 4852, 5117, 5212, 5513, 5689, 6096, 6428, 6597, 6934, 7313, 7655, 8288, 8621]","[0, 210, 300, 435, 525, 698, 849, 939, 1029, 1200, 1456, 1546, 1690, 1937, 2489, 2801, 3118, 3466, 3709, 3804, 4071, 4166, 4498, 4755, 4849, 5016, 5321, 5588, 6607, 6990]",18680,13162,13457,8621,6990,-872,640,-2129,-1896,-394,-4651,30,dire
7532985414,10,25,137,100,26,"[285, 575, 883, 1134, 1340, 1694, 2194, 2612, 3220, 3551, 4067, 4505, 4845, 5061, 5412, 5900, 6081, 6370, 6977, 7624, 8684, 8974, 9442, 9678, 9959, 11352, 12279, 13139, 14197, 14959]","[152, 565, 861, 1321, 1960, 2646, 3166, 3974, 4239, 4417, 5512, 5868, 5958, 6481, 7161, 7512, 7937, 8287, 8750, 9327, 11050, 11508, 11953, 12313, 12902, 13567, 14343, 14868, 15467, 15742]","[285, 563, 800, 967, 1446, 1844, 2246, 2618, 3045, 3423, 3608, 4377, 4774, 5213, 5654, 6262, 6655, 6859, 7869, 8418, 9346, 9765, 10150, 10632, 11261, 12181, 12937, 13031, 13321, 14168]","[106, 316, 450, 540, 753, 892, 1022, 1173, 1358, 1448, 1858, 2037, 2447, 2590, 2685, 2869, 3120, 3381, 3743, 4040, 4408, 4821, 4916, 5387, 5704, 6182, 6406, 6569, 6746, 7021]","[420, 630, 816, 906, 1054, 1192, 1564, 1715, 2062, 2152, 2562, 2875, 2965, 3060, 3332, 3427, 4012, 4107, 4400, 4919, 6457, 6731, 6901, 7142, 7498, 8052, 8393, 8562, 8807, 9107]",14959,15742,14168,7021,9107,96,54,19,65,5,"[0, 282, 590, 876, 1540, 1982, 2337, 2743, 3082, 3996, 4588, 5129, 6140, 6868, 7537, 7967, 9409, 9613, 9944, 10554, 10766, 11831, 12425, 12950, 13626, 13970, 14756, 15436, 15969, 17228]","[0, 314, 517, 772, 1072, 1400, 1689, 2049, 2504, 3153, 3744, 4107, 4671, 5305, 6113, 6873, 8124, 8675, 9211, 9962, 10771, 10866, 11402, 12039, 12803, 12970, 13065, 13835, 14469, 15932]","[0, 155, 403, 844, 1094, 1305, 1605, 1909, 2488, 2960, 3371, 3774, 4356, 5629, 5959, 6354, 7015, 7475, 7942, 8906, 9246, 9759, 10137, 11440, 12062, 12533, 13049, 13583, 13820, 14092]","[0, 155, 245, 384, 831, 1088, 1178, 1303, 1924, 2753, 3334, 3789, 4174, 4712, 5259, 5444, 6369, 7269, 7567, 8284, 8769, 8992, 9280, 9693, 10217, 10880, 11824, 12247, 12746, 13711]","[0, 155, 288, 484, 661, 786, 1262, 1352, 1654, 2357, 2651, 2741, 3107, 3876, 4327, 4512, 5363, 5585, 5776, 6028, 6231, 6515, 6682, 7036, 7241, 7457, 7673, 7974, 8217, 8767]",17228,15932,14092,13711,8767,-2269,-190,76,-6690,340,-8733,30,radiant
7533042916,10,74,47,96,20,"[0, 249, 494, 1105, 1502, 2176, 2846, 3442, 4117, 4820, 5316, 6080, 6900, 7384, 8199, 8915, 9619, 10344, 10941, 12002, 12710, 13328, 14728, 15549, 17048, 18645, 19810, 21106, 21938, 22286]","[0, 258, 635, 885, 1307, 1397, 1888, 2177, 2517, 2933, 3334, 3772, 4233, 4482, 4721, 5195, 5689, 5875, 6417, 7002, 7265, 7558, 8520, 9010, 9504, 10357, 10803, 11629, 12654, 12830]","[0, 286, 451, 857, 1225, 2021, 2520, 2966, 3378, 3681, 4029, 4512, 5127, 5465, 6058, 6499, 7128, 7741, 8132, 8591, 9009, 9450, 10000, 10412, 11083, 11589, 11864, 12441, 13400, 13496]","[0, 205, 340, 478, 568, 842, 1011, 1101, 1238, 1534, 1738, 2185, 2486, 2581, 2865, 3365, 3690, 4271, 4366, 4622, 4717, 4862, 5338, 5542, 5898, 6487, 6692, 7272, 7760, 7856]","[0, 169, 259, 424, 558, 831, 1008, 1194, 1435, 1802, 2427, 2672, 3075, 3334, 3620, 3854, 4174, 4385, 4527, 4793, 5092, 5237, 5875, 6173, 6704, 7071, 7510, 7909, 8086, 8394]",22286,12830,13496,7856,8394,46,22,69,72,121,"[0, 169, 333, 594, 918, 1008, 1607, 2013, 2405, 2866, 3265, 3682, 4438, 5572, 6459, 8057, 8941, 9797, 10558, 11340, 12093, 13028, 14273, 14761, 15467, 16474, 17295, 18244, 19332, 20735]","[0, 291, 593, 874, 1166, 1646, 2126, 2975, 3225, 3518, 4271, 4620, 5142, 6144, 6239, 7131, 7656, 8064, 8365, 9167, 9446, 9968, 10707, 11096, 11369, 11690, 11908, 12823, 13453, 14221]","[0, 206, 480, 793, 963, 1480, 1599, 1779, 2292, 2543, 2721, 3065, 4048, 4723, 5150, 5735, 6400, 7258, 7831, 8226, 9052, 9794, 10553, 10670, 11108, 11576, 11955, 12280, 12940, 13677]","[0, 169, 346, 436, 606, 969, 1500, 1789, 1951, 2041, 2247, 2542, 3011, 3519, 3813, 4270, 4439, 5043, 5278, 5752, 6200, 6513, 6942, 7169, 7495, 7665, 8084, 8654, 8906, 9168]","[0, 215, 348, 654, 869, 1089, 1179, 1359, 1521, 1764, 2081, 2256, 2396, 3186, 3375, 3896, 4107, 4483, 4578, 4860, 5018, 5218, 5524, 5618, 5827, 5922, 6062, 6350, 6571, 6933]",20735,14221,13677,9168,6933,1551,-1391,-181,-1312,1461,128,30,radiant
7533154518,73,120,78,69,72,"[0, 712, 1045, 1268, 1741, 2110, 2332, 2957, 3506, 4216, 4753, 5421, 6092, 7140, 8272, 9388, 10768, 12083, 13284, 14609, 15957, 17409, 18533, 19567, 20582, 21011, 21839, 23211, 24797, 26097]","[0, 291, 584, 927, 1340, 1637, 1999, 2230, 2489, 3075, 3357, 3774, 4480, 4710, 5222, 5889, 6236, 6856, 7330, 7840, 8408, 8630, 9251, 10195, 10511, 11189, 11626, 11877, 12459, 12630]","[0, 170, 335, 539, 791, 1180, 1598, 1733, 2086, 2788, 3290, 3914, 4264, 4981, 5612, 5813, 6285, 6823, 7711, 8401, 8815, 9234, 9970, 10276, 10759, 11498, 11888, 12159, 12737, 13225]","[0, 170, 260, 375, 621, 1011, 1195, 1330, 1459, 1639, 2231, 2589, 3154, 3283, 3412, 3793, 3966, 4470, 4804, 5278, 5588, 5912, 6280, 6731, 7121, 7659, 8181, 8470, 9285, 9398]","[0, 236, 326, 452, 542, 678, 814, 960, 1050, 1273, 1492, 1740, 2263, 2357, 2595, 3076, 3234, 3328, 3423, 4003, 4175, 4349, 4726, 5149, 5599, 6144, 6551, 6721, 7250, 7421]",26097,12630,13225,9398,7421,109,39,112,26,19,"[0, 663, 878, 1198, 1477, 1876, 2242, 2528, 3032, 3259, 3619, 3959, 4931, 5401, 6113, 6804, 7619, 8340, 9085, 9638, 11020, 11799, 12664, 13829, 14714, 16546, 17663, 18568, 19392, 20400]","[0, 324, 558, 930, 1380, 1673, 2040, 2454, 3167, 3630, 4104, 4538, 5119, 5304, 6132, 6541, 7318, 8188, 8837, 9912, 10587, 11287, 12123, 12706, 13203, 14681, 15622, 16325, 17325, 18156]","[0, 221, 382, 725, 888, 1192, 1917, 2131, 2690, 3089, 3672, 4699, 5178, 6309, 6770, 7055, 7347, 8019, 8492, 9061, 9690, 10208, 10856, 11736, 12032, 12787, 13390, 14201, 14898, 15291]","[0, 326, 454, 703, 793, 1016, 1151, 1324, 1504, 1674, 1924, 2081, 2261, 2998, 3501, 3689, 3935, 4121, 4492, 4863, 5340, 5799, 6041, 6245, 6606, 7532, 7851, 8064, 8691, 9117]","[0, 170, 260, 400, 527, 651, 1130, 1460, 1640, 1902, 2306, 2476, 2755, 2849, 3434, 3790, 4015, 4109, 4467, 4830, 5245, 5736, 6366, 6668, 6881, 8215, 8841, 9196, 9612, 9986]",20400,18156,15291,9117,9986,5697,-5526,-2066,281,-2565,-4179,30,dire
7533231811,10,96,11,136,26,"[1, 130, 554, 846, 1368, 1813, 2150, 2843, 3319, 3885, 4333, 4817, 5526, 6130, 6643, 7306, 7923, 8407, 9102, 9923, 10708, 11596, 12380, 12902, 13117, 13452, 14138, 14538, 15041, 15939]","[1, 180, 604, 918, 1589, 2068, 2421, 3239, 3932, 4357, 5013, 5518, 6393, 6716, 7104, 7645, 8568, 9079, 9770, 10033, 10636, 11111, 11854, 12512, 13164, 13846, 14344, 15439, 16259, 16889]","[1, 247, 582, 784, 1065, 1773, 1988, 2236, 2819, 3573, 3993, 4606, 5134, 5332, 5856, 6417, 6747, 7107, 7690, 8673, 9278, 9911, 10826, 11310, 11494, 13046, 14122, 14253, 14876, 15717]","[1, 130, 560, 686, 1077, 1494, 1684, 1855, 2032, 2122, 2395, 2531, 2711, 2806, 2954, 3049, 3383, 3976, 4333, 4858, 5092, 5371, 5707, 5802, 6416, 7222, 7362, 7717, 7911, 8097]","[1, 130, 265, 373, 669, 848, 1188, 1415, 1734, 1908, 2078, 2218, 2997, 3313, 3498, 3878, 3972, 4148, 4346, 4702, 4945, 5172, 5542, 5804, 5942, 6511, 6727, 7027, 7123, 7309]",15939,16889,15717,8097,7309,106,41,19,90,86,"[1, 377, 575, 1180, 1566, 1948, 2545, 2789, 3174, 3388, 3779, 4129, 4521, 5201, 5706, 6536, 7219, 7845, 8470, 9156, 9695, 10468, 11218, 12059, 12461, 13393, 14051, 14749, 15789, 16600]","[1, 210, 458, 783, 1123, 1676, 1838, 2413, 2614, 2986, 3316, 3883, 4088, 4614, 5333, 6052, 6690, 7510, 8462, 9157, 9969, 10792, 12097, 12764, 13430, 14727, 15413, 16308, 18045, 18662]","[1, 244, 485, 655, 988, 1214, 1782, 1989, 2238, 2373, 2542, 2753, 3084, 3558, 3972, 4268, 4825, 5229, 5862, 6352, 6955, 7516, 8109, 9085, 9689, 10515, 11241, 11881, 12791, 13325]","[1, 210, 300, 390, 480, 760, 1014, 1149, 1367, 1715, 1901, 2744, 3422, 3867, 4177, 4734, 5505, 5868, 6359, 6807, 7198, 7509, 8043, 9034, 9595, 10800, 11065, 11839, 13105, 13902]","[1, 249, 383, 518, 682, 1074, 1732, 1954, 2044, 2170, 2552, 2642, 2886, 3071, 3464, 3950, 4216, 4469, 4937, 5305, 5718, 5917, 6501, 6994, 7599, 8270, 8925, 9370, 9827, 10055]",16600,18662,13325,13902,10055,-661,-1773,2392,-5805,-2746,-8593,30,radiant
7533433505,48,43,23,96,119,"[78, 372, 730, 1007, 1486, 1787, 2080, 2547, 2936, 3640, 4003, 4508, 5114, 5708, 5920, 6799, 7679, 8706, 9690, 10944, 11705, 12754, 13763, 14828, 16052, 17077, 18442, 19070, 20181, 21414]","[78, 372, 759, 1105, 1345, 1637, 1990, 2252, 2680, 3175, 3737, 4114, 4623, 5176, 5524, 6196, 6881, 7039, 7275, 8495, 9018, 9432, 10255, 10769, 11310, 11753, 12732, 13274, 13975, 14399]","[211, 450, 681, 1051, 1355, 1565, 2156, 2583, 3268, 3699, 4302, 5277, 5535, 6025, 6445, 7049, 7887, 8274, 8910, 9751, 10505, 10942, 11321, 11649, 12121, 12772, 13578, 13777, 14766, 15217]","[78, 248, 363, 453, 543, 673, 809, 994, 1238, 1645, 2247, 2617, 2707, 3162, 3390, 3699, 4021, 4666, 4868, 5214, 5662, 6340, 6751, 7224, 7838, 8272, 8748, 9180, 9467, 9945]","[78, 348, 463, 598, 704, 834, 942, 1129, 1606, 1900, 2156, 2423, 2513, 3046, 3735, 4014, 4284, 5106, 5226, 5823, 6174, 6473, 6714, 6884, 7054, 7614, 8102, 8950, 9882, 10181]",21414,14399,15217,9945,10181,25,21,129,26,136,"[308, 515, 760, 1030, 1281, 1657, 2126, 2413, 2967, 3428, 3730, 4242, 5189, 5820, 6953, 7444, 8160, 9035, 9667, 10565, 11162, 11645, 12254, 13046, 14084, 14773, 16067, 16766, 17709, 18465]","[308, 566, 763, 1331, 1624, 1943, 2394, 2941, 3150, 3675, 4226, 4536, 5104, 5696, 6469, 7069, 7414, 7932, 8842, 9572, 10193, 10505, 11116, 11706, 12583, 12873, 13437, 13872, 14103, 14315]","[116, 397, 557, 967, 1247, 1584, 2217, 2723, 3479, 3871, 4494, 5050, 5459, 5554, 5923, 6250, 6981, 8299, 9007, 9584, 10103, 10592, 11314, 11674, 12389, 13488, 14103, 14419, 14515, 15234]","[443, 613, 754, 1131, 1221, 1396, 1608, 1760, 1959, 2505, 2761, 2906, 3121, 3263, 3877, 4329, 4580, 5152, 5416, 5692, 5910, 6346, 6619, 6804, 7659, 8436, 8531, 8626, 8899, 9271]","[175, 345, 435, 525, 615, 705, 906, 1058, 1192, 1365, 1500, 1590, 1956, 2145, 2491, 2640, 2877, 3461, 3834, 4199, 4329, 4424, 4653, 4860, 5258, 5352, 5521, 5797, 6076, 6266]",18465,14315,15234,9271,6266,2949,84,-17,674,3915,7605,30,radiant
7533473607,67,21,69,26,102,"[0, 280, 515, 716, 1058, 1417, 1839, 2242, 2657, 3105, 3624, 3877, 4422, 5216, 6374, 6469, 7146, 7474, 8651, 9316, 9647, 10775, 12031, 12540, 13218, 14072, 14860, 16773, 17400, 19333]","[0, 363, 716, 969, 1312, 1670, 2411, 2873, 3258, 4094, 4560, 5095, 5488, 6470, 7086, 7483, 7909, 8114, 8774, 9044, 9854, 10587, 11294, 12231, 12593, 13912, 14708, 15658, 15754, 16971]","[0, 317, 750, 912, 1282, 1486, 1830, 2113, 2581, 3093, 3354, 3852, 4553, 5505, 6435, 7180, 7965, 8753, 8953, 9618, 10584, 11310, 11846, 12499, 12859, 13436, 14603, 14943, 15355, 17035]","[0, 254, 430, 557, 693, 823, 1294, 1455, 1675, 2394, 2942, 3140, 3504, 4146, 4699, 4840, 4971, 5480, 5975, 6699, 6880, 7723, 8228, 8833, 9086, 10025, 10723, 11566, 11662, 12595]","[0, 247, 337, 427, 517, 647, 902, 992, 1128, 1353, 1922, 2203, 2762, 3325, 4037, 4338, 4611, 4706, 5180, 6023, 6287, 6779, 7065, 7465, 8119, 9504, 10193, 10956, 11052, 12333]",19333,16971,17035,12595,12333,138,53,64,74,105,"[0, 205, 626, 1003, 1421, 1696, 2421, 3032, 3403, 4195, 4847, 5217, 5773, 6330, 6988, 7527, 8286, 10049, 10921, 11322, 12197, 12590, 13257, 13805, 14441, 14570, 14664, 15651, 16243, 16484]","[0, 457, 838, 1263, 1597, 1888, 2299, 2505, 2768, 2982, 3257, 4071, 4194, 4617, 4851, 5388, 6157, 7406, 8033, 9046, 9698, 10531, 10715, 11751, 12611, 12706, 13642, 14875, 15491, 16236]","[0, 299, 560, 843, 1174, 1506, 1804, 2088, 2864, 2999, 3183, 3631, 3897, 4215, 4638, 5253, 5944, 6783, 6963, 7482, 7919, 8014, 8482, 8872, 9543, 9638, 9800, 10495, 10927, 11299]","[0, 189, 350, 485, 614, 965, 1135, 1327, 1538, 1999, 2134, 2982, 3072, 3752, 3846, 4856, 5148, 5938, 6242, 6610, 6872, 6967, 7338, 7763, 8649, 8744, 8838, 9327, 9513, 9754]","[0, 189, 279, 413, 549, 639, 729, 999, 1089, 1511, 1681, 2145, 2235, 2504, 2598, 2947, 3042, 3638, 3842, 4338, 4635, 4768, 5406, 5700, 5905, 6074, 6168, 6917, 7250, 7491]",16484,16236,11299,9754,7491,2849,735,5736,2841,4842,17003,30,radiant
7533473919,35,76,23,19,20,"[0, 354, 632, 1068, 1385, 1638, 2092, 2621, 2940, 3296, 3436, 4247, 4537, 4984, 5382, 5977, 6532, 7077, 7421, 7882, 8325, 8936, 10013, 10462, 10591, 11242, 11542, 12694, 13454, 14927]","[0, 350, 632, 810, 1265, 1589, 1811, 2033, 2410, 3169, 3633, 4158, 4596, 5021, 5471, 6170, 6891, 7493, 8123, 8590, 9226, 10025, 10880, 11752, 11940, 12034, 12277, 12372, 13204, 14566]","[0, 285, 522, 955, 1321, 1615, 1898, 2216, 2870, 3389, 3586, 4216, 4804, 5241, 5513, 5733, 6235, 6941, 7426, 8325, 8875, 9152, 10037, 10351, 10616, 10710, 11077, 11466, 11857, 12539]","[100, 509, 599, 689, 874, 1013, 1148, 1306, 1539, 1853, 2011, 2332, 3027, 3397, 3491, 3737, 3878, 4419, 4514, 4904, 5377, 5571, 5816, 6039, 6134, 6313, 6743, 7044, 7770, 8452]","[0, 276, 366, 500, 651, 824, 914, 1004, 1094, 1360, 1450, 1726, 2010, 2276, 2419, 2845, 3100, 3634, 3729, 3997, 4205, 4444, 4736, 4951, 5046, 5140, 5402, 5497, 5755, 6437]",14927,14566,12539,8452,6437,8,69,47,112,83,"[0, 723, 957, 1203, 1544, 1952, 2557, 2823, 3241, 3844, 4284, 4614, 5213, 5995, 6577, 7129, 7804, 8958, 9751, 10404, 11292, 12006, 12487, 13562, 14347, 14945, 16108, 16676, 17660, 18241]","[0, 381, 677, 1042, 1407, 1718, 2017, 2728, 3103, 3667, 4166, 4625, 5355, 6110, 6827, 7042, 7478, 7933, 8435, 8702, 9679, 10196, 10696, 11401, 13094, 13850, 15437, 16260, 16845, 17394]","[0, 423, 676, 1120, 1330, 1605, 1920, 2051, 2401, 2511, 3170, 3999, 4863, 5498, 5962, 6307, 7159, 7394, 7910, 8160, 8773, 9476, 10071, 10550, 11143, 12374, 13282, 14480, 15149, 16161]","[0, 270, 398, 533, 706, 796, 936, 1152, 1287, 1545, 1635, 1844, 2358, 2586, 2900, 2995, 3216, 3603, 3777, 3958, 4852, 5082, 5512, 6050, 6819, 7481, 8489, 8781, 9351, 10220]","[0, 198, 288, 378, 534, 677, 945, 1053, 1188, 1314, 1708, 1871, 2377, 2653, 2837, 2950, 3171, 3465, 3599, 3694, 3905, 4109, 4276, 4569, 5106, 5565, 5660, 6016, 6282, 6668]",18241,17394,16161,10220,6668,-3314,-2828,-3622,-1768,-231,-11763,30,dire
7533525210,8,23,90,112,66,"[0, 250, 456, 616, 846, 1043, 1422, 1913, 2319, 2790, 3192, 3785, 4151, 4672, 4928, 5700, 6066, 6563, 6952, 7707, 8086, 8364, 9008, 9630, 10283, 10915, 11778, 12251, 12817, 13283]","[0, 203, 403, 748, 1076, 1450, 1613, 1877, 2334, 2781, 3193, 3283, 3572, 4295, 4720, 5403, 5625, 6020, 6527, 6899, 7340, 7772, 8309, 8844, 9481, 10232, 10842, 11376, 11859, 12239]","[0, 216, 388, 698, 989, 1360, 1709, 1889, 2317, 2491, 2982, 3162, 3506, 4110, 4525, 5189, 5482, 5667, 6103, 6558, 6959, 7301, 7887, 8442, 8784, 9102, 9254, 9798, 10257, 10585]","[0, 129, 219, 357, 477, 615, 705, 885, 975, 1065, 1229, 1407, 1727, 1970, 2358, 2795, 2889, 3197, 3504, 3781, 4041, 4531, 4996, 5351, 5724, 6266, 6609, 6810, 7067, 7163]","[0, 129, 219, 414, 573, 714, 924, 1285, 1446, 1612, 1833, 2098, 2654, 2850, 3123, 3314, 3568, 3876, 4093, 4552, 4828, 5248, 5808, 6429, 6804, 7560, 7730, 8210, 8588, 8782]",13283,12239,10585,7163,8782,21,59,60,111,20,"[0, 296, 665, 1047, 1525, 1868, 2246, 2811, 3249, 3960, 4867, 5128, 6172, 6639, 6931, 7286, 8322, 9449, 10308, 11255, 11877, 12709, 13227, 13918, 14143, 14725, 15206, 16353, 17002, 17702]","[0, 299, 651, 999, 1179, 1468, 2062, 2600, 2999, 3524, 4229, 4689, 4857, 5060, 5750, 6632, 7125, 7689, 8230, 9344, 10011, 10994, 11718, 12189, 12580, 13104, 13743, 14949, 15586, 16197]","[0, 245, 484, 823, 1035, 1335, 1678, 2174, 2614, 3250, 3882, 4308, 4960, 5299, 5734, 5977, 6406, 7278, 7655, 8338, 8853, 9326, 9761, 10101, 10302, 10898, 11263, 12165, 12676, 13389]","[0, 209, 632, 805, 895, 1029, 1190, 1486, 1625, 1853, 2115, 2205, 2610, 2961, 3393, 3726, 3883, 4464, 4804, 5115, 5676, 5930, 6146, 6375, 6516, 6788, 7123, 7936, 8142, 8393]","[0, 209, 351, 489, 579, 719, 809, 1158, 1248, 1576, 1832, 2035, 2474, 2768, 3073, 3233, 3583, 3852, 3995, 4340, 4514, 4766, 5025, 5254, 5349, 5596, 5865, 6604, 6810, 6946]",17702,16197,13389,8393,6946,-4419,-3958,-2804,-1230,1836,-10575,30,dire
7534334312,70,39,97,51,5,"[0, 286, 536, 744, 1400, 2153, 2402, 3083, 3458, 3968, 4430, 5065, 5540, 6090, 7470, 8384, 9232, 10280, 11297, 12185, 12375, 13375, 13961, 14056, 14632, 15253, 15348, 16058, 16624, 17289]","[0, 361, 648, 991, 1448, 1725, 2213, 2935, 3270, 3509, 4025, 4343, 4663, 5236, 6154, 6508, 7173, 7764, 8341, 9053, 9604, 10313, 11094, 11579, 12259, 12634, 13184, 14143, 15042, 15927]","[0, 291, 574, 807, 1152, 1392, 1482, 1823, 2193, 2732, 2950, 3410, 3979, 4385, 4948, 5428, 6234, 6846, 7247, 7991, 8763, 9544, 10276, 10371, 10667, 11226, 11647, 11929, 12271, 13168]","[0, 210, 300, 602, 772, 862, 952, 1303, 1443, 1697, 2021, 2111, 2255, 2404, 3061, 3619, 3867, 4179, 4575, 4733, 4940, 5244, 5411, 5506, 6112, 6206, 6453, 6910, 7225, 7472]","[0, 210, 300, 390, 701, 887, 1016, 1230, 1370, 1731, 1867, 2077, 2221, 2411, 2796, 3065, 3313, 3543, 3742, 3900, 4090, 4847, 5014, 5234, 5373, 5467, 5562, 5912, 6298, 6509]",17289,15927,13168,7472,6509,10,137,92,110,65,"[0, 174, 504, 817, 1273, 1554, 2084, 2578, 3034, 3650, 4286, 4695, 5347, 5904, 6706, 7945, 8622, 9495, 10175, 10951, 11729, 12150, 13225, 14609, 15432, 15987, 16498, 17879, 18779, 20337]","[0, 293, 589, 883, 1047, 1386, 1756, 2558, 2848, 3215, 3420, 3830, 4535, 5206, 5653, 6130, 6875, 7048, 7445, 8030, 8496, 8892, 9289, 10085, 10993, 11087, 11972, 12157, 13028, 13752]","[0, 504, 832, 1153, 1534, 1770, 1980, 2260, 2667, 2757, 3103, 3547, 4213, 4732, 5095, 5544, 6208, 6559, 6840, 7529, 7713, 7958, 8287, 9204, 9717, 9893, 10428, 11100, 11664, 12340]","[0, 230, 366, 456, 635, 760, 850, 1420, 1544, 1722, 1879, 2049, 2298, 2494, 2729, 3316, 3930, 4257, 4418, 5098, 5720, 6048, 6479, 7223, 7926, 8095, 8517, 9303, 9802, 10439]","[0, 200, 290, 380, 704, 829, 1091, 1410, 1579, 1835, 2313, 2648, 2847, 3545, 3992, 4312, 4733, 5038, 5249, 5821, 6207, 6301, 6468, 7059, 7735, 7829, 8356, 8792, 8969, 9599]",20337,13752,12340,10439,9599,-3048,2175,828,-2967,-3090,-6102,30,radiant
7534419016,10,14,98,31,121,"[0, 170, 520, 863, 1224, 1392, 1861, 2261, 2616, 3085, 3781, 4431, 4897, 5644, 6512, 7055, 7528, 8084, 9116, 9464, 9684, 10207, 11294, 11710, 13124, 14386, 15217, 16232, 16701, 17224]","[0, 551, 925, 1351, 1913, 2121, 2443, 2986, 3434, 3897, 4717, 5500, 5808, 6258, 6761, 7301, 8082, 9079, 9982, 10854, 10949, 11725, 12439, 13557, 14786, 15198, 16646, 17162, 17770, 18673]","[0, 318, 649, 1135, 1423, 1850, 2106, 2553, 3266, 3433, 4277, 4796, 5435, 5881, 6314, 6589, 7269, 7510, 7980, 8277, 9343, 9836, 10945, 11801, 12800, 13320, 13612, 14398, 14934, 15277]","[0, 246, 387, 497, 700, 1023, 1113, 1203, 1328, 1508, 1817, 2084, 2879, 3098, 3689, 3942, 4347, 4530, 5099, 5557, 5887, 6099, 6371, 6600, 7096, 7427, 7917, 8405, 8615, 8786]","[0, 170, 260, 394, 567, 657, 894, 984, 1340, 1464, 1994, 2434, 2636, 2993, 3389, 3742, 4152, 4291, 4543, 4845, 5281, 5376, 6136, 6560, 6849, 7088, 7382, 8056, 8359, 8455]",17224,18673,15277,8786,8455,13,56,77,112,19,"[0, 278, 585, 914, 1081, 1382, 2050, 2576, 3553, 4230, 4540, 5133, 5223, 5852, 6222, 6976, 7753, 8126, 8740, 9720, 10148, 10925, 11422, 11778, 12496, 14062, 14832, 15037, 15908, 16682]","[0, 205, 450, 731, 937, 1520, 1727, 2524, 2884, 3226, 3633, 4057, 4682, 5056, 5435, 6081, 6737, 7105, 7685, 8079, 8422, 8751, 9854, 10001, 10944, 11344, 12323, 12538, 12827, 14175]","[0, 246, 411, 696, 1085, 1610, 1846, 2426, 2717, 3061, 3232, 3765, 4050, 4626, 4937, 5522, 6098, 6629, 7710, 8509, 9255, 10068, 10593, 11088, 11585, 11785, 12585, 13557, 14020, 14685]","[0, 170, 260, 350, 535, 674, 876, 1193, 1494, 1761, 1906, 2191, 2327, 2575, 2971, 3167, 3467, 3923, 4742, 5723, 6046, 6141, 6719, 6814, 7311, 7857, 8161, 8474, 8824, 9120]","[0, 254, 380, 517, 612, 1027, 1158, 1551, 1829, 1999, 2180, 2389, 2479, 2574, 2899, 3085, 3435, 3987, 4429, 4586, 5088, 5183, 5349, 5444, 6249, 6448, 6542, 6999, 7257, 7744]",16682,14175,14685,9120,7744,542,4498,592,-334,711,6009,30,radiant
7535023015,82,13,69,53,26,"[0, 295, 491, 770, 1181, 1437, 1685, 2093, 2571, 3153, 3821, 4110, 4441, 5008, 5691, 6011, 7076, 7674, 8419, 8989, 9657, 10328, 11110, 11885, 13137, 13770, 14160, 14500, 15315, 16466]","[0, 369, 656, 1039, 1443, 1927, 2367, 2870, 3538, 3833, 4541, 4823, 5343, 6183, 6834, 7574, 7844, 8617, 9220, 9740, 10134, 10636, 11673, 12732, 13417, 14346, 14831, 15455, 16632, 17165]","[0, 369, 691, 856, 1352, 1937, 2536, 3348, 3686, 4128, 4656, 5184, 5683, 6260, 6782, 7402, 8045, 8707, 9448, 9896, 10456, 10835, 11548, 12316, 13189, 13675, 14159, 14792, 15934, 16792]","[0, 209, 299, 389, 528, 739, 935, 1137, 1248, 1357, 1686, 1886, 2317, 2891, 3176, 3475, 4003, 4276, 4573, 4848, 5354, 5996, 6292, 6591, 7682, 8288, 8488, 8766, 9891, 10182]","[0, 209, 314, 404, 575, 749, 908, 1268, 1358, 1448, 1803, 1991, 2745, 3590, 3794, 4017, 4176, 4424, 4587, 4967, 5137, 5375, 5707, 6242, 6754, 7204, 7374, 7543, 8240, 8606]",16466,17165,16792,10182,8606,10,96,23,86,83,"[0, 89, 367, 655, 1028, 1226, 1467, 1656, 2383, 2746, 3052, 3642, 4192, 4852, 5158, 5773, 6459, 7827, 8661, 9600, 10335, 10884, 11051, 11782, 12559, 13188, 14426, 15138, 15405, 15761]","[0, 165, 504, 831, 1473, 1853, 2186, 2733, 3288, 3771, 4417, 4760, 5537, 6212, 6598, 7156, 7713, 8262, 9117, 9853, 10516, 10755, 11971, 12795, 13460, 13824, 14985, 15747, 16109, 16919]","[0, 280, 720, 944, 1490, 1850, 2393, 2823, 3471, 3889, 4290, 4792, 5260, 5889, 6661, 7394, 7966, 8395, 9076, 9773, 10576, 10879, 11599, 12182, 12779, 13133, 13858, 14205, 14823, 15322]","[0, 89, 179, 289, 493, 633, 723, 849, 939, 1226, 1716, 1992, 2271, 2719, 2943, 3297, 4028, 4527, 4921, 5155, 5590, 6060, 6442, 6604, 6820, 7120, 7772, 7942, 8113, 8445]","[0, 89, 179, 331, 481, 635, 725, 894, 1110, 1520, 1837, 1962, 2285, 2488, 2712, 2945, 3204, 3456, 3734, 4245, 4756, 5011, 5257, 5426, 5718, 5960, 6531, 6738, 6909, 7080]",15761,16919,15322,8445,7080,705,246,1470,1737,1526,5684,30,radiant
7535030019,53,106,61,123,100,"[0, 253, 533, 976, 1162, 1382, 1666, 2111, 2596, 3101, 3841, 4382, 5048, 5561, 6230, 6727, 7406, 7831, 9114, 9902, 10945, 11620, 13398, 14199, 15587, 15826, 17068, 17845, 18046, 18936]","[0, 245, 539, 992, 1368, 1771, 2046, 2554, 2991, 3332, 4314, 4829, 5171, 5680, 6133, 6608, 6766, 7082, 8046, 8763, 9449, 9785, 10599, 11496, 11949, 12635, 13008, 13666, 14412, 14997]","[0, 204, 364, 591, 1045, 1367, 1649, 1868, 2296, 2920, 3943, 4770, 5281, 6026, 6373, 6965, 7322, 7972, 8349, 8717, 9201, 9777, 10564, 10986, 11530, 12091, 12553, 13147, 13640, 14055]","[0, 170, 304, 394, 573, 703, 793, 996, 1216, 1306, 1646, 2147, 2333, 2542, 2689, 2784, 2942, 3269, 4235, 4802, 5155, 5346, 6077, 6506, 6976, 7282, 7554, 7759, 8324, 8621]","[0, 170, 260, 610, 735, 990, 1096, 1299, 1517, 1607, 2014, 2391, 2571, 3056, 3165, 3418, 3736, 3831, 4425, 4693, 5078, 5237, 5466, 5738, 6015, 6254, 6466, 6671, 6963, 7352]",18936,14997,14055,8621,7352,41,69,74,128,65,"[0, 208, 745, 1070, 1198, 1605, 1959, 2328, 2772, 2996, 3238, 3510, 3783, 4251, 4802, 5210, 5909, 6845, 7148, 7921, 8730, 9687, 9853, 10470, 11173, 11943, 12433, 14059, 14877, 15649]","[0, 214, 459, 795, 1153, 1613, 1897, 2445, 3141, 3470, 3987, 4408, 4943, 5299, 6095, 6469, 7126, 7805, 8500, 8767, 9599, 10339, 11076, 11439, 12000, 12544, 12856, 13739, 14585, 15037]","[0, 242, 450, 694, 1073, 1455, 1817, 2215, 2504, 2749, 2971, 3189, 3633, 4030, 4348, 4706, 5149, 5703, 5980, 6369, 7184, 7802, 8001, 8348, 9292, 9884, 10382, 11347, 11838, 12269]","[0, 170, 297, 454, 588, 1001, 1091, 1301, 1503, 1593, 1813, 2177, 2366, 2562, 3063, 3198, 3896, 4288, 5062, 5384, 6115, 6633, 6919, 7096, 7697, 8115, 8248, 9388, 9710, 10285]","[0, 170, 336, 442, 558, 769, 859, 1226, 1381, 1537, 1766, 2024, 2293, 2489, 2948, 3251, 3786, 4377, 4653, 5141, 5582, 6022, 6831, 6926, 7400, 7495, 7589, 8165, 8630, 8726]",15649,15037,12269,10285,8726,3287,-40,1786,-1664,-1374,1995,30,dire
7535110205,70,49,96,128,65,"[0, 352, 653, 1104, 1484, 1969, 2177, 2566, 3024, 3495, 4070, 4606, 5256, 5860, 6391, 7154, 7553, 8313, 9347, 10105, 10733, 11731, 12457, 13293, 14420, 15545, 16936, 17305, 17696, 17873]","[0, 271, 633, 884, 1294, 1623, 1867, 2584, 3177, 3519, 3836, 4431, 5065, 5634, 5922, 6371, 7153, 7792, 8480, 9264, 9923, 10522, 11196, 11368, 12238, 13253, 14077, 15113, 15364, 15701]","[0, 234, 506, 706, 1071, 1391, 2210, 2387, 3049, 3543, 4189, 4479, 4699, 5073, 5563, 6042, 6693, 6981, 7447, 8134, 8374, 8964, 9866, 10147, 10594, 11789, 12728, 13016, 13279, 13741]","[0, 195, 378, 564, 738, 951, 1236, 1407, 1667, 2127, 2262, 2396, 2873, 3177, 3472, 3688, 3959, 4123, 4473, 4875, 5200, 5578, 5907, 6115, 6456, 6847, 7620, 7935, 8211, 8499]","[0, 195, 285, 658, 794, 1069, 1237, 1373, 1553, 1992, 2265, 2529, 2923, 3310, 3405, 3708, 4207, 5001, 5096, 5254, 5348, 5778, 6432, 6569, 6994, 7089, 7456, 7640, 8080, 8257]",17873,15701,13741,8499,8257,25,29,23,100,20,"[0, 213, 475, 710, 954, 1298, 1465, 2045, 2173, 2362, 3211, 3909, 4480, 5717, 6480, 6884, 7665, 8440, 9175, 10049, 10973, 11825, 12802, 13854, 14895, 15778, 16805, 17784, 19846, 21337]","[0, 330, 610, 971, 1260, 1620, 1851, 2491, 3143, 3663, 4004, 4450, 4626, 5481, 5965, 6613, 7340, 8073, 8738, 9462, 10008, 10785, 11254, 11508, 12081, 12531, 12870, 13497, 14182, 14983]","[0, 206, 440, 767, 1013, 1354, 1559, 1775, 2198, 2724, 3399, 3922, 4805, 5149, 5807, 6499, 7195, 7956, 8200, 8675, 9102, 9542, 10023, 10410, 11031, 11411, 12181, 12584, 13323, 14470]","[0, 170, 260, 393, 483, 818, 908, 1136, 1226, 1539, 2040, 2278, 2635, 3087, 3365, 3616, 3914, 4148, 4243, 4559, 5053, 5148, 5592, 5841, 6072, 6448, 6710, 7010, 7607, 8468]","[0, 170, 260, 441, 531, 699, 789, 1016, 1325, 1509, 1683, 1872, 2200, 2652, 2930, 3086, 3571, 3871, 4142, 4389, 4707, 4846, 5103, 5354, 5538, 6184, 6446, 6709, 7343, 7985]",21337,14983,14470,8468,7985,-3464,718,-729,31,272,-3172,30,dire
7535205409,60,17,123,20,19,"[0, 206, 524, 854, 1215, 1700, 2218, 2915, 3455, 3878, 4348, 5004, 5680, 6224, 6872, 7343, 7918, 8678, 9775, 10540, 11712, 12329, 13137, 13751, 14006, 14520, 15371, 16097, 16479, 17499]","[0, 316, 687, 1020, 1344, 1512, 2086, 2486, 2833, 3629, 4174, 4806, 5149, 5614, 5903, 6734, 7153, 8050, 8391, 9236, 9785, 10753, 10920, 11590, 12153, 12443, 12702, 13552, 14042, 14444]","[0, 246, 502, 898, 988, 1394, 1706, 2085, 2729, 2819, 3197, 3646, 4267, 4682, 4814, 5269, 5593, 5902, 6322, 6716, 7132, 7939, 8106, 8837, 9396, 9567, 10339, 11183, 12499, 13603]","[0, 169, 259, 756, 976, 1268, 1412, 1737, 2047, 2276, 2482, 2647, 3078, 3281, 3376, 3580, 4068, 4316, 4501, 4992, 5089, 5543, 5748, 6197, 6478, 6573, 6753, 7286, 7876, 8181]","[0, 169, 259, 396, 486, 624, 759, 985, 1194, 1421, 1627, 1901, 2512, 2837, 2932, 3050, 3208, 3627, 4080, 4483, 4587, 4958, 5125, 5399, 5494, 5589, 5769, 6059, 6549, 6990]",17499,14444,13603,8181,6990,46,21,78,100,121,"[0, 241, 511, 842, 1260, 1956, 2247, 2663, 3225, 3488, 4241, 5286, 6328, 6772, 7763, 8582, 9317, 10249, 11124, 11738, 13001, 13479, 14919, 16076, 16861, 17770, 19045, 20023, 21348, 22649]","[0, 250, 567, 733, 995, 1453, 1864, 2211, 2675, 3310, 3823, 4432, 4522, 4873, 5477, 6177, 7106, 8202, 8889, 9333, 9716, 10800, 11529, 11794, 12383, 13282, 13981, 14732, 15190, 15837]","[0, 291, 566, 841, 1078, 1504, 1955, 2097, 2404, 2692, 3246, 3611, 3776, 4396, 5249, 5911, 6295, 6908, 7719, 8090, 8483, 8943, 9580, 10070, 11061, 11662, 12301, 12943, 13261, 14044]","[0, 169, 259, 349, 439, 797, 931, 1021, 1111, 1376, 1595, 1868, 2200, 2607, 3000, 3180, 3560, 3931, 4243, 4400, 4972, 5188, 5704, 5798, 6223, 6854, 7059, 7703, 8047, 8618]","[0, 169, 259, 397, 487, 808, 979, 1140, 1230, 1404, 1494, 1858, 2251, 2525, 2914, 3330, 3676, 3861, 4211, 4422, 4815, 5134, 5532, 5800, 6080, 6583, 6908, 7667, 8315, 8724]",22649,15837,14044,8618,8724,-5150,-1393,-441,-437,-1734,-9155,30,dire
7535209904,25,22,23,112,83,"[0, 387, 722, 1300, 1584, 2167, 2968, 3270, 3641, 3930, 4208, 4724, 5657, 6228, 6634, 7089, 7825, 8160, 8836, 8931, 9796, 10555, 10920, 11951, 12531, 12709, 13577, 13672, 14539, 15021]","[0, 281, 608, 952, 1194, 1524, 2025, 2354, 2495, 2806, 3236, 3652, 4065, 5215, 5680, 5800, 6611, 7098, 7576, 7671, 8171, 8711, 8932, 9124, 9410, 9804, 10891, 11417, 11680, 11968]","[0, 265, 546, 845, 1148, 1521, 1821, 2195, 2614, 3094, 3692, 4241, 5114, 5618, 6035, 6958, 7472, 7833, 8511, 9358, 9632, 10243, 10675, 10905, 11322, 11417, 12047, 12142, 12500, 12772]","[0, 265, 355, 445, 535, 714, 889, 979, 1231, 1577, 1759, 2223, 2812, 3503, 3866, 4132, 4428, 4621, 4865, 5160, 5383, 5512, 5606, 5826, 6215, 6310, 6873, 7263, 7526, 7622]","[0, 499, 603, 805, 895, 1069, 1591, 1730, 1925, 2056, 2146, 2282, 2372, 3018, 3149, 3787, 3945, 4148, 4318, 4488, 4962, 5132, 5499, 5873, 6115, 6358, 7033, 7410, 7958, 8139]",15021,11968,12772,7622,8139,46,14,98,121,3,"[0, 324, 702, 1063, 1513, 1793, 2471, 3000, 3547, 4307, 5279, 6076, 6729, 6986, 7437, 8589, 9412, 10389, 11035, 12387, 13577, 14251, 14647, 15278, 16110, 17201, 18044, 19240, 19710, 20406]","[0, 204, 481, 716, 1116, 1253, 1569, 2118, 2504, 3150, 3688, 4139, 4806, 5336, 5917, 6841, 7571, 8083, 8386, 9285, 10126, 10674, 11165, 11583, 12174, 13263, 13788, 14122, 14428, 14961]","[0, 279, 656, 922, 1414, 1713, 2077, 2250, 2537, 2816, 3107, 3742, 4067, 4680, 5398, 5926, 6755, 8015, 8562, 9094, 9832, 10748, 11781, 12452, 12985, 14358, 14853, 15432, 16000, 16573]","[0, 169, 259, 349, 439, 529, 723, 958, 1097, 1395, 2100, 2394, 2624, 2791, 3016, 3201, 3713, 4099, 4358, 4933, 5368, 5860, 6089, 6274, 6764, 7717, 8085, 8924, 9173, 9562]","[0, 169, 259, 349, 751, 868, 1318, 1536, 1626, 1828, 2044, 2185, 2473, 2640, 3118, 3864, 4508, 5162, 5336, 5954, 6475, 6853, 7082, 7729, 8410, 9404, 9653, 9902, 10273, 10498]",20406,14961,16573,9562,10498,-5385,-2993,-3801,-1940,-2359,-16478,30,dire
7535326407,1,113,102,105,20,"[0, 249, 571, 1046, 1691, 2008, 2461, 2940, 3354, 3744, 4576, 5021, 5573, 6159, 6405, 6877, 7700, 8684, 9591, 10054, 11353, 12434, 13760, 14758, 15471, 16527, 17722, 18539, 19319, 20417]","[0, 373, 672, 1085, 1640, 2108, 2756, 3464, 4053, 4492, 4907, 5110, 5660, 6221, 6866, 7665, 8601, 8919, 9697, 10804, 11588, 11843, 12972, 13901, 14316, 14980, 15530, 16259, 16933, 17377]","[0, 255, 453, 808, 1047, 1469, 1767, 2181, 2392, 2872, 3339, 3929, 4359, 4876, 5667, 6072, 6573, 7253, 7484, 8046, 8365, 8794, 9771, 10207, 10698, 11596, 12928, 13212, 14138, 14396]","[0, 169, 259, 349, 479, 650, 740, 1042, 1623, 1802, 2076, 2166, 2346, 2572, 2818, 3118, 3374, 3731, 4452, 4735, 5125, 5220, 6668, 7050, 7145, 7422, 8052, 8192, 8627, 8723]","[0, 169, 259, 349, 858, 1006, 1214, 1551, 1845, 2112, 2386, 2476, 2986, 3135, 3535, 3734, 4354, 4512, 4607, 4948, 5121, 5288, 5988, 6382, 6523, 6837, 7439, 7534, 8597, 8693]",20417,17377,14396,8723,8693,10,78,71,110,26,"[0, 169, 408, 546, 1057, 1345, 1915, 2351, 2814, 3200, 3631, 4257, 4672, 5170, 5765, 6304, 7283, 8204, 8873, 9357, 10241, 10380, 10621, 11750, 12416, 13166, 13966, 14508, 15262, 15777]","[0, 254, 605, 919, 1481, 1869, 2557, 3006, 3249, 3570, 3953, 4587, 4981, 5432, 6087, 6618, 7559, 8395, 8988, 9471, 10169, 10424, 11147, 11780, 12127, 12715, 13893, 14201, 15186, 15606]","[0, 252, 526, 893, 1292, 1577, 1801, 1891, 2302, 3140, 3308, 3649, 4031, 4685, 5145, 5609, 6071, 6690, 7313, 7407, 8119, 8660, 8862, 9412, 9671, 10471, 10867, 11475, 12283, 13036]","[0, 169, 259, 349, 487, 577, 762, 898, 1097, 1418, 1563, 1800, 1983, 2272, 2896, 2990, 3988, 4444, 4763, 4857, 5077, 5310, 5587, 5828, 6077, 6372, 6852, 7022, 7274, 7445]","[0, 169, 259, 394, 666, 836, 1013, 1147, 1282, 1544, 1634, 1871, 2054, 2508, 2930, 3131, 3452, 3637, 3776, 3935, 4173, 4617, 4926, 5243, 5476, 5785, 6152, 6322, 6599, 6695]",15777,15606,13036,7445,6695,4640,1771,1360,1278,1998,11047,30,radiant
7535558607,1,120,50,7,100,"[533, 738, 1216, 1610, 1948, 2425, 2829, 3172, 3668, 4235, 4732, 5369, 6021, 6736, 7271, 8247, 9200, 9899, 11049, 12222, 13456, 14774, 15790, 17351, 18694, 20231, 21290, 23234, 23957, 24899]","[338, 662, 1112, 1483, 1828, 2267, 2445, 2732, 3239, 3718, 4479, 4887, 5309, 5514, 5819, 6140, 6820, 7265, 7713, 7945, 8820, 9282, 9909, 10386, 10948, 12068, 12450, 13292, 13821, 14621]","[348, 606, 807, 1225, 1590, 1952, 2431, 2692, 3099, 3545, 4035, 4212, 4698, 5324, 5851, 6172, 6591, 6892, 7494, 7955, 8357, 9353, 9786, 10341, 11096, 11643, 12036, 12774, 13782, 14361]","[169, 304, 394, 621, 711, 801, 936, 1074, 1214, 1393, 1483, 1845, 2149, 2329, 3055, 3328, 3462, 3765, 4123, 4427, 4788, 5045, 5477, 6586, 7119, 7679, 8027, 8381, 8669, 9193]","[231, 321, 459, 638, 728, 866, 1058, 1325, 1415, 1550, 1719, 1989, 2144, 2288, 2774, 2959, 3383, 3770, 4056, 4394, 4770, 5027, 5193, 5515, 5786, 6196, 6401, 7219, 7409, 7661]",24899,14621,14361,9193,7661,21,15,106,65,19,"[203, 600, 897, 1113, 1433, 1750, 2018, 2342, 2801, 3130, 3642, 4254, 4738, 5278, 5476, 7142, 7916, 8491, 9292, 10078, 10687, 11216, 12015, 12635, 13038, 13132, 13710, 14235, 14766, 15595]","[276, 646, 855, 1085, 1397, 1644, 2023, 2588, 2884, 3585, 4055, 4430, 4958, 5362, 5726, 6684, 7282, 7688, 8573, 9479, 10221, 10844, 11486, 11869, 11964, 12544, 13032, 13362, 13702, 13889]","[458, 825, 1195, 1609, 2103, 2340, 2746, 3105, 3445, 3927, 4526, 4996, 5681, 6320, 6626, 7220, 7763, 7858, 8087, 8642, 9003, 9166, 9485, 9978, 10637, 11226, 11559, 11970, 12394, 12908]","[239, 329, 419, 509, 674, 811, 1043, 1133, 1409, 1544, 2002, 2195, 2622, 2953, 3047, 3691, 4183, 4278, 4556, 4927, 5112, 5254, 5483, 6079, 6588, 6751, 6846, 7186, 7566, 7662]","[275, 365, 455, 545, 710, 800, 890, 980, 1161, 1498, 1693, 1783, 2018, 2245, 2339, 2933, 3159, 3497, 3654, 4025, 4352, 4492, 5037, 5280, 5459, 5873, 6043, 6214, 6385, 6556]",15595,13889,12908,7662,6556,9304,732,1453,1531,1105,14125,30,radiant
7535614616,6,49,29,100,31,"[0, 663, 1026, 1573, 1844, 2405, 2615, 2967, 3392, 3544, 4025, 4420, 4896, 5348, 5733, 6266, 6671, 7196, 8480, 9435, 10415, 11422, 12660, 13324, 14249, 14958, 15647, 16295, 16945, 17492]","[0, 315, 789, 1123, 1558, 1933, 2417, 2870, 3410, 4167, 4685, 5092, 5439, 5825, 6288, 6503, 6661, 7524, 8214, 8793, 9672, 10324, 10518, 11119, 11489, 12019, 12737, 13132, 13309, 13528]","[0, 235, 452, 742, 914, 1285, 1733, 1913, 2682, 3051, 3452, 3889, 4601, 5189, 5513, 6162, 6499, 6899, 7555, 8333, 8770, 9305, 9800, 10610, 11040, 11649, 11837, 12074, 12446, 12726]","[0, 235, 390, 579, 699, 950, 1074, 1254, 1567, 2095, 2376, 2529, 3083, 3658, 4088, 4224, 4382, 4612, 5210, 5488, 6183, 6570, 6766, 7100, 7267, 7785, 7956, 8291, 8514, 8733]","[0, 235, 325, 431, 551, 641, 814, 994, 1275, 1500, 1963, 2053, 2316, 2702, 3011, 3109, 3290, 3566, 3833, 4339, 4733, 5183, 5377, 5704, 5995, 6161, 6271, 6511, 6688, 7144]",17492,13528,12726,8733,7144,113,63,22,2,102,"[0, 326, 526, 817, 1382, 1582, 2099, 2472, 2800, 3427, 4198, 4558, 5439, 5805, 6697, 6975, 7533, 8495, 8916, 9600, 10092, 10934, 11705, 12749, 13672, 14537, 15343, 16260, 16724, 18162]","[0, 170, 382, 607, 842, 1754, 2063, 2153, 2288, 2690, 3100, 3290, 3435, 3584, 3872, 4215, 4760, 5286, 5555, 6416, 6565, 7143, 7237, 7476, 8101, 8474, 9544, 9783, 10359, 11533]","[0, 284, 576, 913, 1252, 1705, 2024, 2598, 3082, 3566, 3964, 4268, 4549, 4734, 5113, 5470, 6014, 6675, 6922, 8050, 8145, 8573, 8769, 9300, 9797, 10500, 11398, 11911, 12254, 14106]","[0, 207, 297, 461, 733, 1065, 1569, 1897, 2426, 2754, 3172, 3495, 3822, 4058, 4380, 4729, 5245, 5890, 6324, 6833, 7004, 7337, 7527, 7902, 8262, 8625, 9218, 9516, 9817, 10393]","[0, 170, 260, 350, 567, 657, 841, 1064, 1199, 1470, 1832, 1922, 2058, 2395, 2590, 2685, 2819, 2977, 3071, 3273, 3368, 3623, 3717, 3881, 4123, 4364, 4644, 4892, 5312, 6096]",18162,11533,14106,10393,6096,-670,1995,-1380,-1660,1048,-667,30,dire
7535724706,70,86,97,138,110,"[249, 522, 882, 1171, 1572, 1808, 2212, 2302, 2648, 3090, 3408, 3791, 4439, 5386, 6057, 7036, 7470, 8119, 8901, 10191, 11169, 11967, 12563, 13520, 14609, 15700, 16942, 17907, 18686, 19760]","[328, 573, 896, 1295, 1753, 2162, 2500, 2926, 3220, 3710, 4358, 4538, 4803, 5328, 5866, 6544, 6995, 7399, 7575, 7831, 8394, 9145, 9384, 9912, 10587, 11343, 11946, 12510, 12701, 13124]","[169, 440, 696, 1195, 1670, 2162, 2762, 3369, 3929, 4480, 5108, 5698, 6562, 7040, 7777, 8174, 8386, 8711, 8869, 9590, 10081, 10530, 11066, 11701, 12074, 12595, 12785, 13149, 13664, 14087]","[169, 302, 392, 575, 768, 1111, 1436, 1657, 1747, 1972, 2126, 2306, 2510, 2687, 3008, 3525, 4134, 4507, 4745, 4839, 5112, 5680, 5987, 6082, 6819, 7317, 7611, 8455, 8761, 9497]","[169, 259, 431, 521, 747, 1034, 1460, 1550, 1680, 1952, 2270, 2678, 3034, 3153, 3533, 3979, 4727, 5082, 5631, 6105, 6468, 7331, 7699, 8069, 8605, 8843, 9258, 9524, 9943, 10428]",19760,13124,14087,9497,10428,113,56,98,105,100,"[296, 586, 955, 1321, 1720, 2019, 2280, 2605, 3019, 3222, 4025, 4827, 5258, 5632, 5917, 6400, 7531, 7979, 8756, 9180, 9712, 9968, 10309, 11115, 12156, 13314, 14352, 15395, 16013, 16335]","[169, 373, 623, 914, 1337, 1523, 1973, 2377, 2664, 3032, 3577, 4500, 4997, 5588, 5953, 6277, 7039, 7502, 8208, 8802, 9415, 10039, 10357, 10888, 11325, 12062, 12765, 13415, 14024, 14201]","[207, 495, 779, 1049, 1249, 1661, 1857, 2487, 2629, 2998, 3707, 4359, 5070, 5294, 6082, 6602, 7211, 7890, 8373, 8781, 9476, 9904, 10204, 10866, 11273, 11817, 12881, 13799, 14251, 14455]","[169, 259, 431, 591, 681, 771, 906, 1317, 1568, 1834, 2077, 2626, 2874, 3047, 3180, 3382, 4037, 4411, 4833, 5173, 5365, 5559, 6055, 6614, 6933, 7346, 7798, 8925, 9279, 9491]","[169, 259, 394, 591, 681, 832, 967, 1158, 1417, 1507, 1697, 2173, 2345, 2440, 2535, 2741, 3357, 3452, 3710, 3804, 4098, 4193, 4394, 4624, 4829, 5407, 5783, 6261, 6513, 6609]",16335,14201,14455,9491,6609,3425,-1077,-368,6,3819,5805,30,radiant
7535725505,41,82,49,58,26,"[0, 239, 487, 929, 1099, 1430, 1597, 2203, 2564, 2776, 3038, 3459, 4103, 4867, 5376, 6136, 7264, 7858, 8767, 9168, 9983, 10657, 11128, 12354, 13029, 14021, 14116, 14504, 15157, 17146]","[0, 273, 434, 731, 1013, 1402, 1617, 2057, 2442, 2723, 3603, 3787, 4701, 5214, 6059, 7181, 7276, 9428, 10212, 10307, 10876, 11065, 13166, 13872, 13967, 14924, 15019, 15812, 15908, 17483]","[0, 130, 398, 670, 891, 1292, 1937, 2310, 2517, 2971, 3413, 3659, 3964, 4503, 5034, 5433, 6132, 7388, 7630, 8139, 8402, 9009, 9104, 9554, 10109, 10203, 10810, 10905, 11554, 12703]","[0, 130, 220, 350, 486, 610, 735, 1041, 1453, 1543, 1823, 1913, 2214, 2345, 2560, 3110, 3389, 4164, 4582, 4716, 4848, 5937, 6857, 8061, 8156, 8441, 8761, 9088, 9184, 10181]","[0, 130, 220, 350, 547, 686, 939, 1119, 1334, 1424, 1700, 1790, 2361, 2672, 2998, 3140, 3454, 3774, 4016, 4481, 4614, 4803, 5536, 5721, 5816, 5910, 6206, 6533, 6678, 7501]",17146,17483,12703,10181,7501,53,98,113,96,9,"[100, 604, 694, 1010, 1347, 1652, 1829, 2031, 2348, 2809, 3495, 4050, 4791, 5117, 5542, 6097, 6760, 7365, 7585, 8660, 9282, 10675, 10956, 12280, 13482, 14448, 15067, 16580, 17776, 18520]","[0, 218, 501, 897, 1263, 1679, 2197, 2684, 3102, 3657, 4352, 4889, 5322, 5834, 6253, 6882, 8173, 8962, 9768, 9987, 10812, 11460, 12066, 13033, 13522, 15052, 15848, 16948, 17366, 17926]","[0, 310, 607, 903, 1385, 1541, 1791, 2297, 3129, 3505, 4058, 4725, 5592, 5914, 6450, 6553, 6828, 7138, 8230, 9094, 9633, 10256, 10947, 11780, 12215, 13223, 14060, 15872, 16566, 16856]","[0, 204, 420, 836, 983, 1704, 2149, 2606, 3096, 3313, 4074, 4578, 4885, 5217, 5787, 6153, 6556, 6761, 7691, 8516, 9121, 9637, 10194, 11131, 11504, 12092, 12693, 13494, 13969, 14285]","[0, 170, 260, 380, 527, 815, 905, 1100, 1754, 2096, 2380, 2976, 3400, 3653, 3848, 4231, 4591, 4791, 5520, 5705, 6106, 6794, 7075, 7891, 8058, 8610, 8896, 9746, 10034, 10349]",18520,17926,16856,14285,10349,-1374,-443,-4153,-4104,-2848,-12922,30,dire
7535755508,6,59,96,5,58,"[0, 290, 782, 1063, 1455, 1865, 2420, 2852, 3283, 3636, 3897, 4240, 4665, 5086, 5745, 6272, 7041, 7788, 8797, 9784, 10487, 11437, 11827, 12639, 13242, 13777, 14886, 15545, 16285, 16960]","[0, 283, 598, 968, 1270, 1588, 2098, 2276, 2577, 3055, 3631, 4252, 4807, 5800, 6300, 7088, 7800, 8224, 9189, 10226, 10922, 11429, 11887, 12241, 12903, 13254, 14061, 14155, 14467, 15107]","[0, 321, 677, 806, 1204, 1713, 2045, 2290, 2579, 2873, 3249, 3592, 4012, 4366, 4608, 5458, 5950, 6678, 7287, 8165, 8507, 9019, 9241, 9446, 10084, 10660, 10998, 11421, 12179, 12486]","[0, 169, 520, 651, 741, 871, 1412, 1502, 1592, 1729, 2025, 2303, 2593, 2742, 3004, 3371, 4011, 4679, 5261, 6402, 6840, 7464, 7714, 7883, 8608, 8891, 9304, 9904, 10386, 10706]","[0, 169, 341, 478, 623, 770, 1424, 1528, 1674, 1817, 2012, 2244, 2943, 3276, 3539, 3809, 4098, 4472, 4993, 5399, 5878, 6436, 6598, 6692, 7368, 8142, 8525, 8962, 9926, 10385]",16960,15107,12486,10706,10385,10,106,86,97,119,"[0, 204, 446, 621, 1035, 1280, 1577, 2083, 2476, 2769, 3259, 3842, 4360, 5066, 5947, 6258, 7028, 7271, 7727, 8595, 9185, 9488, 10798, 11228, 12231, 13348, 13743, 14590, 15554, 16601]","[0, 243, 495, 672, 796, 1450, 1575, 1789, 2279, 2536, 2912, 3297, 3552, 4052, 4553, 4858, 5279, 5473, 5939, 6389, 6564, 6888, 8684, 8994, 9179, 10189, 10930, 11264, 11829, 12693]","[0, 344, 632, 786, 924, 1446, 1634, 1769, 2001, 2180, 2621, 2928, 3422, 3625, 4208, 4722, 5013, 5421, 5775, 6090, 6352, 6627, 8530, 8969, 9339, 10225, 10503, 11312, 11973, 12150]","[0, 509, 758, 1040, 1375, 1615, 1744, 2122, 2301, 2775, 3576, 3922, 4302, 4630, 5111, 5304, 5595, 5860, 5955, 6107, 6331, 6426, 6810, 7705, 8502, 8781, 8876, 9186, 9676, 9887]","[0, 169, 323, 413, 570, 962, 1299, 1468, 1558, 1740, 2099, 2258, 2716, 3026, 3200, 3565, 4079, 4237, 4359, 4454, 4774, 4869, 5840, 6150, 6374, 6877, 6972, 7157, 7300, 7477]",16601,12693,12150,9887,7477,359,2414,336,819,2908,6836,30,radiant
7535757511,95,2,19,14,31,"[0, 208, 495, 804, 1278, 1603, 1764, 2027, 2884, 3301, 3738, 3908, 4375, 4860, 5159, 5629, 6080, 6550, 6950, 7258, 7874, 8525, 9216, 9753, 10400, 10662, 11440, 12031, 12528, 13112]","[0, 281, 615, 911, 1250, 1525, 1888, 2023, 2458, 2862, 3395, 3519, 3812, 4500, 5138, 6062, 6400, 6816, 7172, 7540, 8207, 8453, 9086, 9550, 9792, 10256, 11088, 11445, 11622, 11870]","[0, 398, 647, 958, 1408, 1809, 2370, 2701, 3297, 3978, 4579, 4849, 5038, 5553, 6291, 7492, 7959, 8054, 8400, 9254, 9700, 9851, 10124, 10369, 11116, 11542, 12016, 12201, 12454, 12550]","[0, 242, 332, 504, 803, 933, 1098, 1327, 1526, 1752, 2016, 2243, 2636, 2926, 3671, 4082, 4457, 4682, 4889, 5107, 5293, 5852, 6600, 7166, 7584, 7959, 8174, 8768, 8945, 9255]","[100, 475, 803, 931, 1061, 1191, 1552, 2011, 2146, 2326, 2634, 2724, 2814, 3058, 3569, 3756, 3936, 4031, 4303, 4674, 5186, 5298, 5643, 5738, 6258, 6353, 6512, 6697, 6874, 7234]",13112,11870,12550,9255,7234,10,63,96,114,20,"[0, 296, 872, 1131, 1526, 1966, 2344, 2905, 3406, 3860, 4243, 4834, 5362, 5889, 6626, 7263, 7797, 8461, 9080, 11317, 11811, 12953, 13764, 14876, 16122, 16842, 17460, 18430, 19706, 20493]","[0, 296, 466, 648, 774, 864, 1066, 1205, 1295, 1385, 1759, 2245, 2384, 2741, 3129, 3369, 3730, 4085, 4313, 5192, 5879, 6476, 6705, 7303, 7990, 8524, 8643, 9566, 10641, 11318]","[0, 368, 606, 1013, 1190, 1476, 1871, 2508, 2764, 3213, 3565, 3968, 4381, 4957, 5750, 6063, 6825, 7092, 7407, 7926, 8314, 8750, 8979, 9400, 9862, 10286, 10431, 10851, 11807, 12493]","[0, 762, 1016, 1320, 1668, 2127, 2534, 2997, 3365, 3613, 3978, 4297, 4827, 5378, 5824, 6139, 6433, 6690, 6991, 7324, 7927, 8390, 8708, 9097, 9789, 10287, 10598, 10925, 11863, 12425]","[0, 429, 588, 796, 886, 1025, 1203, 1337, 1461, 1599, 1792, 2284, 2421, 2653, 2986, 3263, 3421, 3682, 3777, 4770, 5110, 5430, 5734, 6152, 6640, 7027, 7196, 7647, 8206, 8665]",20493,11318,12493,12425,8665,-7381,552,57,-3170,-1431,-11373,30,dire
7535992313,95,21,98,75,83,"[64, 442, 605, 1007, 1329, 1670, 2058, 2265, 2676, 3056, 3603, 4195, 4616, 4764, 5595, 6121, 6924, 7747, 7842, 8381, 9162, 10658, 11008, 11671, 12467, 13230, 13993, 14351, 14615, 15353]","[332, 999, 1209, 1571, 1866, 2280, 2612, 3366, 3591, 3860, 4462, 4872, 5621, 6060, 6844, 7236, 8118, 8499, 8962, 9493, 9752, 10758, 11278, 11999, 12650, 13126, 13882, 14698, 14875, 15522]","[64, 315, 586, 818, 1286, 1831, 2136, 2731, 3058, 3708, 4300, 4954, 5342, 5526, 6474, 6759, 7221, 7401, 7736, 8102, 8700, 9095, 9456, 9811, 10383, 10984, 11557, 11806, 12016, 12247]","[64, 315, 423, 513, 712, 818, 1830, 2003, 2140, 2522, 2857, 3229, 3468, 3663, 3917, 4167, 4891, 5320, 5548, 5861, 6101, 6717, 6812, 7112, 7472, 7711, 7947, 8103, 8280, 8689]","[64, 315, 405, 495, 702, 1373, 1508, 1643, 1861, 2281, 2582, 2945, 3184, 3332, 3693, 3933, 4392, 4486, 4671, 5258, 5637, 6003, 6143, 6443, 6840, 7079, 7220, 7354, 7566, 8136]",15353,15522,12247,8689,8136,41,59,96,111,20,"[0, 204, 449, 611, 739, 926, 1332, 1725, 1984, 2397, 2663, 3102, 3472, 4563, 4852, 5482, 6087, 7172, 7933, 8806, 9747, 9842, 11016, 11798, 12608, 13439, 14605, 15311, 16243, 17081]","[0, 278, 489, 750, 1040, 1204, 1543, 1813, 2215, 2536, 2839, 3263, 3896, 4815, 5140, 5360, 5941, 6826, 7514, 8144, 9167, 9262, 10394, 10732, 11216, 11675, 11907, 12405, 12892, 13530]","[0, 254, 582, 1161, 1471, 1644, 2091, 2965, 3306, 3561, 3964, 4345, 4792, 5337, 5540, 5635, 6249, 6667, 7085, 7537, 8097, 8629, 9538, 9688, 10221, 10438, 10863, 11202, 11490, 11969]","[0, 170, 356, 446, 536, 626, 1121, 1325, 1462, 1607, 1966, 2197, 2373, 2919, 3363, 3685, 3951, 4562, 5045, 5428, 5964, 6634, 7195, 7420, 7853, 8339, 8739, 9004, 9503, 9982]","[0, 387, 477, 699, 835, 925, 1182, 1452, 1673, 1808, 2140, 2230, 2320, 2684, 2779, 2874, 3140, 3538, 3990, 4187, 4573, 4668, 5276, 5426, 5592, 5806, 5991, 6131, 6393, 6878]",17081,13530,11969,9982,6878,-1728,1992,278,-1293,1258,507,30,radiant
7535996813,21,80,137,105,26,"[298, 574, 831, 1314, 1694, 2216, 2520, 3312, 3763, 4427, 5185, 5451, 5931, 6479, 7079, 7720, 8979, 10272, 10908, 11609, 12394, 13749, 14541, 15262, 16091, 17250, 17900, 18700, 19142, 20145]","[334, 582, 856, 1259, 1662, 1786, 2318, 2889, 3387, 4157, 4918, 5520, 6142, 6589, 7159, 7458, 7899, 8145, 8303, 8658, 9327, 10202, 10974, 11380, 12461, 13167, 13418, 13986, 14586, 15655]","[371, 660, 997, 1337, 1862, 2025, 2151, 2616, 3028, 3545, 4252, 4815, 5322, 5727, 6090, 6481, 6709, 7446, 8327, 9157, 9411, 9862, 10067, 10471, 11514, 11906, 12607, 13406, 13682, 14235]","[210, 300, 390, 520, 694, 784, 874, 1224, 1362, 1923, 2454, 2563, 3056, 3405, 3744, 3955, 4434, 5633, 5897, 6358, 6527, 6859, 7139, 7511, 7987, 8769, 9559, 10279, 10548, 10941]","[210, 382, 472, 648, 738, 1160, 1524, 1707, 1846, 2150, 2593, 2813, 3301, 3487, 3665, 3963, 4724, 5308, 5606, 5931, 6025, 6549, 6875, 7045, 7715, 8226, 8493, 8959, 9297, 9765]",20145,15655,14235,10941,9765,41,19,38,53,20,"[511, 760, 1403, 1711, 2167, 2746, 3005, 3445, 3699, 3965, 4368, 4732, 5206, 5539, 5997, 6708, 7082, 7670, 8326, 8885, 9511, 10141, 11118, 11659, 12174, 12786, 13828, 14073, 14627, 15294]","[204, 506, 932, 1310, 1653, 2101, 2458, 2871, 3172, 3564, 3906, 4473, 5070, 5410, 6168, 6634, 6987, 7724, 8118, 8540, 8972, 9496, 10423, 10940, 11275, 11801, 12319, 12593, 12830, 13184]","[204, 480, 693, 941, 1071, 1161, 1587, 1847, 2096, 2977, 3617, 3996, 4443, 5347, 6094, 6644, 7700, 8105, 8466, 9063, 9636, 10130, 11322, 11923, 12649, 13136, 14164, 14260, 14573, 15142]","[204, 332, 503, 638, 1041, 1292, 1500, 1873, 2002, 2226, 2417, 2723, 3032, 3455, 3932, 4364, 4549, 5197, 5726, 6171, 6565, 7321, 8156, 8799, 9272, 9528, 10304, 10479, 11114, 12018]","[204, 346, 605, 780, 1148, 1384, 1592, 1806, 1896, 2075, 2436, 2628, 2826, 3090, 3762, 4247, 5762, 6374, 6532, 6717, 6825, 7071, 7462, 8042, 8842, 9178, 9273, 9422, 9805, 10259]",15294,13184,15142,12018,10259,4851,2471,-907,-1077,-494,4844,30,dire
7536605901,10,71,120,110,121,"[0, 130, 369, 816, 1226, 1585, 1920, 2362, 2746, 3295, 3715, 4334, 4700, 5292, 5769, 6338, 7231, 7943, 8833, 9900, 10292, 10901, 11887, 12634, 13064, 13924, 14669, 14763, 15301, 15916]","[0, 164, 516, 796, 1101, 1544, 1806, 2331, 3058, 3476, 3883, 4708, 5478, 6054, 6864, 7402, 8372, 8675, 9073, 9772, 10315, 10482, 11456, 12123, 12302, 12795, 13622, 13784, 14359, 14740]","[0, 296, 494, 940, 1336, 1741, 2011, 2500, 2986, 3558, 4051, 4424, 5233, 5896, 6322, 6633, 7359, 7642, 8206, 9098, 9193, 9660, 10267, 10779, 11568, 11898, 12153, 12671, 13371, 13721]","[0, 168, 258, 415, 641, 798, 888, 1205, 1339, 1474, 1702, 1868, 2396, 2725, 2846, 3074, 4286, 4748, 5015, 5323, 5569, 5736, 5865, 5959, 6054, 6221, 7153, 7435, 7821, 7917]","[0, 175, 602, 692, 937, 1122, 1388, 1556, 1869, 2032, 2200, 2466, 2667, 3089, 3259, 3502, 3935, 4133, 4551, 5228, 5474, 5641, 5839, 6139, 6684, 6911, 7392, 7486, 8025, 8228]",15916,14740,13721,7917,8228,89,106,97,105,75,"[0, 209, 566, 1050, 1386, 1748, 2039, 2538, 2791, 3087, 3762, 4244, 5024, 6073, 7018, 7340, 8410, 9387, 10603, 11383, 11613, 12843, 14416, 15627, 16487, 17868, 18608, 19600, 21528, 22505]","[0, 328, 681, 1007, 1368, 1723, 1930, 2668, 3058, 3830, 4396, 4732, 5311, 5758, 6395, 7000, 7427, 8091, 8300, 9205, 9746, 10877, 11281, 11738, 12333, 12760, 13455, 15258, 15598, 16312]","[0, 209, 556, 799, 1245, 1637, 2047, 2445, 2864, 3444, 3959, 4380, 4922, 5180, 6249, 6836, 8042, 8200, 8488, 9446, 10210, 10377, 11073, 11693, 12333, 12930, 13427, 14346, 15082, 15564]","[0, 170, 260, 416, 506, 661, 796, 961, 1096, 1596, 1776, 2293, 2548, 2762, 3173, 3585, 4361, 4605, 4893, 5096, 5744, 6056, 6477, 6902, 7741, 8029, 8435, 9608, 9949, 10304]","[0, 170, 305, 441, 629, 759, 951, 1244, 1397, 1646, 2028, 2278, 2491, 2705, 2911, 3405, 3981, 4139, 4432, 4783, 5169, 5600, 5932, 6190, 6375, 6614, 6981, 7089, 7456, 7977]",22505,16312,15564,10304,7977,-6589,-1572,-1843,-2387,251,-12140,30,dire
7536677705,113,22,96,65,105,"[73, 237, 645, 817, 1189, 1548, 1960, 2368, 2672, 3075, 3953, 4442, 4900, 5522, 6135, 6948, 7696, 8310, 8911, 10263, 11091, 11588, 12789, 13848, 15032, 15828, 17063, 17850, 18711, 18807]","[73, 326, 719, 1125, 1390, 1800, 2373, 2730, 3237, 3697, 4331, 4849, 5336, 6039, 6297, 6943, 7283, 7632, 8087, 8984, 9374, 9768, 10595, 11000, 11900, 12707, 13196, 13372, 13792, 13983]","[73, 285, 566, 1009, 1431, 1796, 2130, 2385, 2763, 3014, 3475, 3950, 4410, 5409, 5962, 6676, 7092, 7729, 8045, 8659, 9189, 9715, 9953, 10138, 10676, 10770, 10994, 11420, 12069, 12165]","[73, 203, 293, 531, 848, 958, 1369, 1836, 2249, 2546, 3061, 3800, 4340, 4903, 5217, 5815, 6110, 6448, 7197, 7645, 7740, 7835, 8368, 8736, 9199, 9293, 9388, 9844, 10458, 10554]","[206, 336, 441, 531, 666, 756, 1174, 2005, 2193, 2705, 3606, 3732, 4070, 4450, 4838, 5289, 6066, 6211, 6417, 6733, 7489, 7584, 7812, 7997, 8284, 8878, 9045, 9717, 10057, 10153]",18807,13983,12165,10554,10153,94,106,69,58,121,"[174, 420, 627, 966, 1287, 1735, 2096, 2474, 3039, 3507, 4174, 4545, 5188, 5790, 6421, 7081, 7831, 8291, 8644, 9565, 10607, 11261, 12368, 12882, 14199, 15194, 16994, 17787, 19006, 19710]","[307, 703, 951, 1246, 1646, 2059, 2592, 2917, 3091, 3447, 3582, 3965, 4636, 4839, 5525, 5922, 6509, 6961, 7717, 8123, 8959, 9499, 10715, 11442, 12295, 13341, 14100, 15021, 16245, 17018]","[174, 420, 774, 1168, 1581, 1973, 2430, 3191, 3576, 3992, 4204, 4843, 5252, 5785, 6170, 6643, 7311, 7718, 8011, 8602, 9048, 9552, 10258, 10886, 11215, 11951, 13231, 13706, 14830, 15599]","[442, 652, 742, 832, 1074, 1288, 1607, 1852, 2099, 2508, 2680, 3104, 3518, 3721, 3990, 4349, 4834, 5495, 5686, 5893, 6306, 6493, 7074, 7321, 7721, 8454, 8804, 9082, 9585, 10043]","[307, 517, 607, 745, 870, 1125, 1287, 1754, 2059, 2219, 2393, 2800, 2980, 3183, 3377, 3500, 3681, 4313, 4407, 4647, 4829, 4924, 5937, 6032, 6171, 6409, 7004, 7234, 7876, 8252]",19710,17018,15599,10043,8252,-903,-3035,-3434,511,1901,-4960,30,radiant
7537185709,42,120,96,85,121,"[0, 285, 609, 1016, 1297, 1578, 1958, 2261, 2964, 3196, 3652, 4000, 4487, 5055, 5763, 6118, 6766, 7191, 8085, 8558, 9195, 10255, 10927, 11639, 12358, 13375, 13581, 14488, 15094, 15556]","[0, 240, 571, 902, 1123, 1486, 1699, 2087, 2488, 2676, 3246, 3389, 4193, 4632, 4965, 5416, 5993, 6567, 7590, 7837, 8382, 9062, 9565, 10331, 10675, 11089, 11432, 12042, 12678, 13432]","[0, 244, 489, 734, 939, 1262, 1637, 1930, 2456, 2813, 3190, 3280, 3661, 3810, 3951, 4045, 4469, 4607, 5336, 5493, 5737, 6217, 6329, 7213, 7558, 7860, 8326, 8547, 8724, 8930]","[100, 270, 360, 606, 791, 926, 1061, 1241, 1676, 1803, 2342, 2432, 2809, 2958, 3087, 3181, 3467, 3887, 4259, 4416, 4811, 4906, 5000, 5278, 5373, 5789, 5883, 6336, 6549, 6755]","[0, 170, 296, 386, 551, 701, 791, 971, 1328, 1713, 2244, 2334, 2469, 2618, 2713, 2845, 3183, 3443, 3662, 4115, 4210, 4378, 4556, 4751, 4897, 5199, 5495, 5921, 6134, 6340]",15556,13432,8930,6755,6340,113,78,48,30,26,"[0, 326, 568, 818, 1534, 1916, 2467, 3185, 3727, 4213, 4713, 5349, 6062, 7497, 8730, 9553, 10375, 11015, 11521, 13855, 14682, 16008, 16859, 17588, 18232, 19757, 20491, 22136, 23150, 25017]","[0, 207, 493, 697, 1046, 1248, 1583, 1829, 1919, 2449, 2932, 3769, 4476, 4827, 5539, 6084, 6444, 7045, 7744, 8296, 8896, 9527, 10263, 11043, 11639, 13035, 13601, 14518, 15003, 16167]","[0, 252, 415, 589, 893, 1017, 1323, 1695, 1823, 2243, 2423, 2777, 3125, 3544, 4267, 4606, 5115, 5639, 6076, 6634, 7166, 7857, 8646, 9441, 9979, 11156, 11805, 12671, 13166, 14230]","[0, 170, 260, 350, 486, 576, 774, 909, 1076, 1176, 1321, 1689, 1986, 2267, 2624, 2718, 2876, 3043, 3177, 3334, 3429, 3619, 3968, 4063, 4374, 5286, 5496, 5861, 6111, 7638]","[0, 170, 260, 350, 485, 575, 757, 847, 937, 1071, 1216, 1476, 1856, 2527, 2972, 3117, 3275, 3411, 3600, 3757, 3852, 4088, 4254, 4349, 4444, 4668, 5173, 5744, 5950, 6799]",25017,16167,14230,7638,6799,-9461,-2735,-5300,-883,-459,-18838,30,dire
7537775002,41,39,97,123,20,"[326, 613, 928, 1248, 1470, 1882, 2043, 2507, 3040, 3662, 4018, 4648, 4929, 5257, 5772, 6265, 7282, 8159, 8728, 9259, 9769, 10154, 10497, 11106, 12274, 12673, 13748, 14739, 15542, 16124]","[58, 336, 744, 1038, 1524, 1778, 2190, 2679, 3054, 3533, 4003, 4687, 5126, 5740, 6257, 6500, 7840, 8608, 8855, 9802, 10495, 10917, 11940, 13226, 13818, 14514, 15000, 15693, 16295, 16748]","[58, 277, 514, 802, 1048, 1576, 1915, 2294, 2709, 3250, 3518, 4109, 4683, 5256, 5533, 5770, 6334, 6772, 7077, 7926, 8267, 8554, 8723, 9302, 9607, 10445, 11258, 12084, 12794, 12965]","[58, 188, 278, 398, 524, 742, 832, 1121, 1331, 1599, 1866, 2192, 2743, 3389, 3992, 4265, 5143, 5454, 5715, 6366, 6728, 7185, 7438, 8477, 9042, 9321, 9834, 10537, 10917, 11238]","[58, 188, 314, 473, 603, 893, 1018, 1223, 1470, 1871, 2213, 2612, 2792, 3293, 3473, 3657, 4180, 4491, 4683, 4985, 5155, 5325, 5494, 6791, 7155, 7325, 7604, 7982, 8437, 8736]",16124,16748,12965,11238,8736,82,74,129,65,105,"[0, 255, 662, 999, 1385, 1754, 2282, 2780, 3467, 4162, 4559, 4827, 5641, 5958, 6867, 7657, 8591, 9193, 9774, 10006, 11384, 12546, 13089, 13529, 14123, 15224, 16092, 16669, 17519, 17836]","[0, 256, 540, 875, 1142, 1559, 1972, 2410, 2904, 3391, 3721, 4080, 4465, 4941, 5679, 5988, 6173, 6339, 6472, 7659, 8279, 8663, 9551, 9762, 10125, 10875, 11636, 12396, 13257, 13880]","[0, 260, 532, 914, 1307, 1504, 2000, 2346, 2807, 2984, 3241, 3818, 4448, 4977, 5304, 6201, 6386, 7043, 7651, 8140, 8995, 9683, 9934, 10145, 10776, 11087, 11620, 11906, 12108, 12378]","[100, 310, 400, 490, 775, 985, 1075, 1367, 1654, 1744, 1995, 2304, 2520, 2836, 3124, 3564, 3912, 4007, 4537, 5026, 5625, 6180, 6598, 6864, 7309, 8020, 8613, 8863, 9248, 9697]","[0, 210, 300, 498, 618, 743, 927, 1093, 1276, 1568, 1865, 2096, 2560, 2747, 3246, 3533, 3816, 3911, 4052, 4941, 5883, 6769, 7020, 7231, 7398, 7637, 7812, 8273, 9157, 9556]",17836,13880,12378,9697,9556,-1712,2868,587,1541,-820,2464,30,radiant
7537910800,73,120,129,53,79,"[1, 388, 662, 1059, 1328, 1719, 2161, 2928, 3255, 4180, 4807, 5642, 6241, 7749, 8689, 8972, 10258, 11023, 11885, 13207, 14539, 15717, 16338, 17103, 17948, 18965, 19728, 20996, 21928, 22803]","[1, 242, 484, 650, 965, 1368, 1574, 2400, 2646, 3201, 3695, 4168, 4952, 5108, 5552, 6356, 7699, 8548, 9306, 10044, 10565, 10864, 11677, 12446, 12914, 13654, 14310, 15102, 15900, 16558]","[1, 258, 437, 918, 1391, 1809, 2425, 2841, 3292, 3613, 4098, 4250, 4874, 5500, 5801, 6365, 7498, 8261, 8875, 9451, 10092, 11338, 11862, 12480, 13007, 13536, 14270, 14834, 15364, 16258]","[1, 323, 413, 582, 672, 880, 1086, 1266, 1489, 1734, 2054, 2224, 2603, 2934, 3085, 3363, 4201, 4893, 5123, 5610, 5977, 6161, 6684, 7424, 8052, 8664, 8981, 9618, 10261, 10942]","[1, 491, 581, 701, 829, 1145, 1516, 1696, 1803, 2141, 2505, 2885, 3222, 3426, 3799, 4054, 4601, 5225, 5542, 5947, 6479, 6884, 7389, 7816, 8029, 8582, 9100, 9490, 9880, 10635]",22803,16558,16258,10942,10635,47,41,55,51,110,"[1, 256, 544, 804, 1161, 1554, 2242, 2413, 2897, 3529, 3928, 4235, 4837, 5290, 5689, 6051, 6353, 7033, 7278, 7676, 8335, 9066, 9645, 10266, 10439, 10678, 11324, 11807, 12140, 12547]","[1, 171, 387, 595, 978, 1189, 1524, 1820, 2188, 2406, 2918, 3417, 3962, 4391, 5125, 5620, 6116, 6432, 6809, 7491, 8481, 8576, 9036, 9720, 10105, 11068, 11634, 12284, 12631, 13652]","[1, 171, 368, 527, 1033, 1418, 1733, 2257, 2814, 3363, 3837, 4407, 4980, 5380, 6017, 6619, 6981, 7380, 7774, 8224, 9195, 9290, 9902, 10497, 10683, 11322, 11664, 11972, 12204, 12598]","[1, 216, 306, 396, 526, 633, 829, 1045, 1329, 1552, 1687, 2026, 2116, 2412, 2967, 3291, 3439, 3534, 3744, 4109, 4854, 4949, 5354, 5521, 5860, 6551, 6823, 6918, 7105, 7201]","[1, 171, 261, 399, 573, 663, 1026, 1161, 1268, 1366, 1501, 1711, 2014, 2254, 2698, 2809, 3188, 3572, 3908, 4003, 4590, 4964, 5287, 5884, 6317, 6484, 7032, 7127, 7223, 7319]",12547,13652,12598,7201,7319,10256,2906,3660,3741,3316,23879,30,radiant
7538340310,7,55,41,51,20,"[0, 329, 760, 1177, 1707, 2109, 2526, 3355, 3899, 4433, 4970, 5404, 6044, 6756, 7383, 7921, 8500, 9046, 9798, 10190, 11251, 11667, 12524, 13718, 13813, 14194, 17245, 17340, 17970, 18066]","[0, 239, 572, 933, 1322, 2113, 2513, 3149, 3765, 4585, 5296, 5645, 6510, 7523, 8090, 8499, 9454, 9635, 10352, 10959, 11054, 11305, 11885, 12621, 13057, 13659, 14616, 15163, 15801, 16517]","[0, 254, 734, 1134, 1329, 1834, 2241, 2734, 3095, 3478, 3977, 4672, 5268, 5782, 6033, 6545, 7182, 8077, 8777, 9538, 10425, 11021, 11694, 12680, 13119, 13213, 14275, 14446, 14681, 14941]","[0, 208, 322, 461, 598, 853, 943, 1260, 1465, 1555, 1854, 2109, 2429, 2971, 3237, 3765, 4278, 4648, 5248, 5378, 5740, 6152, 6912, 7873, 7968, 8062, 8466, 9022, 9683, 10004]","[0, 170, 260, 481, 615, 822, 912, 1250, 1455, 1637, 1984, 2354, 2498, 3108, 3744, 3972, 4331, 4512, 4651, 4787, 5166, 5432, 5735, 5984, 6079, 6328, 7420, 7795, 8088, 8348]",18066,16517,14941,10004,8348,11,105,2,9,114,"[0, 290, 979, 1302, 1760, 2211, 2704, 3434, 3801, 4063, 4575, 5308, 5826, 6230, 6393, 7094, 7739, 8339, 9215, 10296, 10908, 12049, 12529, 13954, 15186, 16727, 16822, 17632, 18586, 19546]","[0, 338, 716, 1057, 1477, 1973, 2501, 2705, 3122, 3559, 4186, 4510, 4923, 5389, 6345, 6701, 7471, 7994, 9424, 9603, 10077, 10934, 11506, 12559, 13266, 13727, 14166, 16015, 16939, 18290]","[0, 281, 544, 944, 1270, 1699, 2252, 2777, 3334, 3864, 4397, 5026, 5433, 6124, 7514, 7722, 8113, 9154, 9622, 10181, 10433, 11416, 11609, 12486, 12966, 13958, 14498, 14974, 16314, 17363]","[0, 170, 349, 538, 754, 990, 1213, 1385, 1620, 1829, 2055, 2487, 2810, 3008, 3212, 3656, 4068, 4688, 5630, 6166, 6361, 6697, 6910, 7332, 7782, 8479, 9188, 9647, 10587, 11163]","[0, 170, 360, 499, 673, 763, 893, 1108, 1284, 1413, 1725, 1916, 2109, 2307, 2839, 2934, 3248, 3644, 4209, 4837, 5162, 6053, 6321, 6623, 7137, 7448, 7816, 8178, 8539, 9616]",19546,18290,17363,11163,9616,-1480,-1773,-2422,-1159,-1268,-8102,30,dire
7538469504,10,106,78,75,26,"[0, 167, 499, 917, 1286, 1568, 2081, 2542, 3020, 3445, 3877, 4586, 5247, 5735, 6468, 7061, 7612, 8098, 9224, 9894, 10971, 11752, 12256, 13099, 13816, 14811, 15753, 16989, 18519, 19288]","[0, 168, 451, 814, 983, 1149, 1351, 1656, 1908, 2282, 2631, 2911, 3603, 4041, 4423, 4690, 4918, 5750, 6259, 6768, 7131, 7479, 7772, 8402, 8989, 9084, 10031, 10709, 11514, 12105]","[0, 167, 576, 825, 1085, 1415, 1787, 2097, 2389, 2964, 3574, 3955, 4171, 4473, 4760, 5068, 5491, 5755, 6295, 6618, 6987, 7283, 7610, 8463, 8682, 9063, 9205, 10024, 10525, 11026]","[0, 129, 219, 309, 399, 489, 579, 821, 926, 1166, 1382, 1771, 2005, 2222, 2600, 2695, 3060, 3423, 3783, 4326, 4680, 4976, 5303, 5727, 5893, 6191, 6375, 7103, 7474, 7811]","[0, 129, 276, 366, 456, 546, 636, 861, 1046, 1320, 1620, 1800, 2271, 2779, 2955, 3101, 3243, 3522, 3830, 4409, 4642, 5118, 5360, 5720, 5925, 6095, 6412, 7222, 7726, 7978]",19288,12105,11026,7811,7978,41,49,102,58,110,"[0, 209, 372, 576, 851, 1474, 1794, 2102, 2622, 3257, 3571, 3938, 4343, 5040, 5582, 5935, 6273, 7128, 7659, 8417, 9449, 10002, 11371, 12333, 13471, 14289, 15012, 15842, 16568, 17111]","[0, 335, 664, 911, 1378, 1595, 2093, 2584, 2963, 3334, 3943, 4260, 4592, 5329, 6094, 6647, 6865, 7212, 7925, 8231, 9090, 9417, 10579, 11516, 12396, 13394, 14081, 14626, 14803, 15852]","[0, 295, 494, 656, 897, 1458, 1690, 2239, 2662, 3129, 3552, 4194, 4663, 5092, 5632, 6021, 6390, 6933, 7412, 8080, 8559, 8886, 10364, 10854, 11616, 12353, 12987, 13739, 13916, 14691]","[0, 209, 299, 407, 514, 664, 819, 1221, 1311, 1762, 2139, 2527, 2712, 3029, 3161, 3410, 3613, 3857, 4216, 4498, 4834, 5453, 5977, 6492, 6957, 7769, 8221, 8812, 9294, 9828]","[0, 258, 348, 438, 567, 742, 832, 1311, 1401, 1718, 1908, 2302, 2743, 3033, 3220, 3472, 3629, 3834, 4073, 4325, 4674, 4904, 5276, 5504, 5790, 6361, 6947, 7274, 7517, 8023]",17111,15852,14691,9828,8023,2177,-3747,-3665,-2017,-45,-7297,30,dire
7538527908,89,46,23,26,105,"[0, 208, 660, 1101, 1419, 1837, 2266, 2737, 3189, 3769, 4193, 4373, 4962, 5666, 6079, 6855, 7582, 7874, 8496, 9404, 10360, 11189, 12966, 14279, 14557, 15087, 16036, 16932, 17878, 19077]","[0, 204, 406, 607, 731, 1003, 1364, 1794, 2008, 2471, 2976, 3542, 4063, 4824, 5571, 6311, 7258, 8084, 8809, 9465, 10098, 10193, 11380, 12104, 12867, 13494, 14189, 14989, 15647, 16457]","[0, 242, 653, 908, 1153, 1572, 1930, 2055, 2688, 2932, 3742, 4032, 4960, 5089, 5645, 6178, 6642, 7085, 7866, 8096, 8941, 9353, 10450, 11073, 11568, 12262, 12918, 13350, 13620, 14170]","[0, 169, 259, 396, 766, 926, 1155, 1371, 1507, 1861, 2053, 2195, 2453, 2548, 2643, 2997, 3454, 3549, 3734, 3964, 4058, 4153, 4730, 5049, 5143, 5928, 6059, 6240, 6944, 7385]","[0, 169, 259, 349, 439, 564, 793, 883, 1057, 1316, 1637, 1799, 2057, 2187, 2436, 2531, 2688, 2864, 3457, 3687, 3781, 4045, 4762, 4998, 5092, 5318, 5413, 5507, 5717, 6320]",19077,16457,14170,7385,6320,41,22,96,123,20,"[0, 171, 470, 748, 1248, 1628, 1879, 2290, 2724, 3411, 3885, 4417, 4849, 5481, 6292, 6895, 7816, 8738, 9617, 10435, 11300, 12532, 13339, 14043, 15584, 16164, 16730, 17565, 18015, 18561]","[2, 246, 615, 1379, 1667, 2084, 2441, 3041, 3730, 4342, 4955, 5414, 6075, 6263, 6873, 7685, 8298, 9062, 9889, 10565, 11517, 12348, 12928, 13762, 14677, 15380, 16339, 17094, 17865, 18726]","[0, 277, 554, 919, 1417, 1739, 2686, 3220, 3830, 4581, 4974, 5602, 6194, 6560, 6991, 7581, 8083, 8723, 9690, 10292, 11135, 11787, 11882, 12078, 12754, 13192, 14141, 14579, 14768, 14864]","[0, 169, 259, 396, 828, 918, 1384, 1655, 2125, 2583, 2743, 2921, 3234, 3533, 3968, 4254, 4430, 4802, 5492, 5928, 6299, 6547, 6642, 7385, 7881, 8139, 8531, 8635, 9340, 9562]","[2, 173, 297, 425, 585, 793, 1063, 1288, 1585, 2089, 2268, 2405, 2577, 2770, 2969, 3178, 3436, 3720, 4088, 4345, 4750, 5119, 5259, 5354, 5731, 5898, 6278, 6372, 6493, 6589]",18561,18726,14864,9562,6589,516,-2269,-694,-2177,-269,-4893,30,dire
7538558409,138,29,19,64,45,"[0, 361, 601, 889, 1271, 1676, 1940, 2185, 2312, 2882, 3203, 3402, 4167, 4719, 5148, 5679, 6413, 6962, 7694, 7789, 8609, 9642, 11398, 11633, 12122, 12984, 13392, 14146, 14883, 15443]","[0, 454, 793, 990, 1524, 2073, 2613, 3207, 3588, 4065, 4665, 5273, 5616, 6135, 6617, 7531, 8003, 8371, 9064, 9340, 10047, 10332, 10553, 11447, 12235, 13173, 13268, 14027, 14123, 15268]","[0, 328, 659, 858, 1149, 1520, 1854, 2231, 2676, 3120, 3739, 4537, 4872, 5110, 5851, 6517, 6611, 7309, 7687, 7959, 8926, 9667, 10454, 11373, 12115, 12581, 12676, 13127, 13512, 14050]","[0, 287, 380, 470, 845, 1059, 1280, 1460, 1801, 2286, 2511, 3446, 3580, 3969, 4538, 5091, 5497, 6311, 6523, 6654, 6990, 7133, 7228, 7322, 7527, 7812, 7907, 8237, 8488, 8813]","[0, 210, 316, 406, 594, 775, 865, 1045, 1221, 1603, 2179, 2619, 2821, 3001, 3406, 3766, 3983, 4778, 5043, 5138, 6027, 6170, 6410, 7236, 7637, 8093, 8188, 8494, 8590, 9145]",15443,15268,14050,8813,9145,74,129,6,53,103,"[0, 166, 408, 846, 1125, 1532, 1890, 2285, 2587, 2888, 3049, 3283, 3658, 4087, 4721, 4816, 5700, 6280, 8390, 9171, 9617, 10753, 11578, 11842, 12975, 13436, 15418, 16255, 16695, 17746]","[0, 470, 630, 1001, 1295, 1421, 2137, 2709, 3183, 3463, 3955, 4620, 5243, 5624, 6431, 6736, 7143, 7398, 8317, 8933, 9282, 9827, 10323, 11107, 11979, 12596, 13428, 14085, 14763, 16403]","[0, 323, 691, 884, 1166, 1319, 1721, 1919, 2158, 2248, 2502, 2646, 3025, 3368, 3805, 4008, 4506, 4761, 5518, 6208, 6693, 7102, 7527, 8043, 8547, 9426, 9906, 11065, 12030, 12370]","[0, 202, 311, 431, 617, 955, 1277, 1552, 1732, 1872, 2604, 3115, 3465, 3865, 4159, 4920, 5014, 5374, 5885, 6954, 7224, 7962, 8960, 9224, 10021, 11300, 11959, 12493, 13148, 13592]","[0, 202, 292, 459, 549, 639, 1110, 1293, 1512, 1685, 1976, 2362, 2542, 2750, 2969, 3064, 3460, 3698, 4557, 5250, 5475, 6323, 6865, 7129, 7805, 8044, 8787, 9274, 9896, 10479]",17746,16403,12370,13592,10479,-2303,-1135,1680,-4779,-1334,-7871,30,dire
7538571609,25,90,105,137,121,"[656, 1108, 1482, 1814, 1939, 2309, 2660, 3102, 3443, 3635, 4197, 4623, 5165, 5937, 6366, 6881, 8195, 8912, 9512, 10206, 10301, 11177, 11908, 12809, 13559, 13948, 14552, 15502, 15619, 15992]","[611, 858, 1228, 1600, 1777, 2041, 2775, 3245, 3475, 3655, 3896, 4670, 5034, 5705, 5905, 6240, 7367, 8014, 8516, 9079, 9744, 10270, 10744, 11444, 11914, 12178, 12410, 12668, 13375, 14055]","[639, 912, 1047, 1338, 1597, 1836, 2253, 2428, 2731, 2821, 3412, 3620, 4363, 4641, 5437, 5532, 6210, 6895, 7010, 7662, 8034, 8735, 9116, 9286, 9546, 9715, 9886, 10263, 11022, 11915]","[651, 1203, 1642, 1919, 2486, 3318, 3599, 4310, 4713, 4905, 5520, 5615, 6025, 6629, 7217, 7530, 8391, 8860, 8955, 9050, 9367, 9644, 9997, 10092, 10277, 10371, 10467, 10774, 10870, 11325]","[421, 719, 934, 1602, 2007, 2589, 2679, 2987, 3217, 3590, 3734, 4093, 4378, 4608, 4703, 5102, 6177, 6761, 6856, 6997, 7092, 7446, 7613, 7708, 7893, 7987, 8083, 8390, 8520, 8825]",15992,14055,11915,11325,8825,113,69,114,112,5,"[691, 1034, 1438, 1977, 2617, 3010, 3355, 3844, 4606, 5478, 5813, 6725, 7558, 8143, 9148, 9823, 10478, 11305, 12042, 13611, 14224, 14994, 15922, 16729, 17736, 18791, 19285, 20245, 21502, 22684]","[564, 885, 1144, 1781, 2289, 2608, 3379, 3946, 4694, 5089, 5707, 6312, 6627, 6948, 7528, 8333, 8758, 8931, 9488, 10274, 11045, 11442, 12040, 13308, 14223, 14855, 15147, 15748, 16513, 17297]","[578, 1079, 1367, 1966, 2198, 2596, 2903, 3098, 3451, 3905, 4210, 4622, 5082, 5400, 5648, 6268, 6363, 7071, 7248, 7886, 8373, 8885, 9136, 9586, 10490, 11167, 11308, 12032, 12482, 12939]","[360, 499, 589, 865, 1098, 1645, 1861, 2080, 2690, 3118, 3376, 3753, 4025, 4270, 4637, 4777, 5015, 5488, 5632, 7292, 7818, 8516, 9009, 9683, 10458, 11410, 11725, 12066, 12476, 13144]","[259, 469, 783, 1013, 1236, 1558, 1812, 1992, 2646, 2894, 3183, 3436, 3718, 3812, 4469, 4564, 4839, 5190, 5468, 5949, 6149, 6450, 6655, 7205, 7727, 8174, 8314, 8655, 9063, 9804]",22684,17297,12939,13144,9804,-6692,-3242,-1024,-1819,-979,-13756,30,dire
7538618712,41,120,55,26,7,"[479, 890, 1090, 1579, 1946, 2283, 2695, 3085, 3607, 4146, 4850, 5281, 6102, 6565, 7280, 7417, 8245, 8787, 9441, 9536, 10213, 11028, 11805, 12848, 13668, 14259, 15039, 15712, 15976, 16318]","[621, 963, 1300, 1703, 2289, 2706, 3083, 3606, 3870, 4514, 4902, 5186, 5543, 5819, 6202, 6334, 6890, 7571, 8145, 8478, 9223, 9777, 10346, 11097, 11616, 12510, 13441, 14104, 14417, 14761]","[511, 756, 1094, 1796, 2179, 2613, 2986, 3514, 4048, 4690, 5061, 5656, 6484, 6856, 7085, 7303, 7558, 7877, 8195, 8540, 9060, 9313, 9715, 10182, 10554, 10877, 11135, 11366, 11483, 11726]","[271, 361, 451, 759, 1190, 1443, 1614, 1794, 2111, 2201, 2534, 2856, 3194, 3332, 3490, 3643, 3884, 4041, 4188, 4427, 4596, 4766, 5008, 5522, 5953, 6605, 7031, 7279, 7450, 7709]","[271, 361, 787, 1251, 1515, 1605, 1740, 1920, 2098, 2308, 2488, 2876, 3376, 3717, 4098, 4193, 4544, 4701, 4796, 4891, 5196, 5340, 5596, 5998, 6340, 6435, 6693, 6819, 6963, 7189]",16318,14761,11726,7709,7189,48,97,106,58,86,"[528, 738, 1185, 1471, 1904, 2219, 2772, 3414, 4102, 4618, 5227, 6345, 7007, 7667, 8544, 9297, 10065, 11086, 12162, 13350, 14582, 15426, 16302, 17256, 19101, 21029, 22412, 23908, 24808, 25844]","[526, 1022, 1480, 1940, 2376, 2876, 3265, 3892, 4877, 5494, 6287, 6856, 7131, 7797, 8243, 8668, 9659, 10066, 10596, 10888, 11557, 12092, 12830, 13141, 13902, 14519, 15229, 15406, 15702, 16219]","[673, 1038, 1357, 1691, 2084, 2570, 2898, 3074, 3682, 3965, 4624, 5225, 5709, 5803, 6162, 6565, 7148, 7988, 8323, 8725, 9546, 9713, 10431, 10879, 11925, 12336, 12688, 13282, 14298, 14998]","[300, 440, 799, 929, 1099, 1363, 1453, 1722, 2399, 2703, 2900, 3249, 3344, 3511, 3826, 4334, 4467, 4809, 5168, 5650, 5854, 6021, 6424, 6759, 7467, 7807, 8148, 8325, 8524, 9275]","[395, 690, 869, 1036, 1452, 1764, 1898, 2229, 2682, 2932, 3252, 3614, 3761, 3855, 4013, 4329, 4666, 4954, 5463, 5708, 6089, 6300, 6530, 6841, 7502, 8077, 8419, 8596, 9026, 9216]",25844,16219,14998,9275,9216,-9526,-1458,-3272,-1566,-2027,-17849,30,dire
7538635507,25,120,69,84,5,"[0, 203, 441, 935, 1343, 1782, 2372, 2904, 3566, 3896, 4688, 5122, 5924, 6291, 6624, 7147, 7816, 8365, 9188, 10088, 10463, 11353, 11495, 11925, 12020, 12647, 13117, 13547, 14226, 16500]","[0, 328, 646, 1136, 1469, 1935, 2484, 2865, 3234, 3740, 4269, 4893, 5502, 5952, 6858, 7534, 7886, 8880, 9389, 9550, 9901, 10810, 11265, 11655, 11947, 12509, 12603, 12779, 13138, 13467]","[0, 204, 449, 727, 1031, 1256, 1858, 1984, 2246, 2761, 3371, 3769, 4565, 5394, 6335, 6851, 7330, 8046, 8711, 8893, 9738, 10618, 11375, 11514, 11805, 12103, 12501, 12714, 13228, 14447]","[0, 169, 259, 402, 577, 1062, 1227, 1386, 1523, 1658, 2008, 2098, 2376, 2741, 3417, 3977, 4383, 5375, 5687, 6210, 6700, 7344, 7663, 8554, 9226, 9396, 9607, 9858, 10221, 11644]","[0, 221, 350, 487, 617, 770, 905, 1107, 1197, 1371, 1652, 1779, 2195, 2533, 2923, 3149, 3307, 3719, 4089, 4184, 4378, 4809, 5053, 5148, 5243, 5438, 5579, 5755, 6053, 6940]",16500,13467,14447,11644,6940,54,21,55,88,66,"[0, 293, 596, 761, 1326, 1662, 2075, 2516, 3171, 3643, 3878, 4344, 4839, 5282, 5840, 6721, 7474, 7953, 8296, 9621, 10296, 10749, 12112, 12207, 13361, 14063, 15028, 15716, 17564, 18330]","[0, 291, 576, 891, 1349, 1700, 2020, 2581, 2996, 3530, 3826, 4043, 4297, 5295, 5864, 6572, 7160, 7366, 7752, 8453, 9252, 10057, 10751, 10846, 12335, 13083, 14482, 15078, 15284, 15955]","[0, 206, 334, 477, 694, 1019, 1229, 1507, 1832, 2129, 2484, 2731, 3087, 3512, 4247, 4723, 5372, 5834, 6356, 7005, 7393, 7737, 8665, 9455, 10061, 10859, 12172, 12648, 13517, 14062]","[0, 169, 259, 349, 489, 579, 717, 902, 1087, 1215, 1635, 1899, 2134, 2581, 2879, 3063, 3367, 3633, 3771, 4709, 5100, 5241, 6019, 6509, 7317, 7773, 8744, 9133, 10094, 10619]","[0, 169, 259, 365, 539, 653, 844, 1080, 1415, 1780, 2012, 2358, 2781, 3295, 3654, 4184, 4756, 5087, 5562, 5867, 5982, 6252, 6782, 6957, 7499, 8172, 8958, 9374, 10467, 10931]",18330,15955,14062,10619,10931,-1830,-2488,385,1025,-3991,-6899,30,dire
7538639606,41,15,23,19,65,"[874, 1306, 1651, 2127, 2529, 2814, 3213, 3570, 4058, 4549, 4875, 5372, 5953, 6548, 7108, 7812, 9025, 9717, 10289, 10789, 11173, 12103, 13001, 13492, 13889, 14485, 15722, 16517, 18101, 18663]","[711, 934, 1333, 1554, 1920, 2338, 2896, 3352, 3770, 4365, 5107, 5662, 6481, 7238, 7500, 8325, 9284, 9814, 10493, 11092, 11632, 12052, 12653, 13398, 14204, 14677, 15895, 16596, 17775, 17965]","[1049, 1382, 1743, 2463, 2708, 3317, 3722, 4086, 4781, 5296, 5689, 6134, 6530, 6980, 7565, 7891, 8584, 8914, 9561, 9804, 10302, 10892, 11842, 12372, 13322, 14337, 15153, 15617, 16745, 17317]","[455, 692, 828, 918, 1089, 1179, 1324, 1420, 1596, 1849, 2276, 2625, 2779, 2874, 2968, 3232, 3814, 4296, 4476, 4678, 4951, 5237, 5650, 5831, 6243, 6420, 7168, 7285, 7813, 8324]","[460, 683, 1086, 1205, 1593, 1683, 1896, 2385, 2606, 2973, 3258, 3645, 3807, 4182, 4511, 5058, 5751, 6183, 6372, 6726, 7008, 7149, 7592, 7742, 7949, 8126, 8611, 8992, 9371, 9752]",18663,17965,17317,8324,9752,109,53,129,74,20,"[1257, 1467, 1825, 2667, 3178, 3661, 4031, 4838, 5514, 6062, 7086, 7716, 8603, 9428, 9821, 10626, 11575, 12613, 13591, 14390, 15181, 15999, 17474, 18721, 19631, 20352, 20565, 21460, 22050, 22348]","[641, 766, 1135, 1626, 2040, 2328, 2477, 3117, 3655, 3889, 4673, 5135, 5971, 6573, 7330, 7425, 7785, 8111, 8697, 9406, 9793, 10328, 10957, 11704, 11940, 12618, 13167, 13360, 14600, 15424]","[741, 1072, 1434, 1844, 2338, 2740, 3283, 3835, 4250, 5029, 5633, 6352, 6528, 6997, 7999, 8176, 8402, 9054, 9765, 10159, 10826, 11362, 12185, 12661, 12937, 13530, 14007, 14663, 15508, 16237]","[864, 1159, 1489, 1828, 2039, 2410, 2864, 3328, 3628, 3817, 4358, 4797, 5097, 5647, 5899, 6262, 6593, 6863, 7493, 7723, 8025, 8282, 8603, 8698, 8793, 9414, 9820, 10134, 10521, 11188]","[543, 704, 794, 1133, 1344, 1434, 1524, 1819, 1909, 2408, 2821, 2978, 3223, 3707, 3801, 3896, 4054, 4332, 4791, 5021, 5116, 5387, 5664, 5917, 6012, 6279, 6492, 6842, 7229, 7630]",22348,15424,16237,11188,7630,-3685,2541,1080,-2864,2122,-806,30,radiant
7538821104,76,137,29,114,102,"[0, 298, 512, 762, 1173, 1583, 1940, 2550, 2927, 3438, 3837, 4126, 4501, 5044, 5305, 5913, 6438, 7052, 7848, 8373, 8703, 9199, 9601, 9939, 10629, 11188, 11758, 13097, 13705, 14178]","[0, 283, 696, 873, 1229, 1409, 1620, 2066, 2746, 3095, 3849, 4298, 4828, 5278, 5373, 5796, 6571, 7106, 7625, 8503, 9195, 9994, 10089, 10286, 10913, 11517, 12280, 13888, 14065, 14504]","[0, 205, 499, 784, 1281, 1511, 1793, 2248, 2806, 3103, 3556, 3821, 4362, 4480, 4670, 4959, 5311, 5525, 5986, 6364, 6739, 7091, 7285, 7485, 7834, 8370, 8754, 9897, 10198, 10340]","[0, 170, 471, 803, 981, 1196, 1286, 1625, 1850, 1985, 2180, 2270, 2414, 2588, 2810, 3319, 3574, 4140, 4830, 4987, 5521, 5688, 5895, 5989, 6293, 6519, 6733, 7819, 8663, 9085]","[0, 170, 260, 350, 480, 649, 776, 1011, 1282, 1554, 1889, 2229, 2448, 2543, 2725, 2960, 3461, 3675, 3918, 4075, 4349, 4701, 4942, 5036, 5235, 5528, 5761, 6437, 6662, 6973]",14178,14504,10340,9085,6973,56,98,15,68,112,"[0, 349, 676, 1116, 1524, 1979, 2297, 2784, 3138, 3877, 4187, 4634, 5201, 6286, 6954, 7851, 8290, 9097, 9647, 10177, 10991, 11515, 12334, 13495, 14165, 14698, 15859, 16203, 16475, 17299]","[0, 505, 753, 1276, 1732, 2093, 2761, 3168, 3914, 4342, 4432, 5110, 5721, 6661, 7881, 8285, 8927, 9172, 9800, 10387, 11036, 12360, 12993, 13899, 14610, 16064, 16667, 17175, 17973, 18590]","[0, 205, 446, 766, 1011, 1336, 1638, 1911, 2209, 2430, 2882, 3299, 3827, 4372, 4942, 5397, 5906, 6458, 6998, 7619, 8642, 9839, 10620, 11454, 12196, 13091, 13986, 14208, 14715, 15374]","[0, 170, 260, 380, 519, 609, 747, 874, 964, 1054, 1369, 1505, 1773, 2362, 2793, 3189, 3346, 3569, 3794, 3888, 4371, 4989, 5281, 5817, 6056, 6496, 6806, 7104, 7319, 8082]","[0, 311, 401, 521, 611, 878, 1047, 1137, 1423, 1513, 1603, 2107, 2336, 2735, 3175, 3430, 4125, 4294, 4434, 4528, 4916, 5617, 5822, 6207, 6446, 6676, 7108, 7328, 7543, 7943]",17299,18590,15374,8082,7943,-3121,-4086,-5034,1003,-970,-12208,30,dire
7538889304,98,21,46,53,110,"[0, 211, 533, 968, 1139, 1500, 1891, 2317, 2682, 3178, 3630, 4091, 4634, 5374, 5933, 6521, 7305, 7938, 8548, 9796, 10928, 11601, 12283, 12988, 13622, 13896, 15039, 15781, 16839, 17333]","[0, 329, 652, 972, 1316, 1749, 2206, 2674, 2936, 3546, 3927, 4406, 4999, 5684, 6074, 6546, 7061, 7599, 8451, 9330, 10109, 11041, 11226, 12484, 13492, 13805, 14565, 15340, 15981, 16533]","[0, 632, 950, 1373, 1829, 2196, 2743, 3243, 3765, 4311, 4943, 5033, 5866, 6595, 7181, 7648, 8148, 8386, 8481, 9493, 10340, 10768, 11725, 12439, 12767, 12862, 13394, 14254, 15155, 15765]","[0, 205, 347, 730, 854, 1081, 1264, 1562, 1922, 2081, 2171, 2671, 2874, 3350, 3651, 3898, 4310, 4691, 5001, 5833, 6540, 6919, 7587, 8018, 8759, 9071, 9786, 10087, 10661, 11153]","[0, 205, 295, 443, 669, 877, 1012, 1147, 1417, 1576, 1694, 1857, 2057, 2459, 2657, 2881, 3140, 3378, 3941, 4586, 4963, 5102, 5721, 6044, 6563, 6716, 7248, 7431, 7848, 7980]",17333,16533,15765,11153,7980,54,23,112,66,20,"[0, 284, 448, 721, 1037, 1366, 1765, 2295, 2699, 3105, 3614, 4360, 4837, 5401, 6114, 6791, 7627, 8473, 9351, 9702, 10671, 11174, 11450, 12548, 13159, 13367, 14377, 15587, 16239, 16859]","[0, 319, 671, 1002, 1217, 1580, 1973, 2452, 2889, 3388, 3925, 4548, 5105, 5724, 6147, 6795, 7398, 7900, 8188, 8798, 8892, 9414, 9700, 10105, 10686, 10781, 11869, 12482, 12844, 13182]","[0, 210, 444, 680, 971, 1184, 1486, 1656, 1988, 2795, 3299, 3389, 3856, 4408, 4915, 5446, 5837, 6098, 6631, 7068, 7221, 7833, 8193, 8821, 9217, 9478, 10106, 10950, 11419, 11808]","[0, 249, 367, 457, 547, 891, 1072, 1232, 1347, 1629, 2062, 2782, 3137, 3706, 4107, 4628, 5075, 5523, 5886, 6342, 6584, 7290, 7480, 7626, 7984, 8361, 9557, 10214, 10311, 10871]","[0, 210, 397, 487, 994, 1151, 1286, 1421, 1511, 1891, 2116, 2503, 2618, 2795, 3025, 3357, 3539, 3869, 4226, 4321, 4415, 4759, 4949, 5094, 5188, 5283, 5698, 5977, 6074, 6251]",16859,13182,11808,10871,6251,474,3351,3957,282,1729,9793,30,radiant
7538985616,43,10,33,65,19,"[307, 641, 846, 1454, 1786, 2427, 3036, 3770, 4238, 4633, 5176, 5813, 6481, 7327, 7957, 8607, 9402, 9784, 10364, 11384, 12184, 12418, 13564, 15478, 16078, 17202, 17672, 19258, 20836, 22098]","[170, 297, 587, 1269, 1707, 2034, 2267, 2774, 3274, 3905, 4553, 5242, 5748, 6335, 6963, 7694, 8068, 8951, 9932, 10565, 11349, 11939, 12467, 13125, 14031, 15038, 15672, 16923, 18606, 20500]","[304, 576, 949, 1155, 1608, 1927, 2144, 2559, 3054, 3543, 4090, 4939, 5334, 5861, 6235, 7128, 7645, 8120, 8867, 9827, 10468, 10633, 11349, 12153, 12776, 13032, 13567, 14974, 15763, 16673]","[601, 735, 871, 1105, 1235, 1669, 1759, 1894, 2052, 2364, 2952, 3276, 3851, 4062, 4748, 5255, 5814, 6264, 6763, 7326, 7840, 7935, 8353, 8963, 9258, 9657, 10034, 10615, 11554, 12385]","[233, 323, 470, 600, 730, 969, 1059, 1194, 1795, 1930, 2430, 2853, 3164, 3349, 3443, 3709, 4174, 4379, 4984, 5201, 5519, 5654, 6091, 6745, 7119, 7655, 7825, 8990, 9974, 10924]",22098,20500,16673,12385,10924,95,98,106,72,20,"[286, 690, 1073, 1488, 2136, 2880, 3193, 3610, 3938, 4463, 4891, 5329, 6151, 6875, 7620, 8841, 9675, 10226, 11218, 11843, 12696, 13411, 14319, 15115, 15796, 16690, 17037, 17268, 17517, 17710]","[274, 436, 927, 1061, 1425, 1753, 2103, 2328, 2703, 3382, 3875, 4297, 4482, 4771, 5671, 5967, 6418, 6825, 7639, 7841, 8485, 9025, 9673, 10112, 10945, 11575, 12080, 12545, 12913, 13009]","[251, 499, 790, 1077, 1363, 1614, 2162, 2554, 2905, 3275, 3380, 3688, 3925, 4269, 4991, 5521, 6136, 6449, 7186, 7640, 8028, 8960, 9257, 9517, 10514, 11290, 11574, 11805, 11901, 12257]","[170, 260, 396, 642, 767, 1194, 1284, 1419, 1549, 1739, 1949, 2194, 2397, 2694, 2942, 3243, 3491, 3796, 4332, 4592, 5306, 5770, 6028, 6264, 6941, 7239, 7334, 7906, 8185, 8358]","[188, 278, 368, 518, 706, 1020, 1110, 1245, 1375, 1854, 1968, 2058, 2478, 2573, 2821, 2916, 3228, 3323, 3761, 3856, 4076, 4409, 4693, 4929, 5342, 5502, 5786, 6017, 6113, 6209]",17710,13009,12257,8358,6209,4388,7491,4416,4027,4715,25037,30,radiant
7539188102,25,65,62,51,20,"[259, 496, 904, 1397, 1903, 2434, 2942, 3267, 3580, 3937, 4586, 5539, 6261, 6930, 7447, 8736, 9369, 10085, 10547, 11414, 11509, 12188, 12492, 13520, 13730, 13825, 14693, 15952, 16492, 17243]","[250, 483, 764, 932, 1314, 1728, 1863, 2438, 2746, 3609, 4267, 5084, 5695, 6210, 6903, 7787, 8257, 8781, 9144, 9698, 9922, 10570, 10982, 11944, 12601, 13393, 13924, 14596, 14822, 15443]","[249, 599, 897, 1344, 1688, 2134, 2410, 2954, 3445, 3778, 4292, 4928, 5289, 5780, 6165, 6915, 7154, 7285, 7415, 7528, 7939, 8320, 8552, 9025, 9600, 9729, 10014, 10624, 10830, 11432]","[170, 309, 748, 838, 992, 1204, 1387, 1560, 1770, 2118, 2362, 2615, 2854, 3021, 3370, 4043, 4238, 4459, 4579, 4788, 4982, 5261, 5657, 5827, 6639, 6943, 7112, 7358, 7619, 7983]","[170, 306, 449, 634, 771, 861, 996, 1144, 1281, 1524, 2006, 2366, 3083, 3461, 3758, 4134, 4369, 4775, 4888, 5367, 5537, 6100, 6305, 6493, 6828, 6998, 7216, 7684, 7855, 8107]",17243,15443,11432,7983,8107,67,98,106,79,72,"[241, 473, 769, 979, 1344, 1652, 2258, 2597, 3212, 3624, 4140, 4608, 4940, 5626, 6041, 6416, 7463, 8137, 8968, 9602, 10508, 11442, 12631, 12771, 13645, 14612, 15257, 16498, 16984, 17639]","[248, 452, 597, 1026, 1210, 1630, 2171, 2574, 2858, 3870, 4226, 4645, 5614, 6149, 6572, 7689, 8453, 9059, 10323, 10829, 12110, 12746, 13374, 14252, 15218, 16253, 16979, 17464, 18063, 18679]","[278, 565, 848, 1472, 1959, 2289, 2743, 3125, 4013, 4382, 4858, 5179, 5608, 5789, 6169, 6802, 7844, 8180, 8860, 9434, 10115, 11019, 11401, 11695, 12406, 13010, 13329, 13678, 13924, 14618]","[170, 260, 350, 440, 570, 660, 1123, 1231, 1391, 1661, 2312, 3003, 3250, 3621, 3994, 4713, 5115, 5655, 6636, 6946, 7424, 7828, 8329, 8499, 8939, 9190, 9613, 10274, 10543, 11062]","[170, 260, 397, 487, 695, 785, 1121, 1245, 1462, 1732, 1950, 2040, 2362, 2495, 2662, 2896, 3683, 4078, 4736, 5160, 5914, 6318, 7126, 7400, 7961, 8573, 9188, 9734, 10041, 10346]",17639,18679,14618,11062,10346,-396,-3236,-3186,-3079,-2239,-12136,30,dire
7539531110,25,15,28,20,100,"[0, 243, 651, 977, 1228, 1804, 2327, 2765, 3279, 3700, 4208, 4634, 5305, 5990, 6748, 7570, 8245, 9544, 10201, 10941, 12222, 13014, 14597, 14970, 15622, 16647, 17371, 17892, 18112, 18436]","[0, 211, 458, 704, 935, 1321, 1837, 2284, 3141, 3541, 4164, 4452, 5040, 5689, 6131, 6842, 7561, 8241, 8691, 9210, 9926, 10212, 10848, 11396, 12168, 12502, 12900, 13720, 14149, 14559]","[0, 277, 570, 936, 1352, 1870, 2122, 2822, 3057, 3756, 4360, 4700, 5234, 5704, 6147, 6633, 6890, 7314, 7798, 8190, 9000, 9574, 10044, 10777, 11446, 11888, 12576, 12996, 13284, 13455]","[0, 130, 676, 810, 900, 1254, 1455, 1545, 1707, 1918, 2098, 2188, 2393, 2890, 3148, 3362, 3779, 4248, 4784, 5149, 5788, 5903, 6447, 6675, 7279, 7536, 7742, 8009, 8440, 8658]","[0, 130, 220, 310, 400, 525, 749, 883, 1143, 1471, 1651, 1780, 2015, 2164, 2387, 2533, 2914, 3312, 3592, 4175, 4559, 4670, 4909, 5136, 5478, 5573, 5749, 5924, 6106, 6323]",18436,14559,13455,8658,6323,95,38,106,69,110,"[0, 290, 560, 950, 1079, 1277, 1599, 1959, 2049, 2586, 3087, 3774, 4402, 5052, 5616, 6607, 7518, 8307, 8949, 9625, 10335, 11372, 12339, 13110, 14313, 15119, 16315, 17024, 18189, 18786]","[0, 244, 410, 799, 1177, 1314, 1632, 2026, 2567, 2970, 3832, 4380, 4834, 5235, 5762, 6299, 6827, 7133, 7486, 8170, 8939, 9382, 9972, 10523, 11084, 11745, 12146, 12389, 12725, 13155]","[0, 286, 558, 994, 1317, 1514, 1919, 2337, 2972, 3062, 3678, 4140, 4382, 4751, 5212, 5756, 6291, 6582, 6862, 7649, 8455, 9065, 9644, 10131, 10812, 11231, 11756, 12255, 12586, 13033]","[100, 310, 450, 588, 678, 838, 991, 1197, 1337, 1473, 1884, 2129, 2418, 2624, 2782, 3277, 3932, 4047, 4292, 4572, 4912, 5106, 5550, 5879, 6145, 6605, 6910, 7239, 7635, 8842]","[0, 210, 336, 426, 562, 652, 823, 1003, 1183, 1273, 1850, 2042, 2539, 2738, 2833, 3230, 3922, 4216, 4733, 5219, 5404, 5499, 5875, 6269, 6445, 6679, 7060, 7433, 7765, 7981]",18786,13155,13033,8842,7981,-350,1404,422,-184,-1658,-366,30,dire
7539558016,109,69,106,105,20,"[282, 605, 1152, 1450, 1865, 2364, 2730, 3244, 3633, 4113, 4703, 5246, 6083, 6857, 7332, 8309, 8840, 9422, 10311, 11206, 12095, 13032, 14031, 14773, 16569, 17660, 19113, 20079, 20545, 21138]","[241, 519, 728, 1039, 1242, 1672, 2197, 2776, 3217, 3679, 4215, 5004, 6003, 6428, 6924, 7748, 8237, 9216, 9777, 10409, 11359, 12311, 13029, 13429, 14239, 15396, 16106, 16464, 17183, 17341]","[248, 603, 970, 1292, 1544, 1933, 2280, 2731, 3185, 3607, 4072, 4566, 5126, 5722, 6427, 7485, 8044, 8649, 9309, 10105, 10596, 11187, 11620, 12461, 13078, 13708, 14458, 14936, 15550, 15646]","[207, 297, 387, 517, 607, 914, 1356, 1446, 1536, 1789, 1963, 2131, 2577, 2967, 3105, 3403, 3815, 4280, 4670, 5045, 5367, 5828, 6069, 6509, 7155, 7437, 7738, 7909, 8488, 8659]","[219, 309, 708, 910, 1046, 1276, 1415, 1522, 1612, 1918, 2149, 2482, 2848, 3029, 3268, 3528, 3704, 3799, 4219, 4467, 4661, 4802, 4968, 5124, 5497, 5788, 6199, 6340, 6582, 6749]",21138,17341,15646,8659,6749,94,120,28,65,110,"[219, 505, 916, 1318, 1684, 2062, 2705, 3266, 3910, 4400, 5296, 5944, 6620, 7446, 8000, 8815, 9859, 10674, 11101, 11517, 12137, 12868, 13680, 14499, 15310, 15917, 17149, 18201, 19444, 20481]","[219, 452, 785, 1166, 1422, 1828, 2364, 2702, 2965, 3333, 3691, 4174, 4323, 5239, 5914, 6543, 7146, 7811, 8066, 8828, 9111, 9741, 10109, 10877, 11268, 11918, 12503, 12929, 14625, 15884]","[281, 371, 721, 980, 1226, 1443, 1820, 2042, 2276, 2795, 3191, 3870, 4410, 5034, 5519, 5839, 6159, 6683, 7116, 7397, 7844, 8392, 8736, 9227, 9683, 10017, 10192, 10591, 11702, 12522]","[169, 259, 525, 690, 815, 949, 1084, 1421, 1511, 1601, 1896, 2203, 2451, 2712, 2883, 3545, 4116, 4783, 5319, 5574, 6006, 6395, 6763, 7184, 7694, 7971, 8308, 8658, 9859, 10118]","[169, 274, 444, 857, 991, 1081, 1459, 1594, 1684, 1823, 2117, 2347, 2888, 3197, 3410, 3677, 3965, 4347, 4580, 4837, 5279, 5758, 5932, 6117, 6212, 6525, 6700, 6967, 7832, 8266]",20481,15884,12522,10118,8266,657,1457,3124,-1459,-1517,2262,30,radiant
7540018616,10,120,60,21,102,"[526, 733, 1003, 1254, 1838, 2348, 2911, 3261, 3858, 4265, 4895, 5551, 5950, 6221, 6586, 7242, 7829, 8292, 8881, 9609, 10471, 11141, 12223, 12816, 13344, 14886, 15577, 15819, 16158, 16392]","[465, 769, 1015, 1518, 1679, 1990, 2434, 2726, 3391, 3747, 3977, 4545, 4640, 4992, 5649, 6258, 6629, 7536, 8499, 9128, 9800, 9894, 10450, 11160, 11657, 12583, 13453, 14362, 14668, 15092]","[408, 695, 785, 1084, 1595, 1964, 2737, 3020, 3619, 3923, 4172, 4715, 5161, 5386, 5618, 5964, 6423, 7021, 7793, 8062, 8866, 9209, 9864, 10267, 10716, 11692, 12182, 12839, 12935, 13035]","[262, 352, 442, 532, 972, 1107, 1304, 1464, 1835, 1925, 2223, 2561, 2656, 2804, 3087, 3354, 3763, 4128, 4571, 4791, 5229, 5611, 6216, 6958, 7088, 7927, 8263, 8359, 8611, 8931]","[323, 448, 577, 751, 841, 976, 1173, 1398, 1977, 2067, 2304, 2529, 2624, 2893, 2988, 3083, 3178, 3335, 3959, 4099, 4356, 4499, 5181, 5884, 5979, 6570, 6804, 6900, 7032, 7168]",16392,15092,13035,8931,7168,49,6,96,65,86,"[693, 1101, 1571, 1854, 2364, 3028, 3554, 3975, 4308, 4675, 5500, 6041, 6722, 6989, 8174, 8577, 9604, 10251, 11004, 11547, 12341, 13292, 13913, 14008, 15560, 15827, 16509, 17559, 18406, 19883]","[504, 628, 1288, 1871, 2189, 2435, 2762, 3243, 3885, 4462, 5289, 5811, 6554, 7127, 7925, 8832, 9609, 10420, 11128, 11888, 12980, 13678, 14011, 14875, 15875, 16276, 16879, 18071, 18870, 19455]","[553, 960, 1197, 1601, 1822, 2311, 2922, 3555, 3855, 4287, 4864, 5392, 5817, 6168, 7005, 7495, 8003, 8700, 9424, 10112, 10736, 11897, 12324, 12788, 13348, 13442, 13915, 14604, 15262, 15893]","[299, 433, 912, 1217, 1569, 1762, 1852, 2117, 2343, 2792, 3327, 3863, 4569, 5039, 5618, 6274, 6707, 7115, 7320, 7803, 8267, 8550, 8710, 8853, 9228, 9322, 9709, 10445, 10918, 11603]","[331, 467, 692, 871, 1006, 1264, 1354, 1604, 1992, 2281, 2659, 3321, 3963, 4322, 4765, 4904, 5189, 5436, 5682, 5812, 6459, 6703, 6970, 7160, 7658, 7771, 7948, 8493, 8971, 9406]",19883,19455,15893,11603,9406,-3491,-4363,-2858,-2672,-2238,-15622,30,dire
7540116814,70,21,96,53,26,"[624, 752, 1079, 1537, 1984, 2418, 3111, 3370, 3830, 4345, 4799, 5247, 5924, 6179, 6875, 7831, 8354, 8623, 9397, 10306, 11204, 11834, 12596, 13278, 14186, 15019, 15624, 16918, 17569, 18025]","[664, 911, 1245, 1696, 2194, 2701, 3378, 3468, 4140, 4959, 5274, 5907, 6293, 6719, 7477, 7656, 8081, 8616, 9081, 9605, 10328, 11088, 11337, 11909, 12739, 13321, 14268, 14894, 15205, 15849]","[839, 1072, 1432, 1813, 2239, 2704, 3048, 3309, 3812, 4467, 4937, 5534, 5928, 6360, 7159, 7618, 8169, 8586, 9653, 10213, 10914, 11171, 11511, 12091, 12333, 12428, 12836, 13422, 14279, 14822]","[387, 523, 673, 921, 1011, 1300, 1574, 1740, 2017, 2485, 2710, 2978, 3807, 4043, 4724, 4864, 5453, 5548, 6331, 6614, 7307, 7770, 8217, 8494, 8625, 9280, 10270, 10969, 11200, 11788]","[694, 927, 1017, 1196, 1286, 1636, 1909, 2171, 2655, 2858, 2948, 3144, 3569, 4012, 4387, 4591, 4803, 4898, 5303, 5889, 6307, 6780, 6950, 7120, 7289, 7459, 7942, 8223, 8529, 8884]",18025,15849,14822,11788,8884,41,120,14,119,20,"[577, 912, 1235, 1402, 1897, 2361, 2769, 3449, 3668, 4050, 4325, 4711, 5198, 5599, 5884, 6780, 7209, 8086, 9153, 9413, 10685, 11573, 12162, 12772, 13811, 15128, 16103, 16595, 16733, 17491]","[1093, 1344, 1754, 2081, 2398, 3059, 3536, 4254, 4849, 5521, 5718, 6210, 6736, 7270, 8066, 8630, 9676, 10065, 10640, 11341, 12221, 12757, 13522, 13782, 14473, 15450, 16419, 16784, 17550, 17775]","[474, 919, 1208, 1684, 1842, 2003, 2244, 2431, 2785, 3133, 3658, 3875, 4702, 5430, 6230, 6451, 6783, 7609, 8356, 8502, 9202, 9297, 9943, 10154, 11070, 12148, 12615, 12870, 12969, 13069]","[598, 766, 856, 946, 1036, 1248, 1699, 1871, 2184, 2477, 2686, 3007, 3773, 3921, 4252, 4392, 4924, 5368, 5463, 5671, 6060, 6234, 6494, 6861, 7403, 7809, 8323, 8653, 8909, 9084]","[465, 631, 982, 1105, 1195, 1484, 1771, 2002, 2230, 2477, 2663, 2913, 3277, 3471, 3765, 4072, 4431, 4661, 5060, 5355, 5873, 6087, 6372, 6797, 7307, 8021, 8404, 8561, 9046, 9221]",17491,17775,13069,9084,9221,534,-1926,1753,2704,-337,2728,30,dire
7540243410,6,106,98,105,26,"[176, 653, 1025, 1429, 1841, 2471, 2937, 3298, 3813, 4267, 4455, 4886, 5753, 6397, 6793, 7048, 8026, 8120, 8746, 9360, 10119, 10468, 11559, 12263, 12556, 13142, 14202, 15318, 15414, 15677]","[253, 505, 794, 1018, 1346, 1636, 2183, 2513, 3060, 3535, 3908, 4439, 4862, 5206, 5656, 6440, 6828, 7207, 7667, 8658, 9970, 10241, 10667, 11220, 11815, 11953, 12380, 12745, 12968, 13741]","[130, 583, 1178, 1380, 1781, 2164, 2459, 2986, 3606, 4041, 4496, 5084, 5609, 5748, 6261, 6685, 7338, 8296, 8919, 9553, 10086, 10518, 11088, 12001, 12175, 12269, 12410, 12699, 12795, 13066]","[230, 320, 459, 639, 773, 1007, 1311, 1401, 1750, 1934, 2024, 2206, 2301, 2475, 2570, 2946, 3208, 3654, 4053, 4630, 5217, 5719, 6076, 6629, 6724, 6870, 7135, 7477, 7573, 7669]","[130, 220, 535, 675, 765, 939, 1199, 1289, 1609, 1744, 1834, 2014, 2180, 2319, 2414, 2557, 2948, 3252, 3437, 3895, 4297, 4391, 4617, 4965, 5060, 5218, 5364, 5460, 5598, 5694]",15677,13741,13066,7669,5694,49,10,55,90,51,"[280, 610, 1014, 1299, 1632, 2133, 2470, 2844, 3138, 3699, 4286, 5081, 5915, 6629, 7376, 8440, 8934, 10151, 10703, 11467, 12356, 13566, 14324, 15532, 16458, 16991, 17853, 19019, 21063, 21782]","[367, 702, 872, 1197, 1586, 1959, 2400, 2861, 3251, 3709, 4236, 4857, 5593, 6291, 6872, 7573, 8085, 8445, 9127, 9519, 10183, 10677, 11531, 12710, 13914, 14676, 15456, 16424, 17721, 18310]","[576, 855, 1227, 1685, 1912, 2229, 2609, 3252, 3559, 4235, 4771, 5719, 6219, 6731, 7395, 8171, 8545, 9416, 10117, 10480, 11403, 11820, 12270, 13230, 13966, 14398, 15283, 15934, 17324, 17715]","[316, 453, 637, 815, 1155, 1363, 1621, 1769, 2000, 2553, 3063, 3599, 4192, 4988, 5598, 6771, 7483, 7774, 8129, 9108, 9522, 10159, 10982, 11442, 12410, 12963, 13830, 14836, 16127, 16526]","[210, 300, 426, 601, 777, 867, 957, 1094, 1233, 1546, 1762, 1897, 2579, 3059, 3479, 4021, 4654, 4864, 5167, 5421, 5617, 5783, 6085, 6330, 6659, 6967, 7466, 8062, 9333, 9645]",21782,18310,17715,16526,9645,-6105,-4569,-4649,-8857,-3951,-28131,30,dire
7540691210,73,61,23,112,65,"[0, 302, 841, 1107, 1453, 1792, 2302, 2870, 3006, 3154, 3630, 4319, 5064, 5993, 6877, 7776, 8778, 9770, 11252, 12540, 13536, 14671, 16076, 18086, 19465, 21500, 22715, 23846, 25253, 26570]","[0, 213, 362, 652, 742, 1056, 1363, 1934, 2489, 2919, 3527, 4373, 5154, 5897, 6236, 6709, 7563, 8510, 8605, 9251, 10853, 11837, 13592, 14279, 15357, 16243, 17060, 17645, 18791, 19622]","[0, 288, 669, 950, 1198, 1541, 1934, 2588, 2914, 3331, 3672, 4054, 4625, 5320, 6002, 6097, 6581, 7362, 7648, 8328, 8791, 8969, 9539, 9872, 10577, 11386, 11891, 12760, 13221, 13712]","[0, 129, 376, 702, 886, 1072, 1438, 1637, 1764, 2537, 2717, 3053, 3276, 3533, 3770, 3963, 4508, 4859, 5008, 5508, 5971, 6354, 6924, 7073, 7243, 7982, 8280, 8531, 8783, 9358]","[0, 129, 244, 378, 468, 654, 863, 1043, 1182, 1491, 1821, 2072, 2197, 2454, 2749, 3044, 3524, 3993, 4301, 4867, 5330, 5519, 6111, 6205, 6839, 7528, 7703, 8129, 8570, 9234]",26570,19622,13712,9358,9234,53,135,69,26,20,"[0, 291, 555, 965, 1448, 2207, 2603, 3048, 3907, 4396, 5135, 5528, 5939, 6535, 7099, 7541, 8496, 9473, 10323, 10885, 11909, 12008, 13019, 13747, 14520, 14980, 15787, 16753, 17289, 17972]","[0, 372, 688, 989, 1405, 1818, 2382, 2683, 3199, 3597, 4549, 5215, 5896, 6438, 6982, 7382, 8038, 8699, 9363, 10047, 10493, 11318, 11791, 12187, 12832, 13502, 14142, 15182, 15767, 16354]","[0, 314, 810, 1115, 1493, 2104, 2536, 2969, 3457, 3735, 4708, 5092, 5383, 5998, 6690, 6997, 7621, 8395, 9069, 9248, 10378, 10842, 11930, 12431, 12812, 13067, 13274, 13679, 13907, 14222]","[0, 209, 715, 892, 1056, 1267, 1402, 1538, 1858, 2012, 2580, 2670, 2760, 3054, 3207, 3355, 3673, 3774, 4112, 4242, 4876, 4973, 5324, 5437, 5916, 6011, 6117, 6851, 6947, 7043]","[0, 209, 324, 447, 665, 962, 1184, 1399, 1723, 1985, 2636, 2930, 3097, 3534, 3689, 3999, 4379, 4480, 4692, 4786, 5147, 5312, 5407, 5535, 5923, 6018, 6157, 6652, 6783, 7047]",17972,16354,14222,7043,7047,8598,3268,-510,2315,2187,15858,30,radiant
7540902013,72,108,106,20,26,"[0, 580, 908, 1309, 1725, 2168, 2796, 3207, 4013, 4515, 4991, 5982, 6454, 7199, 7968, 8660, 9293, 10027, 10780, 10874, 11765, 12747, 13442, 14347, 15167, 15709, 16810, 17950, 18573, 19286]","[0, 220, 537, 855, 1236, 1656, 1980, 2565, 3312, 3889, 4147, 4674, 4899, 5533, 6081, 6448, 6898, 7489, 7669, 7889, 8115, 8876, 9454, 9841, 10301, 10396, 10724, 11249, 11875, 12314]","[0, 241, 526, 973, 1262, 1607, 2160, 2639, 3144, 3496, 3881, 4398, 4692, 5325, 5884, 6289, 6943, 7301, 7396, 7747, 8226, 8672, 9133, 9425, 10144, 10325, 10703, 11020, 11116, 11670]","[0, 239, 346, 480, 618, 769, 925, 1098, 1445, 1660, 1800, 2355, 2867, 3090, 3559, 3750, 3996, 4140, 4284, 4378, 4733, 4990, 5304, 5399, 6014, 6388, 6526, 6674, 6936, 7245]","[0, 169, 356, 446, 581, 716, 1020, 1223, 1565, 1705, 1910, 2246, 2551, 2793, 3084, 3503, 3852, 3993, 4116, 4226, 4321, 4506, 4672, 4878, 5742, 5837, 5966, 6135, 6249, 6345]",19286,12314,11670,7245,6345,23,25,69,83,121,"[0, 290, 628, 1020, 1316, 1834, 2304, 2758, 3496, 3950, 4757, 5253, 6005, 6455, 7031, 7584, 8362, 8970, 9600, 10519, 11488, 12076, 12666, 13770, 14436, 14864, 15703, 16251, 16835, 17478]","[0, 217, 648, 776, 900, 1272, 1689, 1929, 2131, 2384, 2904, 3310, 3918, 4414, 5101, 5688, 6276, 6840, 7204, 8597, 9257, 9648, 10132, 10847, 11869, 13449, 13712, 14346, 14973, 15515]","[0, 169, 474, 845, 1025, 1233, 1363, 1662, 1880, 2669, 3224, 3493, 4019, 4355, 4980, 5587, 6765, 7203, 7322, 8275, 8871, 9360, 9749, 9981, 10726, 11475, 12124, 12494, 13046, 13494]","[0, 169, 289, 379, 488, 703, 793, 1100, 1488, 1775, 2269, 2413, 2963, 3260, 3570, 3664, 4228, 4372, 4637, 5350, 5580, 5764, 5993, 6206, 6867, 7617, 7711, 7842, 8019, 8409]","[0, 169, 289, 596, 738, 955, 1235, 1370, 1597, 1886, 2264, 2437, 2846, 3131, 3392, 3658, 3906, 4046, 4207, 5037, 5483, 5848, 6077, 6244, 6496, 7056, 7196, 7433, 7682, 7896]",17478,15515,13494,8409,7896,1808,-3201,-1824,-1164,-1551,-5932,30,dire
7540945015,46,32,129,20,21,"[286, 538, 839, 1264, 1655, 2031, 2241, 3223, 3752, 4452, 5047, 5787, 6824, 7491, 8019, 8427, 10023, 10793, 11678, 12298, 13148, 14754, 15670, 16649, 17532, 18824, 19287, 19987, 20083, 21352]","[332, 847, 1130, 1423, 1791, 2173, 2618, 2915, 3236, 3763, 4096, 4535, 4997, 5309, 5991, 6462, 7466, 8199, 8842, 9876, 10048, 10741, 11546, 12136, 12603, 13124, 13716, 14839, 15357, 16270]","[246, 455, 621, 783, 1075, 1476, 1861, 2182, 2462, 2972, 3457, 3916, 4588, 5300, 5395, 5610, 6240, 6713, 7114, 7426, 7560, 8224, 9070, 9616, 9782, 10877, 11526, 11837, 12234, 12501]","[310, 841, 993, 1169, 1295, 1433, 1603, 1870, 2148, 2411, 2663, 2790, 3159, 3539, 3790, 3885, 4848, 4942, 5343, 5598, 5768, 6695, 7248, 7575, 7899, 8956, 9244, 9626, 10156, 10728]","[260, 393, 535, 625, 762, 852, 988, 1170, 1296, 1386, 1853, 2067, 2448, 2722, 3307, 3591, 4075, 4169, 4570, 4960, 5075, 6688, 7251, 7504, 7711, 8301, 8769, 9433, 9576, 9843]",21352,16270,12501,10728,9843,10,23,112,58,100,"[285, 520, 849, 1376, 1718, 2134, 2532, 3076, 3738, 4373, 4779, 5218, 5930, 6462, 7470, 8642, 8957, 9915, 10840, 11896, 13000, 13715, 14333, 14946, 15766, 16148, 16855, 18332, 18995, 20204]","[168, 487, 812, 1246, 1537, 2007, 2439, 3025, 3470, 4161, 4750, 5355, 5546, 6383, 7343, 8127, 8222, 8847, 9333, 9850, 10480, 10983, 11078, 11260, 11533, 11740, 12441, 12938, 13338, 14212]","[201, 397, 666, 831, 1327, 1738, 1980, 2435, 2653, 3005, 3528, 3919, 4259, 4701, 5123, 5512, 5663, 6091, 6785, 6880, 7366, 8224, 8723, 9000, 9377, 9472, 9772, 9868, 10212, 11115]","[130, 268, 388, 612, 781, 883, 1106, 1353, 1570, 1965, 2315, 2607, 2716, 2869, 3224, 3613, 3708, 3993, 4560, 4975, 5769, 6025, 6370, 6488, 6908, 7395, 7908, 8409, 8788, 9504]","[130, 220, 443, 573, 703, 793, 1181, 1271, 1659, 2201, 2726, 2870, 3164, 3426, 3848, 4237, 4332, 4552, 4861, 5283, 5783, 6039, 6134, 6359, 6525, 6620, 6940, 7733, 7829, 8420]",20204,14212,11115,9504,8420,1148,2058,1386,1224,1423,7239,30,radiant
7541057003,73,19,129,123,105,"[60, 445, 821, 995, 1665, 2324, 3031, 3575, 4042, 4854, 5605, 6350, 7115, 8577, 9998, 11307, 12602, 12885, 13748, 14837, 15582, 16605, 17597, 18688, 19475, 20375, 21535, 22557, 23747, 24668]","[58, 304, 594, 1000, 1497, 1886, 2219, 2806, 3211, 3790, 4592, 5063, 5660, 6252, 6828, 7052, 7531, 8309, 9331, 9786, 10010, 10285, 10641, 11335, 11685, 13282, 13678, 14710, 15450, 15546]","[58, 301, 623, 938, 1186, 1484, 1862, 2118, 2779, 2988, 3385, 3908, 4072, 4468, 5048, 5142, 5733, 6635, 7177, 8193, 8417, 8957, 9484, 9909, 10503, 11124, 11833, 12455, 12805, 12901]","[58, 271, 552, 686, 829, 919, 1130, 1306, 1494, 1703, 2109, 2335, 2870, 3238, 3955, 4289, 4691, 5223, 5691, 6260, 6879, 7076, 7504, 7909, 8416, 9013, 9311, 10360, 10700, 10956]","[426, 596, 878, 1019, 1149, 1362, 1790, 2130, 2448, 2670, 2934, 3281, 3405, 3545, 4263, 4440, 4856, 5079, 5513, 6360, 6455, 6550, 6677, 7590, 7801, 8465, 9416, 9749, 10109, 10387]",24668,15546,12901,10956,10387,10,96,53,106,72,"[0, 208, 483, 801, 1115, 1397, 2062, 2509, 2834, 3152, 3844, 4252, 4776, 5693, 6688, 7560, 8455, 9188, 9644, 9863, 10679, 10930, 11705, 12175, 13031, 13236, 13331, 13425, 13856, 15490]","[0, 170, 369, 725, 1244, 1603, 1927, 2134, 2738, 3122, 3778, 4050, 4671, 5311, 5685, 6168, 7006, 7327, 7996, 8274, 8730, 9003, 9868, 10447, 10752, 11415, 12083, 12498, 12761, 13821]","[0, 170, 296, 672, 1076, 1447, 1537, 1939, 2313, 2458, 3052, 3188, 3973, 4754, 5163, 5603, 6217, 6487, 7163, 7971, 8710, 8898, 9488, 9728, 10114, 10613, 11009, 11430, 11830, 13416]","[0, 244, 494, 899, 1271, 1722, 2055, 2289, 2957, 3202, 3636, 4146, 4533, 5079, 5626, 5985, 6605, 6700, 7014, 7376, 8203, 8431, 8794, 9093, 9343, 9741, 9969, 10430, 10564, 11602]","[0, 213, 303, 526, 663, 786, 984, 1074, 1283, 1693, 2044, 2339, 2596, 2889, 3334, 3822, 4702, 4941, 5114, 5208, 6171, 6657, 7098, 7327, 7859, 8263, 8579, 8785, 9088, 9966]",15490,13821,13416,11602,9966,9178,1725,-515,-646,421,10163,30,radiant
7541457507,48,23,96,45,91,"[593, 1011, 1256, 1579, 1861, 2067, 2618, 3195, 3647, 4727, 5246, 5840, 6635, 7590, 8668, 9188, 9984, 10633, 11041, 12010, 12930, 13752, 14336, 14941, 15320, 16303, 16582, 17049, 18415, 19267]","[981, 1393, 1884, 2446, 2845, 3475, 4056, 4518, 4906, 5570, 6050, 6638, 7096, 7539, 8339, 9077, 9689, 9930, 10025, 10702, 11183, 11561, 11982, 12605, 12956, 13543, 13907, 15364, 16040, 16675]","[608, 768, 1169, 1259, 1349, 1690, 2258, 2464, 3024, 3311, 3714, 4404, 4688, 4912, 5307, 5645, 6225, 6462, 6557, 7521, 7785, 8224, 8517, 9001, 9436, 9956, 10464, 11279, 12055, 12368]","[270, 398, 528, 657, 747, 837, 927, 1518, 1656, 2001, 2176, 2440, 2853, 3353, 3771, 3866, 4403, 4671, 4766, 5058, 5618, 5840, 5980, 6075, 6580, 6854, 7133, 8098, 8579, 8932]","[270, 630, 760, 884, 1037, 1127, 1217, 1307, 1500, 1783, 1936, 2031, 2345, 2439, 2769, 2864, 3247, 3462, 3630, 3725, 3910, 4004, 4143, 4321, 4416, 4690, 4969, 5109, 5388, 5587]",19267,16675,12368,8932,5587,73,114,120,58,123,"[1459, 1799, 2431, 3071, 3853, 4808, 5137, 6098, 6800, 7607, 8724, 9518, 10432, 11621, 12078, 13285, 14595, 15722, 16273, 16710, 17665, 18197, 19421, 20507, 21220, 21854, 23553, 24456, 25930, 26286]","[1019, 1381, 1595, 2106, 2681, 3253, 3573, 4111, 4333, 5012, 5580, 6254, 6901, 7346, 7914, 8697, 9119, 9468, 10004, 10937, 11546, 12424, 13325, 14182, 15076, 15499, 16533, 17482, 18741, 19245]","[1028, 1425, 1792, 2141, 2738, 3455, 3896, 4621, 5292, 5624, 6435, 7143, 7683, 8529, 9480, 10268, 10568, 11255, 12043, 12914, 13489, 14149, 15104, 15781, 16656, 17083, 18173, 18683, 19073, 20044]","[554, 722, 995, 1159, 1446, 1702, 2038, 2311, 2581, 3081, 3621, 3748, 3922, 4570, 5009, 5305, 5649, 6054, 6387, 6696, 7243, 7921, 8359, 8643, 9144, 9555, 10106, 10630, 11347, 11490]","[585, 788, 1247, 1337, 1602, 1835, 1986, 2289, 2452, 2838, 3390, 3663, 4137, 4516, 4889, 5116, 5457, 5803, 6023, 6443, 6961, 7380, 7619, 7871, 8531, 8891, 9321, 9775, 10234, 10420]",26286,19245,20044,11490,10420,-7019,-2570,-7676,-2558,-4833,-24656,30,dire
7541497612,48,120,15,100,26,"[1, 296, 533, 1069, 1659, 1907, 2405, 2918, 3350, 3921, 4555, 4940, 5828, 6561, 7331, 7846, 8531, 9174, 10110, 11499, 12136, 13108, 14002, 15206, 16207, 16920, 18298, 19046, 20577, 21857]","[1, 255, 544, 802, 1289, 1787, 2045, 2723, 3115, 3697, 4207, 4560, 5402, 5929, 6794, 7294, 8281, 8804, 9607, 10620, 11130, 11973, 12633, 13590, 14224, 14506, 15560, 15990, 17182, 18068]","[1, 290, 534, 973, 1450, 1697, 2384, 2869, 3438, 3712, 4615, 5005, 5390, 5801, 6412, 7018, 7624, 8137, 8592, 9454, 9916, 10644, 11165, 12056, 12533, 12943, 14038, 14720, 15885, 16859]","[1, 171, 261, 424, 648, 784, 1053, 1262, 1442, 1532, 1994, 2123, 2495, 2917, 3214, 3466, 4006, 4379, 4697, 5025, 5299, 5429, 5706, 6496, 6748, 7069, 7553, 7764, 8396, 9188]","[1, 171, 261, 644, 818, 908, 1090, 1452, 1542, 1709, 2013, 2268, 2571, 2737, 3240, 3494, 4070, 4491, 4990, 5889, 6118, 6257, 6534, 6945, 7149, 7244, 7420, 7515, 7611, 8158]",21857,18068,16859,9188,8158,95,106,20,86,40,"[1, 288, 529, 1031, 1403, 1613, 1943, 2278, 2640, 3307, 4017, 4669, 5889, 6457, 7326, 8438, 9421, 10113, 11530, 12259, 12785, 13817, 14452, 15331, 15737, 16381, 17074, 17430, 17526, 17622]","[1, 368, 704, 1073, 1478, 1860, 2381, 2806, 3138, 3440, 3919, 4404, 4938, 5477, 5785, 6228, 6385, 6838, 7434, 7631, 7964, 8581, 9006, 9405, 9970, 10101, 10780, 11422, 12043, 12260]","[1, 207, 443, 745, 1023, 1268, 1531, 1750, 2344, 2934, 3473, 3941, 4132, 4744, 5033, 5466, 6022, 6732, 7105, 7348, 7790, 8404, 9103, 9296, 9521, 9616, 10173, 10566, 10771, 11270]","[1, 171, 296, 823, 913, 1003, 1093, 1228, 1374, 1650, 2099, 2323, 2773, 3019, 3345, 3718, 3971, 4066, 4259, 4454, 4643, 4944, 5479, 5808, 6066, 6330, 6837, 7051, 7222, 7623]","[1, 171, 261, 506, 613, 703, 793, 1024, 1291, 1531, 1846, 2207, 2620, 2850, 3047, 3222, 3613, 3708, 3803, 3961, 4440, 4719, 5144, 5430, 5524, 5710, 6135, 6230, 6562, 6817]",17622,12260,11270,7623,6817,4235,5808,5589,1565,1341,18538,30,radiant
7541527708,48,28,135,110,20,"[0, 168, 616, 1012, 1347, 1675, 1915, 2399, 2663, 3082, 3381, 3819, 4524, 5101, 5724, 6337, 6749, 7697, 8468, 9587, 10507, 11589, 12896, 13569, 14207, 15785, 16644, 17385, 18378, 18863]","[0, 214, 498, 856, 1156, 1428, 1909, 2380, 2877, 3471, 4091, 4401, 4974, 5524, 5811, 6377, 6852, 7455, 8470, 9035, 9986, 10562, 11211, 11631, 12418, 13134, 13521, 14061, 14568, 15439]","[0, 208, 458, 735, 1027, 1237, 1364, 1870, 2068, 2745, 3205, 4055, 4696, 5315, 5619, 6176, 6756, 7428, 7949, 8350, 9671, 10165, 10449, 10944, 11759, 12687, 13230, 14236, 14850, 15036]","[0, 129, 219, 339, 526, 637, 817, 997, 1181, 1361, 1778, 2175, 2869, 3389, 3598, 4015, 4196, 4426, 4758, 5374, 5683, 5945, 6639, 7250, 7724, 8109, 8403, 8774, 8951, 9203]","[0, 175, 265, 418, 916, 1288, 1479, 1659, 1890, 2070, 2391, 2960, 3121, 3270, 3365, 3459, 3658, 3951, 4344, 4934, 5442, 5582, 5814, 6487, 6885, 7294, 7389, 7861, 8482, 9028]",18863,15439,15036,9203,9028,95,69,25,19,31,"[0, 255, 683, 944, 1176, 1615, 1892, 2291, 2652, 3032, 3670, 4077, 4507, 4889, 5393, 5955, 6736, 7138, 7925, 8522, 9281, 10051, 10826, 11792, 12652, 13455, 14009, 14604, 15570, 16621]","[0, 278, 625, 1082, 1406, 2260, 2628, 3126, 3769, 4459, 5024, 5659, 6172, 6940, 7539, 8509, 9553, 10287, 10866, 11596, 12298, 13052, 13938, 14755, 15439, 16292, 17219, 17843, 18274, 19177]","[0, 368, 714, 1119, 1487, 1857, 2378, 2924, 3424, 4047, 4547, 4956, 5659, 6085, 6929, 7707, 8160, 8673, 9620, 9942, 10313, 10778, 11758, 12223, 12526, 13053, 13255, 13581, 14254, 15065]","[0, 209, 299, 407, 591, 959, 1178, 1456, 1546, 1726, 1906, 2084, 2283, 2432, 2727, 2978, 3469, 3992, 4271, 4687, 5014, 5474, 6342, 6817, 6999, 7313, 7634, 8049, 8448, 9305]","[100, 309, 439, 529, 667, 860, 1187, 1429, 1638, 1894, 2093, 2255, 2639, 2881, 2976, 3299, 3520, 3690, 3863, 4192, 4400, 4929, 5651, 6051, 6196, 6435, 6888, 7117, 7438, 7702]",16621,19177,15065,9305,7702,2242,-3738,-29,-102,1326,-301,30,dire
7541784709,38,21,137,65,83,"[0, 168, 471, 772, 1554, 1987, 2387, 2738, 3333, 3929, 4251, 4609, 4984, 5666, 6252, 6939, 7898, 8535, 9243, 9879, 10481, 11068, 11603, 12716, 13755, 14521, 15478, 16787, 17038, 17429]","[0, 243, 533, 750, 1096, 1335, 1785, 2126, 2783, 3331, 3674, 4207, 4599, 5326, 5727, 6320, 7081, 7786, 8380, 8984, 9497, 10015, 10991, 11854, 12647, 13782, 14858, 16472, 17080, 17531]","[0, 198, 518, 886, 1016, 1263, 1752, 1967, 2482, 2899, 3754, 4660, 5222, 5861, 6512, 7076, 7365, 7996, 8756, 9239, 9592, 9710, 10351, 10747, 11265, 12260, 12825, 13713, 14089, 14185]","[0, 130, 220, 310, 558, 648, 1087, 1310, 1706, 1870, 2314, 2667, 3127, 3626, 4199, 4506, 4995, 5153, 5337, 5908, 6580, 6724, 7055, 7443, 8017, 8556, 9117, 10258, 10509, 10650]","[0, 130, 220, 414, 544, 634, 807, 942, 1591, 1807, 2070, 2328, 2551, 2718, 3252, 3393, 3609, 3814, 4004, 4286, 4556, 4651, 4858, 5197, 5561, 6029, 6617, 7484, 7735, 7879]",17429,17531,14185,10650,7879,41,15,96,20,87,"[0, 245, 447, 766, 1016, 1258, 1616, 2017, 2262, 2631, 2990, 3382, 3748, 4178, 4789, 5165, 5634, 5974, 6446, 6768, 7246, 7828, 8287, 9007, 9762, 9857, 10515, 11306, 12858, 13415]","[0, 329, 641, 1003, 1425, 1882, 2184, 3083, 3501, 4149, 4325, 4572, 4833, 5595, 6019, 6630, 7183, 8078, 8744, 9652, 10480, 11055, 11844, 12527, 13097, 13598, 14059, 14568, 14907, 15552]","[0, 210, 406, 582, 906, 1193, 1602, 1985, 2208, 2647, 3063, 3607, 3913, 4392, 4953, 5476, 6313, 6550, 7080, 7811, 8275, 8988, 9718, 10568, 10945, 11290, 11801, 12888, 13498, 13698]","[0, 259, 435, 602, 822, 947, 1161, 1520, 1656, 1830, 2100, 2298, 2803, 3038, 3223, 3318, 4031, 4260, 4575, 5395, 5744, 6071, 6324, 6565, 6760, 6930, 7263, 7476, 7890, 8061]","[0, 247, 371, 461, 691, 816, 1068, 1434, 1568, 1742, 2071, 2546, 2636, 2903, 3297, 3392, 3745, 4191, 4470, 5037, 5270, 5672, 5914, 6297, 6604, 6830, 7259, 8517, 9539, 9996]",13415,15552,13698,8061,9996,4014,1979,487,2589,-2117,6952,30,dire
7541933305,10,23,47,45,19,"[0, 252, 637, 1020, 1387, 1819, 2243, 2647, 3265, 3732, 4194, 5087, 5616, 6053, 6696, 7314, 8006, 8592, 8989, 9930, 10331, 11064, 12511, 13405, 13793, 14795, 15469, 16106, 16884, 17718]","[0, 288, 680, 1080, 1378, 1999, 2323, 2803, 3352, 4003, 4389, 4832, 5264, 5397, 5914, 6467, 7378, 7561, 8104, 8685, 9457, 9978, 11545, 11959, 12730, 13276, 14140, 14864, 15563, 15856]","[0, 429, 668, 955, 1121, 1583, 1960, 2087, 2321, 2710, 2963, 3274, 3449, 4026, 4245, 4384, 4862, 5539, 5762, 6325, 6828, 7499, 8438, 9298, 9784, 10316, 10776, 11063, 11875, 12326]","[100, 270, 385, 566, 885, 1103, 1193, 1407, 1542, 2035, 2170, 2451, 2587, 2693, 2834, 2953, 3303, 3496, 3640, 4216, 4489, 4584, 5331, 5745, 6385, 6480, 6919, 7374, 7552, 7648]","[0, 261, 415, 505, 812, 1236, 1462, 1552, 1774, 2151, 2286, 2666, 2860, 2960, 3100, 3194, 3664, 3887, 4148, 4639, 4819, 5021, 5847, 6411, 6641, 6904, 7144, 7508, 7686, 7799]",17718,15856,12326,7648,7799,12,74,96,65,20,"[60, 288, 776, 987, 1491, 1795, 2212, 2715, 3160, 3735, 4368, 4830, 5607, 6342, 7141, 7767, 8404, 9275, 10069, 10570, 11564, 12247, 12882, 13338, 13994, 15274, 15928, 16488, 17415, 18274]","[328, 593, 864, 1068, 1403, 1528, 1723, 1982, 2361, 2733, 3281, 3850, 4160, 4649, 5435, 6016, 6536, 7060, 8050, 8666, 9201, 10115, 10705, 10951, 11046, 11715, 12430, 12524, 13477, 13925]","[60, 420, 851, 1149, 1513, 1960, 2327, 2712, 2959, 3831, 4852, 5333, 6042, 6369, 6851, 7311, 7863, 8885, 9485, 9833, 10277, 11041, 11324, 11418, 12069, 12503, 13754, 14032, 14454, 14569]","[60, 345, 500, 590, 778, 933, 1368, 1629, 1875, 2061, 2451, 2641, 2949, 3533, 3959, 4112, 4698, 5566, 6346, 6763, 7172, 7394, 7654, 7806, 8084, 8306, 8805, 9096, 9513, 9609]","[60, 528, 721, 811, 1020, 1154, 1614, 1749, 1839, 1977, 2121, 2285, 2375, 2685, 2879, 2973, 3339, 3805, 4388, 4637, 5045, 5177, 5419, 5661, 5925, 6459, 6884, 7259, 7684, 7780]",18274,13925,14569,9609,7780,-556,1931,-2243,-1961,19,-2810,30,dire
7542425418,94,96,90,20,121,"[603, 847, 1256, 1526, 1984, 2583, 3054, 3510, 3890, 4517, 5022, 5652, 6372, 7467, 8240, 9640, 11104, 12109, 13294, 14406, 15348, 16479, 17737, 19184, 20401, 22712, 24798, 25909, 28121, 30337]","[485, 757, 1084, 1492, 1998, 2261, 2569, 2929, 3266, 3521, 3733, 4430, 4748, 5589, 5819, 6269, 7244, 7960, 8771, 9215, 9694, 10372, 10973, 11500, 12210, 13321, 14036, 14883, 15697, 16560]","[594, 1003, 1334, 1903, 2670, 3276, 3512, 4173, 4610, 5241, 5774, 5869, 6402, 7452, 8014, 8655, 9573, 10166, 11115, 11353, 11789, 12229, 13021, 13560, 14045, 14801, 15177, 15480, 15576, 16423]","[430, 567, 657, 809, 1069, 1249, 1444, 1629, 1758, 2012, 2283, 2393, 2948, 3369, 3821, 4244, 5115, 5857, 6473, 6821, 6988, 7334, 7687, 7938, 8192, 9360, 10038, 10530, 11032, 12177]","[460, 594, 684, 821, 977, 1157, 1530, 1707, 1874, 2168, 2258, 2389, 3059, 3418, 3759, 3944, 4362, 4636, 5418, 5588, 5755, 6118, 6433, 6600, 6694, 7499, 8175, 8478, 9196, 10577]",30337,16560,16423,12177,10577,69,54,17,105,66,"[447, 684, 1204, 1489, 1887, 2131, 2663, 3232, 3813, 4532, 5153, 6005, 6928, 7520, 8406, 9343, 9852, 10824, 11114, 11949, 12871, 13615, 14489, 15248, 16044, 16868, 17678, 18556, 19253, 19694]","[464, 779, 1131, 1568, 1855, 2340, 2815, 3144, 3839, 4489, 4978, 5510, 6163, 6692, 7070, 7842, 8412, 8964, 9597, 10437, 11241, 12192, 12676, 13239, 14217, 14930, 16335, 17807, 17952, 18171]","[604, 971, 1428, 1949, 2412, 2753, 3273, 3621, 3977, 4278, 4662, 5329, 5827, 6504, 6819, 7127, 7327, 7856, 8114, 8813, 9314, 9740, 9835, 10348, 10698, 10952, 11831, 12272, 12681, 13008]","[535, 671, 1112, 1279, 1369, 1542, 2218, 2394, 2784, 2927, 3181, 3698, 4275, 4391, 4601, 4833, 5036, 5193, 5354, 5719, 6279, 6540, 6762, 6931, 7299, 7692, 8323, 9163, 9259, 9536]","[267, 375, 505, 765, 892, 1091, 1466, 1679, 2215, 2594, 3033, 3408, 3771, 3984, 4409, 4755, 5150, 5540, 5737, 6009, 6452, 6761, 7053, 7404, 7731, 8074, 8170, 8921, 9017, 9117]",19694,18171,13008,9536,9117,10643,-1611,3415,2641,1460,16548,30,radiant
7542768300,6,106,28,45,20,"[0, 219, 584, 958, 1399, 1748, 2254, 2530, 3282, 3684, 4082, 4984, 5858, 6302, 6834, 7470, 8394, 8830, 9736, 10499, 11114, 11724, 12273, 12959, 13742, 14439, 15748, 16655, 17406, 18111]","[0, 345, 730, 1005, 1322, 1763, 2140, 2435, 2897, 3451, 3863, 4780, 5224, 5683, 6356, 6845, 7313, 8029, 8490, 8913, 9348, 9618, 10588, 11463, 12338, 12712, 14805, 15088, 15265, 16217]","[0, 346, 581, 897, 1104, 1352, 2217, 2555, 2770, 3577, 3801, 4204, 4992, 5460, 6246, 6820, 7740, 8748, 9100, 9453, 9994, 10372, 11228, 11433, 11954, 12557, 13467, 14039, 14544, 14722]","[0, 454, 590, 710, 817, 966, 1437, 1611, 1945, 2398, 2610, 2755, 3230, 3483, 3665, 3908, 4103, 4261, 4445, 4948, 5165, 5531, 6225, 7053, 7466, 7561, 8688, 9039, 9533, 9629]","[0, 186, 382, 551, 641, 817, 1043, 1143, 1440, 1801, 1909, 2335, 2665, 2777, 3125, 3220, 3693, 3905, 4089, 4357, 4730, 4825, 5336, 5941, 6155, 6438, 7036, 7453, 7838, 7934]",18111,16217,14722,9629,7934,36,49,69,121,51,"[0, 698, 968, 1294, 1729, 2372, 2627, 3211, 4198, 4419, 5056, 5671, 6143, 7309, 8047, 8575, 10064, 10819, 11360, 12165, 13108, 14086, 15285, 15452, 16423, 17216, 18046, 18222, 19256, 21266]","[0, 412, 655, 1019, 1341, 1804, 2134, 2750, 3533, 4124, 4672, 5491, 6161, 6523, 6831, 7352, 9143, 9759, 10675, 11573, 12171, 12547, 12661, 13220, 13959, 14566, 15233, 16278, 17522, 18654]","[0, 205, 425, 794, 1078, 1316, 1653, 1977, 2400, 2624, 3350, 3684, 4079, 4744, 5335, 5848, 6422, 7149, 7827, 8831, 9293, 9746, 10601, 11375, 12146, 13026, 13404, 14838, 15640, 16807]","[0, 698, 839, 981, 1368, 1480, 1615, 1977, 2157, 2412, 2756, 3089, 3179, 3693, 3841, 3936, 4435, 5115, 5276, 5580, 5785, 5917, 6011, 6228, 6977, 7330, 7895, 8625, 9454, 10877]","[0, 453, 543, 633, 769, 990, 1080, 1215, 1561, 1696, 1985, 2334, 2424, 2788, 2936, 3290, 3975, 4511, 4605, 4873, 5279, 5537, 5859, 6026, 6370, 6725, 7039, 7612, 8022, 8964]",21266,18654,16807,10877,8964,-3155,-2437,-2085,-1248,-1030,-9955,30,dire
7544009609,98,46,25,110,20,"[0, 609, 979, 1735, 2044, 2550, 3257, 3587, 4085, 4447, 5456, 6387, 6909, 7523, 8096, 8565, 9526, 10299, 10472, 11313, 11478, 12788, 13670, 14625, 15487, 15674, 16357, 17501, 17678, 17940]","[0, 241, 449, 817, 1269, 1721, 2136, 2771, 3200, 3793, 4395, 5309, 5904, 6206, 6743, 7231, 7941, 8953, 9465, 10812, 11313, 11905, 12524, 13626, 14169, 15143, 15237, 16281, 16822, 16918]","[0, 255, 570, 861, 1174, 1626, 1956, 2085, 2801, 3082, 4098, 4423, 4795, 5212, 5533, 6186, 6963, 7694, 8033, 8981, 9497, 10653, 11380, 12585, 13003, 13424, 14045, 14835, 15220, 16475]","[0, 234, 324, 554, 693, 1071, 1516, 1676, 2050, 2296, 2727, 3481, 3958, 4147, 4740, 4987, 6272, 6823, 7297, 7696, 8720, 9723, 10481, 11053, 11516, 11766, 12220, 12806, 13058, 13707]","[0, 234, 369, 626, 820, 974, 1134, 1351, 1845, 2241, 2668, 2937, 3027, 3122, 3271, 3610, 4074, 4459, 4554, 4805, 4936, 5331, 5767, 6241, 6521, 7034, 7128, 7330, 7507, 7817]",17940,16918,16475,13707,7817,60,114,39,100,119,"[0, 129, 292, 603, 921, 1423, 1851, 2394, 2559, 3071, 3345, 4545, 5104, 5777, 6084, 6360, 6490, 7014, 7745, 8010, 9402, 9639, 9919, 10014, 11042, 11926, 13219, 13732, 15234, 15501]","[0, 201, 363, 566, 1089, 1305, 1561, 1865, 2125, 2487, 2577, 2781, 3353, 3879, 4279, 4709, 5228, 5584, 6293, 6691, 7275, 8000, 8820, 9217, 9784, 10904, 11539, 12492, 14192, 14881]","[0, 164, 398, 667, 952, 1356, 1595, 1941, 2719, 3066, 3289, 3894, 4217, 4758, 5276, 5983, 6125, 6568, 7358, 7779, 8186, 8388, 8551, 9383, 10079, 11298, 11504, 12091, 12846, 13636]","[0, 129, 219, 354, 490, 977, 1497, 1971, 2097, 2278, 2368, 2856, 3083, 3419, 3771, 4047, 4246, 4429, 4878, 5094, 5776, 5871, 5965, 6402, 6830, 8179, 8530, 9017, 10161, 10428]","[0, 129, 219, 309, 475, 682, 854, 989, 1079, 1223, 1349, 1439, 1700, 2036, 2131, 2407, 2665, 2823, 3509, 3725, 4644, 4788, 4956, 5581, 6045, 6608, 6775, 7532, 7890, 8387]",15501,14881,13636,10428,8387,2439,2037,2839,3279,-570,10024,30,radiant
7544133504,114,14,106,85,86,"[0, 170, 454, 875, 1111, 1402, 1756, 2504, 2691, 3214, 3768, 4204, 4487, 4905, 5491, 5995, 6421, 6624, 7187, 7707, 8419, 9243, 11025, 12249, 13719, 14163, 14257, 14810, 15526, 16418]","[0, 248, 489, 935, 1436, 1676, 2235, 2890, 3543, 3890, 4417, 5001, 5405, 5799, 6347, 7062, 7744, 8324, 9148, 9701, 10408, 10712, 11285, 11857, 12546, 13121, 13495, 13880, 14126, 14612]","[0, 287, 650, 995, 1232, 1513, 1726, 2104, 2829, 3213, 4065, 4486, 5107, 5641, 5947, 6822, 7421, 7516, 7873, 8069, 8645, 9310, 9978, 10946, 11439, 11903, 12621, 12806, 13913, 15247]","[0, 257, 717, 982, 1072, 1243, 1614, 1937, 2107, 2345, 2636, 3102, 3801, 4447, 4881, 5583, 5982, 6237, 6386, 6723, 7296, 7493, 8645, 8966, 9061, 9693, 10348, 10533, 10741, 11407]","[0, 468, 558, 748, 916, 1052, 1802, 2281, 2545, 2843, 3044, 3313, 3747, 4318, 4599, 5018, 5176, 5443, 5636, 6101, 6743, 6901, 7698, 8447, 9464, 10013, 10107, 10729, 11078, 11564]",16418,14612,15247,11407,11564,17,102,69,26,100,"[0, 242, 599, 1059, 1497, 1899, 2149, 2563, 2993, 3342, 3942, 4565, 5074, 5624, 6020, 6614, 7179, 8853, 10193, 11108, 12063, 12796, 13606, 14698, 14793, 15019, 17526, 18410, 18877, 21117]","[0, 206, 610, 931, 1333, 1749, 1985, 2313, 2727, 3318, 4117, 4670, 5525, 6137, 6774, 7252, 7994, 8782, 9677, 10587, 11305, 11832, 12254, 13221, 13721, 13897, 15258, 16537, 17564, 17813]","[0, 354, 614, 946, 1596, 2037, 3066, 3245, 3653, 4040, 5183, 5877, 6567, 7159, 7724, 8662, 9330, 10541, 11481, 11900, 12525, 12684, 13473, 14320, 15887, 16326, 17485, 17923, 18404, 18804]","[0, 230, 320, 458, 715, 925, 1281, 1407, 1542, 1677, 1971, 2234, 2848, 2943, 3038, 3429, 3524, 3980, 4505, 4890, 5264, 5541, 5990, 6303, 6398, 6541, 7075, 7170, 7538, 7938]","[0, 498, 588, 727, 873, 1016, 1447, 1537, 1673, 2050, 2356, 2446, 2761, 2856, 2951, 3295, 3390, 4080, 4603, 5188, 5283, 5378, 5606, 5964, 6059, 6154, 6498, 7220, 7541, 8837]",21117,17813,18804,7938,8837,-4699,-3201,-3557,3469,2727,-5261,30,dire
7544192417,128,22,81,107,31,"[0, 240, 402, 1245, 1650, 2052, 2500, 2899, 3187, 3862, 4318, 4702, 5564, 6150, 6941, 7470, 8749, 9559, 10542, 11068, 11587, 12254, 13149, 13798, 15972, 16600, 17741, 19305, 19869, 21376]","[0, 402, 697, 1037, 1492, 1982, 2392, 3078, 3811, 4194, 4675, 5199, 5737, 6151, 6511, 6829, 7179, 7695, 7979, 8317, 8562, 8784, 9299, 9920, 11176, 11586, 12184, 13923, 14857, 16827]","[0, 293, 570, 1009, 1379, 1789, 2270, 2576, 2828, 3284, 3652, 4027, 4563, 4977, 5557, 5758, 6799, 7399, 7738, 8386, 8861, 9017, 9411, 9994, 11790, 12250, 13152, 14103, 15020, 16316]","[0, 169, 259, 467, 557, 734, 1148, 1330, 1420, 1869, 2531, 2621, 2820, 3160, 3492, 3707, 4128, 4456, 4597, 4885, 4979, 5365, 5856, 6195, 6537, 7252, 7610, 8387, 9242, 10195]","[0, 179, 279, 458, 605, 781, 960, 1160, 1326, 1509, 2367, 2544, 2769, 2995, 3285, 3380, 3868, 4229, 4380, 4748, 5036, 5168, 5626, 6056, 6284, 6536, 6851, 7307, 7743, 8588]",21376,16827,16316,10195,8588,106,4,64,97,121,"[0, 282, 594, 969, 1391, 1842, 2296, 2832, 3532, 4205, 4759, 4982, 5701, 6246, 6730, 7461, 8658, 9086, 9997, 11535, 12384, 13996, 14689, 15411, 16017, 16112, 16911, 17408, 17609, 18055]","[0, 245, 563, 816, 1229, 1493, 1993, 2355, 2891, 3154, 3394, 3809, 4227, 4673, 4868, 5385, 5907, 6346, 7427, 8422, 9140, 10318, 10910, 11722, 12542, 13260, 13633, 15320, 15416, 15723]","[0, 169, 302, 392, 531, 621, 814, 950, 1318, 1540, 1834, 2731, 3114, 3310, 3734, 4184, 4557, 4652, 5199, 5742, 6075, 6649, 6996, 7201, 7526, 7696, 8634, 9604, 9775, 10034]","[0, 205, 525, 767, 1178, 1508, 1877, 2040, 2492, 2901, 3153, 3454, 3906, 4390, 4716, 5209, 5429, 5811, 6241, 6649, 6954, 7418, 7585, 7773, 7868, 8173, 8268, 8362, 8775, 8908]","[0, 169, 259, 457, 821, 960, 1097, 1187, 1419, 1556, 1726, 2199, 2682, 2914, 3095, 3399, 3708, 3803, 4008, 4551, 4645, 5015, 5182, 5406, 5626, 5721, 5816, 6549, 6645, 7029]",18055,15723,10034,8908,7029,3321,1104,6282,1287,1559,13553,30,radiant
7544499316,10,13,69,40,123,"[0, 170, 486, 1029, 1386, 1613, 2060, 2717, 3215, 3805, 4372, 4881, 5541, 5956, 6752, 7358, 8149, 8942, 9508, 10351, 11408, 11937, 12827, 14049, 14934, 16409, 17770, 19130, 20198, 20294]","[0, 253, 465, 860, 1175, 1529, 1906, 2346, 2680, 3141, 3407, 3987, 4415, 4510, 5203, 5849, 6701, 6927, 7175, 7783, 8342, 8839, 9481, 9831, 10708, 11272, 12027, 12658, 13054, 13150]","[0, 204, 592, 759, 1005, 1193, 1560, 1738, 1950, 2288, 2761, 3141, 3644, 4195, 5432, 6096, 7207, 8446, 8949, 9559, 10566, 11509, 11960, 13171, 14066, 14611, 15325, 15796, 16087, 16544]","[0, 514, 604, 694, 830, 929, 1126, 1342, 1432, 1522, 1657, 1747, 1947, 2042, 2196, 2356, 2827, 3542, 3932, 4026, 4201, 4642, 5307, 5922, 6017, 6516, 6895, 7513, 8094, 8554]","[100, 316, 625, 715, 854, 1022, 1312, 1402, 1492, 1705, 2050, 2474, 2654, 2749, 2938, 3098, 3597, 4161, 4300, 4679, 5106, 5461, 6334, 6931, 7286, 8063, 8446, 8835, 9341, 9602]",20294,13150,16544,8554,9602,42,20,53,32,21,"[0, 241, 486, 724, 1157, 1433, 1800, 2332, 2606, 2990, 3437, 3806, 4218, 4907, 5317, 5969, 6416, 7071, 7600, 8127, 8730, 9537, 10115, 10670, 11052, 11851, 12207, 12476, 13238, 13789]","[0, 250, 564, 951, 1235, 1690, 2138, 2592, 2930, 3164, 3697, 3948, 4151, 4661, 5317, 5758, 6830, 7125, 7473, 7879, 8212, 8397, 8932, 9489, 10298, 10919, 11381, 11843, 13231, 14702]","[0, 170, 260, 444, 1026, 1165, 1414, 1641, 1852, 2181, 2801, 3062, 3288, 3527, 3886, 4138, 4977, 5072, 5830, 6922, 7143, 7349, 7903, 8230, 8993, 9546, 9787, 10144, 10798, 11427]","[0, 257, 781, 1140, 1513, 1793, 2195, 2617, 3144, 3737, 4410, 4846, 5201, 5578, 5673, 6076, 6741, 6836, 7082, 7586, 7996, 8522, 8844, 9047, 9378, 9642, 9737, 10280, 10724, 11677]","[0, 170, 260, 350, 533, 756, 930, 1210, 1474, 1692, 2042, 2284, 2395, 2931, 3026, 3234, 4299, 4394, 4740, 5136, 5570, 5737, 6370, 6858, 7198, 7564, 7659, 7976, 8709, 9239]",13789,14702,11427,11677,9239,6505,-1552,5117,-3123,363,7310,30,dire
7545119608,25,120,47,112,102,"[0, 243, 437, 1076, 1331, 1620, 2019, 2344, 2821, 3369, 3713, 4239, 4853, 5047, 5870, 6041, 6432, 6706, 7586, 8360, 9312, 9755, 11109, 11953, 12740, 12870, 13281, 14152, 14351, 15055]","[0, 282, 536, 833, 1204, 1666, 2120, 2331, 3011, 3298, 3938, 4478, 4750, 5046, 5623, 5961, 6324, 8078, 8463, 9104, 9763, 10138, 10766, 11611, 12137, 12293, 12641, 12938, 13662, 14181]","[0, 239, 441, 771, 1016, 1261, 1747, 1955, 2200, 2495, 2823, 3026, 3366, 3884, 4412, 4683, 5166, 5909, 6469, 7050, 7327, 7966, 8262, 8592, 9218, 9716, 10166, 10707, 10803, 11057]","[0, 471, 609, 747, 877, 1016, 1155, 1326, 1461, 1772, 1906, 2119, 2299, 2394, 2707, 2801, 3230, 4073, 4337, 5287, 5450, 5545, 5640, 5734, 5829, 6181, 6691, 6997, 7093, 7498]","[0, 129, 219, 391, 521, 619, 709, 799, 1356, 1446, 1627, 1717, 1943, 2318, 2680, 2774, 3159, 3862, 4066, 4748, 4843, 4938, 5033, 5127, 5222, 5317, 5457, 6067, 6163, 6718]",15055,14181,11057,7498,6718,15,69,74,86,91,"[0, 453, 702, 902, 1231, 1502, 1753, 2019, 2474, 3082, 3712, 4313, 4885, 5654, 6631, 7054, 7994, 8430, 9460, 9861, 10463, 11149, 12193, 13210, 14058, 15063, 17055, 18953, 20109, 21685]","[0, 281, 538, 773, 1193, 1482, 1678, 1907, 2358, 2769, 3438, 3722, 4617, 5171, 5845, 6361, 7256, 7843, 8609, 9258, 10001, 10444, 11337, 11894, 12608, 12983, 13696, 14498, 15191, 16200]","[0, 291, 527, 874, 1286, 1641, 1770, 2060, 2559, 3001, 3476, 3729, 4251, 4699, 5195, 5961, 6746, 6942, 7571, 8366, 8784, 8942, 9540, 9971, 10514, 11119, 12098, 12616, 13320, 14788]","[0, 209, 337, 638, 773, 941, 1031, 1167, 1412, 1679, 1914, 2098, 2486, 2752, 3086, 3652, 4010, 4241, 4929, 5277, 5372, 5546, 6002, 6404, 6849, 7086, 7409, 8296, 8882, 9599]","[0, 283, 373, 463, 600, 825, 964, 1364, 1467, 1646, 1904, 2070, 2295, 2531, 3009, 3167, 3640, 3735, 4187, 4407, 4656, 4849, 5167, 5452, 5585, 5825, 6185, 6470, 6903, 7261]",21685,16200,14788,9599,7261,-6630,-2019,-3731,-2101,-543,-15024,30,dire
7545474417,13,93,80,62,31,"[0, 240, 561, 848, 1250, 1551, 1893, 2186, 2582, 3165, 3603, 4433, 4794, 5829, 5924, 6708, 7129, 7644, 8404, 9556, 10209, 10774, 11577, 11838, 13237, 13442, 14812, 15508, 16990, 17086]","[0, 291, 550, 1016, 1386, 1834, 2084, 2464, 2925, 3450, 3897, 4501, 4914, 5406, 5970, 7330, 7942, 8611, 9170, 9996, 10577, 11176, 11570, 12036, 12447, 12724, 13681, 13954, 14893, 14989]","[0, 296, 607, 955, 1151, 1426, 2272, 2454, 3469, 3888, 4164, 4979, 5800, 6291, 6589, 7196, 7907, 8149, 8537, 9388, 10069, 10164, 10569, 10921, 11453, 11805, 12390, 13094, 13769, 13865]","[100, 269, 384, 504, 664, 799, 934, 1140, 1673, 2002, 2287, 2734, 3343, 3998, 4093, 4957, 5052, 5313, 5590, 6042, 6307, 6411, 6513, 6985, 7329, 7555, 7650, 7744, 8031, 8127]","[0, 169, 284, 449, 654, 837, 1210, 1394, 2145, 2421, 2511, 3084, 3395, 3711, 3806, 4227, 4357, 4816, 5037, 5486, 5700, 5795, 6129, 6393, 7190, 7476, 8158, 8252, 8624, 8821]",17086,14989,13865,8127,8821,48,21,76,74,26,"[0, 208, 447, 741, 1224, 1751, 2605, 3211, 3545, 3732, 4246, 4762, 5474, 6170, 6854, 8236, 9638, 11032, 12254, 12964, 13122, 14525, 15544, 16139, 17218, 18288, 19242, 20151, 21175, 23269]","[0, 280, 594, 950, 1397, 1627, 2249, 2509, 2599, 3335, 3831, 4253, 4343, 5141, 5440, 6041, 6486, 7433, 7905, 8328, 8943, 9185, 9559, 9947, 10179, 10833, 11668, 12183, 12616, 13545]","[0, 203, 403, 731, 988, 1378, 1782, 2254, 2690, 2890, 3016, 3243, 3724, 4741, 5093, 5303, 5915, 6749, 7309, 7766, 8740, 9494, 10422, 10815, 11816, 12687, 12863, 13450, 14006, 14961]","[0, 169, 296, 386, 538, 958, 1251, 1402, 1826, 1992, 2277, 2470, 2599, 3730, 4102, 4484, 5117, 5859, 6103, 6846, 7304, 7793, 8352, 8519, 8795, 9541, 10098, 10786, 11393, 11968]","[0, 169, 601, 735, 912, 1135, 1364, 1499, 1589, 1975, 2358, 2732, 3069, 3540, 3635, 3902, 4303, 4848, 5196, 5448, 5964, 6059, 6611, 6705, 6910, 7402, 7857, 8217, 8429, 9193]",23269,13545,14961,11968,9193,-6183,1444,-1096,-3841,-372,-10048,30,dire
7545622003,74,78,41,105,50,"[0, 386, 514, 1001, 1170, 1387, 1678, 2176, 2266, 2565, 3277, 3568, 3862, 4814, 5115, 5519, 6913, 7575, 8328, 8894, 8988, 9646, 10461, 10555, 11593, 11886, 12324, 13067, 14188, 14560]","[0, 309, 748, 1314, 1533, 1820, 2035, 2425, 2878, 3559, 3948, 4373, 4597, 5177, 5486, 5668, 6523, 6819, 7413, 7737, 8027, 8839, 9632, 10421, 11040, 11135, 11429, 12278, 12922, 13468]","[0, 229, 487, 772, 1026, 1116, 1343, 1574, 1664, 1912, 2342, 2645, 2904, 3167, 3416, 3686, 4450, 4705, 4959, 5654, 5748, 6090, 6654, 6748, 7127, 7732, 8020, 8448, 8827, 8923]","[0, 497, 661, 825, 915, 1005, 1095, 1272, 1362, 1542, 1778, 1868, 1981, 2228, 2514, 2609, 3370, 3708, 3803, 4115, 4209, 4693, 4974, 5068, 5253, 5397, 5492, 5602, 6199, 6626]","[0, 229, 353, 526, 633, 723, 813, 990, 1080, 1260, 1680, 1911, 2141, 2425, 2896, 3148, 3633, 3728, 3823, 3992, 4086, 4384, 4906, 5260, 5860, 5955, 6121, 6215, 6601, 6971]",14560,13468,8923,6626,6971,2,46,43,123,53,"[0, 243, 850, 1275, 1685, 2665, 3039, 3526, 4259, 4974, 5227, 5728, 6358, 7326, 8289, 8877, 9034, 9665, 10299, 10546, 11105, 11772, 11909, 12832, 13651, 14246, 15193, 15634, 16417, 17747]","[0, 205, 400, 694, 975, 1370, 1752, 2357, 2808, 3234, 4181, 4681, 5237, 5826, 6241, 6771, 7538, 8225, 8873, 9689, 10101, 10268, 10583, 11391, 12088, 12990, 13837, 14918, 15779, 15956]","[0, 241, 456, 761, 1136, 1702, 2065, 2553, 3504, 3975, 4411, 4916, 5046, 5307, 5899, 6457, 6790, 7418, 7814, 8174, 8966, 9659, 9895, 10730, 11346, 11955, 12374, 13069, 13992, 14832]","[100, 316, 627, 828, 1135, 1407, 1617, 1912, 2204, 2482, 2764, 2854, 2963, 3788, 4102, 4386, 4960, 5567, 5817, 6059, 6841, 7914, 8387, 9112, 9503, 9708, 9984, 10264, 10814, 11454]","[0, 208, 314, 420, 577, 753, 890, 1067, 1452, 1632, 1865, 2110, 2200, 2833, 3361, 3510, 3714, 3993, 4202, 4691, 5108, 5724, 6109, 6598, 7338, 7984, 8435, 8645, 9561, 9949]",17747,15956,14832,11454,9949,-3187,-2488,-5909,-4828,-2978,-19390,30,dire
7545626504,46,21,41,14,64,"[54, 275, 588, 1068, 1377, 1863, 2504, 3209, 4353, 5179, 5889, 6633, 7155, 7958, 9003, 9346, 10051, 10699, 11746, 12497, 13429, 14136, 14916, 15468, 16043, 16684, 18213, 18607, 19602, 20610]","[54, 450, 711, 1119, 1748, 2069, 2597, 2838, 3323, 3778, 4641, 5340, 5600, 6205, 6579, 6975, 7236, 8090, 9477, 10137, 10342, 10758, 11559, 12267, 12623, 13365, 14128, 14586, 15015, 15528]","[54, 297, 463, 870, 1194, 1444, 1779, 2003, 2721, 3234, 3656, 4082, 4524, 5186, 5618, 6073, 6645, 7164, 7376, 8328, 9033, 9534, 10294, 10499, 11019, 11529, 12084, 12531, 12830, 13231]","[54, 281, 405, 655, 858, 948, 1375, 1681, 2285, 2587, 3128, 3218, 3400, 3744, 3941, 4640, 5011, 5254, 5827, 6215, 6420, 6710, 6986, 7153, 7248, 7566, 7872, 8328, 9155, 9457]","[322, 491, 581, 820, 990, 1098, 1188, 1472, 1832, 2080, 2841, 3067, 3307, 4037, 4187, 4612, 5141, 5299, 6075, 6813, 7194, 7539, 8185, 8452, 8547, 8642, 8736, 8831, 9256, 9700]",20610,15528,13231,9457,9700,42,29,53,106,26,"[0, 242, 494, 793, 958, 1293, 1531, 2181, 2411, 2501, 2781, 3173, 3633, 3994, 4534, 5130, 5548, 6049, 6342, 6785, 7420, 7851, 8487, 9531, 10167, 11183, 11948, 12732, 13289, 14381]","[0, 243, 525, 778, 986, 1481, 1764, 2236, 2326, 2580, 3225, 3901, 4356, 4590, 5807, 6437, 6819, 7227, 7674, 7768, 8057, 8333, 8732, 9511, 10087, 10587, 11113, 11306, 12010, 12964]","[0, 213, 303, 672, 919, 1272, 1413, 1956, 2046, 2270, 2942, 3557, 4047, 4335, 4932, 5539, 6318, 6889, 7115, 7538, 7965, 8550, 8978, 9373, 9673, 9937, 10112, 10460, 10729, 11748]","[0, 279, 586, 758, 1032, 1352, 1550, 1899, 2028, 2380, 2737, 3204, 3373, 3767, 4191, 4842, 5799, 6488, 6714, 7079, 7248, 7742, 8517, 9645, 10185, 10531, 10706, 11157, 11476, 12576]","[0, 169, 259, 671, 786, 921, 1011, 1339, 1429, 1519, 1748, 2089, 2321, 2461, 2885, 3399, 3546, 4042, 4268, 4362, 4457, 4600, 4865, 5175, 5526, 5763, 6013, 6208, 6545, 7064]",14381,12964,11748,12576,7064,6229,2564,1483,-3119,2636,9793,30,radiant
7545665209,138,60,74,85,51,"[119, 363, 671, 951, 1493, 1939, 2117, 2620, 3051, 3509, 3933, 4447, 4727, 5237, 6280, 6811, 7604, 7918, 8831, 9426, 9908, 10171, 10730, 11560, 12157, 12841, 13649, 14458, 14635, 15222]","[119, 369, 709, 1062, 1264, 1633, 1961, 2286, 2632, 2761, 3191, 3583, 3673, 3767, 4575, 5216, 5431, 5870, 6076, 6591, 7287, 7444, 7888, 9195, 9667, 9762, 10235, 10923, 11664, 11823]","[252, 461, 691, 854, 1175, 1776, 2088, 2764, 3120, 3294, 3435, 3878, 4372, 4599, 5347, 5644, 6597, 7746, 8161, 8753, 9112, 9335, 9575, 10264, 10546, 10835, 11291, 11568, 11811, 12115]","[387, 557, 782, 872, 1116, 1206, 1418, 1881, 2033, 2234, 2324, 2579, 2669, 2901, 3512, 3690, 4553, 4857, 5234, 5468, 5826, 5921, 6164, 7310, 7494, 8091, 8332, 8813, 8990, 9352]","[59, 229, 349, 486, 593, 749, 879, 1014, 1104, 1194, 1284, 1472, 1766, 1971, 2423, 2563, 2975, 3479, 3733, 4128, 4360, 4455, 4698, 5290, 5669, 5764, 6153, 6970, 7261, 7357]",15222,11823,12115,9352,7357,123,76,19,86,97,"[72, 240, 590, 909, 1199, 1409, 1823, 2907, 3519, 4102, 4922, 5327, 6016, 6762, 7015, 7924, 8503, 10063, 10738, 11497, 12112, 13153, 14458, 14829, 15130, 16494, 17216, 19059, 19436, 20495]","[72, 275, 631, 880, 1355, 1676, 2075, 2299, 2801, 3447, 4322, 4592, 5175, 5976, 6251, 6678, 7278, 7822, 8338, 9226, 10376, 11124, 11405, 12002, 12948, 13842, 14825, 14920, 15767, 16884]","[72, 202, 327, 462, 679, 809, 899, 989, 1213, 1474, 1875, 1965, 2609, 2971, 3269, 4032, 4410, 4908, 5003, 5365, 5915, 6762, 7342, 7586, 7851, 8471, 9079, 9728, 10145, 11075]","[205, 335, 460, 550, 720, 907, 1033, 1677, 1942, 2175, 2814, 2904, 3249, 4043, 4176, 4513, 5586, 6017, 6112, 6337, 6917, 7586, 8046, 8285, 8522, 9012, 9807, 10295, 10959, 11772]","[72, 236, 646, 812, 1119, 1249, 1571, 1735, 1870, 2026, 2465, 2876, 3225, 3834, 4016, 4344, 4679, 4773, 5108, 5550, 5981, 6630, 7176, 7610, 7704, 8091, 8377, 9358, 9589, 9795]",20495,16884,11075,11772,9795,-5273,-5061,1040,-2420,-2438,-14152,30,dire
7545688814,48,13,53,79,20,"[0, 323, 688, 975, 1248, 1540, 2265, 3029, 3580, 3707, 4379, 5037, 5626, 6609, 7058, 8242, 9279, 10526, 11599, 12505, 13429, 14138, 15278, 16524, 17551, 18445, 19440, 20777, 21599, 22660]","[0, 261, 500, 720, 1083, 1380, 1953, 2557, 2776, 3027, 3750, 4187, 4844, 5380, 5987, 6731, 7425, 8287, 8565, 8936, 9030, 9591, 10167, 10461, 11044, 11919, 12427, 12760, 13340, 13768]","[0, 333, 700, 1109, 1360, 1938, 2222, 2706, 2998, 3623, 4156, 4510, 5058, 5897, 6057, 6780, 7601, 8660, 9005, 9511, 9777, 10074, 10542, 10803, 11054, 12552, 13047, 13576, 14219, 15236]","[0, 311, 401, 491, 629, 767, 1066, 1301, 1700, 2022, 2332, 3156, 3274, 3821, 3916, 4446, 4985, 5780, 6134, 6292, 6386, 6596, 6988, 7159, 7418, 8481, 9134, 9310, 9614, 10498]","[0, 210, 317, 452, 542, 1024, 1236, 1677, 2038, 2208, 2344, 2831, 2921, 3282, 3377, 3752, 4058, 4518, 4796, 5070, 5164, 5540, 5932, 6079, 6434, 6943, 7196, 7420, 7597, 8096]",22660,13768,15236,10498,8096,44,17,14,128,37,"[0, 239, 525, 903, 1110, 1446, 1812, 1947, 2765, 2903, 3390, 3536, 3936, 4223, 4580, 4913, 5457, 6108, 6944, 7877, 9171, 10082, 10693, 11515, 11958, 12672, 13751, 14582, 15163, 16450]","[0, 213, 521, 707, 1155, 1525, 1756, 2266, 2951, 3133, 3718, 4072, 4464, 4891, 5299, 5556, 5983, 6156, 6735, 7405, 8110, 8393, 9269, 9808, 10414, 10616, 10923, 11439, 12115, 12904]","[0, 166, 488, 689, 896, 1409, 2056, 2477, 2901, 3669, 4070, 4421, 4766, 5536, 5939, 6034, 6662, 6757, 7050, 7458, 8383, 8666, 8833, 9081, 9370, 9576, 10105, 10726, 10940, 11287]","[0, 230, 320, 410, 547, 810, 900, 1157, 1410, 1755, 2330, 2521, 2657, 3279, 3459, 3782, 4023, 4301, 4660, 5266, 6193, 6671, 6894, 7278, 7372, 7469, 7676, 7927, 8023, 8462]","[0, 130, 220, 781, 871, 1041, 1131, 1266, 1814, 1942, 2463, 2639, 2819, 2958, 3227, 3430, 3587, 3809, 3941, 4519, 5291, 5386, 5553, 6096, 6300, 6395, 6544, 7084, 7421, 7860]",16450,12904,11287,8462,7860,6210,864,3949,2036,236,13295,30,radiant
7545749916,48,54,21,86,14,"[0, 243, 773, 1270, 1519, 1964, 2811, 2984, 3230, 3462, 3898, 4665, 5323, 5869, 6391, 6958, 7757, 9020, 9559, 10801, 11346, 12208, 12928, 13839, 14127, 14728, 15527, 16239, 17097, 18039]","[0, 170, 425, 707, 987, 1394, 1685, 2201, 2442, 2739, 3204, 3697, 4078, 4476, 5139, 5674, 6289, 7029, 7405, 8256, 8745, 9634, 10090, 10620, 11308, 11895, 12071, 13291, 13844, 14408]","[0, 251, 549, 973, 1296, 1700, 2196, 2771, 3110, 3759, 4756, 4926, 5673, 6116, 6897, 7292, 8466, 8713, 8978, 9863, 10547, 11034, 11362, 11807, 12035, 12582, 13390, 14063, 14741, 15572]","[0, 170, 260, 397, 696, 884, 974, 1242, 1387, 1562, 2204, 2958, 3378, 3806, 4367, 5072, 5470, 6010, 6514, 7425, 7848, 8386, 8892, 9848, 10358, 10453, 10705, 11204, 11628, 12194]","[0, 170, 328, 765, 855, 1050, 1433, 1662, 1925, 2157, 2544, 2714, 3261, 3673, 4177, 4614, 5596, 6113, 6583, 7075, 7473, 7956, 8198, 8485, 9350, 9750, 10050, 10845, 10982, 11444]",18039,14408,15572,12194,11444,120,25,98,103,26,"[0, 313, 513, 1003, 1333, 1655, 1994, 2354, 2787, 3459, 4369, 4858, 5364, 5899, 6644, 8074, 8169, 9156, 10176, 10761, 11073, 11345, 12132, 12862, 14174, 15754, 16431, 17140, 17766, 18511]","[0, 261, 464, 919, 1460, 1974, 2184, 2840, 3195, 4289, 4658, 5590, 6546, 6711, 7398, 8306, 8594, 8921, 9488, 10525, 11278, 11746, 12478, 13306, 14681, 15569, 16718, 16813, 17315, 18092]","[0, 170, 329, 678, 963, 1313, 1701, 2038, 2360, 2797, 3078, 3294, 3384, 3629, 4093, 4732, 5303, 5958, 6730, 7014, 7393, 7725, 8419, 8817, 8911, 9950, 10759, 11362, 12059, 12620]","[0, 170, 260, 394, 484, 649, 739, 1213, 1303, 1618, 1806, 2084, 2340, 2520, 2869, 3351, 3446, 3944, 4270, 4602, 4770, 5271, 5366, 5609, 6109, 6875, 7275, 7602, 8251, 8467]","[0, 170, 260, 350, 529, 742, 832, 1060, 1197, 1430, 1877, 2204, 2521, 2669, 2866, 3129, 3224, 3650, 3835, 4119, 4258, 4352, 4447, 4587, 5214, 5795, 6171, 6455, 6667, 6896]",18511,18092,12620,8467,6896,-472,-3684,2952,3727,4548,7071,30,radiant
7545759506,63,106,9,129,85,"[0, 246, 648, 946, 1156, 1700, 1911, 2241, 2709, 3108, 3517, 4092, 4246, 5021, 5346, 5912, 6644, 7474, 8624, 9330, 10851, 11949, 12701, 13989, 15009, 15820, 16668, 18095, 18906, 20023]","[0, 260, 468, 795, 1088, 1214, 1348, 1893, 2494, 3086, 3462, 4049, 4521, 4957, 5210, 5340, 5834, 6395, 7150, 7594, 8183, 8953, 9462, 10909, 11874, 12379, 12837, 13328, 14699, 15861]","[0, 210, 635, 825, 1118, 1263, 1400, 1796, 2290, 2929, 3233, 4041, 4267, 4695, 4950, 5045, 5312, 5694, 6290, 6598, 7884, 8407, 8589, 9862, 10029, 10959, 11615, 12661, 13645, 14494]","[0, 331, 740, 1023, 1260, 1388, 1699, 1859, 2039, 2168, 2766, 3100, 3458, 3800, 4230, 4652, 5047, 5450, 6070, 6473, 7477, 8163, 8519, 9744, 9911, 10655, 11637, 12386, 12981, 13232]","[0, 210, 300, 472, 562, 903, 1079, 1169, 1639, 1907, 2042, 2518, 2725, 2996, 3090, 3185, 3280, 3612, 4033, 4218, 5251, 5616, 5842, 6725, 7162, 7821, 8400, 8730, 9197, 9706]",20023,15861,14494,13232,9706,10,53,114,136,100,"[0, 155, 326, 582, 1055, 1548, 2118, 2574, 3329, 3720, 4256, 4606, 5256, 5778, 6594, 7115, 7667, 8538, 8685, 9469, 9634, 10616, 11430, 11660, 12316, 12994, 13549, 14829, 15957, 16883]","[0, 266, 437, 634, 1002, 1235, 1709, 2396, 2935, 3278, 3840, 4688, 5384, 6072, 6572, 7342, 7906, 8692, 9335, 10085, 10727, 11260, 11355, 12044, 12395, 12766, 13397, 13711, 13928, 15192]","[0, 244, 489, 883, 1226, 1554, 2053, 2393, 2691, 2781, 3148, 3238, 4171, 4449, 4768, 5260, 5701, 6391, 6976, 7362, 7871, 8291, 8731, 9265, 9584, 10314, 11152, 11525, 11621, 12510]","[0, 155, 245, 335, 425, 515, 1035, 1485, 1575, 1665, 1755, 1922, 2288, 2545, 2803, 3304, 3462, 4056, 4542, 5069, 5586, 5680, 5800, 6030, 6288, 6454, 6718, 7023, 7141, 8098]","[0, 155, 245, 335, 710, 833, 1067, 1242, 1458, 1548, 1638, 1805, 2075, 2332, 2678, 3140, 3298, 4157, 4252, 4733, 4984, 5288, 5427, 5732, 5902, 6361, 6569, 6915, 7443, 7614]",16883,15192,12510,8098,7614,3140,669,1984,5134,2092,13019,30,radiant
7545850405,69,14,22,123,20,"[215, 537, 627, 947, 1447, 1636, 2032, 2615, 2918, 3900, 4427, 5473, 6590, 7281, 8271, 8982, 9644, 10594, 11250, 12516, 13326, 14555, 15981, 16833, 17451, 18233, 18839, 19955, 21283, 21947]","[277, 581, 1012, 1413, 1925, 2448, 2985, 3602, 4233, 4860, 5523, 6197, 6836, 7492, 8033, 8399, 9550, 9838, 10377, 11193, 11812, 12561, 13695, 14584, 15229, 16280, 16947, 17381, 18377, 19418]","[348, 704, 994, 1383, 1775, 2222, 2576, 3239, 3763, 4095, 5011, 5480, 5677, 6511, 7048, 7417, 8209, 8466, 9209, 9989, 10989, 11459, 12395, 13088, 13437, 15054, 15661, 16295, 16472, 16888]","[348, 652, 742, 928, 1304, 1572, 1797, 2091, 2284, 2644, 2824, 3347, 4054, 4617, 4819, 4968, 5986, 6243, 6722, 7749, 8339, 8604, 9214, 9309, 9879, 10212, 10948, 11673, 11850, 12260]","[215, 785, 1095, 1276, 1515, 1693, 1899, 2059, 2194, 2329, 2674, 2898, 3275, 3598, 3800, 3949, 4433, 4718, 4924, 5407, 5738, 5898, 6739, 6991, 7221, 7705, 7881, 8057, 8234, 8598]",21947,19418,16888,12260,8598,109,106,97,19,26,"[186, 470, 1058, 1282, 2111, 2400, 2685, 2986, 3275, 3530, 3772, 4029, 4653, 5124, 5665, 6484, 6999, 7425, 8091, 8460, 8641, 9462, 10300, 11154, 11465, 12043, 12833, 14281, 15512, 16050]","[454, 767, 1051, 1375, 1626, 2265, 2587, 3257, 3840, 4145, 4617, 4941, 5641, 5860, 6240, 7182, 7660, 8154, 8611, 9307, 10501, 10767, 11493, 11751, 12802, 13011, 13106, 14026, 15477, 15573]","[250, 494, 777, 1013, 1312, 1479, 1894, 2066, 2506, 2842, 3259, 3688, 4191, 4660, 4873, 5327, 5857, 6329, 6801, 7248, 7793, 7990, 8278, 8501, 9190, 9284, 9727, 10695, 11349, 11643]","[319, 603, 693, 783, 873, 1003, 1236, 1371, 1573, 1663, 1753, 1887, 2270, 2644, 2857, 3601, 3798, 4222, 4560, 4845, 5364, 5458, 5746, 5931, 6407, 6692, 7388, 8053, 8856, 9335]","[186, 559, 733, 823, 1116, 1249, 1339, 1590, 1806, 1981, 2117, 2253, 2909, 3124, 3518, 3938, 4376, 4495, 4818, 5367, 5667, 5765, 6247, 6507, 6811, 7275, 7445, 8209, 8569, 8886]",16050,15573,11643,9335,8886,5897,3845,5245,2925,-288,17624,30,radiant
7546267004,74,38,70,21,26,"[0, 295, 577, 946, 1271, 1647, 1935, 2341, 2790, 3630, 3882, 4243, 4872, 5477, 6178, 6568, 6961, 7420, 8507, 8941, 9335, 9975, 10603, 11309, 12135, 12726, 13033, 14085, 14383, 15061]","[0, 283, 518, 879, 1187, 1553, 1853, 2020, 2195, 3011, 3443, 4052, 4453, 5412, 6108, 6904, 7580, 8574, 9486, 10550, 11330, 11864, 12234, 12989, 13518, 14260, 14830, 15395, 15659, 16314]","[0, 209, 523, 768, 1091, 1425, 1620, 2131, 2582, 3015, 3383, 3473, 3686, 4350, 4801, 5352, 6004, 7068, 8095, 8700, 9288, 10239, 10939, 11033, 11760, 12186, 12581, 13447, 13995, 15092]","[0, 209, 299, 483, 635, 802, 969, 1143, 1279, 1612, 1968, 2058, 2260, 2497, 2988, 3165, 3434, 3857, 4271, 4671, 5101, 5697, 5867, 6675, 7281, 7802, 8047, 8538, 8965, 9484]","[0, 209, 341, 431, 541, 675, 765, 855, 990, 1584, 1764, 1996, 2198, 2533, 2747, 2842, 3300, 3501, 4009, 4341, 4600, 5011, 5144, 5497, 5853, 6146, 6328, 6796, 6892, 7240]",15061,16314,15092,9484,7240,25,102,32,58,3,"[0, 234, 569, 952, 1283, 1606, 1978, 2470, 2900, 3128, 3595, 4186, 4779, 6388, 7149, 7776, 8500, 9036, 9669, 10351, 11010, 12158, 13019, 14411, 15595, 16155, 16680, 17968, 18602, 19308]","[0, 220, 485, 885, 1230, 1393, 1837, 2051, 2461, 2717, 3269, 3618, 4481, 4962, 5197, 5780, 6239, 6783, 6878, 7120, 7777, 8233, 8591, 9107, 9485, 10120, 10525, 11246, 11691, 12361]","[0, 168, 330, 457, 744, 962, 1496, 1670, 2197, 2373, 2542, 2893, 3218, 3865, 4047, 4593, 5200, 5682, 5840, 6164, 6933, 7525, 7779, 8373, 8468, 8755, 9076, 9378, 9729, 10159]","[0, 129, 219, 309, 399, 489, 734, 869, 1049, 1186, 1487, 1631, 1923, 2171, 2353, 2806, 3035, 3449, 3882, 4039, 4224, 4611, 4706, 5032, 5127, 5466, 5769, 6436, 6876, 7276]","[0, 129, 219, 354, 559, 649, 1196, 1368, 1458, 1548, 1956, 2100, 2667, 2835, 3017, 3365, 3568, 3815, 3910, 4232, 4477, 4677, 4772, 5098, 5193, 5288, 5498, 5592, 6056, 6242]",19308,12361,10159,7276,6242,-4247,3953,4933,2208,998,7845,30,radiant
7546556801,98,43,109,83,112,"[0, 283, 840, 1087, 1629, 1940, 2105, 2595, 3009, 3669, 4224, 4850, 5667, 5851, 6379, 7285, 8364, 8817, 9589, 9923, 10813, 12211, 13032, 13424, 14802, 15864, 17443, 18138, 18553, 19172]","[0, 232, 442, 862, 1189, 1564, 1945, 2834, 3082, 3262, 3757, 4312, 4824, 5738, 6231, 6916, 7767, 8578, 9325, 9521, 10238, 11244, 12402, 13101, 14261, 15537, 16379, 17517, 18078, 18544]","[0, 209, 514, 796, 1371, 1671, 1798, 2428, 2819, 3419, 3893, 4471, 4850, 5144, 5609, 6351, 7053, 7718, 8498, 9205, 9839, 10897, 11524, 12625, 13406, 13722, 14374, 15755, 17075, 17791]","[0, 129, 219, 309, 470, 560, 650, 1098, 1188, 1501, 1684, 2023, 2191, 2883, 3023, 3386, 4080, 4289, 4384, 4479, 4732, 5107, 5459, 5816, 6257, 6594, 7415, 7954, 8254, 8425]","[0, 129, 314, 404, 583, 673, 763, 1089, 1226, 1406, 1718, 2200, 2290, 2580, 2720, 3083, 3530, 3688, 3969, 4064, 4293, 4866, 5143, 5381, 5835, 6040, 6503, 6967, 7144, 7339]",19172,18544,17791,8425,7339,72,60,36,91,121,"[0, 320, 758, 1048, 1380, 1669, 2140, 2737, 3005, 3694, 4087, 4868, 5543, 6727, 7316, 8234, 8645, 9257, 9806, 10296, 11489, 12835, 13494, 14211, 15650, 15852, 17078, 17416, 17998, 19474]","[0, 246, 564, 809, 984, 1357, 1812, 2243, 2741, 3403, 3857, 4086, 4803, 5361, 5957, 6297, 6930, 7348, 7957, 8275, 8785, 9441, 9536, 9790, 10328, 10423, 11228, 11517, 11993, 13995]","[0, 366, 723, 1103, 1398, 1488, 1700, 1912, 2549, 3088, 3583, 3980, 4335, 4967, 5520, 6142, 6648, 6980, 7806, 8368, 8936, 9343, 9727, 10724, 11425, 11653, 11748, 12392, 12650, 13933]","[0, 209, 533, 671, 801, 891, 1207, 1400, 1675, 2394, 2508, 2693, 2961, 3503, 3770, 3918, 4012, 4192, 4425, 4864, 5093, 5622, 5717, 5891, 6433, 6741, 6836, 6930, 7188, 7665]","[0, 209, 299, 426, 556, 693, 1088, 1253, 1520, 1841, 2015, 2105, 2323, 2585, 2888, 3065, 3214, 3355, 3689, 3847, 4118, 4520, 4663, 4757, 5323, 5418, 5513, 5639, 5897, 6759]",19474,13995,13933,7665,6759,-302,4549,3858,760,580,9445,30,radiant
7546718402,89,102,137,26,45,"[0, 251, 418, 777, 1100, 1441, 1696, 2044, 2369, 2871, 3318, 3754, 4183, 5016, 5732, 6477, 7470, 8424, 9536, 10613, 11370, 12017, 13173, 14042, 14863, 15669, 17282, 18079, 19807, 20849]","[0, 212, 488, 903, 1359, 1814, 2413, 2858, 3308, 4075, 4531, 4984, 5623, 6244, 6721, 7078, 7341, 8483, 9006, 9710, 10256, 10759, 11587, 12218, 12407, 12923, 13596, 14244, 14924, 15311]","[0, 249, 611, 1023, 1404, 2006, 2454, 2856, 3285, 3636, 3981, 4564, 5214, 5720, 6387, 6925, 7455, 8051, 8634, 8953, 9454, 10040, 10910, 11527, 11775, 12715, 13534, 13739, 14263, 14730]","[0, 130, 432, 649, 779, 886, 1041, 1221, 1442, 1855, 1990, 2098, 2505, 2957, 3051, 3286, 3572, 3836, 4026, 4268, 4498, 5237, 5612, 5782, 5877, 6237, 6854, 6949, 7445, 7620]","[0, 130, 220, 401, 563, 698, 788, 1013, 1305, 1523, 1704, 2109, 2328, 2835, 3128, 3288, 3383, 3642, 3905, 4147, 4377, 4607, 4994, 5236, 5553, 5829, 6380, 6475, 6978, 7157]",20849,15311,14730,7620,7157,39,93,129,123,119,"[0, 305, 594, 1054, 1406, 1652, 2104, 2637, 3064, 3409, 3971, 4454, 5080, 5746, 6419, 7018, 7746, 8423, 9121, 9453, 10564, 11394, 12302, 12709, 13357, 14041, 14433, 15163, 15427, 15950]","[0, 280, 408, 698, 879, 1083, 1435, 1709, 1983, 2235, 2708, 3219, 3486, 4086, 4806, 5402, 5894, 6461, 7479, 8223, 8823, 9379, 10006, 10511, 11200, 11917, 12260, 12954, 13094, 13810]","[0, 569, 732, 1085, 1371, 1664, 2440, 2775, 3409, 3892, 4272, 4727, 5240, 5766, 6025, 7167, 8086, 8488, 9552, 10041, 10830, 11351, 11806, 12144, 12823, 13153, 13248, 13764, 14187, 14688]","[0, 265, 406, 496, 626, 716, 938, 1111, 1363, 1721, 2088, 2203, 2293, 2499, 2639, 3308, 3865, 4263, 4528, 5018, 5604, 5752, 6364, 6839, 7073, 7816, 8196, 8563, 8863, 9209]","[0, 265, 391, 562, 692, 782, 872, 996, 1086, 1285, 1475, 1650, 1871, 2014, 2261, 2661, 3054, 3251, 3697, 3792, 4296, 4391, 4648, 4743, 4945, 5218, 5313, 5525, 5667, 5763]",15950,13810,14688,9209,5763,4899,1501,42,-1589,1394,6247,30,dire
7546973501,94,43,7,83,100,"[604, 816, 1397, 1840, 2344, 2683, 3277, 3753, 4231, 4823, 5427, 6173, 7307, 7845, 8888, 9686, 10594, 11232, 12085, 12569, 13648, 15219, 16457, 17683, 18506, 20017, 21287, 22402, 22833, 24121]","[619, 867, 1126, 1299, 1515, 1959, 2481, 2999, 3782, 4282, 4867, 5528, 6491, 6806, 7529, 7786, 8522, 8991, 9414, 10391, 10780, 11526, 12126, 12588, 13058, 13702, 14168, 14862, 15401, 16374]","[536, 842, 1173, 1512, 2052, 2552, 3120, 3690, 4330, 4916, 5416, 5872, 6231, 6620, 7339, 7721, 7864, 8502, 9065, 9488, 9877, 10541, 11216, 11656, 12396, 12956, 13670, 14078, 14452, 15644]","[285, 375, 545, 635, 770, 1183, 1870, 2036, 2306, 2741, 3104, 3253, 3685, 4174, 4888, 5065, 5204, 5498, 5704, 5799, 6381, 6762, 6928, 7205, 7545, 7790, 8304, 8640, 8959, 9633]","[321, 411, 515, 605, 895, 1243, 1464, 1871, 2189, 2822, 3068, 3217, 3565, 3732, 4078, 4444, 4539, 4796, 5146, 5241, 5594, 5975, 6402, 6887, 7227, 7541, 8007, 8306, 8703, 9094]",24121,16374,15644,9633,9094,48,13,102,20,103,"[589, 924, 1275, 1600, 2022, 2262, 2664, 2968, 3324, 3414, 3971, 4166, 4916, 5813, 6620, 7213, 7762, 8590, 9569, 10328, 11061, 11526, 12794, 13674, 14976, 16026, 17035, 17434, 18448, 19044]","[453, 664, 995, 1365, 1857, 2185, 2785, 3048, 3301, 3513, 3866, 4313, 5398, 6002, 6648, 7103, 7622, 8264, 9089, 9304, 9399, 9922, 10514, 11034, 11512, 12335, 12849, 12945, 13125, 13534]","[901, 1134, 1366, 1627, 1944, 2358, 2587, 3090, 3319, 3627, 4208, 4761, 5131, 5457, 5944, 6811, 7281, 7548, 7997, 8380, 8475, 8699, 9317, 10108, 10907, 11174, 11645, 11957, 12393, 12707]","[370, 685, 818, 908, 1143, 1356, 1880, 1970, 2060, 2150, 2303, 2398, 2783, 2917, 3429, 3952, 4047, 4253, 4623, 4798, 4937, 5278, 5743, 5876, 6043, 6219, 6600, 6731, 7066, 7543]","[322, 412, 522, 646, 1038, 1414, 1718, 1808, 1898, 1988, 2078, 2211, 2547, 2849, 3173, 3434, 3578, 3770, 4154, 4249, 4392, 4652, 5073, 5168, 5263, 5439, 5706, 5802, 6185, 6725]",19044,13534,12707,7543,6725,5077,2840,2937,2090,2369,15313,30,radiant
7547188716,61,41,14,47,31,"[403, 858, 1023, 1467, 1716, 2166, 2419, 2934, 3253, 3601, 3914, 4631, 5423, 6361, 7045, 7573, 8125, 9114, 9582, 10488, 11167, 11477, 12583, 13835, 14597, 15857, 16468, 17066, 17444, 18113]","[498, 817, 1322, 1887, 2233, 2608, 3214, 4032, 4616, 5273, 5808, 6162, 6435, 7039, 7648, 8337, 8688, 9386, 9747, 10492, 10745, 11427, 12196, 13079, 13899, 14815, 15387, 15524, 16128, 16750]","[360, 450, 581, 795, 1236, 1549, 1954, 2245, 2629, 3329, 3765, 4324, 5417, 5825, 6272, 7069, 7658, 8451, 8763, 9320, 10268, 10712, 11117, 11708, 12233, 13442, 14059, 14572, 15089, 15769]","[405, 654, 783, 1113, 1323, 1774, 1864, 2270, 2479, 2839, 3195, 3593, 4055, 4573, 4923, 5215, 5735, 6168, 6464, 7285, 7865, 8554, 9052, 9955, 10370, 11097, 11553, 11854, 12030, 12316]","[259, 349, 485, 648, 1073, 1293, 1460, 1790, 1969, 2357, 2588, 3061, 3246, 3448, 3734, 4050, 4234, 4419, 4824, 5581, 5901, 6258, 6509, 7357, 7451, 8431, 8608, 8752, 9236, 9813]",18113,16750,15769,12316,9813,10,23,99,30,105,"[613, 860, 1154, 1480, 1827, 2227, 2667, 2837, 3196, 3593, 3930, 4464, 5218, 5758, 6289, 6875, 7380, 8265, 8938, 10578, 11231, 12010, 12728, 13904, 14503, 14598, 15322, 16740, 17786, 18662]","[648, 863, 1160, 1523, 1822, 2337, 2754, 3254, 3825, 4292, 4613, 4956, 6282, 6376, 6945, 7202, 7931, 8725, 9084, 9627, 10167, 10801, 11388, 11725, 11944, 12222, 12490, 13075, 13551, 14012]","[538, 949, 1217, 1561, 2000, 2286, 2792, 3000, 3246, 3573, 3840, 4445, 4757, 5031, 5591, 5899, 6466, 6780, 7126, 7221, 7977, 8486, 8793, 9345, 9493, 9588, 10119, 10958, 11577, 12239]","[259, 349, 439, 573, 908, 998, 1265, 1355, 1535, 1662, 1770, 2120, 2963, 3057, 3314, 3951, 4188, 4563, 4761, 4856, 5699, 5794, 6171, 6454, 6548, 6643, 6820, 7327, 7955, 8235]","[259, 394, 531, 665, 803, 942, 1125, 1215, 1400, 1525, 1696, 2031, 2266, 2490, 2703, 2941, 3144, 3632, 3882, 4016, 4333, 4428, 4718, 5219, 5486, 5781, 5958, 6421, 6812, 7116]",18662,14012,12239,8235,7116,-549,2738,3530,4081,2697,12497,30,radiant
7547237916,109,69,120,53,100,"[604, 999, 1863, 2190, 2452, 2848, 3046, 3649, 4291, 4729, 6122, 6638, 7237, 7816, 8546, 9582, 10689, 10931, 11853, 13126, 13612, 14589, 15496, 16518, 17167, 17543, 17923, 18813, 19602, 20911]","[418, 716, 1009, 1150, 1585, 2070, 2572, 3198, 3881, 4430, 4912, 6037, 6605, 7535, 8448, 8811, 9390, 10112, 11048, 11899, 12697, 13323, 13954, 14311, 14868, 15469, 15837, 17031, 17594, 18250]","[530, 907, 1348, 1795, 2485, 2942, 3568, 3912, 4648, 5199, 5671, 6439, 6794, 7704, 8008, 8626, 9539, 10156, 10582, 11551, 12351, 12446, 13254, 13605, 14274, 14553, 14649, 15190, 15591, 15902]","[318, 473, 934, 1024, 1257, 1748, 2031, 2364, 2949, 3228, 3370, 3696, 4175, 5027, 5438, 5817, 6535, 6736, 7146, 7552, 8048, 8401, 8496, 9219, 9851, 9946, 10042, 11105, 11361, 11711]","[300, 436, 614, 704, 1426, 1692, 1911, 2001, 2371, 2551, 2760, 3118, 3364, 4025, 4183, 4350, 4718, 5094, 5509, 5711, 6176, 6506, 6814, 7165, 7410, 7709, 7805, 8429, 8573, 8787]",20911,18250,15902,11711,8787,138,43,88,14,91,"[902, 1385, 1775, 2375, 2705, 3031, 3376, 3685, 4062, 4507, 4979, 5110, 5545, 5792, 6399, 7389, 8030, 8562, 9128, 10380, 11402, 12279, 13081, 14095, 15915, 17130, 18107, 18688, 18784, 20323]","[502, 715, 959, 1433, 2314, 2797, 3413, 3746, 4080, 4505, 5255, 5708, 6117, 6537, 6680, 7549, 8526, 9014, 9535, 10318, 10818, 11416, 11790, 12453, 13165, 13901, 14595, 15499, 15709, 16681]","[577, 886, 1220, 1397, 1902, 2416, 2623, 3149, 3828, 4253, 4437, 4950, 5195, 5745, 5840, 6544, 6876, 7953, 8277, 8914, 9596, 10150, 10834, 11111, 11681, 12899, 13497, 14015, 14173, 14363]","[397, 487, 577, 794, 1108, 1198, 1411, 1598, 1953, 2133, 2417, 2681, 2989, 3198, 3293, 3751, 4856, 5104, 5283, 5757, 6221, 6505, 6686, 6781, 7444, 8641, 8977, 9662, 9795, 10111]","[290, 442, 576, 1022, 1382, 1726, 1816, 2004, 2303, 2483, 2767, 3004, 3306, 3515, 3681, 4100, 4194, 4289, 4472, 5014, 5527, 5622, 5717, 6077, 6717, 7130, 7336, 7675, 7771, 8077]",20323,16681,14363,10111,8077,588,1569,1539,1600,710,6006,30,radiant
7547312807,89,106,16,105,45,"[243, 530, 934, 1145, 1540, 1906, 2322, 2834, 3322, 3931, 4566, 5685, 6367, 6560, 7320, 8272, 9619, 10627, 11786, 12102, 12737, 13621, 14849, 14980, 16283, 17337, 17611, 18629, 19410, 21452]","[243, 412, 700, 1139, 1949, 2288, 2496, 2924, 3727, 4192, 4787, 5138, 5882, 6227, 6633, 6867, 7636, 8116, 8756, 8851, 9465, 10243, 10600, 10695, 11181, 11379, 12003, 12493, 12987, 13816]","[170, 442, 655, 866, 1080, 1334, 1579, 1706, 1983, 2238, 2328, 3010, 3697, 4099, 4616, 5010, 5825, 6323, 6838, 7188, 7526, 7985, 8759, 8854, 9118, 9321, 9999, 10404, 10648, 11238]","[170, 309, 399, 489, 690, 1161, 1508, 1719, 2206, 2876, 3147, 3746, 4241, 4336, 4542, 4664, 5569, 6133, 6584, 7025, 7439, 8000, 8469, 8922, 9053, 9346, 9478, 10260, 10583, 11055]","[170, 260, 350, 440, 882, 1018, 1150, 1261, 1583, 2133, 2556, 2849, 3501, 3748, 4100, 4195, 4867, 5167, 5532, 5627, 5908, 6564, 7178, 7416, 8362, 8788, 9166, 9582, 9984, 10856]",21452,13816,11238,11055,10856,102,11,80,88,64,"[389, 750, 984, 1550, 1831, 2527, 3077, 3454, 3907, 4388, 5220, 5496, 6249, 7259, 7952, 8712, 9285, 10041, 10795, 11886, 13164, 13975, 14844, 16104, 17446, 18437, 19131, 20295, 21435, 21873]","[464, 749, 998, 1505, 1843, 2470, 3394, 4036, 4304, 4894, 5330, 5887, 6144, 6994, 7667, 8464, 9040, 9577, 10130, 11636, 12309, 12592, 13469, 13774, 14325, 15229, 15701, 16600, 17019, 17987]","[208, 453, 701, 951, 1165, 1614, 1924, 2153, 2761, 3094, 3664, 4098, 4505, 5398, 5958, 6643, 7057, 7505, 8049, 8759, 9229, 9339, 10708, 10803, 11862, 12294, 13247, 13597, 13939, 14465]","[232, 322, 509, 685, 793, 928, 1572, 1771, 1906, 2068, 2248, 2422, 2625, 2973, 3067, 3325, 3743, 3951, 4159, 4947, 5117, 5287, 5711, 5902, 6400, 6746, 7234, 7711, 8028, 8658]","[500, 590, 717, 885, 975, 1234, 1459, 1664, 1754, 1939, 2164, 2335, 2691, 3034, 3128, 3572, 3728, 3883, 4125, 4515, 4610, 4754, 5265, 5770, 6311, 6406, 7185, 7549, 7969, 8269]",21873,17987,14465,8658,8269,-421,-4171,-3227,2397,2587,-2835,30,radiant
7547417213,10,106,69,86,121,"[260, 497, 820, 1139, 1501, 1805, 2120, 2426, 2696, 3240, 3689, 4253, 5118, 5720, 6548, 6706, 7670, 8610, 9061, 9984, 11150, 11526, 12295, 13547, 14808, 15657, 16375, 17043, 17734, 18598]","[293, 777, 1055, 1318, 1774, 2271, 2715, 3127, 3627, 4127, 4693, 4876, 6146, 6653, 7205, 7780, 8408, 9597, 10275, 10980, 11333, 12129, 12798, 13722, 14757, 15394, 16029, 16720, 17254, 17943]","[274, 580, 917, 1482, 1818, 2116, 2365, 2805, 3491, 4008, 4686, 4869, 5539, 5865, 6243, 6401, 6651, 7908, 8703, 9545, 10347, 11339, 12177, 13060, 13793, 14275, 15573, 15902, 16388, 17369]","[170, 642, 784, 988, 1118, 1358, 1618, 1708, 1962, 2127, 2299, 2671, 3381, 3524, 3882, 4174, 4453, 5152, 5579, 5786, 6180, 6409, 6878, 7219, 7615, 7900, 8290, 8467, 8943, 9262]","[170, 310, 400, 661, 1036, 1248, 1555, 1911, 2117, 2585, 2788, 2971, 3300, 3648, 3906, 4064, 4159, 4408, 4594, 4752, 5165, 5394, 5561, 5890, 6154, 6487, 6877, 7215, 7782, 8106]",18598,17943,17369,9262,8106,94,60,107,20,45,"[204, 506, 893, 1233, 1671, 2009, 2260, 2679, 3130, 3785, 4239, 4907, 5497, 6328, 6975, 7985, 8792, 9242, 9336, 10046, 11048, 11876, 12757, 13283, 14919, 16029, 16890, 17789, 19113, 20806]","[247, 621, 911, 1196, 1355, 1802, 2208, 2682, 3146, 3672, 4079, 5051, 5409, 5811, 6025, 6933, 7794, 8234, 8338, 8845, 9471, 9688, 10323, 10693, 11061, 11895, 13019, 13300, 13659, 13978]","[213, 461, 710, 1197, 1598, 1976, 2273, 2726, 3016, 3635, 3990, 4831, 5278, 5641, 6095, 6584, 7279, 7624, 7806, 8221, 8624, 9353, 10008, 10308, 11134, 11352, 11694, 12085, 12271, 12809]","[170, 260, 655, 785, 875, 1084, 1223, 1313, 1602, 2068, 2250, 3112, 3374, 3523, 3617, 4178, 4687, 5397, 5491, 5678, 5884, 6080, 6573, 6686, 6781, 6875, 7225, 7488, 7921, 8506]","[170, 260, 439, 613, 751, 905, 995, 1085, 1504, 1789, 1934, 2496, 2663, 2908, 3012, 3374, 4160, 4609, 4740, 4898, 5167, 5333, 5714, 5921, 6405, 6499, 6996, 7370, 7686, 7897]",20806,13978,12809,8506,7897,-2208,3965,4560,756,209,7282,30,radiant
7547476916,59,93,28,21,20,"[215, 534, 922, 1665, 2118, 2456, 3008, 3860, 4534, 5135, 6105, 6242, 6986, 7439, 8285, 8933, 9693, 9890, 10715, 11490, 12611, 13327, 14027, 14291, 15263, 15925, 16789, 17926, 18899, 19927]","[253, 491, 936, 1261, 1559, 1959, 2342, 2834, 3487, 4037, 4707, 5005, 5628, 6396, 7208, 7621, 8050, 8767, 9730, 10468, 10684, 11568, 12447, 13310, 14288, 15133, 16194, 17394, 18374, 19198]","[207, 575, 897, 1265, 1474, 1811, 2470, 2839, 3409, 3636, 4405, 5088, 5898, 6319, 7201, 7820, 8418, 8754, 9636, 9854, 10038, 10644, 11360, 11548, 11933, 12403, 12856, 13410, 13842, 14466]","[170, 346, 436, 619, 776, 911, 1079, 1382, 1802, 2010, 2190, 2516, 3214, 3393, 3722, 4106, 4336, 4523, 4924, 5203, 5457, 5822, 6188, 6283, 6708, 6803, 7063, 7752, 8488, 8947]","[272, 398, 537, 671, 761, 896, 1124, 1304, 1565, 1909, 2193, 2331, 2624, 2737, 2922, 3201, 3667, 3762, 4222, 4380, 4564, 4806, 5200, 5333, 5609, 5704, 5953, 6433, 6956, 7415]",19927,19198,14466,8947,7415,82,13,55,123,31,"[330, 498, 1091, 1325, 1657, 2295, 2753, 2843, 3239, 4080, 4565, 4935, 5766, 6609, 7328, 8078, 8586, 9014, 9372, 10376, 11026, 12019, 13246, 14236, 15339, 16625, 17239, 18020, 18643, 18739]","[296, 541, 705, 838, 1002, 1242, 1485, 1767, 2128, 2666, 2756, 3166, 3495, 3721, 4069, 4576, 5102, 5692, 5825, 6647, 7231, 7878, 8650, 9691, 10420, 10944, 11744, 12086, 13230, 13631]","[245, 387, 802, 1084, 1251, 1741, 2280, 2568, 2916, 3122, 3307, 4222, 4711, 5145, 5676, 6090, 6729, 6914, 7102, 7828, 8244, 8760, 9932, 10433, 11176, 11996, 12333, 12545, 13600, 13712]","[170, 260, 414, 549, 679, 769, 1182, 1318, 1408, 1767, 1857, 2158, 2439, 2706, 3162, 3391, 3921, 4091, 4870, 5460, 5602, 5956, 6538, 6948, 7364, 7736, 7831, 7927, 8695, 8909]","[170, 260, 473, 563, 708, 798, 933, 1023, 1113, 1248, 1338, 1639, 1788, 1921, 2107, 2318, 2652, 2747, 3005, 3464, 3558, 3725, 4377, 4658, 4975, 5151, 5246, 5342, 5950, 6082]",18739,13631,13712,8909,6082,1188,5567,754,38,1333,8880,30,radiant
7547652005,41,129,34,123,20,"[0, 169, 424, 798, 1118, 1609, 1922, 2339, 2849, 3283, 3865, 4505, 4825, 5307, 5822, 6193, 6648, 7272, 7760, 8960, 9337, 10076, 10767, 11284, 12770, 13721, 13816, 14734, 16128, 16764]","[0, 284, 573, 850, 1102, 1756, 2347, 2719, 3131, 3937, 4171, 4369, 4708, 5689, 5969, 6441, 6535, 7279, 7375, 7798, 8253, 8795, 9901, 10605, 11646, 11780, 11875, 12158, 13016, 13737]","[0, 205, 534, 898, 1151, 1498, 1622, 1712, 2146, 2420, 2698, 2827, 2953, 3434, 3588, 3822, 3952, 4387, 4972, 5689, 6312, 6881, 7618, 8253, 8970, 9653, 10017, 10562, 11378, 11648]","[0, 169, 341, 483, 573, 1004, 1166, 1256, 1346, 1653, 2362, 2499, 2672, 3032, 3127, 3869, 3999, 4486, 4941, 5403, 5772, 6342, 6722, 7123, 8328, 8651, 8746, 9232, 9545, 9703]","[0, 169, 331, 655, 856, 1270, 1360, 1532, 1656, 1746, 2154, 2244, 2669, 3029, 3124, 3549, 3643, 3935, 4210, 4609, 4836, 5110, 5687, 5854, 6974, 7148, 7243, 7337, 7514, 7610]",16764,13737,11648,9703,7610,54,106,28,86,65,"[0, 335, 537, 902, 1108, 1354, 1712, 2071, 2470, 2765, 3553, 4166, 4774, 5484, 5919, 6180, 6995, 7918, 8381, 8640, 9788, 10816, 11393, 12557, 12951, 14559, 15504, 16570, 17292, 18617]","[0, 282, 653, 1017, 1388, 1909, 2621, 3254, 3877, 4640, 5238, 6053, 6428, 6830, 7087, 7945, 8487, 9716, 10133, 10994, 11643, 12338, 12851, 14038, 14924, 15922, 16682, 17140, 17687, 18389]","[0, 208, 823, 1026, 1263, 1552, 1945, 2454, 3100, 3694, 4107, 4617, 5104, 5798, 6324, 7054, 7612, 8251, 9108, 9315, 9982, 10760, 11019, 11894, 12540, 13456, 14238, 15118, 15892, 16400]","[0, 169, 259, 349, 539, 715, 840, 1047, 1448, 1734, 2000, 2358, 2538, 2984, 3619, 3851, 4442, 5029, 5398, 5849, 6189, 6579, 6941, 7395, 7924, 8615, 9111, 9567, 9926, 10814]","[0, 204, 362, 531, 661, 858, 983, 1300, 1605, 2050, 2383, 2675, 3088, 3479, 3718, 4251, 4523, 5050, 5541, 6577, 7179, 7724, 8103, 8333, 8640, 8923, 9888, 10699, 11060, 11392]",18617,18389,16400,10814,11392,-1853,-4652,-4752,-1111,-3782,-16150,30,dire
7547992002,41,129,120,64,107,"[0, 330, 740, 1098, 1466, 1910, 2325, 2584, 3132, 3832, 4564, 4926, 5866, 6605, 7151, 7622, 8443, 9113, 9403, 10348, 10971, 11422, 12254, 13210, 14068, 15045, 15777, 16439, 17160, 17601]","[0, 204, 438, 713, 1452, 1770, 2022, 2375, 2708, 2946, 3502, 4019, 4385, 4951, 5342, 5648, 6118, 6537, 7077, 7668, 8092, 8289, 8883, 10112, 11403, 11991, 12196, 12701, 13071, 13466]","[0, 307, 510, 805, 1014, 1104, 1359, 1840, 2057, 2654, 3268, 4012, 4351, 5083, 5276, 5634, 6282, 6674, 7055, 7591, 8096, 8366, 9008, 9591, 10401, 11065, 11729, 12188, 12884, 13202]","[0, 170, 260, 505, 643, 782, 1178, 1313, 1542, 1808, 2168, 2422, 2637, 3088, 3237, 3591, 4200, 4426, 4521, 5102, 5414, 5714, 6243, 7089, 7571, 8102, 8594, 9006, 9572, 9803]","[0, 170, 260, 350, 641, 731, 866, 1004, 1139, 1643, 2052, 2243, 2423, 2780, 2929, 3023, 3181, 3276, 3371, 3528, 3671, 4046, 4387, 4850, 5513, 5948, 6233, 6517, 6907, 7138]",17601,13466,13202,9803,7138,36,6,99,86,20,"[0, 256, 525, 873, 1277, 1530, 2028, 2349, 2800, 3169, 3597, 3826, 4298, 5375, 5742, 6138, 6704, 7048, 7397, 8086, 8622, 9492, 9749, 9843, 9938, 10278, 10373, 11008, 12164, 12698]","[0, 222, 433, 667, 950, 1244, 1479, 1736, 2019, 2200, 2618, 2800, 3242, 3436, 3780, 4135, 4482, 5105, 5694, 6212, 6678, 7148, 7948, 8372, 8702, 9158, 9861, 10769, 11303, 12028]","[0, 170, 333, 593, 847, 937, 1162, 1289, 1424, 1584, 1674, 1937, 2063, 3070, 3243, 3522, 3800, 4262, 4652, 5099, 5399, 5766, 6187, 6448, 6743, 6838, 7274, 7595, 7890, 8194]","[0, 170, 260, 589, 679, 816, 1006, 1132, 1296, 1386, 1525, 1615, 1822, 2416, 2511, 2652, 2942, 3037, 3523, 3840, 3935, 4133, 4435, 4529, 4624, 4719, 4859, 5001, 5370, 5466]","[0, 170, 260, 350, 799, 936, 1077, 1198, 1306, 1479, 1656, 1746, 1881, 2176, 2271, 2409, 2727, 2822, 3007, 3164, 3420, 3567, 3915, 4009, 4297, 4392, 4535, 4629, 5047, 5234]",12698,12028,8194,5466,5234,4903,1438,5008,4337,1904,17590,30,radiant
7548094003,48,25,47,105,136,"[0, 284, 526, 954, 1284, 1667, 2078, 2478, 2986, 3416, 4000, 4751, 5355, 6147, 6912, 7349, 8430, 8797, 9468, 9661, 10166, 10647, 11291, 11913, 13098, 13419, 14196, 14698, 16071, 17205]","[0, 207, 547, 893, 1234, 1602, 2025, 2594, 3193, 3460, 4047, 4665, 5152, 5520, 5831, 6253, 7184, 8169, 8625, 9342, 10068, 11048, 11850, 12849, 13132, 13733, 14417, 15033, 15622, 16750]","[2, 206, 409, 663, 1004, 1129, 1483, 1702, 2040, 2400, 3104, 3609, 3908, 4103, 4323, 4684, 5259, 5717, 6106, 6615, 7333, 8254, 8716, 9126, 9623, 10072, 10759, 10898, 11396, 11985]","[0, 169, 295, 385, 700, 840, 1215, 1305, 1484, 1741, 2033, 2276, 2366, 2561, 2656, 2794, 3553, 3738, 3908, 4973, 5206, 5618, 5784, 6103, 6483, 6775, 7159, 7536, 7755, 9286]","[0, 169, 259, 527, 617, 862, 1045, 1163, 1345, 1449, 1690, 1933, 2067, 2282, 2377, 2941, 3099, 3359, 3523, 3618, 4453, 4847, 5106, 5414, 5559, 5654, 5796, 6143, 6239, 6425]",17205,16750,11985,9286,6425,114,106,123,96,79,"[60, 229, 790, 1113, 1399, 1827, 2332, 2947, 3289, 3759, 4304, 4923, 5545, 6208, 6542, 7127, 7516, 8126, 9152, 10179, 10932, 11798, 12548, 13148, 14113, 14994, 15441, 16715, 17781, 17958]","[328, 695, 1052, 1267, 1805, 2102, 2432, 3127, 3568, 4413, 5107, 5511, 6209, 7137, 7286, 7664, 8575, 9188, 9978, 10259, 10801, 11186, 12008, 12179, 13045, 13574, 14225, 14804, 15856, 16165]","[60, 229, 319, 644, 780, 1129, 1264, 1401, 1537, 2201, 2574, 2929, 3204, 3623, 4109, 4526, 5346, 5589, 6204, 6485, 7094, 7422, 7714, 7917, 8975, 9316, 9898, 10446, 11127, 11350]","[60, 302, 640, 1068, 1467, 1966, 2056, 2559, 3058, 3607, 4494, 4659, 5273, 5820, 6020, 6334, 6834, 7166, 7726, 8350, 8667, 9358, 9671, 9914, 10530, 10990, 11450, 12162, 12688, 13240]","[60, 229, 383, 526, 616, 805, 1015, 1298, 1447, 1964, 2559, 3010, 3190, 3439, 3639, 4064, 4402, 4831, 5211, 5702, 6488, 6655, 6891, 7115, 7431, 7829, 8179, 8355, 8781, 8958]",17958,16165,11350,13240,8958,-753,585,635,-3954,-2533,-6020,30,dire
7548252414,67,22,2,40,20,"[0, 291, 700, 948, 1156, 1450, 1707, 2035, 2448, 2981, 3348, 3853, 4247, 4533, 4894, 5067, 5642, 6361, 6651, 7104, 8239, 8617, 9067, 9941, 10236, 11269, 11709, 12343, 13141, 14296]","[0, 219, 622, 1021, 1375, 1772, 2151, 3091, 3710, 4589, 5051, 6038, 6587, 7112, 7531, 7869, 8412, 9236, 9641, 10418, 11828, 12267, 12629, 12998, 13093, 13743, 14218, 14904, 15167, 15677]","[0, 205, 448, 831, 1235, 1491, 1780, 2272, 2657, 3677, 4111, 4647, 5279, 6037, 6949, 7381, 8181, 9513, 10362, 10622, 11773, 12145, 12882, 13306, 14065, 14539, 14634, 14968, 15168, 15734]","[0, 517, 632, 722, 904, 1004, 1141, 1415, 1505, 1845, 2067, 2389, 2908, 3034, 3444, 3640, 3944, 4587, 5079, 5514, 6035, 6419, 6852, 7396, 7888, 8334, 8477, 8816, 9040, 9445]","[0, 169, 284, 374, 464, 601, 691, 781, 919, 1309, 1444, 1604, 1920, 2191, 2338, 2433, 2771, 3600, 3981, 4138, 4412, 4670, 4765, 4968, 5193, 5470, 5565, 5794, 5890, 6459]",14296,15677,15734,9445,6459,8,97,43,27,121,"[0, 205, 472, 799, 1204, 1587, 1995, 2579, 3091, 3333, 3986, 4237, 4754, 5208, 5659, 6371, 7217, 7477, 8184, 9194, 9457, 9816, 10606, 10921, 11389, 12282, 12596, 13119, 13570, 14017]","[0, 216, 579, 938, 1354, 1928, 2276, 2569, 3113, 3619, 4346, 4686, 5284, 5962, 6471, 7163, 8063, 8295, 8912, 9323, 10288, 10832, 11445, 12011, 13251, 13529, 14376, 14636, 15777, 15873]","[0, 237, 486, 816, 1336, 1465, 1555, 1965, 2295, 2626, 3014, 3351, 3496, 3819, 4343, 4547, 5000, 5247, 5757, 6464, 6939, 7635, 8213, 8347, 9207, 9646, 9959, 10264, 10801, 11108]","[100, 269, 359, 449, 652, 817, 953, 1043, 1178, 1529, 1664, 1875, 2150, 2433, 2695, 2893, 3497, 3820, 4008, 4322, 4653, 5090, 5412, 5554, 6807, 7182, 7309, 7512, 7865, 8344]","[0, 169, 259, 397, 610, 775, 910, 1078, 1256, 1346, 1481, 1571, 1661, 2236, 2432, 2546, 2852, 3272, 3537, 3851, 4162, 4329, 4568, 4817, 5401, 5496, 5591, 5685, 5943, 6039]",14017,15873,11108,8344,6039,279,-196,4626,1101,420,6230,30,radiant
7548322301,10,98,21,100,84,"[0, 294, 709, 883, 1220, 1904, 2224, 2778, 3197, 3928, 4485, 5025, 5411, 6269, 6886, 7519, 8499, 8593, 9875, 10300, 11078, 11428, 12434, 13101, 13480, 13915, 14915, 15095, 15329, 16406]","[0, 250, 625, 1110, 1407, 1845, 2387, 2931, 3265, 3831, 4339, 5051, 5838, 6438, 6950, 7624, 8270, 8474, 9143, 9826, 10500, 11300, 11738, 12437, 13122, 13665, 14398, 14668, 15151, 16021]","[0, 241, 487, 881, 1186, 1641, 1919, 2149, 2779, 3569, 4024, 4487, 4608, 5139, 5534, 5742, 6870, 7322, 8008, 8502, 9210, 10444, 10964, 11494, 11813, 12421, 12784, 13098, 13686, 14349]","[100, 270, 360, 796, 886, 1235, 1325, 1829, 2140, 2461, 2686, 3382, 3674, 3822, 3917, 4012, 4512, 4650, 4803, 4898, 5265, 5761, 5946, 6041, 6783, 7121, 7618, 8004, 8248, 8711]","[0, 170, 260, 350, 489, 709, 799, 1080, 1260, 1462, 1687, 1905, 1995, 2188, 2299, 2394, 2993, 3133, 3273, 3493, 3588, 3714, 4119, 4289, 4459, 4906, 5223, 5478, 5649, 6328]",16406,16021,14349,8711,6328,82,22,102,58,5,"[0, 207, 468, 804, 1048, 1355, 1946, 2507, 2841, 3159, 3659, 4380, 5227, 5774, 6412, 7121, 8426, 9463, 10389, 11168, 11835, 12660, 13223, 14354, 15198, 16445, 17388, 19216, 20176, 20988]","[0, 357, 763, 1126, 1662, 2036, 3343, 3800, 4134, 5087, 5666, 6060, 7014, 7405, 7657, 8070, 8787, 9610, 10272, 11065, 11411, 12078, 12619, 12849, 13490, 14044, 14695, 15667, 16261, 16444]","[0, 170, 517, 826, 1041, 1466, 1915, 2207, 2728, 3047, 3343, 3892, 4262, 4850, 5257, 5724, 6566, 6965, 7359, 7759, 8212, 8584, 8850, 9178, 9590, 10124, 10534, 11623, 11927, 12262]","[0, 170, 285, 405, 495, 794, 1134, 1356, 1558, 1908, 2486, 2874, 3271, 3706, 3999, 4170, 4536, 4966, 5355, 5788, 5981, 6572, 6811, 7449, 7859, 8590, 8685, 9476, 9787, 9929]","[0, 170, 334, 499, 589, 725, 1080, 1260, 1423, 1513, 1787, 1963, 2358, 2602, 2798, 3148, 3562, 3836, 4097, 4567, 4782, 5110, 5429, 5659, 5927, 6547, 6917, 7661, 8128, 8224]",20988,16444,12262,9929,8224,-4582,-423,2087,-1218,-1896,-6032,30,radiant
7548329914,73,51,14,86,26,"[330, 619, 988, 1314, 1746, 2217, 2539, 3086, 3612, 4373, 4982, 5602, 6786, 7967, 9035, 10120, 11682, 12868, 13815, 15711, 16038, 16696, 18276, 19472, 20394, 21543, 22482, 23935, 25050, 26433]","[60, 339, 574, 905, 1351, 1757, 2279, 2404, 2748, 3515, 4108, 4556, 5423, 6025, 6852, 7496, 7719, 8832, 9529, 10035, 11074, 12122, 13038, 14081, 14784, 15457, 17484, 18046, 19251, 20319]","[60, 402, 675, 1457, 1669, 2316, 2864, 3274, 3645, 4264, 4473, 5020, 6080, 6728, 7383, 8117, 8849, 9514, 9898, 10176, 10454, 11093, 11365, 12122, 13039, 14015, 14702, 15756, 16303, 17438]","[60, 275, 365, 455, 632, 946, 1183, 1273, 1411, 1667, 2049, 2381, 3209, 3984, 4345, 4449, 4655, 4939, 5735, 6125, 6564, 7118, 7284, 8047, 8292, 9053, 9592, 9813, 10184, 11018]","[60, 430, 767, 1034, 1164, 1444, 1625, 1725, 1945, 2286, 2376, 2820, 3700, 4016, 4230, 4324, 4482, 4728, 5450, 5545, 5887, 6212, 6625, 7033, 7128, 7455, 7945, 8417, 8649, 9311]",26433,20319,17438,11018,9311,94,69,76,100,121,"[0, 330, 506, 942, 1203, 1293, 1538, 2031, 2276, 2957, 3185, 3673, 4101, 4432, 4927, 6224, 6770, 7283, 7742, 8648, 9317, 9412, 9745, 10715, 11993, 12645, 12906, 13222, 14016, 14485]","[0, 207, 485, 727, 1064, 1459, 1773, 2300, 2564, 2806, 3421, 4025, 4494, 4941, 5142, 6098, 6545, 7167, 8430, 8652, 9316, 10015, 10472, 10786, 11537, 12289, 12429, 12802, 13222, 13682]","[0, 325, 620, 1024, 1308, 1708, 2114, 2642, 3000, 3090, 3700, 3898, 3988, 4327, 4983, 5967, 6164, 6310, 6965, 7242, 8016, 8790, 9930, 10530, 10715, 11073, 11167, 11751, 12011, 12444]","[0, 393, 483, 704, 794, 889, 996, 1284, 1376, 1618, 1708, 1906, 2086, 2365, 2460, 3165, 3260, 3355, 4633, 4872, 5299, 5895, 6400, 6929, 7024, 7387, 7481, 7576, 7727, 7823]","[0, 169, 259, 349, 524, 614, 827, 1373, 1629, 1945, 2035, 2233, 2323, 2418, 2665, 3211, 3306, 3401, 4208, 4458, 5016, 5479, 5981, 6333, 6503, 6745, 6914, 7139, 7410, 7581]",14485,13682,12444,7823,7581,11948,6637,4994,3195,1730,28504,30,radiant
7548406310,106,69,93,123,31,"[329, 609, 1048, 1456, 1948, 2281, 2731, 2985, 3232, 3887, 4344, 4931, 5673, 6365, 7032, 7343, 7759, 8379, 9086, 10404, 10955, 11315, 12245, 12973, 13596, 14116, 15313, 16194, 16669, 17814]","[61, 347, 514, 932, 1233, 1551, 2020, 2429, 2828, 3670, 3891, 4252, 4893, 5627, 6319, 7340, 7963, 8505, 8706, 9478, 10276, 11013, 11731, 12339, 13101, 13618, 14996, 15648, 16231, 16767]","[61, 267, 511, 793, 1190, 1434, 1782, 2176, 2567, 3022, 3577, 4157, 4696, 5163, 5885, 6102, 6408, 7306, 7783, 8112, 9168, 9918, 10842, 11666, 12294, 12763, 13921, 14279, 14915, 15677]","[61, 230, 320, 455, 593, 683, 818, 908, 998, 1379, 1707, 2023, 2260, 2605, 3267, 3556, 4245, 4937, 5078, 5577, 5893, 6658, 7349, 7456, 7761, 7928, 8785, 8987, 9209, 9770]","[61, 230, 320, 649, 739, 921, 1179, 1435, 1525, 1889, 2069, 2257, 2446, 2816, 3520, 3941, 4162, 4325, 4466, 5014, 5211, 5618, 5886, 6081, 6286, 6528, 7046, 7821, 8082, 8363]",17814,16767,15677,9770,8363,94,120,53,97,105,"[0, 207, 540, 874, 1041, 1426, 1795, 2200, 2542, 2914, 3442, 4148, 4630, 5368, 5973, 6672, 7440, 7774, 8352, 8654, 9140, 9590, 10370, 11388, 12216, 13290, 14137, 14231, 15053, 15549]","[0, 324, 643, 1017, 1308, 1633, 2030, 2624, 3364, 3792, 4175, 4544, 5244, 5728, 6471, 7167, 7829, 8858, 9546, 10054, 10149, 10611, 11470, 11756, 12715, 13190, 13720, 14300, 14841, 15072]","[0, 169, 259, 568, 771, 968, 1320, 1823, 2044, 2367, 2540, 2748, 3054, 3213, 3641, 3894, 4102, 4622, 5074, 5504, 5863, 6596, 6913, 7081, 7276, 7803, 8525, 8962, 9353, 9584]","[0, 207, 463, 888, 1167, 1529, 1895, 2507, 2957, 3409, 3832, 3973, 4763, 5198, 5410, 5504, 5863, 6185, 6761, 7369, 7870, 8126, 8221, 8567, 8938, 9303, 9657, 9957, 10053, 10578]","[0, 169, 259, 651, 995, 1167, 1325, 1833, 2134, 2358, 2635, 2951, 3351, 3512, 3933, 4164, 4653, 4842, 5027, 5337, 5432, 5547, 5642, 5791, 6029, 6508, 6840, 6934, 7030, 7261]",15549,15072,9584,10578,7261,2265,1695,6093,-808,1102,10347,30,radiant
7548715213,89,128,2,71,105,"[1, 242, 514, 1008, 1399, 1773, 1972, 2387, 2714, 3304, 3920, 4291, 5080, 5769, 6556, 7375, 8347, 9458, 9838, 10831, 11618, 13101, 14026, 15726, 17008, 18137, 18547, 19234, 19671, 20228]","[1, 291, 659, 1002, 1495, 2196, 2681, 3250, 3726, 4534, 5047, 5479, 5822, 6748, 7637, 8214, 8308, 9319, 10052, 10320, 10838, 11741, 12486, 12932, 13098, 13458, 14398, 14695, 15653, 16539]","[1, 247, 513, 753, 1036, 1345, 1975, 2120, 2827, 3525, 4228, 4751, 5153, 5569, 6569, 7091, 7185, 8111, 8695, 9141, 9377, 10731, 11230, 12282, 13063, 13907, 14337, 15034, 15292, 15951]","[1, 171, 261, 351, 487, 678, 808, 1025, 1160, 1365, 1590, 1887, 2142, 2625, 2774, 3174, 3349, 3764, 4047, 4805, 4918, 5403, 6189, 6613, 7217, 7670, 8625, 9108, 10390, 11054]","[1, 171, 261, 785, 923, 1076, 1206, 1389, 1534, 2006, 2231, 2953, 3475, 3839, 4610, 5264, 5960, 6230, 6388, 6882, 7261, 7829, 8148, 8679, 8928, 9106, 9496, 10266, 11025, 11330]",20228,16539,15951,11054,11330,14,69,53,135,121,"[1, 196, 663, 906, 1268, 1686, 2099, 2575, 2820, 3102, 3286, 3715, 4724, 4872, 5107, 6119, 7291, 7795, 8746, 9383, 10236, 10716, 10883, 12358, 12452, 13112, 13676, 16353, 17000, 18500]","[3, 357, 601, 933, 1315, 1525, 1934, 2104, 2433, 2603, 3198, 3496, 4619, 5193, 5716, 6398, 7701, 8097, 8396, 8852, 9686, 10304, 10680, 11446, 11980, 12365, 13125, 14138, 14743, 15961]","[1, 196, 286, 376, 554, 684, 1105, 1292, 1768, 1858, 2179, 2420, 3063, 3211, 3357, 3569, 4236, 4634, 5179, 5555, 6566, 7197, 7364, 8619, 8713, 9012, 9413, 9679, 9779, 10663]","[1, 231, 360, 687, 854, 1354, 1778, 2154, 2639, 3062, 3513, 3819, 4010, 4158, 4253, 4698, 5209, 5534, 6334, 6743, 7111, 7505, 8111, 8566, 8768, 9141, 9483, 10483, 10579, 11182]","[1, 196, 286, 601, 731, 1184, 1605, 1792, 2052, 2177, 2435, 2572, 3087, 3235, 3330, 3561, 3992, 4213, 4714, 4935, 5343, 5810, 5977, 6144, 6238, 6622, 6925, 8682, 8999, 9345]",18500,15961,10663,11182,9345,1728,578,5288,-128,1985,9451,30,radiant
7548737005,10,39,60,86,83,"[450, 700, 1185, 1573, 1785, 2417, 2673, 3498, 3829, 4782, 5899, 6475, 7008, 7574, 8117, 8948, 9896, 10863, 11436, 12404, 13483, 14258, 15013, 16228, 17000, 17960, 19827, 20535, 20631, 21224]","[749, 1132, 1543, 1972, 2285, 2582, 2967, 3542, 3913, 4790, 5267, 5415, 5783, 6149, 6591, 6786, 7243, 7589, 8478, 8816, 9737, 10258, 10746, 11196, 11912, 12273, 13314, 14160, 14765, 15990]","[560, 908, 1230, 1830, 2092, 2864, 3249, 3886, 4272, 4727, 5281, 5763, 6166, 6261, 6778, 6992, 7447, 8187, 8384, 8557, 9096, 9425, 9750, 10027, 10396, 10616, 11589, 12103, 12532, 13014]","[599, 739, 1008, 1185, 1327, 1676, 1766, 2035, 2170, 2673, 2990, 3138, 3371, 3639, 3979, 4516, 4974, 5742, 5836, 6100, 6401, 6889, 7043, 7652, 7963, 8118, 8878, 9254, 9510, 10031]","[261, 351, 536, 626, 716, 896, 1069, 1629, 1903, 2403, 2668, 3012, 3107, 3202, 3359, 3454, 3661, 3952, 4046, 4229, 4629, 4724, 4906, 5294, 5513, 5608, 6192, 6690, 6885, 7151]",21224,15990,13014,10031,7151,42,28,95,37,20,"[533, 928, 1295, 1697, 2113, 2928, 3303, 4068, 4511, 5142, 5621, 6484, 6835, 7624, 9028, 10024, 11140, 11922, 13272, 13738, 15123, 16675, 17693, 18527, 19618, 20126, 21100, 21735, 22770, 23616]","[695, 1317, 1568, 1941, 2297, 2387, 2642, 3445, 3923, 4175, 4812, 5656, 6388, 7023, 7501, 7726, 8589, 9213, 9588, 9758, 10175, 11154, 11622, 12461, 13248, 13954, 14394, 14490, 15172, 15419]","[575, 905, 1182, 1321, 1565, 1729, 1907, 2020, 2334, 2778, 2993, 3583, 3678, 4438, 5308, 5675, 6122, 6758, 7333, 7561, 8211, 8910, 9277, 10277, 10501, 11195, 11815, 12121, 12325, 13393]","[327, 969, 1152, 1472, 1713, 1803, 1941, 2569, 2801, 3102, 3192, 3796, 4111, 4444, 5233, 5434, 5667, 5825, 5919, 6014, 6636, 6913, 7007, 7568, 7663, 7758, 8060, 8213, 8403, 8758]","[327, 417, 547, 637, 825, 915, 1005, 1569, 1905, 2194, 2429, 2787, 3082, 3504, 3966, 4098, 4451, 4609, 4789, 4904, 5556, 5932, 6054, 6622, 6752, 6902, 7508, 7604, 7873, 8228]",23616,15419,13393,8758,8228,-2392,571,-379,1273,-1077,-2004,30,radiant
7548774319,39,93,78,58,26,"[557, 892, 1237, 1502, 1979, 2334, 2955, 3902, 4566, 5168, 5950, 6551, 7107, 7201, 7702, 8125, 8920, 9491, 10177, 10417, 11179, 12041, 12791, 14306, 14927, 15183, 16059, 16751, 17582, 18063]","[519, 1038, 1379, 1624, 2045, 2411, 2775, 3537, 4075, 4606, 5136, 5634, 6086, 6180, 6632, 7134, 8293, 9125, 9975, 11278, 11673, 11903, 12880, 13818, 14333, 15022, 15483, 16384, 16641, 17328]","[791, 1156, 1489, 1736, 2275, 2823, 3565, 4013, 4960, 5145, 5870, 6489, 7300, 7394, 8228, 8945, 9416, 10164, 10883, 11757, 12310, 12540, 13091, 13430, 13906, 14309, 15150, 15718, 16221, 16481]","[260, 350, 536, 647, 1212, 1380, 1636, 2053, 2430, 2772, 3368, 3695, 4037, 4308, 4767, 4959, 5325, 5569, 5975, 6944, 7542, 8107, 8597, 9260, 9747, 10003, 10537, 10876, 11635, 11934]","[421, 511, 641, 775, 1068, 1203, 1488, 1699, 2123, 2431, 2791, 3107, 3451, 3545, 3802, 3960, 4349, 4590, 4768, 5698, 6275, 6610, 7229, 7756, 7984, 8204, 8688, 9338, 9532, 9852]",18063,17328,16481,11934,9852,25,137,14,53,5,"[657, 903, 1357, 1719, 2091, 2524, 3063, 3549, 4141, 4231, 4471, 4566, 5017, 6074, 6696, 6951, 7911, 8371, 8967, 9335, 10034, 10313, 10874, 11627, 11885, 12569, 13005, 15111, 15711, 16670]","[488, 612, 900, 1045, 1385, 1544, 1819, 2107, 2425, 2940, 3213, 3428, 3964, 4554, 5117, 5938, 6494, 6889, 7392, 7487, 7916, 8297, 8716, 9640, 10105, 10477, 11078, 12306, 13479, 13913]","[741, 1060, 1337, 1720, 2029, 2406, 2579, 2992, 3370, 3460, 4086, 4892, 5072, 5672, 6122, 6509, 6945, 7262, 7701, 7796, 8323, 8653, 8851, 9472, 9566, 10038, 10134, 10739, 11012, 11987]","[344, 666, 796, 886, 1314, 1404, 1494, 1822, 2063, 2303, 2588, 3082, 3347, 3860, 4345, 4508, 4939, 5286, 5708, 5803, 6227, 6701, 6814, 7131, 7439, 7941, 8037, 8603, 9054, 9737]","[344, 701, 831, 970, 1153, 1287, 1377, 1553, 1766, 1919, 2181, 2314, 2409, 3393, 3523, 3761, 4021, 4183, 4594, 4689, 5054, 5350, 5445, 5871, 6040, 6246, 6417, 7309, 7741, 8213]",16670,13913,11987,9737,8213,1393,3415,4494,2197,1639,13138,30,radiant
7548914808,10,39,80,91,84,"[0, 324, 633, 1101, 1478, 1987, 2504, 3079, 3810, 4418, 5160, 5908, 6531, 7247, 8092, 8668, 9481, 10107, 10835, 11558, 12463, 14506, 15672, 16726, 18524, 20081, 22907, 23756, 24690, 26179]","[0, 370, 743, 1060, 1392, 1812, 2183, 2716, 3492, 3918, 4452, 5114, 5629, 6345, 6736, 7167, 7901, 8694, 9478, 10108, 10629, 11137, 12736, 12921, 13333, 14329, 15646, 16172, 16818, 17287]","[0, 324, 669, 1110, 1520, 1988, 2331, 2979, 3741, 4045, 4596, 5503, 6461, 7268, 7362, 8009, 8329, 8840, 9674, 10119, 10767, 11295, 13066, 13251, 14323, 14772, 14948, 15337, 15599, 15695]","[0, 170, 260, 425, 561, 698, 837, 976, 1293, 1396, 1620, 1919, 2139, 2342, 2436, 2531, 2768, 2926, 3020, 3115, 3210, 3484, 3898, 4083, 4724, 5104, 5280, 5419, 5796, 5916]","[0, 170, 260, 428, 518, 655, 789, 879, 1198, 1288, 1516, 1817, 1907, 2464, 2558, 2701, 2796, 2999, 3093, 3188, 3327, 3422, 3788, 4007, 4254, 4677, 4853, 4948, 5224, 5320]",26179,17287,15695,5916,5320,114,109,28,86,64,"[0, 320, 729, 1059, 1470, 1892, 2301, 2897, 3630, 4150, 4717, 5139, 5746, 6445, 7138, 7779, 8981, 9855, 10360, 10957, 12067, 12872, 14297, 15794, 16809, 17626, 18389, 18565, 21003, 21906]","[0, 277, 675, 1049, 1357, 1574, 1934, 2245, 2658, 3043, 3455, 3830, 4522, 4988, 5611, 6269, 7745, 8557, 9287, 10281, 10872, 11760, 12035, 12923, 13659, 14192, 14287, 14919, 15383, 15759]","[0, 244, 639, 1059, 1436, 2038, 2524, 3019, 3512, 3962, 4474, 5035, 5558, 5989, 6791, 7429, 7685, 8576, 9247, 9625, 9927, 10471, 10670, 11335, 12286, 13318, 13738, 14478, 15588, 16104]","[0, 221, 311, 401, 542, 681, 816, 906, 1131, 1603, 1996, 2442, 2863, 3590, 3908, 4352, 4905, 5153, 5780, 6087, 6342, 6565, 7273, 8161, 8554, 8648, 8849, 9025, 9898, 10075]","[0, 170, 260, 350, 507, 597, 687, 813, 903, 1041, 1131, 1275, 1414, 1509, 1603, 1880, 2300, 2548, 2642, 2800, 3239, 3602, 3870, 4352, 4543, 4934, 5104, 5391, 5886, 6138]",21906,15759,16104,10075,6138,4273,1528,-409,-4159,-818,415,30,radiant
7548949810,8,76,107,64,9,"[283, 572, 770, 1272, 1722, 2168, 2519, 2758, 3267, 3687, 4328, 4693, 5303, 5951, 6395, 7017, 7368, 8419, 9064, 10041, 10444, 10672, 11212, 11689, 12392, 12821, 13468, 14287, 14728, 15004]","[248, 496, 994, 1328, 1795, 2075, 2728, 3216, 3581, 3934, 4388, 5209, 5541, 6310, 6713, 7180, 7359, 7911, 8403, 9400, 10080, 10540, 11542, 12569, 13634, 13897, 14477, 15683, 16312, 16408]","[241, 825, 1153, 1488, 2018, 2226, 2396, 2725, 3019, 3390, 4036, 4356, 4884, 5424, 6042, 6684, 7214, 8243, 8856, 9259, 9938, 10070, 10656, 11133, 11871, 12119, 12422, 13427, 13957, 14259]","[170, 396, 486, 679, 850, 1029, 1119, 1964, 2104, 2306, 2533, 2770, 2911, 3262, 3564, 3778, 3943, 4372, 4865, 5195, 5595, 5842, 6257, 6734, 7104, 7283, 7785, 8038, 8292, 8388]","[170, 336, 426, 556, 646, 781, 1298, 1388, 1557, 1681, 1976, 2379, 2474, 2845, 2939, 3390, 3580, 4168, 4439, 4662, 4892, 5289, 5384, 6082, 6339, 6487, 6688, 6992, 7169, 7284]",15004,16408,14259,8388,7284,54,13,102,33,128,"[615, 811, 1059, 1470, 1671, 2221, 2646, 3142, 3587, 3808, 4149, 4780, 5305, 5554, 6272, 6850, 7358, 7494, 8528, 8855, 9482, 11187, 11824, 12391, 12558, 13335, 13930, 14650, 15509, 16761]","[284, 488, 737, 1053, 1255, 1710, 2006, 2490, 2789, 3191, 3700, 3950, 4516, 5151, 5419, 5858, 6773, 7255, 7810, 8560, 9465, 10396, 10828, 11117, 11794, 12329, 12757, 13212, 13831, 14915]","[247, 529, 809, 1164, 1402, 2029, 2594, 3206, 3503, 4152, 4774, 4864, 5391, 5910, 6471, 7113, 7421, 8398, 9376, 9848, 10226, 10847, 11322, 11523, 11895, 12342, 12946, 13439, 13902, 14580]","[170, 260, 350, 520, 610, 1054, 1234, 1723, 1896, 2330, 2743, 2833, 3190, 3560, 3811, 4133, 4436, 4793, 5176, 5346, 5663, 5968, 6343, 6805, 7171, 7777, 8371, 9132, 9338, 9912]","[283, 373, 545, 690, 784, 1117, 1297, 1477, 1651, 1949, 2439, 2613, 2809, 3083, 3241, 3443, 3995, 4090, 4337, 4570, 4907, 5355, 5550, 5877, 6298, 6703, 7001, 7927, 8462, 8894]",16761,14915,14580,9912,8894,-1757,1493,-321,-1524,-1610,-3719,30,radiant
7549153711,42,53,9,7,87,"[340, 631, 920, 1128, 1419, 1687, 2063, 2567, 3045, 3511, 4269, 4700, 5265, 6023, 6376, 7295, 8014, 8783, 10475, 11052, 12317, 13201, 14252, 15063, 16330, 17968, 19190, 20501, 22914, 24041]","[670, 1347, 1672, 2243, 2831, 3199, 3802, 4171, 4995, 5538, 6742, 7184, 7949, 8604, 9428, 10053, 10655, 11097, 11426, 12086, 12498, 12864, 13087, 13719, 14458, 15337, 16177, 16615, 17487, 18358]","[502, 654, 983, 1169, 1638, 1789, 1979, 2119, 2361, 2688, 3032, 3430, 3923, 4330, 4961, 5261, 5725, 5998, 7156, 7357, 7600, 8148, 8702, 9149, 9546, 10181, 11061, 11224, 12601, 12896]","[333, 460, 640, 863, 1296, 1506, 1599, 1689, 1896, 2416, 2637, 3077, 3564, 4098, 4543, 4753, 5266, 5462, 6182, 6377, 6780, 7124, 7294, 7776, 8440, 9022, 9945, 10116, 11170, 11435]","[578, 974, 1108, 1290, 1455, 1625, 2106, 2208, 2465, 2720, 3064, 3343, 4176, 4707, 5276, 5486, 5704, 5942, 6663, 6810, 7008, 7534, 7638, 7882, 7977, 8354, 8829, 9000, 9739, 9977]",24041,18358,12896,11435,9977,36,61,69,1,51,"[1026, 1431, 1816, 2114, 2362, 2967, 3410, 3713, 4281, 4963, 5623, 6057, 6444, 6539, 7241, 7956, 8557, 9291, 9946, 10773, 11352, 12162, 13336, 14361, 15179, 16330, 17326, 18060, 19003, 20752]","[702, 1030, 1328, 1768, 2208, 2779, 3165, 3740, 4709, 5559, 6454, 6933, 7088, 7434, 7977, 9303, 9868, 10299, 10625, 10993, 12182, 13511, 14100, 14762, 15313, 16038, 16964, 17300, 17566, 17756]","[490, 657, 933, 1063, 1605, 2452, 2772, 3217, 3856, 4427, 4805, 5526, 5760, 6339, 6972, 7542, 8012, 8701, 9255, 9735, 10253, 10756, 11481, 12305, 13439, 13694, 14628, 15320, 15576, 16450]","[322, 458, 806, 1027, 1199, 1425, 1515, 1962, 2394, 2874, 3184, 3390, 3485, 3618, 3776, 4115, 4913, 5349, 5721, 5912, 6280, 6894, 7363, 7661, 7953, 8048, 8546, 8788, 9029, 10113]","[260, 350, 488, 617, 792, 1082, 1218, 1398, 2137, 2526, 2796, 2982, 3077, 3172, 3503, 4212, 4761, 5093, 5188, 5287, 5526, 6036, 6432, 6941, 7654, 7749, 7926, 8236, 8332, 8957]",20752,17756,16450,10113,8957,3289,602,-3554,1322,1020,2679,30,dire
7549213314,48,14,105,33,84,"[0, 257, 588, 1193, 1606, 1933, 2367, 2780, 3138, 3524, 4252, 4919, 5396, 5987, 6338, 7064, 7592, 8719, 9538, 10380, 11046, 11414, 12299, 12856, 13978, 15004, 16694, 17383, 18931, 19027]","[0, 311, 641, 1033, 1320, 1704, 2185, 2518, 3009, 3516, 4270, 4414, 5266, 5802, 5897, 6903, 7371, 8296, 8883, 9200, 9840, 10565, 10877, 11539, 12255, 12953, 14875, 16512, 17218, 17314]","[0, 169, 303, 610, 700, 790, 880, 1014, 1271, 1361, 1749, 2026, 3112, 3398, 4330, 5300, 6431, 6602, 6760, 6917, 7087, 8057, 8970, 10373, 11071, 11580, 13509, 13919, 14180, 14455]","[0, 244, 540, 858, 1174, 1379, 1605, 2037, 2199, 2447, 2818, 3274, 3609, 4090, 4326, 4870, 4999, 5442, 6002, 6179, 6565, 6933, 7497, 8201, 8434, 9185, 9940, 10526, 10812, 11244]","[0, 169, 259, 496, 630, 766, 900, 1160, 1420, 1555, 1997, 2224, 2454, 2657, 2904, 3199, 3909, 4413, 4571, 4873, 5545, 6509, 6604, 7565, 7945, 8278, 9072, 9944, 10719, 11268]",19027,17314,14455,11244,11268,76,55,46,83,26,"[0, 364, 725, 1181, 1637, 2058, 2507, 3048, 3558, 4295, 4875, 5426, 5961, 6621, 7643, 8301, 9003, 9098, 9765, 10808, 11296, 13485, 15080, 16319, 16414, 17276, 18407, 19069, 21318, 21414]","[0, 329, 704, 1085, 1355, 1954, 2602, 3115, 3393, 3823, 4423, 4641, 5677, 6594, 7772, 8346, 8963, 9252, 9512, 10511, 10941, 11694, 12377, 12947, 13533, 14097, 14701, 16092, 17548, 18272]","[0, 280, 643, 1406, 1777, 2212, 2823, 3331, 4061, 4780, 5208, 5553, 5777, 6910, 7752, 7953, 8639, 9207, 9759, 10948, 11389, 12863, 13280, 14051, 14788, 15438, 15710, 16555, 16891, 17386]","[0, 169, 277, 487, 606, 947, 1130, 1238, 1461, 1747, 1853, 2072, 2474, 2761, 3281, 3375, 3533, 3721, 3861, 4495, 4685, 5144, 5665, 6377, 6826, 7485, 7853, 8345, 8516, 9315]","[0, 169, 259, 360, 450, 633, 835, 974, 1077, 1479, 1613, 1758, 2321, 2604, 2993, 3135, 3293, 3816, 3963, 4190, 4314, 5047, 5418, 5713, 6033, 6272, 6740, 7325, 7421, 7702]",21414,18272,17386,9315,7702,-2387,-958,-2931,1929,3566,-781,30,radiant
7549256701,36,120,28,83,121,"[0, 331, 658, 1074, 1415, 1660, 2150, 2493, 3183, 3397, 3952, 4394, 4745, 5230, 5775, 6051, 6590, 7396, 8098, 8681, 9894, 10184, 10507, 11033, 11241, 12047, 13843, 14557, 15058, 16434]","[0, 322, 730, 1097, 1437, 1685, 1894, 2265, 2614, 3435, 3840, 4412, 5009, 5742, 6277, 6444, 7150, 7780, 8107, 8450, 9151, 9674, 9997, 10336, 10903, 11718, 12600, 13279, 13375, 15838]","[0, 335, 499, 627, 952, 1261, 1691, 2059, 2451, 2721, 3201, 3877, 4342, 5105, 5527, 5694, 6211, 6909, 7434, 7815, 8605, 8764, 9422, 9681, 10946, 11489, 12380, 12982, 13650, 13927]","[0, 210, 405, 541, 631, 937, 1075, 1165, 1345, 1589, 2043, 2133, 2387, 2668, 2985, 3360, 3454, 3639, 3734, 4084, 4546, 4690, 5234, 5606, 6192, 6631, 6726, 6858, 7081, 8571]","[0, 210, 345, 435, 922, 1118, 1208, 1342, 1522, 1917, 2214, 2304, 2438, 2725, 3282, 3622, 3793, 3978, 4109, 4311, 4797, 4892, 5215, 5309, 5530, 5769, 6069, 6218, 6954, 7480]",16434,15838,13927,8571,7480,95,74,60,112,26,"[0, 255, 585, 913, 1305, 1694, 1979, 2573, 2927, 3262, 4012, 4433, 5117, 5855, 6449, 7606, 8280, 9172, 9777, 10500, 11258, 12606, 14690, 15354, 15912, 16806, 17760, 19334, 20341, 20763]","[0, 216, 458, 836, 1213, 1613, 2022, 2355, 2647, 2762, 3001, 3525, 4154, 4496, 5066, 6120, 6681, 7278, 7853, 8353, 8883, 9187, 10730, 11897, 12758, 13714, 14304, 14508, 14659, 14882]","[0, 178, 378, 662, 859, 1034, 1161, 1624, 2089, 2522, 3052, 3611, 3982, 4491, 4892, 5107, 5586, 6029, 6743, 7264, 7609, 7943, 8259, 8799, 9369, 9872, 10223, 10845, 11737, 11962]","[0, 130, 264, 354, 444, 534, 629, 854, 1006, 1096, 1556, 1734, 1978, 2127, 2435, 2831, 3193, 3856, 4404, 4871, 5028, 5575, 6510, 7019, 7738, 8204, 8406, 8826, 9174, 9396]","[0, 130, 220, 310, 400, 538, 628, 808, 898, 998, 1346, 1436, 1670, 1853, 2184, 2740, 3057, 3351, 3851, 4431, 4667, 4981, 5919, 6448, 6887, 7359, 7730, 8241, 8556, 9166]",20763,14882,11962,9396,9166,-4329,956,1965,-825,-1686,-3919,30,radiant
7549265807,28,92,21,51,5,"[0, 210, 668, 1005, 1326, 1719, 2032, 2615, 2982, 3523, 3854, 4212, 4933, 5534, 6102, 6604, 7296, 7881, 8450, 9011, 9342, 9629, 10608, 10904, 11917, 12340, 13490, 14376, 15156, 15919]","[0, 364, 682, 924, 1257, 1548, 1840, 2157, 2498, 3043, 3611, 4092, 4786, 5427, 5909, 6593, 6857, 7454, 8142, 9130, 9809, 10348, 11109, 11296, 11926, 13032, 13627, 14445, 15376, 15633]","[0, 360, 633, 912, 1134, 1632, 1968, 2459, 2986, 3307, 3877, 4385, 4815, 5611, 6033, 6514, 7123, 8048, 8635, 9665, 9960, 10174, 10773, 10903, 11938, 12778, 13395, 13939, 14668, 15244]","[0, 210, 300, 429, 519, 879, 1052, 1187, 1277, 1491, 1740, 1889, 2374, 2750, 3165, 3433, 3776, 3961, 4314, 4770, 4876, 5043, 5310, 5471, 5595, 5850, 6026, 6233, 6497, 6995]","[0, 210, 300, 454, 544, 674, 886, 1021, 1129, 1491, 1758, 2028, 2216, 2521, 2805, 3665, 3850, 4072, 4491, 5069, 5341, 5552, 5814, 5909, 6399, 6689, 6865, 7034, 7324, 7708]",15919,15633,15244,6995,7708,10,106,69,123,110,"[0, 169, 496, 817, 1133, 1378, 1867, 2391, 2833, 3299, 3820, 4314, 4894, 5386, 5886, 6600, 7036, 7637, 8460, 9290, 10240, 11483, 12441, 12698, 13282, 14290, 15139, 16166, 17001, 17964]","[0, 257, 559, 886, 1139, 1380, 1676, 1905, 2457, 2602, 2868, 3182, 3445, 3984, 4652, 4918, 5196, 5931, 6205, 6935, 7271, 8295, 8717, 9325, 9554, 10197, 10718, 11492, 12216, 12897]","[0, 205, 332, 529, 804, 1168, 1758, 2233, 2541, 2887, 3367, 3934, 4428, 4826, 5257, 6018, 6414, 7061, 7566, 7904, 8293, 9178, 9985, 10290, 10804, 11261, 11592, 12326, 12940, 13461]","[0, 178, 307, 469, 908, 1024, 1277, 1412, 1502, 1646, 1970, 2287, 2585, 2987, 3140, 3325, 3419, 3810, 4128, 4331, 4425, 4923, 5536, 5631, 6088, 6382, 6477, 6681, 6969, 7279]","[0, 174, 264, 414, 737, 870, 1101, 1308, 1482, 1621, 1796, 2180, 2402, 2741, 2957, 3142, 3345, 3618, 4011, 4262, 4477, 5198, 5556, 5651, 5914, 6113, 6208, 6491, 6779, 7199]",17964,12897,13461,7279,7199,-2045,2736,1783,-284,509,2699,30,radiant
7549276501,90,114,84,71,26,"[0, 279, 576, 854, 1273, 1812, 2223, 2642, 3196, 3834, 4574, 5700, 6203, 6778, 7411, 7848, 9049, 9998, 10683, 12004, 13204, 13455, 14229, 14826, 15555, 17754, 18279, 18965, 19986, 20553]","[0, 320, 598, 975, 1417, 1791, 2048, 2174, 2813, 3199, 3730, 4038, 4856, 5350, 5903, 6358, 6976, 7778, 8236, 8617, 9614, 10491, 11374, 12293, 12984, 14636, 14931, 15669, 16631, 17003]","[0, 508, 598, 734, 871, 1212, 1302, 1392, 1626, 1761, 2108, 2198, 2559, 3152, 3358, 3907, 4299, 4457, 4947, 5491, 6276, 6702, 7486, 7727, 7894, 8956, 9051, 9863, 10119, 10215]","[0, 207, 512, 720, 886, 1179, 1563, 1688, 2203, 2356, 2485, 2820, 3121, 3438, 3863, 4532, 4979, 5137, 5430, 5914, 6748, 7156, 7491, 7876, 8043, 8940, 9344, 9438, 9534, 9746]","[0, 255, 607, 794, 955, 1093, 1183, 1273, 1593, 1683, 1773, 2100, 2426, 2799, 3158, 3608, 4218, 4547, 5099, 5672, 6330, 6751, 7298, 7392, 7591, 7872, 8209, 8633, 9120, 9589]",20553,17003,10215,9746,9589,13,54,40,83,86,"[0, 360, 689, 1147, 1605, 2133, 2623, 3317, 3972, 4570, 5210, 5871, 6505, 7214, 7436, 7689, 7821, 9024, 9209, 9532, 9795, 11182, 12046, 13301, 13730, 14952, 15047, 15924, 16930, 19221]","[0, 297, 566, 893, 1256, 1575, 1941, 2879, 3304, 3769, 4318, 4810, 5299, 6409, 7494, 8138, 8779, 9614, 10055, 10841, 11506, 11854, 12376, 13351, 14177, 15352, 15933, 16531, 17369, 17465]","[0, 280, 697, 1135, 1423, 1693, 2048, 2563, 3066, 3505, 3873, 4324, 4617, 5215, 5790, 6265, 6463, 6942, 7721, 8446, 9185, 9462, 9912, 10727, 10822, 11709, 12518, 13304, 13981, 14860]","[0, 170, 260, 387, 477, 567, 702, 1082, 1262, 1643, 1876, 1966, 2099, 2451, 2776, 3297, 3650, 4152, 4247, 4621, 4884, 5315, 5721, 6282, 6654, 7270, 7701, 8310, 8568, 9315]","[0, 170, 260, 399, 526, 918, 1008, 1478, 1960, 2129, 2318, 2408, 2498, 2854, 2949, 3545, 3724, 4063, 4158, 4315, 4578, 4677, 5188, 5482, 5845, 6461, 6556, 6960, 7218, 7389]",19221,17465,14860,9315,7389,1332,-462,-4645,431,2200,-1144,30,dire
7549277311,46,19,69,102,121,"[0, 308, 609, 959, 1426, 1780, 2232, 2668, 3226, 3717, 4497, 4972, 5753, 6370, 7193, 7687, 8314, 8828, 9545, 10058, 10570, 10927, 12505, 13724, 14459, 15597, 16511, 17172, 17940, 18688]","[0, 154, 493, 1326, 1842, 2125, 2540, 3028, 3396, 3858, 4240, 4330, 5083, 5603, 6347, 6543, 6872, 7766, 7909, 8198, 8680, 9107, 10683, 11268, 11742, 12280, 12652, 12923, 13921, 14017]","[0, 154, 382, 809, 1139, 1423, 1533, 1834, 2333, 2648, 2988, 3987, 4606, 5268, 5909, 6229, 6603, 7073, 8022, 8139, 8369, 8890, 10089, 10590, 11106, 11516, 11959, 12450, 12953, 13390]","[0, 154, 292, 412, 619, 841, 931, 1111, 1295, 1385, 1555, 1768, 2321, 2587, 2971, 3395, 3538, 3723, 4412, 4682, 4912, 5007, 5381, 5783, 5878, 6313, 6715, 6856, 7089, 7185]","[0, 189, 279, 447, 703, 833, 923, 1227, 1361, 1451, 1541, 1902, 2447, 2643, 2936, 3030, 3125, 3474, 3948, 4043, 4273, 4528, 5586, 5753, 5848, 6235, 6670, 6825, 7002, 7098]",18688,14017,13390,7185,7098,82,13,129,90,20,"[0, 245, 599, 1151, 1415, 1766, 2203, 3183, 3757, 4531, 5190, 5721, 5811, 6235, 6833, 7965, 8991, 10039, 10992, 11329, 12883, 14070, 14327, 15472, 16661, 17756, 18764, 19567, 20357, 21309]","[0, 288, 550, 808, 1238, 1456, 1742, 2244, 2706, 3152, 3610, 4039, 4627, 5205, 5928, 6235, 7246, 7741, 8124, 8897, 9473, 9984, 10869, 11817, 12745, 13482, 14485, 14947, 15842, 16958]","[0, 243, 538, 829, 1107, 1561, 1821, 2352, 2724, 3141, 3597, 3966, 4226, 4823, 5378, 5628, 6104, 6830, 7416, 8332, 9012, 9444, 9818, 10104, 10779, 11284, 11795, 12328, 12757, 13041]","[0, 257, 407, 522, 612, 749, 892, 1027, 1117, 1232, 1546, 1934, 2246, 2789, 2884, 3154, 3819, 4460, 5098, 6179, 7213, 7308, 7474, 7619, 8064, 8519, 9114, 9659, 10199, 10439]","[0, 253, 368, 579, 669, 806, 927, 1171, 1403, 1493, 1967, 2295, 2385, 2625, 2877, 3016, 3511, 3696, 3906, 4108, 4628, 4950, 5116, 5295, 5500, 5717, 5926, 6128, 6372, 6662]",21309,16958,13041,10439,6662,-2621,-2941,349,-3254,436,-8031,30,dire
7549315406,78,74,67,58,20,"[81, 287, 569, 1014, 1485, 1919, 2261, 2859, 3350, 4048, 4555, 5236, 5538, 5930, 6635, 7254, 7595, 8114, 8725, 9276, 10242, 10933, 11948, 12550, 13400, 14066, 14803, 15510, 16544, 17036]","[81, 210, 509, 755, 1063, 1365, 1635, 1770, 2237, 2583, 3009, 3394, 3520, 3920, 4979, 5387, 5614, 6282, 6937, 7346, 7980, 8371, 8995, 9514, 10101, 10650, 11590, 12385, 13701, 13996]","[81, 171, 442, 571, 904, 1076, 1241, 1733, 2180, 2449, 2824, 3180, 3484, 4210, 4816, 5265, 5795, 6552, 7081, 7615, 8158, 8597, 8853, 9143, 10077, 10551, 11347, 11552, 12302, 12990]","[81, 171, 261, 396, 486, 879, 1015, 1166, 1627, 1938, 2028, 2487, 2642, 3021, 3494, 3783, 4069, 4464, 4708, 5336, 5577, 5826, 5977, 6381, 6917, 7360, 7938, 8472, 9058, 9422]","[81, 171, 261, 351, 441, 531, 621, 846, 1457, 2049, 2438, 2711, 2846, 3186, 3598, 3783, 4337, 4578, 4673, 4984, 5115, 5372, 5576, 5885, 6348, 6555, 7002, 7628, 8471, 8777]",17036,13996,12990,9422,8777,80,92,21,100,103,"[1, 171, 490, 1461, 1945, 2437, 2870, 3152, 3572, 3982, 4549, 5056, 5289, 6519, 6906, 7443, 8779, 9478, 10076, 10527, 11392, 12469, 13119, 13582, 14946, 15451, 16053, 16740, 16888, 17165]","[1, 243, 445, 815, 1137, 1379, 1781, 2143, 2702, 3257, 3840, 4521, 5099, 6018, 6633, 7138, 7638, 8085, 8779, 9115, 9744, 10444, 10969, 11389, 12576, 13057, 13796, 14887, 15028, 15390]","[1, 247, 462, 902, 1133, 1302, 1585, 1868, 2295, 2601, 3308, 3744, 4650, 5410, 5559, 6130, 6820, 7520, 7833, 8317, 8632, 9212, 9539, 9877, 11602, 11973, 12217, 12697, 12793, 12889]","[1, 222, 312, 618, 807, 998, 1322, 1412, 1547, 2405, 2631, 3066, 3233, 3597, 3855, 3950, 4489, 4856, 5203, 5347, 5566, 6038, 6205, 6410, 7437, 7982, 8077, 8817, 9121, 9396]","[1, 171, 297, 434, 564, 694, 784, 874, 1009, 1315, 1621, 1788, 1956, 2531, 2680, 2883, 3305, 3463, 3693, 3896, 4167, 4520, 4687, 4892, 5218, 5629, 5724, 6598, 6733, 6829]",17165,15390,12889,9396,6829,-129,-1394,101,26,1948,552,30,radiant
7549377918,73,35,129,105,112,"[403, 582, 910, 1269, 1573, 1984, 2326, 2977, 4010, 4862, 5848, 6767, 7764, 8934, 10050, 11218, 12421, 13528, 13904, 15317, 16152, 17334, 18313, 19143, 20159, 21524, 22866, 24419, 25155, 26038]","[337, 948, 1313, 1764, 2261, 2817, 3265, 3807, 4224, 4833, 5546, 5984, 6460, 7167, 7739, 8835, 9543, 10082, 10710, 11034, 11456, 12524, 13307, 14309, 15133, 16485, 17025, 17840, 18463, 19267]","[295, 697, 935, 1182, 1466, 1701, 2218, 2439, 2704, 3437, 4006, 4565, 5018, 5467, 5774, 5982, 6739, 7226, 8041, 9028, 9860, 11026, 11200, 11837, 12491, 12853, 13985, 14345, 14825, 15277]","[209, 299, 523, 613, 868, 958, 1048, 1310, 1818, 2260, 2759, 3358, 3768, 4209, 4831, 5177, 5419, 6048, 6278, 6684, 7409, 7732, 8725, 8985, 9587, 9965, 10339, 10828, 11362, 11901]","[209, 349, 517, 654, 791, 925, 1062, 1277, 1555, 1827, 2013, 2193, 2422, 2606, 2863, 3301, 3486, 3649, 3879, 4351, 4574, 4850, 5135, 5479, 5700, 6435, 6530, 6890, 7121, 7437]",26038,19267,15277,11901,7437,47,54,96,58,26,"[211, 459, 814, 1111, 1424, 1678, 2181, 2941, 3271, 3722, 4366, 4799, 5328, 5989, 6309, 7200, 7875, 8180, 8705, 9313, 9494, 10114, 11070, 12285, 12641, 13510, 14134, 15306, 16390, 17080]","[163, 473, 637, 1255, 1619, 1991, 2454, 2914, 3316, 3788, 4166, 4789, 5262, 5784, 6317, 6771, 7273, 7651, 8418, 8734, 9247, 9868, 10677, 11346, 11830, 13017, 13217, 13851, 14446, 15037]","[201, 440, 799, 1213, 1584, 1992, 2552, 2799, 3251, 3698, 4165, 4534, 4928, 5454, 5683, 6106, 7100, 7231, 7889, 8423, 8518, 8934, 9757, 10643, 11239, 12166, 12451, 13102, 13668, 13869]","[129, 219, 309, 499, 677, 809, 1051, 1315, 1452, 1587, 1727, 1943, 2332, 2689, 2990, 3148, 3793, 4165, 4792, 5173, 5619, 6170, 6434, 6667, 6816, 7279, 7645, 8284, 8714, 9065]","[180, 309, 399, 529, 697, 908, 1171, 1371, 1509, 1665, 1878, 2105, 2456, 2634, 2731, 3052, 3251, 3345, 4007, 4267, 4362, 4528, 4761, 4971, 5066, 5543, 5674, 5851, 5947, 6263]",17080,15037,13869,9065,6263,8958,4230,1408,2836,1174,18606,30,radiant
7549801106,106,21,88,128,26,"[543, 920, 1241, 1568, 1968, 2458, 3042, 3643, 4307, 4737, 5213, 5933, 6645, 7051, 7790, 8700, 9153, 9686, 10589, 11556, 12196, 12795, 13436, 14458, 15392, 15709, 16387, 17617, 18292, 19026]","[654, 871, 1274, 1673, 2010, 2405, 2847, 3163, 3427, 3691, 3824, 4341, 4896, 5544, 6201, 6415, 6786, 7467, 7834, 8514, 9269, 9851, 10755, 11544, 12041, 12589, 13062, 13499, 14544, 15197]","[497, 1239, 1865, 2268, 2567, 2902, 3267, 3752, 4281, 4559, 4702, 5520, 6340, 6657, 7113, 7532, 7743, 7965, 8811, 9390, 9556, 9815, 10000, 10635, 11103, 11270, 11800, 12381, 12867, 13214]","[266, 420, 628, 850, 1030, 1212, 1302, 1551, 2016, 2311, 2491, 3639, 3920, 4140, 4389, 4571, 5061, 5639, 5734, 6391, 6808, 6998, 7468, 7960, 8277, 8507, 8837, 9337, 9813, 10659]","[240, 330, 487, 651, 886, 1021, 1111, 1371, 1576, 1683, 1822, 2441, 2536, 2720, 3012, 3194, 3288, 3565, 3660, 4215, 4592, 5155, 5390, 5706, 6074, 6431, 6838, 7399, 7495, 8058]",19026,15197,13214,10659,8058,41,77,74,119,110,"[487, 797, 965, 1292, 1825, 2224, 2518, 2999, 3330, 3797, 4416, 5021, 5605, 6122, 6951, 7551, 9363, 10375, 10868, 11392, 12054, 12787, 13575, 14362, 15231, 15986, 16609, 17228, 17801, 18903]","[603, 845, 1135, 1452, 1711, 2421, 2695, 3123, 3591, 3999, 4279, 4726, 5148, 6103, 6661, 7524, 8632, 9428, 9914, 10154, 10729, 11280, 12170, 12795, 13398, 14020, 14693, 15016, 15503, 16891]","[547, 926, 1243, 1579, 2024, 2317, 2577, 2667, 3228, 3592, 4046, 4141, 5002, 5671, 6156, 6764, 7206, 7967, 8062, 8227, 8685, 8954, 9372, 9957, 10763, 11293, 11679, 12155, 12806, 13591]","[299, 389, 479, 569, 659, 889, 979, 1622, 1712, 2151, 2295, 2426, 2643, 2999, 3220, 3836, 4655, 4993, 5143, 5312, 5553, 5858, 6228, 6632, 6963, 7238, 7538, 7709, 8234, 8960]","[299, 389, 479, 569, 708, 890, 997, 1319, 1474, 1652, 1940, 2220, 2528, 2712, 3096, 3322, 4087, 4452, 4547, 5056, 5222, 5506, 5874, 6153, 6480, 6845, 7022, 7118, 7635, 8390]",18903,16891,13591,8960,8390,123,-1694,-377,1699,-332,-581,30,dire
7549846718,19,93,69,45,121,"[0, 359, 700, 1097, 1508, 1795, 2223, 2921, 3339, 4016, 4344, 4586, 5409, 5905, 6077, 6725, 7393, 7534, 8018, 8457, 8663, 9110, 9621, 10286, 10862, 11533, 11918, 12824, 13434, 13587]","[0, 204, 560, 924, 1175, 1389, 1680, 1924, 2184, 2566, 3065, 3751, 4131, 5054, 5432, 5938, 6673, 7199, 7688, 8516, 9075, 9642, 9737, 10243, 11185, 12012, 12840, 13224, 13496, 13706]","[0, 208, 375, 684, 895, 1207, 1612, 1936, 2425, 2705, 3236, 3722, 4346, 5029, 5201, 5471, 5949, 6554, 6960, 7802, 8278, 8827, 9082, 9841, 10161, 10635, 11090, 11780, 12134, 12230]","[0, 269, 405, 540, 718, 808, 1249, 1386, 1601, 1844, 2135, 2426, 2844, 3482, 3982, 4076, 4655, 4803, 5389, 5911, 6006, 6586, 6811, 7081, 7176, 7399, 7694, 7995, 8147, 8410]","[0, 218, 355, 567, 657, 794, 976, 1277, 1367, 1536, 1992, 2136, 2531, 2871, 3090, 3312, 3605, 3700, 3961, 4448, 4543, 4748, 4843, 5326, 5480, 5722, 6345, 6515, 6686, 6857]",13587,13706,12230,8410,6857,25,22,49,123,30,"[0, 280, 997, 1306, 1648, 1979, 2398, 2953, 3253, 3727, 3969, 4491, 4914, 5451, 6441, 6845, 7456, 8221, 8384, 9229, 10120, 10864, 11131, 11663, 12008, 12731, 13449, 14533, 15516, 16883]","[0, 241, 578, 964, 1375, 1788, 2276, 2696, 3065, 3915, 4139, 4827, 5130, 5562, 6485, 6832, 7334, 8064, 8383, 9333, 10176, 10752, 11125, 11724, 12538, 13440, 13730, 14355, 15072, 15678]","[0, 239, 509, 825, 1141, 1685, 2066, 2560, 3129, 3755, 4096, 4384, 4712, 5109, 5576, 5729, 6549, 6987, 7343, 7734, 8221, 8574, 9365, 11037, 11511, 12011, 12393, 12678, 13212, 13977]","[0, 169, 259, 349, 553, 996, 1086, 1266, 1356, 1611, 1766, 2215, 2667, 2762, 3152, 3283, 3776, 4116, 4523, 4904, 5232, 5618, 5713, 6935, 7507, 8010, 8337, 8576, 9189, 9825]","[0, 169, 546, 636, 775, 905, 1041, 1221, 1311, 1566, 1701, 2009, 2144, 2287, 2594, 2971, 3297, 3661, 3756, 4085, 4243, 4448, 4543, 4903, 5195, 5595, 5965, 6170, 6428, 6862]",16883,15678,13977,9825,6862,-3296,-1972,-1747,-1415,-5,-8435,30,dire
7549866219,19,128,69,51,79,"[0, 203, 487, 749, 1082, 1333, 1724, 2226, 2635, 3375, 3738, 4806, 5342, 6128, 6683, 7251, 8366, 9043, 9138, 9944, 10288, 10802, 12246, 13174, 13668, 14369, 14534, 15418, 15968, 16401]","[0, 239, 520, 1076, 1367, 1590, 1862, 2392, 2775, 3321, 3752, 4421, 5060, 5495, 6462, 7148, 7799, 8807, 9119, 9768, 10339, 11100, 11386, 12475, 12795, 13141, 13898, 14595, 15323, 15827]","[0, 253, 774, 1206, 1647, 1988, 2664, 3410, 4188, 4698, 5476, 6319, 7143, 7750, 8256, 8687, 9105, 9854, 10419, 11174, 11854, 12409, 13682, 14182, 14527, 14913, 15624, 16329, 16838, 18727]","[0, 202, 310, 734, 938, 1028, 1192, 1484, 1907, 2267, 2562, 2973, 3293, 3874, 4403, 4497, 4829, 5362, 5457, 5869, 6059, 6330, 7009, 7513, 7683, 8058, 8227, 8924, 9413, 9930]","[0, 169, 617, 1095, 1185, 1552, 1716, 2346, 2819, 2983, 3211, 3757, 4121, 4469, 4716, 4982, 5215, 5545, 5640, 6513, 6708, 6875, 7440, 7678, 7773, 8111, 8316, 8792, 9091, 9671]",16401,15827,18727,9930,9671,12,25,45,38,121,"[0, 358, 817, 907, 1285, 1632, 2372, 2576, 3151, 3640, 3959, 4414, 4897, 5221, 5580, 5938, 6587, 7132, 8703, 9223, 10207, 10850, 11017, 11697, 13008, 14158, 14554, 15357, 16086, 16774]","[0, 349, 718, 1047, 1455, 1905, 2378, 2859, 3258, 3676, 4285, 5061, 5151, 5474, 5959, 6380, 6835, 7020, 8042, 8833, 10000, 10215, 10809, 11501, 12335, 13070, 14536, 15311, 16116, 16340]","[0, 422, 512, 715, 853, 986, 1215, 1579, 1769, 1960, 2233, 2436, 2526, 3067, 3626, 4028, 4471, 5253, 6251, 6345, 7096, 7282, 7433, 7837, 8474, 8991, 9314, 9717, 10281, 10699]","[0, 323, 522, 886, 1174, 1410, 1902, 2148, 2506, 2647, 3125, 3475, 3604, 4075, 4676, 4818, 4976, 5434, 6535, 6708, 6991, 7314, 8548, 8848, 9459, 10402, 10925, 11677, 11977, 12453]","[0, 553, 770, 910, 1092, 1202, 1443, 1773, 1908, 1998, 2191, 2394, 2652, 2837, 3086, 3248, 3431, 3616, 4173, 4283, 4604, 4699, 4794, 5109, 5637, 6167, 6396, 6691, 6912, 7135]",16774,16340,10699,12453,7135,-373,-513,8028,-2523,2536,7155,30,dire
7550266815,46,93,96,105,83,"[243, 606, 958, 1360, 1743, 2277, 2670, 3122, 3451, 4080, 4424, 5142, 6001, 6720, 7024, 7825, 8593, 9240, 9700, 10590, 11832, 12499, 13117, 14008, 14817, 16057, 16682, 17724, 18428, 19520]","[285, 589, 927, 1267, 1590, 2083, 2549, 2961, 3601, 4089, 4576, 5141, 6247, 6755, 6903, 7421, 8399, 8860, 9608, 10198, 10650, 11501, 12134, 12605, 13436, 14014, 14386, 15184, 16034, 16489]","[287, 495, 820, 1103, 1425, 2172, 2262, 2864, 3239, 3901, 4490, 5018, 5717, 6159, 6534, 6989, 7413, 7909, 9051, 9305, 9690, 10652, 11531, 12223, 12783, 13687, 14540, 15132, 15715, 16209]","[169, 259, 349, 483, 926, 1152, 1320, 1495, 1630, 2104, 2323, 2541, 2780, 2964, 3195, 4047, 4646, 5314, 5635, 6114, 6740, 6979, 7437, 7749, 7979, 8435, 8847, 9186, 9449, 9553]","[269, 359, 548, 674, 784, 919, 1009, 1401, 1581, 1884, 2064, 2154, 2497, 2708, 2904, 3541, 3864, 3959, 4643, 4997, 5274, 5691, 6468, 6848, 7113, 7579, 7779, 8174, 8380, 8476]",19520,16489,16209,9553,8476,15,41,13,53,19,"[203, 440, 756, 891, 1285, 1702, 2151, 2449, 2836, 3260, 3828, 4150, 4800, 5537, 6466, 6968, 7481, 8006, 8367, 8711, 9318, 10014, 10502, 10636, 11005, 11660, 12611, 13121, 13764, 14277]","[331, 533, 839, 1230, 1667, 1957, 2554, 2821, 3091, 3560, 4155, 4425, 4735, 5344, 6084, 6662, 7022, 7483, 8309, 8919, 9900, 10662, 11054, 11517, 12126, 13028, 13831, 14585, 14880, 15240]","[239, 488, 810, 1095, 1410, 1710, 2281, 2533, 2835, 3017, 3890, 4217, 4807, 5313, 6397, 6760, 7421, 7731, 8685, 9190, 9702, 10479, 11011, 11362, 12177, 13312, 14034, 14654, 15134, 15754]","[169, 259, 425, 562, 736, 965, 1322, 1412, 1541, 1795, 2191, 2499, 3084, 3445, 3985, 4143, 4496, 4693, 4912, 5007, 5268, 5671, 6152, 6351, 6686, 6971, 7304, 7643, 8214, 8457]","[169, 338, 543, 683, 920, 1055, 1280, 1459, 1549, 1664, 2060, 2150, 2476, 2877, 3348, 3593, 3851, 4194, 4838, 5019, 5114, 5281, 5561, 5771, 6210, 6394, 6525, 6751, 6872, 7182]",14277,15240,15754,8457,7182,5243,1249,455,1096,1294,9337,30,radiant
7550292203,13,41,43,100,75,"[0, 243, 601, 1021, 1383, 1826, 2350, 3026, 3540, 3993, 4625, 5314, 5859, 6177, 6738, 6994, 7486, 8160, 8619, 8902, 9682, 9849, 11013, 11466, 12324, 12588, 13473, 14216, 15060, 15846]","[0, 251, 497, 929, 1293, 1859, 2221, 2489, 2649, 3083, 3621, 4239, 4836, 5484, 5930, 6636, 7321, 7686, 8451, 9088, 10248, 10878, 12139, 13704, 14318, 14962, 15613, 16407, 17112, 17823]","[4, 264, 475, 792, 1103, 1513, 1942, 2580, 3678, 4123, 4528, 5213, 5585, 6210, 6611, 7049, 7900, 8309, 8916, 9473, 10212, 10768, 12265, 13031, 13541, 14042, 14569, 14904, 15048, 15682]","[0, 172, 266, 356, 701, 831, 1513, 1648, 1971, 2061, 2287, 2601, 3186, 3598, 4121, 4216, 4441, 4766, 4911, 5061, 5574, 5935, 6588, 7205, 7727, 8032, 8438, 8954, 9309, 9525]","[0, 170, 260, 488, 622, 837, 1371, 1583, 1907, 2066, 2341, 2877, 3106, 3344, 3638, 3975, 4353, 4511, 4606, 4996, 5622, 6169, 6970, 7487, 7748, 8234, 8439, 8725, 8867, 9015]",15846,17823,15682,9525,9015,89,90,129,110,123,"[58, 263, 539, 824, 1015, 1414, 1879, 2314, 2678, 3057, 3599, 4101, 4832, 5225, 5487, 6220, 6884, 7877, 8829, 9387, 10215, 11648, 12161, 12799, 13139, 14490, 15275, 15879, 17005, 18624]","[58, 468, 632, 1005, 1355, 1823, 2661, 3109, 3537, 3943, 4537, 4934, 5123, 5706, 6268, 7072, 7563, 8348, 9024, 9446, 9772, 10290, 10475, 10840, 11134, 11541, 12700, 12917, 13374, 14379]","[58, 313, 802, 1242, 1499, 1957, 2348, 2714, 3317, 3652, 3968, 4321, 4990, 5496, 5885, 6363, 6457, 6835, 7195, 7618, 7847, 8928, 9113, 9515, 10213, 10380, 11021, 11479, 12107, 12474]","[326, 496, 586, 723, 847, 982, 1163, 1310, 1577, 1744, 1934, 2273, 2476, 2746, 2979, 3525, 3653, 4240, 4809, 5250, 5538, 6233, 6493, 6961, 7621, 7960, 8476, 8646, 9016, 9302]","[58, 228, 381, 535, 625, 715, 943, 1159, 1434, 1524, 1832, 1982, 2220, 2512, 2924, 3176, 3289, 3864, 4181, 4742, 5082, 5419, 5604, 5749, 6090, 6360, 7137, 7839, 8579, 8914]",18624,14379,12474,9302,8914,-2778,3444,3208,223,101,4198,30,radiant
7550369811,10,17,29,110,123,"[671, 1378, 1840, 2098, 2428, 2884, 3056, 3396, 3729, 4309, 4694, 5641, 6123, 6437, 6963, 7794, 8338, 9622, 10419, 11198, 11867, 12991, 13606, 14540, 15546, 16440, 17203, 18669, 19039, 20012]","[560, 945, 1324, 1731, 2094, 2569, 2973, 3514, 4253, 4596, 4704, 5623, 5972, 6450, 7418, 8029, 8568, 9194, 9822, 10276, 10637, 11354, 11985, 12152, 12907, 14078, 14449, 15260, 15830, 16503]","[473, 883, 1086, 1211, 1475, 1865, 2081, 2409, 2920, 3304, 3757, 4269, 4875, 5266, 5538, 6704, 7512, 8071, 8750, 9190, 9826, 10293, 10886, 11466, 11815, 12191, 12639, 12735, 13143, 13840]","[284, 478, 701, 896, 986, 1169, 1358, 1557, 1948, 2076, 2295, 2715, 2810, 3389, 3571, 3970, 4592, 4827, 5115, 5255, 5511, 5965, 6060, 6227, 7098, 7510, 7937, 8373, 8971, 9071]","[319, 663, 793, 883, 1093, 1679, 2062, 2152, 2609, 2699, 2789, 3529, 3811, 4234, 4588, 5092, 5307, 5831, 6084, 6179, 6483, 6823, 7241, 7441, 8188, 8570, 8795, 8891, 9078, 9711]",20012,16503,13840,9071,9711,25,78,19,128,20,"[577, 938, 1376, 1930, 2671, 3323, 3972, 4220, 4704, 5116, 5705, 5800, 6706, 8631, 9213, 9862, 10672, 11409, 12206, 12948, 13645, 14450, 15462, 16618, 17565, 18351, 19725, 20787, 21519, 22429]","[606, 883, 1242, 1590, 1960, 2229, 2728, 3281, 3636, 4089, 4252, 4761, 5514, 6344, 7150, 7647, 8275, 8612, 8707, 9223, 9852, 10427, 10983, 11263, 11714, 12106, 12740, 13543, 14201, 15067]","[564, 806, 1133, 1469, 1814, 2076, 2369, 2992, 3583, 3932, 4248, 4541, 5068, 6115, 6654, 7106, 7772, 7930, 8396, 8728, 9334, 9888, 10462, 10673, 10826, 11486, 11902, 12799, 13239, 14355]","[259, 401, 714, 850, 985, 1170, 1830, 2337, 2764, 3265, 3747, 3903, 4188, 4464, 4777, 5093, 5187, 5629, 5855, 6069, 6298, 6535, 6870, 7125, 7321, 7768, 8474, 8837, 8933, 9358]","[294, 384, 520, 768, 1068, 1203, 1487, 1665, 1901, 2110, 2270, 2365, 2699, 3107, 3498, 3656, 3877, 4035, 4326, 4421, 4650, 4745, 4924, 5019, 5181, 5357, 6191, 6710, 6906, 7327]",22429,15067,14355,9358,7327,-2417,1436,-515,-287,2384,601,30,radiant
7550382805,48,106,80,123,20,"[869, 1203, 1697, 2055, 2444, 2803, 3217, 3385, 4166, 4759, 5598, 6305, 6818, 7684, 8366, 9177, 10060, 10913, 11870, 12760, 13495, 14231, 15167, 15893, 16976, 17903, 18681, 19998, 21605, 22073]","[922, 1264, 1508, 1891, 2432, 2890, 3224, 3650, 4197, 4402, 4892, 5324, 5650, 6279, 7065, 7753, 8211, 8575, 8843, 9188, 9652, 10575, 10831, 11141, 11647, 11743, 12609, 13135, 13762, 13896]","[888, 1178, 1505, 1628, 1991, 2655, 3032, 3603, 3842, 4282, 4776, 5005, 5379, 5667, 5913, 6378, 6915, 7413, 7976, 8604, 9244, 9570, 10206, 10738, 11475, 11617, 11867, 12190, 12776, 12951]","[479, 585, 803, 974, 1245, 1422, 1557, 1748, 1901, 2076, 2485, 2716, 2811, 3209, 3598, 3693, 3946, 4290, 4474, 4643, 5328, 5737, 5993, 6424, 7121, 7290, 7980, 8166, 8573, 8673]","[547, 779, 1033, 1162, 1252, 1462, 1597, 1954, 2044, 2187, 2585, 2963, 3086, 3333, 3458, 3553, 3709, 4019, 4497, 4592, 4712, 5038, 5328, 5472, 6269, 6414, 6856, 7042, 7403, 7503]",22073,13896,12951,8673,7503,46,63,33,136,83,"[800, 1127, 1464, 1986, 2473, 3102, 3775, 4386, 5212, 6033, 6769, 7763, 8279, 9216, 10344, 11391, 12550, 13508, 14747, 15561, 17206, 17731, 18764, 19649, 20217, 21105, 21505, 22344, 23341, 24457]","[799, 1253, 1468, 2101, 2489, 2891, 3295, 3556, 3831, 4812, 5330, 6401, 6859, 7544, 8091, 8883, 9612, 10171, 10694, 11807, 13009, 13627, 14162, 14798, 15525, 16387, 16973, 18029, 18890, 19547]","[1419, 1991, 2118, 2632, 3353, 3966, 4353, 5354, 5761, 6154, 6572, 6971, 7302, 7771, 8211, 8672, 9467, 9942, 10571, 10996, 11804, 12466, 13092, 13503, 13825, 14268, 14904, 15196, 15758, 16046]","[561, 768, 1105, 1265, 1538, 1832, 1994, 2216, 2351, 2692, 2919, 3405, 3605, 4159, 4517, 4860, 5283, 5601, 6263, 6562, 7563, 7783, 7877, 8229, 8405, 8911, 9142, 9238, 9659, 9810]","[443, 622, 801, 985, 1246, 1474, 1636, 1858, 2193, 2700, 3046, 3395, 3649, 4216, 4570, 4986, 5322, 5529, 5805, 6053, 6731, 7147, 7476, 7687, 8063, 8843, 9074, 9215, 9495, 9595]",24457,19547,16046,9810,9595,-2384,-5651,-3095,-1137,-2092,-14359,30,radiant
7550385619,106,41,7,53,121,"[0, 539, 839, 1251, 1413, 1899, 2268, 2660, 3039, 3496, 3905, 4278, 4903, 5120, 5586, 6081, 6688, 7294, 7552, 8092, 8604, 8933, 9811, 10481, 11168, 12114, 12898, 13524, 14186, 15836]","[0, 278, 475, 726, 1008, 1291, 1604, 1894, 2234, 2399, 3166, 3588, 4161, 4660, 5205, 5676, 6325, 6911, 7452, 8025, 8323, 8786, 9541, 10272, 10704, 11128, 12209, 12976, 13560, 14387]","[0, 244, 474, 784, 1150, 1507, 1753, 2427, 2685, 3112, 3511, 4166, 4681, 5021, 5596, 6158, 7424, 8061, 8155, 8728, 9030, 9894, 10202, 10723, 11131, 11672, 12239, 12747, 13085, 14286]","[0, 271, 361, 734, 941, 1157, 1297, 1867, 2001, 2204, 2538, 2702, 3180, 3322, 3516, 3842, 4870, 5048, 5637, 5831, 5926, 6133, 6317, 6834, 7058, 7291, 8117, 8597, 8840, 9584]","[0, 315, 450, 773, 863, 1079, 1169, 1417, 1541, 2038, 2356, 2730, 3037, 3180, 3274, 3622, 4008, 4103, 4197, 4400, 4620, 4715, 4899, 5158, 5253, 5530, 6129, 6224, 6439, 7504]",15836,14387,14286,9584,7504,49,98,21,58,19,"[0, 202, 523, 837, 1244, 1608, 1909, 2409, 2942, 3236, 3508, 3901, 4565, 5284, 5874, 6376, 6773, 7461, 7851, 8583, 9666, 10230, 11102, 11364, 12201, 13146, 13555, 14504, 15033, 15270]","[0, 287, 531, 949, 1219, 1516, 1753, 1959, 2366, 2845, 3059, 3525, 4245, 4620, 4927, 5460, 6299, 6669, 7261, 8107, 8888, 9573, 9874, 10509, 11284, 11657, 12107, 12202, 12950, 13658]","[0, 248, 478, 725, 1234, 1438, 1775, 1981, 2770, 2958, 3338, 3866, 4152, 5046, 5493, 5923, 6864, 7646, 8288, 8718, 9716, 10242, 10703, 11524, 12252, 12811, 13609, 14197, 14714, 15282]","[0, 130, 263, 390, 525, 769, 859, 1004, 1215, 1420, 1591, 1718, 2344, 2786, 3080, 3422, 4028, 4248, 4595, 4944, 5200, 5463, 5778, 6682, 7383, 7794, 8148, 8514, 8892, 9727]","[0, 130, 269, 359, 604, 1011, 1220, 1402, 1664, 1876, 2252, 2352, 2532, 2825, 3205, 3514, 4105, 4400, 4584, 4742, 5229, 5324, 5684, 5944, 6221, 6426, 6914, 7009, 7186, 7407]",15270,13658,15282,9727,7407,566,729,-996,-143,97,253,30,radiant
7550400712,138,137,101,29,31,"[205, 491, 889, 1186, 1407, 1910, 2105, 2594, 3163, 3505, 4443, 5033, 5466, 6047, 6463, 7714, 8486, 9191, 9894, 10259, 11109, 12319, 13183, 14729, 15631, 16422, 17203, 17984, 19005, 19511]","[424, 751, 1109, 1465, 1794, 2297, 2485, 2906, 3287, 3844, 4594, 4924, 5117, 5400, 6008, 6285, 6733, 7655, 7861, 8985, 9404, 10249, 10586, 11620, 12353, 13196, 13728, 14629, 15089, 16035]","[170, 594, 798, 972, 1062, 1484, 1981, 2237, 2363, 2989, 3154, 3968, 4366, 4746, 5332, 5665, 6252, 6549, 6785, 7455, 7843, 8710, 8932, 9318, 9559, 10153, 10850, 11930, 12612, 13527]","[290, 633, 801, 1155, 1531, 1827, 2088, 2484, 2822, 3527, 3838, 4256, 4734, 5181, 5734, 6199, 6902, 7088, 7554, 8373, 8853, 9578, 9941, 10543, 10638, 10948, 11279, 11879, 12425, 13166]","[170, 310, 446, 576, 666, 955, 1045, 1220, 1592, 1950, 2183, 2498, 2691, 2974, 3320, 3503, 3769, 4037, 4194, 4573, 4839, 5349, 5444, 5864, 5959, 6213, 6543, 7158, 7469, 7907]",19511,16035,13527,13166,7907,114,36,88,121,26,"[207, 409, 978, 1325, 1485, 2026, 2199, 2548, 2719, 2809, 3286, 3569, 4078, 4737, 5449, 5865, 6531, 7107, 7760, 7855, 8253, 9133, 9742, 10529, 10769, 11534, 12082, 12612, 13995, 14754]","[170, 445, 773, 1104, 1347, 1596, 1846, 2128, 2542, 2704, 3147, 3434, 3600, 3820, 4578, 5070, 5620, 6057, 6411, 6940, 7279, 7516, 7987, 8979, 9438, 9803, 10203, 10693, 11405, 12138]","[256, 589, 793, 1160, 1288, 1619, 1923, 2107, 2458, 2674, 3027, 3340, 4177, 4893, 5041, 5796, 6148, 6852, 7208, 7303, 7907, 8001, 8186, 8728, 8823, 9111, 9206, 9302, 9619, 10417]","[170, 260, 398, 533, 707, 933, 1023, 1477, 1733, 1823, 2278, 2368, 2463, 2682, 3079, 3300, 4030, 4360, 4721, 4816, 5160, 5514, 6194, 6736, 6831, 7018, 7113, 7453, 8152, 8569]","[170, 260, 528, 618, 708, 893, 1021, 1240, 1375, 1757, 2242, 2379, 2562, 2696, 3057, 3278, 3661, 4062, 4339, 4480, 4754, 4848, 5160, 5571, 5666, 5842, 6144, 6240, 7152, 7507]",14754,12138,10417,8569,7507,4757,3897,3110,4597,400,16761,30,radiant
7550636605,126,54,102,100,26,"[0, 294, 688, 1061, 1632, 2014, 2489, 2916, 3324, 3764, 4445, 4949, 5517, 5612, 6316, 6916, 7456, 7811, 8558, 9307, 10516, 11753, 13012, 13718, 14406, 15207, 16071, 16594, 17191, 18343]","[0, 244, 592, 982, 1375, 1877, 2314, 2756, 3267, 3759, 4260, 4824, 5280, 5849, 6343, 7027, 7664, 8350, 9345, 10185, 11073, 11874, 13106, 14030, 14900, 15534, 16740, 17578, 18514, 19111]","[0, 326, 619, 1500, 2000, 2690, 3175, 3630, 4220, 4708, 5662, 6068, 6603, 7088, 7641, 7918, 8165, 8545, 9319, 9975, 11139, 12580, 13514, 14004, 14745, 15408, 15884, 16871, 17769, 18274]","[0, 169, 259, 474, 690, 907, 1044, 1134, 1314, 1449, 1795, 1885, 1975, 2241, 2390, 2533, 2690, 2921, 3106, 3334, 3741, 4173, 4944, 5434, 5948, 6118, 6533, 6627, 6804, 6936]","[0, 169, 259, 364, 534, 789, 926, 1055, 1253, 1388, 1523, 1655, 1745, 1912, 2105, 2200, 2357, 2452, 2738, 3054, 3605, 4083, 4353, 4629, 4784, 4953, 5129, 5223, 5400, 5584]",18343,19111,18274,6936,5584,11,2,74,86,84,"[0, 292, 730, 982, 1446, 1625, 2066, 2436, 3152, 3625, 3953, 4119, 5031, 5644, 6202, 7916, 9145, 9989, 10618, 11302, 12015, 12110, 12205, 13035, 14195, 15156, 15920, 16690, 17380, 17867]","[0, 254, 491, 821, 1194, 1613, 2028, 2461, 3389, 4473, 4946, 5515, 6647, 7014, 7369, 8367, 9458, 9921, 10496, 11187, 11907, 12579, 12718, 12812, 13121, 13786, 14495, 15096, 15544, 16238]","[0, 257, 631, 757, 1434, 1860, 2058, 2447, 2798, 3368, 3707, 4140, 4746, 5147, 5705, 6472, 7634, 8104, 8546, 9267, 9669, 9856, 10265, 10609, 11490, 12432, 13090, 13780, 14431, 14827]","[0, 169, 311, 444, 534, 641, 776, 1166, 1511, 1786, 1921, 2184, 2681, 2944, 3318, 3736, 4471, 5138, 5645, 6306, 6662, 6832, 7097, 7536, 8122, 8609, 8889, 9400, 9857, 10718]","[0, 169, 259, 349, 484, 645, 735, 872, 1039, 1153, 1429, 1780, 1994, 2251, 2484, 3216, 3795, 3890, 3985, 4127, 4284, 4418, 4513, 4607, 4774, 4869, 5119, 5213, 5390, 5634]",17867,16238,14827,10718,5634,476,2873,3447,-3782,-50,2964,30,dire
7550680216,29,81,21,26,87,"[0, 239, 540, 839, 1243, 1488, 1866, 2208, 2691, 2820, 3549, 4047, 4756, 5458, 5857, 6397, 7076, 7617, 8617, 9774, 10314, 10959, 12174, 12774, 13572, 15087, 15398, 16450, 17505, 17897]","[0, 286, 415, 738, 1153, 1882, 2273, 2704, 3077, 3378, 4000, 4493, 5228, 5865, 6300, 6818, 7514, 8067, 9209, 10151, 11636, 12226, 14683, 15002, 15271, 16117, 16389, 17387, 18567, 18780]","[0, 243, 526, 873, 1203, 1535, 2017, 2485, 2815, 3271, 3676, 4038, 4674, 5169, 5706, 6511, 7247, 7567, 7909, 8840, 9747, 9989, 10205, 11002, 11889, 13090, 13385, 14530, 15032, 16039]","[0, 169, 259, 349, 488, 614, 807, 942, 1081, 1171, 1515, 1687, 1895, 2610, 2705, 2972, 3164, 3461, 3983, 4455, 5168, 5605, 6148, 6443, 7083, 7508, 7651, 8160, 8256, 8922]","[0, 169, 296, 433, 570, 790, 925, 1141, 1231, 1358, 1601, 1740, 2056, 2345, 2440, 2704, 2862, 3107, 3534, 3738, 4141, 4346, 5243, 5600, 6179, 6710, 6804, 7104, 7447, 7868]",17897,18780,16039,8922,7868,126,4,71,27,58,"[0, 252, 540, 912, 1411, 1712, 2080, 2465, 3065, 3706, 4089, 4527, 4975, 5918, 6411, 6664, 7565, 8489, 9258, 9578, 9865, 10420, 11747, 12369, 13278, 13821, 14547, 15476, 15572, 16442]","[0, 204, 434, 677, 1010, 1414, 1741, 2361, 2803, 3424, 3934, 4508, 4916, 5974, 6645, 7076, 8140, 8708, 9428, 9939, 10375, 10472, 10569, 11572, 12352, 12553, 13647, 14351, 14603, 15774]","[0, 169, 491, 820, 1176, 1458, 1776, 2232, 2643, 3030, 3502, 3906, 4458, 5022, 5171, 5744, 6200, 6666, 7250, 7855, 8848, 9033, 9611, 10672, 10962, 11330, 12414, 13144, 13288, 14308]","[0, 169, 259, 441, 571, 697, 836, 1016, 1228, 1363, 1498, 1716, 2354, 2602, 2964, 3216, 3524, 3756, 4281, 4680, 5033, 5130, 5656, 6924, 7871, 8057, 8578, 9264, 9360, 9909]","[0, 169, 259, 389, 556, 694, 931, 1352, 1502, 1891, 2097, 2386, 2590, 3146, 3594, 3883, 4407, 4935, 5331, 5488, 5731, 5912, 6167, 6602, 7228, 7609, 8452, 8883, 9027, 9820]",16442,15774,14308,9909,9820,1455,3006,1731,-987,-1952,3253,30,dire
7550704109,41,120,97,86,58,"[0, 279, 486, 843, 1131, 1369, 1698, 1959, 2431, 2904, 3331, 4145, 4620, 5365, 5981, 7035, 7730, 8730, 9338, 10098, 11162, 11917, 12381, 13598, 14385, 15560, 16383, 17369, 18594, 19232]","[0, 205, 499, 900, 1352, 1825, 2595, 2746, 3170, 3589, 4468, 4942, 5674, 6080, 6441, 6962, 8232, 8622, 8955, 10075, 11039, 11491, 12158, 12864, 13524, 13968, 14170, 14844, 15595, 16151]","[0, 285, 532, 1042, 1412, 1532, 2069, 2312, 2673, 3252, 3617, 4151, 4737, 5672, 6238, 6423, 7247, 7649, 8418, 9468, 9685, 10298, 10980, 11185, 11762, 12095, 12297, 12391, 12842, 13374]","[0, 170, 260, 432, 675, 765, 855, 1188, 1347, 1437, 1878, 2138, 2336, 2624, 3197, 3905, 4257, 4470, 4957, 5328, 6060, 6593, 6959, 7218, 7585, 8081, 8522, 8953, 9255, 9351]","[0, 170, 260, 463, 675, 841, 975, 1143, 1276, 1597, 1873, 2095, 2491, 2850, 2983, 3690, 4125, 4547, 5096, 5380, 5674, 6134, 6549, 7168, 7668, 8536, 8975, 9567, 9894, 10133]",19232,16151,13374,9351,10133,48,98,106,121,119,"[0, 206, 511, 844, 1212, 1513, 1891, 2147, 2697, 3198, 3709, 4318, 4919, 5593, 6240, 6545, 7189, 7990, 8730, 9627, 9721, 10495, 11237, 11873, 12767, 13433, 14515, 15734, 16277, 16600]","[0, 216, 455, 690, 937, 1298, 1707, 2122, 2593, 3128, 3714, 4173, 5061, 5497, 5967, 6424, 7416, 7829, 8142, 8733, 8911, 9156, 9751, 10704, 11631, 12328, 12579, 13581, 14382, 15680]","[0, 293, 627, 999, 1378, 1639, 1934, 2433, 2775, 3194, 3636, 4207, 4740, 5102, 5315, 5660, 6348, 6842, 7365, 8235, 8468, 8730, 9409, 9926, 10657, 11155, 12007, 12935, 13491, 13692]","[0, 170, 303, 393, 580, 670, 805, 941, 1089, 1333, 1502, 1804, 2300, 2536, 2631, 2863, 3083, 3854, 4011, 4426, 4629, 4799, 5041, 5451, 5854, 6809, 7634, 8123, 8419, 8971]","[0, 170, 260, 350, 440, 601, 736, 1031, 1166, 1390, 1559, 2020, 2399, 2700, 2901, 3187, 3514, 3610, 3955, 4640, 4887, 4982, 5334, 5674, 6095, 6497, 7030, 7392, 7569, 7962]",16600,15680,13692,8971,7962,2632,471,-318,380,2171,5336,30,radiant
7550728517,77,44,90,72,83,"[0, 289, 603, 880, 1253, 1785, 2209, 2732, 3155, 4325, 4874, 5614, 6533, 7176, 7561, 7835, 8131, 8885, 9465, 10047, 10887, 11776, 12993, 13820, 14578, 15048, 16016, 16913, 18165, 18513]","[0, 292, 728, 1157, 1484, 1899, 2359, 2865, 3322, 3850, 4265, 4928, 5464, 5869, 6532, 7044, 7549, 8459, 9350, 10368, 10866, 11070, 12015, 13200, 13747, 14206, 14900, 15166, 16013, 16190]","[0, 255, 541, 916, 1212, 1598, 1925, 2340, 2760, 3376, 4095, 4613, 5115, 5557, 6057, 6556, 7363, 8034, 8285, 8932, 9681, 10182, 11027, 11507, 12760, 13576, 14200, 14466, 15247, 15839]","[0, 170, 260, 425, 601, 1137, 1314, 1404, 1543, 1960, 2192, 2877, 3093, 3370, 3752, 4001, 4096, 4656, 5045, 5765, 6211, 6973, 7816, 8282, 8472, 8567, 9081, 9434, 10444, 10804]","[0, 170, 260, 398, 580, 719, 809, 946, 1083, 1403, 1575, 1969, 2130, 2366, 2461, 2790, 2885, 3042, 3235, 3690, 4161, 5161, 5816, 6268, 7549, 7791, 8196, 8553, 9129, 9435]",18513,16190,15839,10804,9435,48,14,43,45,5,"[0, 284, 557, 1020, 1485, 1909, 2448, 2958, 3607, 3832, 4317, 4930, 5434, 5830, 6737, 7526, 7984, 8842, 9925, 10573, 11528, 12822, 13012, 13920, 15378, 15473, 16463, 17867, 17997, 18561]","[0, 327, 660, 1073, 1493, 2044, 2873, 3326, 3999, 4443, 5140, 5650, 6123, 6640, 7156, 7424, 8479, 10038, 10591, 11381, 11586, 12574, 13089, 13444, 14369, 14464, 15281, 16045, 17747, 18737]","[0, 331, 656, 1019, 1399, 1761, 2361, 2939, 3573, 4654, 4998, 5552, 6043, 6615, 7114, 7601, 8457, 9401, 10001, 10511, 10872, 11222, 11964, 12377, 12636, 13662, 14773, 15539, 15671, 15914]","[0, 170, 260, 350, 484, 588, 678, 768, 993, 1308, 1398, 1629, 1756, 1850, 2035, 2130, 2679, 3622, 3948, 4089, 4539, 5107, 5521, 5802, 6400, 6737, 7249, 8163, 8608, 9035]","[0, 170, 260, 363, 498, 605, 695, 788, 1065, 1183, 1273, 1363, 1597, 1736, 1969, 2068, 2841, 2935, 3263, 3868, 4073, 4167, 4384, 4639, 5237, 5577, 6819, 7394, 7490, 7871]",18561,18737,15914,9035,7871,-48,-2547,-75,1769,1564,663,30,dire
7550854213,25,109,53,86,5,"[0, 367, 723, 1081, 1534, 2264, 2766, 3395, 4219, 4787, 5539, 6274, 7275, 8002, 9077, 9999, 10817, 12136, 12444, 12809, 12903, 13541, 13636, 14420, 15663, 15959, 16383, 17644, 18425, 19293]","[0, 327, 642, 1015, 1467, 1870, 2445, 3079, 3453, 4027, 4377, 4810, 5272, 5760, 6464, 7084, 7613, 8113, 8943, 9038, 9696, 10165, 11150, 12141, 12696, 13853, 14458, 15981, 16694, 17542]","[0, 246, 494, 734, 1296, 1658, 2035, 2218, 2565, 2799, 3160, 3336, 3760, 4167, 4664, 5331, 5939, 6802, 7333, 8214, 8937, 9634, 10494, 10774, 11871, 13126, 14582, 15846, 16836, 17255]","[0, 213, 351, 464, 751, 890, 1072, 1255, 1465, 1629, 1897, 2308, 2718, 3165, 3774, 4056, 4879, 5504, 6137, 6317, 6842, 6937, 7112, 7820, 8182, 9663, 10440, 11320, 11526, 11831]","[0, 169, 612, 751, 890, 1030, 1247, 1430, 1568, 1830, 1954, 2230, 2374, 2603, 2745, 2930, 3336, 3766, 4192, 4287, 4646, 4827, 5120, 5214, 5309, 5486, 6741, 7322, 7528, 7760]",19293,17542,17255,11831,7760,74,48,81,27,83,"[0, 287, 658, 990, 1398, 1853, 2339, 2786, 3147, 3651, 4166, 4882, 5520, 5939, 6567, 7252, 7965, 9053, 10413, 11614, 12645, 12972, 14368, 15181, 15771, 16495, 16913, 17453, 17917, 19058]","[0, 169, 415, 774, 983, 1233, 1519, 1726, 2170, 2647, 3178, 3706, 4238, 4810, 5342, 6330, 6944, 7220, 7886, 8856, 9838, 10945, 11978, 13101, 13932, 14372, 15108, 16071, 16239, 17293]","[0, 282, 518, 887, 1295, 1624, 1966, 2350, 2648, 3110, 3596, 3741, 4467, 4959, 5885, 6526, 7167, 7814, 8331, 9941, 10704, 11434, 12409, 13047, 13252, 14425, 14601, 15493, 15589, 16411]","[0, 216, 342, 432, 585, 675, 914, 1076, 1544, 1867, 2442, 2662, 3173, 3331, 3539, 3893, 4785, 4918, 5658, 6473, 7038, 7375, 8624, 9328, 9638, 11007, 11258, 11762, 11933, 12240]","[0, 169, 259, 395, 597, 722, 851, 1027, 1117, 1223, 1313, 1504, 1642, 1836, 1968, 2099, 2500, 2601, 3246, 4045, 4666, 4833, 5198, 5575, 5855, 6266, 6517, 7238, 7448, 7755]",19058,17293,16411,12240,7755,235,249,844,-409,5,924,30,radiant
7551597806,82,74,19,65,85,"[0, 289, 655, 1097, 1624, 1867, 2417, 3023, 3767, 4480, 5020, 5451, 6290, 7049, 7659, 8587, 9512, 11051, 11697, 13270, 14155, 15197, 16651, 17994, 19248, 20360, 21500, 22363, 23313, 23902]","[0, 209, 390, 680, 1135, 1445, 1746, 2205, 2601, 3045, 3616, 4254, 4788, 5085, 5598, 5849, 6262, 7021, 7490, 8450, 9133, 9972, 10796, 11606, 11912, 12809, 13550, 13912, 14390, 14651]","[0, 251, 538, 784, 1370, 1615, 1906, 2326, 2696, 3046, 3628, 4419, 4776, 5295, 5623, 5800, 6319, 6790, 7314, 8208, 8544, 9371, 10588, 11090, 11383, 12225, 12906, 13312, 14062, 14263]","[0, 170, 260, 387, 659, 749, 924, 1014, 1164, 1435, 1688, 2191, 2454, 2689, 3291, 3523, 4370, 4961, 5154, 5737, 6812, 7406, 8298, 8765, 9260, 9578, 10106, 10440, 11061, 11390]","[0, 170, 260, 350, 640, 730, 820, 910, 1045, 1309, 1532, 1915, 2005, 2253, 2506, 2648, 3191, 3474, 3774, 4475, 4704, 5030, 5792, 6258, 6424, 6700, 7158, 7424, 7780, 7910]",23902,14651,14263,11390,7910,94,129,103,83,119,"[0, 170, 586, 872, 1326, 1654, 1883, 2367, 2827, 3108, 3425, 3549, 3968, 4783, 5380, 5839, 6937, 7521, 8099, 8639, 8771, 9540, 9669, 10175, 10665, 11478, 12020, 12704, 13524, 14946]","[0, 329, 724, 1068, 1393, 1681, 2307, 2710, 3409, 3783, 4392, 4794, 5367, 5767, 5971, 6066, 6569, 6664, 7105, 7556, 7900, 8808, 8903, 9084, 9786, 10196, 11108, 11491, 11856, 12324]","[0, 244, 502, 740, 1043, 1447, 1812, 2315, 2786, 3089, 3898, 3996, 4404, 4634, 5131, 5321, 5714, 5913, 6348, 6857, 6977, 7219, 7527, 7659, 7835, 7930, 8386, 8686, 9110, 9242]","[0, 170, 285, 375, 514, 604, 768, 967, 1164, 1254, 1755, 1850, 2271, 2672, 3338, 3526, 3817, 4064, 4235, 4805, 5139, 5297, 5472, 5567, 5661, 6040, 6254, 6423, 7208, 7335]","[0, 213, 362, 452, 542, 897, 1394, 1529, 1619, 1709, 2112, 2205, 2496, 2748, 3243, 3551, 3798, 4120, 4215, 4511, 4799, 4968, 5063, 5158, 5324, 5618, 6336, 6468, 6831, 6927]",14946,12324,9242,7335,6927,8956,2327,5021,4055,983,21342,30,radiant
7551667014,48,21,106,86,105,"[849, 1093, 1304, 1662, 2060, 2311, 2948, 3123, 3747, 4364, 5166, 5683, 6330, 7048, 7697, 8369, 8687, 9326, 9716, 10738, 11861, 12952, 13672, 14285, 15626, 16712, 17463, 18213, 18632, 19124]","[957, 1448, 2150, 2509, 2857, 3152, 3411, 3870, 4251, 4519, 4968, 5458, 5820, 5981, 6482, 6949, 7364, 8289, 9292, 10092, 11150, 12128, 12819, 13631, 14172, 15376, 15926, 16022, 16732, 16832]","[1020, 1395, 1789, 1973, 2264, 2580, 3001, 3417, 3794, 4090, 4709, 5055, 5629, 5848, 6512, 6850, 7599, 8880, 9137, 9930, 10812, 11469, 11564, 12207, 12790, 13516, 14047, 14371, 14699, 15540]","[350, 480, 695, 1140, 1320, 1457, 1547, 1637, 1772, 2136, 2364, 2598, 2865, 3262, 3623, 4012, 4210, 4817, 5114, 5576, 5857, 6405, 6575, 7022, 7539, 8130, 8301, 8472, 8716, 8827]","[394, 524, 653, 1226, 1406, 1512, 1711, 1883, 2160, 2250, 2517, 2686, 2781, 2951, 3120, 3214, 3372, 3975, 4552, 4808, 5197, 5580, 5675, 5992, 6466, 6805, 7354, 7865, 8099, 8199]",19124,16832,15540,8827,8199,41,49,102,121,20,"[678, 954, 1253, 1549, 1810, 2266, 2701, 3159, 3809, 4440, 5058, 5777, 6518, 7062, 7994, 8571, 9852, 11018, 11936, 13124, 14234, 15255, 16457, 17413, 18424, 18520, 19627, 21083, 22141, 23208]","[882, 1337, 1711, 2212, 2814, 3193, 3705, 4142, 4892, 5417, 6188, 6907, 7396, 8085, 8794, 9492, 10459, 11014, 11212, 12286, 12906, 13746, 14046, 14756, 15252, 15876, 16921, 18001, 18952, 19604]","[760, 1053, 1709, 2115, 2452, 3055, 3606, 4167, 4949, 5242, 5927, 6508, 6945, 7581, 8078, 8630, 9321, 10261, 10538, 11358, 11657, 12684, 13812, 14216, 14813, 15560, 15925, 17083, 17625, 18425]","[398, 535, 802, 1036, 1126, 1345, 1435, 1832, 2101, 2447, 2817, 3359, 3681, 4032, 4178, 4506, 5085, 5473, 5688, 6050, 6145, 6364, 6669, 6873, 7228, 7421, 7948, 8618, 9065, 9582]","[436, 590, 720, 1065, 1155, 1419, 1509, 1776, 2081, 2294, 2773, 2925, 3366, 3833, 4129, 4716, 5079, 5611, 5706, 5959, 6054, 6393, 6890, 7094, 7283, 7379, 8128, 8901, 9253, 9642]",23208,19604,18425,9582,9642,-4084,-2772,-2885,-755,-1443,-11939,30,dire
7551823505,10,135,53,14,105,"[279, 609, 933, 1381, 1800, 2570, 2789, 3207, 3751, 4104, 4762, 5102, 5860, 6265, 6717, 7098, 7504, 8490, 9214, 10633, 11455, 12550, 13188, 14319, 15593, 16684, 17561, 18721, 19733, 20741]","[654, 818, 1294, 1658, 1947, 2196, 2535, 3077, 3751, 4167, 4652, 5339, 6085, 6648, 7586, 8021, 8500, 9313, 10016, 10311, 10753, 11419, 12124, 13022, 13435, 14268, 14734, 15969, 16620, 17668]","[226, 354, 532, 821, 1094, 1645, 1828, 1989, 2468, 2848, 3040, 3462, 4246, 4341, 4846, 5272, 5866, 6597, 7008, 7820, 8276, 9063, 9459, 10505, 11169, 11529, 12632, 13977, 14443, 15931]","[226, 316, 455, 604, 739, 1353, 1659, 1864, 2109, 2279, 2432, 2738, 3281, 3496, 3702, 4163, 4631, 5495, 5859, 7005, 7569, 7918, 8012, 8315, 8901, 9621, 10519, 11167, 11585, 12222]","[170, 260, 350, 485, 623, 1046, 1226, 1359, 1543, 1681, 1873, 2053, 2423, 2543, 2780, 3088, 3246, 3574, 3966, 4785, 4979, 5692, 5786, 6052, 6695, 7092, 7583, 8141, 8597, 9234]",20741,17668,15931,12222,9234,18,123,31,71,26,"[731, 1107, 1340, 1655, 1983, 2361, 2785, 3584, 4173, 5009, 5571, 6149, 7014, 7577, 8274, 8931, 9411, 9587, 10690, 11140, 11560, 12074, 12757, 13283, 13580, 14570, 15030, 15126, 15707, 16550]","[354, 574, 793, 1177, 1267, 1496, 1926, 2186, 2412, 2714, 2888, 3348, 3860, 4253, 4873, 5533, 6145, 6677, 7256, 7864, 8088, 8774, 9727, 10020, 10964, 11488, 12012, 12586, 13119, 13780]","[315, 566, 762, 1047, 1288, 1712, 1964, 2257, 2483, 2826, 3310, 3521, 3821, 3916, 4252, 4495, 4977, 5342, 5671, 6576, 6832, 7179, 7568, 7956, 8432, 8694, 9101, 9357, 9528, 9789]","[311, 401, 698, 1075, 1165, 1519, 1944, 2397, 2532, 2950, 3117, 3207, 3356, 3732, 4153, 4699, 4794, 4970, 5127, 5671, 5766, 5951, 6064, 6269, 6364, 6459, 6793, 6889, 7025, 7211]","[513, 641, 824, 1060, 1150, 1240, 1403, 1694, 1864, 2145, 2511, 2705, 2854, 3249, 3584, 3742, 3976, 4152, 4309, 4756, 4932, 5191, 5452, 5650, 6309, 6631, 6725, 6870, 6966, 7194]",16550,13780,9789,7211,7194,4191,3888,6142,5011,2040,21272,30,radiant
7552020905,18,46,104,72,22,"[0, 244, 606, 1109, 1536, 1913, 2408, 2940, 3589, 4256, 5149, 5806, 6456, 7029, 7394, 8065, 8865, 9628, 10856, 12042, 12263, 13121, 15148, 15494, 16446, 17624, 18538, 19283, 19379, 20436]","[0, 407, 696, 1180, 1455, 1947, 2385, 2790, 3310, 4180, 5071, 5611, 6378, 6982, 7564, 8136, 8921, 9650, 11017, 11877, 12824, 13683, 13975, 15145, 15650, 16118, 16213, 16738, 17640, 17898]","[0, 279, 554, 989, 1350, 1750, 2107, 2435, 2838, 3052, 3519, 3840, 4330, 4785, 5396, 5799, 6606, 7347, 7769, 8440, 9094, 9760, 10518, 11417, 11980, 12361, 12456, 12975, 13451, 13869]","[0, 170, 308, 443, 613, 746, 884, 974, 1203, 1383, 1818, 1986, 2218, 2833, 3240, 3512, 3922, 4559, 5407, 5745, 6257, 6467, 6706, 7216, 7728, 8308, 8599, 9096, 9724, 9982]","[0, 170, 278, 429, 635, 1319, 1456, 1584, 1800, 1935, 2119, 2209, 2418, 2637, 2839, 2934, 3673, 3929, 4712, 5338, 5606, 5700, 6149, 7285, 7653, 7782, 8475, 8570, 9259, 9517]",20436,17898,13869,9982,9517,48,19,96,5,86,"[0, 279, 595, 1005, 1402, 2047, 2470, 3012, 3508, 4248, 4842, 5356, 6042, 6769, 7394, 8048, 8788, 9643, 10438, 10533, 11334, 13151, 13610, 14168, 14263, 14915, 16790, 17546, 18835, 18931]","[0, 324, 617, 1032, 1521, 1971, 2394, 3038, 3560, 4206, 4778, 5259, 5930, 6151, 7035, 7434, 7529, 8027, 8569, 9277, 9972, 10635, 10820, 11839, 11934, 12537, 13886, 15333, 16824, 18045]","[0, 283, 510, 904, 1235, 1478, 1896, 2329, 2697, 3072, 3572, 4033, 4489, 4844, 5454, 6000, 6473, 7033, 7744, 8453, 9057, 9852, 10359, 11202, 11936, 12030, 13088, 13789, 14161, 15072]","[0, 170, 260, 437, 567, 749, 886, 1113, 1307, 1534, 1722, 1937, 2027, 2122, 2671, 2865, 3243, 3414, 3912, 4007, 4369, 4879, 5064, 5607, 6000, 6346, 7162, 7754, 8754, 9006]","[0, 222, 312, 402, 532, 658, 748, 974, 1109, 1199, 1383, 1519, 1609, 1704, 2148, 2243, 2338, 2945, 3282, 3466, 3922, 4145, 4330, 5098, 5919, 6465, 6832, 7664, 7841, 8140]",18931,18045,15072,9006,8140,1505,-147,-1203,976,1377,2508,30,dire
7552046611,56,51,55,105,86,"[0, 314, 710, 963, 1301, 1622, 2201, 2565, 3076, 3586, 4249, 5281, 5697, 6271, 6613, 7195, 8295, 8519, 9016, 9843, 10374, 10723, 12005, 12723, 13629, 14463, 14584, 15796, 16434, 18748]","[0, 581, 919, 1368, 1861, 2186, 2468, 3051, 3352, 3759, 4293, 4679, 5014, 5352, 5630, 5978, 6661, 7424, 8243, 8794, 9677, 9895, 10897, 11507, 11712, 12467, 12951, 14084, 14501, 15664]","[0, 199, 444, 733, 1097, 1422, 1907, 2565, 2854, 3496, 4087, 4470, 4807, 5000, 5866, 6085, 6927, 7294, 7820, 7951, 8341, 8436, 9614, 10131, 10578, 11221, 11515, 12342, 12755, 13583]","[0, 281, 574, 664, 842, 972, 1358, 1696, 1786, 2065, 2368, 2690, 3104, 3253, 3450, 4102, 4588, 4913, 5093, 5755, 5913, 6008, 6616, 6906, 7111, 7331, 7455, 8342, 8438, 9495]","[0, 281, 371, 461, 591, 721, 846, 1149, 1290, 1463, 1780, 2101, 2437, 2707, 3120, 3519, 4120, 4563, 4797, 5480, 5692, 5915, 6690, 7016, 7221, 8221, 8710, 9621, 9717, 10191]",18748,15664,13583,9495,10191,48,126,69,21,27,"[0, 363, 651, 1111, 1546, 1880, 2295, 2662, 3201, 3759, 4420, 4791, 5612, 6180, 6927, 7666, 8847, 9396, 10142, 11886, 13138, 14051, 14544, 14929, 16127, 17289, 18055, 18940, 19198, 19541]","[0, 246, 480, 885, 1293, 1644, 2123, 2530, 3145, 3683, 4038, 4642, 5627, 6588, 7102, 8253, 9197, 10020, 10495, 11707, 12373, 12468, 12653, 13383, 13478, 15482, 16211, 17213, 18241, 18992]","[0, 574, 772, 1092, 1353, 1527, 1759, 2229, 2823, 3187, 3705, 4248, 4907, 5524, 6062, 7213, 7952, 8893, 9167, 9871, 10435, 10690, 11547, 12355, 12450, 13250, 13452, 13949, 14513, 15269]","[0, 272, 382, 492, 626, 763, 957, 1131, 1467, 1728, 2085, 2268, 2755, 3199, 3607, 4294, 4710, 5112, 5849, 6148, 6600, 7122, 7680, 8025, 8238, 8736, 9199, 9646, 10407, 10709]","[0, 272, 574, 682, 772, 1115, 1205, 1343, 1665, 1929, 2019, 2109, 2308, 2501, 2695, 3085, 3443, 3929, 4061, 4887, 5222, 5446, 5631, 5824, 5963, 6851, 7201, 7782, 8312, 8655]",19541,18992,15269,10709,8655,-793,-3328,-1686,-1214,1536,-5485,30,dire
7552078015,48,13,20,26,102,"[698, 1093, 1517, 1961, 2459, 2981, 3391, 3848, 4836, 5433, 6252, 6890, 7661, 8661, 9947, 10673, 11052, 11907, 12671, 13663, 14444, 15607, 16679, 18127, 19062, 20218, 20770, 21767, 23631, 25116]","[865, 1101, 1503, 1843, 2024, 2349, 2824, 3558, 3873, 4354, 4937, 5545, 6043, 6303, 7123, 7895, 8462, 9174, 10377, 10706, 11645, 12440, 13519, 14720, 15915, 16841, 17830, 18900, 20637, 21859]","[860, 1361, 1714, 2164, 2445, 3147, 3696, 3806, 4142, 4716, 5506, 6053, 6377, 7073, 8025, 8548, 8897, 9126, 9518, 10607, 11288, 11637, 12757, 13312, 13841, 14477, 15281, 15851, 16197, 17059]","[489, 614, 744, 879, 969, 1104, 1375, 1727, 1894, 2082, 2290, 2620, 2715, 2872, 3472, 3697, 3792, 4045, 4333, 4662, 4761, 5454, 5898, 6463, 6737, 7125, 7584, 8012, 8752, 9566]","[346, 471, 619, 754, 860, 950, 1396, 1712, 2054, 2198, 2430, 2680, 2870, 3052, 3499, 3724, 3819, 4272, 4555, 4884, 4991, 5608, 5850, 6273, 6584, 6962, 7268, 7848, 8768, 9355]",25116,21859,17059,9566,9355,12,106,98,45,79,"[1140, 1465, 1853, 2270, 2745, 3058, 3445, 3866, 4157, 4522, 5383, 5716, 6262, 6819, 7648, 7942, 8755, 9388, 9700, 10276, 10808, 11498, 12148, 12878, 13748, 14482, 15010, 15484, 15584, 16571]","[1151, 1526, 1943, 2168, 2578, 2996, 3473, 3874, 4323, 4728, 5159, 5549, 5864, 7098, 7672, 8108, 8735, 9056, 9602, 10460, 10830, 11213, 12092, 12606, 12701, 13080, 13774, 14426, 14925, 16290]","[775, 1001, 1512, 1708, 2172, 2830, 3569, 4389, 4775, 5412, 6090, 6856, 7156, 8095, 8653, 9117, 9834, 10335, 11113, 11378, 12017, 12774, 13236, 13675, 14353, 14862, 15445, 16243, 16569, 16902]","[860, 954, 1092, 1182, 2060, 2235, 2661, 3059, 3268, 3678, 4203, 4442, 4687, 5067, 5454, 5645, 6199, 6351, 6663, 7301, 7479, 7762, 8364, 8459, 8554, 8776, 8872, 9149, 9518, 9984]","[421, 771, 861, 951, 1132, 1222, 1564, 1865, 2056, 2423, 2756, 2995, 3338, 3543, 4145, 4396, 4874, 5212, 5458, 5801, 6028, 6122, 6604, 6871, 7157, 7334, 7430, 7571, 7879, 8498]",16571,16290,16902,9984,8498,8545,5569,157,-418,857,14710,30,radiant
7552136213,48,49,129,105,119,"[0, 210, 486, 1022, 1210, 1425, 1804, 2372, 2536, 2987, 3367, 3862, 4444, 5359, 6417, 7351, 8114, 9253, 10165, 10704, 10899, 11974, 12726, 12820, 13921, 14983, 15628, 17348, 18361, 19188]","[0, 373, 610, 1029, 1404, 1755, 2401, 2990, 3398, 3817, 4249, 4879, 5327, 6167, 6870, 7078, 8178, 8885, 9657, 10282, 10377, 11279, 11374, 12559, 13233, 13976, 14952, 15993, 17042, 17671]","[0, 246, 651, 1005, 1249, 1666, 2037, 2542, 2915, 3490, 3941, 4496, 5103, 5492, 6130, 6657, 6997, 7490, 7948, 8424, 8610, 9527, 9780, 9874, 10332, 10427, 11114, 11747, 12627, 12879]","[0, 330, 420, 713, 803, 893, 1321, 1703, 1963, 2148, 2529, 2761, 2905, 3179, 3777, 4269, 4409, 4623, 4959, 5458, 5789, 6310, 6544, 6746, 6964, 7663, 7917, 8263, 8440, 9020]","[0, 210, 351, 485, 575, 1040, 1215, 1535, 1625, 1805, 1996, 2119, 2594, 2849, 3198, 3462, 3807, 3902, 4392, 4524, 4754, 5312, 5500, 5669, 6173, 6343, 6715, 7656, 7908, 8006]",19188,17671,12879,9020,8006,41,25,97,26,45,"[0, 205, 565, 936, 1258, 1653, 1974, 2289, 2557, 3093, 3344, 3828, 4236, 4817, 5453, 6464, 7184, 8275, 8563, 9316, 9577, 10294, 11181, 12019, 12798, 14355, 15539, 16129, 17136, 17768]","[0, 354, 662, 988, 1316, 1698, 2034, 2383, 2833, 3350, 3779, 4516, 5061, 5658, 6392, 7508, 8044, 8424, 9016, 10289, 11395, 11685, 13201, 14685, 15282, 15959, 17136, 17585, 18400, 18946]","[0, 536, 798, 1117, 1553, 1917, 2308, 2838, 3136, 3555, 4095, 5020, 5683, 6380, 6920, 8318, 9090, 9801, 10420, 11255, 12018, 12113, 13352, 13790, 14064, 14647, 15617, 15881, 16058, 16268]","[0, 193, 319, 409, 625, 761, 851, 941, 1146, 1427, 1644, 1892, 2081, 2828, 3013, 3498, 3764, 3934, 4029, 4528, 5234, 5755, 6197, 6645, 6887, 7930, 8420, 8670, 9064, 9387]","[0, 239, 329, 467, 689, 1159, 1249, 1383, 1603, 2049, 2367, 2547, 2883, 3445, 3546, 4042, 4308, 4407, 4601, 4799, 5737, 5832, 6491, 6934, 7399, 7886, 8154, 8329, 8506, 8765]",17768,18946,16268,9387,8765,1420,-1275,-3389,-367,-759,-4370,30,dire
7552190011,73,98,39,5,45,"[0, 335, 644, 1182, 1578, 1897, 2110, 2561, 3094, 3747, 4510, 5315, 5806, 6877, 8030, 8613, 9316, 10364, 11644, 12467, 12741, 13415, 14006, 14395, 14961, 15591, 16988, 17603, 18361, 18931]","[0, 292, 618, 951, 1208, 1572, 2221, 2784, 3339, 3815, 4381, 4834, 5405, 6176, 6839, 7362, 8066, 8792, 9249, 9988, 10638, 11384, 12321, 12722, 13143, 14362, 15282, 15896, 16646, 17058]","[0, 289, 521, 888, 1104, 1378, 1722, 2219, 2676, 3038, 3466, 3879, 4178, 4608, 4755, 5056, 5682, 6345, 6916, 7290, 7834, 8261, 8644, 9133, 10294, 11233, 11582, 11856, 11952, 12132]","[0, 169, 307, 443, 599, 725, 859, 1169, 1493, 1843, 1978, 2068, 2258, 2692, 2871, 2998, 3254, 3540, 3634, 3810, 3924, 4294, 4463, 4680, 5177, 5663, 5880, 6050, 6221, 6392]","[0, 169, 259, 445, 583, 759, 934, 1163, 1471, 1640, 1896, 2034, 2181, 2735, 3273, 3778, 3997, 4396, 4518, 4676, 5118, 5213, 5355, 5715, 6357, 6953, 7095, 7190, 7333, 7494]",18931,17058,12132,6392,7494,48,43,33,58,19,"[0, 204, 408, 734, 1172, 1655, 1978, 2386, 2766, 3382, 3943, 4846, 5532, 6415, 7014, 7766, 8511, 9483, 10044, 11243, 11744, 12484, 13424, 14528, 15257, 16218, 17116, 18132, 18926, 19635]","[0, 294, 651, 955, 1239, 1560, 1883, 2471, 2873, 3244, 3952, 4506, 4813, 5052, 5747, 6372, 7077, 7435, 8044, 8568, 9305, 9868, 10370, 10671, 11490, 12286, 12738, 13376, 13712, 14218]","[0, 169, 410, 741, 994, 1323, 2226, 2656, 3116, 3404, 3991, 4500, 4977, 5733, 6192, 6505, 7183, 7631, 7979, 8787, 9190, 9629, 10161, 10675, 10880, 11158, 11621, 11948, 12044, 12269]","[0, 169, 259, 349, 596, 783, 1100, 1557, 1922, 2027, 2209, 2519, 2648, 3062, 3546, 3868, 4322, 4417, 4681, 5145, 5458, 5725, 6181, 6515, 6767, 7045, 7205, 7665, 7851, 8709]","[0, 169, 259, 349, 555, 691, 931, 1178, 1344, 1434, 1687, 1867, 1957, 2223, 2590, 3089, 3756, 4205, 4490, 4672, 4991, 5369, 5610, 6151, 6477, 7241, 7410, 7624, 7843, 8122]",19635,14218,12269,8709,8122,-704,2840,-137,-2317,-628,-946,30,dire
7552191700,15,106,97,110,51,"[253, 609, 906, 1072, 1366, 1661, 2165, 2549, 3034, 3626, 4297, 4870, 5555, 6524, 7003, 7818, 8324, 9189, 10049, 10910, 11711, 12716, 13740, 14181, 14935, 15630, 16795, 17355, 18476, 19303]","[331, 777, 953, 1334, 1568, 1974, 2398, 2648, 3065, 3544, 3883, 4220, 4467, 5153, 6134, 6802, 7916, 8212, 8743, 9635, 10462, 11220, 11838, 12642, 12889, 13278, 14608, 15217, 15643, 16928]","[205, 616, 796, 1162, 1581, 2154, 2621, 3206, 3745, 4312, 4534, 5149, 5873, 6278, 6712, 7288, 7993, 8668, 9419, 9978, 10697, 11513, 12147, 12948, 13532, 13660, 14965, 15276, 15665, 15922]","[176, 268, 380, 482, 703, 1262, 1442, 1599, 1823, 2080, 2246, 2440, 2905, 3397, 3752, 4209, 4519, 4649, 4898, 5201, 5600, 6120, 6467, 7129, 7444, 7681, 8644, 8815, 9229, 9791]","[515, 605, 741, 831, 921, 1011, 1191, 1301, 1499, 2002, 2496, 2729, 2824, 3424, 3616, 4043, 4544, 4745, 5063, 5351, 5605, 5918, 6231, 6700, 6942, 7111, 8549, 8765, 8984, 9155]",19303,16928,15922,9791,9155,89,17,137,86,65,"[204, 487, 727, 1121, 1332, 1648, 2127, 2570, 2988, 3398, 3934, 4462, 5275, 6290, 7041, 8109, 8831, 9991, 10814, 11565, 12255, 13245, 14318, 14936, 16606, 17520, 17615, 19025, 20004, 20970]","[326, 604, 1060, 1395, 1756, 1935, 2351, 2689, 3038, 3395, 3803, 4399, 5052, 5380, 5611, 6289, 6632, 7344, 7810, 8009, 8754, 9290, 9830, 10962, 11529, 11986, 12301, 13315, 13688, 14167]","[170, 489, 733, 1138, 1575, 1855, 2205, 2524, 2830, 3210, 3644, 4372, 5108, 5590, 6095, 6627, 6951, 7316, 7750, 8282, 8703, 9273, 9513, 9967, 10373, 10596, 10691, 11313, 11409, 11802]","[170, 308, 563, 951, 1206, 1341, 1494, 1661, 2096, 2225, 2520, 2749, 3459, 3644, 4184, 4473, 4658, 4867, 5348, 5784, 6156, 6542, 6774, 7319, 8005, 8174, 8344, 8860, 9368, 9634]","[170, 260, 350, 485, 605, 749, 886, 976, 1087, 1452, 1847, 2145, 2741, 2872, 3301, 3570, 3804, 4129, 4509, 5234, 5555, 5649, 5951, 6364, 7396, 7857, 7952, 8691, 9275, 9396]",20970,14167,11802,9634,9396,-1667,2761,4120,157,-241,5130,30,radiant
7552353215,120,41,96,58,33,"[407, 617, 984, 1409, 1808, 1978, 2480, 3247, 3859, 4473, 4804, 5214, 6056, 6951, 7126, 7739, 8857, 9671, 10419, 10983, 11503, 11767, 12137, 12728, 13695, 14687, 15467, 16430, 17911, 18392]","[141, 351, 598, 930, 1055, 1473, 1599, 2305, 2867, 3203, 3791, 4217, 4769, 5080, 5417, 5659, 6251, 7029, 7668, 8298, 8883, 9398, 10232, 10942, 11159, 11865, 12879, 13200, 13427, 14125]","[141, 389, 729, 858, 1189, 1562, 1871, 2085, 2271, 2656, 2900, 2990, 3585, 3911, 4359, 4713, 6295, 6672, 6946, 7588, 8305, 9059, 9237, 9712, 10522, 10956, 11281, 11612, 12215, 12733]","[141, 351, 557, 647, 737, 907, 1030, 1506, 1596, 1804, 1943, 2175, 2501, 2848, 3183, 3278, 3535, 3983, 4114, 4854, 5906, 6369, 6618, 6897, 7729, 8751, 9424, 9689, 10766, 11323]","[141, 544, 678, 805, 926, 1155, 1288, 1925, 2173, 2596, 2804, 3042, 3813, 4078, 4247, 4342, 4994, 5667, 6160, 6439, 6677, 6861, 7157, 7418, 8417, 9717, 9932, 10330, 10606, 10926]",18392,14125,12733,11323,10926,137,21,92,14,71,"[122, 599, 935, 1263, 1682, 2478, 3104, 3736, 4154, 4482, 4893, 5643, 5733, 6392, 7534, 8096, 8336, 9045, 9539, 10185, 10816, 12019, 12907, 13425, 14033, 14127, 15325, 16005, 16791, 17382]","[122, 359, 644, 1039, 1424, 1802, 2162, 2521, 3459, 4025, 4557, 5176, 5645, 6165, 7138, 8018, 8176, 8552, 9139, 9937, 10591, 11617, 12381, 12699, 13098, 13647, 14561, 15463, 15857, 16857]","[523, 928, 1214, 1565, 1946, 2194, 2723, 3083, 3295, 3914, 4398, 5033, 5328, 5423, 5975, 6558, 7072, 7578, 7783, 8257, 8834, 9356, 9931, 10780, 11404, 11498, 12150, 12935, 13112, 13988]","[122, 292, 382, 687, 863, 1143, 1361, 1821, 2002, 2440, 2734, 2907, 2997, 3240, 3571, 4089, 4316, 4747, 5290, 5448, 5849, 6303, 7000, 7312, 7758, 8641, 8892, 9359, 9611, 9899]","[122, 403, 493, 583, 751, 986, 1116, 1333, 1753, 2065, 2870, 3097, 3344, 3581, 4245, 4557, 5087, 5957, 6356, 6580, 6852, 7466, 8167, 8449, 8728, 8822, 9692, 10394, 10571, 10836]",17382,16857,13988,9899,10836,1010,-2732,-1255,1424,90,-1463,30,radiant
7552492602,94,13,96,121,83,"[630, 834, 1167, 1480, 2064, 2561, 3324, 3715, 4238, 4790, 5374, 6332, 7077, 7826, 8770, 9381, 10447, 12026, 13011, 13935, 14797, 15250, 16187, 17341, 18192, 18734, 19614, 20151, 21292, 22283]","[765, 1017, 1381, 1682, 2058, 2392, 2837, 3189, 3733, 4390, 4604, 5045, 5447, 5720, 5975, 6697, 7100, 7842, 8573, 9251, 10095, 10678, 11056, 12053, 12305, 13055, 13276, 13372, 14723, 15356]","[439, 960, 1064, 1429, 1893, 2428, 2912, 3039, 3678, 4005, 4629, 5182, 5655, 5864, 6469, 6627, 6827, 7357, 7846, 8490, 8957, 9518, 9887, 10693, 11106, 11845, 11941, 12485, 13346, 14040]","[393, 567, 657, 907, 1289, 1443, 1934, 2278, 2533, 2713, 2824, 3147, 3280, 3584, 3759, 4397, 4506, 5011, 5600, 5908, 6362, 6687, 6857, 7388, 7668, 7943, 8114, 8428, 9059, 9324]","[627, 764, 903, 1243, 1479, 1636, 1924, 2014, 2304, 2484, 2720, 3043, 3353, 3553, 4012, 4348, 4443, 5605, 5763, 6023, 6490, 6776, 6871, 7327, 7619, 7713, 7926, 8022, 8410, 8600]",22283,15356,14040,9324,8600,7,41,69,72,64,"[615, 965, 1525, 1772, 2375, 2745, 3113, 3691, 4147, 4738, 5718, 6025, 6760, 7793, 9180, 9595, 10164, 10501, 11156, 12076, 13182, 13912, 14628, 15660, 16366, 17002, 17545, 18612, 19286, 19960]","[436, 562, 975, 1198, 1578, 1727, 2117, 2830, 3140, 3573, 3830, 4308, 5361, 5733, 6431, 6666, 7291, 7670, 8279, 8585, 8862, 9108, 9642, 10382, 11023, 11735, 12858, 13688, 14361, 15226]","[292, 508, 824, 1004, 1194, 1460, 1550, 1961, 2501, 2757, 3167, 3659, 4145, 4291, 4906, 5435, 5781, 6152, 6297, 6602, 7191, 7609, 8057, 8410, 8768, 9173, 10210, 10501, 10838, 11218]","[219, 309, 399, 489, 579, 669, 759, 1053, 1340, 1430, 1651, 2147, 2662, 2757, 3396, 3491, 3739, 4304, 4638, 4898, 5212, 5535, 5897, 6067, 6237, 6648, 7784, 8079, 8536, 8754]","[219, 309, 399, 533, 729, 819, 954, 1219, 1523, 1613, 1703, 2010, 2818, 3091, 3779, 4052, 4433, 4628, 4725, 5098, 5412, 5653, 5823, 5993, 6555, 6724, 7307, 7568, 7820, 8306]",19960,15226,11218,8754,8306,2323,130,2822,570,294,6139,30,radiant
7552498805,129,13,21,65,5,"[1818, 2015, 2604, 3010, 3732, 3913, 4450, 5697, 5792, 6333, 6817, 7619, 8316, 9265, 9845, 10667, 12020, 12480, 13024, 13369, 14107, 15053, 15755, 16255, 17038, 17603, 18504, 19001, 19555, 20804]","[1884, 2197, 2612, 3024, 3333, 4101, 4684, 5316, 5687, 6106, 6727, 7865, 9024, 9606, 10107, 11154, 12470, 13194, 13395, 14181, 14827, 15629, 16568, 17103, 17402, 18401, 18591, 18912, 19012, 20276]","[1642, 1852, 2066, 2407, 2911, 3079, 3333, 3710, 4159, 4575, 4984, 5515, 6820, 7331, 7919, 8695, 9774, 10333, 10428, 11457, 12169, 12973, 14069, 14165, 14803, 15166, 16219, 16768, 17465, 18608]","[986, 1147, 1639, 1869, 2388, 2730, 2855, 3328, 3620, 4218, 4594, 5322, 5949, 6484, 6904, 7337, 7658, 8341, 8815, 9235, 9844, 10106, 10433, 10838, 11245, 11751, 12425, 12687, 13204, 13956]","[1094, 1255, 1562, 1712, 2153, 2426, 2584, 2912, 3213, 3427, 3522, 3750, 4636, 4809, 4904, 5337, 5766, 5861, 5956, 6301, 6540, 6931, 7310, 7406, 7583, 7783, 8232, 8416, 8516, 10007]",20804,20276,18608,13956,10007,90,14,112,20,100,"[1707, 2481, 2866, 3415, 4186, 4948, 5293, 5504, 5920, 6674, 6977, 7319, 7572, 8051, 8439, 8787, 9343, 10172, 10939, 11659, 12270, 12784, 13642, 14594, 15127, 15689, 16750, 18229, 19060, 20141]","[1831, 2105, 2609, 2950, 3468, 4039, 4585, 5199, 5920, 6560, 7069, 7584, 8180, 8764, 9274, 9907, 10242, 11683, 12489, 13411, 14032, 14752, 15698, 17404, 17827, 18499, 19666, 20946, 21883, 23322]","[1002, 1306, 1979, 2269, 2790, 3327, 3847, 4204, 4837, 5748, 6226, 6448, 6739, 7304, 7624, 7852, 8187, 8682, 9192, 9722, 9919, 10494, 10907, 11003, 11617, 12113, 12601, 13147, 14105, 14437]","[977, 1244, 1538, 1871, 2411, 2838, 3089, 3224, 3940, 4417, 4791, 5047, 5142, 5569, 6036, 6130, 6646, 7831, 8246, 8449, 8756, 9500, 10028, 10457, 10761, 10904, 11483, 11938, 12597, 13104]","[879, 1252, 1499, 1676, 2455, 2851, 3044, 3179, 3515, 3848, 4250, 4610, 4705, 4800, 5021, 5115, 5450, 5859, 6116, 6511, 6606, 6982, 7241, 7862, 8039, 8216, 9079, 9476, 10056, 10470]",20141,23322,14437,13104,10470,663,-3046,4171,852,-463,2177,30,radiant
7552578103,95,25,112,86,19,"[252, 671, 1006, 1440, 1715, 2129, 2747, 3419, 3986, 4384, 4736, 5299, 6079, 6274, 7302, 8171, 8799, 9553, 10350, 10773, 12029, 13390, 13924, 14490, 16223, 17067, 17813, 18839, 19672, 20944]","[333, 777, 1142, 1538, 1964, 2411, 2757, 3220, 4038, 4615, 5348, 5900, 7302, 8106, 8688, 8845, 9105, 9572, 10286, 11599, 12346, 13479, 14419, 15219, 16065, 17122, 17576, 18397, 18958, 19755]","[205, 551, 826, 1235, 1596, 1995, 2456, 2911, 3284, 3752, 4285, 4591, 5188, 5569, 5924, 6460, 6663, 6896, 7301, 7569, 8153, 8521, 9147, 9486, 10285, 10969, 11710, 12158, 12407, 12931]","[170, 695, 889, 1019, 1230, 1567, 1906, 2042, 2349, 2524, 2614, 2788, 3527, 3729, 4107, 4454, 4614, 5135, 5465, 6120, 6492, 6935, 7301, 7660, 8234, 8773, 9052, 9410, 9720, 10499]","[170, 514, 604, 810, 900, 1113, 1307, 1514, 2047, 2182, 2272, 2554, 3113, 3589, 3927, 4132, 4521, 4849, 5076, 5650, 5948, 6316, 6607, 6993, 7293, 7566, 7861, 8383, 8786, 9103]",20944,19755,12931,10499,9103,49,1,105,14,20,"[325, 645, 1057, 1467, 1870, 2237, 2540, 3073, 3396, 4002, 4493, 4963, 5384, 5713, 6363, 6742, 7478, 7991, 9189, 9982, 10167, 10435, 11341, 12188, 12699, 13625, 14517, 15281, 15883, 16079]","[241, 434, 722, 955, 1232, 1474, 1653, 1743, 1939, 2347, 2728, 3123, 3747, 4289, 4869, 5697, 6379, 7135, 7697, 8559, 9434, 10048, 10143, 10998, 11622, 12181, 12658, 13689, 14273, 15407]","[170, 260, 397, 636, 1232, 1406, 1541, 1670, 1760, 2250, 2674, 2954, 3049, 3731, 4296, 5041, 5535, 5889, 6073, 6539, 6996, 7238, 7599, 8060, 8755, 9006, 9175, 9787, 10032, 10800]","[208, 498, 800, 1212, 1786, 2036, 2372, 2571, 2826, 3137, 3620, 4118, 4213, 4770, 5052, 5349, 5614, 5968, 6643, 6930, 7203, 7601, 7874, 8160, 8887, 9463, 9812, 10258, 10770, 11221]","[256, 346, 436, 561, 735, 950, 1090, 1180, 1270, 1815, 2047, 2270, 2400, 2697, 3117, 3540, 4051, 4537, 5038, 5399, 5584, 5751, 5846, 5940, 6197, 6567, 6661, 7454, 7550, 7993]",16079,15407,10800,11221,7993,4865,4348,2131,-722,1110,11732,30,radiant
7552578501,89,80,38,86,20,"[206, 452, 750, 960, 1171, 1579, 1985, 2563, 2936, 3508, 4220, 4971, 5947, 6638, 7501, 8371, 9776, 10732, 11433, 12643, 13233, 14164, 15046, 16729, 17785, 18913, 19999, 20997, 21901, 22583]","[300, 654, 1034, 1490, 1854, 2239, 2737, 3381, 4251, 4570, 5263, 5729, 6462, 7086, 7659, 8306, 8501, 8853, 9358, 10405, 10500, 10642, 10930, 11864, 12787, 13365, 13826, 15086, 15723, 16169]","[205, 369, 723, 1191, 1539, 2052, 2461, 2718, 3386, 3953, 4456, 4812, 5742, 6836, 7351, 7976, 8181, 8737, 9243, 9890, 10117, 10652, 11149, 12412, 13084, 13862, 14215, 14787, 14987, 15462]","[170, 304, 394, 976, 1141, 1648, 1965, 2271, 2631, 3263, 3587, 3785, 4692, 5092, 5486, 5927, 6092, 6528, 6930, 7434, 7529, 7624, 7830, 8580, 8926, 9378, 9519, 9998, 10094, 10438]","[170, 318, 425, 633, 769, 1214, 1374, 1594, 2054, 2439, 2597, 2893, 3654, 4362, 4668, 4889, 5054, 5437, 5666, 6237, 6332, 6665, 6971, 7803, 8246, 8514, 8806, 9514, 9610, 10471]",22583,16169,15462,10438,10471,41,137,92,26,19,"[205, 440, 601, 1039, 1478, 2030, 2377, 2676, 2934, 3551, 4053, 4722, 5289, 5486, 6000, 6539, 7387, 8234, 9129, 9224, 10901, 11632, 12593, 12842, 13541, 14130, 14473, 15166, 16053, 16828]","[201, 363, 568, 770, 1192, 1736, 2277, 2671, 2969, 3645, 4035, 4596, 5355, 5780, 6517, 7057, 8202, 8734, 9700, 10112, 10590, 11216, 11778, 12519, 12791, 13405, 13562, 14252, 14546, 14897]","[212, 529, 904, 1216, 1467, 2047, 2454, 3089, 3780, 4095, 4701, 4926, 5607, 5945, 6573, 7153, 8706, 9144, 9877, 10428, 11433, 12015, 12392, 12641, 13058, 13568, 13707, 14359, 14494, 14940]","[264, 354, 483, 688, 1196, 1425, 1560, 1780, 1960, 2197, 2703, 2848, 2943, 3038, 3223, 3380, 4167, 4392, 4781, 5304, 5971, 6816, 6985, 7347, 7964, 8351, 8578, 8866, 9148, 9657]","[232, 326, 460, 860, 950, 1294, 1514, 1787, 2025, 2294, 2565, 2828, 3099, 3241, 3620, 4227, 5049, 5144, 5807, 6349, 6875, 7428, 7725, 8413, 8717, 9069, 9367, 9544, 10291, 10912]",16828,14897,14940,9657,10912,5755,1272,522,781,-441,7889,30,dire
7552718510,48,65,112,19,91,"[0, 124, 425, 586, 787, 1103, 1545, 1964, 2377, 3051, 3791, 4656, 5270, 5990, 6328, 7211, 7956, 8741, 9874, 11028, 11990, 12912, 13657, 14625, 15791, 17085, 18946, 19969, 21306, 21988]","[0, 246, 565, 972, 1386, 1682, 2164, 2715, 3249, 4444, 4770, 5682, 6268, 6832, 7836, 8702, 9374, 9776, 11000, 11468, 12004, 12743, 12926, 13840, 14553, 15466, 15936, 16077, 16608, 17076]","[0, 158, 392, 673, 776, 1142, 1387, 1660, 1838, 2145, 2457, 2895, 3376, 3561, 3828, 4193, 5070, 5427, 5965, 6591, 7048, 7675, 8284, 8689, 8797, 9853, 10204, 11091, 11349, 12028]","[0, 90, 180, 270, 360, 702, 837, 1096, 1371, 1716, 2188, 2563, 2758, 3107, 3379, 3708, 4255, 4569, 5252, 5642, 5939, 6270, 6663, 6905, 7226, 8146, 8481, 8651, 8950, 9256]","[19, 211, 301, 408, 516, 665, 818, 953, 1301, 1537, 1755, 2079, 2179, 2322, 2625, 2855, 3194, 3351, 3850, 4078, 4384, 4780, 4947, 5114, 5208, 6060, 6396, 6491, 6958, 7189]",21988,17076,12028,9256,7189,98,25,33,7,20,"[0, 360, 725, 1094, 1224, 1520, 1798, 2193, 2778, 3371, 3998, 4442, 4765, 5282, 6149, 6320, 6690, 7372, 7854, 8796, 9424, 10288, 10887, 11679, 12260, 12873, 13043, 14082, 14834, 15586]","[0, 336, 566, 1004, 1429, 1682, 2384, 2984, 3392, 3814, 4181, 4602, 5002, 5577, 6285, 6697, 7776, 8442, 8816, 9572, 10356, 11318, 12066, 12749, 13203, 14014, 14109, 14814, 15666, 16301]","[0, 285, 694, 1045, 1416, 1794, 2125, 2577, 3029, 3398, 4187, 4300, 4702, 5249, 5753, 6056, 6306, 6812, 7084, 7565, 8008, 8505, 8717, 8948, 9369, 9775, 10129, 10809, 11146, 11518]","[0, 250, 340, 765, 940, 1074, 1164, 1254, 1414, 1549, 1971, 2061, 2562, 3007, 3726, 3999, 4215, 4358, 4453, 4674, 4769, 5168, 5380, 5739, 5837, 6249, 6665, 7294, 7657, 8007]","[0, 250, 469, 653, 901, 991, 1159, 1331, 1491, 1761, 1986, 2218, 2355, 2557, 2882, 3067, 3225, 3319, 3585, 3854, 4056, 4387, 4557, 4862, 5034, 5475, 5645, 5815, 6067, 6311]",15586,16301,11518,8007,6311,6402,775,510,1249,878,9814,30,radiant
7552731302,17,56,96,123,83,"[0, 254, 528, 1027, 1559, 2260, 2597, 2906, 3427, 4083, 4787, 5245, 6127, 6787, 7378, 8002, 8968, 9498, 9807, 10317, 10885, 12185, 12580, 13163, 13974, 15191, 16044, 16742, 17344, 18031]","[0, 164, 431, 770, 1058, 1345, 2006, 2261, 2468, 3055, 3422, 3916, 4571, 4937, 5720, 6408, 7086, 8439, 9129, 9868, 10297, 11518, 12088, 13149, 13992, 14717, 15389, 15897, 16169, 16786]","[0, 164, 396, 676, 1336, 1937, 2316, 2564, 3111, 3794, 4292, 5164, 5491, 6143, 6826, 7048, 7774, 8508, 8968, 9526, 10096, 10936, 11485, 11905, 12566, 14199, 14604, 15044, 15390, 16197]","[0, 130, 220, 710, 966, 1152, 1434, 1524, 1708, 1832, 2372, 2606, 2928, 3556, 4035, 4130, 4698, 5477, 5742, 6066, 6435, 7373, 7630, 7813, 8237, 8925, 9695, 10443, 10539, 11058]","[0, 130, 220, 354, 484, 618, 846, 981, 1116, 1321, 1456, 1830, 1999, 2403, 2803, 3037, 3461, 3803, 3898, 4512, 4762, 5257, 5760, 5956, 6123, 7038, 7378, 7624, 7720, 7937]",18031,16786,16197,11058,7937,48,82,129,58,45,"[0, 282, 515, 838, 1324, 1414, 1718, 2274, 2722, 3257, 3831, 4280, 4945, 5867, 6171, 6777, 7610, 8563, 9659, 10590, 11406, 12436, 12835, 14356, 15490, 16264, 16548, 18502, 19912, 21068]","[0, 281, 574, 838, 1219, 1805, 2371, 2706, 3143, 3345, 3671, 3944, 4076, 4463, 4942, 5531, 5987, 6242, 6865, 7414, 8025, 8481, 8576, 9167, 9654, 10121, 10216, 10809, 11772, 12829]","[0, 249, 683, 1115, 1497, 1967, 2498, 2826, 3358, 3736, 4173, 4902, 5431, 5613, 5809, 6265, 6433, 7989, 8084, 8635, 9169, 9263, 9441, 9859, 10106, 10321, 10523, 10618, 11291, 12116]","[0, 210, 325, 415, 642, 735, 911, 1120, 1340, 1669, 2080, 2418, 2696, 3047, 3430, 3679, 3837, 4206, 4610, 4768, 5050, 5251, 5524, 5942, 6480, 7164, 7669, 8366, 9508, 10309]","[0, 210, 369, 507, 597, 795, 1048, 1226, 1546, 1869, 2104, 2328, 2454, 2602, 2934, 3391, 3601, 4178, 4800, 5152, 5562, 5955, 6117, 6552, 7008, 7174, 7317, 7953, 8558, 9098]",21068,12829,12116,10309,9098,-3037,3957,4081,749,-1161,4589,30,dire
7552840615,72,114,97,105,65,"[383, 637, 917, 1242, 1623, 2163, 2609, 3193, 4116, 4607, 5255, 6090, 6744, 7047, 7591, 7916, 8729, 9773, 10536, 11104, 12952, 13700, 14501, 15495, 16030, 16362, 16964, 17653, 18224, 18516]","[228, 391, 654, 939, 1388, 1954, 2477, 2888, 3337, 3710, 4347, 4509, 5589, 6407, 6908, 7602, 8251, 8880, 9212, 9698, 10435, 11062, 11965, 12619, 13397, 13959, 14472, 15639, 16760, 17225]","[302, 550, 781, 1237, 1446, 1712, 2127, 2620, 3146, 3947, 4460, 5059, 5440, 6211, 6836, 7820, 8756, 9066, 9553, 10122, 11677, 12502, 12843, 13654, 14250, 14711, 15323, 15584, 16120, 16388]","[535, 625, 924, 1137, 1262, 1422, 1654, 1834, 2027, 2231, 2429, 2596, 2866, 3159, 3513, 4049, 4685, 5077, 5172, 5966, 7034, 7200, 7836, 8041, 8348, 9404, 10013, 10282, 10858, 11086]","[194, 302, 521, 667, 806, 1310, 1737, 2077, 2313, 2788, 3266, 3603, 3827, 4326, 4644, 4889, 5298, 5712, 6172, 6402, 6832, 7098, 7594, 8011, 8178, 9337, 9738, 9870, 10595, 10708]",18516,17225,16388,11086,10708,8,53,49,33,20,"[279, 592, 887, 1164, 1481, 1976, 2207, 2569, 3173, 3599, 3801, 4195, 4756, 5205, 5764, 6651, 7100, 7745, 8705, 9365, 10329, 10423, 11262, 11764, 12107, 13160, 13976, 15782, 16525, 16621]","[194, 284, 594, 724, 849, 939, 1105, 1296, 1699, 1917, 2042, 3134, 3482, 3631, 4778, 5357, 5988, 6500, 7300, 7725, 8957, 9051, 9551, 10094, 10444, 11576, 12592, 14308, 14485, 15084]","[230, 562, 847, 1168, 1363, 1570, 1877, 2447, 2915, 3947, 4554, 4956, 5105, 5603, 6145, 6878, 7300, 7431, 7560, 7979, 8854, 9338, 9828, 10349, 10744, 11882, 11977, 13215, 13897, 13993]","[266, 465, 1015, 1291, 1561, 1863, 2121, 2428, 2837, 3455, 3947, 4725, 5086, 5601, 6298, 6674, 6796, 7061, 7693, 8323, 8882, 9214, 9309, 9735, 9957, 10451, 10570, 11370, 11709, 12081]","[194, 284, 453, 605, 779, 931, 1021, 1385, 1565, 1888, 2126, 2478, 2665, 2814, 3342, 3590, 3724, 4064, 4421, 4671, 5167, 5437, 5607, 5849, 6019, 6967, 7274, 8402, 8703, 8799]",16621,15084,13993,12081,8799,1895,2141,2395,-995,1909,7345,30,radiant
7552909311,109,106,21,86,14,"[0, 206, 603, 854, 1273, 1648, 2277, 2678, 2940, 3180, 3591, 4020, 4720, 5527, 6327, 6817, 7911, 8362, 9328, 10332, 11835, 12886, 13987, 14980, 16071, 17242, 18717, 19269, 20204, 20495]","[0, 234, 435, 674, 919, 1385, 1806, 2119, 2574, 3075, 3424, 3907, 4403, 4826, 5251, 5839, 6234, 6744, 7575, 7857, 8557, 8902, 9416, 10010, 10863, 11380, 11634, 12141, 12879, 13482]","[0, 661, 991, 1409, 1740, 2111, 2401, 2831, 3151, 3753, 4094, 4608, 5256, 5574, 6279, 6899, 7354, 7951, 8273, 8577, 9122, 9559, 10100, 11125, 11950, 12507, 13403, 14009, 14507, 14677]","[0, 272, 780, 886, 1069, 1325, 1540, 1755, 1845, 2423, 2958, 3189, 3576, 4130, 4933, 5452, 5960, 6488, 6672, 6898, 7605, 7700, 8109, 9275, 9581, 9916, 10308, 10514, 10811, 10982]","[0, 234, 324, 414, 552, 742, 908, 1116, 1206, 1522, 1788, 2073, 2247, 2568, 2985, 3174, 3434, 4035, 4219, 4314, 4928, 5404, 5680, 6743, 6906, 7073, 7342, 7596, 8518, 8614]",20495,13482,14677,10982,8614,48,59,71,20,79,"[0, 329, 605, 1106, 1440, 1724, 2236, 2611, 2915, 3450, 3999, 4535, 5167, 5678, 6567, 7364, 8472, 9572, 10940, 11966, 12800, 13713, 14300, 15228, 15700, 16989, 17881, 18839, 20254, 21385]","[0, 208, 434, 797, 1052, 1394, 1831, 2779, 3220, 3624, 4604, 5534, 6264, 6828, 7383, 7963, 8240, 9213, 9868, 10622, 11240, 12284, 13340, 13847, 14129, 14918, 16463, 17368, 18732, 19494]","[0, 207, 422, 712, 921, 1287, 1850, 2183, 2901, 3232, 3663, 4127, 4703, 5066, 5160, 5693, 6173, 6946, 7416, 8003, 8187, 8810, 9034, 9566, 10059, 10400, 10732, 11062, 11481, 12045]","[0, 169, 560, 808, 1032, 1232, 1608, 1738, 1928, 2375, 2575, 3143, 3457, 4197, 4291, 4386, 4570, 5043, 5330, 5908, 6052, 6748, 7594, 7956, 8180, 8740, 9102, 9501, 10267, 10946]","[0, 169, 259, 423, 579, 669, 777, 1109, 1379, 1563, 2090, 2315, 2677, 3199, 3422, 3674, 3769, 4122, 4565, 5123, 5293, 5553, 6048, 6485, 6655, 7033, 7515, 7858, 8321, 8602]",21385,19494,12045,10946,8602,-890,-6012,2632,36,12,-4222,30,dire
7553035705,56,120,97,21,86,"[0, 286, 485, 735, 1131, 1385, 1671, 2278, 2680, 3212, 3562, 4566, 4850, 5476, 5799, 6013, 7848, 8342, 8910, 9594, 9741, 10195, 10576, 11290, 11385, 11519, 12302, 12568, 13109, 14247]","[0, 247, 498, 791, 1162, 1652, 2058, 2492, 2884, 3331, 3771, 4032, 4641, 5506, 6223, 6529, 7206, 7684, 7956, 8360, 9077, 9830, 10527, 11183, 11811, 11906, 12545, 13365, 14136, 14935]","[0, 205, 483, 898, 1152, 1552, 1797, 2208, 2721, 3123, 3586, 4099, 4717, 5349, 6068, 6537, 7475, 7979, 8239, 8770, 9610, 10027, 10292, 10752, 10847, 11498, 12001, 12893, 13838, 13934]","[0, 170, 260, 396, 486, 576, 666, 1396, 1737, 1925, 2052, 2464, 2554, 2882, 3407, 3546, 4317, 4766, 5342, 5592, 5760, 6717, 7256, 7714, 7809, 7904, 8392, 9150, 9765, 10121]","[0, 170, 260, 751, 889, 1238, 1449, 1629, 2091, 2583, 2758, 3044, 3134, 3448, 3597, 3738, 4509, 4604, 4800, 5068, 5225, 5871, 6040, 6693, 7108, 7477, 7746, 8194, 8574, 9029]",14247,14935,13934,10121,9029,48,106,96,84,112,"[0, 279, 579, 829, 1105, 1558, 1800, 2375, 2745, 3396, 3848, 4450, 5163, 5688, 6585, 7146, 7992, 8814, 9528, 10210, 11206, 12775, 13729, 14751, 15362, 16567, 17641, 18514, 19460, 20296]","[0, 256, 640, 1013, 1340, 1699, 2070, 2356, 2794, 3477, 4431, 5615, 6364, 7253, 7688, 8227, 9160, 10137, 11533, 12057, 13050, 13420, 13883, 15168, 15599, 17616, 18325, 18874, 19749, 21053]","[0, 280, 560, 994, 1198, 1786, 2039, 2238, 2635, 3039, 3453, 4018, 4308, 4655, 5039, 5401, 5762, 6554, 7286, 7496, 7872, 8850, 9437, 9709, 9804, 10516, 10979, 11573, 11959, 12476]","[0, 170, 260, 350, 440, 614, 786, 1009, 1099, 1456, 1591, 2120, 2210, 2510, 2730, 2931, 3936, 4448, 4905, 5100, 5377, 6231, 6397, 6673, 7044, 7821, 8619, 8962, 9303, 9701]","[0, 170, 260, 415, 572, 831, 921, 1011, 1148, 1515, 1781, 2310, 2473, 2825, 3088, 3289, 3574, 3669, 4097, 4713, 5127, 5256, 5552, 5915, 6010, 6331, 6717, 7314, 7655, 8068]",20296,21053,12476,9701,8068,-6049,-6118,1458,420,961,-9328,30,dire
7553046702,126,93,28,121,26,"[593, 1036, 1327, 1824, 2246, 2624, 2997, 3211, 3403, 3674, 3933, 4199, 4930, 5196, 5394, 6960, 7415, 8016, 8626, 8941, 9207, 9991, 10560, 11533, 12279, 13798, 14790, 15353, 16347, 16628]","[533, 886, 1538, 1882, 2242, 2645, 2934, 3339, 3843, 4411, 4914, 5382, 5694, 6241, 7014, 7963, 8716, 9211, 9844, 10674, 11370, 11651, 12218, 12737, 13996, 15282, 15949, 16045, 16407, 16507]","[492, 740, 1034, 1202, 1410, 1624, 1750, 2085, 2528, 2814, 3269, 3529, 3952, 4274, 4559, 5008, 5444, 5602, 5874, 6129, 6370, 6805, 7070, 7398, 7625, 7911, 8493, 8851, 9128, 9414]","[260, 432, 748, 981, 1106, 1521, 1611, 1871, 2063, 2362, 2543, 2691, 3083, 3501, 3634, 3971, 4193, 4351, 4572, 4700, 4906, 5125, 5397, 5761, 5892, 5987, 6474, 6707, 7105, 7570]","[260, 368, 614, 790, 1047, 1182, 1272, 1362, 1554, 1698, 1941, 2172, 2419, 2514, 3156, 3723, 3933, 4156, 4428, 4522, 4728, 4823, 4918, 5246, 5625, 6186, 6525, 6621, 6717, 6842]",16628,16507,9414,7570,6842,44,96,74,45,20,"[612, 977, 1179, 1701, 2240, 2809, 3520, 3849, 4457, 4784, 5388, 5975, 6719, 7335, 8152, 8728, 9486, 10662, 11364, 12021, 12788, 13190, 13958, 14643, 15423, 16212, 17403, 18225, 19182, 20544]","[478, 1023, 1298, 1793, 2036, 2548, 3032, 3209, 3611, 4011, 4494, 5143, 5972, 6417, 7203, 7428, 7691, 8172, 8485, 8579, 9003, 9816, 9997, 10229, 10888, 11243, 12197, 12814, 13339, 13901]","[343, 620, 789, 955, 1185, 1552, 1783, 2207, 2658, 3006, 3311, 3879, 4418, 4722, 5055, 5242, 5838, 6186, 6814, 7081, 7787, 8175, 8726, 8964, 9331, 9553, 10182, 10278, 10687, 11741]","[260, 398, 498, 682, 971, 1277, 1714, 2097, 2586, 2751, 2841, 3438, 4120, 4215, 4538, 4993, 5370, 5765, 5860, 5954, 6205, 6419, 6625, 7064, 7294, 7590, 8457, 8553, 9302, 9428]","[260, 421, 511, 893, 1123, 1539, 1761, 1851, 2348, 2438, 2528, 2886, 3626, 3841, 4089, 4183, 4381, 4539, 4634, 4910, 5160, 5327, 5713, 6289, 6519, 6654, 7179, 7275, 7575, 7675]",20544,13901,11741,9428,7675,-3916,2606,-2327,-1858,-833,-6328,30,dire
7553049303,48,21,47,30,119,"[0, 169, 467, 788, 1197, 1451, 1696, 1906, 2398, 2844, 3151, 3683, 4015, 4476, 5194, 5704, 6466, 7167, 7862, 8896, 10021, 10794, 12069, 12862, 14188, 14654, 15415, 16359, 17440, 18064]","[0, 329, 665, 1001, 1455, 1938, 2377, 2898, 3496, 4038, 4471, 5129, 5662, 6294, 7062, 7575, 8402, 9538, 10331, 10873, 11661, 12117, 13078, 13791, 15192, 15832, 16616, 17878, 18055, 18546]","[0, 250, 457, 754, 983, 1473, 1802, 2124, 2712, 3134, 3474, 4438, 4695, 5398, 5808, 6310, 6931, 7621, 8080, 8511, 8960, 9463, 10094, 10367, 10807, 11498, 12011, 13017, 13552, 13977]","[0, 169, 259, 349, 439, 578, 842, 932, 1352, 1618, 2132, 3056, 3146, 3524, 3831, 3925, 4797, 4937, 5164, 5865, 6306, 6492, 6768, 6902, 7428, 7730, 8262, 8939, 9321, 9591]","[0, 169, 310, 448, 555, 697, 1047, 1137, 1428, 1518, 1653, 2263, 2353, 2763, 3185, 3328, 4018, 4192, 4286, 4552, 4806, 4901, 5177, 5272, 5868, 6170, 6531, 7283, 7460, 7637]",18064,18546,13977,9591,7637,135,71,6,14,26,"[0, 256, 570, 942, 1279, 1600, 1982, 2773, 3282, 3596, 4040, 4130, 4848, 5041, 5488, 6247, 6738, 6833, 7297, 7916, 8218, 8624, 9087, 9493, 9763, 10451, 10636, 12049, 12618, 13277]","[0, 259, 387, 709, 992, 1382, 2134, 2705, 3026, 3280, 4029, 4212, 4791, 5043, 5426, 5793, 6111, 6367, 6826, 7496, 8184, 8960, 9641, 10242, 10413, 11119, 11412, 12102, 12777, 13323]","[0, 204, 440, 619, 896, 1031, 1324, 1516, 1727, 2005, 2304, 2658, 3072, 3594, 4024, 4387, 5039, 5134, 5388, 6274, 6472, 6757, 7537, 7959, 8696, 9287, 9965, 11129, 11743, 12318]","[0, 169, 308, 443, 533, 708, 1083, 1397, 1532, 1622, 2124, 2214, 2691, 2786, 2881, 3278, 3436, 3531, 3625, 4060, 4226, 4396, 4637, 4807, 5594, 5836, 6094, 7181, 7352, 7523]","[0, 169, 259, 349, 439, 569, 753, 1273, 1408, 1498, 1756, 1846, 2097, 2192, 2287, 2471, 2678, 2773, 2867, 3336, 3431, 3592, 3912, 4082, 4506, 4748, 5167, 6071, 6291, 6462]",13277,13323,12318,7523,6462,4787,5223,1659,2068,1175,14912,30,radiant
7553157112,70,20,98,136,83,"[0, 239, 536, 856, 1155, 1478, 1707, 2340, 2803, 3168, 3651, 4318, 5019, 5672, 6260, 7128, 7901, 8867, 9599, 10838, 11527, 12658, 13587, 13885, 14430, 15740, 16621, 17706, 19259, 20556]","[0, 208, 515, 852, 1566, 1959, 2610, 3504, 3966, 4418, 5178, 5792, 6523, 7109, 7649, 8458, 9210, 9428, 10253, 10765, 11129, 11704, 12078, 12438, 12743, 13738, 14636, 15272, 16678, 17847]","[0, 282, 576, 821, 1030, 1246, 1582, 1967, 2395, 2626, 3026, 3992, 4521, 5443, 5672, 6246, 6648, 7422, 8274, 9374, 10293, 10977, 11504, 12044, 13049, 13796, 13890, 15056, 16085, 17197]","[0, 170, 260, 452, 717, 1085, 1861, 2131, 2270, 2360, 2621, 3165, 3394, 3810, 3904, 4103, 4672, 4830, 5471, 6082, 6582, 6677, 6843, 6938, 7578, 8082, 8500, 8730, 9568, 10309]","[0, 216, 306, 481, 620, 756, 916, 1186, 1276, 1437, 1701, 2457, 2671, 3050, 3299, 3561, 3875, 4059, 4707, 5098, 5198, 5400, 5615, 5710, 6079, 6403, 6781, 7387, 8153, 8939]",20556,17847,17197,10309,8939,48,39,29,123,100,"[0, 243, 537, 957, 1116, 1376, 1466, 1750, 2139, 2828, 3068, 3593, 4263, 5553, 6085, 7013, 7951, 8645, 8987, 9645, 10298, 11571, 13013, 13686, 14024, 14965, 16459, 16554, 17353, 17612]","[0, 280, 553, 884, 1339, 1786, 2016, 2369, 2789, 3426, 3806, 4287, 4779, 6333, 6686, 7097, 7902, 8250, 8918, 10075, 10659, 11744, 12505, 13164, 13875, 14209, 15481, 16153, 16796, 17184]","[0, 241, 455, 832, 1197, 1535, 1854, 2330, 2737, 3284, 3718, 3986, 4705, 5477, 5571, 5891, 6758, 7426, 8130, 8642, 8979, 9294, 10386, 10791, 11001, 11336, 11704, 11862, 11980, 12479]","[0, 170, 260, 368, 458, 637, 727, 862, 1212, 1485, 1575, 1903, 2236, 2480, 2752, 2955, 3306, 3538, 3828, 4448, 4633, 5263, 5731, 6075, 6706, 6926, 7487, 7620, 7754, 8013]","[0, 170, 260, 430, 903, 1071, 1199, 1334, 1509, 1711, 1848, 2071, 2309, 2753, 2971, 3174, 3422, 3629, 3803, 4066, 4466, 4783, 5266, 5361, 5501, 5920, 6429, 6524, 6829, 7088]",17612,17184,12479,8013,7088,2944,663,4718,2296,1851,12472,30,radiant
7553455115,8,126,96,9,121,"[0, 453, 821, 1185, 1708, 2213, 2690, 3028, 3553, 3851, 4611, 5283, 5827, 6668, 7310, 7882, 8627, 9464, 9964, 10846, 11512, 12317, 13230, 13684, 15204, 16103, 17330, 19503, 20714, 21723]","[0, 365, 683, 1026, 1358, 1730, 1974, 2384, 2759, 3197, 3703, 4420, 4901, 5578, 6001, 6333, 6831, 7347, 7964, 8564, 8906, 9319, 10005, 10461, 11537, 12914, 14008, 15040, 15768, 16993]","[0, 258, 456, 773, 1112, 1499, 1657, 2198, 2367, 2477, 3184, 3646, 4063, 4567, 4804, 5173, 5705, 6241, 6482, 7041, 7235, 7461, 7675, 7827, 8696, 9249, 9939, 10292, 10752, 10995]","[0, 210, 300, 435, 604, 789, 928, 1247, 1581, 1936, 2396, 2673, 3000, 3369, 3916, 4099, 4413, 4632, 4837, 5538, 5903, 6076, 6405, 6656, 7168, 7934, 8799, 9474, 10087, 10378]","[0, 282, 372, 462, 624, 828, 991, 1395, 1529, 1638, 1993, 2234, 2373, 2784, 3127, 3304, 3461, 3829, 4075, 4809, 4981, 5382, 5767, 6032, 6748, 6990, 7649, 8428, 8852, 9121]",21723,16993,10995,10378,9121,120,56,97,83,86,"[0, 314, 686, 1066, 1368, 1904, 2415, 2748, 3279, 3912, 4312, 4574, 5094, 5851, 6716, 8069, 8914, 9620, 10983, 11662, 12079, 12631, 13360, 14468, 14942, 15211, 16191, 16825, 17828, 18545]","[0, 274, 594, 974, 1182, 1592, 2045, 2670, 3300, 3774, 4231, 4702, 5242, 5678, 6442, 7411, 8118, 8276, 8941, 9619, 9987, 10722, 11455, 12778, 13351, 14091, 14186, 15363, 15825, 16147]","[0, 200, 327, 655, 1245, 1527, 1828, 2228, 2357, 2528, 2933, 3077, 3562, 3835, 4102, 4599, 5267, 5770, 6278, 6862, 7203, 7846, 8157, 8962, 9485, 9705, 9872, 10272, 10450, 10546]","[0, 468, 558, 692, 826, 916, 1143, 1390, 1480, 1614, 1794, 2006, 2144, 2450, 2966, 3670, 3925, 4268, 4828, 5096, 5394, 5536, 5835, 6720, 7024, 7319, 7526, 8430, 8683, 8953]","[0, 231, 408, 498, 669, 759, 939, 1396, 1520, 1610, 1872, 1972, 2108, 2257, 2613, 2930, 3346, 3736, 4554, 5042, 5136, 5231, 5398, 5692, 5921, 6016, 6111, 6215, 6393, 6489]",18545,16147,10546,8953,6489,3178,846,449,1425,2632,8530,30,radiant
7553527512,13,42,2,86,85,"[0, 207, 456, 663, 1078, 1456, 1713, 1971, 2419, 2547, 2760, 2850, 4527, 5009, 5409, 6662, 7316, 8223, 8682, 8776, 9035, 9130, 9748, 10806, 12214, 12788, 13327, 14211, 14554, 16009]","[0, 294, 657, 1453, 1782, 2108, 2404, 2888, 3391, 3636, 4065, 4366, 5295, 5983, 6311, 7202, 7873, 8675, 9034, 9296, 9872, 10117, 10535, 11076, 11759, 12525, 13032, 13864, 14722, 16065]","[0, 206, 437, 753, 949, 1388, 1665, 1852, 2242, 2688, 3061, 3425, 3781, 4467, 4834, 5480, 6164, 6549, 6779, 6873, 7430, 7871, 8409, 10675, 11274, 12035, 12405, 13549, 13964, 14986]","[0, 170, 260, 366, 514, 692, 826, 1168, 1342, 1432, 1643, 2037, 2773, 3158, 3704, 4634, 4792, 5035, 5207, 5443, 6392, 6761, 7287, 8655, 9559, 10419, 10952, 11315, 11795, 12422]","[0, 170, 260, 528, 662, 839, 929, 1067, 1618, 1708, 1844, 1934, 2638, 2971, 3112, 3730, 4047, 4744, 4974, 5068, 5209, 5485, 5579, 6458, 7069, 7501, 7757, 8373, 8674, 10177]",16009,16065,14986,12422,10177,15,128,71,19,7,"[0, 292, 579, 914, 1411, 1884, 2357, 2773, 3557, 4379, 4923, 5466, 5967, 6849, 7585, 8098, 8702, 9302, 10484, 11635, 12763, 13225, 13515, 14480, 15000, 16280, 16843, 18839, 19859, 20634]","[0, 205, 412, 629, 997, 1175, 1533, 1861, 2266, 2681, 3060, 3445, 3762, 4285, 4715, 4809, 5402, 6040, 6890, 7490, 7912, 8431, 9460, 9869, 10105, 10459, 11246, 12020, 13200, 13489]","[0, 170, 260, 458, 748, 956, 1135, 1277, 1608, 2189, 2437, 3383, 3563, 4108, 4696, 5070, 5700, 6848, 7504, 7771, 8651, 9267, 9474, 10154, 10249, 10668, 11480, 12030, 12845, 13393]","[0, 329, 720, 1073, 1523, 1930, 2623, 3007, 3420, 4011, 4548, 4904, 5160, 5255, 5956, 6050, 6418, 7935, 9228, 9618, 10149, 10522, 11142, 11748, 11843, 12238, 12981, 13907, 14175, 15164]","[0, 170, 260, 350, 485, 625, 889, 1062, 1326, 1462, 1597, 1777, 2165, 2446, 2909, 3148, 3357, 3630, 4487, 4934, 5320, 5750, 6133, 6474, 6623, 7366, 7541, 7985, 8570, 9410]",20634,13489,13393,15164,9410,-4625,2576,1593,-2742,767,-2431,30,dire
7553532818,54,106,97,26,30,"[244, 570, 986, 1236, 1559, 2003, 2593, 3204, 3638, 4058, 4524, 5137, 5569, 6465, 7051, 7834, 8176, 8990, 9690, 10349, 10851, 11322, 11787, 12643, 13477, 14864, 15850, 17718, 18519, 19250]","[240, 450, 741, 1087, 1347, 1570, 2098, 2459, 2558, 3183, 3416, 3954, 4477, 5015, 5404, 5914, 6857, 7378, 8082, 8584, 9164, 9468, 10503, 11032, 11846, 12484, 12847, 13741, 15520, 15826]","[544, 840, 1044, 1669, 2107, 2681, 3018, 3260, 3640, 4326, 4853, 5241, 5812, 6111, 6663, 6920, 7349, 7826, 8900, 9183, 9481, 9576, 10224, 10390, 10945, 11257, 11385, 12401, 13216, 13718]","[277, 367, 457, 706, 823, 1034, 1286, 1376, 1466, 1913, 2003, 2264, 2461, 3408, 3730, 3824, 4171, 4313, 4634, 4963, 5094, 5217, 5652, 5897, 6439, 6735, 6829, 7251, 7649, 8100]","[170, 260, 365, 455, 545, 635, 887, 1117, 1207, 1388, 1478, 1693, 2231, 2872, 3082, 3358, 3939, 4119, 4277, 4461, 5087, 5218, 5355, 5860, 6117, 6520, 6818, 7549, 7921, 8017]",19250,15826,13718,8100,8017,73,49,96,58,112,"[337, 761, 1025, 1232, 1807, 2023, 2765, 3816, 4601, 5588, 6044, 7220, 8215, 9592, 10634, 11639, 12221, 12990, 13514, 14158, 15012, 16097, 17303, 17921, 19006, 19783, 20577, 21490, 21748, 21979]","[340, 662, 981, 1252, 1780, 2031, 2587, 3346, 4036, 4624, 4874, 4964, 5468, 6438, 6833, 7847, 8314, 8983, 9583, 10517, 11145, 11564, 12067, 12615, 12782, 13552, 14377, 15323, 16240, 17024]","[205, 567, 869, 1101, 1901, 2444, 2699, 3283, 3591, 4255, 4850, 5297, 6175, 6602, 7188, 7635, 7906, 8351, 8943, 9514, 9658, 9979, 11002, 11232, 12328, 12952, 13751, 14499, 14906, 15303]","[170, 260, 463, 571, 736, 955, 1110, 1637, 2102, 2505, 2655, 2782, 2942, 3451, 3809, 4410, 4617, 5123, 5605, 5834, 6159, 6693, 7262, 7444, 7729, 7908, 8525, 8831, 9008, 9457]","[170, 260, 350, 454, 824, 914, 1359, 1508, 1894, 2119, 2308, 2398, 2558, 2825, 3167, 3511, 3905, 4229, 4564, 4793, 5131, 5368, 6017, 6183, 6439, 6650, 7235, 7794, 7971, 8293]",21979,17024,15303,9457,8293,-2729,-1198,-1585,-1357,-276,-7145,30,dire
7553597819,82,2,11,53,64,"[0, 337, 659, 1109, 1733, 2226, 2803, 3435, 4204, 4962, 5652, 6527, 6962, 7627, 8339, 8830, 10048, 10946, 11716, 13554, 14591, 16108, 16274, 17072, 17995, 18430, 19414, 20277, 20454, 21090]","[0, 288, 554, 678, 1132, 1367, 1712, 2128, 2528, 2775, 3287, 3750, 4497, 5281, 6518, 6781, 7183, 7578, 8546, 9102, 9750, 10392, 11620, 11909, 12642, 14256, 15050, 15145, 16244, 16805]","[0, 582, 822, 1194, 1524, 1877, 2201, 2736, 2945, 3390, 3657, 4316, 4832, 5272, 5696, 6269, 6734, 7200, 7716, 8795, 9467, 10042, 10626, 11003, 11314, 11481, 12151, 12613, 13305, 13643]","[0, 518, 608, 823, 1053, 1143, 1363, 1821, 2084, 2435, 3221, 3588, 4056, 4569, 5186, 5454, 5734, 6276, 7500, 8245, 8430, 8756, 9294, 9937, 10248, 10510, 10938, 11175, 11380, 11985]","[0, 198, 288, 423, 513, 832, 966, 1264, 1400, 1695, 1987, 2212, 2386, 2625, 2766, 2954, 3049, 3203, 3406, 4042, 4345, 4576, 4742, 4837, 5120, 5378, 5472, 5867, 6044, 6272]",21090,16805,13643,11985,6272,7,59,49,72,85,"[0, 368, 761, 1058, 1515, 1918, 2526, 2952, 3648, 4223, 4739, 5233, 5819, 6135, 6857, 7291, 8061, 8837, 9367, 9862, 10698, 11167, 12420, 14110, 14631, 15189, 15845, 17190, 17894, 18500]","[0, 280, 691, 1192, 1558, 1926, 2245, 2819, 3277, 3650, 4382, 4782, 5123, 5796, 6366, 6712, 7203, 7912, 8440, 9308, 10047, 10882, 11688, 12411, 12962, 13700, 13794, 14533, 15603, 16593]","[0, 244, 541, 870, 1073, 1486, 1865, 2483, 2868, 3611, 4439, 4700, 4926, 5557, 6296, 6796, 7380, 8031, 8232, 8819, 10021, 10417, 10826, 11431, 13252, 13649, 14346, 14912, 15604, 16069]","[0, 210, 374, 510, 600, 725, 919, 1188, 1343, 1712, 1982, 2213, 2380, 2810, 3087, 3182, 3540, 3827, 4217, 4714, 5274, 5542, 6175, 7509, 7675, 8113, 8489, 10007, 10355, 11266]","[0, 210, 325, 691, 781, 951, 1076, 1256, 1346, 1436, 1754, 1896, 1986, 2306, 2823, 3131, 3364, 3881, 4082, 4177, 4958, 5180, 5783, 6163, 6864, 7678, 7772, 8766, 9114, 9513]",18500,16593,16069,11266,9513,2590,212,-2426,719,-3241,-2146,30,radiant
7553654119,90,32,97,45,83,"[410, 738, 1073, 1460, 1828, 2350, 2942, 3416, 4021, 4318, 4949, 5523, 6341, 7435, 7873, 8286, 9052, 9750, 10886, 11319, 11821, 12272, 12790, 13593, 14622, 15966, 16494, 17221, 17592, 18360]","[144, 431, 628, 849, 1140, 1492, 1713, 2085, 2363, 2621, 3016, 3310, 3798, 4566, 4935, 5400, 5711, 6614, 7081, 7742, 8169, 8595, 8816, 9279, 9922, 10279, 10858, 12006, 12267, 12826]","[144, 350, 582, 732, 1320, 1582, 2111, 2860, 3294, 3818, 4324, 4782, 5705, 6345, 7065, 7591, 8739, 9343, 9911, 10447, 10811, 11520, 11702, 12311, 12840, 13081, 13730, 14449, 14816, 15187]","[144, 463, 553, 703, 793, 912, 1096, 1383, 1489, 1579, 1971, 2146, 2402, 2658, 2870, 3174, 3731, 4326, 4681, 4954, 5256, 5636, 5731, 5993, 6263, 6620, 7179, 7366, 7462, 7648]","[72, 242, 332, 532, 666, 756, 1024, 1199, 1336, 1426, 1562, 1768, 2002, 2491, 2679, 2939, 3424, 3983, 4494, 4767, 4861, 5064, 5246, 5341, 5611, 5995, 6274, 6369, 6465, 6651]",18360,12826,15187,7648,6651,120,21,51,23,112,"[119, 433, 803, 1048, 1638, 2094, 2586, 2879, 3517, 3973, 4588, 4906, 5611, 6112, 6725, 7247, 8092, 8464, 9323, 10094, 11590, 12556, 13689, 14240, 14754, 15123, 15909, 17102, 17788, 18215]","[119, 386, 754, 1171, 1597, 1910, 2270, 2574, 2748, 3309, 3733, 4047, 4666, 5212, 5614, 6078, 7154, 7371, 7933, 9118, 10011, 10268, 11947, 12699, 12906, 14021, 14363, 15124, 15859, 16413]","[119, 348, 438, 595, 760, 1060, 1158, 1280, 1428, 1518, 1792, 2005, 2272, 2508, 2603, 2907, 3313, 3407, 3666, 4216, 4755, 4850, 5793, 6510, 6713, 7694, 8199, 9310, 9697, 10331]","[252, 382, 764, 1120, 1475, 1761, 2109, 2593, 3290, 3737, 4147, 4634, 5372, 5886, 5981, 6867, 7275, 7538, 7827, 8673, 9256, 9827, 10613, 11241, 11435, 12096, 12878, 13769, 14176, 14362]","[387, 714, 804, 1005, 1180, 1305, 1444, 1582, 1845, 1956, 2400, 2572, 2817, 3291, 3482, 3850, 4374, 4484, 4890, 5487, 6227, 6390, 6996, 7252, 7530, 8895, 9363, 9825, 10419, 10724]",18215,16413,10331,14362,10724,145,-3587,4856,-6714,-4073,-9373,30,dire
7553708506,10,19,69,100,86,"[0, 478, 887, 1062, 1989, 2481, 2690, 2825, 3162, 3695, 4705, 5264, 5742, 6182, 6987, 8140, 8773, 9486, 10620, 11776, 12568, 13297, 14742, 15824, 16558, 17858, 18786, 19614, 21173, 22459]","[0, 248, 576, 957, 1295, 1716, 2190, 2532, 3252, 3506, 4243, 4455, 4712, 5175, 5657, 6538, 6912, 7213, 7952, 8773, 9119, 9402, 10413, 11101, 11674, 13272, 13583, 14046, 14907, 15864]","[0, 201, 291, 554, 885, 1075, 1906, 2085, 2331, 2561, 3035, 3491, 3906, 4133, 4761, 5247, 5697, 6220, 6818, 7128, 7382, 7690, 8211, 8600, 9283, 9693, 10442, 11106, 11718, 12277]","[0, 220, 310, 400, 759, 889, 1147, 1237, 1423, 1618, 2059, 2149, 2239, 2334, 2483, 3070, 3645, 4053, 4895, 5143, 5293, 5697, 5977, 6410, 6614, 7412, 7798, 8159, 8861, 9856]","[0, 174, 264, 354, 490, 620, 797, 887, 1368, 1748, 2163, 2253, 2392, 2523, 2824, 3242, 3575, 3670, 3925, 4408, 4517, 4823, 5073, 5304, 5623, 6498, 7007, 7351, 7960, 8708]",22459,15864,12277,9856,8708,52,6,71,85,26,"[328, 609, 861, 1367, 1786, 2201, 2330, 2625, 2977, 3790, 4540, 5158, 5669, 6315, 6627, 6807, 7310, 7773, 8739, 9478, 10205, 10716, 11407, 11919, 13231, 13416, 13793, 14359, 15485, 16661]","[60, 355, 708, 1039, 1270, 1697, 1945, 2408, 2730, 3206, 3766, 4311, 4845, 5450, 5856, 6135, 7121, 7590, 8245, 9055, 9766, 10250, 10930, 11616, 12419, 12672, 13336, 14059, 14884, 15325]","[60, 307, 795, 1119, 1379, 1731, 2218, 2554, 2798, 2888, 3028, 3458, 4059, 4627, 4769, 5109, 5876, 6200, 6706, 8376, 8747, 9251, 9493, 9931, 10441, 10739, 11486, 12103, 12447, 13340]","[60, 269, 359, 449, 838, 1036, 1351, 1593, 1756, 1925, 2177, 2503, 2682, 3175, 3270, 3503, 4100, 4413, 4626, 5073, 5528, 5623, 5804, 6195, 6858, 7043, 7505, 7841, 8110, 8433]","[60, 269, 423, 513, 647, 777, 867, 1266, 1401, 1625, 1854, 2123, 2298, 2800, 3024, 3119, 3744, 3948, 4221, 4881, 5160, 5255, 5536, 6239, 7023, 7208, 7438, 7892, 8149, 8544]",16661,15325,13340,8433,8544,5798,539,-1063,1423,164,6861,30,radiant
7554078113,89,19,14,128,26,"[364, 954, 1083, 1407, 1688, 2004, 2189, 2591, 2826, 3437, 3868, 4605, 5453, 6039, 6976, 8009, 8432, 9137, 9848, 10782, 11646, 12759, 13952, 15293, 16659, 17433, 19158, 20128, 20648, 21183]","[569, 830, 1126, 1491, 2267, 2760, 3172, 3735, 4654, 5351, 5841, 5971, 6616, 6710, 7312, 8165, 9019, 9516, 10102, 10197, 11002, 12472, 13006, 13370, 14027, 14379, 15569, 16846, 17105, 17578]","[365, 812, 1125, 1290, 1773, 2065, 2286, 2687, 3223, 3769, 4320, 5306, 5837, 6030, 6575, 6917, 7848, 8109, 8544, 8823, 9276, 10334, 10612, 11199, 12158, 12755, 13810, 14430, 14801, 15535]","[305, 440, 657, 747, 982, 1168, 1306, 1497, 1843, 2115, 2642, 2990, 3193, 3287, 3542, 3781, 4107, 4266, 4728, 4948, 5181, 5927, 6169, 6411, 7081, 7394, 8080, 8939, 9300, 9569]","[357, 609, 699, 789, 879, 1059, 1324, 1563, 1837, 2117, 2393, 2626, 2829, 2923, 3243, 3474, 3675, 3941, 4099, 4194, 4483, 4758, 4925, 5092, 5571, 5666, 6145, 6689, 6948, 7077]",21183,17578,15535,9569,7077,21,120,102,123,85,"[879, 1163, 1798, 2256, 2721, 3225, 3826, 4488, 5212, 5703, 6210, 6950, 7223, 7855, 8397, 9038, 9505, 9797, 10559, 10897, 11601, 12183, 12497, 12828, 13126, 13332, 13866, 14350, 15080, 15444]","[534, 696, 1032, 1419, 1543, 2360, 2909, 3423, 3894, 4594, 4842, 5516, 5965, 6659, 7709, 8569, 9162, 9605, 10310, 10850, 11432, 11527, 12133, 12546, 13168, 13797, 14118, 14380, 15583, 16136]","[509, 649, 1022, 1244, 1843, 2416, 2926, 3190, 3712, 4313, 4632, 5571, 6302, 6563, 7535, 8125, 8767, 9376, 9921, 10561, 11099, 11376, 11748, 12778, 13530, 14100, 14415, 15136, 17415, 18205]","[370, 460, 887, 1035, 1200, 1521, 1631, 1971, 2177, 2441, 2746, 3478, 3617, 3995, 4599, 4829, 4924, 5018, 5176, 5339, 5617, 5953, 6217, 6447, 6861, 6956, 7169, 7452, 8523, 8905]","[550, 739, 957, 1093, 1476, 1656, 1816, 2052, 2292, 2472, 2708, 3534, 3673, 4470, 4968, 5153, 5351, 5533, 5691, 5887, 6079, 6281, 6644, 7202, 7673, 7843, 8095, 8572, 8743, 9248]",15444,16136,18205,8905,9248,5739,1442,-2670,664,-2171,3004,30,radiant
7554125309,82,112,40,19,26,"[64, 310, 544, 861, 1266, 1590, 1889, 2328, 2706, 2882, 3568, 4077, 4484, 4922, 5072, 5576, 6148, 6455, 7204, 7629, 8415, 8878, 9414, 10492, 11188, 11922, 12188, 12804, 13477, 13573]","[332, 704, 1112, 1472, 1928, 2375, 2738, 3080, 3615, 4033, 4833, 5131, 5376, 5806, 6551, 7037, 7361, 7664, 7968, 8621, 8817, 9364, 9755, 10421, 10689, 10784, 11337, 11844, 12726, 13161]","[64, 272, 536, 669, 1053, 1220, 1434, 1615, 1845, 2247, 2909, 3263, 3681, 4066, 5624, 5990, 6256, 6755, 7127, 7417, 7860, 8013, 8260, 8776, 9571, 9827, 10519, 10794, 12410, 12634]","[64, 234, 462, 552, 728, 1044, 1193, 1333, 1499, 1638, 1875, 1980, 2070, 2641, 2903, 3075, 3331, 3675, 3902, 4307, 4773, 5227, 5322, 5706, 6190, 6537, 6961, 7056, 8541, 8637]","[64, 283, 373, 607, 868, 1035, 1125, 1285, 1506, 1634, 1724, 1923, 2013, 2370, 3601, 3696, 3790, 3885, 4221, 4379, 4536, 4631, 4756, 4923, 5046, 5216, 5560, 5802, 6678, 6896]",13573,13161,12634,8637,6896,47,98,120,105,84,"[0, 206, 488, 1015, 1332, 2003, 2430, 3018, 3435, 4090, 4508, 5115, 6438, 6828, 7429, 8019, 8669, 9999, 10758, 11612, 12370, 13298, 13876, 14820, 15446, 16107, 17129, 18219, 19766, 21110]","[0, 240, 564, 885, 1271, 1618, 2284, 2956, 3387, 4372, 5007, 5663, 6258, 6643, 7066, 7449, 8403, 9679, 10261, 11060, 11555, 12666, 13703, 14362, 14536, 15402, 15995, 16987, 17947, 18288]","[0, 238, 450, 785, 1104, 1514, 2118, 2576, 2961, 3468, 4042, 4405, 5451, 6205, 7447, 7895, 8373, 8918, 9480, 10149, 10790, 11384, 12034, 12507, 13285, 13827, 14662, 15197, 15418, 15803]","[0, 170, 475, 565, 655, 840, 1106, 1355, 1466, 1816, 2021, 2661, 2895, 3293, 3713, 4377, 5090, 5475, 6142, 6731, 7057, 7707, 8052, 8756, 9034, 9303, 9695, 10372, 10752, 11564]","[0, 170, 260, 437, 573, 933, 1131, 1328, 1418, 1942, 2312, 2523, 2906, 3034, 3698, 3915, 4186, 4671, 5112, 5257, 5652, 6126, 6693, 7456, 8140, 8352, 8965, 9718, 10596, 11419]",21110,18288,15803,11564,11419,-7537,-5127,-3169,-2927,-4523,-23283,30,dire
7554270913,46,13,129,105,20,"[248, 521, 849, 1260, 1562, 1893, 2233, 2874, 3462, 3982, 4548, 5314, 6059, 6804, 7486, 8315, 9055, 9681, 10790, 12189, 12948, 13922, 14688, 15751, 16898, 17792, 18475, 18772, 19115, 19211]","[239, 606, 932, 1386, 1848, 2327, 2782, 3387, 3844, 4405, 4822, 5066, 5810, 6128, 6867, 7480, 7756, 8342, 9090, 9773, 10128, 10652, 11280, 12051, 12882, 13803, 14288, 14731, 15074, 15850]","[256, 530, 892, 1347, 1556, 1976, 2215, 2841, 3288, 3794, 4649, 5233, 5669, 5854, 6129, 6670, 7071, 7769, 7927, 8439, 8963, 9380, 9607, 9952, 10518, 11542, 12321, 12637, 12980, 13331]","[170, 260, 395, 572, 879, 999, 1089, 1309, 1511, 1649, 2055, 2250, 2453, 2817, 3238, 3396, 3490, 4170, 4844, 4985, 5258, 5917, 6386, 6752, 7205, 7974, 8144, 8315, 8733, 8904]","[170, 260, 428, 615, 705, 864, 1006, 1226, 1530, 1620, 1958, 2155, 2486, 2583, 2797, 2955, 3116, 3301, 3468, 3576, 3783, 4315, 4410, 4646, 5110, 5481, 5576, 5915, 6624, 7038]",19211,15850,13331,8904,7038,48,19,96,85,123,"[294, 495, 733, 927, 1218, 1497, 1892, 2306, 2677, 3306, 3702, 4460, 5195, 6172, 6946, 8145, 8770, 9336, 10312, 11043, 11746, 13248, 13977, 15265, 16688, 17883, 18850, 19825, 22066, 23370]","[418, 723, 1016, 1432, 1897, 2269, 2893, 3417, 3863, 4434, 4781, 5143, 5274, 5836, 6219, 6668, 7072, 7711, 8469, 8666, 9650, 10286, 10972, 11486, 12428, 13138, 13567, 14094, 15130, 16260]","[309, 835, 1209, 1455, 1950, 2324, 2774, 3230, 3654, 4547, 4988, 5500, 5904, 6097, 6398, 7190, 7722, 8082, 8781, 9145, 9502, 9951, 10216, 10710, 11039, 11593, 12022, 12643, 13404, 13972]","[260, 350, 440, 530, 711, 846, 1193, 1358, 1448, 1879, 2027, 2119, 2427, 2679, 3163, 3849, 3943, 4517, 4705, 4987, 5329, 5697, 5865, 6272, 6508, 6844, 7219, 8157, 9041, 9638]","[528, 685, 822, 912, 1036, 1281, 1486, 1621, 1711, 2257, 2554, 2726, 2821, 3147, 3812, 4203, 4487, 4821, 5288, 5702, 6056, 6223, 6404, 6851, 7140, 7785, 8035, 8384, 8624, 9170]",23370,16260,13972,9638,9170,-4159,-410,-641,-734,-2132,-8076,30,dire
7554357902,1,120,92,19,66,"[63, 270, 520, 720, 1059, 1503, 2412, 2791, 3288, 3768, 4247, 4667, 5214, 5479, 6295, 7503, 8873, 9842, 11183, 11871, 12166, 12882, 13605, 14802, 15757, 16586, 16984, 17279, 18221, 19246]","[63, 269, 521, 1041, 1408, 1735, 2235, 2698, 3203, 3947, 4649, 4983, 5344, 6039, 7453, 7973, 9038, 9600, 10576, 11944, 12483, 12650, 13272, 13669, 14640, 15038, 15618, 16158, 17246, 18188]","[63, 271, 554, 923, 1297, 1650, 1740, 2279, 2727, 3443, 3756, 4144, 4641, 5191, 5963, 6489, 7108, 7465, 7886, 8345, 8762, 9429, 9990, 10552, 10993, 11438, 11632, 12680, 12990, 13429]","[63, 268, 358, 448, 627, 833, 1185, 1627, 1717, 2109, 2438, 2668, 2758, 2925, 3629, 3904, 4708, 5065, 5459, 6023, 6117, 6646, 6913, 7297, 7638, 7846, 8056, 8358, 9154, 9461]","[331, 501, 827, 917, 1246, 1574, 1896, 2149, 2352, 2803, 3154, 3513, 3806, 4124, 4698, 5294, 6018, 6375, 6802, 7142, 7285, 7688, 7978, 8363, 8532, 8747, 8908, 9088, 9798, 10171]",19246,18188,13429,9461,10171,48,53,90,97,100,"[0, 279, 631, 863, 1117, 1583, 1994, 2282, 2684, 2985, 3601, 4203, 4817, 5716, 6191, 7252, 7603, 9109, 10068, 11057, 11968, 13719, 14172, 14944, 15757, 16975, 18430, 20327, 20960, 21656]","[0, 170, 260, 648, 823, 993, 1110, 1250, 1447, 1537, 1738, 1981, 2108, 2459, 2554, 3726, 4132, 4651, 5429, 7046, 7495, 8094, 8526, 8913, 9778, 10491, 11162, 11854, 12468, 12564]","[0, 267, 566, 938, 1179, 1605, 1982, 2581, 3129, 3495, 3696, 4292, 4601, 5013, 5146, 5689, 5974, 6611, 6861, 7402, 8190, 8861, 9375, 9642, 10251, 11047, 11609, 12060, 12407, 12541]","[0, 331, 622, 1150, 1631, 1909, 2071, 2268, 2574, 2968, 3277, 3888, 4147, 4836, 5277, 5655, 5832, 6843, 7159, 7254, 8072, 8518, 8707, 9091, 9468, 10396, 10771, 11222, 11824, 12027]","[0, 170, 260, 385, 475, 720, 810, 900, 1097, 1321, 1522, 1712, 1955, 2457, 2562, 2902, 3042, 3832, 4307, 4609, 4950, 5965, 6060, 6190, 6759, 7232, 7591, 8156, 8362, 8539]",21656,12564,12541,12027,8539,-2410,5624,888,-2566,1632,3168,30,radiant
7554476514,10,120,29,26,83,"[859, 1289, 1793, 2221, 2586, 3207, 3445, 3958, 4432, 5024, 5588, 6823, 7318, 8228, 9027, 9980, 11254, 11812, 12617, 13332, 13470, 14549, 14716, 16607, 17192, 17754, 18877, 19451, 20291, 21726]","[1241, 1528, 1830, 2201, 2948, 3282, 4046, 4426, 5344, 5705, 6161, 7110, 7252, 7687, 8510, 8829, 9692, 10146, 10530, 11150, 11792, 12422, 13241, 14143, 15030, 15839, 16772, 17536, 18357, 19162]","[1025, 1407, 1803, 2128, 2434, 2709, 3150, 3603, 4272, 4804, 5072, 5699, 6203, 6908, 7463, 8029, 8453, 8682, 8887, 9175, 9315, 9745, 10382, 11494, 12303, 12784, 13255, 13486, 13889, 14559]","[603, 737, 919, 1091, 1432, 1721, 1995, 2299, 2555, 2741, 2893, 3168, 3449, 3806, 4179, 4510, 5060, 5357, 5807, 6142, 6450, 6715, 7271, 7729, 8254, 8607, 8930, 9238, 9861, 10655]","[556, 646, 821, 947, 1511, 1836, 2064, 2548, 2728, 2863, 3182, 3741, 3881, 4246, 4747, 5201, 5733, 5999, 6328, 6834, 7308, 7607, 7812, 8655, 8994, 9171, 9494, 9725, 9975, 10498]",21726,19162,14559,10655,10498,93,106,96,105,101,"[795, 1204, 1604, 1853, 2227, 2868, 3178, 3569, 3904, 4384, 5001, 5096, 5948, 6915, 7479, 8499, 9015, 9623, 10223, 10531, 11708, 12342, 12709, 13040, 13313, 14122, 14422, 14608, 15543, 15733]","[852, 1062, 1496, 1586, 1715, 2210, 2391, 3093, 3428, 3806, 4097, 4329, 5255, 5981, 6802, 7122, 7454, 8111, 8500, 8894, 9765, 10724, 11560, 12207, 12659, 13115, 13297, 13920, 14324, 15018]","[914, 1166, 1622, 1953, 2315, 2732, 3015, 3283, 3544, 3876, 4010, 4105, 4767, 6429, 6892, 7286, 7444, 7787, 7981, 8449, 9291, 9854, 10374, 10819, 11044, 11575, 11760, 12289, 12812, 13546]","[350, 492, 761, 894, 1234, 1644, 1734, 1869, 2047, 2172, 2443, 3198, 3710, 4159, 4464, 4649, 4807, 4901, 5545, 6029, 6818, 7497, 7701, 8070, 8580, 9272, 9865, 10036, 10336, 10637]","[498, 623, 1051, 1141, 1283, 1418, 1508, 1879, 2052, 2262, 2461, 2556, 3113, 3733, 4102, 4456, 4832, 5061, 5210, 5730, 6147, 6496, 6663, 6957, 7247, 7468, 7564, 7660, 7799, 8131]",15733,15018,13546,10637,8131,5993,4144,1013,18,2367,13535,30,radiant
7554721500,48,62,129,20,84,"[548, 952, 1196, 1602, 2024, 2438, 2770, 3254, 3893, 4604, 5240, 5989, 7239, 7770, 8368, 9443, 10901, 12711, 13938, 15306, 16250, 16984, 17842, 18441, 19826, 21129, 22121, 23236, 24768, 24868]","[754, 1095, 1499, 1829, 2082, 2547, 2907, 3444, 4279, 4480, 5070, 5549, 6022, 6354, 7196, 7587, 8247, 9405, 9739, 10240, 10407, 10869, 11074, 11367, 12911, 13345, 13755, 14121, 14697, 14957]","[491, 850, 1276, 1592, 1924, 2407, 2807, 3241, 3483, 4133, 4553, 5249, 5970, 6350, 6729, 7173, 7510, 8298, 8614, 8709, 9166, 9957, 10377, 11067, 12044, 12937, 13439, 13845, 14417, 14517]","[285, 375, 606, 696, 908, 1136, 1226, 1695, 2115, 2255, 2568, 2876, 3037, 3344, 3678, 3852, 4290, 4963, 5207, 5559, 5801, 6105, 6385, 6555, 7160, 7419, 7967, 8372, 9028, 9419]","[285, 393, 503, 709, 843, 1113, 1381, 2036, 2306, 2396, 2721, 3070, 3255, 3397, 3878, 4251, 4622, 5346, 5802, 6040, 6253, 6610, 6854, 6993, 7528, 7833, 8135, 8509, 9005, 9178]",24868,14957,14517,9419,9178,10,49,39,58,123,"[565, 816, 1111, 1502, 1975, 2230, 2701, 3293, 4005, 4674, 5002, 5762, 6359, 7154, 7772, 8576, 9427, 10010, 10658, 11367, 12432, 13354, 14236, 15145, 15509, 16336, 17091, 17865, 18469, 19483]","[472, 757, 1048, 1364, 1642, 2091, 2365, 2918, 3367, 3670, 4330, 4769, 5536, 6094, 7032, 7842, 8369, 8618, 9387, 10249, 11037, 12288, 12551, 13511, 13751, 13977, 15203, 16037, 16717, 17643]","[646, 965, 1410, 1707, 2188, 2609, 2978, 3670, 4158, 4582, 5060, 5471, 6066, 6886, 7258, 7571, 8000, 8729, 9227, 9763, 10933, 11842, 12542, 13182, 13482, 14375, 15145, 15241, 15902, 16880]","[260, 350, 597, 1078, 1322, 1546, 1695, 2246, 2426, 2619, 2743, 3027, 3122, 3478, 3795, 4337, 4667, 4916, 5308, 5548, 5869, 6321, 6615, 7040, 7508, 7815, 8073, 8462, 9270, 10272]","[359, 467, 603, 693, 783, 963, 1066, 1338, 1518, 1735, 2042, 2581, 2676, 2949, 3203, 3434, 3708, 4032, 4511, 4699, 4939, 5443, 5824, 6412, 6629, 7422, 7755, 8277, 8750, 9315]",19483,17643,16880,10272,9315,5385,-2686,-2363,-853,-137,-654,30,dire
7555041119,46,49,129,20,26,"[1100, 1463, 1834, 2287, 2870, 3353, 4073, 4608, 5128, 6264, 6955, 7410, 7604, 8523, 9317, 9929, 10692, 11809, 12802, 13584, 14289, 15193, 15751, 16595, 17127, 17898, 18185, 19371, 20080, 20597]","[1033, 1375, 1781, 2156, 2456, 2956, 3658, 4080, 4553, 4947, 5356, 5848, 6477, 7169, 7657, 8198, 9433, 10079, 10174, 10572, 11435, 12203, 12779, 13361, 13859, 14478, 15123, 15676, 16350, 16966]","[947, 1304, 1785, 2356, 2767, 3134, 3601, 4197, 4893, 5325, 5945, 6371, 6841, 7325, 8452, 8547, 9222, 9647, 10068, 10683, 11311, 11915, 12245, 12648, 13187, 13990, 14300, 14845, 15545, 15693]","[613, 837, 976, 1111, 1447, 1635, 1932, 2264, 2859, 3046, 3293, 3600, 3794, 4062, 4307, 4436, 5057, 5151, 5246, 5412, 5507, 5601, 5852, 5996, 6091, 6513, 6609, 6795, 7051, 7151]","[412, 549, 639, 823, 973, 1081, 1306, 1486, 1666, 1932, 2095, 2349, 2629, 3016, 3261, 3359, 3643, 4297, 4392, 4487, 4582, 4762, 4929, 5024, 5119, 5541, 5693, 5879, 6088, 6237]",20597,16966,15693,7151,6237,13,41,96,58,123,"[677, 982, 1232, 1694, 2035, 2493, 2989, 3264, 3931, 4528, 5043, 5947, 6676, 7429, 7853, 8423, 8943, 9672, 10569, 11418, 11870, 12469, 12861, 13924, 14688, 15548, 16093, 16807, 18694, 19506]","[790, 1071, 1732, 2112, 2447, 2816, 3181, 3509, 3972, 4420, 4900, 5420, 6296, 6835, 7601, 8669, 9536, 9980, 10491, 11314, 11923, 12298, 13197, 13467, 14200, 15023, 15698, 16370, 17861, 18073]","[785, 1232, 1510, 1928, 2343, 2843, 3172, 3709, 4369, 4831, 5366, 5979, 6552, 7223, 7616, 8162, 8532, 9070, 9866, 10434, 11107, 11526, 12041, 12611, 13302, 13884, 14165, 14561, 15548, 15743]","[433, 563, 778, 1188, 1368, 1597, 1687, 1899, 2117, 2284, 2516, 2992, 3132, 3701, 4020, 4757, 5009, 5245, 5407, 5824, 6438, 6807, 7175, 7753, 8072, 8408, 8764, 9435, 9833, 10466]","[350, 480, 570, 775, 1034, 1479, 1618, 1755, 2063, 2253, 2420, 2938, 3322, 4066, 4319, 4471, 4878, 4972, 5324, 5630, 5870, 6087, 6323, 6574, 6669, 7307, 7403, 7784, 8639, 9310]",19506,18073,15743,10466,9310,1091,-1107,-50,-3315,-3073,-6454,30,dire
7555172308,73,90,112,110,97,"[58, 649, 1043, 1412, 1758, 2061, 2670, 3270, 3843, 4562, 5151, 6151, 6790, 7777, 8799, 9817, 10807, 11146, 12656, 13718, 13827, 14784, 15157, 15396, 17095, 18543, 19017, 19112, 20750, 21796]","[58, 430, 631, 1099, 1398, 1658, 1926, 2913, 3366, 3887, 4221, 4692, 5405, 5988, 6276, 6920, 7575, 8398, 9073, 9532, 10088, 10840, 11007, 11749, 12516, 13118, 13377, 13917, 15266, 15885]","[58, 228, 318, 408, 542, 704, 1203, 1562, 2059, 2230, 2616, 2815, 3017, 3848, 4453, 5100, 5407, 5948, 6684, 7582, 7752, 8460, 9150, 9317, 9984, 10582, 10714, 10809, 11168, 11345]","[58, 294, 583, 876, 1172, 1329, 1671, 1984, 2109, 2236, 2616, 2706, 2796, 3194, 3788, 4160, 4836, 5286, 6179, 6852, 7097, 7441, 8072, 8929, 9678, 10280, 10598, 10768, 12108, 12613]","[326, 583, 822, 985, 1263, 1471, 1763, 2185, 2312, 2614, 2812, 3180, 3501, 3976, 4413, 5087, 5316, 5579, 6037, 6481, 6651, 6944, 7455, 8026, 8484, 9338, 9433, 10054, 10746, 11457]",21796,15885,11345,12613,11457,113,98,29,45,47,"[0, 283, 526, 906, 1201, 1530, 2089, 2385, 2924, 3712, 4229, 4883, 5450, 6138, 6675, 7144, 7624, 8497, 8865, 9314, 10046, 10842, 12004, 12466, 13034, 13479, 14946, 15957, 16187, 16443]","[154, 324, 645, 861, 1282, 1804, 2098, 2515, 2922, 3441, 4086, 4837, 5353, 6061, 6495, 6789, 6947, 7759, 7854, 8235, 9776, 10115, 10419, 11242, 11700, 12073, 13176, 13847, 14598, 15126]","[0, 598, 774, 1070, 1486, 1784, 2715, 2839, 3374, 3869, 4597, 5126, 6041, 6516, 6769, 7334, 7776, 8691, 9320, 9875, 10904, 11407, 12234, 12924, 13135, 13329, 14400, 14964, 15433, 15529]","[154, 324, 448, 586, 725, 965, 1233, 1367, 1457, 1593, 2122, 2457, 2754, 2902, 3507, 3662, 3820, 4474, 4768, 5227, 6896, 7089, 7427, 8077, 8171, 8266, 9727, 10522, 10896, 11355]","[0, 332, 422, 512, 602, 692, 1006, 1133, 1350, 1440, 1803, 2138, 2247, 2715, 3179, 3446, 3604, 3885, 3980, 4231, 4605, 4699, 5003, 5630, 5724, 5819, 7185, 7553, 7960, 8180]",16443,15126,15529,11355,8180,5353,759,-4184,1258,3277,6463,30,radiant
7555291916,93,106,97,123,105,"[644, 982, 1422, 1665, 1917, 2476, 2795, 3059, 3641, 4191, 4871, 5420, 5901, 6550, 7337, 7943, 8761, 8867, 9014, 9649, 10981, 11606, 12161, 13075, 13434, 14020, 15479, 17631, 18395, 19052]","[775, 1176, 1560, 1813, 1940, 2555, 3050, 3446, 3658, 4202, 4949, 5629, 6353, 6866, 7690, 8728, 9171, 9669, 9940, 10564, 11106, 11960, 12794, 13771, 14112, 14825, 16122, 16987, 17083, 17819]","[469, 1035, 1445, 1861, 2369, 2940, 3465, 3986, 4652, 5161, 5475, 5883, 6509, 6935, 7543, 7993, 8522, 8625, 8719, 9163, 9547, 10119, 10813, 11754, 12460, 13138, 14088, 14793, 15361, 15551]","[373, 536, 898, 988, 1266, 1446, 1809, 1955, 2135, 2486, 2836, 3415, 3778, 3926, 4493, 4990, 5212, 5859, 5953, 6148, 6606, 6933, 7371, 7815, 8260, 8593, 8901, 9514, 9851, 10292]","[300, 463, 602, 778, 1156, 1336, 1560, 1650, 2078, 2306, 2539, 2720, 2929, 3024, 3488, 3673, 4041, 4375, 4469, 4810, 5324, 5552, 5991, 6593, 7084, 7383, 7975, 8775, 9085, 9529]",19052,17819,15551,10292,9529,73,120,137,58,86,"[595, 959, 1311, 1401, 1908, 2240, 2549, 2983, 3703, 4194, 4996, 5944, 6723, 7834, 9464, 10535, 11523, 12850, 14241, 15493, 16359, 16784, 17984, 19275, 20034, 20128, 20596, 20882, 22131, 23619]","[560, 902, 1286, 1856, 2493, 2856, 3211, 3679, 4265, 4409, 4923, 5467, 5562, 5868, 6648, 7141, 8327, 9019, 10592, 11215, 11820, 12302, 12765, 13282, 13377, 13976, 15156, 16244, 16592, 17245]","[392, 660, 1153, 1656, 1894, 2325, 2782, 3456, 3801, 4516, 5128, 5501, 6350, 6713, 7480, 8113, 8788, 9009, 9901, 10469, 11081, 11575, 12537, 13353, 13448, 14065, 14571, 15053, 15659, 16315]","[245, 644, 815, 1023, 1422, 1592, 1682, 2065, 2323, 2685, 2915, 3118, 3257, 3475, 4157, 4570, 4946, 5248, 5859, 6070, 6573, 6914, 7462, 7939, 8034, 8261, 8593, 8761, 9234, 9784]","[293, 466, 631, 943, 1078, 1213, 1303, 1776, 2006, 2245, 2604, 3089, 3267, 3667, 4143, 4398, 4611, 4832, 5457, 5764, 6104, 6199, 6443, 7040, 7180, 7274, 7652, 8134, 8230, 8670]",23619,17245,16315,9784,8670,-4567,574,-764,508,859,-3390,30,dire
7555314400,46,106,45,123,83,"[523, 734, 1059, 1430, 1846, 2342, 2706, 3376, 3981, 4652, 5226, 6079, 6533, 7500, 7844, 8182, 8629, 9418, 10452, 11327, 11933, 12323, 13379, 14080, 15186, 15890, 16230, 16795, 17554, 17992]","[514, 757, 1075, 1354, 1641, 1892, 2178, 2476, 2942, 3428, 3892, 4291, 4800, 5194, 5932, 6707, 7496, 7793, 8286, 8575, 9334, 9600, 9949, 10686, 11995, 12390, 12747, 13257, 13744, 14187]","[586, 1000, 1683, 1862, 2189, 2618, 3066, 3156, 3871, 4624, 5062, 5822, 6069, 6491, 6966, 7295, 8122, 8613, 9363, 10126, 10476, 10661, 11337, 12384, 12796, 13689, 14035, 14371, 15263, 15691]","[261, 367, 577, 667, 840, 930, 1020, 1287, 1637, 1926, 2016, 2478, 2574, 2846, 3347, 4123, 4767, 4925, 5177, 5541, 6016, 6201, 6410, 7032, 7836, 8012, 8108, 8727, 9312, 9547]","[261, 400, 534, 663, 838, 928, 1018, 1108, 1332, 1651, 1741, 2142, 2266, 2361, 2705, 3119, 3566, 3700, 3998, 4183, 4476, 4706, 4800, 5305, 5720, 5896, 5992, 6433, 6818, 7295]",17992,14187,15691,9547,7295,95,49,97,119,20,"[627, 945, 1458, 1930, 2384, 2913, 3196, 3946, 4356, 4850, 5419, 6029, 6679, 7320, 8137, 8664, 9347, 10237, 10924, 12071, 12579, 13325, 14240, 14811, 15279, 15995, 17033, 17798, 18902, 19926]","[547, 878, 1178, 1669, 2064, 2836, 3128, 3866, 4425, 5005, 5354, 5831, 6361, 6832, 7385, 7480, 7859, 8567, 8897, 10018, 10790, 11151, 12172, 12464, 12646, 13120, 13995, 14537, 15149, 16017]","[568, 888, 1179, 1469, 1655, 1825, 2466, 3085, 3747, 4329, 4814, 5123, 5422, 5813, 6218, 6313, 6512, 7086, 7722, 8091, 9107, 9462, 10120, 10395, 10515, 11257, 11726, 12170, 12530, 12899]","[261, 351, 490, 681, 822, 1035, 1242, 1577, 1807, 1954, 2044, 2256, 2867, 3144, 3414, 3509, 3948, 4440, 4831, 4951, 5214, 5504, 5715, 6407, 6807, 7451, 7889, 8272, 8525, 8715]","[261, 351, 535, 756, 1065, 1278, 1368, 1634, 1814, 1904, 2049, 2143, 2408, 2714, 3123, 3218, 3359, 3580, 4008, 4155, 4452, 4910, 5089, 5364, 5661, 5875, 6260, 6645, 7226, 7416]",19926,16017,12899,8715,7416,-1934,-1830,2792,832,-121,-261,30,dire
7555372304,93,29,53,59,83,"[0, 290, 524, 892, 1254, 1763, 2118, 2480, 3029, 3606, 4121, 4493, 4843, 5496, 5783, 6128, 6859, 7468, 8991, 9523, 9618, 9899, 10958, 12029, 12180, 12365, 12833, 12927, 13023, 13119]","[0, 327, 609, 855, 1369, 1670, 2154, 2396, 2606, 2696, 3259, 3750, 4380, 4884, 5442, 6154, 6813, 7392, 7771, 8309, 8680, 9184, 9826, 11065, 11471, 11656, 12413, 12507, 12603, 12699]","[0, 170, 260, 469, 637, 1012, 1363, 1690, 1907, 2421, 3091, 3181, 3471, 3714, 4018, 4264, 4959, 5358, 6109, 6792, 6887, 6982, 7077, 8126, 8382, 8650, 9145, 9655, 9751, 10484]","[0, 254, 469, 640, 931, 1110, 1334, 1516, 1736, 2078, 2466, 2858, 3305, 3869, 4098, 4192, 4502, 5035, 5396, 5785, 6542, 7056, 7481, 7742, 8181, 8716, 9766, 10226, 10322, 10713]","[0, 170, 364, 454, 618, 1046, 1277, 1622, 1729, 2007, 2302, 2595, 2811, 2996, 3139, 3389, 3574, 4242, 4828, 5171, 5483, 5658, 5879, 6570, 6768, 7797, 8249, 8487, 8899, 9029]",13119,12699,10484,10713,9029,106,10,96,9,27,"[0, 609, 1168, 1799, 2177, 2772, 3453, 3990, 4742, 5071, 5578, 6018, 6882, 7219, 7989, 8489, 9562, 10204, 10497, 11396, 12519, 13339, 14120, 14747, 15653, 16722, 17461, 17860, 19013, 20042]","[0, 285, 604, 871, 1273, 1883, 2212, 2703, 3315, 3842, 4312, 4768, 5163, 5562, 6109, 6602, 6828, 7315, 7805, 8528, 9105, 9994, 10534, 11261, 11595, 12316, 13000, 13688, 15565, 17446]","[0, 281, 529, 793, 1080, 1491, 1967, 2221, 2523, 2767, 3102, 3544, 3869, 4347, 4967, 5137, 5295, 5620, 6160, 7022, 7618, 7900, 8230, 8903, 9587, 10076, 10449, 10768, 11362, 12391]","[0, 232, 369, 489, 639, 885, 1426, 1908, 2367, 2509, 2599, 2779, 3239, 3432, 3768, 4134, 4656, 4883, 5225, 5707, 6841, 7166, 7473, 7681, 7776, 8162, 8670, 9197, 10233, 11296]","[0, 232, 322, 521, 673, 843, 1157, 1455, 1703, 2041, 2176, 2518, 2966, 3179, 3375, 3469, 3734, 3933, 4319, 4670, 5182, 5398, 5634, 5842, 6239, 7073, 7279, 7598, 8391, 9115]",20042,17446,12391,11296,9115,-6923,-4747,-1907,-583,-86,-14246,30,dire
7555678503,48,106,98,86,100,"[621, 1067, 1312, 1574, 2056, 2210, 2560, 2995, 3296, 3748, 4281, 4819, 6030, 6953, 7735, 8296, 8966, 10071, 11031, 12022, 13122, 14174, 14583, 15615, 16604, 17529, 18914, 19418, 21303, 22459]","[538, 860, 1199, 1524, 1974, 2520, 3202, 3996, 4714, 4859, 5302, 5657, 6787, 7554, 8571, 9394, 10047, 10779, 11336, 12178, 13015, 13579, 14662, 14757, 15161, 15903, 16949, 17721, 18298, 19083]","[506, 763, 968, 1264, 1608, 1893, 2334, 2663, 3410, 3723, 4365, 5046, 5432, 5982, 6470, 6931, 7401, 7975, 8838, 9413, 10298, 10804, 11344, 11995, 12719, 12972, 14119, 14628, 14805, 15576]","[642, 783, 873, 1100, 1225, 1402, 1578, 2267, 2737, 2883, 3103, 3252, 4383, 4614, 5333, 5981, 6187, 6382, 6933, 7683, 7922, 8271, 8826, 9002, 9322, 9577, 10307, 10602, 11385, 11763]","[333, 468, 558, 695, 829, 1006, 1096, 1518, 2123, 2407, 2705, 3018, 3542, 4073, 4382, 4673, 4793, 5039, 5350, 5772, 6011, 6757, 7118, 7262, 7483, 7688, 8166, 8262, 8775, 9055]",22459,19083,15576,11763,9055,46,17,129,53,123,"[733, 1106, 1422, 1668, 2272, 2528, 3228, 3811, 4315, 4590, 5128, 5662, 6402, 6732, 8025, 8693, 9663, 10425, 11040, 11896, 12405, 13207, 14021, 16039, 17088, 17794, 18149, 19209, 20122, 20847]","[651, 1112, 1357, 1743, 2206, 2547, 2986, 3400, 3815, 3952, 4445, 5078, 5530, 5936, 6470, 7274, 7472, 8316, 8542, 9482, 10324, 10884, 11132, 11922, 12688, 13046, 13638, 13993, 14266, 14653]","[629, 874, 1398, 1731, 2159, 2537, 3023, 3416, 4014, 4454, 4714, 5367, 6558, 6652, 7082, 7586, 7681, 8383, 8841, 8981, 9516, 10125, 10489, 10959, 11381, 11873, 12422, 12697, 13229, 13532]","[511, 650, 757, 963, 1402, 1791, 2218, 2308, 2849, 2939, 3212, 3341, 3914, 4008, 4797, 5072, 5292, 5757, 5992, 6333, 6621, 6804, 6946, 7583, 8024, 8244, 9070, 9166, 9373, 9769]","[350, 440, 575, 795, 1089, 1179, 1368, 1503, 1761, 2077, 2218, 2413, 2894, 2988, 3446, 3765, 4119, 4322, 4492, 4895, 5168, 5623, 6042, 6876, 7313, 7679, 8189, 8619, 9212, 9565]",20847,14653,13532,9769,9565,1612,4430,2044,1994,-510,9570,30,radiant
7556112506,98,21,53,96,111,"[423, 715, 1123, 1464, 1911, 2544, 2942, 3227, 3918, 4286, 4522, 5302, 5650, 6040, 6218, 6637, 7081, 7398, 7643, 8141, 8371, 9009, 9603, 10101, 10816, 11375, 11678, 11880, 12157, 12435]","[423, 681, 1011, 1306, 1721, 2049, 2451, 2970, 3484, 3852, 4251, 4558, 4800, 4950, 5295, 6172, 6694, 7294, 7833, 8496, 8658, 8954, 9293, 9646, 10320, 10677, 10929, 11272, 11639, 12076]","[365, 575, 665, 999, 1135, 1613, 1745, 1895, 2333, 2580, 2947, 3340, 3507, 3688, 3995, 4700, 5013, 5108, 5388, 5794, 6093, 6489, 6994, 7346, 7953, 8703, 9079, 9309, 9980, 10384]","[500, 778, 1168, 1367, 1637, 1889, 2230, 2521, 2872, 3382, 3637, 4184, 4351, 4446, 4541, 5113, 5333, 5534, 6062, 6458, 6587, 7037, 7728, 7822, 8228, 8787, 8968, 9541, 10050, 10357]","[423, 633, 782, 964, 1271, 1584, 1768, 1858, 2227, 2317, 2543, 3040, 3207, 3383, 3526, 3764, 4050, 4145, 4330, 4487, 4582, 5160, 5440, 5609, 5779, 6211, 6381, 6550, 6802, 7149]",12435,12076,10384,10357,7149,19,48,43,102,26,"[292, 490, 836, 1310, 1723, 2183, 2539, 3100, 4026, 4683, 5290, 5659, 6362, 6968, 7591, 8090, 9603, 10923, 11329, 11903, 12462, 13479, 14370, 14844, 15469, 16172, 17286, 18847, 19598, 20690]","[206, 368, 617, 825, 1198, 1530, 2473, 2764, 3163, 3513, 4090, 4648, 5368, 5974, 6800, 6976, 7752, 8693, 9333, 10298, 11170, 12464, 13202, 14247, 14886, 15551, 16645, 18124, 19122, 20567]","[159, 249, 496, 586, 822, 1034, 1407, 1719, 1947, 2317, 2542, 3193, 4275, 4611, 5455, 5855, 6539, 7059, 7431, 8213, 8712, 9434, 9666, 10456, 10770, 11834, 12687, 13590, 14732, 15506]","[159, 249, 378, 514, 729, 899, 1299, 1470, 1779, 1966, 2216, 2602, 3173, 3380, 4046, 4192, 4470, 4718, 4851, 5118, 5612, 6020, 6437, 6711, 6916, 7302, 7801, 8745, 9788, 10296]","[73, 163, 253, 379, 544, 634, 845, 945, 1083, 1704, 2007, 2535, 3066, 3273, 3773, 4037, 4476, 4768, 4863, 5265, 5531, 5802, 6044, 6520, 6940, 7299, 7873, 8902, 9580, 10160]",20690,20567,15506,10296,10160,-8255,-8491,-5122,61,-3011,-24818,30,dire
7556149516,80,90,4,86,21,"[0, 163, 391, 783, 1548, 1887, 2277, 2787, 3076, 3954, 4141, 4775, 5263, 5743, 6964, 7413, 8263, 8955, 10083, 10600, 11921, 12249, 12619, 12855, 12979, 13353, 13485, 14158, 14292, 15056]","[0, 129, 403, 632, 826, 1170, 1614, 1962, 2621, 3188, 4499, 5269, 5874, 6337, 6678, 6936, 7571, 8266, 9075, 9778, 10247, 10801, 11601, 11873, 12261, 13133, 13228, 13590, 13686, 14188]","[0, 192, 436, 887, 1109, 1509, 1883, 2107, 2440, 2799, 3243, 3424, 3997, 5190, 5533, 5849, 7081, 7906, 8349, 9181, 10419, 11213, 11566, 12039, 12356, 13134, 13229, 13874, 13970, 14705]","[100, 190, 305, 443, 533, 674, 911, 1105, 1277, 1595, 2176, 2453, 2633, 2969, 3402, 3548, 4043, 4558, 4783, 5031, 5646, 5799, 6055, 6587, 6757, 6998, 7168, 7529, 7700, 8053]","[0, 90, 205, 398, 770, 1092, 1222, 1312, 1558, 1809, 2228, 2460, 2778, 3138, 3469, 3788, 4121, 4708, 4802, 5399, 5979, 6193, 6360, 6596, 7051, 7271, 7366, 7754, 7850, 8172]",15056,14188,14705,8053,8172,73,74,97,20,79,"[247, 696, 1157, 1515, 1652, 1968, 2326, 2737, 3316, 3871, 4709, 5805, 6455, 7257, 8304, 10013, 11398, 12571, 13780, 15122, 16258, 17007, 18734, 21503, 22401, 23595, 24783, 26265, 27493, 28831]","[680, 1007, 1213, 1593, 2050, 2368, 2987, 3375, 3740, 4022, 4563, 5085, 5756, 6343, 6583, 7074, 7260, 7512, 7844, 8363, 8799, 9120, 10098, 11468, 12370, 13049, 13503, 13979, 14968, 15429]","[112, 522, 956, 1204, 1413, 1612, 1835, 2417, 2807, 3316, 3770, 4223, 4668, 5382, 5612, 6198, 6599, 7096, 7828, 8115, 8718, 9263, 9890, 10718, 11523, 12255, 12805, 13500, 14234, 15544]","[112, 362, 542, 790, 880, 1010, 1100, 1235, 1563, 1945, 2653, 3170, 3384, 4311, 4405, 4528, 4714, 5027, 5288, 5446, 5764, 5930, 6224, 7802, 8136, 8538, 8907, 9394, 10030, 10636]","[112, 362, 502, 592, 682, 812, 990, 1251, 1429, 1519, 1901, 2228, 2836, 3039, 3257, 3524, 3899, 4138, 4618, 4845, 5432, 5880, 6159, 6959, 7346, 7891, 8471, 8798, 9473, 10285]",28831,15429,15544,10636,10285,-13775,-1241,-839,-2583,-2113,-20551,30,dire
7556191109,25,69,40,123,106,"[0, 167, 433, 562, 815, 1149, 1565, 1897, 2439, 2693, 3337, 3914, 4456, 4842, 5204, 6578, 7291, 8048, 8538, 8918, 9818, 11254, 11581, 11964, 12596, 13583, 13677, 14418, 15041, 16194]","[0, 198, 549, 844, 1519, 2119, 2787, 3032, 3425, 3682, 3995, 5039, 5319, 5956, 6520, 7364, 7765, 8536, 9391, 10035, 10645, 11417, 11817, 12072, 12474, 13201, 14261, 14648, 15212, 16224]","[0, 129, 219, 671, 800, 970, 1168, 1612, 1844, 2092, 2381, 2815, 3052, 3147, 3419, 3648, 4358, 4453, 4731, 5043, 5615, 6366, 6740, 6967, 7257, 7647, 8286, 8536, 9061, 9747]","[0, 129, 219, 356, 621, 891, 1194, 1497, 1587, 1888, 2245, 2482, 2572, 2702, 3171, 3824, 4491, 5032, 5171, 5426, 5946, 6362, 6630, 6725, 7217, 7599, 8414, 8761, 9164, 9884]","[0, 211, 426, 641, 838, 1046, 1218, 1699, 1931, 2478, 3134, 3371, 3902, 4093, 4365, 4864, 5344, 6044, 6344, 6615, 6746, 7560, 7963, 8058, 8174, 8431, 8687, 9030, 9568, 10325]",16194,16224,9747,9884,10325,63,98,96,101,85,"[114, 407, 607, 942, 1675, 2181, 2554, 3334, 3725, 4127, 4794, 5528, 6420, 7298, 7885, 8473, 8833, 9325, 10457, 10969, 12229, 13621, 14550, 15821, 16596, 17404, 18284, 18938, 19707, 20441]","[382, 794, 1033, 1540, 1864, 2517, 3177, 3520, 4218, 4971, 5563, 5897, 6523, 7183, 7906, 8143, 9000, 9230, 9805, 10288, 11140, 11546, 12004, 12766, 12994, 13462, 13955, 14587, 15380, 15664]","[114, 323, 526, 984, 1612, 1910, 2131, 2830, 3321, 3879, 4139, 4984, 5543, 6418, 6731, 7015, 7528, 8169, 8889, 9521, 10184, 11027, 11765, 12006, 12389, 12898, 14178, 14827, 15231, 15372]","[247, 503, 593, 976, 1115, 1205, 1295, 1794, 2470, 2760, 2967, 3799, 4284, 4739, 4951, 5453, 5659, 6163, 6783, 6926, 7449, 7904, 8678, 8948, 9425, 10104, 11268, 11564, 12315, 12967]","[114, 323, 413, 503, 746, 905, 1255, 1612, 1769, 1906, 2159, 2454, 2634, 3088, 3300, 3756, 3935, 4165, 4369, 4509, 5109, 5695, 6480, 6831, 7031, 7308, 8192, 8645, 8876, 9016]",20441,15664,15372,12967,9016,-4247,560,-5625,-3083,1309,-11086,30,dire
7556255807,47,72,82,20,19,"[0, 239, 439, 810, 1451, 1625, 1981, 2071, 2641, 2981, 3191, 4186, 4645, 5166, 5261, 6312, 6918, 7445, 8053, 8148, 8840, 9288, 9948, 10646, 11404, 12254, 12930, 13707, 14136, 14466]","[0, 251, 517, 804, 1040, 1452, 1915, 2272, 2564, 2907, 3348, 4200, 4616, 5522, 5654, 6271, 6657, 7424, 8326, 8801, 9926, 10474, 10725, 11100, 12058, 12628, 13213, 14655, 15084, 15942]","[0, 245, 524, 650, 1086, 1212, 1506, 1977, 2136, 2392, 3112, 3655, 4173, 4565, 5007, 5520, 5780, 6687, 7472, 8149, 8508, 9173, 9424, 10048, 10393, 11308, 12832, 14117, 14955, 15074]","[0, 170, 275, 365, 500, 641, 750, 940, 1145, 1235, 1370, 2122, 2302, 2511, 2760, 3139, 3262, 3543, 3845, 3940, 4397, 4716, 5460, 5913, 6232, 6608, 6946, 7333, 7999, 8095]","[0, 170, 260, 350, 440, 530, 798, 924, 1051, 1180, 1315, 1867, 2047, 2526, 2709, 3104, 3415, 4108, 4652, 4747, 5290, 5609, 5704, 5889, 6169, 6630, 7293, 7690, 7866, 8097]",14466,15942,15074,8095,8097,106,95,28,27,79,"[331, 622, 1188, 1474, 1601, 1847, 2417, 3123, 3586, 4153, 4695, 4863, 5280, 5591, 6867, 7265, 7759, 9219, 9691, 10362, 10632, 10989, 13282, 14450, 15128, 16302, 17239, 18280, 19804, 21484]","[63, 315, 559, 970, 1394, 1780, 2193, 2534, 2646, 3078, 3689, 3874, 4333, 4796, 5602, 6314, 7114, 7939, 8383, 9093, 9549, 10162, 10569, 11030, 11457, 12546, 13244, 14583, 15300, 15742]","[63, 233, 544, 1057, 1183, 1430, 1770, 2198, 2733, 3045, 3419, 3931, 4467, 4723, 5480, 5985, 6214, 6991, 7295, 7773, 7868, 7962, 8290, 9107, 9810, 10397, 10784, 11358, 11627, 12606]","[63, 233, 388, 815, 1017, 1599, 1802, 2054, 2933, 3207, 3921, 4059, 4408, 5047, 5498, 5865, 5982, 6397, 6624, 7491, 7586, 7935, 8297, 8893, 9085, 9423, 9691, 10307, 11209, 11928]","[63, 233, 353, 457, 601, 731, 1175, 1427, 1748, 2024, 2404, 2781, 2984, 3303, 3642, 3875, 4171, 4588, 4683, 5224, 5319, 5913, 6967, 7563, 7792, 8250, 8491, 9457, 9913, 10837]",21484,15742,12606,11928,10837,-7018,200,2468,-3833,-2740,-10923,30,radiant
7556413616,82,120,129,66,86,"[534, 739, 955, 1386, 1509, 2085, 2341, 2822, 3402, 3852, 4635, 5243, 5555, 6486, 7483, 8457, 9326, 9640, 10499, 11402, 12302, 13246, 14576, 15295, 16377, 16747, 17016, 18336, 19042, 19142]","[450, 777, 1139, 1427, 1805, 2221, 2618, 3165, 3630, 4333, 5054, 5578, 6208, 6502, 7178, 7680, 8474, 8850, 9482, 9887, 10767, 11879, 12577, 13144, 13319, 14204, 15163, 16109, 16329, 16936]","[616, 813, 1212, 1515, 1958, 2617, 3063, 3397, 4000, 4851, 5313, 6124, 7081, 7635, 8153, 8939, 9633, 9728, 10858, 11309, 11797, 12730, 13354, 14146, 14552, 14647, 15007, 15573, 16076, 16176]","[303, 461, 645, 844, 1015, 1341, 1639, 1846, 2190, 3100, 3377, 3685, 4283, 4555, 4973, 5265, 5673, 6060, 6404, 6842, 7245, 7883, 8417, 8837, 9298, 9572, 9963, 10395, 10566, 11127]","[312, 402, 596, 770, 860, 1040, 1548, 1706, 1932, 2258, 2542, 2735, 2977, 3532, 3878, 4110, 4522, 4849, 5178, 5445, 5997, 6678, 7149, 7481, 7962, 8132, 8536, 9000, 9356, 9585]",19142,16936,16176,11127,9585,73,47,97,105,7,"[507, 773, 1064, 1559, 2001, 2721, 2980, 3294, 3982, 4491, 5495, 6622, 7648, 8463, 9398, 10358, 11495, 12216, 13028, 14051, 15351, 16012, 17068, 17714, 19028, 19912, 20977, 22314, 23294, 24080]","[412, 757, 1094, 1417, 1794, 2267, 2646, 3131, 3655, 3962, 4408, 4897, 5418, 5997, 6837, 7581, 8400, 9122, 9785, 10611, 11584, 11889, 12173, 12328, 13576, 15061, 16073, 17295, 18730, 19773]","[605, 917, 1213, 1460, 1700, 2262, 2713, 3020, 3595, 4126, 4669, 5150, 5593, 5927, 6533, 7231, 8031, 8438, 9206, 9391, 9815, 10120, 10585, 11345, 12049, 13039, 13985, 14325, 15103, 15719]","[310, 400, 535, 625, 715, 865, 1025, 1236, 1584, 1820, 2127, 2501, 3484, 3758, 4195, 4364, 4900, 5270, 5462, 5722, 6221, 6428, 6637, 6807, 7477, 7886, 8363, 8526, 9182, 9482]","[341, 480, 619, 742, 832, 993, 1083, 1275, 1504, 1992, 2131, 2364, 2934, 3064, 3362, 3581, 3722, 4074, 4244, 4791, 5286, 5506, 5676, 6278, 6447, 7070, 7755, 7926, 8454, 8789]",24080,19773,15719,9482,8789,-4938,-2837,457,1645,796,-4877,30,dire
7556745318,6,53,29,49,86,"[80, 516, 747, 1043, 1614, 2070, 2635, 3028, 3399, 4182, 4474, 5485, 6167, 6626, 6988, 7607, 7989, 8103, 8860, 9629, 10135, 10546, 11688, 11947, 12608, 13330, 13715, 14396, 14739, 15456]","[80, 344, 536, 884, 1397, 1796, 2080, 2881, 3258, 3986, 4384, 4936, 5423, 5815, 6265, 6466, 6667, 6866, 7315, 8006, 8729, 9007, 9394, 9536, 9749, 10069, 10210, 11209, 11576, 12237]","[80, 319, 544, 814, 1144, 1623, 2042, 2576, 3074, 3254, 3912, 4672, 4919, 5481, 5786, 6075, 6274, 6809, 7388, 7815, 8085, 8389, 8529, 8692, 9109, 9359, 9872, 10638, 10734, 11091]","[80, 321, 662, 944, 1236, 1574, 1932, 2191, 2511, 3037, 3242, 3917, 4386, 4730, 5446, 5941, 6080, 6751, 7538, 8106, 8376, 8573, 8768, 8949, 9289, 9608, 9894, 10451, 10647, 11282]","[474, 644, 759, 947, 1128, 1296, 1501, 1991, 2208, 2501, 2716, 3929, 4493, 4716, 5181, 5275, 5612, 5707, 6257, 6572, 6712, 6940, 7035, 7189, 7374, 7469, 7672, 8149, 8301, 8921]",15456,12237,11091,11282,8921,98,93,22,64,2,"[354, 611, 889, 1346, 1704, 1994, 2556, 3330, 3671, 4644, 5056, 6839, 6965, 8356, 8809, 9499, 10674, 11220, 11702, 12343, 13622, 14430, 15431, 16174, 16476, 17059, 17874, 19105, 19469, 19968]","[110, 280, 521, 741, 1292, 1619, 1979, 2142, 2232, 2545, 2680, 3025, 3698, 4215, 4985, 5245, 6028, 6569, 7216, 7854, 8447, 9190, 10426, 11181, 12104, 12775, 13219, 14426, 14738, 15376]","[489, 659, 1258, 1348, 1538, 1790, 1880, 2067, 2393, 2590, 2986, 3622, 3835, 4069, 4807, 5349, 6241, 7123, 7698, 8187, 9383, 9836, 10352, 11162, 11534, 12398, 13048, 14924, 15229, 15816]","[487, 657, 747, 909, 1089, 1224, 1658, 1748, 1923, 2361, 2589, 3289, 3379, 3613, 3993, 4087, 4329, 4754, 5043, 5574, 6409, 6579, 6893, 7521, 8145, 8337, 8588, 9668, 9925, 10216]","[221, 391, 636, 833, 1091, 1226, 1316, 1720, 1853, 2044, 2401, 2882, 3057, 3323, 3726, 4504, 4948, 5514, 5770, 6407, 7353, 7615, 8080, 8803, 9277, 9388, 9931, 10970, 11174, 11752]",19968,15376,15816,10216,11752,-4512,-3139,-4725,1066,-2831,-14141,30,dire
7556769809,36,70,102,27,79,"[0, 209, 386, 634, 882, 1153, 1524, 1702, 2116, 2324, 3170, 3637, 4081, 4968, 5172, 5717, 6239, 6901, 7419, 7680, 8305, 8625, 9385, 11286, 12074, 13220, 13315, 14401, 14497, 14641]","[0, 279, 616, 827, 1253, 1685, 1922, 2425, 2748, 3485, 3982, 4281, 4671, 5127, 5588, 6225, 6708, 7611, 7872, 8050, 8794, 9272, 10210, 10942, 11840, 12233, 12504, 13643, 14092, 14188]","[0, 286, 573, 966, 1129, 1438, 1959, 2290, 2755, 3131, 3575, 4045, 4519, 4843, 5332, 5988, 6564, 7020, 7692, 7945, 8393, 9093, 9349, 10456, 11218, 11324, 11512, 11744, 12153, 12590]","[0, 170, 547, 637, 1293, 1681, 1814, 2319, 2454, 2740, 2976, 3784, 3997, 4179, 4570, 4755, 5008, 5485, 5632, 5790, 6201, 6520, 6687, 7729, 8312, 8406, 8657, 8833, 9290, 9432]","[0, 170, 260, 395, 485, 678, 901, 1235, 1370, 1567, 1924, 2252, 2342, 2749, 3163, 3469, 3773, 4249, 4344, 4502, 4740, 5107, 5349, 7189, 7521, 7690, 7860, 8350, 9000, 9291]",14641,14188,12590,9432,9291,25,21,14,123,51,"[0, 296, 587, 936, 1366, 2032, 2725, 3334, 3705, 4492, 4914, 5270, 6310, 6680, 7294, 7909, 8554, 9560, 10261, 11546, 12673, 13800, 14594, 15170, 15536, 16834, 18057, 19628, 21056, 22790]","[0, 170, 499, 848, 1271, 1565, 2206, 2445, 2772, 3391, 3952, 4461, 5034, 5364, 5823, 6283, 6945, 7312, 7838, 8689, 9357, 10029, 10975, 11070, 11517, 12361, 12937, 13615, 14341, 15609]","[0, 170, 694, 909, 1332, 1655, 2296, 2663, 3254, 3344, 3554, 4185, 4569, 5171, 5868, 6318, 6641, 7626, 8402, 8698, 9712, 10162, 10576, 10671, 11216, 12178, 12532, 13195, 13604, 14227]","[0, 221, 636, 843, 1042, 1266, 1855, 2057, 2395, 2677, 2883, 3397, 3794, 4194, 4881, 5319, 5633, 6337, 6748, 7186, 7540, 7893, 8098, 8401, 8518, 9236, 9441, 9790, 10086, 10686]","[0, 170, 303, 641, 823, 953, 1154, 1356, 1853, 2314, 2449, 2845, 3096, 3416, 3776, 3951, 4172, 4864, 5121, 5710, 6167, 6792, 7154, 7249, 7564, 8406, 8660, 9283, 9798, 10900]",22790,15609,14227,10686,10900,-8149,-1421,-1637,-1254,-1609,-14070,30,dire
7556977117,63,126,21,108,26,"[1, 242, 522, 961, 1378, 1680, 2364, 2538, 2799, 3094, 3500, 4155, 4597, 5791, 6152, 6499, 6912, 7160, 7526, 7936, 8201, 8658, 9193, 9380, 9837, 10344, 11133, 12294, 13052, 14025]","[1, 426, 589, 944, 1356, 1712, 2278, 2661, 3132, 3819, 4879, 5428, 6306, 6616, 7163, 7808, 7992, 9162, 9297, 9612, 9988, 10165, 10420, 11009, 11103, 11427, 11685, 12664, 13178, 13355]","[1, 215, 384, 521, 806, 997, 1380, 1552, 2063, 2188, 2635, 2821, 2911, 3560, 3992, 4651, 5310, 6520, 6971, 7257, 7585, 7818, 8020, 8653, 9227, 9679, 9842, 11558, 12316, 13015]","[1, 171, 370, 576, 976, 1264, 1700, 1838, 1980, 2107, 2332, 2871, 3158, 3576, 3935, 4330, 4890, 5781, 6105, 6485, 6678, 6942, 7204, 7709, 8015, 8203, 8298, 9171, 9348, 9663]","[1, 171, 597, 810, 938, 1044, 1332, 1422, 2106, 2215, 2621, 2711, 2801, 3308, 3493, 3889, 4073, 4836, 5123, 5281, 5375, 5470, 5565, 5660, 5754, 5849, 5983, 6963, 7140, 7317]",14025,13355,13015,9663,7317,70,71,22,20,75,"[1, 247, 547, 875, 1326, 1617, 1992, 2739, 3220, 3908, 4434, 4809, 5257, 5656, 6380, 7156, 8303, 8907, 9218, 10696, 11568, 12356, 13344, 14585, 15780, 16656, 18000, 18880, 18976, 19949]","[1, 171, 615, 823, 1146, 1345, 1674, 2006, 2241, 2877, 3054, 3887, 4315, 4573, 5164, 5387, 5846, 6329, 6914, 7573, 8248, 8744, 9001, 9686, 10295, 10975, 11952, 12507, 12673, 13241]","[1, 259, 573, 778, 1117, 1481, 1811, 2569, 2769, 3035, 3606, 4051, 4411, 4982, 5337, 5657, 5944, 7083, 7522, 8276, 8854, 9496, 9853, 10558, 10839, 11431, 11978, 12427, 12927, 13649]","[1, 171, 308, 398, 578, 708, 1340, 1611, 1701, 2028, 2254, 2490, 2669, 3249, 3398, 3597, 3972, 4956, 5396, 6046, 6256, 6530, 6810, 7310, 7523, 8102, 8581, 8913, 9084, 9635]","[1, 171, 567, 657, 831, 1000, 1122, 1412, 1878, 2000, 2177, 2591, 2681, 2939, 3088, 3287, 3709, 4178, 4273, 5042, 5254, 5416, 5707, 6132, 6506, 6855, 7452, 7708, 7804, 8051]",19949,13241,13649,9635,8051,-5924,114,-634,28,-734,-7150,30,dire
7557160807,10,120,129,65,20,"[814, 1352, 1807, 2318, 2689, 3137, 3607, 4328, 4968, 5588, 6279, 6966, 7713, 8715, 9732, 10795, 11112, 12044, 12587, 13494, 14334, 15266, 16895, 18025, 18551, 19311, 20279, 21612, 21712, 22259]","[958, 1205, 1616, 1955, 2629, 3039, 3289, 3932, 4543, 4950, 5675, 6459, 6831, 7975, 8560, 9283, 9635, 10425, 10772, 11559, 12078, 12502, 13522, 14215, 14737, 15246, 15877, 16818, 16918, 17283]","[956, 1226, 1676, 2185, 2687, 3048, 3584, 4386, 4665, 5129, 5921, 6286, 6701, 7035, 8005, 8398, 8989, 9192, 9969, 10652, 11123, 11724, 12290, 12866, 13382, 13677, 14728, 15210, 15524, 16166]","[619, 714, 804, 1386, 1726, 1816, 2292, 2671, 3237, 3500, 4005, 4138, 4501, 5295, 5909, 6164, 6501, 6888, 7620, 8001, 8332, 8550, 9697, 10065, 10580, 10933, 11220, 11923, 12023, 12485]","[567, 704, 794, 1033, 1316, 1530, 1959, 2346, 2623, 2762, 3077, 3259, 3624, 4117, 4319, 4548, 4688, 4891, 4986, 5516, 5745, 5920, 6677, 7307, 7558, 7735, 8098, 8679, 8779, 8879]",22259,17283,16166,12485,8879,41,74,29,105,45,"[957, 1227, 1462, 1761, 2167, 2662, 2888, 3151, 3805, 4350, 4772, 5279, 5682, 6340, 6900, 7541, 8211, 8825, 9614, 10304, 11098, 11713, 12361, 12754, 13105, 14079, 14670, 16405, 18123, 18889]","[761, 974, 1268, 1611, 1925, 2519, 2927, 3375, 3949, 4057, 4364, 4734, 5284, 5587, 6357, 6831, 7259, 7688, 7945, 8911, 9568, 9996, 10718, 11151, 11317, 11413, 11864, 11995, 13290, 13742]","[1195, 1546, 2017, 2386, 2859, 3335, 3584, 4110, 4565, 5079, 5604, 6380, 6652, 7338, 7692, 8184, 8342, 8995, 9957, 10622, 11190, 11667, 12577, 12671, 12836, 13766, 13897, 14130, 15089, 15376]","[514, 650, 740, 925, 1015, 1278, 1715, 1941, 2312, 2446, 2727, 3091, 3286, 3444, 3683, 3843, 4223, 4448, 4787, 4954, 5092, 5187, 5658, 6018, 6113, 6763, 7055, 7151, 8993, 9143]","[623, 713, 908, 1043, 1133, 1313, 1403, 1638, 1938, 2421, 2608, 2855, 3089, 3247, 3468, 3612, 3819, 4280, 4582, 4895, 5224, 5548, 6056, 6150, 6245, 6524, 6721, 7186, 7990, 8090]",18889,13742,15376,9143,8090,3370,3541,790,3342,789,11832,30,radiant
7557552704,10,43,23,79,20,"[0, 166, 433, 558, 916, 1250, 1631, 2092, 2427, 2912, 3522, 3889, 4555, 5238, 5507, 6154, 6881, 7718, 8507, 9603, 10456, 10550, 11010, 11959, 12720, 13694, 14666, 15491, 16488, 17329]","[0, 254, 525, 817, 1125, 1502, 1834, 2324, 2658, 3456, 4245, 4701, 5508, 5946, 6825, 7579, 8038, 8689, 9858, 10791, 12079, 12173, 13816, 14344, 15151, 16018, 16694, 17054, 17532, 17740]","[0, 204, 576, 1017, 1406, 1571, 1849, 2257, 2589, 3200, 4005, 4538, 5064, 5766, 6628, 7128, 7594, 8385, 8792, 9373, 9947, 10144, 10867, 11328, 11689, 12177, 12598, 12737, 13284, 14023]","[0, 130, 245, 733, 868, 958, 1177, 1397, 1790, 2200, 2632, 2843, 3135, 3231, 3636, 3824, 4300, 4509, 4711, 5022, 5452, 5546, 6106, 6350, 6892, 7249, 7840, 8353, 8613, 9068]","[0, 130, 245, 335, 473, 563, 714, 804, 1032, 1284, 1599, 1761, 1930, 2175, 2598, 2729, 2896, 3083, 3408, 3719, 4017, 4111, 4278, 4807, 5154, 5568, 6093, 6234, 6419, 6608]",17329,17740,14023,9068,6608,78,6,98,64,21,"[0, 246, 499, 747, 1091, 1522, 1813, 2127, 2585, 3032, 3561, 3997, 4778, 5278, 5593, 6063, 6578, 6928, 7975, 8152, 8831, 9403, 10146, 10825, 11229, 12124, 12977, 13343, 14454, 14840]","[0, 247, 484, 684, 963, 1398, 2116, 2327, 2462, 2731, 3193, 3540, 4232, 4743, 4892, 5443, 6095, 6662, 7345, 7677, 8067, 8926, 9110, 9531, 10109, 10840, 11372, 11912, 12712, 13312]","[0, 367, 763, 1093, 1468, 1842, 2305, 2551, 3047, 3392, 3859, 4528, 4968, 5540, 5733, 6139, 6982, 7319, 7981, 8076, 8513, 8902, 9086, 9917, 10585, 11168, 12017, 12722, 13856, 14388]","[0, 357, 536, 626, 760, 1103, 1309, 1399, 1687, 1955, 2125, 2313, 2742, 2890, 3093, 3283, 3621, 3933, 4573, 4729, 4913, 5229, 5415, 5842, 6028, 6195, 6337, 6639, 7222, 7318]","[0, 210, 352, 489, 579, 937, 1121, 1379, 1734, 2081, 2216, 2365, 2788, 3094, 3559, 3717, 4026, 4183, 4560, 4907, 5241, 5557, 5748, 6060, 6573, 6904, 7300, 7533, 7973, 8264]",14840,13312,14388,7318,8264,2489,4428,-365,1750,-1656,6646,30,radiant
7557808608,10,39,96,123,66,"[419, 739, 1346, 1588, 2052, 2534, 3041, 3659, 4325, 4920, 5701, 6635, 6856, 7383, 8169, 8865, 9893, 10638, 11149, 11553, 12022, 12844, 14364, 15420, 16295, 17305, 17485, 18355, 19154, 20944]","[506, 791, 1318, 1747, 2098, 2417, 2726, 3265, 4186, 4551, 5192, 5719, 6103, 6696, 7550, 8585, 9282, 10215, 10842, 11148, 11313, 12319, 13067, 13475, 14430, 15254, 15688, 16503, 17477, 19219]","[396, 764, 1133, 1410, 1838, 2146, 2433, 2898, 3622, 4181, 4713, 5352, 5981, 6261, 6656, 7504, 7909, 8618, 8874, 9264, 10076, 10415, 11352, 12024, 12407, 12948, 13044, 13507, 14331, 15473]","[266, 453, 661, 773, 1025, 1475, 1612, 1877, 2331, 2529, 3069, 3481, 3871, 4132, 4427, 5020, 5444, 5855, 6075, 6528, 7253, 7573, 7667, 8194, 8633, 8901, 9127, 9294, 9666, 10577]","[258, 367, 674, 792, 917, 1269, 1480, 1684, 2234, 2732, 3069, 3582, 3801, 4061, 4608, 4896, 5301, 5830, 6132, 6485, 6757, 6990, 7551, 7791, 8042, 8391, 8649, 9038, 9328, 9937]",20944,19219,15473,10577,9937,95,13,128,53,19,"[558, 794, 1388, 1805, 2208, 2605, 2845, 3309, 3739, 4303, 4836, 5249, 5552, 6244, 6926, 7712, 7970, 8225, 8831, 9232, 10955, 11598, 12492, 13445, 14010, 14683, 15399, 16240, 16798, 16898]","[565, 872, 1206, 1539, 1950, 2305, 3004, 3298, 3472, 3953, 4372, 4751, 5566, 5876, 6296, 6391, 6877, 7254, 7945, 8356, 8927, 9633, 10068, 10524, 11678, 12201, 12639, 13447, 14217, 14698]","[639, 871, 1276, 1484, 1799, 2120, 2516, 3023, 3420, 3865, 4382, 4974, 5544, 5951, 6631, 6799, 7044, 7483, 8301, 8648, 9484, 9853, 10455, 10866, 11065, 11685, 12167, 12645, 12741, 12952]","[300, 395, 600, 735, 825, 1267, 1480, 1722, 1812, 2045, 2248, 2536, 2968, 3195, 3711, 3912, 4274, 4676, 5203, 5526, 6139, 6424, 7718, 7957, 8386, 9556, 10329, 10749, 10880, 10980]","[300, 390, 529, 619, 709, 879, 1107, 1332, 1422, 1980, 2070, 2255, 2620, 2875, 3032, 3446, 3600, 3792, 4050, 4145, 4831, 5176, 5455, 5694, 6207, 6558, 6965, 7343, 7618, 7718]",16898,14698,12952,10980,7718,4046,4521,2521,-403,2219,12904,30,radiant
7557812714,1,23,97,53,72,"[0, 248, 638, 885, 1271, 1627, 2358, 2935, 3290, 3665, 3951, 4347, 5120, 6188, 6761, 7432, 8547, 9466, 10201, 11098, 11545, 12516, 12904, 13646, 14484, 15230, 15947, 16722, 17018, 17498]","[0, 337, 616, 1071, 1729, 2066, 2679, 3227, 3660, 4255, 4858, 5157, 6423, 7299, 7848, 8112, 8495, 8813, 9630, 9958, 10409, 10918, 11441, 12323, 12866, 13209, 13433, 13528, 14176, 14963]","[0, 292, 613, 947, 1270, 1664, 2046, 2472, 3204, 3545, 4109, 4390, 5100, 5586, 6057, 6381, 6907, 7469, 8481, 9265, 9645, 10185, 10939, 11442, 12197, 12506, 13127, 13222, 13701, 13936]","[0, 209, 299, 389, 568, 704, 853, 1005, 1384, 1474, 1763, 1853, 2536, 2944, 3393, 3801, 4455, 4976, 5362, 6033, 6128, 6466, 6868, 7591, 8116, 8211, 8651, 9089, 9185, 9515]","[0, 209, 629, 765, 992, 1131, 1569, 1757, 1948, 2119, 2347, 2475, 2916, 3277, 3472, 3566, 4082, 4387, 4525, 5060, 5422, 5517, 6035, 6465, 6584, 6781, 7005, 7100, 7741, 8190]",17498,14963,13936,9515,8190,98,41,104,64,26,"[0, 222, 549, 802, 1099, 1465, 1927, 3058, 3606, 4231, 4835, 5527, 5973, 6310, 6678, 6913, 8262, 9067, 9447, 10375, 11341, 11901, 12853, 13817, 14498, 15005, 15450, 16447, 17801, 17972]","[0, 243, 561, 723, 1258, 1573, 1806, 2067, 2326, 2768, 3106, 3461, 4040, 4385, 4747, 5236, 6464, 7207, 7677, 8614, 9725, 10159, 10625, 10972, 11359, 12359, 12705, 13998, 15045, 15432]","[0, 271, 703, 1032, 1372, 1712, 1925, 2513, 2868, 3213, 3699, 4073, 4662, 5013, 5469, 5856, 6454, 6778, 7675, 8570, 8841, 9722, 10397, 10656, 10751, 11163, 11706, 11969, 12577, 12673]","[0, 154, 244, 334, 559, 649, 826, 1293, 1516, 1699, 1971, 2199, 2472, 2687, 2869, 2963, 3537, 3883, 4040, 4646, 5180, 5606, 5972, 6516, 7049, 7618, 7831, 8351, 8660, 8756]","[0, 154, 366, 492, 663, 787, 927, 1393, 1483, 1922, 2101, 2486, 2759, 2937, 3229, 3323, 3418, 3636, 3906, 4741, 5103, 5281, 5746, 6022, 6192, 6434, 6603, 7165, 7305, 7866]",17972,15432,12673,8756,7866,-474,-469,1263,759,324,1403,30,radiant
7557847702,48,29,74,105,20,"[75, 720, 983, 1403, 1926, 2312, 2684, 3355, 3758, 4350, 4795, 5224, 6220, 7029, 7124, 8123, 8771, 9148, 10004, 10420, 11226, 11778, 12143, 12948, 13293, 13455, 14439, 15046, 17495, 18395]","[141, 436, 723, 960, 1110, 1364, 1644, 1828, 1945, 2331, 2732, 3293, 3855, 4366, 5114, 5347, 5972, 6194, 6580, 7316, 7411, 7802, 8915, 9184, 9625, 9824, 9919, 10849, 13108, 13826]","[208, 588, 797, 1086, 1216, 1643, 2090, 2257, 2879, 3063, 3406, 4018, 4882, 5341, 5659, 6024, 6865, 7068, 7625, 7906, 8501, 8838, 9149, 9278, 9545, 9745, 10133, 10267, 10609, 11587]","[75, 490, 580, 734, 907, 1077, 1492, 1582, 1966, 2377, 2821, 3331, 3731, 4157, 4502, 4850, 5271, 5872, 6029, 6342, 6613, 6955, 7237, 7573, 7775, 8275, 8719, 8889, 10003, 10808]","[0, 681, 801, 998, 1205, 1696, 1975, 2217, 2841, 3025, 3208, 3758, 3960, 4108, 4360, 4483, 4835, 4929, 5192, 5530, 5625, 5819, 6191, 6286, 6650, 6783, 7079, 7174, 8153, 8704]",18395,13826,11587,10808,8704,41,106,38,107,79,"[191, 631, 1033, 1243, 1524, 1900, 2303, 2767, 3245, 3747, 4406, 4637, 5406, 6102, 6718, 7231, 7741, 8240, 8873, 10007, 10697, 11099, 12619, 13233, 13927, 14867, 16214, 16770, 17573, 18371]","[122, 426, 961, 1124, 1514, 1874, 2213, 2738, 3033, 3692, 4477, 4567, 5123, 5731, 6302, 6746, 7588, 8495, 9045, 10082, 10597, 11086, 12327, 12996, 13980, 15559, 17042, 17620, 18014, 18110]","[390, 705, 923, 1050, 1425, 1821, 2197, 2647, 2855, 3260, 4007, 4506, 4956, 5661, 6436, 7092, 7587, 8256, 8794, 10014, 10599, 11034, 12632, 13327, 13672, 14673, 15360, 16231, 16906, 17173]","[122, 252, 425, 550, 675, 1225, 1315, 1450, 1540, 2003, 2489, 2700, 2880, 3443, 3839, 4229, 5049, 5673, 5816, 6234, 6712, 7358, 8226, 8475, 8928, 9610, 9950, 10245, 10466, 10917]","[122, 533, 663, 777, 954, 1129, 1267, 1420, 1786, 1912, 2304, 2568, 2821, 3256, 3917, 4298, 4671, 5053, 5193, 6029, 6250, 6344, 6856, 7232, 7597, 8500, 8840, 9135, 9592, 9688]",18371,18110,17173,10917,9688,24,-4284,-5586,-109,-984,-10939,30,dire
7557858600,98,51,6,105,100,"[0, 206, 480, 890, 1371, 1669, 2064, 2670, 3093, 3643, 4278, 5011, 5540, 6049, 6519, 7480, 7989, 9022, 9698, 10016, 10884, 11894, 12477, 13109, 13966, 14630, 15605, 16195, 16424, 16796]","[0, 243, 527, 910, 1089, 1447, 1862, 2623, 3013, 3495, 3790, 4443, 5182, 5774, 6365, 7394, 7593, 8341, 8651, 9482, 9991, 10802, 11509, 12032, 12703, 13325, 13723, 14238, 14877, 15704]","[0, 251, 704, 986, 1114, 1451, 1646, 1856, 2073, 2330, 2640, 2864, 3376, 3870, 4275, 5214, 5586, 6126, 6938, 7465, 8264, 9243, 10089, 10331, 10755, 11263, 11901, 12288, 12517, 13383]","[0, 169, 276, 370, 460, 595, 803, 1043, 1178, 1535, 1625, 2117, 2504, 2764, 2905, 3233, 3477, 3832, 4127, 4445, 4860, 5555, 5917, 6262, 6536, 6741, 6955, 7281, 7882, 8251]","[0, 384, 608, 718, 850, 1041, 1131, 1221, 1356, 1529, 1619, 1985, 2458, 2718, 2813, 3265, 3675, 3960, 4591, 4798, 5146, 5526, 5726, 5999, 6275, 6480, 6788, 6943, 7039, 7534]",16796,15704,13383,8251,7534,25,54,47,53,123,"[58, 387, 716, 1074, 1787, 2564, 2936, 3596, 3951, 4529, 5183, 5719, 6280, 7133, 7828, 8298, 8835, 9507, 10191, 11085, 11571, 11666, 12124, 12895, 13590, 14404, 15487, 15969, 16677, 17338]","[58, 263, 467, 681, 962, 1377, 1674, 2013, 2168, 2599, 2887, 3309, 3851, 4258, 4768, 5395, 5815, 6485, 6920, 7476, 8040, 8440, 9165, 9525, 10274, 10531, 11002, 11890, 12715, 13350]","[326, 596, 723, 901, 1187, 1437, 1993, 2313, 2662, 3491, 3980, 4225, 4794, 5526, 5767, 6598, 6756, 7287, 7793, 8088, 8464, 8667, 9511, 9606, 10063, 10263, 10695, 11289, 12098, 12470]","[58, 425, 515, 609, 783, 913, 1124, 1520, 1741, 2239, 2536, 2779, 3101, 3860, 3955, 4332, 5140, 5745, 6105, 6400, 6803, 7006, 7304, 7399, 7884, 7979, 8670, 8993, 9798, 9979]","[58, 330, 493, 583, 761, 891, 1102, 1498, 1588, 1910, 2412, 2797, 3466, 4081, 4176, 4698, 4856, 4951, 5494, 6026, 6121, 6216, 6797, 7402, 7755, 7850, 8529, 8852, 9427, 9824]",17338,13350,12470,9979,9824,-542,2354,913,-1728,-2290,-1293,30,radiant
7557859218,21,39,49,53,119,"[0, 274, 567, 972, 1327, 1687, 2139, 2621, 3283, 3847, 4285, 5190, 5767, 6526, 7121, 8003, 9021, 9883, 10264, 11373, 12024, 12912, 13449, 14081, 14746, 15889, 17205, 18317, 19300, 19948]","[0, 332, 688, 931, 1397, 1809, 2214, 2968, 3429, 4105, 4689, 5500, 5917, 6411, 7188, 7543, 8324, 8619, 9159, 9685, 10046, 10646, 11454, 12046, 12674, 13380, 14729, 15790, 17634, 18249]","[0, 245, 599, 1161, 1529, 1952, 2153, 2533, 3076, 3722, 4421, 5286, 5697, 6511, 7064, 7511, 8843, 10072, 10741, 11096, 11819, 11999, 12698, 13146, 13936, 14515, 15025, 15510, 16648, 17288]","[0, 169, 259, 349, 585, 890, 1124, 1580, 1762, 2247, 2472, 2807, 3003, 3775, 4573, 5416, 6048, 6436, 6845, 7200, 7857, 8475, 8747, 9247, 9850, 10489, 10911, 11312, 12506, 13432]","[0, 169, 259, 789, 1137, 1227, 1577, 1839, 2009, 2205, 2430, 2766, 3003, 3310, 3525, 3920, 4445, 4836, 4970, 5573, 5731, 6007, 6173, 6411, 6731, 7133, 7600, 8016, 8741, 9054]",19948,18249,17288,13432,9054,10,22,47,71,20,"[0, 203, 514, 715, 1222, 1592, 2029, 2483, 2914, 3629, 4155, 4856, 5394, 5912, 6449, 6610, 6856, 8049, 9268, 10135, 10415, 11127, 12529, 12829, 12924, 13806, 14524, 15016, 15660, 16159]","[0, 257, 665, 846, 1138, 1271, 1595, 2089, 2466, 2712, 3394, 3770, 4038, 4378, 4696, 4790, 4995, 5972, 6734, 7224, 7839, 8208, 9004, 9589, 10412, 10691, 11455, 11550, 12013, 12400]","[0, 169, 489, 738, 868, 1077, 1358, 1782, 2077, 2539, 2933, 3230, 3769, 4086, 4341, 4472, 4801, 5092, 5730, 6632, 6727, 6980, 7478, 8060, 8347, 8638, 9437, 9532, 9628, 9772]","[0, 169, 314, 488, 618, 757, 934, 1175, 1282, 1510, 1696, 1834, 2024, 2418, 2630, 2930, 3025, 3467, 4703, 5448, 5703, 5916, 6641, 7185, 7623, 7742, 8269, 8364, 8460, 8876]","[0, 169, 314, 404, 534, 624, 744, 985, 1075, 1165, 1300, 1390, 1686, 1873, 1968, 2106, 2201, 2550, 2691, 3095, 3384, 3659, 3825, 4110, 4292, 4387, 5116, 5211, 5307, 5571]",16159,12400,9772,8876,5571,3789,5849,7516,4556,3483,25193,30,radiant
7557888317,2,120,10,14,5,"[0, 239, 436, 634, 1210, 1626, 1859, 2253, 2742, 3441, 4199, 4870, 5489, 5672, 6445, 6783, 7542, 8188, 9615, 10441, 10952, 11881, 12400, 12710, 14058, 14864, 15615, 15785, 17190, 17662]","[0, 412, 776, 1227, 1637, 2007, 2550, 3182, 3692, 4238, 4706, 5388, 5995, 6555, 7167, 7261, 7678, 8587, 9033, 9608, 10186, 11257, 11781, 12766, 14213, 15002, 15096, 15350, 15789, 16003]","[0, 243, 481, 768, 971, 1138, 1625, 2089, 2325, 2503, 3066, 3552, 4315, 4846, 5289, 5780, 6355, 6998, 7727, 9008, 9571, 9930, 10559, 11428, 11862, 12735, 12829, 13120, 13919, 14896]","[0, 273, 412, 502, 1249, 1410, 1699, 1789, 1975, 2253, 2478, 2666, 2964, 3207, 3473, 3705, 4222, 4452, 5169, 5678, 5799, 6275, 6369, 6727, 7478, 7862, 8383, 8478, 8574, 8923]","[0, 170, 260, 398, 488, 578, 761, 890, 980, 1205, 1430, 1520, 1837, 1986, 2235, 2329, 2424, 2654, 2834, 3340, 3630, 3992, 4086, 4505, 4906, 5129, 5877, 5972, 6068, 6462]",17662,16003,14896,8923,6462,48,106,53,96,86,"[0, 208, 569, 974, 1226, 1666, 2048, 2552, 3112, 3681, 4356, 5168, 5827, 6800, 7808, 8775, 9979, 10998, 11530, 11846, 13086, 13632, 15082, 16484, 17402, 19066, 20325, 21206, 22595, 24949]","[0, 361, 759, 1173, 1507, 1928, 2461, 2818, 3506, 4135, 4581, 5149, 5705, 6303, 6946, 7698, 8474, 9208, 9666, 9761, 10489, 10809, 11689, 12515, 12919, 13293, 14259, 15365, 16146, 17563]","[0, 170, 400, 490, 654, 788, 878, 1014, 1423, 1795, 1979, 2381, 2622, 3017, 3337, 3619, 4325, 5018, 5434, 5900, 6726, 7157, 7908, 8413, 8902, 10222, 10768, 11934, 12966, 14072]","[0, 282, 523, 832, 1166, 1752, 1962, 2503, 2980, 3331, 3742, 4141, 4481, 5143, 5692, 6170, 6769, 7347, 7709, 7988, 8601, 8831, 9267, 9559, 10003, 10652, 10856, 11776, 13117, 14208]","[0, 170, 260, 350, 760, 897, 1001, 1174, 1791, 1948, 2363, 2453, 3034, 3601, 3819, 4245, 4899, 5339, 5491, 5720, 6636, 6941, 8039, 8511, 8815, 9621, 10312, 10607, 11404, 12190]",24949,17563,14072,14208,12190,-7287,-1560,824,-5285,-5728,-19036,30,dire
7557904901,49,41,76,123,20,"[0, 290, 642, 943, 1299, 1770, 2192, 2677, 3223, 3475, 4267, 4667, 4983, 5540, 6171, 7041, 8028, 8478, 8676, 9520, 9875, 10275, 10568, 11255, 11765, 12347, 12874, 13041, 13843, 14554]","[0, 244, 445, 618, 914, 1316, 1615, 2024, 2391, 3106, 3805, 4174, 4753, 4848, 5343, 6031, 6468, 7020, 7356, 7900, 8619, 8995, 9288, 9817, 10346, 11128, 12190, 12285, 12811, 13890]","[0, 169, 383, 706, 901, 1229, 1509, 2120, 2571, 2962, 3735, 4121, 4426, 5306, 5754, 6374, 6587, 6899, 7175, 7569, 8150, 8614, 9244, 9538, 10069, 10466, 10895, 10990, 11120, 11857]","[0, 169, 259, 429, 563, 958, 1093, 1430, 1598, 1887, 2267, 2428, 2651, 2828, 3135, 3508, 4019, 4200, 4370, 4663, 4792, 5153, 5427, 5768, 6070, 6421, 6897, 6992, 7088, 7312]","[0, 169, 259, 349, 439, 590, 725, 906, 1110, 1280, 1757, 2113, 2300, 2602, 2697, 2944, 3184, 3420, 3515, 3772, 4044, 4370, 4602, 5006, 5101, 5378, 5472, 5621, 5766, 6175]",14554,13890,11857,7312,6175,106,22,71,93,53,"[0, 288, 690, 984, 1438, 1763, 2084, 2304, 2775, 3152, 4011, 4139, 4531, 5112, 5662, 6046, 6723, 7475, 7840, 8361, 9159, 9447, 10222, 11063, 11800, 12370, 13296, 14345, 14984, 15553]","[0, 169, 309, 877, 1007, 1255, 1562, 1697, 1897, 1987, 2167, 2497, 3114, 3668, 3869, 5011, 5374, 5925, 6233, 6904, 7585, 8592, 9698, 10153, 10585, 11098, 11436, 12006, 12669, 13442]","[0, 205, 482, 876, 1277, 1871, 2158, 2727, 3267, 3716, 4045, 4257, 4973, 5514, 5663, 6397, 6645, 6740, 7530, 8114, 8596, 9337, 10184, 10694, 11723, 12186, 12960, 14082, 14614, 15810]","[0, 208, 532, 690, 935, 1309, 1601, 2137, 2771, 2999, 3586, 3889, 4513, 5082, 5704, 6404, 7274, 7968, 8940, 9666, 10614, 11102, 12269, 12772, 13362, 13860, 14474, 15275, 15911, 16322]","[0, 169, 259, 383, 558, 688, 846, 981, 1071, 1161, 1455, 1545, 1819, 2128, 2377, 2807, 3055, 3448, 3712, 4315, 4536, 4931, 5746, 5947, 6301, 6482, 6762, 6982, 7356, 7859]",15553,13442,15810,16322,7859,-999,448,-3953,-9010,-1684,-15198,30,dire
7557909018,21,76,2,100,123,"[0, 244, 513, 898, 1224, 1506, 1919, 2543, 2974, 3995, 4121, 4265, 5497, 5629, 6111, 6850, 7237, 8077, 8483, 9420, 9515, 10035, 11005, 11657, 12470, 13544, 13809, 14675, 14771, 15229]","[0, 328, 564, 897, 1240, 1573, 1936, 2085, 2328, 2754, 3097, 3363, 3596, 3797, 4202, 4613, 5213, 5459, 5764, 6296, 7002, 7705, 8339, 8941, 9591, 10266, 10799, 11030, 11224, 11973]","[0, 292, 560, 880, 1251, 1426, 1870, 2168, 2383, 2806, 3161, 3746, 4066, 4410, 4645, 4908, 5197, 5484, 5760, 6078, 6173, 6268, 6529, 7121, 7754, 8315, 8786, 9198, 9294, 9628]","[0, 209, 299, 469, 652, 742, 880, 1061, 1151, 1486, 1576, 1720, 2082, 2177, 2272, 2691, 3343, 3438, 3748, 4066, 4161, 4839, 5548, 5732, 6153, 6448, 6739, 7121, 7532, 8293]","[0, 209, 526, 662, 1098, 1188, 1335, 1489, 1579, 1769, 1859, 2003, 2365, 2475, 2570, 2897, 3082, 3177, 3666, 3997, 4146, 4579, 4744, 5016, 5444, 5919, 6432, 6782, 7071, 7424]",15229,11973,9628,8293,7424,106,32,33,45,19,"[0, 239, 478, 857, 1190, 1465, 1888, 2352, 3070, 3372, 4061, 4624, 5854, 6522, 7133, 7611, 8266, 8522, 9269, 9832, 10680, 11075, 11690, 12304, 12561, 13071, 13610, 14410, 15509, 16437]","[0, 199, 814, 1060, 1390, 1965, 2498, 2882, 3310, 3491, 4460, 4952, 5801, 5996, 6309, 6800, 7671, 8079, 8208, 8773, 9007, 9505, 10812, 11372, 12144, 12473, 13001, 13832, 14479, 15409]","[0, 210, 551, 1065, 1509, 1713, 2135, 2497, 3098, 3317, 4247, 4882, 5326, 5703, 6332, 6773, 7393, 7619, 8677, 9351, 9810, 9905, 10582, 10989, 11502, 12388, 12842, 13521, 14509, 15062]","[0, 129, 299, 434, 564, 1025, 1286, 1442, 1695, 2063, 2420, 2827, 3369, 3668, 3937, 4350, 4833, 4991, 5347, 5786, 6478, 6969, 7474, 7771, 8001, 8096, 8360, 8999, 9594, 10493]","[0, 129, 219, 611, 788, 914, 1141, 1268, 1725, 1860, 2507, 2745, 3456, 3605, 3700, 4224, 4509, 4667, 5120, 5473, 5568, 6035, 6540, 6875, 7177, 7501, 7868, 8910, 9694, 10049]",16437,15409,15062,10493,10049,-1208,-3436,-5434,-2200,-2625,-14903,30,dire
7557955707,120,41,102,107,75,"[0, 257, 622, 1092, 1414, 1614, 2057, 2475, 3015, 3105, 3488, 4181, 4434, 5279, 5679, 6066, 6803, 7285, 8116, 8273, 8857, 9617, 10021, 10343, 10880, 11514, 11947, 12203, 12500, 12808]","[0, 294, 490, 762, 1132, 1530, 1858, 2216, 2615, 3243, 3644, 4197, 4680, 5034, 5570, 5856, 6829, 7325, 7934, 8499, 8594, 9125, 9664, 10008, 10698, 11264, 11741, 12060, 13070, 14057]","[0, 208, 519, 804, 1102, 1433, 1523, 1909, 2313, 2968, 3508, 4040, 4284, 4454, 5054, 5401, 6564, 7152, 7502, 7826, 8272, 8716, 9460, 10003, 10264, 10883, 11153, 11835, 12112, 12420]","[0, 217, 359, 690, 780, 949, 1039, 1174, 1264, 1743, 2194, 2485, 2622, 3063, 3231, 3325, 3977, 4348, 4785, 4942, 5097, 5319, 5489, 5658, 5828, 6334, 6504, 6835, 7051, 7434]","[0, 169, 259, 349, 488, 630, 742, 877, 967, 1057, 1250, 1714, 1983, 2340, 2497, 2591, 2910, 3095, 3390, 3547, 3818, 3989, 4198, 4292, 4437, 4532, 4627, 4883, 4979, 5287]",12808,14057,12420,7434,5287,17,93,97,27,26,"[65, 382, 671, 885, 1282, 1832, 2087, 2460, 2771, 3547, 4127, 4954, 5352, 5782, 6133, 6680, 7341, 7895, 8495, 9592, 10522, 11304, 12329, 12955, 13863, 14636, 15577, 16832, 18397, 19100]","[65, 293, 614, 814, 1323, 1525, 1973, 2354, 2606, 2908, 3625, 3969, 4353, 5166, 5949, 6469, 7165, 7952, 8669, 9910, 10573, 11223, 11689, 12863, 13931, 14665, 15306, 16319, 17819, 18871]","[65, 259, 657, 1096, 1496, 1751, 1992, 2209, 2606, 3164, 3771, 4186, 4303, 4589, 5129, 5391, 6009, 6559, 6903, 7240, 7583, 7822, 8091, 8942, 9606, 10148, 10684, 11167, 12242, 12663]","[65, 259, 549, 705, 883, 1364, 1674, 1885, 2246, 2681, 2951, 3395, 3691, 3968, 4199, 4449, 4750, 5019, 5457, 6195, 6412, 6636, 7487, 8308, 8817, 9249, 9419, 10022, 11120, 11624]","[333, 577, 667, 846, 1137, 1227, 1361, 1511, 1898, 2603, 2873, 3263, 3400, 3781, 3975, 4151, 4309, 4538, 4809, 5414, 5789, 5984, 6244, 6912, 7261, 7653, 7748, 8733, 9473, 10147]",19100,18871,12663,11624,10147,-6292,-4814,-243,-4190,-4860,-20399,30,dire
7558125303,50,54,29,123,20,"[0, 626, 943, 1436, 1930, 2413, 2934, 3379, 4118, 4590, 5054, 5747, 6276, 6619, 7227, 7322, 8215, 8925, 9602, 10188, 10527, 11038, 11852, 12578, 13707, 13911, 15029, 15158, 15558, 15654]","[0, 208, 575, 980, 1368, 1726, 2378, 3040, 3549, 3840, 4209, 5172, 5532, 5814, 6242, 6982, 7771, 8280, 9036, 9608, 10107, 10253, 10796, 11352, 12576, 12977, 13635, 14174, 14497, 14593]","[0, 272, 511, 764, 1120, 1280, 1370, 1670, 2330, 2937, 3600, 4162, 4606, 5047, 5447, 5655, 6325, 6724, 7120, 7619, 8380, 8571, 8793, 9272, 10239, 10544, 10639, 11146, 11430, 11674]","[0, 339, 429, 563, 699, 932, 1084, 1374, 1620, 1850, 2020, 2733, 3263, 3815, 4049, 4298, 4952, 5210, 5882, 6465, 7046, 7235, 7940, 8345, 9372, 9640, 10278, 10558, 11213, 11389]","[0, 238, 328, 418, 554, 644, 856, 1036, 1282, 1512, 1648, 1918, 2213, 2522, 2662, 2757, 3226, 3365, 3680, 4066, 4545, 4639, 4978, 5128, 5429, 5633, 5728, 5998, 6366, 6462]",15654,14593,11674,11389,6462,10,23,17,119,112,"[0, 282, 564, 769, 1096, 1457, 2194, 2921, 3416, 3849, 4394, 4999, 5611, 6763, 7468, 8561, 9324, 10239, 10614, 11368, 12151, 12632, 13675, 14251, 14346, 14982, 15618, 16884, 18364, 18972]","[0, 170, 414, 731, 1103, 1474, 1982, 2430, 2879, 3382, 3939, 4329, 4817, 5405, 5828, 6393, 7069, 7730, 8002, 8354, 9075, 9390, 9912, 10466, 10727, 11293, 12255, 13436, 14410, 15161]","[0, 219, 424, 646, 906, 1179, 1448, 1684, 2165, 2458, 3013, 3444, 4034, 4688, 5221, 5840, 6489, 7032, 7759, 8355, 9000, 9222, 10191, 11032, 11994, 12351, 12693, 13105, 13889, 14304]","[0, 170, 260, 350, 440, 530, 665, 1143, 1277, 1412, 1711, 1969, 2441, 2948, 3214, 3532, 4022, 4165, 4319, 4890, 5403, 6272, 6529, 7052, 7232, 7673, 8597, 8957, 9692, 10028]","[0, 170, 260, 350, 440, 618, 753, 934, 1154, 1356, 1688, 1778, 2001, 2451, 2944, 3356, 3531, 3672, 3826, 4167, 4530, 5415, 5821, 6452, 6693, 7538, 7849, 8464, 9152, 9286]",18972,15161,14304,10028,9286,-3318,-568,-2630,1361,-2824,-7979,30,dire
7558127419,48,80,86,51,19,"[657, 906, 1372, 1844, 2148, 2406, 2729, 3432, 4046, 4589, 5101, 6094, 7141, 7589, 8084, 8892, 9848, 10973, 11868, 12805, 13738, 14234, 15021, 15885, 17055, 18079, 19139, 20244, 20931, 22328]","[684, 1174, 1375, 1709, 1981, 2459, 2832, 3336, 4096, 4637, 4732, 5133, 5858, 6062, 6724, 7307, 7851, 8420, 8924, 9120, 9735, 10178, 10632, 11252, 11491, 12021, 12971, 13067, 13533, 14570]","[793, 1294, 1769, 2463, 2877, 3104, 3761, 4461, 5283, 5764, 5949, 6386, 6731, 7399, 7494, 8000, 8711, 9150, 9245, 9477, 9896, 10177, 10824, 10918, 11527, 12045, 12515, 12611, 12841, 13509]","[318, 503, 878, 1278, 1506, 1758, 2004, 2375, 2816, 3152, 3247, 3641, 4011, 4211, 4725, 5019, 5114, 5223, 5393, 5580, 5840, 6010, 6252, 6466, 6922, 7427, 7972, 8143, 8448, 8929]","[269, 399, 625, 951, 1131, 1588, 1692, 1935, 2243, 2478, 2654, 2987, 3537, 4010, 4324, 4669, 4779, 5067, 5486, 5764, 6024, 6249, 6587, 6756, 7318, 7570, 8115, 9014, 9319, 10091]",22328,14570,13509,8929,10091,95,33,90,100,26,"[1171, 1750, 2275, 2523, 3148, 3617, 4221, 4796, 5440, 5910, 7233, 7960, 8618, 9407, 10779, 11442, 12092, 12743, 14137, 15215, 15861, 16799, 17421, 18119, 19139, 19646, 20501, 21738, 22840, 23529]","[1185, 1617, 1861, 2266, 2947, 3267, 4008, 4673, 5204, 5704, 6698, 7281, 7914, 8317, 8982, 9782, 10359, 11172, 11934, 12878, 13739, 14200, 14880, 15587, 15757, 16355, 16890, 18025, 18706, 19307]","[1147, 1469, 1903, 2511, 2941, 3695, 4329, 4733, 5153, 5606, 6530, 7414, 7791, 8370, 8919, 9253, 10038, 10196, 10607, 11451, 12161, 12602, 13020, 13643, 13955, 14363, 14996, 15917, 16841, 17400]","[684, 820, 910, 1076, 1211, 1441, 1666, 1824, 2023, 2113, 2697, 3256, 3666, 3895, 4186, 4518, 4861, 5019, 5389, 5755, 6151, 6357, 6524, 6618, 6857, 6953, 7414, 7682, 8035, 8210]","[937, 1075, 1210, 1300, 1435, 1824, 2050, 2209, 2299, 2389, 3004, 3442, 3635, 4026, 4620, 4849, 5007, 5165, 5535, 5901, 6106, 6296, 6463, 6557, 6796, 6892, 7257, 7858, 8459, 8559]",23529,19307,17400,8210,8559,-1201,-4737,-3891,719,1532,-7578,30,dire
7558222315,95,80,74,123,20,"[58, 436, 788, 1170, 1648, 2126, 2596, 2918, 3128, 3449, 3830, 4085, 4747, 5181, 6250, 6521, 7182, 7907, 8598, 8813, 9437, 10246, 10685, 12224, 12772, 13488, 13826, 14334, 15047, 15640]","[58, 384, 587, 1021, 1698, 1888, 2135, 2499, 2841, 3091, 3638, 4124, 4592, 5029, 6204, 6761, 7409, 7977, 8652, 8843, 9259, 9755, 10199, 11362, 11964, 12425, 12984, 13527, 14274, 14571]","[326, 576, 936, 1315, 1565, 1904, 2618, 2931, 3021, 3473, 3964, 4092, 4743, 5282, 6154, 6339, 6634, 7151, 7642, 7736, 8328, 8695, 9086, 10086, 10432, 10836, 11579, 11809, 12291, 12456]","[58, 354, 444, 553, 689, 779, 913, 1087, 1177, 1353, 1597, 1865, 2144, 2373, 3248, 3473, 3567, 3823, 4569, 4698, 4920, 5105, 5383, 6504, 6898, 7344, 7682, 7776, 8597, 9189]","[158, 587, 677, 826, 1219, 1425, 1515, 1679, 1893, 2069, 2204, 2294, 2589, 2862, 3446, 3541, 3673, 4029, 4237, 4331, 4437, 4879, 5245, 5913, 6083, 6398, 6627, 6796, 7122, 7293]",15640,14571,12456,9189,7293,53,114,98,28,3,"[0, 90, 412, 502, 1147, 1410, 1915, 2363, 2683, 2996, 3230, 3564, 4053, 4496, 5190, 5936, 6264, 6882, 7627, 8676, 9357, 10214, 10994, 11427, 11927, 12902, 13651, 14762, 15438, 15829]","[0, 171, 807, 1135, 1526, 2025, 2647, 3097, 3580, 4038, 4378, 5056, 5358, 5772, 5867, 6775, 7321, 8174, 8915, 10091, 10567, 11663, 12537, 12665, 13428, 14156, 15040, 15896, 16630, 17397]","[0, 163, 597, 814, 1159, 1536, 1837, 2268, 3038, 3457, 4045, 4586, 4992, 5753, 5999, 6718, 7190, 7647, 8361, 8990, 9310, 10259, 11077, 11556, 12224, 12782, 13619, 14153, 14841, 15340]","[0, 164, 452, 728, 818, 908, 1043, 1500, 1983, 2490, 2953, 3469, 3960, 4444, 5014, 5199, 5993, 6171, 6612, 7308, 7542, 8913, 9355, 9449, 9786, 10044, 10671, 11019, 11403, 11713]","[0, 90, 419, 590, 1055, 1145, 1493, 1842, 2206, 2335, 2610, 2923, 3299, 3536, 3798, 4534, 4945, 5040, 5286, 5838, 5933, 6238, 6562, 6656, 7234, 7435, 7855, 8154, 8673, 8816]",15829,17397,15340,11713,8816,-189,-2826,-2884,-2524,-1523,-9946,30,dire
7558241314,89,108,106,26,123,"[0, 164, 498, 784, 1019, 1579, 1978, 2177, 2615, 3198, 4073, 4392, 5311, 5983, 7008, 7511, 8254, 8820, 9366, 10125, 10591, 11251, 11829, 12876, 14026, 14553, 16123, 17539, 18628, 19973]","[0, 169, 495, 1137, 1551, 1731, 2178, 2515, 2933, 3685, 4304, 4853, 5473, 5693, 6186, 6835, 7241, 7758, 8620, 9768, 10326, 10579, 11434, 11853, 12499, 12850, 14017, 14661, 15015, 15405]","[0, 246, 651, 979, 1317, 1611, 1810, 2221, 2311, 2620, 3063, 3373, 4134, 4472, 5284, 5818, 6366, 6605, 7313, 7571, 7887, 8070, 8594, 9219, 10444, 10691, 11718, 12258, 12933, 13355]","[0, 130, 255, 405, 513, 631, 761, 856, 1104, 1479, 1800, 2219, 2560, 2688, 3205, 3486, 3581, 3944, 4549, 4807, 4949, 5044, 5443, 5538, 5632, 5809, 7160, 7802, 8004, 8151]","[0, 179, 659, 1034, 1169, 1304, 1492, 1599, 1689, 2086, 2580, 2670, 2967, 3061, 3464, 3957, 4067, 4161, 4443, 4701, 4934, 5118, 5547, 5757, 5947, 6088, 6721, 7212, 7308, 7537]",19973,15405,13355,8151,7537,73,46,135,65,20,"[0, 330, 502, 889, 1161, 1551, 1886, 2648, 3183, 4125, 4984, 5870, 6723, 8121, 9085, 10288, 11345, 11815, 12461, 13103, 14264, 15315, 16109, 16754, 17732, 18428, 19041, 19760, 21060, 22526]","[0, 320, 656, 942, 1631, 2051, 2651, 3202, 3833, 4059, 4837, 5332, 6249, 6882, 7341, 8314, 9267, 10134, 10627, 11024, 11879, 12525, 13366, 14009, 14823, 15554, 16351, 16547, 17563, 18214]","[0, 248, 446, 679, 1052, 1456, 1873, 2501, 3025, 3443, 3816, 4349, 4757, 5122, 5798, 6407, 7185, 7613, 8020, 8627, 9090, 10058, 10420, 11035, 11578, 12281, 12457, 13118, 13599, 14293]","[0, 258, 396, 486, 666, 1035, 1125, 1350, 1854, 1944, 2061, 2421, 2658, 3010, 3105, 3848, 4346, 4941, 5271, 5822, 6610, 6856, 7284, 7559, 7961, 8301, 8477, 8886, 9097, 9713]","[0, 297, 433, 560, 710, 1121, 1318, 1565, 1779, 1898, 2194, 2284, 2523, 2824, 2977, 3252, 3473, 3669, 3860, 4617, 4883, 5205, 5761, 5856, 5950, 6230, 6406, 6618, 6795, 7161]",22526,18214,14293,9713,7161,-2553,-2809,-938,-1562,376,-7486,30,dire
7558300613,128,10,96,123,45,"[0, 182, 422, 788, 1192, 1488, 1924, 2290, 2843, 3535, 3873, 4489, 4579, 4924, 6468, 7033, 7865, 8386, 8481, 9691, 11354, 12457, 13171, 13282, 14256, 15297, 15786, 16595, 17046, 17591]","[0, 245, 579, 1014, 1275, 1717, 2128, 2489, 2978, 3190, 3994, 4408, 4688, 5615, 6390, 7142, 7299, 7794, 8796, 9723, 10250, 10624, 11018, 11711, 12751, 13817, 14197, 14471, 15235, 15669]","[0, 167, 514, 683, 1001, 1267, 1625, 1913, 2185, 2432, 2718, 3393, 3584, 3769, 4237, 4846, 5189, 5495, 5780, 6214, 6599, 7351, 7713, 7808, 8209, 8718, 8915, 9095, 9546, 9642]","[0, 130, 220, 345, 519, 645, 833, 1197, 1563, 1653, 1788, 1943, 2465, 2650, 3151, 3596, 4144, 4239, 4365, 4567, 5387, 5746, 6072, 6167, 6491, 6845, 7481, 7834, 8285, 8414]","[0, 130, 576, 715, 890, 1027, 1117, 1224, 1326, 1501, 1748, 1876, 2318, 2634, 3150, 3484, 3739, 3834, 4054, 4428, 4929, 5497, 5779, 5874, 6199, 6814, 6909, 7107, 7558, 7796]",17591,15669,9642,8414,7796,36,78,20,68,100,"[0, 281, 616, 874, 1331, 1743, 1955, 2446, 3153, 3658, 4145, 4586, 5885, 6294, 6884, 7453, 8135, 8860, 9934, 11096, 11752, 12247, 13054, 14196, 14729, 15530, 16124, 16855, 19863, 20702]","[0, 283, 682, 884, 1252, 1652, 1742, 2174, 2566, 2932, 3348, 3966, 4622, 5127, 5620, 6354, 7655, 8496, 9424, 10079, 10843, 11771, 12352, 13192, 13748, 14368, 15290, 15849, 17910, 18398]","[0, 296, 542, 868, 1532, 1850, 2133, 2563, 2938, 3667, 4393, 4813, 5119, 5500, 5649, 6129, 6848, 7637, 8111, 8790, 9480, 10063, 10621, 11468, 12159, 12428, 13401, 14026, 15491, 16010]","[0, 210, 486, 576, 706, 866, 956, 1094, 1351, 1525, 1839, 2071, 2446, 2779, 2972, 3317, 3805, 4561, 5317, 5730, 6225, 6392, 6997, 7588, 8330, 8971, 9635, 10223, 12275, 12604]","[0, 210, 414, 759, 1169, 1329, 1466, 1970, 2150, 2470, 2747, 3174, 3799, 4193, 4342, 4762, 5145, 5393, 6163, 6663, 6949, 7293, 7585, 8229, 8580, 9150, 9575, 10044, 11072, 11303]",20702,18398,16010,12604,11303,-3111,-2729,-6368,-4190,-3507,-19905,30,dire
7558405219,48,13,102,21,119,"[2, 287, 594, 932, 1300, 1716, 2094, 2593, 3189, 3663, 4099, 4739, 5309, 6048, 6638, 7262, 8277, 9501, 9942, 10037, 11239, 12165, 13141, 14483, 15119, 15722, 16827, 17493, 18906, 19921]","[0, 279, 545, 908, 1237, 1684, 1984, 2585, 3128, 3659, 4352, 4477, 5085, 5449, 6046, 6517, 7340, 7920, 8140, 8958, 9681, 10016, 10699, 11401, 11776, 12026, 12405, 13058, 13703, 14520]","[0, 248, 533, 780, 1084, 1437, 1634, 1858, 2214, 2909, 3235, 3798, 4278, 4862, 5422, 5633, 6288, 6383, 7187, 7651, 8300, 8395, 8873, 9404, 9944, 10326, 10612, 11225, 11599, 11776]","[2, 176, 270, 360, 456, 635, 795, 928, 1035, 1283, 1418, 1697, 2083, 2274, 2518, 2838, 3022, 3391, 3486, 3823, 4065, 4160, 4462, 4668, 5028, 5249, 5415, 5848, 6323, 6573]","[0, 170, 260, 414, 504, 640, 1022, 1159, 1356, 1585, 1720, 2012, 2493, 2587, 2682, 2777, 3007, 3464, 3934, 4586, 4887, 5024, 5194, 5436, 5645, 5982, 6152, 6658, 7149, 7399]",19921,14520,11776,6573,7399,120,28,89,3,45,"[0, 329, 714, 1085, 1430, 1958, 2353, 3016, 3421, 4051, 4713, 5298, 5661, 6474, 6822, 7588, 8182, 9856, 10410, 11251, 11846, 12517, 13595, 14273, 15634, 15922, 16419, 17101, 17755, 19184]","[0, 220, 481, 775, 1170, 1569, 1950, 2450, 2761, 3267, 3930, 4231, 4997, 5728, 6432, 6970, 7443, 8358, 8778, 9780, 10272, 11019, 11541, 12150, 12523, 12730, 13167, 14036, 14826, 15674]","[0, 309, 638, 886, 1194, 1583, 1845, 2253, 2674, 3010, 3538, 4016, 4818, 5501, 5943, 6630, 7313, 7794, 8647, 9543, 10342, 11164, 12249, 13113, 13564, 14184, 14991, 15765, 16621, 17230]","[0, 220, 335, 517, 647, 753, 1078, 1303, 1717, 1852, 2086, 2640, 2900, 3102, 3318, 3963, 4373, 4748, 4887, 5587, 5996, 6409, 6599, 7147, 7285, 7509, 7815, 8072, 8367, 8520]","[0, 220, 335, 425, 999, 1155, 1245, 1425, 1728, 1921, 2233, 2385, 2696, 2932, 3127, 3562, 3972, 4166, 4412, 4810, 5006, 5727, 6086, 6519, 6716, 6847, 7251, 7508, 7803, 8149]",19184,15674,17230,8520,8149,737,-1154,-5454,-1947,-750,-8568,30,radiant
7558455414,1,97,106,86,121,"[0, 239, 483, 727, 1034, 1358, 1542, 1731, 1972, 2492, 2990, 3354, 4056, 4855, 5463, 6467, 7396, 8566, 9643, 10504, 11605, 12467, 14035, 15162, 16321, 17556, 19173, 19984, 21281, 22518]","[0, 170, 449, 736, 1148, 1598, 2042, 2476, 3099, 3841, 4609, 5115, 5669, 6184, 7035, 8114, 8702, 9707, 10294, 11004, 11389, 12018, 12113, 13156, 14985, 16199, 17131, 17865, 18332, 18869]","[0, 206, 451, 896, 1255, 1574, 2115, 2715, 3224, 3927, 4527, 5043, 5464, 5824, 6357, 7136, 7944, 8997, 9565, 9925, 10565, 10917, 11693, 12665, 14279, 14910, 15469, 16435, 17129, 17759]","[0, 218, 666, 756, 956, 1208, 1380, 1711, 2146, 3097, 3357, 3447, 3537, 3770, 4137, 4535, 5031, 5623, 6068, 6394, 6592, 6818, 7197, 7648, 8556, 8904, 9124, 9403, 9953, 10518]","[0, 170, 311, 418, 583, 1004, 1299, 1668, 2105, 2525, 2838, 2976, 3066, 3289, 3712, 4177, 4398, 5354, 5705, 6199, 6502, 6643, 6842, 7209, 8046, 8658, 8910, 9370, 9711, 10206]",22518,18869,17759,10518,10206,10,47,17,105,20,"[0, 281, 410, 717, 972, 1352, 1636, 2085, 2649, 3109, 3702, 4137, 4752, 5427, 6035, 6321, 7021, 7726, 8030, 8632, 9334, 9766, 10595, 11452, 11547, 12238, 12571, 13414, 14088, 14975]","[0, 205, 490, 743, 1042, 1478, 1770, 2276, 2927, 3524, 4021, 4734, 5103, 5661, 6126, 6231, 6833, 7314, 7969, 8474, 8988, 9250, 9718, 10186, 10281, 10816, 11158, 11759, 12286, 12426]","[0, 289, 744, 1096, 1504, 1700, 1911, 2074, 2450, 2798, 3237, 3858, 4432, 4642, 5154, 5536, 6054, 6211, 6777, 7435, 7748, 8251, 8962, 9412, 9507, 9853, 10060, 10320, 10886, 11730]","[0, 270, 360, 549, 686, 1010, 1100, 1190, 1372, 1601, 1829, 2063, 2356, 2450, 2618, 2815, 2968, 3331, 3574, 3963, 4339, 4444, 4912, 5386, 5485, 6033, 6379, 6533, 6820, 7128]","[0, 218, 326, 466, 875, 1084, 1208, 1308, 1482, 1662, 1890, 2015, 2105, 2324, 2473, 2578, 2673, 2830, 2970, 3384, 3524, 3620, 4088, 4260, 4355, 4567, 4737, 5148, 5480, 5651]",14975,12426,11730,7128,5651,7543,6443,6029,3390,4555,27960,30,radiant
7558794800,10,69,13,110,26,"[725, 1012, 1387, 1851, 2222, 2390, 2719, 3225, 3741, 4278, 4644, 5071, 5624, 6158, 6588, 7493, 8344, 8998, 9416, 9991, 10749, 11482, 12278, 13193, 13798, 14729, 15654, 16159, 16842, 17002]","[638, 1055, 1562, 1909, 2493, 2899, 3313, 3787, 4219, 4482, 5136, 5476, 5944, 6637, 6897, 7326, 8200, 8883, 9069, 9542, 10116, 10802, 11352, 11821, 12243, 13276, 13743, 14416, 15154, 15254]","[469, 1033, 1202, 1553, 1756, 2042, 2525, 2894, 3283, 3740, 4131, 4656, 4799, 5508, 6217, 6792, 7249, 7501, 7846, 8405, 8500, 9402, 10378, 10860, 11468, 11564, 11988, 12992, 13331, 13431]","[382, 565, 741, 1131, 1221, 1384, 1495, 1585, 1768, 1858, 1970, 2064, 2251, 2444, 2712, 2806, 3560, 4138, 4478, 4891, 5193, 5516, 6241, 6535, 6731, 7188, 7404, 7871, 8348, 8448]","[666, 865, 1041, 1176, 1266, 1513, 1603, 1693, 1844, 1963, 2175, 2479, 2597, 2827, 2967, 3061, 3925, 4254, 4397, 4603, 4698, 4793, 5167, 5420, 5587, 5884, 6094, 6494, 6974, 7074]",17002,15254,13431,8448,7074,123,15,35,73,51,"[758, 972, 1229, 1587, 2034, 2757, 3299, 3950, 4352, 4750, 5267, 6105, 6735, 7162, 7972, 8554, 9114, 10196, 10881, 11657, 12993, 13726, 14977, 15723, 16369, 16637, 17217, 18021, 18590, 20157]","[663, 917, 1301, 1720, 2136, 2382, 2824, 3252, 3639, 4280, 4914, 5613, 6407, 7167, 7891, 8555, 9187, 9723, 10183, 10693, 11665, 12339, 12669, 13565, 14364, 15158, 16022, 16698, 17613, 19915]","[1038, 1284, 1614, 1904, 2450, 2700, 3108, 3600, 4126, 4380, 4933, 5455, 6344, 7036, 7900, 8647, 9073, 9817, 10429, 10981, 11965, 12267, 12660, 13271, 14159, 14941, 15407, 16520, 17371, 19227]","[723, 813, 1126, 1216, 1488, 2102, 2457, 2824, 3247, 3476, 3820, 4274, 4783, 5060, 5644, 6210, 6511, 6848, 7760, 8122, 8704, 9295, 10006, 10176, 10591, 10762, 11043, 11802, 12252, 13355]","[446, 536, 641, 959, 1139, 1470, 1699, 1894, 2163, 2615, 2842, 3408, 4035, 4352, 4633, 5299, 5457, 5728, 6005, 6446, 7011, 7313, 7805, 7900, 7995, 8296, 8502, 9033, 9223, 9727]",20157,19915,19227,13355,9727,-3155,-4661,-5796,-4907,-2653,-21172,30,dire
7558802112,109,13,129,90,100,"[0, 170, 520, 798, 1031, 1319, 1409, 1887, 2118, 2545, 3014, 3554, 3755, 4228, 4754, 5287, 6037, 7123, 8043, 9017, 9973, 10489, 11248, 11973, 12811, 14055, 14467, 14706, 15222, 16028]","[0, 205, 418, 706, 915, 1144, 1603, 1855, 2483, 2929, 4002, 4513, 5024, 5315, 5947, 6149, 6750, 7969, 8528, 8841, 10116, 10705, 11351, 12141, 12842, 13346, 13516, 14055, 14521, 15190]","[0, 170, 555, 957, 1227, 1711, 1997, 2449, 2734, 3414, 4133, 4497, 5054, 5558, 5993, 6721, 7041, 8040, 8635, 8882, 9796, 10473, 11126, 11708, 12296, 12608, 13139, 13379, 13475, 14424]","[0, 219, 405, 540, 630, 837, 927, 1062, 1231, 1526, 2235, 2510, 2636, 2990, 3225, 3365, 3633, 4357, 5146, 5747, 6606, 7197, 7434, 7676, 7991, 8158, 8253, 8347, 8653, 8979]","[0, 170, 260, 394, 484, 620, 829, 1010, 1100, 1568, 1862, 1952, 2129, 2224, 2319, 2413, 2758, 3322, 3677, 3924, 4471, 4863, 5346, 5485, 5580, 5944, 6039, 6492, 6796, 6973]",16028,15190,14424,8979,6973,41,39,137,45,20,"[0, 216, 458, 814, 1219, 1595, 1842, 2122, 2698, 2872, 3511, 4012, 4458, 5076, 5531, 6275, 7035, 7461, 7767, 8350, 8661, 8915, 9811, 10555, 11191, 11669, 12244, 12834, 13261, 14366]","[0, 280, 635, 919, 1325, 1745, 2204, 2696, 3100, 3643, 4271, 4901, 5465, 6007, 6335, 6987, 7744, 8132, 8571, 9079, 9467, 10309, 10973, 11196, 11790, 12886, 13246, 14176, 14630, 15188]","[0, 245, 575, 813, 1137, 1436, 1812, 2192, 3059, 3758, 4552, 5190, 5793, 6225, 6863, 7767, 8872, 9143, 9759, 9988, 10295, 10912, 11657, 12172, 12579, 13149, 13780, 14708, 15001, 15277]","[0, 207, 297, 412, 588, 1141, 1535, 1625, 2092, 2716, 3081, 3321, 3664, 4379, 4709, 5106, 5417, 5696, 5920, 6249, 6458, 6675, 7311, 7848, 8059, 8226, 8381, 9253, 9767, 10102]","[0, 170, 260, 422, 552, 731, 830, 967, 1281, 1457, 1682, 1772, 1970, 2323, 2664, 3162, 3473, 3568, 3692, 3921, 4106, 4324, 4785, 5507, 5602, 5769, 5864, 6581, 6968, 7382]",14366,15188,15277,10102,7382,1662,2,-853,-1123,-409,-721,30,dire
7558826219,95,23,20,72,19,"[1250, 1541, 1910, 2253, 2683, 3049, 3649, 4044, 4559, 4931, 5472, 5915, 6346, 7290, 7972, 8641, 9317, 10163, 11118, 12121, 12830, 13630, 14296, 14815, 16568, 17869, 18966, 19614, 21158, 22080]","[1148, 1454, 1775, 2348, 2632, 3263, 3973, 4440, 5363, 5686, 5984, 6231, 6882, 7261, 7749, 8216, 8450, 9056, 9872, 10414, 10833, 11595, 12138, 12695, 13672, 14023, 14256, 14690, 15354, 15760]","[1019, 1415, 1796, 2196, 2500, 2782, 3372, 3728, 4056, 4535, 5066, 5672, 6071, 6652, 7100, 7584, 8165, 8435, 9160, 9698, 10094, 10820, 11067, 11269, 11781, 12124, 12495, 12969, 13538, 13672]","[841, 1040, 1165, 1255, 1418, 1691, 2021, 2188, 2471, 2833, 3117, 3339, 3766, 4106, 4296, 4438, 4926, 5279, 5374, 5975, 6198, 6445, 7005, 7441, 8041, 8323, 8536, 8956, 9638, 9738]","[650, 740, 865, 999, 1422, 2021, 2351, 2518, 2752, 2923, 3216, 3637, 4123, 4385, 4926, 5280, 5583, 5964, 6095, 6361, 6615, 6851, 6946, 7122, 7216, 7472, 7568, 7745, 8439, 8539]",22080,15760,13672,9738,8539,46,41,96,110,21,"[799, 1247, 1673, 1929, 2416, 2872, 3223, 3618, 4400, 5061, 5601, 6313, 7005, 8035, 9230, 10062, 11025, 11943, 12715, 13256, 14375, 15204, 15988, 16470, 17265, 18004, 19021, 19252, 19785, 20677]","[620, 870, 1073, 1432, 1731, 1973, 2558, 2956, 3661, 4171, 4582, 5124, 5446, 5948, 6511, 7181, 7590, 8429, 8925, 9757, 10304, 10897, 11502, 11707, 12086, 12283, 13329, 14089, 14633, 15895]","[617, 1060, 1200, 1566, 2097, 2391, 3119, 3418, 3859, 4074, 4512, 4746, 4937, 5366, 5762, 6260, 6506, 7218, 7569, 7860, 8452, 8708, 9281, 9827, 10227, 10424, 10839, 11070, 11315, 11588]","[340, 430, 520, 752, 881, 1285, 1465, 1600, 2016, 2316, 2746, 3197, 3498, 3846, 4060, 4373, 4699, 5093, 5464, 5908, 6075, 6889, 7213, 7418, 7617, 7814, 8185, 8416, 8914, 9330]","[332, 470, 630, 720, 1123, 1327, 1592, 2015, 2786, 3087, 3308, 3577, 3887, 4476, 4690, 5051, 5474, 5972, 6198, 6575, 7157, 7406, 7795, 8233, 8549, 8865, 9331, 9637, 10257, 10447]",20677,15895,11588,9330,10447,1403,-135,2084,408,-1908,1852,30,dire
7558963713,41,97,29,20,45,"[0, 198, 513, 755, 1071, 1448, 1886, 2379, 2705, 2891, 3619, 3870, 4395, 4689, 5886, 6175, 6580, 7515, 8022, 8657, 9699, 10533, 11174, 11754, 13053, 13611, 14773, 15152, 16240, 17098]","[0, 288, 576, 947, 1340, 1773, 2141, 2710, 2922, 3440, 4224, 4640, 4985, 5495, 6644, 7121, 7486, 7804, 8451, 8648, 9470, 10002, 10452, 11527, 11622, 11871, 12425, 12951, 13531, 14287]","[0, 245, 608, 871, 1332, 1589, 1990, 2481, 2875, 3144, 3446, 3622, 3999, 4446, 5345, 5861, 6280, 7232, 8211, 8649, 9336, 9653, 9983, 10577, 11194, 11527, 12213, 12645, 13393, 14039]","[0, 231, 321, 411, 549, 722, 929, 1109, 1199, 1289, 1623, 1887, 2084, 2638, 3162, 3912, 4069, 4508, 5087, 5181, 5445, 5737, 6030, 6298, 6850, 7249, 7478, 7573, 8004, 8952]","[0, 129, 472, 562, 697, 822, 960, 1168, 1304, 1422, 1604, 1785, 1922, 2101, 2617, 2810, 2954, 3167, 3640, 3908, 4355, 4693, 5037, 5320, 6568, 6663, 7109, 7204, 7649, 8630]",17098,14287,14039,8952,8630,48,106,69,40,26,"[0, 287, 923, 1173, 1406, 1851, 2225, 2661, 2967, 3491, 3999, 4423, 4803, 5543, 5782, 6098, 6869, 7448, 8386, 9198, 10001, 10648, 10872, 11698, 12716, 13563, 14554, 14989, 15439, 15631]","[0, 364, 565, 890, 1335, 1629, 2084, 2422, 3094, 3523, 4079, 4353, 4637, 5188, 5579, 6148, 6618, 6939, 8002, 8421, 8845, 9260, 9636, 9810, 10213, 10504, 11122, 11659, 12185, 12826]","[0, 287, 486, 767, 891, 1278, 1785, 2066, 2473, 2841, 3224, 3634, 4308, 4695, 5048, 5442, 6091, 6378, 6876, 7338, 8212, 8627, 9222, 9479, 9991, 10242, 10921, 11286, 11626, 11886]","[0, 209, 337, 642, 732, 822, 957, 1091, 1356, 1589, 1843, 2073, 2665, 3099, 3338, 3647, 3900, 4065, 4312, 4471, 4794, 5168, 5428, 5756, 6564, 6897, 7147, 7463, 7882, 8053]","[0, 209, 379, 514, 604, 743, 918, 1312, 1492, 1707, 2213, 2303, 2393, 2789, 3028, 3397, 3700, 3867, 4117, 4274, 4681, 4776, 4961, 5135, 5487, 5762, 6063, 6244, 6340, 6482]",15631,12826,11886,8053,6482,1467,1461,2153,899,2148,8128,30,radiant
7558993106,106,109,28,53,112,"[1, 362, 743, 1004, 1449, 1781, 2308, 2739, 3031, 3404, 4098, 4637, 5151, 5799, 6119, 6469, 7181, 7782, 8335, 8991, 9739, 10318, 10700, 11387, 12050, 12752, 13517, 13881, 14431, 15271]","[1, 239, 517, 798, 1149, 1539, 1898, 2248, 2833, 3251, 3767, 4358, 5040, 5565, 6181, 6760, 7527, 8081, 8699, 9330, 9931, 10677, 11438, 12401, 13247, 14121, 14816, 15157, 15997, 16093]","[1, 209, 535, 987, 1482, 1659, 2138, 2637, 3173, 3682, 4175, 4685, 5227, 5824, 6346, 6874, 7300, 7933, 8628, 9394, 10125, 10390, 10698, 11274, 12021, 12883, 13419, 13725, 14093, 14189]","[1, 171, 337, 427, 609, 756, 846, 1295, 1519, 1709, 1889, 2205, 2369, 2677, 2976, 3225, 3509, 3850, 4265, 4760, 5016, 5257, 5839, 6485, 6777, 7471, 7895, 8422, 8830, 9203]","[101, 271, 361, 451, 701, 814, 953, 1378, 1728, 1818, 1998, 2178, 2268, 2516, 2709, 3132, 3392, 3982, 4190, 4401, 4697, 4882, 5112, 5297, 5482, 5880, 6212, 6548, 6693, 6887]",15271,16093,14189,9203,6887,10,29,120,123,20,"[1, 245, 568, 885, 1326, 1606, 2012, 2317, 2583, 2981, 3463, 3989, 4616, 5169, 5786, 6273, 6978, 7691, 8262, 9804, 10484, 11016, 11695, 12287, 13230, 13874, 14288, 14976, 15909, 17596]","[332, 696, 987, 1286, 1654, 1947, 2261, 2741, 2950, 3656, 4427, 5029, 5607, 6171, 6610, 7388, 7808, 8440, 9202, 9802, 10430, 10708, 11455, 11888, 12548, 13289, 13637, 14211, 14850, 15678]","[1, 353, 550, 1009, 1452, 1812, 2268, 2408, 2498, 2878, 3316, 3727, 4142, 4682, 5297, 6080, 6526, 7108, 7403, 8297, 9089, 9461, 9870, 10372, 11011, 11610, 12412, 12996, 13992, 14933]","[64, 295, 432, 572, 902, 1012, 1342, 1482, 1592, 1742, 2023, 2348, 2514, 2627, 2819, 3109, 3465, 3660, 3755, 4301, 4471, 4633, 5140, 5424, 5630, 6225, 6612, 6756, 7464, 7896]","[64, 234, 324, 414, 654, 744, 925, 1065, 1358, 1496, 1974, 2064, 2337, 2431, 2572, 2714, 2871, 3017, 3112, 3461, 3696, 3817, 4310, 4522, 4637, 5000, 5095, 5294, 5684, 5850]",17596,15678,14933,7896,5850,-2325,415,-744,1307,1037,-310,30,dire
7559020110,41,69,23,110,26,"[205, 366, 616, 916, 1204, 1452, 1758, 1978, 2106, 2575, 2950, 3511, 4106, 4674, 6180, 6878, 7494, 8160, 8838, 9562, 10202, 11022, 11546, 12708, 13237, 13528, 14404, 15477, 15573, 16703]","[204, 442, 701, 1166, 2060, 2692, 3007, 3832, 4137, 4754, 5080, 5890, 6042, 6656, 7729, 8077, 8489, 8915, 9494, 10277, 10713, 11681, 12451, 13027, 13531, 14377, 15185, 16464, 16833, 17174]","[326, 654, 1102, 1427, 1909, 2347, 2891, 3557, 4160, 4761, 5129, 5609, 6072, 6436, 7304, 7800, 8328, 8973, 9324, 9594, 9885, 10199, 10366, 10967, 11625, 12033, 12429, 13053, 13149, 13908]","[170, 296, 497, 652, 896, 998, 1399, 1640, 1730, 2076, 2462, 2775, 2972, 3157, 3805, 4025, 4418, 4676, 5215, 5416, 5822, 6598, 7212, 7622, 7809, 8060, 8888, 9558, 9654, 9782]","[221, 311, 447, 585, 955, 1161, 1296, 1801, 1910, 2120, 2669, 2967, 3116, 3401, 4271, 4733, 4995, 5335, 5637, 5897, 6067, 6456, 6794, 7198, 7530, 7865, 8230, 8402, 8725, 8975]",16703,17174,13908,9782,8975,94,120,33,123,85,"[288, 465, 745, 1074, 1479, 1814, 2420, 2566, 3102, 3689, 4245, 4593, 5244, 5981, 6877, 8120, 8644, 9769, 10583, 11567, 12534, 12701, 13426, 14365, 15106, 16021, 16992, 18358, 20151, 21073]","[290, 526, 894, 1351, 1691, 2039, 2417, 2873, 3403, 4189, 4881, 5703, 6644, 7723, 8144, 8238, 8823, 9253, 9961, 10725, 11392, 12110, 12374, 12764, 13308, 13975, 14069, 14899, 15643, 16601]","[206, 568, 843, 1247, 1834, 2052, 2704, 3166, 3874, 4875, 5378, 6113, 6462, 6823, 7088, 7280, 7776, 8163, 8636, 9270, 9533, 10432, 10817, 11100, 11267, 11969, 12172, 13060, 14084, 14512]","[170, 260, 372, 591, 764, 941, 1453, 1543, 1855, 2416, 2699, 2987, 3369, 3635, 3800, 3894, 4284, 4872, 5105, 5535, 5705, 6431, 6601, 7090, 7332, 7796, 8208, 9086, 9975, 10149]","[170, 260, 350, 487, 896, 986, 1263, 1435, 1744, 2198, 2983, 3392, 3760, 4075, 4321, 4439, 4680, 5116, 5274, 5566, 5842, 6288, 6681, 6775, 6959, 7401, 7702, 8087, 8318, 8414]",21073,16601,14512,10149,8414,-4370,573,-604,-367,561,-4207,30,dire
7559162616,21,82,137,128,26,"[1029, 1240, 1826, 2275, 2609, 3028, 3754, 4212, 4797, 5049, 5577, 6334, 6918, 7779, 8525, 9327, 9983, 10769, 11686, 12777, 13873, 14781, 15273, 16372, 17608, 18350, 18992, 19830, 20855, 21497]","[1188, 1572, 1773, 2161, 2251, 2764, 3201, 3803, 4529, 4959, 5419, 6032, 6957, 8098, 8612, 9439, 9925, 10565, 10921, 11964, 12912, 13570, 14127, 14846, 15985, 16797, 17296, 18126, 18907, 19980]","[1000, 1271, 1439, 1613, 2022, 2433, 3079, 3531, 4083, 4704, 4920, 5538, 5885, 6687, 7245, 7979, 8483, 8709, 9287, 9839, 10601, 11422, 11517, 12683, 13340, 13517, 14316, 15016, 15430, 16413]","[459, 755, 932, 1359, 1557, 1867, 2107, 2311, 2741, 2914, 3009, 3323, 3538, 3921, 4558, 4844, 5311, 5753, 6028, 6473, 6794, 7086, 7253, 7605, 7994, 8398, 8944, 9065, 9324, 9649]","[350, 440, 708, 864, 954, 1134, 1269, 1473, 1716, 1924, 2066, 2477, 2934, 3438, 3907, 4076, 4472, 4668, 4987, 5432, 5939, 6189, 6284, 6685, 6860, 7246, 7728, 7824, 8059, 8384]",21497,19980,16413,9649,8384,46,120,98,123,20,"[734, 1068, 1755, 2061, 2459, 2973, 3401, 3950, 4620, 4811, 5605, 6072, 6844, 7681, 7896, 8319, 8414, 9195, 9882, 10332, 11242, 11949, 12116, 12939, 13450, 14286, 15212, 15928, 16702, 17632]","[882, 1340, 1627, 2121, 2484, 3057, 3183, 3936, 4453, 5110, 5770, 6250, 6857, 7670, 7872, 8592, 9743, 10492, 11041, 11798, 11893, 12353, 12811, 13213, 13611, 14206, 14514, 14802, 15457, 16138]","[752, 1307, 1473, 1721, 1924, 2186, 2462, 2965, 3497, 3909, 4427, 4709, 5178, 5799, 5978, 6449, 7105, 7438, 8215, 9097, 9603, 10013, 10585, 10836, 11250, 11976, 12149, 12516, 12935, 13923]","[395, 603, 693, 1130, 1220, 1492, 1714, 1982, 2346, 2872, 3068, 3233, 3400, 3781, 4010, 4356, 4869, 4988, 5174, 5553, 5860, 5954, 6319, 6631, 7105, 7503, 7944, 8199, 8739, 9288]","[402, 567, 786, 1035, 1161, 1357, 1468, 1644, 2088, 2352, 2631, 2756, 2897, 3117, 3212, 3471, 3779, 3873, 4229, 4598, 4741, 4835, 5002, 5383, 5477, 5663, 6009, 6105, 6295, 6592]",17632,16138,13923,9288,6592,3865,3842,2490,361,1792,12350,30,radiant
7559477319,25,120,135,26,51,"[347, 656, 930, 1298, 1801, 2144, 2709, 3195, 3682, 4335, 4737, 5529, 5865, 6463, 6996, 7818, 8849, 9447, 10228, 10902, 11362, 12079, 13457, 14194, 15562, 17311, 17700, 18465, 19012, 19710]","[621, 1045, 1395, 1648, 2192, 2364, 3111, 3743, 4409, 5109, 5904, 6204, 6722, 7279, 7849, 8475, 8748, 9674, 10023, 11106, 11647, 12031, 12656, 13262, 14422, 15580, 16033, 16682, 17251, 17791]","[293, 689, 1096, 1452, 1771, 2080, 2260, 2800, 3049, 3647, 3931, 4508, 4671, 5361, 6142, 6969, 7871, 8286, 8891, 9608, 10128, 10820, 11577, 11672, 12506, 14137, 14941, 15385, 16364, 17021]","[365, 480, 570, 867, 997, 1345, 1622, 1712, 1917, 2237, 2413, 2670, 2799, 3057, 3391, 3711, 3965, 4451, 4608, 4948, 5043, 5194, 5539, 6146, 6670, 6840, 7520, 8290, 8979, 9319]","[265, 380, 470, 604, 780, 968, 1148, 1238, 1398, 1578, 1843, 2075, 2287, 2436, 2894, 3162, 3757, 4140, 4312, 4867, 5062, 5157, 5541, 5853, 6167, 6793, 7259, 7459, 7690, 8078]",19710,17791,17021,9319,8078,10,17,29,110,101,"[168, 501, 661, 1083, 1563, 1883, 2468, 2829, 3378, 3810, 3990, 4530, 5786, 6362, 6559, 6931, 8090, 8602, 9238, 10330, 11018, 11726, 12311, 13523, 14222, 16276, 16370, 17135, 18144, 18774]","[288, 639, 934, 1346, 1790, 2323, 2686, 3225, 3758, 3848, 4228, 4709, 5587, 6237, 6718, 7175, 7892, 8302, 8888, 9326, 10029, 10750, 11208, 12100, 12621, 13376, 13808, 14228, 14507, 15172]","[129, 504, 893, 1247, 1469, 1968, 2292, 2925, 3241, 3662, 4187, 4656, 5188, 5499, 5715, 6285, 6810, 7215, 7843, 8347, 8738, 9046, 9855, 10247, 10832, 11374, 11573, 12148, 12244, 12639]","[129, 244, 334, 698, 884, 1129, 1254, 1344, 1679, 1968, 2280, 2405, 2729, 3042, 3337, 3830, 4483, 4748, 4890, 5242, 5486, 6025, 6267, 6789, 7342, 8092, 8261, 8432, 8578, 8946]","[129, 244, 334, 509, 599, 847, 972, 1107, 1556, 1646, 1853, 2016, 2367, 2728, 2822, 2980, 3323, 3418, 3681, 4036, 4131, 4298, 4392, 4783, 5083, 5436, 5729, 5870, 5966, 6535]",18774,15172,12639,8946,6535,936,2619,4382,373,1543,9853,30,radiant
7559752002,17,46,14,33,85,"[0, 376, 753, 1221, 1682, 2206, 2634, 3182, 3754, 4363, 4931, 5445, 5975, 7017, 7613, 7953, 8673, 9562, 10052, 10544, 12011, 12523, 13408, 14155, 15164, 16178, 17467, 18399, 19962, 21775]","[0, 240, 364, 562, 789, 1047, 1285, 1578, 2052, 2460, 2871, 3175, 3713, 4247, 4743, 5451, 6007, 6437, 7079, 7381, 7890, 8271, 9153, 9838, 11303, 11398, 12135, 13338, 14133, 15759]","[0, 207, 445, 771, 895, 1422, 1701, 2077, 2841, 3345, 3866, 4430, 5124, 5750, 6228, 6486, 7259, 7519, 7906, 8326, 8421, 9214, 9511, 10092, 11161, 11256, 11919, 12690, 13085, 14214]","[0, 170, 260, 785, 1128, 1346, 1536, 1882, 2576, 2834, 3227, 3659, 4180, 4849, 5328, 5847, 6354, 6613, 7000, 7676, 8103, 8252, 8666, 9085, 10266, 10361, 10866, 11458, 12778, 13431]","[0, 170, 260, 350, 477, 918, 1236, 1894, 2217, 2640, 2956, 3321, 3996, 4376, 4471, 4770, 5565, 5660, 5804, 5898, 6319, 7151, 7246, 7576, 7927, 8113, 8488, 8934, 9933, 10480]",21775,15759,14214,13431,10480,6,35,21,58,86,"[0, 248, 490, 1109, 1199, 1482, 1875, 2374, 2777, 3222, 3829, 4286, 4606, 4932, 5536, 6158, 7130, 8085, 8741, 9503, 10389, 11905, 12544, 13108, 13797, 15354, 16752, 17410, 17859, 17955]","[0, 360, 730, 1151, 1562, 2233, 2882, 3563, 4078, 4624, 5490, 5965, 6952, 7563, 8083, 8532, 8976, 9105, 9768, 10947, 11607, 12102, 13192, 14061, 14555, 14804, 15416, 15770, 16268, 16364]","[0, 206, 607, 984, 1357, 1772, 2264, 2480, 2855, 3407, 3934, 4264, 4354, 5128, 5695, 6336, 6664, 6905, 7661, 8432, 9019, 9984, 10846, 11449, 11981, 12342, 13097, 13523, 14269, 15317]","[0, 170, 260, 639, 811, 901, 1036, 1268, 1402, 1545, 1851, 2158, 2463, 2828, 3021, 3324, 3848, 4597, 4850, 5291, 5552, 6081, 6701, 6965, 7642, 7997, 8454, 8573, 8738, 9287]","[0, 221, 311, 401, 491, 581, 716, 1121, 1211, 1306, 1610, 1832, 2301, 3331, 3536, 3849, 4368, 4618, 4762, 5131, 5392, 5873, 6359, 6598, 7285, 8134, 8229, 8417, 8743, 9239]",17955,16364,15317,9287,9239,3820,-605,-1103,4144,1241,7497,30,radiant
7559771013,95,120,98,86,100,"[0, 217, 531, 984, 1355, 2049, 2328, 3177, 3549, 4165, 4909, 5554, 6077, 6786, 7569, 8485, 9514, 10410, 11299, 12415, 13195, 14245, 14876, 15668, 16385, 17228, 18204, 18815, 20214, 21555]","[0, 249, 550, 920, 1303, 2051, 2499, 2870, 3637, 4272, 4879, 5514, 6149, 6793, 7356, 7683, 8507, 8995, 9228, 9774, 10152, 10757, 11591, 12173, 12934, 13343, 13437, 14425, 15289, 16119]","[0, 241, 524, 1198, 1446, 1940, 2303, 3058, 3556, 4242, 4626, 5292, 5954, 6661, 6935, 7647, 8380, 8637, 8731, 9429, 9971, 10943, 11396, 11491, 12164, 12353, 12783, 13654, 14389, 15143]","[0, 321, 411, 580, 736, 931, 1188, 1423, 1816, 2054, 2632, 2999, 3392, 4169, 4525, 4800, 5352, 6051, 6382, 6820, 7076, 7304, 7873, 8369, 8838, 9080, 9843, 10340, 10829, 11455]","[0, 169, 311, 485, 575, 933, 1068, 1326, 1518, 1985, 2193, 2337, 2625, 3125, 3487, 3644, 4192, 4422, 4693, 5340, 5703, 5837, 6051, 6259, 6479, 6646, 7016, 7435, 7933, 8246]",21555,16119,15143,11455,8246,106,38,70,110,101,"[0, 324, 698, 1151, 1497, 1908, 2343, 2926, 3256, 3673, 4131, 4462, 4822, 5300, 5945, 6205, 6615, 7736, 8454, 9546, 10004, 10508, 11483, 11921, 12656, 13185, 14558, 15196, 16245, 16861]","[0, 255, 493, 617, 1060, 1305, 1602, 2175, 2532, 2989, 3442, 3672, 4104, 4511, 4740, 5092, 6036, 7135, 7583, 8543, 9102, 9627, 10756, 11231, 12085, 12483, 13079, 13843, 14816, 15493]","[0, 278, 510, 709, 1182, 1624, 2089, 2437, 2789, 3106, 3466, 4132, 4459, 4934, 5319, 5839, 6299, 7516, 8250, 8927, 9386, 9776, 10768, 11451, 12089, 12797, 14207, 14497, 15187, 15667]","[0, 169, 259, 349, 488, 627, 964, 1099, 1271, 1361, 1599, 1689, 1862, 2089, 2352, 2483, 2626, 2978, 3345, 3633, 3944, 4355, 5348, 5518, 6073, 6593, 7411, 7731, 7983, 8144]","[0, 169, 259, 349, 568, 984, 1074, 1209, 1299, 1389, 1627, 2221, 2355, 2450, 2842, 2980, 3319, 3731, 4279, 4813, 4999, 5094, 5673, 5843, 6013, 6375, 6880, 7087, 7313, 7409]",16861,15493,15667,8144,7409,4694,626,-524,3311,837,8944,30,radiant
7559833511,48,76,97,65,110,"[0, 209, 370, 747, 981, 1187, 1679, 1992, 2301, 2747, 3280, 3675, 4162, 5006, 5614, 6454, 7191, 8168, 8880, 9362, 10839, 11555, 12512, 13493, 14637, 15463, 16734, 17504, 18907, 20219]","[0, 291, 589, 827, 1226, 1576, 1975, 2302, 2827, 3173, 3690, 4161, 4814, 5137, 5750, 6018, 6409, 6754, 7216, 7568, 9012, 9773, 10288, 11085, 11573, 12620, 13915, 14386, 15091, 16016]","[0, 204, 452, 542, 897, 1266, 1442, 1688, 2144, 2605, 2861, 3389, 3891, 4491, 5045, 5140, 5657, 6352, 7075, 7332, 8398, 9141, 9999, 10709, 10894, 11473, 12151, 12777, 13758, 13929]","[0, 170, 260, 458, 885, 1022, 1136, 1283, 1373, 1556, 1992, 2262, 2518, 2681, 3073, 3168, 3414, 3874, 4329, 4424, 5459, 5913, 6201, 6616, 6971, 7383, 7800, 8426, 8953, 9680]","[0, 219, 309, 399, 580, 670, 807, 936, 1026, 1209, 1603, 1804, 1980, 2299, 2710, 2888, 3402, 3496, 3777, 3872, 4192, 4358, 4569, 4923, 5177, 5343, 5724, 5844, 6021, 6763]",20219,16016,13929,9680,6763,25,13,102,3,26,"[0, 326, 600, 845, 1257, 1630, 2122, 2683, 3284, 3876, 4429, 5024, 5380, 6032, 6720, 7539, 8267, 8983, 9461, 9725, 9820, 10653, 11798, 12573, 12843, 13993, 14642, 14737, 15581, 16782]","[0, 242, 430, 758, 1101, 1420, 1581, 1908, 2235, 2639, 3390, 3705, 4114, 4670, 4924, 5100, 5590, 6059, 6700, 6880, 6975, 7476, 8295, 8972, 9204, 9583, 10336, 10669, 11415, 12232]","[0, 209, 591, 758, 1132, 1397, 1757, 2144, 2756, 2960, 3474, 3835, 4544, 4879, 5233, 5566, 6004, 6542, 6796, 7339, 7434, 8098, 8752, 9376, 9865, 10187, 10654, 10855, 11162, 11479]","[0, 170, 285, 375, 505, 595, 706, 967, 1147, 1237, 1372, 1503, 1683, 2093, 2490, 2585, 2806, 2900, 2995, 3380, 3654, 3954, 4352, 4447, 4542, 4708, 4803, 5017, 5238, 5532]","[0, 170, 285, 426, 601, 691, 830, 1457, 1768, 1858, 2126, 2216, 2445, 2593, 2725, 2820, 3041, 3579, 3964, 4366, 4513, 4679, 4846, 5160, 5287, 5593, 5737, 5832, 6009, 6303]",16782,12232,11479,5532,6303,3437,3784,2450,4148,460,14279,30,radiant
7559889100,13,95,97,66,138,"[281, 494, 858, 1304, 1672, 2028, 2406, 2919, 3369, 3944, 4575, 5440, 6253, 6758, 7253, 8124, 8896, 9679, 10230, 11201, 11789, 12379, 12972, 13894, 14678, 14961, 15819, 16827, 17252, 18929]","[360, 635, 762, 1277, 1694, 2100, 2535, 2849, 3324, 3648, 4077, 4666, 5470, 6175, 6807, 7466, 8195, 8914, 9615, 10371, 11483, 12246, 13190, 14065, 15128, 15747, 16255, 16432, 17177, 17931]","[232, 610, 876, 1161, 1667, 2045, 2504, 2956, 3394, 3816, 4203, 4442, 4885, 5225, 5738, 5937, 6441, 6916, 7166, 7535, 8171, 8338, 8892, 9349, 9941, 10807, 11256, 11633, 11731, 12804]","[500, 615, 749, 958, 1065, 1395, 1641, 1910, 2247, 2465, 2694, 3089, 3366, 3837, 4440, 5068, 5514, 6051, 6431, 7031, 7707, 7956, 8784, 9530, 9881, 10343, 10620, 11117, 11497, 12600]","[232, 347, 471, 596, 686, 776, 866, 1001, 1243, 1663, 2018, 2307, 2597, 2851, 3194, 3672, 4174, 4453, 4834, 5252, 5347, 5651, 6034, 6464, 6968, 7609, 8279, 8781, 9034, 9360]",18929,17931,12804,12600,9360,73,120,21,58,65,"[452, 858, 1222, 1583, 2195, 2628, 3441, 4272, 4949, 5888, 6625, 7596, 8129, 9563, 10061, 10502, 11501, 13037, 14274, 15058, 16426, 17238, 17798, 19115, 19443, 20279, 21973, 22840, 23345, 23899]","[283, 653, 1143, 1513, 2088, 2532, 2829, 3549, 4194, 4653, 5276, 5827, 6351, 6896, 7556, 8126, 9015, 9338, 9894, 10270, 10956, 11566, 12022, 12780, 13562, 14711, 15737, 16116, 16657, 17084]","[242, 445, 843, 1194, 1602, 1878, 2207, 2575, 3148, 3451, 3763, 4154, 4694, 5330, 5844, 6144, 6579, 7016, 7661, 8065, 9024, 9765, 10342, 10950, 11200, 12093, 13008, 13177, 13766, 14126]","[337, 427, 553, 683, 883, 973, 1118, 1500, 1618, 2018, 2198, 2742, 2927, 3266, 3447, 3587, 3886, 4574, 4977, 5718, 6080, 6497, 6790, 6968, 7420, 8523, 9031, 9376, 10207, 10542]","[237, 327, 462, 592, 770, 887, 1022, 1194, 1318, 1544, 1634, 1980, 2491, 2779, 3234, 3575, 3913, 4406, 4648, 4798, 5199, 5384, 5570, 5918, 6062, 6663, 7378, 7640, 8038, 8636]",23899,17084,14126,10542,8636,-4970,847,-1322,2058,724,-2663,30,radiant
7559896009,93,128,21,66,62,"[0, 572, 662, 1003, 1467, 1792, 2007, 2748, 3231, 3808, 4688, 5315, 5968, 6474, 7258, 7971, 9075, 9883, 10822, 11289, 12140, 14013, 14711, 15525, 16603, 17924, 18813, 19484, 20330, 21453]","[0, 239, 497, 795, 1110, 1503, 1837, 2228, 2441, 2837, 3225, 3994, 4758, 5335, 5873, 6297, 7131, 7417, 7851, 8265, 9084, 9792, 10386, 11342, 11671, 13149, 13860, 14423, 15020, 15458]","[0, 284, 570, 998, 1263, 1559, 1790, 2039, 2486, 3274, 4050, 4680, 5137, 5708, 6456, 7169, 7366, 8183, 8554, 8779, 9324, 9768, 10175, 11223, 11924, 12302, 13094, 13601, 13888, 14751]","[0, 230, 429, 658, 1255, 1403, 2133, 2547, 2694, 2988, 3443, 3666, 4201, 4847, 5105, 5691, 6019, 6833, 7367, 7779, 8049, 8763, 9456, 9878, 10550, 11320, 11826, 12253, 12663, 12957]","[0, 169, 259, 664, 818, 1008, 1307, 1750, 1885, 2048, 2749, 3062, 3472, 3820, 3991, 4130, 4416, 4637, 5165, 5521, 5679, 6652, 6928, 7530, 7771, 8091, 8310, 9036, 9399, 9712]",21453,15458,14751,12957,9712,10,64,92,45,14,"[0, 205, 579, 838, 1315, 1627, 1914, 2203, 2695, 2908, 3192, 3495, 4278, 5002, 5690, 6246, 7176, 8101, 8434, 8691, 9211, 9810, 10316, 10692, 11466, 12174, 12730, 13623, 14184, 14753]","[0, 316, 723, 1043, 1336, 1638, 2291, 2582, 3092, 3515, 4280, 4370, 4781, 5313, 5849, 6217, 7054, 7423, 7848, 8877, 9051, 9498, 9592, 9884, 10475, 10642, 11334, 11801, 12486, 13153]","[0, 206, 589, 831, 1294, 1738, 2447, 2582, 2904, 3253, 3805, 4078, 4806, 5262, 5611, 6104, 6553, 7157, 7489, 7938, 8344, 8478, 8572, 8667, 9191, 9358, 9452, 9786, 10385, 10747]","[0, 169, 259, 349, 567, 721, 1086, 1221, 1578, 1703, 1928, 2380, 3048, 3282, 3492, 3586, 3900, 4229, 4414, 4836, 5498, 6010, 6150, 6298, 7264, 7431, 7589, 8066, 8635, 8731]","[0, 169, 395, 554, 714, 924, 1252, 1493, 1647, 2143, 2553, 2841, 3199, 3294, 3601, 3769, 4128, 4665, 4850, 5341, 5825, 5920, 6269, 6430, 6597, 6764, 6904, 6999, 7431, 7605]",14753,13153,10747,8731,7605,6700,2305,4004,4226,2107,19342,30,radiant
7559921108,48,96,28,123,105,"[0, 241, 527, 949, 1269, 1640, 2035, 2322, 2656, 3237, 3680, 4277, 5074, 5980, 6918, 7651, 8526, 8985, 9437, 10157, 11355, 11999, 12913, 13536, 14353, 15799, 16201, 17775, 18707, 19864]","[0, 322, 560, 809, 1055, 1336, 1789, 2330, 2754, 3228, 3623, 4249, 5009, 5533, 6180, 6835, 7298, 7633, 8267, 8746, 9160, 9850, 11004, 11621, 12293, 13529, 13889, 15046, 15749, 16574]","[0, 367, 653, 1063, 1537, 1904, 2368, 2661, 2932, 3443, 4219, 4646, 4874, 5326, 5743, 5964, 6503, 6961, 7543, 8185, 8938, 9377, 10036, 10444, 11342, 12261, 12356, 13012, 13696, 14260]","[0, 170, 309, 399, 513, 659, 795, 1139, 1528, 1663, 1857, 2002, 2308, 2677, 2960, 3216, 3528, 3926, 4268, 4425, 4917, 5532, 5771, 6236, 6947, 7666, 7761, 8210, 8988, 9390]","[0, 215, 339, 477, 616, 754, 844, 1015, 1109, 1272, 1611, 1764, 2054, 2418, 2619, 3025, 3193, 3426, 3936, 4093, 4329, 4518, 5017, 5186, 5491, 6081, 6312, 6893, 7731, 8093]",19864,16574,14260,9390,8093,63,120,129,26,20,"[0, 242, 572, 701, 958, 1241, 1642, 1968, 2513, 2949, 3563, 4055, 4379, 5188, 5747, 6461, 7351, 7754, 8468, 9309, 9845, 10771, 11903, 12562, 13218, 13829, 14040, 15047, 15644, 16137]","[0, 248, 412, 746, 1002, 1287, 1626, 1860, 2228, 2542, 2940, 3719, 4097, 4864, 5559, 6353, 7306, 8056, 8921, 9460, 10148, 10821, 11671, 12324, 12850, 12988, 13509, 14058, 14890, 15282]","[0, 260, 574, 889, 1064, 1511, 1993, 2409, 2931, 3350, 3662, 4412, 5002, 5852, 6305, 7025, 7733, 8804, 9704, 10509, 10846, 11109, 11483, 11684, 12054, 12325, 12536, 12630, 13568, 14001]","[0, 170, 358, 487, 577, 761, 941, 1444, 1579, 1669, 2177, 2680, 3122, 3662, 3813, 4282, 4502, 4936, 5211, 5422, 5635, 5730, 6279, 6405, 6610, 6850, 7366, 7543, 7836, 8109]","[0, 251, 341, 468, 558, 712, 989, 1222, 1401, 1557, 1804, 2156, 2246, 2539, 2634, 2944, 3239, 3907, 4214, 4674, 4844, 5014, 5450, 5666, 5946, 6116, 6402, 6571, 6823, 6994]",16137,15282,14001,8109,6994,3727,1292,259,1281,1099,7658,30,radiant
7559947915,17,129,47,110,100,"[0, 204, 418, 782, 1113, 1464, 1706, 2041, 2365, 3010, 3666, 4202, 4919, 5372, 6048, 6462, 7128, 7483, 8341, 9098, 9778, 10219, 11452, 12241, 13182, 13981, 14630, 15167, 15856, 16516]","[0, 174, 550, 1050, 1263, 1604, 2230, 2608, 2870, 3298, 3833, 4146, 4801, 5220, 5622, 6191, 6604, 7129, 7784, 8758, 10057, 10581, 11235, 12046, 13109, 13994, 14981, 15620, 16231, 16459]","[0, 526, 731, 1088, 1343, 1683, 1843, 2264, 2596, 3261, 3691, 4179, 4744, 5388, 5649, 6186, 6656, 7127, 7649, 8007, 8743, 9166, 9696, 10894, 11676, 12317, 12712, 13276, 13962, 14361]","[0, 90, 180, 352, 442, 572, 662, 927, 1064, 1245, 1473, 1687, 2138, 2480, 2630, 3105, 3432, 4081, 4730, 5050, 5397, 5707, 6686, 6960, 7329, 7860, 8490, 8905, 9348, 9602]","[0, 168, 258, 348, 438, 617, 707, 797, 887, 1063, 1243, 1333, 1790, 2008, 2158, 2252, 2475, 2960, 3254, 3574, 4153, 4446, 5225, 5648, 6147, 6434, 7198, 7455, 7632, 7868]",16516,16459,14361,9602,7868,43,120,41,58,123,"[0, 406, 718, 1093, 1428, 1897, 2262, 2673, 3156, 3711, 4237, 4728, 5533, 6018, 6914, 7350, 8102, 8761, 9311, 9624, 9967, 11043, 11402, 12046, 12570, 12836, 13308, 13402, 14258, 15354]","[0, 323, 528, 962, 1451, 1713, 1803, 2028, 2311, 2622, 3062, 3502, 4186, 4759, 5750, 6097, 6534, 6629, 7270, 7744, 8025, 8468, 8891, 9348, 9961, 10467, 10598, 11007, 11932, 12353]","[0, 287, 589, 867, 1030, 1272, 1719, 1980, 2395, 2741, 3211, 3713, 4078, 4433, 5288, 5881, 6521, 6802, 7547, 8327, 8838, 9113, 9585, 9985, 10759, 10952, 11809, 12401, 12917, 13692]","[0, 250, 389, 576, 715, 805, 1200, 1550, 1927, 2286, 2528, 2745, 2987, 3248, 4139, 4392, 4747, 5249, 5516, 5757, 5852, 6506, 6838, 7058, 7153, 7318, 7710, 8140, 8545, 8876]","[0, 250, 340, 511, 662, 752, 885, 1156, 1353, 1448, 2051, 2273, 2455, 2737, 3550, 3894, 4432, 4844, 5174, 5912, 6007, 6250, 6417, 6928, 7348, 7489, 7944, 8133, 8770, 9380]",15354,12353,13692,8876,9380,1162,4106,669,726,-1512,5151,30,radiant
7559964211,82,98,20,26,112,"[0, 334, 746, 1116, 1484, 1814, 2514, 2799, 3453, 3904, 4313, 4725, 5087, 5672, 6388, 7394, 8023, 9285, 9904, 10899, 11781, 12681, 13623, 14507, 15459, 16252, 16575, 17649, 19135, 20315]","[0, 289, 638, 1092, 1471, 1845, 2197, 2796, 3091, 3593, 4011, 4295, 5005, 5310, 5704, 6340, 7154, 7452, 7895, 8466, 9163, 9413, 10198, 11086, 11849, 12397, 13201, 14372, 15296, 15670]","[0, 331, 777, 1093, 1347, 1816, 2154, 2606, 3102, 3486, 3801, 4118, 4208, 4302, 4547, 4822, 5085, 5537, 5990, 6511, 6941, 7437, 7714, 8452, 8955, 9508, 10129, 10840, 11523, 11685]","[0, 210, 300, 455, 637, 727, 866, 1005, 1184, 1309, 1399, 1658, 1869, 2240, 2406, 3308, 3465, 3595, 4384, 4892, 4986, 5682, 5954, 6691, 6995, 7165, 7335, 7965, 8633, 9018]","[100, 310, 465, 768, 972, 1106, 1243, 1333, 1718, 1808, 1898, 2085, 2540, 2634, 2729, 3276, 3594, 3735, 4059, 4439, 4607, 4829, 4924, 5978, 6464, 6559, 6654, 6987, 7578, 7690]",20315,15670,11685,9018,7690,10,71,74,119,21,"[0, 167, 450, 668, 997, 1295, 1646, 1948, 2486, 2766, 3329, 3755, 4149, 4759, 5292, 5896, 6479, 6885, 7394, 8091, 8667, 9447, 10004, 10099, 10945, 11569, 12334, 12662, 13164, 14145]","[0, 130, 474, 900, 1511, 1801, 2207, 2599, 2854, 3247, 3654, 4476, 4566, 5158, 5663, 5812, 6622, 6845, 7084, 7926, 8157, 8765, 9474, 10041, 10772, 11636, 12651, 12989, 13539, 14151]","[0, 179, 465, 821, 1139, 1556, 1959, 2835, 3574, 3985, 4772, 5170, 5439, 5864, 6082, 6231, 6786, 7280, 7753, 8335, 8769, 9354, 10023, 10118, 10938, 11673, 12369, 13274, 14074, 14528]","[0, 477, 792, 882, 1012, 1122, 1228, 1591, 1681, 2062, 2887, 3268, 3528, 4141, 4475, 4784, 5168, 5553, 5745, 6581, 6799, 7568, 8301, 8577, 9353, 9682, 10297, 10717, 11251, 12160]","[0, 209, 299, 750, 926, 1271, 1454, 1754, 2009, 2431, 3230, 3620, 4006, 4658, 5139, 5472, 5765, 6170, 6398, 6840, 7090, 7528, 8145, 8435, 9095, 9398, 10018, 10300, 10468, 11383]",14145,14151,14528,12160,11383,6170,1519,-2843,-3142,-3693,-1989,30,radiant
7559964417,70,113,28,110,123,"[253, 608, 893, 1182, 1669, 2112, 2604, 2935, 3877, 4349, 5046, 5627, 6335, 6886, 7678, 8668, 9543, 10365, 11143, 11801, 12232, 12327, 12755, 14115, 15327, 15926, 17755, 18719, 19587, 20488]","[276, 609, 1057, 1445, 1791, 2523, 2664, 3122, 4188, 4695, 5301, 5767, 6291, 6729, 7236, 7817, 8267, 9043, 9418, 9892, 10560, 11139, 11667, 12366, 13196, 13772, 14806, 15288, 16285, 17213]","[294, 528, 1020, 1204, 1654, 1992, 2352, 2786, 3493, 4144, 4848, 5274, 6236, 6780, 7175, 7835, 8253, 8876, 9129, 9224, 10497, 11821, 12240, 12829, 13509, 13929, 14601, 15331, 16003, 17132]","[170, 260, 350, 523, 942, 1032, 1199, 1373, 1987, 2802, 2982, 3165, 4174, 4283, 4394, 5028, 5248, 5777, 6247, 6582, 6767, 7182, 7486, 8428, 9025, 9213, 9843, 10281, 11056, 11657]","[170, 309, 399, 875, 1014, 1171, 1261, 1612, 1980, 2232, 2412, 2734, 3330, 3425, 3636, 4008, 4289, 4611, 5051, 5282, 5467, 6024, 6435, 6883, 8062, 8240, 8858, 9191, 9587, 10160]",20488,17213,17132,11657,10160,41,17,14,128,105,"[259, 530, 814, 1022, 1335, 1712, 2021, 2167, 2393, 2662, 2957, 3839, 4416, 4836, 5260, 5810, 6552, 7219, 7655, 7802, 8876, 9919, 10591, 11327, 11822, 12805, 13813, 14467, 14745, 15035]","[333, 661, 1030, 1406, 1787, 2209, 2779, 2981, 3071, 3285, 3727, 4694, 4993, 5660, 6086, 6632, 7407, 7895, 8423, 8640, 9125, 9485, 9777, 10134, 10562, 10657, 11120, 11506, 11698, 11829]","[209, 370, 611, 808, 981, 1290, 1662, 2033, 2123, 2420, 3074, 3720, 4077, 4556, 5119, 5647, 6560, 6985, 7079, 7579, 8085, 8771, 9589, 10230, 10325, 10828, 11165, 11342, 11438, 11691]","[221, 358, 546, 636, 766, 901, 1450, 1540, 1630, 1720, 1895, 3751, 3846, 4104, 4198, 4416, 5581, 5815, 6114, 6467, 6823, 7436, 7530, 8162, 8257, 8352, 8689, 8960, 9056, 9152]","[170, 260, 399, 489, 905, 995, 1379, 1469, 1559, 1732, 1963, 2982, 3077, 3172, 3528, 3686, 4395, 4529, 4984, 5285, 5455, 5890, 6059, 6278, 6448, 6783, 7195, 7652, 7823, 8075]",15035,11829,11691,9152,8075,5453,5384,5441,2505,2085,20868,30,radiant
7559972212,95,17,29,66,86,"[292, 602, 923, 1179, 1466, 1970, 2645, 3049, 3542, 4069, 4559, 5092, 5641, 6397, 6800, 7522, 8659, 9501, 10009, 10881, 11199, 11985, 12691, 13581, 14291, 15184, 15953, 16644, 17626, 18729]","[331, 696, 1049, 1413, 1792, 2127, 2744, 3206, 3661, 4015, 4453, 5152, 6082, 6478, 7029, 7756, 8278, 8591, 9611, 10117, 11258, 11956, 12607, 13135, 14052, 14542, 15400, 16072, 16806, 17361]","[293, 606, 846, 1179, 1516, 2033, 2597, 2950, 3202, 4119, 4754, 5388, 5766, 6021, 6421, 6750, 7956, 8947, 9471, 9591, 10249, 10713, 11666, 12030, 12700, 12894, 13483, 13787, 14155, 14669]","[170, 658, 784, 911, 1050, 1332, 1670, 1968, 2266, 2916, 3539, 4009, 4581, 5133, 5652, 6280, 6887, 7349, 7942, 8236, 8526, 9182, 9793, 10473, 11170, 11632, 12159, 12788, 13328, 14032]","[170, 312, 402, 492, 582, 854, 1073, 1294, 1462, 1733, 1977, 2338, 2639, 2823, 2918, 3444, 3843, 4073, 4382, 4477, 4837, 5332, 5633, 5838, 6172, 6267, 6744, 7046, 7430, 7619]",18729,17361,14669,14032,7619,46,120,97,123,110,"[249, 568, 882, 1203, 1459, 1990, 2397, 2807, 3690, 4150, 4674, 5382, 6310, 7179, 7593, 7928, 8652, 9202, 9914, 10799, 11394, 12700, 13763, 14494, 15072, 16130, 16980, 17207, 17750, 18478]","[206, 531, 1012, 1425, 1753, 2106, 2438, 2926, 3429, 4257, 4362, 4888, 5304, 5552, 5995, 6519, 6783, 7251, 8032, 8803, 8984, 9576, 10235, 10898, 11307, 11957, 12347, 13083, 13451, 14065]","[205, 464, 742, 988, 1187, 1491, 1941, 2236, 2376, 2849, 3306, 3947, 4386, 4847, 5321, 5617, 5711, 6401, 6950, 7662, 8220, 8727, 8963, 9058, 9345, 9620, 9961, 10057, 10277, 10958]","[213, 375, 465, 555, 696, 970, 1126, 1216, 1530, 1907, 2116, 2292, 2611, 2946, 3189, 3374, 3468, 3563, 3791, 3949, 4330, 4497, 4895, 5088, 5315, 5462, 5703, 5799, 5900, 5996]","[170, 260, 397, 487, 577, 677, 860, 969, 1109, 1314, 1404, 1494, 1697, 1888, 2304, 2647, 2741, 2852, 3063, 3491, 3886, 4333, 4569, 4970, 5228, 5377, 5603, 5699, 5795, 6108]",18478,14065,10958,5996,6108,251,3296,3711,8036,1511,16805,30,radiant
7560048306,82,73,29,123,105,"[257, 639, 1028, 1464, 1782, 2399, 2682, 3280, 3743, 4469, 4893, 5582, 6229, 7055, 7997, 8752, 9440, 10487, 11071, 12630, 13206, 14349, 15558, 16833, 17707, 18505, 18975, 20437, 21443, 22513]","[407, 729, 1217, 1615, 1886, 2252, 2756, 3362, 4330, 5070, 6155, 6425, 7941, 8640, 9815, 10474, 11393, 12900, 13387, 14487, 15477, 16907, 17107, 17927, 19163, 20606, 20978, 22083, 23002, 23992]","[383, 877, 1426, 1772, 2363, 2840, 3552, 4044, 4473, 5256, 5958, 6476, 7048, 7452, 8254, 8763, 9363, 10429, 11179, 11437, 11893, 12320, 12716, 13176, 13905, 14738, 15084, 15594, 15941, 16405]","[499, 654, 868, 1004, 1094, 1351, 1644, 1780, 2052, 2269, 2664, 2873, 3143, 3373, 3818, 4427, 4648, 5023, 5750, 5960, 6370, 6674, 6769, 7463, 7964, 8454, 8864, 9640, 10024, 10697]","[231, 514, 651, 844, 934, 1130, 1518, 1620, 1807, 2017, 2175, 2525, 2728, 2870, 3241, 3475, 4008, 4228, 4530, 4852, 5196, 5440, 5600, 5948, 6285, 6817, 7395, 8099, 8413, 8815]",22513,23992,16405,10697,8815,89,7,106,58,86,"[241, 564, 849, 1073, 1363, 1692, 2111, 2689, 3041, 3573, 4330, 5019, 5821, 6589, 7125, 7657, 8419, 9768, 10944, 11614, 12626, 13222, 14112, 15555, 16398, 17549, 18681, 19789, 20791, 23034]","[208, 624, 994, 1330, 1741, 2080, 2767, 3270, 3664, 4195, 4592, 5465, 6254, 6590, 6723, 7277, 7419, 7656, 8248, 8611, 9383, 9645, 10340, 10543, 10638, 10923, 11738, 12668, 13087, 14399]","[169, 336, 747, 1004, 1343, 1576, 2153, 2483, 2847, 3403, 4086, 4292, 4971, 5464, 5864, 6372, 6983, 7379, 7474, 7899, 8599, 9423, 9608, 9779, 10072, 10402, 10769, 11292, 11584, 12381]","[169, 259, 396, 499, 633, 723, 1276, 1366, 1501, 1831, 2234, 2691, 3086, 3487, 3865, 4185, 4370, 4536, 4999, 5612, 5707, 6051, 6218, 6654, 6769, 6994, 7152, 7610, 8264, 8661]","[169, 530, 670, 760, 850, 1061, 1348, 1438, 1792, 2381, 2693, 2882, 3206, 3417, 3667, 3915, 4010, 4104, 4213, 4593, 4779, 4913, 5291, 5386, 5481, 5859, 5954, 6179, 6360, 6566]",23034,14399,12381,8661,6566,-521,9593,4024,2036,2249,17381,30,radiant
7560138206,73,98,39,123,5,"[0, 371, 802, 1303, 1563, 1817, 2709, 3218, 3729, 4590, 5399, 6373, 7520, 9111, 9959, 11101, 12567, 13677, 14380, 15542, 17369, 18901, 20608, 21633, 22308, 22942, 24111, 25078, 25831, 26259]","[0, 244, 477, 857, 1018, 1433, 1897, 2238, 2472, 2888, 3200, 3641, 4517, 5502, 5948, 6640, 7430, 8000, 8463, 9133, 9790, 10778, 11440, 12231, 12982, 13527, 13941, 15029, 15782, 15965]","[0, 331, 607, 961, 1410, 1822, 2196, 2743, 3213, 3691, 4349, 5160, 5483, 6068, 6619, 7353, 7854, 8333, 9151, 10312, 11068, 11372, 12447, 13330, 13926, 14712, 15800, 16193, 17095, 17483]","[0, 169, 640, 760, 850, 986, 1194, 1398, 1768, 1868, 2266, 2356, 2871, 3254, 3924, 4333, 4702, 4971, 5311, 5588, 6198, 6909, 7612, 8160, 8731, 9248, 9950, 10635, 10950, 11301]","[0, 169, 365, 550, 685, 775, 1003, 1236, 1504, 1865, 2205, 2540, 2870, 3107, 3291, 3636, 4002, 4232, 4503, 4997, 5498, 6142, 6524, 6978, 7284, 7527, 8596, 8984, 9248, 9422]",26259,15965,17483,11301,9422,22,48,29,45,58,"[0, 357, 962, 1254, 1673, 2098, 2470, 3144, 3550, 3855, 4352, 4784, 5396, 5890, 6388, 6665, 7370, 7889, 8885, 9551, 10546, 10887, 11791, 12295, 13002, 13966, 15052, 16257, 16989, 18443]","[0, 257, 658, 1098, 1381, 1791, 2007, 2480, 2905, 3333, 3950, 4390, 5055, 5890, 6098, 6658, 7471, 8516, 9279, 9964, 11056, 11789, 12158, 12545, 13053, 13575, 13866, 14105, 15042, 16395]","[0, 245, 564, 763, 1170, 1689, 2098, 2617, 3019, 3371, 3831, 4077, 4660, 5416, 5929, 6521, 7313, 8084, 8954, 9270, 9988, 10252, 10509, 11032, 11525, 11741, 12032, 12463, 12920, 13704]","[0, 169, 289, 426, 578, 811, 967, 1291, 1504, 1781, 2014, 2104, 2275, 2548, 2823, 3041, 3632, 4004, 4397, 5005, 5655, 5919, 6220, 6385, 6776, 6992, 7468, 7804, 8471, 9466]","[0, 169, 289, 398, 488, 736, 826, 961, 1056, 1146, 1566, 1688, 1880, 2100, 2317, 2448, 2950, 3176, 3462, 3916, 4256, 4825, 5220, 5375, 5642, 5809, 6361, 6582, 7155, 8184]",18443,16395,13704,9466,8184,7816,-430,3779,1835,1238,14238,30,radiant
7560377202,10,49,61,128,121,"[609, 813, 1117, 1479, 1821, 2279, 2830, 3294, 3928, 4561, 5155, 5376, 6036, 7003, 7911, 9053, 9990, 10925, 11864, 12661, 13228, 13665, 14474, 15712, 16385, 17807, 18731, 19870, 21122, 21715]","[532, 735, 1017, 1355, 1516, 1965, 2161, 2550, 3453, 4054, 4712, 5674, 6162, 6883, 7330, 8177, 8448, 8904, 9510, 10089, 10678, 10843, 11073, 11894, 12347, 13230, 13610, 14454, 15081, 16287]","[904, 1289, 1555, 2178, 2789, 3355, 3832, 4496, 5306, 5751, 7115, 7427, 8009, 9014, 9509, 9996, 10284, 10720, 11109, 11499, 12101, 12426, 13161, 14003, 14334, 15425, 16176, 16703, 17485, 18143]","[541, 677, 767, 998, 1322, 1715, 1883, 2021, 2249, 2751, 3123, 3427, 3522, 4305, 4601, 4909, 5175, 5510, 5672, 5951, 6151, 6366, 6671, 7002, 7305, 7844, 8392, 8685, 8907, 9408]","[350, 490, 624, 714, 1003, 1267, 1435, 1570, 1902, 2076, 2628, 2883, 3165, 3640, 4149, 4351, 4533, 4726, 4821, 5025, 5120, 5215, 5445, 5701, 5796, 6083, 6393, 6714, 6904, 7356]",21715,16287,18143,9408,7356,70,35,129,123,20,"[948, 1196, 1487, 2008, 2434, 2608, 2912, 3425, 4042, 4721, 5256, 5833, 6507, 7235, 8050, 8629, 9387, 9905, 11068, 11669, 12466, 13020, 14279, 14963, 16065, 17077, 17531, 18418, 19659, 21626]","[530, 819, 1282, 1603, 2002, 2744, 3559, 4307, 5102, 5708, 6562, 6832, 7477, 8115, 8290, 8960, 9720, 10354, 11114, 11683, 12219, 12745, 13178, 13510, 14129, 14701, 15364, 16084, 16810, 18736]","[932, 1348, 1848, 2227, 2633, 3139, 4121, 4681, 5098, 5801, 6596, 6700, 6939, 7386, 7561, 8274, 8932, 9460, 10047, 10400, 10758, 10903, 11388, 11799, 12818, 13661, 14172, 14320, 14623, 15416]","[532, 622, 1099, 1189, 1344, 1544, 1812, 2020, 2362, 2801, 3210, 3421, 3767, 4182, 4402, 4769, 4864, 5220, 5615, 5828, 6166, 6404, 6590, 6708, 7364, 7620, 7790, 8225, 8467, 9502]","[829, 966, 1267, 1572, 1920, 2020, 2425, 2873, 3266, 3383, 3700, 4200, 4439, 4732, 4907, 5371, 5585, 5863, 6329, 6570, 6893, 7063, 7351, 7568, 8072, 8288, 8459, 8630, 9088, 9900]",21626,18736,15416,9502,9900,89,-2449,2727,-94,-2544,-2271,30,dire
7560505612,49,10,129,119,65,"[0, 350, 640, 974, 1305, 1518, 2125, 2753, 3179, 3532, 4184, 4580, 5033, 5994, 6547, 6807, 7711, 8587, 9288, 10251, 11032, 11635, 12749, 13947, 14940, 15749, 16402, 18209, 19344, 20434]","[0, 574, 840, 1216, 1504, 1841, 2165, 2794, 3182, 3784, 4337, 5082, 5771, 6456, 7039, 7837, 8704, 9390, 10259, 11822, 12864, 12959, 13753, 14527, 15252, 16324, 17033, 19028, 19965, 20061]","[0, 129, 401, 668, 999, 1387, 1741, 2172, 2405, 2953, 3417, 3708, 4344, 5291, 5847, 6335, 7137, 7810, 8488, 8707, 9418, 9513, 10101, 10916, 11749, 12060, 13081, 14029, 15218, 16087]","[0, 193, 308, 398, 532, 705, 861, 1017, 1107, 1288, 1782, 1928, 2156, 2835, 3031, 3438, 4107, 4265, 4467, 5101, 5265, 5695, 6081, 6737, 7310, 7796, 8128, 9243, 9870, 10595]","[0, 294, 409, 499, 589, 923, 1156, 1361, 1703, 1924, 2287, 2527, 2707, 3445, 3699, 4177, 4532, 4859, 5197, 5948, 6106, 6206, 6714, 7123, 7541, 7728, 7933, 8333, 8916, 9604]",20434,20061,16087,10595,9604,12,126,96,105,79,"[0, 246, 579, 787, 1111, 1274, 1802, 1937, 2313, 2798, 3169, 3397, 4275, 4661, 5184, 5784, 6149, 6847, 7654, 8761, 9123, 10782, 11287, 12347, 12442, 13373, 13878, 14143, 15125, 16216]","[0, 369, 567, 905, 1200, 1443, 1742, 2160, 2526, 3117, 3528, 4044, 4660, 4971, 5395, 5906, 6438, 6952, 7544, 7790, 8670, 9649, 10083, 11362, 11726, 12317, 13187, 13421, 14084, 14749]","[0, 354, 590, 793, 1331, 1634, 1841, 2262, 2689, 3069, 3373, 3642, 4109, 4590, 5157, 5325, 5643, 6061, 6360, 6803, 7427, 8409, 8992, 9552, 9647, 9814, 10281, 10731, 11770, 12219]","[0, 412, 502, 592, 774, 901, 1040, 1470, 1694, 1915, 2154, 2304, 2540, 2686, 2781, 3360, 3583, 3854, 4040, 5016, 5155, 6221, 6316, 6714, 7038, 7495, 7963, 8395, 9263, 10152]","[0, 279, 369, 459, 589, 794, 884, 1155, 1290, 1511, 1601, 1790, 2026, 2221, 2316, 2607, 2856, 3120, 3441, 4407, 4502, 5346, 5441, 5734, 5995, 6162, 6257, 6526, 7229, 7626]",16216,14749,12219,10152,7626,4218,5312,3868,443,1978,15819,30,radiant
7560508910,63,106,29,128,20,"[205, 446, 654, 1076, 1351, 1485, 2159, 2525, 2873, 3263, 3717, 4263, 4838, 5092, 5712, 6437, 6965, 7304, 7895, 8262, 9249, 10018, 10712, 11182, 11966, 12827, 13115, 14397, 15199, 16515]","[207, 415, 762, 1016, 1309, 1600, 1909, 2293, 2709, 2996, 3465, 3760, 4531, 4805, 5319, 5513, 5885, 6461, 7242, 7716, 8501, 9236, 9816, 10421, 10845, 11337, 11902, 12882, 13418, 14859]","[205, 452, 739, 1060, 1356, 1620, 2034, 2502, 2921, 3161, 3448, 4134, 4700, 5302, 5939, 6176, 7151, 7810, 8323, 8900, 9653, 10444, 11551, 11932, 12144, 12710, 13263, 14083, 14489, 15591]","[223, 313, 403, 533, 709, 799, 1076, 1303, 1704, 1929, 2019, 2319, 2737, 2832, 3324, 3518, 3774, 3916, 4611, 5135, 5230, 5666, 6393, 6646, 7059, 7511, 7859, 9042, 9483, 10213]","[221, 311, 401, 579, 980, 1107, 1372, 1507, 1683, 1792, 1882, 2005, 2351, 2539, 2879, 3073, 3168, 3353, 4189, 4508, 4603, 5081, 5559, 5653, 5820, 6005, 6210, 6894, 7338, 8556]",16515,14859,15591,10213,8556,17,21,129,33,45,"[326, 685, 1102, 1467, 1927, 2373, 2774, 3287, 3659, 4095, 4943, 5446, 5855, 6554, 6949, 7871, 8642, 9363, 9793, 10026, 10315, 10751, 11175, 11812, 11979, 12806, 13206, 13478, 13781, 14400]","[253, 454, 581, 1128, 1460, 1758, 2185, 2764, 3112, 3470, 4258, 4669, 5188, 5733, 6440, 6890, 7311, 8028, 8258, 9110, 9303, 9889, 10703, 11098, 11762, 12649, 12906, 13083, 13422, 13990]","[254, 541, 803, 1329, 1526, 2043, 2344, 2673, 3170, 3714, 4018, 4594, 4878, 5834, 6208, 6657, 7358, 7700, 8038, 8443, 9063, 9728, 9823, 10064, 10570, 11068, 11242, 11787, 12140, 12706]","[171, 261, 351, 573, 663, 753, 948, 1234, 1373, 1722, 1976, 2178, 2272, 2681, 2776, 3285, 3597, 3855, 4282, 4425, 5168, 5594, 5811, 6152, 6462, 6758, 7086, 7338, 7680, 8262]","[171, 610, 700, 874, 1186, 1276, 1696, 1959, 2049, 2229, 2464, 2665, 3329, 3941, 4207, 4464, 4950, 5599, 6111, 6299, 6394, 6561, 6739, 6915, 7082, 7616, 7763, 8104, 8325, 8481]",14400,13990,12706,8262,8481,2115,869,2885,1951,75,7895,30,radiant
7560629402,49,25,23,123,45,"[0, 287, 601, 868, 1171, 1463, 1787, 2067, 2482, 2746, 3302, 3513, 4183, 4734, 5297, 5736, 6713, 7377, 8238, 9284, 10193, 10694, 11437, 11778, 12564, 13290, 14159, 15009, 16195, 16334]","[0, 293, 545, 787, 1021, 1233, 1323, 1648, 2008, 2286, 2853, 3223, 3857, 4462, 5287, 5823, 6344, 6656, 7707, 8103, 8738, 9319, 10015, 11096, 11716, 12551, 13273, 13699, 14517, 14700]","[0, 243, 408, 842, 1194, 1537, 2144, 2334, 3118, 3747, 4345, 5063, 5582, 6232, 6703, 7190, 7660, 8396, 9022, 9242, 9950, 10132, 10682, 12164, 12427, 12936, 13624, 14083, 14850, 15147]","[0, 215, 390, 480, 640, 730, 867, 1004, 1233, 1456, 1768, 2117, 2374, 2591, 3066, 3494, 3903, 4516, 5490, 6072, 6399, 6823, 6918, 7013, 7604, 7916, 8670, 9294, 9794, 10375]","[0, 205, 295, 385, 610, 769, 865, 955, 1184, 1674, 1980, 2070, 2291, 2434, 2960, 3325, 4185, 4336, 4706, 5138, 5473, 5567, 5662, 5757, 6090, 6258, 6751, 6902, 7189, 7553]",16334,14700,15147,10375,7553,59,15,106,102,105,"[0, 244, 442, 603, 1122, 1467, 2021, 2444, 3023, 3512, 4077, 4961, 5465, 6213, 6779, 7349, 8658, 9094, 9944, 10114, 11312, 12395, 13520, 14560, 14836, 15990, 16630, 17215, 17908, 18543]","[0, 243, 492, 1155, 1452, 1853, 2217, 2545, 2872, 3428, 3649, 4412, 4943, 5309, 5662, 6050, 6839, 7502, 8122, 8607, 9018, 9736, 10452, 11261, 11804, 12226, 12867, 13404, 13930, 14508]","[0, 208, 491, 708, 967, 1333, 1468, 1962, 2160, 2540, 3173, 3448, 3885, 4185, 4633, 5154, 5748, 6357, 7015, 7110, 8037, 8404, 9603, 11107, 11717, 12204, 12597, 13134, 13908, 14145]","[0, 170, 317, 407, 532, 871, 1079, 1321, 1411, 1552, 1733, 1960, 2313, 2748, 3152, 3350, 3691, 3921, 4319, 4414, 4841, 5116, 5714, 6341, 6436, 6710, 6805, 6946, 7177, 7273]","[0, 170, 299, 603, 757, 847, 1220, 1577, 1797, 1887, 2128, 2331, 2421, 2837, 3422, 3637, 4124, 4354, 4621, 4752, 5074, 5759, 6581, 7248, 7418, 7706, 8224, 8394, 8753, 8924]",18543,14508,14145,7273,8924,-2209,192,1002,3102,-1371,716,30,radiant
7560661218,73,93,120,86,105,"[0, 411, 690, 1068, 1410, 1862, 2343, 2809, 3361, 4084, 4977, 5503, 6194, 7192, 7596, 9063, 10430, 11472, 12646, 13727, 14701, 15752, 17094, 18168, 18599, 19495, 20031, 20392, 20991, 21832]","[0, 244, 560, 945, 1186, 1673, 1904, 2185, 2691, 2978, 3358, 3871, 4164, 4661, 4953, 5376, 6647, 6832, 7514, 8137, 8908, 9355, 9620, 10418, 10698, 10972, 11516, 12096, 12292, 12918]","[0, 245, 484, 1009, 1573, 2064, 2288, 2667, 2879, 3370, 3849, 4131, 4692, 5398, 5792, 6153, 6796, 7144, 7507, 8074, 8500, 8907, 9678, 10436, 10531, 11124, 11313, 11930, 12170, 12782]","[0, 258, 348, 485, 916, 1168, 1308, 1443, 1558, 2099, 2540, 2666, 2977, 3197, 3291, 3511, 3732, 4226, 4588, 4923, 5043, 5163, 5418, 5622, 5885, 6172, 6505, 6799, 7246, 7601]","[0, 210, 300, 437, 567, 776, 866, 1048, 1138, 1362, 1620, 1710, 1844, 2196, 2290, 2421, 2936, 3221, 3340, 3498, 3593, 3688, 4333, 4500, 4595, 4762, 4900, 4995, 5191, 5368]",21832,12918,12782,7601,5368,46,21,29,20,136,"[0, 205, 605, 1054, 1453, 1898, 2433, 2676, 3146, 3641, 4244, 4932, 5770, 6121, 6847, 7427, 9157, 9802, 10283, 10747, 11724, 12531, 13306, 14153, 15416, 16162, 17484, 18547, 19745, 20851]","[0, 165, 399, 856, 1064, 1261, 1558, 1841, 2239, 2747, 2980, 3386, 4076, 4713, 5146, 5579, 6630, 7280, 7866, 8207, 8951, 9583, 10343, 10900, 11746, 12475, 13226, 13826, 14360, 14826]","[0, 204, 915, 1194, 1515, 1810, 2168, 2479, 2920, 3482, 3987, 4695, 5188, 5721, 6489, 7330, 8107, 8619, 9172, 9267, 9977, 10767, 11634, 12570, 13020, 13642, 14442, 14906, 15491, 16124]","[0, 130, 272, 423, 537, 627, 751, 841, 931, 1060, 1303, 1623, 1943, 2407, 2712, 3035, 3705, 4021, 4485, 4980, 5339, 5555, 5894, 6196, 6731, 7272, 7494, 7759, 8141, 8654]","[0, 130, 297, 436, 526, 699, 836, 926, 1052, 1142, 1277, 1761, 2046, 2361, 2675, 3088, 3664, 3952, 4542, 4859, 5306, 5571, 6206, 6458, 6775, 7063, 7463, 7727, 8059, 8525]",20851,14826,16124,8654,8525,981,-1908,-3342,-1053,-3157,-8479,30,dire
7560727113,95,126,65,120,110,"[328, 624, 992, 1327, 1610, 2149, 2542, 2942, 3399, 4047, 4391, 4860, 5283, 6041, 6672, 6984, 7589, 8401, 9042, 9953, 10760, 11538, 12392, 13367, 14890, 16114, 17583, 18314, 19213, 19986]","[0, 277, 609, 990, 1362, 1639, 2250, 2476, 2924, 3573, 3874, 4188, 4433, 5049, 5389, 6261, 6938, 7250, 7660, 8311, 9009, 10111, 10494, 11088, 11827, 12185, 12788, 13584, 13947, 14375]","[60, 269, 463, 858, 1296, 1598, 2169, 2587, 3145, 3855, 4503, 5775, 6282, 6840, 7125, 7393, 8104, 8495, 8725, 9674, 9982, 10686, 11283, 11603, 12453, 13025, 13894, 14284, 14800, 15104]","[60, 320, 410, 549, 682, 1116, 1312, 1447, 1638, 1818, 2178, 2507, 2927, 3236, 3557, 3652, 3809, 4049, 4401, 4746, 5156, 5833, 6094, 6189, 6969, 7686, 8145, 8538, 8634, 9095]","[160, 369, 459, 549, 679, 882, 1002, 1318, 1457, 1734, 1961, 2129, 2323, 2583, 2946, 3079, 3436, 4147, 4611, 4888, 5139, 5750, 5943, 6235, 6688, 7390, 7896, 8071, 8503, 8903]",19986,14375,15104,9095,8903,48,13,23,123,105,"[0, 164, 416, 663, 1161, 1667, 2205, 2536, 2747, 3160, 3773, 4296, 5030, 5546, 6106, 6892, 7822, 8531, 9357, 10328, 11333, 11957, 13307, 14088, 15144, 15239, 16255, 17021, 17866, 18227]","[0, 199, 438, 684, 1242, 1541, 1988, 2422, 2750, 3211, 4021, 4327, 4889, 5281, 5793, 5888, 6663, 7023, 7402, 7696, 8259, 8765, 9975, 10653, 11196, 11945, 12040, 12701, 13225, 13979]","[0, 178, 579, 790, 984, 1228, 1513, 1858, 2118, 2444, 3293, 3678, 4180, 4645, 4974, 5388, 6002, 6663, 7124, 7536, 8330, 8623, 9173, 9405, 9643, 9738, 10402, 10836, 11092, 11220]","[0, 129, 219, 359, 606, 734, 1337, 1975, 2100, 2190, 2401, 2539, 3041, 3234, 3377, 3527, 4129, 4224, 4916, 5533, 5750, 5845, 6537, 6906, 7308, 7403, 7743, 7979, 8156, 8420]","[0, 129, 219, 309, 469, 627, 1085, 1220, 1348, 1438, 1663, 1911, 2140, 2235, 2375, 2720, 3026, 3232, 4198, 4585, 4857, 4993, 5652, 5822, 6203, 6373, 6543, 6757, 7009, 7180]",18227,13979,11220,8420,7180,1759,396,3884,675,1723,8437,30,radiant
7560784306,46,126,135,123,84,"[693, 944, 1401, 1823, 2366, 2964, 3458, 4031, 4389, 5510, 6075, 6940, 7441, 7917, 8357, 9576, 10309, 11269, 11528, 11768, 12376, 13152, 13884, 14148, 14966, 15772, 16713, 17623, 18312, 18622]","[705, 946, 1158, 1481, 1990, 2500, 2881, 3459, 3682, 4200, 4439, 4929, 5355, 5810, 6627, 7168, 7943, 8204, 9029, 9604, 10822, 11581, 11917, 12184, 12569, 13267, 13363, 14422, 14881, 15267]","[858, 1117, 1443, 1775, 2325, 2683, 3019, 3671, 4117, 4700, 4871, 5706, 6000, 6541, 7339, 7901, 8307, 8515, 8750, 9185, 9846, 10192, 10995, 11532, 12509, 12794, 12924, 13868, 14469, 14979]","[328, 418, 618, 753, 888, 1145, 1235, 1525, 1786, 2253, 2486, 2805, 2951, 3330, 4387, 4719, 4949, 5268, 5657, 6019, 6421, 6689, 6805, 6900, 7076, 7868, 7985, 8354, 8650, 9283]","[444, 559, 768, 939, 1091, 1310, 1534, 1824, 2053, 2360, 2508, 2968, 3259, 3885, 4622, 4937, 5122, 5217, 5561, 6228, 6775, 7049, 7179, 7403, 7903, 8257, 8447, 8823, 8923, 9113]",18622,15267,14979,9283,9113,41,23,96,53,26,"[712, 962, 1459, 1704, 1990, 2266, 2748, 3283, 3833, 4254, 4867, 5370, 6292, 7221, 7955, 8474, 9219, 10162, 10919, 11414, 12121, 12386, 13653, 15189, 16242, 17173, 18005, 18967, 20054, 21246]","[1229, 1632, 2155, 2503, 2992, 3285, 3845, 4240, 4613, 5051, 6187, 6942, 7421, 8046, 8387, 9218, 9756, 10786, 10974, 12749, 13268, 13690, 14032, 15356, 16090, 16882, 17625, 18188, 18826, 19632]","[1101, 1460, 1871, 2211, 2664, 3081, 3542, 4170, 4759, 5015, 5506, 5941, 6565, 7210, 7628, 8408, 8959, 9987, 10261, 11853, 12283, 13266, 13729, 14713, 15314, 15784, 16439, 16927, 17682, 18462]","[773, 1092, 1282, 1372, 1681, 1792, 2037, 2216, 2479, 2597, 3018, 3248, 4052, 4670, 4935, 5243, 5801, 6225, 6813, 7908, 8620, 9033, 9722, 10430, 10820, 11863, 12088, 13026, 13641, 14554]","[549, 736, 915, 1005, 1206, 1296, 1488, 1667, 2082, 2276, 2518, 2770, 3257, 3713, 3963, 4058, 4508, 4693, 4876, 5943, 6099, 6727, 7073, 8226, 8493, 8801, 9264, 10278, 10728, 11203]",21246,19632,18462,14554,11203,-2624,-4365,-3483,-5271,-2090,-17833,30,dire
7560901901,72,76,38,20,105,"[314, 619, 937, 1393, 2180, 2572, 2994, 3527, 4144, 4696, 5116, 5710, 6450, 7189, 7706, 8788, 9124, 10359, 11470, 12351, 13275, 13928, 14673, 15456, 16320, 17403, 18801, 19278, 19776, 20489]","[249, 416, 581, 1117, 1448, 1831, 2243, 2817, 3318, 3739, 4020, 4569, 4834, 5250, 5441, 6013, 6325, 7518, 8139, 8719, 9256, 9971, 10502, 10597, 10859, 11113, 12514, 13217, 13949, 14045]","[535, 807, 985, 1260, 1679, 2010, 2281, 2795, 3101, 3575, 4334, 4775, 5231, 5548, 5943, 6314, 7085, 7796, 8455, 8788, 9133, 9745, 10098, 10563, 10789, 11490, 12488, 12897, 13173, 13454]","[229, 358, 465, 692, 978, 1068, 1439, 1616, 1721, 1856, 2061, 2629, 3097, 3385, 3693, 3944, 4174, 4709, 5016, 5336, 5597, 5770, 6080, 6175, 6398, 6947, 7675, 7771, 8047, 8143]","[277, 412, 502, 592, 726, 864, 999, 1089, 1179, 1560, 2281, 2547, 2715, 3165, 3623, 3718, 3948, 4453, 4649, 4744, 4902, 5243, 6511, 6606, 6724, 6818, 7854, 7994, 8147, 8243]",20489,14045,13454,8143,8243,95,23,97,110,26,"[197, 505, 993, 1389, 1718, 2268, 2818, 3252, 3725, 4193, 4728, 5429, 6636, 7404, 8294, 9478, 10346, 10524, 11474, 12392, 13250, 14292, 15371, 16431, 17565, 18305, 19073, 20487, 22726, 23307]","[239, 543, 914, 1123, 1458, 1632, 1942, 2321, 2672, 3158, 3802, 3943, 4637, 4902, 5568, 6412, 6924, 7590, 7903, 8396, 8885, 9233, 10438, 11023, 12126, 12675, 13354, 13726, 14638, 14955]","[207, 491, 808, 1131, 1615, 2236, 2681, 3200, 3607, 4153, 4775, 5053, 5250, 5710, 6298, 7057, 7715, 7893, 8328, 8850, 9424, 9881, 11072, 11319, 11740, 12446, 12614, 12946, 13419, 13815]","[169, 259, 406, 536, 626, 761, 1022, 1134, 1260, 1678, 1924, 2448, 2685, 3092, 3277, 3632, 4184, 4362, 4654, 4857, 5027, 5419, 6082, 6547, 6968, 7607, 7831, 8374, 9094, 9310]","[219, 346, 436, 612, 862, 1156, 1291, 1518, 1733, 1959, 2186, 2353, 2680, 2775, 3123, 3326, 3657, 3835, 3929, 4024, 4119, 4213, 5097, 5323, 5806, 6669, 6793, 7137, 7840, 8077]",23307,14955,13815,9310,8077,-2818,-910,-361,-1167,166,-5090,30,dire
7561106207,106,14,6,27,85,"[0, 244, 641, 1016, 1550, 1929, 2481, 2832, 3413, 4050, 4669, 5273, 5950, 6687, 7269, 7938, 8670, 9080, 9694, 10690, 11296, 11939, 12877, 13664, 14568, 15481, 16518, 17108, 17450, 18282]","[0, 129, 400, 756, 1351, 1841, 2611, 2864, 3351, 3921, 4258, 4694, 5187, 5730, 6535, 7001, 7762, 8179, 8990, 9267, 9816, 10007, 10373, 11513, 11983, 12885, 13786, 14269, 14888, 15215]","[0, 206, 638, 948, 1238, 1923, 2247, 2441, 2843, 2933, 3365, 3495, 4049, 4508, 4984, 5715, 6115, 7132, 7998, 8647, 9302, 9919, 10421, 11561, 12175, 12734, 14125, 14452, 14718, 14814]","[0, 133, 223, 347, 622, 855, 1123, 1306, 1564, 1676, 1841, 2172, 2687, 2880, 3333, 3677, 4010, 4740, 5071, 5522, 6043, 6619, 7253, 8248, 8883, 9443, 10354, 10602, 10976, 11656]","[0, 90, 285, 422, 512, 1020, 1155, 1406, 1759, 2052, 2497, 2911, 3091, 3334, 3764, 3859, 4080, 4238, 4396, 4490, 4783, 4923, 5090, 5680, 6355, 6862, 7501, 7676, 7956, 8500]",18282,15215,14814,11656,8500,44,25,112,119,3,"[0, 322, 684, 889, 1280, 1559, 1870, 2372, 2959, 3171, 3544, 4282, 4749, 5249, 6090, 6464, 6962, 7844, 8581, 9281, 10236, 11018, 12123, 13238, 14085, 14180, 14694, 16421, 18750, 19454]","[331, 734, 1139, 1546, 1907, 2541, 3048, 3537, 4244, 4538, 5463, 6130, 6655, 6875, 7476, 8108, 8817, 9183, 9894, 10741, 11302, 11767, 12499, 12721, 13165, 13867, 14896, 15594, 17067, 17713]","[63, 349, 584, 997, 1489, 1579, 2037, 2285, 2541, 3104, 3509, 3881, 4285, 4768, 5375, 5867, 6521, 7067, 7593, 8099, 8661, 9123, 9994, 10642, 10829, 10994, 11170, 11910, 12991, 13826]","[63, 313, 664, 792, 970, 1234, 1448, 1595, 1970, 2729, 3326, 3710, 4148, 4546, 4784, 5215, 5372, 5467, 5748, 6467, 6610, 7005, 7262, 7484, 7616, 7792, 7968, 8860, 9295, 9922]","[63, 357, 447, 598, 801, 991, 1081, 1256, 1456, 1727, 1955, 2045, 2490, 2702, 2956, 3100, 3257, 3381, 3539, 3872, 3997, 4092, 4349, 4443, 4633, 4870, 5046, 5298, 6666, 6933]",19454,17713,13826,9922,6933,-1172,-2498,988,1734,1567,619,30,radiant
7561146918,36,59,104,79,22,"[0, 382, 798, 1170, 1580, 2217, 3015, 3427, 4145, 4821, 5047, 5931, 6491, 7514, 8013, 8635, 9764, 10189, 11501, 12347, 13247, 13967, 14787, 15426, 15701, 16886, 17776, 19049, 19688, 20593]","[0, 252, 541, 973, 1343, 1621, 1894, 2177, 2453, 2870, 3475, 4079, 4495, 4976, 5405, 5770, 6444, 6835, 7733, 8244, 8938, 9402, 9790, 10806, 11954, 12382, 12823, 12951, 14162, 15104]","[0, 281, 615, 1019, 1317, 1531, 2067, 2382, 2606, 2926, 3382, 3835, 4169, 4562, 5039, 5336, 5882, 6553, 7227, 7653, 8257, 9130, 9692, 10744, 11643, 12449, 12810, 13353, 14451, 15089]","[0, 170, 260, 432, 653, 743, 906, 996, 1196, 1286, 2037, 2516, 2729, 2985, 3261, 3561, 4051, 4191, 4732, 5195, 5929, 6111, 6545, 6875, 7199, 7479, 8113, 9183, 9563, 10052]","[0, 170, 260, 455, 584, 692, 822, 947, 1115, 1290, 1426, 1739, 2195, 2380, 2558, 2734, 3201, 3354, 3619, 4062, 4367, 4462, 4764, 5017, 6180, 6806, 7479, 7974, 8487, 8770]",20593,15104,15089,10052,8770,25,71,6,86,84,"[0, 335, 658, 993, 1376, 2042, 2430, 2998, 3624, 4516, 5161, 5975, 6949, 7434, 8290, 8783, 9758, 10860, 11749, 12583, 13305, 14232, 15547, 15921, 16279, 16574, 17084, 17802, 18643, 18739]","[0, 329, 563, 930, 1269, 1608, 1749, 2165, 2571, 2909, 3292, 4115, 4879, 5514, 6307, 6686, 7320, 7901, 8617, 8711, 9171, 9851, 10158, 11021, 11788, 12865, 13215, 14295, 15057, 16181]","[0, 290, 610, 817, 1140, 1464, 1863, 2280, 2778, 3219, 3751, 4370, 4543, 5323, 5939, 6864, 7530, 7870, 8148, 8712, 9446, 10300, 10755, 12274, 12825, 12992, 13711, 14306, 14938, 15219]","[0, 170, 307, 397, 563, 750, 840, 1021, 1201, 1613, 2072, 2356, 2716, 3385, 3833, 4311, 5210, 5588, 6204, 6701, 7196, 7984, 8536, 9008, 9618, 9785, 10268, 10750, 11008, 11104]","[0, 170, 260, 350, 528, 666, 756, 976, 1204, 1294, 1547, 1834, 2015, 2602, 2809, 3116, 3473, 3585, 3847, 3941, 4036, 4675, 5002, 5096, 5925, 6092, 6187, 7060, 7576, 7697]",18739,16181,15219,11104,7697,1854,-1077,-130,-1052,1073,668,30,radiant
7561212717,94,137,17,123,90,"[0, 154, 481, 857, 1337, 1708, 1833, 2164, 2432, 3001, 3491, 4181, 4591, 5607, 6105, 6785, 7507, 8678, 9560, 10499, 10998, 11093, 12270, 13487, 14640, 15856, 16544, 17322, 18337, 19858]","[0, 191, 434, 706, 945, 1437, 1676, 1854, 2062, 2611, 3165, 3682, 3999, 4623, 5463, 5980, 6974, 7507, 8173, 8496, 9313, 9408, 9736, 10320, 11194, 11780, 12277, 12804, 13050, 13970]","[0, 273, 560, 1014, 1507, 2057, 2463, 3057, 3419, 3836, 4265, 4519, 4923, 5345, 5691, 6290, 6749, 7108, 7579, 8069, 8667, 8982, 9380, 10226, 10625, 11098, 11436, 11885, 12326, 13090]","[0, 154, 244, 514, 644, 779, 905, 1166, 1404, 1518, 1775, 2076, 2215, 2766, 3130, 3342, 3896, 4291, 4478, 4874, 5348, 5443, 5631, 5989, 6164, 6331, 6425, 6620, 6906, 7493]","[0, 154, 244, 381, 596, 780, 903, 1059, 1295, 1406, 1500, 1813, 1953, 2208, 2545, 2758, 3296, 3482, 3952, 4258, 4417, 4512, 4699, 5002, 5211, 5378, 5472, 5661, 5815, 6632]",19858,13970,13090,7493,6632,95,13,96,65,110,"[0, 317, 560, 758, 1227, 1650, 2141, 2672, 3170, 3722, 4308, 4732, 5175, 5722, 6291, 7222, 7620, 8304, 9150, 10066, 10796, 12769, 13695, 14811, 15629, 16694, 17521, 18390, 19537, 20395]","[0, 292, 542, 821, 1227, 1637, 2053, 2614, 3147, 3589, 4166, 4589, 5051, 5895, 6338, 6993, 7534, 7837, 8411, 8772, 9225, 10865, 11409, 12047, 12432, 13032, 13206, 14036, 14427, 14647]","[0, 243, 598, 962, 1321, 1609, 1952, 2244, 2580, 3032, 3556, 4020, 4397, 5073, 5567, 6160, 7040, 7677, 8254, 8858, 9151, 10200, 10908, 11247, 11546, 12269, 12363, 13225, 13928, 14446]","[0, 209, 299, 389, 863, 973, 1203, 1497, 1662, 1828, 2008, 2272, 2602, 3013, 3355, 3787, 4220, 4363, 4655, 4981, 5514, 6503, 7073, 7242, 7579, 7870, 8039, 8386, 8926, 9314]","[0, 255, 345, 455, 668, 803, 1116, 1472, 1605, 2169, 2349, 2483, 2679, 3045, 3348, 3532, 3765, 4059, 4307, 4639, 5035, 5602, 5841, 5935, 6186, 6521, 6615, 7027, 7369, 7709]",20395,14647,14446,9314,7709,-537,-677,-1356,-1821,-1077,-5468,30,dire
7561287313,19,7,138,86,92,"[0, 322, 675, 937, 1267, 1709, 1927, 2362, 2641, 3011, 3242, 4073, 4479, 4733, 5043, 6051, 6890, 7280, 7727, 8310, 8923, 10064, 10578, 11308, 11403, 12139, 13157, 13391, 14156, 14953]","[0, 242, 475, 790, 1113, 1566, 1813, 2063, 2466, 2774, 3365, 3710, 4132, 4456, 4862, 5632, 6039, 6284, 7082, 7511, 7784, 8497, 8930, 9209, 9931, 10139, 10352, 11245, 11466, 11596]","[0, 207, 833, 968, 1058, 1312, 1501, 1591, 1763, 2108, 2375, 3486, 3720, 4260, 4435, 5148, 5706, 6078, 7002, 7562, 7657, 8473, 9063, 9201, 9593, 9872, 10153, 11010, 11106, 11334]","[0, 218, 308, 500, 674, 903, 1042, 1255, 1513, 1875, 2092, 3102, 3697, 3936, 4117, 4707, 4865, 4993, 5486, 5973, 6241, 6758, 6981, 7085, 7491, 7699, 8070, 8609, 8780, 9049]","[0, 204, 502, 705, 1008, 1332, 1494, 1704, 1839, 2014, 2194, 2859, 3171, 3481, 4031, 4516, 4935, 5151, 5778, 6141, 6285, 7346, 7538, 7653, 7857, 7951, 8270, 8751, 8892, 9123]",14953,11596,11334,9049,9123,46,120,97,123,21,"[0, 244, 559, 962, 1248, 1669, 2527, 3161, 3734, 4604, 5735, 6549, 7220, 8050, 8648, 9209, 10341, 11255, 12267, 13459, 14293, 15193, 16493, 18463, 19940, 20878, 22174, 23124, 23839, 25190]","[0, 288, 533, 981, 1384, 1727, 2507, 2801, 3411, 3587, 4065, 4535, 4974, 5761, 6086, 6340, 7026, 7526, 8076, 8893, 9177, 9564, 10369, 11035, 11710, 12168, 12662, 13421, 14233, 14501]","[0, 243, 581, 970, 1286, 1771, 2027, 2708, 3003, 3645, 4231, 4536, 4991, 5743, 6475, 6795, 7270, 7538, 8113, 8637, 9071, 9950, 10093, 10606, 11150, 11487, 11851, 12552, 13414, 13885]","[0, 170, 309, 545, 728, 958, 1195, 1453, 1682, 1993, 2384, 2730, 2964, 3292, 3491, 3936, 4303, 4654, 4749, 5761, 6190, 6360, 6561, 7106, 7521, 8046, 8687, 8946, 9684, 9943]","[0, 170, 260, 385, 540, 692, 999, 1172, 1480, 1726, 2096, 2457, 2547, 3007, 3101, 3365, 3590, 3849, 4077, 4421, 5052, 5193, 5607, 5991, 6331, 6585, 6934, 7382, 7817, 8125]",25190,14501,13885,9943,8125,-10237,-2905,-2551,-894,998,-15589,30,dire
7561841307,80,39,129,45,20,"[0, 169, 412, 682, 998, 1353, 1973, 2311, 2607, 3615, 4171, 4636, 4975, 5626, 6243, 6553, 6931, 7541, 7966, 9158, 10233, 10684, 12134, 12943, 13492, 14232, 15161, 15694, 16106, 16605]","[0, 298, 569, 905, 1180, 1512, 1803, 2428, 2704, 2956, 3159, 3712, 4084, 4526, 4901, 5548, 5812, 6316, 6817, 7897, 9122, 9658, 10372, 10822, 11601, 12651, 13546, 13957, 15041, 16219]","[0, 278, 592, 920, 1096, 1575, 1927, 2423, 2905, 3232, 3659, 3957, 4207, 4485, 4860, 5233, 5434, 5831, 6281, 7160, 8153, 8454, 9139, 9677, 10019, 10220, 10693, 11355, 11900, 12337]","[0, 169, 259, 349, 439, 569, 659, 1107, 1197, 1582, 1904, 2094, 2234, 2383, 2948, 3503, 3761, 3981, 4184, 4641, 5532, 5942, 6663, 6944, 7285, 7418, 8112, 8364, 9046, 9248]","[0, 169, 298, 406, 531, 685, 822, 1168, 1258, 1403, 1732, 1822, 2058, 2273, 2548, 3055, 3150, 3260, 3463, 3926, 4988, 5083, 5680, 5962, 6163, 6502, 7029, 7199, 7855, 7951]",16605,16219,12337,9248,7951,10,106,137,21,136,"[0, 169, 334, 567, 1039, 1384, 1787, 2108, 2512, 3080, 3654, 4045, 4552, 5142, 5653, 6421, 7242, 7513, 8387, 9171, 9598, 9775, 10464, 11312, 12301, 12946, 13607, 14190, 14969, 15515]","[0, 278, 638, 889, 1305, 1604, 1953, 2170, 2551, 3153, 3380, 3590, 4307, 4985, 5421, 5773, 6422, 7018, 7547, 8142, 8491, 8978, 9463, 10172, 10638, 11177, 11668, 12287, 12993, 13467]","[0, 267, 720, 964, 1335, 1796, 2029, 2664, 3484, 4017, 4239, 4561, 5374, 5689, 5938, 7076, 7487, 8003, 8595, 9399, 9904, 10343, 10727, 10971, 11366, 11926, 12212, 12388, 13040, 13315]","[0, 501, 638, 778, 1193, 1323, 1511, 1822, 2032, 2465, 2854, 2979, 3355, 3647, 3954, 4301, 4792, 4887, 5279, 5605, 5849, 6270, 6684, 6864, 7003, 7170, 7264, 7635, 7973, 8246]","[0, 233, 429, 749, 872, 1002, 1092, 1354, 1513, 1859, 2326, 2416, 2797, 3343, 3564, 3912, 4414, 4509, 4604, 4761, 5021, 5116, 5418, 5512, 5607, 5774, 5868, 6044, 6526, 7193]",15515,13467,13315,8246,7193,1090,2752,-978,1002,758,4624,30,dire
7561842010,120,21,28,79,85,"[60, 379, 807, 1057, 1473, 1841, 2180, 2440, 2723, 3181, 3713, 4317, 4569, 4757, 5268, 5998, 7184, 7764, 8290, 8798, 9581, 10426, 11091, 11596, 12733, 13533, 14750, 15562, 16427, 17356]","[60, 394, 623, 1157, 1499, 1828, 2223, 2559, 2958, 3564, 4177, 4722, 4972, 5140, 5516, 6619, 7678, 8120, 8413, 8829, 9576, 10084, 10487, 10991, 11238, 12018, 12933, 13512, 14158, 15168]","[60, 384, 674, 958, 1382, 2111, 2729, 3135, 3575, 4119, 4812, 5318, 5510, 5876, 6573, 7479, 8328, 8822, 9523, 9928, 10306, 11131, 11514, 12235, 12330, 13677, 14291, 14490, 14857, 15670]","[328, 537, 627, 717, 967, 1160, 1315, 1453, 1659, 1913, 2479, 2623, 2915, 3513, 4070, 4477, 5129, 5585, 5961, 6695, 7501, 7911, 8090, 8189, 8596, 8861, 9480, 9815, 10046, 10333]","[60, 269, 406, 680, 987, 1117, 1254, 1426, 1572, 1796, 2379, 2523, 2743, 2933, 3516, 3961, 4357, 5231, 5471, 5777, 6206, 6549, 6716, 6967, 7720, 8007, 8315, 8455, 8757, 9177]",17356,15168,15670,10333,9177,12,39,96,27,112,"[0, 168, 452, 822, 1216, 1486, 1670, 1880, 2090, 2413, 2886, 3257, 4525, 4934, 5531, 6097, 7097, 7516, 7745, 8820, 9336, 10039, 10768, 11539, 12310, 12911, 13934, 14378, 15374, 16098]","[0, 202, 436, 724, 1042, 1458, 1791, 2149, 2797, 3058, 3628, 4537, 4999, 5655, 6132, 6470, 7023, 7902, 8471, 9003, 9293, 9669, 10378, 10823, 11347, 11647, 12492, 12820, 13554, 14307]","[0, 205, 452, 724, 1222, 1431, 1782, 2327, 2818, 3368, 3692, 4036, 4742, 5118, 5849, 6046, 6858, 7161, 7355, 7808, 8080, 8280, 8900, 9224, 9776, 10071, 10272, 10808, 11221, 11595]","[0, 129, 219, 362, 709, 848, 982, 1072, 1492, 1701, 2121, 2477, 3049, 3921, 4127, 4306, 5357, 5795, 6140, 6297, 6392, 6681, 7276, 7677, 8156, 8380, 8588, 9017, 9549, 10149]","[0, 129, 219, 309, 490, 580, 1002, 1186, 1370, 1579, 1849, 2141, 2570, 2725, 2986, 3080, 3643, 4138, 4406, 4866, 5310, 5534, 6334, 6627, 6866, 7285, 7380, 7835, 8437, 9040]",16098,14307,11595,10149,9040,1258,861,4075,184,137,6515,30,dire
7562239303,21,69,43,20,26,"[0, 255, 646, 970, 1461, 1783, 2327, 2603, 3330, 3695, 4253, 4825, 5624, 6212, 6410, 7108, 7936, 8346, 9495, 10574, 11255, 11999, 12896, 13933, 14636, 15506, 16419, 17960, 18709, 19731]","[0, 243, 528, 687, 1242, 1556, 2045, 2396, 2700, 3184, 3789, 4142, 4677, 5521, 5909, 6436, 7103, 7794, 8289, 8930, 9610, 10362, 11094, 11774, 12473, 13332, 14150, 14570, 15690, 16208]","[0, 279, 556, 968, 1272, 1640, 2061, 2479, 3031, 3398, 4161, 5015, 5420, 6156, 6523, 6913, 7518, 8472, 9296, 10062, 10862, 11391, 12080, 12829, 13564, 14465, 15076, 15686, 16290, 16902]","[0, 170, 260, 475, 647, 1031, 1166, 1514, 1744, 1834, 2059, 2359, 2449, 2712, 2807, 3025, 3329, 3462, 3991, 4197, 4485, 4720, 4950, 5360, 5618, 5912, 6166, 6403, 6886, 7072]","[0, 170, 363, 524, 661, 859, 994, 1165, 1300, 1436, 1739, 1967, 2248, 2396, 2491, 2586, 2856, 2976, 3309, 3657, 3896, 4109, 4392, 4559, 4837, 5114, 5494, 6062, 6320, 6874]",19731,16208,16902,7072,6874,18,98,23,53,121,"[0, 568, 934, 1374, 1713, 2357, 2683, 3192, 3724, 4373, 4828, 5904, 6358, 6902, 7852, 8594, 9418, 10236, 10795, 11869, 12405, 13091, 14420, 15136, 15978, 16638, 17535, 18124, 19536, 20395]","[0, 195, 355, 756, 923, 1136, 1613, 2008, 2224, 2669, 3133, 3665, 3920, 4440, 5074, 5378, 5808, 6424, 6639, 7137, 7499, 8011, 8760, 9610, 10433, 11021, 11586, 11756, 12306, 12748]","[0, 346, 618, 782, 1117, 1319, 1914, 2049, 2287, 2737, 3008, 3276, 3755, 4345, 4883, 5556, 6063, 6287, 6723, 7233, 7599, 7930, 8775, 9378, 9495, 9590, 10175, 10478, 10763, 10944]","[0, 263, 353, 708, 798, 1093, 1264, 1399, 1535, 1625, 1932, 2218, 2586, 2834, 3289, 3482, 3897, 4145, 4360, 4721, 5135, 5473, 5895, 6297, 6966, 7313, 7733, 8396, 8591, 9267]","[0, 263, 371, 581, 716, 1055, 1226, 1377, 1518, 1608, 1758, 2235, 2494, 2853, 3256, 3558, 3715, 4064, 4279, 4545, 4677, 4772, 5279, 5482, 5576, 5671, 5936, 6145, 6552, 6862]",20395,12748,10944,9267,6862,-664,3460,5958,-2195,12,6571,30,radiant
7562523900,48,19,14,21,20,"[0, 281, 525, 913, 1224, 1481, 1738, 2068, 2473, 2840, 3233, 3637, 4140, 4681, 5417, 5952, 6589, 7347, 7915, 8748, 9717, 10514, 11802, 12634, 13377, 15382, 16496, 18303, 19619, 22319]","[0, 290, 574, 792, 1259, 1832, 2163, 2591, 3106, 3569, 4154, 4667, 5189, 5307, 5860, 6519, 6975, 8173, 8957, 9844, 10085, 11272, 11961, 12920, 13388, 14364, 15325, 17046, 17576, 18686]","[0, 170, 386, 550, 973, 1371, 1813, 2277, 2578, 2872, 3255, 3555, 4001, 4424, 5081, 5748, 6202, 6731, 7198, 7426, 7936, 8773, 9412, 9871, 10230, 10965, 12166, 12492, 12779, 13533]","[0, 213, 377, 519, 729, 953, 1125, 1306, 1562, 1652, 1939, 2284, 2422, 2724, 3893, 4186, 4416, 4786, 4937, 5572, 5832, 6455, 7327, 7529, 8018, 9025, 9666, 9992, 10352, 11359]","[0, 170, 260, 618, 788, 970, 1124, 1259, 1535, 1625, 1774, 1903, 2077, 2255, 2771, 3253, 3746, 4172, 4267, 4498, 4825, 5321, 5782, 5877, 6119, 6917, 7166, 7861, 8084, 9091]",22319,18686,13533,11359,9091,109,74,61,86,100,"[0, 586, 781, 1011, 1860, 2213, 2593, 2882, 3337, 3954, 4751, 5266, 5979, 6698, 6991, 7513, 8636, 9418, 10463, 11126, 11693, 12614, 13759, 14485, 15569, 16544, 17368, 17675, 18577, 19470]","[0, 325, 659, 1081, 1668, 2042, 2497, 2917, 3651, 3905, 4272, 5017, 5653, 6425, 6856, 7128, 8427, 8606, 9183, 10249, 10909, 11570, 11955, 12978, 13667, 14406, 15304, 15638, 16504, 17440]","[0, 209, 548, 767, 1367, 1790, 2214, 2697, 3126, 4109, 4621, 5448, 6001, 6708, 7072, 7527, 8546, 9351, 10166, 11059, 12042, 12974, 14192, 14987, 15911, 16469, 16564, 16763, 17030, 17417]","[0, 245, 360, 450, 674, 809, 899, 989, 1263, 1462, 1773, 1973, 2188, 2624, 3114, 3283, 3823, 3917, 4684, 5222, 5549, 5768, 6180, 6293, 6593, 7153, 7447, 7581, 7785, 8216]","[0, 170, 260, 395, 932, 1071, 1161, 1335, 1425, 1691, 2177, 2518, 2777, 3032, 3127, 3430, 3908, 4163, 4507, 4700, 4795, 4961, 5586, 5681, 6080, 6336, 6630, 6725, 6821, 7208]",19470,17440,17417,8216,7208,2849,1246,-3884,3143,1883,5237,30,radiant
7562563601,89,13,97,66,119,"[646, 906, 1263, 1557, 2178, 2660, 3090, 3565, 4345, 5043, 5743, 6583, 7075, 7483, 8027, 9018, 9499, 10854, 11970, 13185, 14349, 15755, 16874, 17941, 18887, 20106, 21231, 21495, 22906, 24652]","[489, 613, 703, 924, 1305, 2198, 2619, 2709, 3173, 3434, 3923, 4310, 4881, 5474, 6212, 6781, 7266, 8031, 8537, 8832, 9867, 10538, 11380, 12257, 13188, 13708, 14768, 15416, 15711, 17078]","[505, 943, 1566, 1811, 2217, 2679, 3257, 3347, 3764, 4046, 4721, 5383, 5940, 6245, 7076, 7932, 8539, 9725, 10451, 11322, 12104, 12738, 13553, 14152, 14246, 14736, 15128, 16081, 16892, 17657]","[285, 524, 633, 882, 1256, 1902, 2170, 2312, 2638, 2969, 3144, 3656, 3932, 4145, 4512, 4931, 5139, 5580, 5852, 6334, 6861, 7246, 7501, 8087, 8592, 9177, 9569, 9897, 10137, 10527]","[260, 350, 607, 697, 952, 1253, 1445, 1535, 1900, 1990, 2433, 2618, 2713, 2834, 3106, 3312, 3549, 4072, 4167, 4372, 4727, 4922, 5017, 5184, 5364, 5714, 6106, 6415, 6710, 7100]",24652,17078,17657,10527,7100,113,14,112,123,136,"[946, 1400, 1737, 1947, 2461, 3101, 3315, 4182, 5125, 5640, 6297, 6991, 7269, 8161, 8874, 9399, 9896, 10760, 11735, 12341, 13158, 13568, 14473, 15421, 16359, 16968, 17738, 19492, 19957, 20937]","[946, 1420, 1692, 2305, 2792, 3244, 3555, 4387, 5058, 5569, 5988, 7212, 7678, 8417, 8943, 9700, 10344, 11012, 11774, 12386, 12979, 13365, 14071, 14756, 15493, 16024, 16195, 16689, 17135, 17804]","[483, 653, 1007, 1431, 1538, 2003, 2441, 2788, 3159, 3547, 3776, 4264, 4545, 5346, 5780, 6306, 6580, 6824, 7257, 8115, 8480, 9096, 9847, 10209, 10556, 10912, 11719, 12495, 12877, 13268]","[519, 697, 916, 1163, 1298, 1456, 1587, 2159, 2415, 2559, 2777, 3402, 3721, 4047, 4274, 4478, 4616, 4828, 5049, 5409, 5691, 5858, 6024, 6518, 6962, 7430, 7526, 7622, 7844, 7989]","[415, 553, 911, 1001, 1091, 1249, 1367, 1657, 2094, 2238, 2592, 2831, 3304, 3533, 3760, 3961, 4058, 4392, 4666, 5202, 5431, 6045, 6246, 6503, 6947, 7256, 7451, 7759, 8181, 8329]",20937,17804,13268,7989,8329,3715,-726,4389,2538,-1229,8687,30,radiant
7562655919,106,82,43,114,90,"[0, 294, 733, 1215, 1713, 1970, 2391, 2833, 3400, 3922, 4436, 5039, 5867, 6723, 7261, 8695, 9377, 10351, 10615, 11159, 11891, 12730, 13319, 14165, 14965, 16045, 16590, 18515, 18611, 20126]","[0, 283, 568, 932, 1297, 1423, 1768, 1936, 2133, 2361, 2847, 3194, 3535, 4181, 4697, 5170, 5612, 6474, 7270, 7474, 7953, 8753, 9150, 9550, 10252, 10872, 11248, 12242, 14237, 15920]","[0, 175, 375, 715, 1084, 1555, 2136, 2421, 2903, 3403, 4120, 4512, 4816, 5173, 5405, 6058, 6465, 6931, 7315, 7814, 8371, 8541, 9891, 10297, 10756, 11050, 11437, 12859, 13731, 14323]","[0, 172, 695, 820, 1001, 1182, 1461, 1648, 1859, 2125, 2539, 3013, 3425, 3757, 3993, 4444, 5040, 5807, 6350, 6748, 6882, 7574, 7811, 8463, 8668, 8763, 9274, 10054, 10194, 10908]","[0, 216, 383, 553, 726, 903, 1085, 1221, 1546, 1636, 2348, 2639, 3077, 3262, 3535, 4266, 4487, 5459, 5873, 5973, 6612, 6892, 7250, 7886, 8194, 8563, 9136, 9445, 9958, 10240]",20126,15920,14323,10908,10240,4,60,25,86,37,"[0, 237, 671, 952, 1322, 1534, 1821, 2025, 2252, 2616, 3203, 3579, 4097, 4621, 4984, 5388, 6317, 7009, 7829, 9353, 9883, 11072, 12281, 13338, 14149, 15405, 16629, 16801, 17350, 18077]","[0, 241, 488, 953, 1154, 1603, 1764, 2693, 3183, 3795, 4407, 5137, 5367, 6143, 6875, 7077, 7685, 8380, 8855, 10371, 10772, 11340, 11506, 12250, 13192, 13958, 14763, 15936, 16678, 16774]","[0, 365, 844, 1146, 1599, 2115, 2776, 3179, 3720, 4268, 4883, 5505, 6033, 6491, 7094, 7583, 7947, 8128, 9372, 10275, 10946, 11807, 12797, 12964, 13520, 14396, 15322, 15918, 16266, 17190]","[0, 169, 259, 617, 747, 1008, 1145, 1527, 1699, 2124, 2632, 2949, 3347, 3768, 4348, 4915, 5671, 5894, 6670, 7396, 7938, 9432, 9883, 10050, 10677, 11324, 11811, 11906, 12544, 13023]","[0, 169, 418, 572, 702, 945, 1084, 1432, 1691, 2044, 2269, 3146, 3465, 3614, 3888, 3982, 4214, 4572, 5063, 5633, 5777, 6350, 6777, 6993, 7088, 7834, 8273, 8901, 9414, 9510]",18077,16774,17190,13023,9510,2049,-854,-2867,-2115,730,-3057,30,radiant
7563208314,39,21,49,19,20,"[0, 280, 480, 730, 1130, 1405, 1604, 2021, 2797, 3084, 3511, 3929, 4509, 4986, 5411, 5999, 6730, 7473, 8121, 9286, 9789, 10745, 11668, 12618, 13989, 15228, 16144, 17200, 18490, 19840]","[0, 208, 409, 788, 1143, 1395, 2298, 2766, 3189, 3679, 4083, 4566, 5076, 5624, 6431, 6952, 7643, 8140, 9136, 11411, 12188, 13026, 13579, 14039, 15327, 16264, 16544, 17570, 18047, 18567]","[0, 242, 527, 818, 1020, 1595, 1842, 2458, 2680, 3100, 3609, 4106, 4556, 5156, 6223, 6655, 6994, 7597, 7852, 8786, 9270, 9534, 10180, 10852, 11564, 12026, 12776, 13133, 13898, 15005]","[0, 221, 311, 665, 785, 910, 1000, 1135, 1338, 1563, 1923, 2256, 2436, 2630, 2725, 3051, 3341, 3507, 3660, 4109, 4680, 5025, 5422, 5516, 5920, 6212, 6344, 6763, 7387, 8452]","[0, 170, 260, 575, 754, 879, 1065, 1264, 1369, 1459, 1682, 1865, 2089, 2432, 3134, 3499, 3756, 3851, 3946, 4484, 5044, 5350, 5599, 5693, 6269, 6625, 6758, 6962, 7330, 8366]",19840,18567,15005,8452,8366,48,43,129,105,119,"[0, 170, 455, 853, 1232, 1466, 1696, 1964, 2235, 2841, 3431, 3839, 4586, 5451, 6251, 7157, 8044, 8671, 9640, 10274, 10912, 11879, 12820, 13365, 13564, 14518, 14740, 15597, 16311, 16485]","[0, 696, 954, 1341, 1620, 1877, 2367, 2694, 3012, 3633, 3944, 4287, 4700, 5535, 5924, 6527, 7076, 8052, 9027, 9561, 10173, 10792, 11404, 11757, 12188, 12901, 13051, 13307, 13437, 13697]","[0, 232, 562, 795, 1127, 1433, 1658, 1837, 2169, 2577, 3323, 3570, 4264, 4843, 5434, 5928, 6369, 7169, 7615, 7783, 8027, 8372, 9244, 9410, 9505, 9875, 9970, 10187, 10283, 10379]","[0, 232, 322, 456, 586, 716, 1025, 1206, 1315, 1685, 2016, 2106, 2349, 2646, 3022, 3311, 3842, 4044, 4654, 4939, 5183, 5338, 5552, 6212, 6382, 7005, 7245, 7645, 7816, 7987]","[0, 232, 521, 611, 886, 1225, 1315, 1450, 1625, 1805, 2060, 2238, 2645, 3328, 3680, 3969, 4252, 4428, 4874, 5122, 5443, 5640, 5883, 6033, 6128, 6295, 6390, 6607, 6739, 7261]",16485,13697,10379,7987,7261,3355,4870,4626,465,1105,14421,30,radiant
7563295705,73,49,106,123,121,"[0, 354, 960, 1395, 1672, 1967, 2290, 2502, 2795, 3182, 3702, 4449, 5158, 5793, 6991, 8217, 9146, 9979, 10291, 11260, 12283, 13139, 14303, 15612, 16417, 17397, 18346, 18835, 19543, 20385]","[0, 199, 631, 911, 1146, 1505, 2028, 2253, 2964, 3424, 4191, 4837, 5196, 5694, 6585, 7220, 8109, 9019, 9793, 9991, 10948, 11981, 12913, 13808, 14485, 15135, 16112, 16739, 17199, 17548]","[0, 175, 457, 749, 996, 1208, 1435, 1690, 1993, 2287, 2790, 3323, 3462, 3973, 4744, 5194, 5860, 6238, 6818, 7291, 7972, 8742, 9938, 10685, 11162, 11646, 11931, 12891, 13070, 13732]","[0, 129, 553, 744, 834, 924, 1187, 1312, 1576, 1762, 1942, 2345, 2530, 2658, 3199, 3627, 4131, 4602, 4842, 5147, 5357, 5805, 6806, 7241, 7792, 8234, 8771, 9050, 9221, 9573]","[0, 247, 481, 633, 801, 1013, 1103, 1193, 1455, 1860, 2040, 2295, 2545, 2774, 3170, 3438, 3728, 4038, 4342, 4866, 4961, 5287, 5921, 6186, 6391, 6558, 6787, 7076, 7172, 7268]",20385,17548,13732,9573,7268,98,33,25,100,51,"[0, 336, 781, 1155, 1687, 2303, 2850, 3523, 4197, 4379, 4854, 5314, 5729, 6555, 6931, 7659, 8119, 8426, 9426, 10664, 11229, 11677, 11772, 12520, 13130, 14142, 15192, 15878, 16503, 16876]","[0, 243, 493, 809, 1175, 1705, 2009, 2602, 3582, 4283, 4939, 5729, 6084, 6591, 7148, 7508, 8269, 8719, 9275, 10166, 10685, 11125, 11708, 12148, 12403, 12887, 13340, 13832, 14355, 14522]","[0, 295, 633, 797, 1170, 1358, 1483, 1950, 2379, 2659, 3079, 3490, 4180, 4660, 5213, 5869, 6774, 7281, 7945, 9030, 9628, 9872, 9977, 10206, 10486, 11191, 11762, 12441, 13132, 13806]","[0, 209, 334, 424, 554, 779, 958, 1164, 1471, 1719, 1899, 2133, 2304, 2584, 2754, 3118, 3629, 3804, 4020, 4568, 4895, 5065, 5327, 5631, 5801, 6161, 6486, 7016, 7761, 8247]","[0, 209, 299, 389, 519, 731, 821, 1405, 1680, 1804, 1984, 2248, 2389, 2659, 2819, 2999, 3157, 3418, 3810, 4167, 4262, 4383, 4478, 4735, 4830, 5304, 5526, 6061, 6348, 6444]",16876,14522,13806,8247,6444,3509,3026,-74,1326,824,8611,30,radiant
7563784607,76,48,71,14,45,"[0, 242, 717, 1084, 1532, 1818, 2360, 2766, 3158, 3898, 4343, 5372, 5855, 6990, 7540, 7763, 8401, 9012, 9632, 10358, 10606, 12036, 12628, 13265, 13433, 14578, 15142, 16509, 17909, 19736]","[0, 293, 606, 968, 1129, 1690, 1780, 2023, 2534, 2962, 3321, 3872, 4312, 5113, 5750, 6443, 7549, 8587, 9224, 10275, 10732, 11258, 12427, 12787, 12882, 13948, 14816, 14911, 15256, 16836]","[0, 170, 290, 426, 600, 818, 908, 1065, 1305, 1469, 1643, 2173, 2347, 2786, 3102, 3572, 4283, 4663, 4917, 5123, 6061, 6906, 7478, 7866, 8379, 8636, 9315, 10224, 10874, 11280]","[0, 170, 401, 612, 1058, 1332, 1813, 1999, 2320, 2644, 2993, 3285, 3522, 4000, 4365, 4995, 5537, 6346, 6638, 7571, 8178, 8673, 9458, 9723, 9867, 10275, 10522, 11034, 11736, 12698]","[0, 170, 374, 464, 764, 1352, 1538, 1991, 2423, 2719, 3077, 4007, 4097, 4402, 4747, 5228, 5745, 6123, 6351, 6958, 7324, 7791, 8151, 8415, 8510, 8803, 9121, 9665, 10238, 10506]",19736,16836,11280,12698,10506,25,39,49,64,121,"[0, 256, 820, 1070, 1650, 2171, 2535, 3340, 3928, 4573, 5153, 5709, 6252, 7053, 7755, 8388, 8988, 10258, 10890, 11299, 12714, 13184, 13534, 15768, 16860, 17906, 18673, 19490, 20221, 21261]","[0, 280, 568, 884, 1093, 1409, 1736, 2176, 2469, 2785, 3140, 3320, 4202, 4628, 5062, 5410, 6020, 6970, 7414, 7776, 9253, 9471, 9850, 11036, 11791, 12249, 12684, 13943, 14424, 15830]","[0, 244, 566, 887, 1381, 1926, 2384, 2854, 3431, 3954, 4462, 4933, 5844, 6467, 7477, 7719, 7814, 7999, 8470, 8928, 9717, 10040, 10295, 10700, 10977, 11456, 11731, 12265, 12361, 13015]","[0, 170, 260, 350, 534, 713, 852, 1113, 1287, 1425, 1625, 1984, 2509, 2914, 3742, 4041, 4224, 4887, 5266, 5709, 6501, 6750, 7324, 8407, 9105, 9584, 10235, 10545, 10767, 11373]","[0, 170, 501, 591, 851, 1134, 1389, 1666, 1852, 1942, 2121, 2338, 2632, 2893, 3335, 3657, 3752, 3981, 4389, 4547, 5093, 5683, 5816, 6710, 7079, 8175, 8631, 9170, 9266, 10511]",21261,15830,13015,11373,10511,-1525,1006,-1735,1325,-5,-934,30,dire
7563837503,78,10,106,105,51,"[0, 170, 575, 921, 1120, 1565, 1990, 2534, 3020, 3514, 3982, 4786, 5362, 5925, 6392, 7279, 7497, 8575, 9609, 10650, 11775, 12509, 13509, 14725, 15662, 16304, 17379, 18552, 19357, 20782]","[0, 170, 373, 576, 942, 1187, 1593, 2092, 2354, 2644, 3174, 3675, 4456, 4975, 5564, 6393, 6945, 8173, 8932, 9713, 10702, 11886, 13030, 13631, 14178, 14625, 15537, 16227, 17055, 17870]","[0, 329, 609, 1057, 1432, 1760, 2072, 2562, 3009, 3733, 4159, 4721, 5385, 5702, 6130, 7030, 7246, 8105, 9175, 9910, 10632, 11101, 12093, 12599, 13157, 13890, 14884, 16075, 16535, 17269]","[0, 170, 260, 386, 476, 566, 700, 934, 1071, 1161, 1399, 1673, 2035, 2183, 2519, 2789, 3181, 4038, 4928, 5179, 5363, 5756, 6319, 6661, 6931, 7192, 7417, 8128, 8563, 9907]","[0, 221, 311, 401, 591, 727, 867, 1099, 1189, 1423, 2016, 2262, 2544, 3050, 3206, 3391, 3903, 4239, 4727, 5175, 5885, 6270, 6727, 7001, 7145, 7543, 8060, 8652, 8905, 9592]",20782,17870,17269,9907,9592,1,120,129,86,26,"[0, 207, 507, 851, 1485, 1679, 1880, 2253, 2387, 2809, 3007, 3285, 3595, 4395, 4967, 5457, 5896, 6580, 7505, 8158, 8985, 9993, 10740, 11919, 12013, 12814, 13430, 14432, 14834, 16262]","[0, 282, 518, 897, 1307, 1790, 2188, 2392, 2866, 3117, 3651, 4049, 5043, 5602, 6293, 7204, 8031, 8494, 9201, 9649, 10540, 11126, 11951, 12402, 13469, 13879, 14874, 15884, 16230, 16938]","[0, 324, 599, 918, 1443, 1870, 2254, 2561, 2889, 3306, 3617, 3965, 4407, 5004, 5622, 6113, 6581, 7281, 7876, 8353, 8891, 8986, 9937, 10388, 11015, 11438, 11677, 12031, 13055, 13848]","[0, 220, 384, 480, 627, 830, 920, 1113, 1546, 1664, 1894, 2104, 2336, 2518, 2710, 3066, 3489, 3953, 4336, 4607, 5024, 5284, 5652, 5822, 6507, 6855, 7169, 7339, 7585, 8114]","[0, 170, 285, 419, 590, 945, 1083, 1218, 1308, 1457, 1636, 1726, 2563, 2657, 2854, 3385, 3645, 3944, 4140, 4359, 4803, 4898, 5191, 5642, 6003, 6284, 6523, 6941, 7125, 7687]",16262,16938,13848,8114,7687,4520,932,3421,1793,1905,12571,30,radiant
7564044018,48,104,138,74,136,"[0, 282, 557, 843, 1390, 1768, 2273, 2723, 3487, 3763, 4266, 5069, 5745, 6452, 7386, 8370, 9360, 9942, 10753, 12427, 13602, 13931, 15091, 16282, 16885, 18084, 19192, 20052, 21998, 22204]","[0, 247, 524, 921, 1309, 1774, 2203, 2512, 3244, 3858, 4373, 5399, 6034, 6360, 7069, 8012, 8658, 8753, 8936, 10223, 10715, 10987, 11289, 12042, 12342, 13027, 13320, 13618, 14448, 15489]","[0, 209, 514, 621, 866, 1004, 1193, 1351, 1531, 1690, 2016, 2373, 2598, 3065, 3598, 4055, 4461, 4654, 4938, 5430, 5797, 6386, 6759, 6926, 7923, 8847, 9410, 9788, 10581, 11741]","[0, 322, 484, 863, 1113, 1455, 1703, 2203, 2652, 2868, 3101, 3681, 3983, 4558, 5086, 5382, 5862, 5957, 6140, 6665, 7083, 7544, 7959, 8400, 8694, 9120, 9214, 9649, 10274, 10899]","[0, 209, 299, 421, 624, 748, 991, 1081, 1434, 1593, 1849, 2049, 2229, 2506, 2810, 3180, 3453, 3548, 4127, 5059, 5264, 5511, 5760, 5927, 6146, 6540, 6894, 6989, 7292, 7796]",22204,15489,11741,10899,7796,106,69,93,26,40,"[0, 286, 646, 999, 1443, 1895, 2327, 2864, 3246, 3457, 4412, 4575, 5263, 5616, 5890, 6575, 7112, 8253, 8866, 9238, 9523, 10467, 11230, 11831, 12614, 13607, 14767, 15229, 16575, 16671]","[0, 202, 641, 913, 1386, 1633, 2012, 2364, 2828, 3352, 3969, 4249, 4922, 5354, 5684, 6106, 6826, 7647, 7956, 8115, 8837, 9471, 10358, 10523, 11764, 12231, 12584, 12801, 13464, 13823]","[0, 513, 710, 836, 1090, 1388, 1770, 2103, 2457, 2645, 3121, 3487, 3908, 4466, 5125, 5665, 6005, 6804, 7212, 7930, 8265, 8875, 9964, 10354, 10996, 11243, 11762, 12488, 13281, 13377]","[0, 129, 293, 656, 845, 935, 1340, 1475, 1676, 1813, 2734, 2824, 3013, 3198, 3475, 3705, 4044, 4452, 4604, 5167, 5440, 5607, 5863, 6055, 6639, 6734, 7235, 7330, 7917, 8013]","[0, 210, 300, 390, 480, 570, 670, 805, 1006, 1289, 1497, 1809, 1953, 2138, 2333, 2468, 2810, 3256, 3705, 4137, 4232, 4681, 4937, 5251, 5821, 6359, 6571, 6666, 7169, 7265]",16671,13823,13377,8013,7265,5533,1666,-1636,2886,531,8980,30,radiant
7564643705,120,93,28,123,20,"[0, 278, 611, 947, 1310, 1721, 2370, 3268, 3805, 4194, 5377, 5945, 6521, 7550, 8091, 8758, 8997, 9238, 9795, 10189, 10962, 11606, 12766, 13402, 14124, 15079, 15868, 16231, 17102, 18365]","[0, 170, 423, 750, 951, 1123, 1322, 1761, 1928, 2353, 2818, 3259, 3686, 4335, 4852, 5402, 6312, 6893, 7633, 8189, 8940, 9421, 10861, 11225, 11936, 12576, 13451, 13964, 15158, 16057]","[0, 254, 495, 842, 1175, 1380, 1935, 2516, 2671, 3191, 3775, 4326, 5128, 5843, 6095, 6600, 6942, 7354, 7666, 7965, 8807, 9055, 9630, 10014, 10828, 11567, 12155, 12513, 13063, 13363]","[0, 170, 305, 440, 530, 620, 1167, 1918, 2230, 2647, 3060, 3397, 3577, 4396, 4845, 5370, 5528, 5716, 5910, 6147, 6674, 6843, 7198, 7401, 7756, 7922, 8289, 8691, 9254, 9623]","[0, 170, 260, 404, 576, 691, 864, 1338, 1635, 1770, 2094, 2300, 2495, 3015, 3295, 3778, 4096, 4328, 4486, 4837, 5329, 5451, 5690, 5810, 5905, 6096, 6191, 6620, 7101, 7510]",18365,16057,13363,9623,7510,10,17,96,100,86,"[0, 204, 477, 796, 960, 1339, 1593, 1997, 2376, 2601, 3037, 3551, 4014, 4446, 5085, 5583, 6524, 7147, 7832, 8653, 9683, 10127, 10971, 11300, 11920, 12666, 13365, 13740, 14333, 15163]","[0, 365, 742, 1025, 1307, 1724, 2265, 2743, 3236, 3494, 4131, 4825, 4997, 5355, 5918, 6050, 7021, 7478, 8340, 8892, 9381, 9571, 10385, 10755, 11032, 11286, 11996, 12265, 13188, 13394]","[0, 206, 444, 601, 887, 1296, 1824, 2194, 2831, 3216, 3351, 3867, 4488, 5186, 6322, 6580, 7223, 8020, 8468, 9002, 9584, 10197, 10292, 10387, 10984, 11741, 12113, 12208, 12610, 12977]","[0, 170, 260, 396, 531, 661, 1230, 1320, 1533, 1803, 2022, 2271, 2440, 2625, 3237, 3589, 4145, 4558, 4929, 5150, 5380, 5710, 5880, 6050, 6426, 6858, 7066, 7236, 7525, 7696]","[0, 170, 307, 466, 637, 767, 970, 1060, 1249, 1374, 1668, 2070, 2205, 2390, 2834, 3059, 3377, 3625, 4300, 4613, 4843, 5044, 5422, 5517, 5612, 5778, 5951, 6046, 6260, 6356]",15163,13394,12977,7696,6356,3202,2663,386,1927,1154,9332,30,radiant
7565176702,53,120,40,97,30,"[0, 580, 707, 1055, 1307, 1731, 1840, 2047, 2930, 3236, 4256, 4513, 5191, 5796, 6473, 7012, 8083, 9408, 10376, 10902, 11338, 12191, 12336, 12784, 13683, 14421, 15312, 15882, 17811, 18683]","[0, 346, 616, 867, 1125, 1493, 1687, 2625, 2879, 3231, 3700, 3790, 4192, 4716, 5235, 5612, 5897, 6664, 7600, 8236, 8689, 9127, 9743, 10064, 10876, 11396, 11776, 11871, 12861, 13476]","[0, 192, 492, 661, 924, 1435, 1666, 1801, 2228, 2415, 2706, 2796, 3126, 3429, 3907, 4390, 5219, 5973, 6650, 7262, 7772, 7962, 8494, 8723, 9307, 9782, 10805, 10900, 11635, 12392]","[0, 192, 331, 459, 753, 1097, 1561, 1977, 2155, 2436, 2862, 3036, 3409, 3794, 4181, 4441, 4713, 5179, 5715, 6410, 6658, 7134, 7414, 7509, 8359, 8630, 9074, 9758, 10668, 11626]","[0, 292, 434, 568, 816, 1353, 1566, 1701, 1963, 2232, 2585, 2675, 2765, 2914, 3387, 4116, 4345, 4672, 5220, 5619, 5714, 5893, 5987, 6082, 6965, 7204, 7465, 7765, 8814, 9126]",18683,13476,12392,11626,9126,98,41,69,123,79,"[0, 368, 680, 1004, 1364, 1785, 2200, 2445, 3261, 3490, 4335, 5365, 5597, 6525, 7095, 7881, 8911, 9006, 9530, 10427, 10997, 11442, 12769, 12936, 13218, 13976, 14810, 15589, 16051, 16228]","[0, 247, 495, 700, 996, 1533, 1817, 2322, 2630, 3292, 3747, 4510, 4872, 5169, 5581, 6527, 6983, 7234, 7610, 8233, 9085, 9853, 10266, 10433, 10633, 11113, 11878, 12906, 13803, 14462]","[0, 210, 492, 686, 971, 1147, 1556, 2019, 2163, 2786, 3212, 3606, 3877, 4348, 4607, 5437, 6052, 6620, 7950, 8404, 8813, 9306, 10452, 10720, 10975, 11615, 12310, 12704, 12848, 13200]","[0, 210, 300, 425, 563, 728, 938, 1131, 1221, 1472, 1699, 2201, 2345, 2549, 2730, 3268, 3499, 3895, 4214, 4621, 4956, 5384, 6359, 6948, 7425, 7804, 8229, 8650, 8766, 8943]","[0, 210, 300, 390, 480, 659, 749, 839, 1145, 1539, 1674, 2017, 2213, 2483, 2835, 3457, 3650, 3745, 4310, 4551, 4653, 4913, 5570, 6030, 6200, 6370, 6539, 6848, 7066, 7356]",16228,14462,13200,8943,7356,2455,-986,-808,2683,1770,5114,30,radiant
7565351207,25,13,135,136,20,"[0, 253, 399, 771, 1373, 1751, 2535, 2888, 3215, 4063, 4731, 5127, 5770, 6474, 7245, 8197, 9089, 9976, 10593, 11829, 12691, 13197, 14251, 15315, 15410, 16061, 17135, 17846, 18213, 18773]","[0, 328, 698, 940, 1217, 1554, 1875, 2564, 3034, 3758, 4227, 4335, 5025, 5872, 6351, 7075, 7753, 8460, 9051, 10245, 10927, 11440, 12720, 13363, 14142, 14858, 15581, 15676, 16590, 17524]","[0, 290, 595, 851, 1293, 1655, 1890, 2265, 2700, 2945, 3496, 4068, 4365, 5180, 5904, 6543, 6986, 7828, 8259, 9118, 9668, 10346, 10837, 11607, 11702, 12485, 13450, 13852, 14188, 15090]","[0, 170, 260, 752, 996, 1248, 1482, 1798, 1888, 2085, 2464, 2593, 3060, 3379, 3801, 4020, 4150, 4356, 4602, 4993, 5244, 5383, 5704, 5954, 6069, 6383, 6707, 6877, 7048, 7219]","[0, 170, 260, 350, 525, 660, 777, 956, 1117, 1314, 1493, 1583, 1912, 2245, 2600, 2784, 2915, 3088, 3273, 3727, 3976, 4251, 4545, 4749, 4892, 5495, 5822, 5992, 6163, 6571]",18773,17524,15090,7219,6571,41,129,120,58,105,"[0, 207, 499, 709, 913, 1442, 1953, 2490, 2839, 3286, 3892, 4183, 5067, 5638, 6302, 6901, 7756, 8385, 9181, 9949, 10706, 11522, 12139, 12823, 14371, 15216, 15919, 17262, 17819, 19536]","[0, 206, 548, 906, 1355, 1611, 1775, 2598, 3276, 3596, 4128, 4795, 5436, 6189, 6801, 7384, 8047, 8464, 9145, 9769, 10280, 11149, 12017, 12870, 14026, 14961, 16051, 16970, 17548, 18202]","[0, 289, 589, 788, 1243, 1624, 2070, 2518, 2936, 3159, 3735, 4340, 4675, 4871, 5226, 5997, 6869, 7290, 8010, 8230, 8723, 9217, 9621, 10028, 11070, 11568, 12199, 12796, 13441, 14875]","[0, 170, 260, 350, 440, 836, 971, 1515, 1760, 2004, 2350, 2558, 3010, 3223, 3437, 3705, 4200, 4378, 4760, 5048, 5209, 5397, 5715, 6172, 7089, 7610, 7900, 8130, 8639, 10708]","[0, 170, 260, 437, 576, 706, 841, 1278, 1458, 1675, 2294, 2664, 2844, 3170, 3390, 3505, 3981, 4202, 4710, 4930, 5025, 5361, 5699, 5865, 6583, 6750, 7383, 7605, 7892, 8520]",19536,18202,14875,10708,8520,-763,-678,215,-3489,-1949,-6664,30,dire
7565441012,10,14,19,69,53,"[0, 324, 592, 1001, 1319, 1679, 1926, 2497, 2939, 3313, 3875, 4752, 5237, 5809, 6338, 6938, 7574, 8356, 9111, 9666, 10451, 11103, 11393, 11775, 12548, 13618, 14051, 15034, 15130, 15226]","[0, 278, 442, 769, 1110, 1450, 2076, 2394, 3294, 3808, 3980, 5347, 5437, 6384, 6993, 7402, 8392, 9075, 9839, 10066, 10618, 10864, 11666, 12119, 12512, 13130, 13776, 14718, 14916, 15012]","[0, 313, 703, 987, 1495, 1860, 2577, 3033, 3510, 3803, 4280, 4674, 5025, 5591, 6654, 6903, 7826, 8759, 9908, 10312, 10509, 11272, 12159, 12833, 13274, 13584, 14164, 14438, 14534, 14630]","[0, 170, 260, 431, 553, 976, 1270, 1533, 1813, 2120, 2413, 3030, 3252, 3575, 3955, 4283, 4857, 5108, 5203, 5622, 5975, 6404, 7629, 8363, 9013, 9950, 10837, 11213, 11665, 12014]","[0, 170, 307, 397, 531, 670, 1323, 1579, 1974, 2100, 2401, 2865, 3199, 3859, 4193, 4592, 5153, 5356, 5527, 5975, 6297, 7064, 7284, 8317, 8661, 9151, 9322, 9544, 9982, 10368]",15226,15012,14630,12014,10368,8,104,22,50,85,"[0, 250, 619, 709, 929, 1195, 1776, 2001, 2273, 2678, 3370, 3631, 4396, 4772, 5232, 5743, 6344, 7414, 8120, 9082, 10039, 10522, 11691, 12598, 13687, 15337, 15717, 16928, 18317, 19434]","[0, 205, 568, 886, 1349, 1561, 2170, 2588, 3108, 3623, 3940, 4555, 4811, 5351, 5704, 6152, 7047, 7757, 9290, 9857, 10430, 10761, 11734, 12235, 12475, 13573, 14755, 16473, 17438, 18692]","[0, 323, 740, 1069, 1604, 2006, 2334, 3019, 3441, 3626, 4162, 4804, 5472, 5948, 6543, 6937, 7699, 8388, 9489, 10090, 11218, 11643, 11850, 12801, 13776, 14484, 14995, 15527, 16815, 17759]","[0, 170, 260, 514, 999, 1089, 1775, 2031, 2183, 2731, 3094, 3494, 3836, 4229, 4770, 5025, 5453, 5947, 6149, 7034, 8230, 8910, 9232, 9399, 9755, 10336, 10965, 11530, 13088, 13839]","[0, 170, 260, 396, 486, 852, 1186, 1366, 1542, 1764, 2413, 2660, 3005, 3099, 3313, 3671, 3812, 4045, 4431, 4730, 5747, 6184, 6736, 7345, 8037, 8900, 9070, 9602, 10893, 11672]",19434,18692,17759,13839,11672,-4208,-3680,-3129,-1825,-1304,-14146,30,dire
7565603215,113,63,14,72,26,"[0, 282, 621, 901, 1169, 1539, 1937, 2271, 2686, 3149, 3821, 4133, 4439, 4951, 5476, 6020, 6450, 7204, 7672, 8283, 8753, 9183, 9634, 10933, 11643, 12416, 13299, 13609, 14312, 14666]","[0, 245, 561, 970, 1274, 1590, 2017, 2242, 2441, 3141, 3634, 4229, 4669, 5456, 6026, 6711, 7244, 8225, 9300, 9853, 10510, 11617, 12198, 13278, 13923, 14954, 15708, 15802, 16012, 16591]","[0, 290, 604, 855, 1252, 1574, 1852, 1942, 2409, 2977, 3425, 3751, 4296, 4859, 5428, 5732, 6739, 6997, 7182, 7436, 7958, 8160, 8646, 8990, 9194, 9612, 10118, 10212, 10623, 10909]","[0, 261, 351, 489, 856, 1093, 1259, 1408, 1754, 2301, 2679, 2944, 3477, 3835, 3981, 4252, 4496, 4834, 5102, 5356, 5724, 5998, 6541, 6688, 6892, 7223, 7747, 7841, 8150, 8493]","[0, 209, 640, 730, 865, 1073, 1258, 1348, 1874, 2132, 2488, 2624, 2804, 3007, 3187, 3372, 3715, 4037, 4284, 4538, 4809, 5044, 5139, 5278, 5372, 5556, 5804, 5898, 6312, 6485]",14666,16591,10909,8493,6485,21,98,49,105,58,"[0, 237, 484, 890, 1220, 1800, 2285, 2791, 2881, 3595, 4095, 4508, 5201, 5924, 6590, 7101, 7821, 8501, 9193, 10459, 11017, 11112, 11773, 12459, 13058, 13646, 14682, 15970, 17024, 17848]","[0, 287, 499, 907, 1285, 1704, 2435, 3219, 3637, 4355, 4445, 4719, 5613, 6152, 6568, 7219, 7901, 8381, 8959, 9483, 10139, 10437, 11304, 12323, 12821, 13575, 14493, 15341, 16114, 16586]","[0, 248, 558, 769, 1346, 1707, 2240, 2426, 2913, 3369, 3774, 4053, 4657, 5233, 5737, 6088, 6937, 7314, 7677, 8518, 8708, 8928, 9095, 9638, 10461, 10878, 11255, 12306, 13351, 13753]","[0, 129, 219, 309, 796, 930, 1143, 1494, 1584, 1793, 1883, 2009, 2224, 2632, 2727, 2904, 3283, 3697, 3840, 4392, 4702, 4797, 5300, 5717, 5899, 6156, 6533, 7670, 7848, 8205]","[0, 181, 306, 396, 535, 992, 1263, 1614, 1704, 2011, 2141, 2575, 2720, 2972, 3229, 3488, 3891, 4043, 4409, 4782, 5055, 5150, 5589, 5926, 6239, 6736, 6959, 7399, 7767, 8070]",17848,16586,13753,8205,8070,-3182,5,-2844,288,-1585,-7318,30,radiant
7565753404,49,32,137,121,26,"[1007, 1282, 1696, 1988, 2583, 2882, 3105, 3281, 3796, 4131, 4621, 5421, 6068, 6605, 7236, 8085, 9330, 10229, 11365, 12266, 13168, 13693, 14266, 14739, 15825, 16590, 17425, 18673, 20139, 20638]","[664, 1077, 1400, 1768, 2179, 2701, 2834, 3445, 3875, 4572, 4830, 5161, 5513, 5984, 6810, 7270, 7901, 8600, 9239, 9793, 10032, 10223, 10947, 11359, 11837, 12007, 12479, 13027, 13337, 13695]","[788, 1002, 1332, 1733, 2288, 3095, 3703, 4239, 4410, 5103, 5859, 6279, 6434, 6687, 7209, 7535, 7954, 8369, 9106, 9508, 9843, 10352, 10591, 11055, 11938, 12408, 12651, 13086, 13714, 14264]","[418, 508, 681, 868, 1073, 1396, 1535, 1777, 1912, 2239, 2384, 2569, 2664, 2758, 3216, 3366, 3821, 4092, 4549, 4832, 5146, 5523, 5837, 6216, 6669, 7021, 7192, 7546, 7717, 8194]","[553, 715, 876, 1031, 1471, 1689, 1817, 1907, 2216, 2391, 2619, 3178, 3514, 3608, 3903, 4218, 4666, 5304, 5674, 6160, 6579, 7233, 7472, 7680, 7922, 8016, 8112, 8289, 8385, 8575]",20638,13695,14264,8194,8575,41,78,53,90,20,"[478, 816, 1523, 1767, 2111, 2334, 2693, 3183, 3737, 4160, 4539, 4863, 5377, 5824, 6148, 6716, 7352, 8122, 8663, 9175, 9790, 10788, 12519, 13730, 14208, 15029, 16460, 17301, 17621, 18368]","[372, 708, 798, 1207, 1414, 2048, 2508, 3063, 3699, 4175, 4718, 5249, 5688, 6168, 6702, 7004, 7541, 8081, 8299, 9129, 9709, 10500, 12344, 12793, 13023, 13523, 14309, 14678, 15298, 15875]","[319, 493, 787, 1016, 1384, 1509, 1827, 2366, 2665, 2806, 2896, 3045, 3431, 3742, 3960, 4390, 4659, 4993, 5473, 5806, 5976, 6633, 7629, 7871, 8410, 8579, 9395, 10068, 10301, 11218]","[535, 814, 1052, 1531, 1832, 2344, 2599, 3371, 4301, 4541, 4786, 5225, 5572, 6027, 6449, 6967, 7596, 7951, 8357, 8452, 8924, 9521, 9875, 10357, 10587, 10888, 11781, 12219, 12603, 13102]","[219, 309, 567, 707, 879, 1086, 1324, 1685, 2038, 2334, 2488, 2676, 2874, 2968, 3126, 3332, 4048, 4222, 4317, 4412, 4739, 4936, 5629, 5913, 6143, 6237, 6874, 7079, 7175, 7440]",18368,15875,11218,13102,7440,2270,-2180,3046,-4908,1135,-637,30,radiant
7565999305,98,95,43,90,20,"[0, 382, 669, 1045, 1570, 2056, 2519, 3122, 3737, 4427, 5301, 6138, 6478, 7068, 7594, 8820, 9366, 10279, 10991, 11409, 12042, 12822, 13347, 14259, 14902, 15366, 16145, 17633, 18458, 19060]","[0, 219, 504, 772, 1262, 1711, 2086, 2560, 2999, 3524, 4093, 4563, 4943, 5436, 6116, 6611, 7465, 8065, 8534, 9429, 10107, 10856, 12064, 12772, 14010, 14670, 15370, 16354, 17268, 18096]","[0, 216, 526, 880, 1174, 1624, 1880, 2372, 2798, 3352, 3803, 4179, 4604, 4934, 5393, 6035, 7008, 7784, 8395, 8952, 9239, 10046, 10441, 10914, 11387, 11865, 12133, 13145, 14141, 14664]","[0, 180, 270, 713, 839, 929, 1019, 1233, 1485, 1712, 1919, 2157, 2479, 2644, 2815, 3234, 3603, 3978, 4234, 4459, 4689, 5137, 5548, 5791, 6185, 6413, 6691, 6953, 7421, 8015]","[0, 281, 371, 480, 664, 799, 889, 1489, 1903, 2083, 2346, 2577, 2667, 2832, 2980, 3111, 3464, 3699, 3794, 3933, 4163, 4485, 4814, 5055, 5253, 5347, 5523, 5967, 6335, 6629]",19060,18096,14664,8015,6629,36,106,129,88,110,"[0, 353, 558, 873, 1206, 1584, 2026, 2378, 2721, 2984, 3482, 3876, 4479, 5057, 5558, 6207, 6626, 7388, 8225, 9039, 9904, 10617, 11375, 11957, 12649, 13487, 14143, 14238, 14443, 15375]","[0, 388, 717, 1001, 1315, 1525, 1812, 2098, 2469, 2818, 3301, 3588, 3857, 4375, 4834, 5457, 5805, 6117, 6401, 6911, 7470, 8063, 8473, 9196, 9972, 10844, 11528, 11623, 12278, 13021]","[0, 269, 474, 646, 944, 1153, 1632, 2099, 2353, 2767, 3120, 3522, 4045, 4431, 4862, 5348, 5518, 6028, 6470, 7073, 7699, 7901, 8413, 8508, 9165, 9895, 10525, 10620, 11183, 11680]","[0, 235, 360, 487, 577, 711, 846, 1192, 1355, 1494, 1629, 2026, 2116, 2265, 2558, 3069, 3329, 3717, 4082, 4475, 4653, 4970, 5112, 5478, 5855, 6397, 6639, 6772, 7394, 7490]","[0, 235, 361, 451, 541, 631, 783, 873, 1008, 1119, 1326, 1622, 1712, 1997, 2091, 2346, 2695, 3248, 3421, 3788, 3979, 4413, 4508, 4828, 5337, 5736, 6049, 6144, 6294, 6390]",15375,13021,11680,7490,6390,3685,5075,2984,525,239,12508,30,radiant
7566090506,41,98,97,128,105,"[76, 321, 609, 857, 1142, 1426, 1862, 2493, 2909, 3440, 4218, 4474, 4757, 5427, 5942, 6382, 7037, 7808, 8876, 9463, 10582, 10800, 11407, 11905, 12699, 12794, 13442, 13715, 14627, 15180]","[76, 281, 643, 967, 1287, 1774, 2074, 2584, 2979, 3679, 4216, 4375, 4967, 5294, 5806, 6178, 6725, 7638, 8367, 8501, 9173, 9268, 9680, 10058, 10620, 10786, 11360, 11455, 12031, 12554]","[76, 359, 740, 938, 1288, 1694, 2124, 2341, 2934, 3510, 3764, 4233, 4742, 5202, 5556, 5651, 6263, 7354, 7854, 8216, 8676, 8771, 9336, 9925, 10518, 10803, 11357, 11967, 12845, 13150]","[209, 636, 778, 1019, 1195, 1386, 1565, 1700, 1790, 2118, 2647, 2737, 2873, 2967, 3062, 3206, 3486, 4524, 5090, 5438, 5724, 5819, 6000, 6168, 6262, 6357, 6492, 6765, 7345, 7571]","[76, 246, 469, 589, 807, 1034, 1169, 1304, 1605, 1931, 2111, 2201, 2291, 2400, 2534, 2915, 3072, 3596, 4008, 4359, 4671, 4841, 5528, 5736, 5976, 6271, 6475, 6831, 7082, 7253]",15180,12554,13150,7571,7253,21,137,135,53,19,"[250, 469, 944, 1352, 1796, 2230, 2697, 3140, 3766, 4427, 5016, 5500, 6318, 6956, 7663, 8209, 8702, 9494, 10178, 10679, 11395, 12270, 13320, 14024, 14657, 15582, 16720, 17653, 18286, 18624]","[117, 375, 608, 909, 1463, 1747, 2241, 3031, 3541, 3744, 4164, 4417, 4949, 5440, 5882, 6392, 7365, 7834, 8802, 9544, 10408, 11142, 11889, 12459, 12858, 13628, 14611, 15360, 15911, 16257]","[117, 287, 599, 860, 1233, 1361, 1801, 2205, 2572, 2831, 3227, 3771, 4784, 5074, 5532, 5969, 6474, 6610, 6940, 7710, 8497, 9100, 9526, 10184, 10836, 11509, 12334, 13198, 13893, 14496]","[117, 287, 377, 467, 597, 914, 1004, 1463, 2037, 2332, 2572, 2882, 3448, 3813, 4250, 4753, 5050, 5313, 5658, 6053, 6429, 7373, 7771, 8452, 9310, 9707, 10434, 10887, 11610, 12331]","[385, 555, 765, 855, 985, 1272, 1619, 1906, 2244, 2334, 2667, 2794, 3634, 3935, 4262, 4685, 5260, 5360, 5620, 5913, 6147, 6654, 7007, 7217, 7534, 7914, 8633, 9085, 9262, 9920]",18624,16257,14496,12331,9920,-3444,-3703,-1346,-4760,-2667,-15920,30,radiant
7566202716,70,21,49,123,75,"[0, 321, 516, 991, 1317, 1589, 2624, 2997, 3087, 3676, 4182, 4836, 5323, 6309, 7003, 7583, 8399, 9805, 9902, 10405, 10889, 11958, 12690, 13258, 14447, 15196, 15834, 16458, 17055, 17256]","[0, 301, 574, 888, 1283, 1389, 1707, 2032, 2417, 2872, 3164, 3732, 4405, 4959, 5534, 6004, 6622, 7409, 7506, 8057, 8616, 9335, 9773, 10490, 10740, 11558, 12509, 12984, 13761, 14754]","[0, 246, 580, 776, 1027, 1446, 1715, 2044, 2447, 2823, 3336, 3696, 4368, 4754, 5269, 5829, 6590, 7211, 7459, 7992, 8626, 8897, 9709, 10268, 11137, 12054, 12591, 12965, 13457, 14329]","[0, 210, 337, 427, 563, 671, 761, 896, 986, 1076, 1256, 1425, 1695, 1906, 2164, 2669, 3144, 3484, 3683, 4183, 4334, 4605, 4764, 5142, 5397, 5564, 5846, 6289, 6488, 6913]","[0, 210, 350, 488, 623, 729, 938, 1073, 1235, 1366, 1501, 1606, 1876, 2270, 2579, 2756, 3112, 3398, 3495, 3924, 4216, 4540, 4820, 5023, 5230, 5397, 5599, 5694, 5957, 6216]",17256,14754,14329,6913,6216,102,98,39,110,26,"[0, 253, 899, 1199, 1655, 2089, 2720, 3374, 3623, 4025, 4545, 5064, 5416, 6058, 6767, 7481, 8434, 8751, 8846, 9229, 10222, 10811, 11410, 11999, 12313, 13045, 14049, 14735, 15518, 16387]","[0, 201, 517, 757, 1061, 1294, 1556, 1941, 2350, 2607, 2778, 3126, 3788, 4504, 5433, 5991, 6467, 7257, 7685, 8487, 9055, 9282, 9887, 10374, 10824, 11444, 12417, 13712, 14429, 14854]","[0, 164, 373, 497, 747, 943, 1152, 1403, 1704, 1916, 2244, 2338, 2644, 3078, 3626, 3833, 4182, 4277, 4687, 5231, 5731, 6336, 7019, 7276, 7706, 7839, 8650, 8933, 9371, 9927]","[0, 130, 295, 385, 554, 932, 1188, 1368, 1749, 2070, 2252, 2393, 2565, 2879, 3186, 3281, 3689, 3784, 4032, 4631, 4788, 5086, 5328, 5598, 6106, 6325, 6697, 7023, 7384, 7994]","[0, 176, 313, 403, 493, 583, 940, 1120, 1437, 1601, 1736, 1886, 1976, 2268, 2546, 2641, 2888, 3013, 3449, 4129, 4395, 4659, 4826, 5107, 5730, 6074, 6345, 6671, 7071, 7539]",16387,14854,9927,7994,7539,869,-100,4402,-1081,-1323,2767,30,radiant
7566439806,102,21,106,100,121,"[206, 449, 811, 1095, 1474, 1825, 2148, 2870, 3297, 3684, 4368, 4633, 5137, 5747, 6484, 7067, 7551, 7963, 8531, 9309, 9910, 10389, 10799, 12234, 13238, 14327, 15054, 15538, 16515, 17525]","[73, 356, 602, 1003, 1390, 1979, 2221, 3200, 3435, 3820, 4139, 4465, 4870, 5400, 6513, 7317, 7899, 8236, 8688, 9225, 10144, 10739, 11187, 11703, 12608, 13617, 14390, 15037, 15301, 16176]","[73, 404, 685, 968, 1333, 1771, 1979, 2610, 3195, 3601, 4197, 4522, 5309, 5912, 6477, 7238, 7864, 8416, 9286, 9858, 10546, 11078, 11469, 12194, 12731, 13118, 13782, 14097, 14743, 15095]","[0, 170, 304, 677, 767, 1015, 1105, 1300, 1621, 1711, 2054, 2297, 3223, 3748, 4162, 4447, 4934, 5418, 5713, 6153, 6392, 6487, 6710, 7274, 7894, 8171, 8265, 8360, 8803, 9155]","[73, 243, 333, 653, 795, 1041, 1181, 1454, 1589, 1803, 2328, 2453, 2977, 3299, 4019, 4304, 4731, 4989, 5195, 5290, 5636, 5731, 6128, 6561, 6925, 7272, 7615, 7833, 7929, 8175]",17525,16176,15095,9155,8175,63,120,19,20,101,"[310, 567, 897, 1393, 1945, 2335, 3137, 3435, 3970, 4678, 5367, 5935, 6192, 7036, 7579, 7980, 8827, 10192, 10846, 11893, 12376, 12989, 14365, 15249, 15946, 16864, 17813, 19463, 20303, 21596]","[445, 703, 864, 1322, 1789, 2171, 2388, 2962, 3485, 4033, 4481, 4993, 5432, 5951, 6745, 7181, 7666, 8635, 9463, 9831, 10222, 11073, 11677, 11934, 12376, 12810, 13559, 14642, 15326, 16189]","[310, 591, 874, 1284, 1957, 2236, 2611, 2868, 3182, 3526, 3661, 4055, 4485, 4779, 5023, 5243, 6044, 6648, 6832, 7592, 7891, 8309, 8526, 9096, 9268, 9645, 9858, 10759, 11380, 11476]","[177, 347, 437, 620, 973, 1156, 1481, 1680, 1836, 2050, 2586, 2746, 2848, 2997, 3217, 3546, 3979, 4244, 4451, 4702, 4994, 5493, 5768, 6067, 6231, 6326, 6578, 6754, 7021, 7427]","[116, 286, 376, 526, 737, 891, 1026, 1213, 1503, 1869, 2184, 2274, 2485, 2634, 2939, 3084, 3517, 3705, 3889, 4110, 4205, 4385, 4847, 5156, 5251, 5346, 5796, 6648, 7139, 7235]",21596,16189,11476,7427,7235,-4071,-13,3619,1728,940,2203,30,radiant
7566572217,28,93,106,53,26,"[0, 129, 329, 567, 847, 1379, 1779, 2263, 2912, 3610, 4433, 4973, 5367, 6028, 6634, 7379, 7859, 8791, 9433, 10650, 11008, 12136, 13368, 13792, 14383, 16212, 16534, 16629, 17429, 18175]","[58, 315, 644, 1041, 1425, 1793, 2030, 2550, 2685, 3039, 3664, 4006, 4716, 5363, 5845, 7092, 7692, 8466, 8806, 9857, 10405, 11644, 12455, 13067, 13407, 14330, 14505, 14600, 15670, 16258]","[58, 314, 635, 976, 1356, 1805, 1966, 2332, 2796, 3183, 3763, 4244, 4540, 4899, 5189, 5502, 6194, 7024, 7272, 8159, 8495, 9314, 9943, 10442, 10754, 11789, 12096, 12754, 13602, 13911]","[326, 520, 610, 971, 1061, 1516, 1719, 1856, 2035, 2297, 2707, 2926, 3252, 3450, 4064, 4451, 4929, 5360, 5626, 6203, 6379, 7398, 8250, 8647, 9309, 9820, 10504, 10889, 11645, 11993]","[58, 385, 546, 751, 888, 1157, 1538, 1707, 1891, 2209, 2525, 2615, 2705, 2800, 3291, 3856, 4077, 4172, 4401, 4764, 4859, 5335, 6122, 6934, 7123, 7290, 7465, 7560, 8131, 8439]",18175,16258,13911,11993,8439,41,38,120,101,102,"[0, 293, 625, 858, 1102, 1605, 1935, 2354, 2631, 3138, 3491, 3974, 4629, 5202, 5799, 6286, 7004, 7825, 8698, 9324, 9419, 10103, 10197, 10725, 11975, 12294, 12982, 14587, 14691, 15168]","[0, 243, 391, 556, 901, 1264, 1650, 2384, 2836, 3530, 3944, 4526, 4879, 5776, 6276, 6825, 7393, 7812, 7984, 8652, 9435, 9798, 10056, 10717, 11849, 12764, 13085, 14133, 14830, 15360]","[0, 247, 689, 1050, 1431, 1677, 2094, 2399, 2783, 3235, 3833, 4490, 5169, 5681, 5892, 6314, 6678, 7025, 8014, 9023, 9689, 9905, 10510, 10782, 11474, 11793, 12247, 13218, 13441, 13744]","[0, 209, 302, 392, 482, 652, 1328, 2009, 2424, 2706, 2978, 3143, 3590, 4251, 4393, 4757, 4942, 5286, 5461, 5847, 6017, 6187, 6570, 6789, 7369, 7737, 8527, 9240, 9411, 9717]","[0, 209, 299, 428, 518, 741, 831, 1046, 1181, 1460, 1640, 1779, 1915, 2371, 2635, 3001, 3186, 3530, 3624, 3931, 4228, 4429, 4570, 4665, 5369, 5705, 6192, 6702, 6798, 7029]",15168,15360,13744,9717,7029,3007,898,167,2276,1410,7758,30,radiant
7566637019,49,95,107,123,121,"[376, 738, 1053, 1261, 1714, 2316, 2815, 3482, 3886, 4635, 5577, 5867, 6674, 7170, 7645, 8368, 9200, 9986, 10588, 11007, 11660, 12955, 13586, 14135, 14890, 15743, 16675, 17208, 17863, 18691]","[240, 522, 719, 1019, 1459, 1654, 2386, 3053, 3304, 3661, 4056, 4660, 5159, 5584, 6201, 6974, 7949, 8730, 9006, 9930, 10345, 11486, 12163, 12943, 13815, 14256, 14872, 16211, 16857, 18276]","[506, 870, 1157, 1494, 1794, 2128, 2691, 3515, 4037, 4716, 5351, 5937, 6280, 7383, 7678, 7822, 8511, 9598, 9977, 11330, 11583, 12959, 13261, 13624, 14117, 15243, 15779, 16528, 16749, 17814]","[373, 583, 673, 763, 940, 1351, 1896, 2378, 2468, 2648, 3113, 3366, 3608, 4112, 4297, 4392, 4612, 5181, 5453, 5967, 6062, 6157, 6459, 6824, 7183, 7806, 8274, 8866, 9467, 9843]","[108, 318, 408, 498, 707, 797, 1127, 1418, 1553, 1786, 2057, 2362, 2982, 3474, 3661, 3775, 4169, 4836, 4931, 5645, 5740, 6336, 6638, 6914, 7209, 7768, 7992, 8251, 8730, 9339]",18691,18276,17814,9843,9339,82,126,69,64,45,"[154, 309, 630, 1149, 1396, 1603, 1812, 2030, 2478, 2856, 3207, 3764, 4356, 4672, 5160, 5897, 6570, 6776, 7574, 8252, 9094, 9732, 10324, 11198, 12182, 12990, 13735, 14135, 14438, 15669]","[287, 564, 818, 1217, 1504, 1956, 2526, 3122, 3794, 4089, 4857, 5020, 5460, 5997, 6181, 6672, 7193, 7343, 7682, 8174, 9097, 9768, 9863, 10331, 10729, 11350, 11571, 11988, 12084, 13171]","[154, 378, 499, 900, 1128, 1577, 1856, 2173, 2425, 2750, 3446, 3907, 4287, 4873, 5326, 5969, 6473, 7434, 7773, 8332, 8427, 8968, 9089, 9652, 10622, 11398, 12091, 12601, 12857, 13279]","[154, 309, 486, 606, 993, 1183, 1396, 1639, 1833, 2166, 2991, 3156, 3246, 3494, 3589, 4256, 4511, 4651, 4840, 5731, 6011, 6945, 7247, 7979, 8517, 8924, 9198, 9292, 9508, 10097]","[287, 691, 781, 992, 1160, 1285, 1421, 1601, 1795, 1979, 2413, 2503, 2593, 2878, 3127, 3823, 3917, 4057, 4152, 4357, 4452, 4737, 4832, 5169, 5646, 5847, 5942, 6223, 6746, 8201]",15669,13171,13279,10097,8201,3022,5105,4535,-254,1138,13546,30,radiant
7566638207,97,107,136,72,100,"[0, 323, 574, 1002, 1402, 1737, 2817, 3119, 3846, 4493, 5159, 5620, 6265, 7050, 7351, 8186, 8931, 9252, 10089, 11022, 11371, 11868, 13070, 13670, 13991, 14085, 15033, 15642, 16124, 16370]","[0, 279, 498, 859, 1179, 1383, 1761, 2022, 2452, 2914, 3361, 3780, 4252, 4985, 5796, 5982, 6871, 7480, 8264, 9050, 9277, 10147, 10751, 11347, 11962, 12334, 12900, 13389, 14024, 15029]","[0, 204, 439, 1015, 1348, 1879, 2389, 2992, 3930, 4209, 5367, 6136, 6989, 7365, 8131, 8408, 8792, 9707, 10423, 10779, 11441, 11960, 12558, 13287, 13961, 14228, 15481, 15658, 16339, 16683]","[100, 270, 663, 922, 1056, 1233, 1399, 1579, 1879, 1991, 2544, 2871, 3139, 3345, 3630, 4114, 4567, 4881, 5062, 5610, 5828, 6503, 6861, 7171, 7266, 7526, 7621, 8322, 8844, 9224]","[100, 270, 411, 576, 716, 862, 1040, 1258, 1616, 1706, 2378, 2623, 2992, 3332, 3796, 3982, 4603, 4777, 4913, 5251, 5407, 5885, 6211, 6576, 6969, 7144, 7539, 7749, 8175, 8597]",16370,15029,16683,9224,8597,49,21,78,53,86,"[0, 363, 699, 1094, 1466, 2010, 2644, 2898, 3344, 3639, 3950, 4129, 4710, 5251, 5650, 6277, 6832, 7901, 9056, 9747, 10674, 10971, 11548, 12417, 12598, 13386, 13565, 14101, 15203, 16086]","[0, 287, 562, 682, 1186, 1386, 1646, 2256, 2609, 3079, 3630, 3850, 4554, 5204, 5736, 7154, 7592, 7941, 8450, 8930, 9576, 10460, 11106, 12202, 12596, 13186, 13748, 13917, 14414, 15564]","[0, 260, 500, 774, 1134, 1260, 1779, 2110, 2200, 2669, 3341, 4122, 4284, 5273, 5390, 5901, 6380, 6870, 7378, 7583, 8227, 8691, 9217, 9418, 9706, 9902, 10457, 10633, 11224, 11722]","[0, 170, 260, 415, 505, 595, 1063, 1425, 1515, 1706, 2078, 2222, 2723, 3358, 3569, 4035, 4391, 4675, 4985, 5319, 5905, 6192, 6562, 6788, 7087, 7707, 8121, 8251, 8653, 9163]","[0, 170, 605, 725, 861, 994, 1302, 1437, 1571, 1741, 2225, 2531, 2655, 3027, 3211, 3558, 3806, 3901, 4208, 4476, 4817, 4912, 5251, 5393, 5488, 5654, 5749, 5965, 6237, 6435]",16086,15564,11722,9163,6435,284,-535,4961,61,2162,6933,30,dire
7566660314,74,32,55,20,19,"[0, 288, 591, 885, 1544, 2017, 2679, 3270, 3719, 4704, 5122, 6104, 6686, 7270, 7766, 8856, 9949, 10742, 11563, 11871, 12665, 13112, 15241, 15654, 16091, 16815, 17401, 18142, 19299, 19811]","[0, 325, 548, 885, 1052, 1387, 1713, 2038, 2128, 2424, 2551, 2746, 3378, 4035, 4707, 5337, 5976, 6340, 6434, 6688, 7095, 7711, 8396, 8655, 9114, 9395, 9597, 10086, 10292, 10967]","[0, 324, 611, 1024, 1202, 1670, 1937, 2571, 2848, 3419, 4011, 4532, 4975, 5264, 5358, 5729, 6242, 6771, 7156, 7329, 7949, 8044, 8563, 8883, 9256, 9612, 9797, 10172, 10751, 10947]","[0, 250, 353, 443, 569, 992, 1430, 1916, 2006, 2898, 2988, 3093, 3906, 4181, 4431, 4803, 5235, 5561, 5655, 6114, 6429, 6524, 7216, 7347, 7526, 7894, 8315, 8507, 8713, 9118]","[0, 250, 340, 430, 520, 686, 776, 1097, 1317, 1627, 1717, 2035, 2478, 2785, 3294, 3521, 4128, 4454, 4548, 4802, 5023, 5118, 6049, 6144, 6284, 6378, 6473, 6568, 7048, 7626]",19811,10967,10947,9118,7626,48,40,120,88,64,"[326, 582, 959, 1344, 1795, 2352, 2976, 3305, 3866, 4507, 5233, 5878, 6093, 7093, 7971, 8696, 9923, 10997, 11513, 12902, 13656, 14892, 15480, 16238, 17178, 18413, 20171, 21224, 22585, 24289]","[58, 377, 784, 979, 1446, 2246, 2972, 3526, 4110, 4410, 4674, 5176, 5948, 6563, 6844, 7061, 8086, 8720, 8903, 9425, 10511, 10889, 11395, 12038, 12482, 13082, 14180, 14981, 16449, 17325]","[58, 220, 588, 957, 1291, 1421, 1784, 2344, 2803, 2893, 3164, 3383, 3749, 4436, 4642, 5363, 5767, 6957, 7238, 7767, 8776, 9205, 9371, 9803, 10366, 10611, 12207, 12801, 13698, 14457]","[58, 206, 315, 405, 569, 787, 1043, 1306, 1531, 1747, 2259, 2718, 3615, 4262, 4670, 5250, 5651, 6133, 6379, 7372, 7728, 8532, 8698, 8865, 9158, 10529, 11460, 12101, 12870, 14326]","[58, 206, 296, 386, 492, 622, 856, 946, 1499, 1680, 2211, 2444, 2927, 3337, 3717, 3958, 4295, 5179, 5284, 5718, 6126, 6512, 7097, 7264, 7884, 9379, 10292, 10922, 11845, 12307]",24289,17325,14457,14326,12307,-4478,-6358,-3510,-5208,-4681,-24235,30,dire
7566664510,89,78,19,72,68,"[445, 701, 947, 1074, 1295, 1617, 1791, 2100, 2598, 3273, 3901, 4299, 5135, 5924, 6906, 7816, 8324, 9426, 10562, 11456, 12486, 13327, 14561, 14948, 16176, 17354, 18646, 19767, 20831, 22648]","[447, 573, 845, 1211, 1511, 1721, 2145, 2511, 2802, 3564, 3866, 4505, 4824, 5264, 6240, 6837, 7664, 8493, 9082, 9640, 10016, 10766, 11021, 11421, 11871, 13315, 14031, 14762, 15913, 16702]","[179, 339, 701, 943, 1459, 1705, 2045, 2432, 2704, 3281, 3665, 4118, 4533, 4795, 5730, 6135, 6592, 6774, 7388, 7660, 8201, 8296, 8637, 9212, 9642, 10437, 11379, 12045, 12859, 13513]","[179, 304, 445, 581, 710, 936, 1202, 1510, 1875, 2244, 2424, 2890, 3094, 3478, 4604, 4869, 5121, 5985, 6602, 7272, 7420, 7864, 7993, 9200, 9685, 10685, 11195, 11668, 12764, 13507]","[119, 254, 344, 450, 589, 725, 906, 1041, 1445, 1864, 2124, 2903, 3110, 3205, 3936, 4144, 4480, 5007, 5236, 5806, 6023, 6118, 6300, 7065, 7232, 8171, 8966, 9287, 9916, 10507]",22648,16702,13513,13507,10507,73,47,29,45,100,"[0, 571, 929, 1309, 1615, 1969, 2296, 2682, 3145, 4127, 4488, 5071, 5445, 6545, 7252, 7820, 8473, 9189, 10074, 11189, 12071, 12206, 12547, 13348, 14265, 15203, 15826, 16736, 17059, 18112]","[280, 628, 909, 1198, 1669, 2101, 2257, 2813, 3361, 3915, 4215, 4588, 5105, 5592, 6002, 6492, 7422, 8027, 8499, 9335, 10271, 10842, 11745, 12711, 13044, 13663, 13913, 15225, 15419, 15794]","[147, 494, 631, 947, 1387, 1844, 2256, 2581, 2999, 3505, 4210, 4640, 4985, 5812, 6018, 6271, 6845, 7228, 7545, 8148, 9234, 9476, 9821, 10370, 10465, 10980, 11075, 11956, 12231, 12419]","[147, 422, 598, 815, 990, 1369, 1499, 1844, 2071, 2279, 2405, 2560, 2944, 3559, 3859, 4095, 4665, 4939, 5462, 5944, 6695, 6895, 7038, 7977, 8072, 8226, 8464, 8639, 8816, 9045]","[280, 555, 758, 878, 1055, 1434, 1913, 2003, 2430, 2638, 2892, 2982, 3483, 3776, 3871, 4226, 4749, 5166, 5309, 5691, 6454, 6549, 6801, 7227, 7465, 7595, 7915, 8333, 8510, 8789]",18112,15794,12419,9045,8789,4536,908,1094,4462,1718,12718,30,radiant
7566684319,95,39,29,53,64,"[0, 284, 737, 1156, 1402, 1682, 2401, 2881, 3131, 3506, 4123, 4594, 5008, 5612, 6227, 6675, 7256, 8022, 8789, 9372, 9921, 10473, 11752, 12500, 12950, 13713, 14372, 14843, 14939, 16981]","[0, 322, 573, 905, 1117, 1448, 1965, 2253, 2563, 3228, 4050, 4472, 4856, 5381, 5746, 6155, 7107, 7572, 8622, 9766, 10232, 11527, 12346, 12953, 13968, 14865, 15917, 16011, 16673, 17051]","[0, 245, 531, 732, 981, 1206, 1420, 1859, 2370, 2797, 2887, 3214, 3842, 4208, 4428, 4887, 5245, 5869, 6556, 6982, 7250, 8335, 8646, 9051, 9447, 9586, 9967, 10216, 10312, 10763]","[0, 170, 309, 399, 525, 699, 912, 1108, 1283, 1566, 1921, 2146, 2407, 2785, 3018, 3205, 3592, 4080, 4452, 5174, 5638, 6453, 6967, 7252, 7964, 8059, 8719, 8990, 9086, 9182]","[0, 170, 344, 434, 571, 661, 1062, 1258, 1348, 1575, 1665, 1890, 2096, 2459, 2644, 2739, 2916, 3406, 3591, 3913, 4008, 4516, 4827, 5361, 5456, 5600, 5810, 5904, 6127, 6223]",16981,17051,10763,9182,6223,82,13,137,58,86,"[0, 502, 735, 1283, 1561, 2081, 2766, 3150, 3870, 4420, 5343, 5810, 6625, 7172, 7831, 8783, 9527, 9983, 10547, 11513, 12040, 12972, 13934, 14934, 15952, 17237, 19089, 20258, 21088, 22798]","[0, 246, 607, 820, 1106, 1603, 2022, 2680, 3183, 3711, 4227, 4955, 5571, 6192, 6812, 7371, 8071, 8407, 9251, 9830, 10299, 10394, 11254, 11994, 13140, 13815, 14530, 15829, 17052, 17776]","[0, 207, 636, 904, 1200, 1592, 1880, 2259, 2660, 3138, 3454, 3955, 4566, 5102, 5720, 6272, 7125, 7490, 8040, 8292, 9038, 9210, 9446, 9650, 10297, 11289, 11661, 12524, 12838, 13288]","[0, 234, 324, 696, 786, 916, 1329, 1850, 2083, 2272, 2811, 3097, 3406, 3689, 4027, 4719, 4876, 5048, 5608, 5702, 6133, 6295, 6942, 7376, 7874, 8428, 8836, 9609, 10244, 10669]","[0, 170, 363, 453, 663, 1008, 1263, 1635, 1831, 2202, 2675, 2869, 3094, 3297, 3530, 3785, 4187, 4457, 4811, 5123, 5320, 5586, 5834, 6038, 6546, 6980, 7398, 7885, 8116, 8429]",22798,17776,13288,10669,8429,-5817,-725,-2525,-1487,-2206,-12760,30,dire
7566717109,82,55,63,123,112,"[0, 376, 732, 1020, 1501, 1815, 2095, 2476, 3107, 3832, 4273, 4938, 5560, 6245, 7172, 7432, 7572, 8123, 8485, 8887, 9757, 10490, 11609, 12256, 13008, 13915, 14897, 15958, 16647, 16847]","[0, 331, 916, 1201, 1580, 2268, 2754, 3304, 3881, 4393, 4630, 5060, 6082, 6986, 7473, 8126, 8817, 9570, 10318, 10815, 11415, 12091, 12418, 12647, 13156, 14392, 14985, 15670, 16252, 16431]","[0, 205, 416, 592, 1029, 1373, 1698, 1990, 2412, 2688, 3147, 3471, 3877, 4464, 4975, 5443, 6091, 6480, 7173, 7921, 8713, 9390, 10284, 10379, 11449, 11823, 12158, 13063, 13446, 14097]","[0, 170, 335, 522, 652, 1107, 1209, 1299, 1461, 1839, 2146, 2505, 3031, 3508, 3761, 3946, 4169, 4550, 4900, 5388, 5732, 6035, 6373, 6805, 7054, 7578, 7693, 8197, 8405, 8752]","[0, 170, 260, 350, 590, 844, 934, 1060, 1240, 1449, 1905, 2038, 2321, 2618, 2888, 2982, 3171, 3432, 3743, 4051, 4904, 5188, 5525, 5989, 6243, 6576, 6670, 7394, 7834, 7930]",16847,16431,14097,8752,7930,1,13,102,20,101,"[0, 247, 461, 928, 1160, 1398, 1900, 2314, 2790, 3097, 3731, 4058, 4374, 4693, 5027, 5554, 6209, 6922, 7501, 8393, 9086, 9715, 10901, 11254, 12073, 12560, 13360, 14306, 15332, 16623]","[0, 255, 660, 1067, 1364, 1713, 2238, 2884, 3328, 3626, 3996, 4511, 5333, 5740, 6649, 7483, 8334, 8858, 9242, 9763, 10164, 10880, 11964, 12698, 13670, 14930, 15554, 16423, 17059, 18521]","[0, 287, 446, 716, 1033, 1287, 1411, 1856, 1980, 2366, 2659, 2834, 3301, 3650, 4088, 4459, 5200, 5646, 6219, 6713, 7274, 7545, 8647, 9074, 9554, 9760, 10242, 10604, 10951, 11578]","[0, 307, 397, 788, 976, 1066, 1263, 1803, 1932, 2115, 2403, 2585, 3110, 3297, 3743, 4145, 4971, 5231, 5427, 5732, 6258, 6739, 7213, 7465, 7803, 8119, 8340, 8606, 9286, 9765]","[0, 170, 260, 380, 517, 652, 849, 1150, 1240, 1330, 1465, 1848, 2265, 2656, 2891, 3174, 3522, 3617, 3774, 3869, 4160, 4409, 5114, 5318, 5606, 6118, 6367, 6627, 7149, 7920]",16623,18521,11578,9765,7920,224,-2090,2519,-1013,10,-350,30,radiant
7566732510,48,23,55,66,51,"[116, 346, 760, 1136, 1398, 1861, 2161, 2630, 3298, 3742, 4277, 4876, 5502, 5961, 6784, 7071, 7707, 7929, 8849, 9863, 10616, 11360, 12123, 12984, 14059, 15246, 16110, 16728, 17713, 18847]","[249, 601, 914, 1237, 1661, 2135, 2630, 3439, 4224, 4786, 5282, 5938, 6409, 6904, 7604, 8289, 8993, 9466, 10503, 11429, 12133, 12647, 12972, 13522, 14315, 14932, 15518, 15962, 16546, 17479]","[116, 346, 557, 754, 915, 1316, 1818, 2479, 3166, 3699, 4317, 4595, 5294, 5659, 6412, 6717, 7195, 7571, 8127, 9041, 9885, 10347, 10999, 11644, 12306, 12901, 13472, 14204, 14905, 15837]","[116, 311, 451, 652, 824, 1078, 1225, 1638, 2028, 2345, 2618, 3088, 3482, 3904, 4188, 4768, 5402, 5916, 6319, 7076, 7574, 8077, 8446, 9002, 9523, 10028, 10715, 11078, 11738, 12638]","[384, 579, 669, 830, 1180, 1305, 1764, 2034, 2214, 2355, 2832, 3067, 3450, 3645, 4021, 4374, 4845, 4940, 5145, 5513, 5777, 6404, 6889, 7327, 8139, 8416, 8742, 8883, 9060, 9659]",18847,17479,15837,12638,9659,13,21,96,45,20,"[0, 252, 490, 702, 954, 1044, 1444, 1806, 2181, 2766, 3295, 3456, 4109, 4492, 5002, 5872, 6415, 7282, 8037, 8377, 9053, 9905, 10866, 11406, 11886, 12309, 13172, 13796, 14520, 15383]","[0, 283, 595, 840, 1314, 1657, 1939, 2240, 2625, 3082, 4007, 4322, 4823, 5353, 5712, 6691, 7364, 7613, 8451, 9074, 10044, 10843, 10937, 11648, 12621, 12938, 13758, 14277, 14729, 15587]","[0, 283, 613, 996, 1195, 1368, 2063, 2439, 2601, 3080, 3215, 3412, 3871, 4325, 4955, 5593, 5881, 6184, 6279, 6643, 6891, 7196, 7639, 8147, 8441, 8721, 9068, 9771, 10088, 11037]","[0, 170, 260, 399, 788, 925, 1155, 1245, 1386, 1743, 1966, 2259, 2516, 2665, 2885, 2979, 3137, 3232, 3474, 3821, 4240, 4355, 4449, 5019, 5478, 5986, 6361, 6610, 6765, 7408]","[100, 270, 360, 495, 680, 810, 1073, 1184, 1362, 1554, 1874, 2012, 2474, 2623, 2808, 3233, 3391, 3530, 3772, 3929, 4354, 4659, 4844, 5074, 5169, 5264, 5729, 6033, 6304, 6705]",15383,15587,11037,7408,6705,3464,1892,4800,5230,2954,18340,30,radiant
7566759713,25,69,106,107,30,"[0, 290, 693, 994, 1403, 1815, 2368, 2714, 3326, 3834, 4521, 5218, 5840, 6290, 7205, 7807, 9032, 9839, 10813, 11637, 12430, 13112, 13961, 14984, 15917, 17038, 18763, 19833, 20591, 22690]","[0, 208, 454, 638, 1009, 1384, 1527, 1894, 2201, 2680, 3230, 3692, 4430, 5101, 5846, 6391, 7072, 8133, 9040, 9839, 10427, 11416, 12093, 12573, 13346, 14352, 14709, 15411, 16502, 17771]","[0, 251, 598, 1013, 1274, 1664, 1988, 2159, 2366, 2601, 2905, 3204, 3548, 3948, 4769, 5039, 5775, 6180, 7369, 8150, 8937, 9585, 10247, 10827, 11544, 12376, 12848, 13382, 14302, 15791]","[0, 219, 419, 509, 639, 878, 968, 1140, 1323, 1615, 1969, 2331, 2467, 2928, 3171, 3389, 3889, 4167, 4630, 5103, 5198, 5510, 5784, 6447, 6770, 7147, 7666, 8169, 8575, 9494]","[0, 169, 284, 374, 538, 754, 892, 1027, 1210, 1318, 1611, 1764, 1931, 2296, 2494, 2737, 3343, 3865, 4721, 5109, 5309, 5634, 6185, 6692, 7057, 7461, 7781, 7950, 8611, 9449]",22690,17771,15791,9494,9449,42,49,28,110,86,"[0, 215, 584, 1095, 1463, 2076, 2580, 3263, 3602, 3922, 4414, 4809, 5462, 5708, 6277, 6872, 7846, 8560, 8690, 9644, 10293, 10878, 11376, 11667, 12448, 13444, 14242, 14569, 14665, 15564]","[0, 242, 562, 845, 1199, 1634, 2045, 2298, 2748, 3165, 3624, 3987, 4530, 4922, 5349, 5701, 6045, 6915, 7010, 7447, 7669, 8042, 8423, 8602, 9126, 9531, 9695, 10278, 10531, 10627]","[0, 169, 373, 797, 887, 977, 1224, 1565, 1860, 2165, 2474, 2965, 3477, 3695, 3960, 4479, 4968, 5514, 5915, 6525, 7180, 7563, 7917, 8120, 8215, 8563, 8908, 9382, 9714, 10282]","[0, 169, 651, 1010, 1204, 1387, 1533, 1944, 2155, 2506, 3082, 3403, 3623, 3828, 4150, 4454, 4637, 5030, 5338, 5935, 6285, 6520, 7079, 7473, 7734, 7997, 8210, 8304, 8516, 8839]","[0, 169, 304, 521, 650, 740, 830, 965, 1350, 1440, 1575, 1738, 2108, 2203, 2298, 2392, 2593, 2814, 2909, 3142, 3327, 3422, 3619, 3760, 3855, 4154, 4285, 4379, 4613, 5062]",15564,10627,10282,8839,5062,7126,7144,5509,655,4387,24821,30,radiant
7566769601,48,13,21,14,68,"[0, 168, 297, 660, 1001, 1464, 1887, 2301, 2705, 3137, 3513, 3949, 4678, 5488, 6252, 7037, 7297, 7834, 8390, 9574, 10610, 11116, 12475, 12783, 13064, 14420, 15419, 16145, 17174, 17629]","[0, 202, 476, 687, 1109, 1310, 1843, 2379, 2766, 2986, 3584, 4008, 4338, 4472, 5132, 5850, 6107, 7152, 7350, 7878, 9094, 9802, 10073, 10327, 11162, 12193, 13102, 13196, 13542, 14310]","[0, 215, 751, 915, 1355, 1986, 2477, 2567, 2809, 3233, 3580, 3680, 4156, 4617, 4873, 5338, 5530, 6318, 6791, 7328, 8008, 8534, 8838, 8932, 9806, 10257, 10605, 10859, 11354, 11652]","[0, 168, 258, 664, 913, 1299, 1389, 1858, 2031, 2121, 2333, 2549, 2639, 2863, 3269, 3710, 4043, 4774, 5043, 5648, 5998, 6550, 6720, 6889, 7410, 7692, 7952, 8160, 9100, 9271]","[0, 129, 305, 400, 577, 798, 977, 1402, 1812, 1902, 2150, 2240, 2330, 2554, 2855, 3385, 3480, 3982, 4077, 4316, 4886, 5151, 5246, 5340, 5979, 6074, 6259, 6353, 6870, 6966]",17629,14310,11652,9271,6966,96,106,42,20,112,"[0, 209, 611, 1152, 1405, 1615, 2123, 2445, 2927, 3472, 3940, 4706, 5310, 6295, 6736, 6988, 7938, 8506, 9222, 10271, 10784, 11484, 12203, 12888, 13305, 13844, 14144, 15158, 15883, 16766]","[0, 209, 881, 1200, 1653, 1934, 2313, 2692, 3122, 4314, 4823, 5187, 5590, 6628, 7050, 7726, 8401, 8720, 9325, 10355, 11061, 11636, 11842, 12620, 13348, 13976, 14403, 15315, 16176, 17085]","[0, 256, 457, 619, 895, 1187, 1453, 1895, 2343, 2858, 3440, 4361, 4782, 5849, 6409, 6961, 7480, 8326, 9411, 10084, 10617, 11353, 12081, 12849, 13947, 14757, 15596, 16208, 17264, 18698]","[0, 209, 299, 694, 833, 1194, 1564, 1654, 1744, 2094, 2668, 3009, 3236, 3941, 4325, 4774, 5328, 5571, 5832, 6178, 6404, 6634, 7043, 7450, 7867, 8073, 8168, 8567, 8854, 9193]","[0, 209, 299, 389, 479, 605, 818, 908, 1368, 1718, 1988, 2551, 2970, 3601, 3868, 3962, 4384, 4568, 5026, 5549, 5754, 5984, 6188, 6784, 7201, 7700, 7795, 8198, 8574, 8913]",16766,17085,18698,9193,8913,863,-2775,-7046,78,-1947,-10827,30,dire
7566771908,20,43,93,53,51,"[0, 304, 708, 945, 1388, 1780, 2146, 2848, 3850, 4272, 4810, 5493, 6188, 6752, 7195, 7510, 7993, 8087, 8821, 9433, 10033, 10783, 11506, 11783, 12314, 13692, 15021, 15724, 16697, 16831]","[0, 623, 912, 1212, 1545, 1988, 2545, 2841, 3370, 3793, 4137, 4507, 5147, 5600, 6429, 7118, 7937, 8331, 8683, 9501, 9739, 10174, 10907, 11506, 11874, 12410, 13252, 13932, 14691, 15147]","[0, 309, 507, 744, 950, 1193, 1301, 1476, 1741, 2116, 2382, 2707, 3311, 3759, 4078, 4762, 5487, 5768, 6478, 7145, 7670, 8190, 8678, 9243, 9647, 10467, 11190, 11926, 12707, 13334]","[0, 437, 527, 652, 1038, 1240, 1470, 1788, 2334, 2681, 2816, 3039, 3260, 3705, 3933, 4186, 4635, 4852, 5043, 5737, 5935, 6134, 6497, 7029, 7736, 8384, 9122, 9574, 10030, 10708]","[0, 304, 394, 519, 798, 963, 1343, 1564, 1953, 2214, 2447, 2665, 2951, 3172, 3400, 3549, 3862, 4218, 4323, 4616, 4877, 5072, 5267, 5800, 6069, 7406, 7899, 8203, 8747, 8918]",16831,15147,13334,10708,8918,49,10,60,123,136,"[0, 523, 807, 1081, 1411, 1660, 1868, 2204, 2329, 2690, 2986, 3884, 4416, 4921, 5745, 6269, 6860, 7938, 8509, 9347, 10170, 10881, 12218, 12851, 13128, 13586, 14822, 15390, 16677, 17497]","[0, 170, 460, 1043, 1221, 1720, 2124, 2360, 3027, 3360, 3994, 4535, 5129, 5626, 6296, 6977, 7417, 8922, 9455, 9933, 10650, 11607, 12620, 13379, 14164, 15426, 15870, 16515, 17495, 17949]","[0, 235, 514, 892, 1237, 1639, 2032, 2428, 2870, 3301, 3834, 4242, 4734, 5421, 5590, 6315, 6568, 7488, 8209, 9021, 9590, 10062, 10996, 11377, 11972, 13030, 13320, 14086, 14874, 15261]","[0, 279, 369, 489, 579, 782, 894, 1178, 1317, 1735, 2045, 2451, 2739, 2937, 3301, 3626, 4143, 4736, 4917, 5161, 5664, 5761, 6098, 6661, 7271, 8057, 8578, 8673, 9051, 9154]","[0, 283, 373, 576, 666, 846, 953, 1088, 1178, 1358, 1448, 1995, 2270, 2411, 2560, 2757, 3013, 3697, 4015, 4173, 4454, 4562, 4801, 5149, 5244, 5811, 5906, 6040, 6373, 6559]",17497,17949,15261,9154,6559,-666,-2802,-1927,1554,2359,-1482,30,radiant
7567126703,10,120,21,65,110,"[0, 219, 422, 664, 913, 1186, 1571, 1997, 2525, 3019, 3526, 4089, 4676, 5256, 5884, 6376, 7414, 8096, 8497, 9005, 9559, 10134, 10727, 11083, 11640, 12195, 12848, 13735, 14234, 14330]","[0, 362, 524, 975, 1260, 1678, 2045, 2804, 3217, 3655, 4178, 4793, 5213, 5835, 6689, 7026, 7644, 8165, 8811, 9010, 9933, 10592, 11319, 11643, 12461, 12795, 13363, 13458, 13802, 13989]","[0, 251, 522, 924, 1305, 1585, 2101, 2513, 2967, 3418, 3671, 4084, 4454, 5107, 5779, 6436, 6885, 7617, 8318, 8553, 8902, 9358, 9936, 10272, 10451, 11724, 12009, 12368, 12608, 13082]","[0, 170, 260, 398, 567, 743, 955, 1090, 1180, 1316, 1530, 1698, 1992, 2682, 2831, 2926, 3515, 3784, 4068, 4554, 4978, 5409, 5954, 6265, 6434, 6968, 7419, 7796, 7967, 8175]","[0, 170, 260, 427, 517, 607, 791, 1011, 1101, 1191, 1326, 1491, 1581, 2307, 2648, 2843, 3090, 3188, 3601, 3696, 4045, 4370, 4827, 5336, 5598, 5826, 6002, 6097, 6231, 6500]",14330,13989,13082,8175,6500,70,82,98,26,123,"[0, 331, 598, 1004, 1342, 1776, 2069, 2503, 2828, 3437, 3865, 4421, 5023, 5566, 6012, 6572, 7412, 8337, 9132, 9743, 10994, 11863, 12669, 13484, 14790, 15555, 16729, 17813, 19495, 20578]","[0, 222, 661, 884, 1323, 1532, 1963, 2414, 2953, 3284, 3999, 4511, 5113, 5637, 6547, 7429, 8513, 9688, 10990, 11695, 12699, 13342, 14187, 15315, 16193, 16360, 17413, 18228, 19099, 20073]","[0, 299, 685, 1146, 1356, 1684, 2257, 3030, 3538, 4056, 4625, 5111, 5546, 5777, 6822, 7241, 7767, 8071, 9024, 9626, 10255, 10943, 11878, 12472, 13296, 13666, 14620, 15648, 16686, 17395]","[0, 170, 260, 416, 552, 733, 868, 1011, 1127, 1364, 1878, 2572, 2752, 2970, 3311, 3738, 4032, 4874, 5054, 5212, 5968, 6333, 6553, 6915, 7171, 7338, 7970, 8220, 9078, 9387]","[0, 170, 260, 350, 534, 670, 805, 1058, 1220, 1310, 1832, 1922, 2307, 2401, 2767, 3033, 3280, 3925, 4215, 4387, 4824, 5198, 5550, 6039, 6436, 6646, 6915, 7300, 7802, 8057]",20578,20073,17395,9387,8057,-6248,-6084,-4313,-1212,-1557,-19414,30,dire
7567721608,63,98,43,90,83,"[0, 331, 917, 1404, 1796, 2450, 3007, 3501, 4061, 4317, 4670, 5067, 5427, 6398, 6594, 7198, 8071, 8724, 9178, 10270, 11378, 12082, 12945, 13350, 14401, 14718, 15599, 16426, 17236, 17392]","[0, 364, 761, 1253, 1507, 1956, 2716, 3163, 3550, 4136, 4486, 4719, 5112, 5611, 5968, 6633, 7834, 8256, 8457, 10640, 11383, 12191, 12676, 13452, 13764, 14570, 15437, 16313, 16638, 16957]","[21, 269, 612, 906, 1187, 1613, 1870, 2191, 2449, 2880, 3258, 3631, 4225, 4730, 4910, 5327, 5857, 5952, 6666, 7295, 7647, 8010, 8568, 9398, 9870, 11095, 11527, 12132, 12343, 12981]","[0, 210, 374, 917, 1083, 1190, 1520, 1655, 1745, 1880, 2196, 2357, 2760, 3388, 3522, 3617, 3895, 4141, 4445, 5437, 5745, 5992, 6501, 7219, 7626, 8418, 8594, 8905, 9580, 9924]","[0, 210, 490, 681, 910, 1362, 1618, 1753, 1914, 2049, 2184, 2518, 2741, 3378, 3544, 3639, 4065, 4160, 4255, 4821, 5091, 5258, 5501, 6104, 6444, 6922, 7173, 7343, 7645, 7816]",17392,16957,12981,9924,7816,46,77,45,20,26,"[0, 130, 518, 907, 1364, 1648, 2186, 2548, 3007, 3506, 3963, 4672, 4936, 5951, 7004, 7747, 8407, 9299, 10528, 11653, 12107, 12883, 13785, 14969, 15756, 16351, 16713, 17405, 18484, 19562]","[0, 207, 571, 890, 1486, 1949, 2075, 2708, 3044, 3627, 4120, 4324, 4826, 5868, 6504, 7466, 7953, 8530, 9316, 9983, 10728, 11480, 12124, 12672, 12766, 13062, 13850, 14215, 14973, 15735]","[0, 253, 542, 914, 1316, 1489, 1725, 2126, 2337, 2680, 3115, 3618, 4200, 4706, 5211, 6068, 6952, 7311, 7550, 8175, 8641, 9063, 9366, 9919, 10355, 11212, 11634, 12268, 12796, 13179]","[0, 130, 220, 326, 589, 872, 1261, 1384, 1474, 2032, 2167, 2404, 2539, 3236, 3651, 4089, 4381, 4566, 5017, 5508, 5602, 5767, 6047, 6783, 6952, 7122, 7375, 7833, 8517, 8735]","[0, 130, 220, 560, 776, 911, 1218, 1322, 1517, 1607, 1871, 2218, 2308, 2766, 3137, 3460, 3752, 4017, 4482, 4928, 5236, 5399, 5604, 5955, 6162, 6360, 6794, 6970, 7425, 7808]",19562,15735,13179,8735,7808,-2170,1222,-198,1189,8,51,30,dire
7567823304,14,103,13,63,21,"[0, 372, 761, 1195, 1769, 2253, 2772, 3488, 4068, 4912, 6013, 6103, 6778, 7078, 8310, 8842, 9977, 10473, 10678, 11214, 12183, 12344, 13579, 14760, 15333, 16388, 16844, 17687, 18335, 19004]","[0, 547, 839, 1088, 1684, 2373, 2804, 3122, 3537, 3861, 4322, 4872, 5583, 5879, 7209, 7502, 8472, 8990, 9640, 10269, 10927, 11540, 12176, 12842, 13715, 14459, 14921, 16016, 16600, 17113]","[0, 792, 1044, 1278, 1697, 2070, 2448, 2815, 3114, 3616, 3779, 4381, 4471, 5232, 5956, 6471, 7438, 8051, 8896, 9191, 9366, 10515, 11367, 12273, 13079, 14070, 14773, 15352, 15448, 16320]","[20, 300, 594, 777, 1025, 1581, 1845, 2179, 2397, 2622, 2971, 3242, 3510, 3605, 3929, 4070, 4334, 5075, 5612, 5936, 6625, 6882, 7906, 8681, 9136, 9588, 9717, 11278, 11617, 12215]","[100, 639, 729, 868, 1259, 1504, 1825, 2276, 2501, 3050, 3241, 3510, 4024, 4208, 4657, 4785, 5349, 5700, 6076, 6519, 7069, 7381, 8258, 8821, 9133, 9884, 10119, 10504, 11054, 11150]",19004,17113,16320,12215,11150,113,82,20,51,5,"[0, 364, 649, 1020, 1317, 1540, 2001, 2308, 2730, 3235, 3829, 4465, 5289, 5956, 6439, 6972, 7966, 8941, 9348, 10084, 11281, 12292, 13079, 13281, 14994, 15992, 16895, 17511, 17607, 18187]","[0, 229, 554, 682, 1028, 1414, 1849, 2092, 2480, 2880, 3659, 4204, 5328, 6028, 6757, 7545, 7678, 8892, 9889, 10697, 11924, 12246, 13319, 13519, 13813, 14502, 14879, 14974, 15593, 16650]","[0, 605, 767, 976, 1182, 1272, 1813, 2201, 2513, 2935, 3363, 3805, 4303, 4815, 5141, 5351, 5746, 6082, 6452, 6674, 7268, 7556, 8020, 8452, 8862, 9325, 9827, 11197, 11783, 12778]","[0, 268, 358, 448, 554, 678, 942, 1127, 1673, 1857, 2231, 2469, 3362, 3692, 3888, 4118, 4644, 5040, 5135, 5538, 5702, 5974, 6513, 6788, 7531, 7836, 8334, 9025, 9196, 9652]","[100, 501, 591, 681, 817, 907, 1330, 1923, 2013, 2153, 2379, 2964, 3443, 3787, 4172, 4266, 4788, 5263, 5748, 6353, 7251, 7445, 7990, 8243, 8777, 9007, 9195, 9608, 10336, 10929]",18187,16650,12778,9652,10929,817,463,3542,2563,221,7606,30,radiant
7568258612,120,96,54,86,65,"[0, 213, 540, 937, 1316, 1698, 2101, 2402, 2841, 3528, 4424, 4845, 5810, 6511, 7415, 7821, 8309, 9090, 9675, 10616, 11324, 12010, 12823, 13533, 13628, 14407, 15135, 15766, 16809, 17312]","[0, 216, 508, 958, 1290, 1535, 1955, 2571, 3045, 3459, 3725, 4024, 4672, 5205, 6170, 6264, 7194, 7802, 8329, 9020, 9810, 10262, 11197, 11571, 12406, 12978, 13363, 13834, 13930, 14686]","[0, 199, 563, 722, 1029, 1227, 1575, 2012, 2191, 2428, 2999, 3376, 3925, 4407, 5219, 5629, 6395, 6884, 7596, 8198, 8784, 9318, 9832, 10175, 10639, 10970, 11064, 11159, 11255, 11351]","[0, 129, 222, 312, 402, 492, 582, 948, 1126, 1320, 1575, 1665, 1958, 2244, 2698, 3057, 3437, 3934, 4122, 4431, 4589, 5308, 5953, 6176, 6406, 6573, 7005, 7276, 8101, 8687]","[100, 229, 319, 409, 499, 589, 767, 857, 1127, 1254, 1517, 1607, 2148, 2577, 3077, 3171, 3559, 3921, 4415, 4825, 5489, 5848, 6455, 6648, 7048, 7798, 8262, 8502, 9724, 10040]",17312,14686,11351,8687,10040,39,102,78,123,72,"[0, 321, 687, 1053, 1459, 1800, 2194, 2861, 3277, 3783, 4304, 5238, 5675, 5963, 6206, 7121, 7979, 8074, 8749, 9411, 10317, 10795, 11949, 12715, 14145, 14836, 15594, 17366, 18596, 19475]","[0, 256, 548, 904, 1192, 1670, 1914, 2344, 2921, 3345, 3770, 4248, 4777, 5143, 5738, 6152, 7038, 7407, 7963, 8637, 9438, 10051, 10569, 11157, 11918, 12572, 13520, 14801, 15295, 15641]","[0, 280, 548, 828, 1451, 2034, 2279, 2612, 2996, 3412, 3718, 4204, 4696, 4997, 5813, 6207, 6689, 6936, 7398, 7988, 8228, 8515, 8982, 9220, 10050, 10361, 10925, 11567, 12558, 13283]","[0, 209, 299, 433, 589, 797, 887, 1131, 1346, 1591, 1995, 2313, 2466, 2607, 2860, 3395, 3706, 3849, 4106, 4411, 4751, 5161, 5730, 5847, 6434, 6604, 7354, 8162, 8656, 8752]","[0, 209, 316, 485, 575, 1024, 1236, 1416, 1906, 1996, 2219, 3028, 3181, 3392, 3700, 4015, 4326, 4495, 4655, 4904, 5121, 5319, 5620, 5844, 6383, 6529, 6989, 8013, 8686, 8782]",19475,15641,13283,8752,8782,-2163,-955,-1932,-65,1258,-3857,30,dire
7568353308,4,22,69,110,121,"[0, 204, 561, 915, 1403, 1790, 2248, 2679, 3018, 3163, 3465, 3895, 4582, 5018, 5757, 6387, 6862, 7433, 8163, 8845, 9679, 10294, 10691, 12334, 13129, 13668, 14316, 15068, 15802, 16295]","[0, 326, 723, 1046, 1453, 1780, 2194, 2706, 2988, 3420, 4181, 4491, 5034, 5492, 6375, 6479, 7122, 7823, 8097, 9051, 9789, 10043, 10306, 10994, 11327, 11924, 12146, 12240, 12748, 12967]","[0, 206, 333, 423, 634, 1050, 1140, 1266, 1737, 2199, 2581, 2765, 3665, 4155, 4363, 4667, 5147, 5592, 6264, 6840, 8372, 8627, 9208, 10095, 10591, 11069, 11324, 11522, 11817, 12132]","[0, 170, 260, 417, 555, 896, 1776, 1866, 2213, 2498, 2623, 3109, 3508, 3773, 4120, 4217, 4477, 4913, 5464, 5559, 5978, 6586, 6866, 7554, 8003, 8222, 8317, 8411, 8646, 8787]","[0, 170, 260, 422, 512, 788, 1136, 1226, 1360, 1495, 1748, 1885, 2335, 2484, 2867, 3071, 3587, 3691, 4222, 4645, 5682, 5956, 6182, 6990, 7266, 7473, 7643, 8089, 8475, 8781]",16295,12967,12132,8787,8781,21,120,129,53,136,"[0, 251, 864, 1647, 2173, 2614, 3224, 3865, 4392, 4517, 5611, 6303, 6843, 7293, 8064, 8572, 9695, 10158, 11227, 11819, 12584, 12679, 13482, 13872, 14705, 15581, 16743, 17789, 18563, 19131]","[0, 329, 682, 1095, 1548, 1923, 2525, 2828, 3700, 4182, 5106, 5776, 6095, 6707, 7388, 8095, 8252, 9014, 10058, 10955, 12313, 12808, 13523, 13759, 14437, 15214, 15750, 16868, 17501, 17828]","[0, 274, 585, 746, 914, 1294, 1747, 2118, 2600, 3206, 3751, 3985, 4237, 4484, 5052, 5429, 6115, 6970, 7847, 8380, 8935, 9030, 9698, 10063, 10720, 11186, 11617, 12831, 13400, 13706]","[0, 170, 344, 591, 776, 1128, 1567, 1930, 2284, 2507, 3313, 3916, 4208, 4467, 4719, 5006, 5576, 5901, 6744, 7512, 8058, 8153, 8592, 9075, 9717, 10226, 11383, 12127, 12549, 12845]","[0, 170, 673, 921, 1106, 1444, 1718, 1853, 2110, 2200, 2452, 2770, 2933, 3241, 3640, 3735, 4517, 4722, 5424, 5681, 6512, 7029, 7394, 7634, 7779, 8035, 8466, 9346, 9885, 10261]",19131,17828,13706,12845,10261,-2836,-4861,-1574,-4058,-1480,-14809,30,dire
7568433407,114,71,2,123,121,"[62, 303, 502, 703, 912, 1283, 1578, 2057, 2457, 2835, 3689, 4158, 4573, 4810, 5385, 5840, 6416, 6910, 7570, 8383, 8996, 9469, 9699, 10034, 10646, 11588, 12775, 13251, 14319, 14842]","[60, 353, 667, 914, 1078, 1293, 1706, 2235, 2574, 2916, 3839, 4144, 4789, 5350, 5711, 6249, 7161, 7346, 7755, 8226, 8408, 8675, 9242, 9662, 10040, 10262, 10744, 11158, 11836, 12279]","[328, 534, 880, 1105, 1338, 1743, 2326, 2873, 3267, 3471, 4127, 4845, 5271, 5668, 6156, 6895, 7560, 7844, 8281, 8745, 9213, 9969, 10575, 10814, 11088, 11527, 13190, 13641, 14184, 14280]","[60, 229, 319, 615, 705, 1070, 1324, 1586, 1721, 2113, 2332, 2737, 3087, 3430, 3961, 4359, 4731, 5256, 5580, 6079, 6209, 6520, 6785, 7034, 7376, 7870, 8956, 9279, 9990, 10086]","[60, 229, 337, 472, 664, 895, 1032, 1744, 2014, 2220, 2662, 2904, 3200, 3386, 3550, 3744, 4261, 4356, 4885, 5197, 5292, 5484, 5650, 5828, 6369, 6536, 7695, 8095, 8473, 8569]",14842,12279,14280,10086,8569,63,65,29,100,79,"[0, 250, 559, 876, 1232, 1445, 1689, 2003, 2317, 2726, 3299, 3389, 3817, 4348, 4745, 5159, 5603, 5875, 6401, 6819, 7872, 8348, 9029, 9792, 10634, 11138, 11407, 12419, 13134, 13929]","[0, 274, 562, 894, 1173, 1543, 2070, 2501, 2942, 3350, 3566, 3829, 4225, 4392, 4764, 5407, 5838, 6343, 6778, 7677, 8078, 8739, 9024, 9504, 10784, 11833, 12256, 12556, 13157, 13627]","[0, 169, 375, 704, 1154, 1591, 1911, 2261, 2652, 2742, 2926, 3253, 3540, 4242, 4692, 5466, 5665, 6249, 6663, 7277, 7647, 8082, 8546, 9025, 9587, 10268, 10733, 10914, 11390, 11675]","[0, 169, 259, 435, 565, 703, 793, 883, 1060, 1430, 1520, 1610, 1700, 2002, 2143, 2328, 2602, 2697, 2883, 3041, 3136, 3566, 3749, 4453, 5313, 5902, 6543, 6847, 7169, 7265]","[0, 169, 259, 397, 572, 799, 972, 1325, 1425, 1622, 2027, 2117, 2207, 2614, 2985, 3205, 3691, 3933, 4374, 4744, 4839, 5111, 5388, 5865, 6675, 7128, 7382, 7477, 7654, 7875]",13929,13627,11675,7265,7875,913,-1348,2605,2821,694,5685,30,dire
7568469704,93,97,47,19,112,"[0, 237, 582, 791, 1116, 1447, 1748, 1924, 2246, 2573, 2875, 3262, 3543, 4185, 4666, 5398, 6104, 6653, 7354, 8167, 9580, 10191, 10733, 11677, 12495, 13374, 13989, 14907, 15086, 15866]","[0, 316, 720, 965, 1263, 1586, 1808, 1993, 2370, 2645, 2998, 3444, 4426, 4824, 5085, 5594, 6019, 6584, 7005, 7163, 7693, 8176, 8353, 8930, 9334, 9868, 10223, 10901, 11200, 12020]","[0, 268, 495, 831, 1171, 1460, 1901, 2266, 2735, 2825, 3034, 3859, 4213, 4437, 4995, 5533, 5926, 6335, 6701, 7167, 7647, 8407, 8669, 8809, 8904, 9241, 9688, 10708, 10970, 11728]","[0, 194, 434, 524, 625, 760, 1094, 1184, 1681, 1855, 1975, 2218, 2512, 2813, 3424, 3938, 4339, 4684, 4994, 5152, 5859, 6278, 6791, 6886, 6981, 7358, 7686, 8410, 8506, 9278]","[0, 194, 284, 485, 623, 774, 864, 1069, 1375, 1534, 1754, 2042, 2205, 2457, 2718, 2896, 3054, 3326, 3420, 3712, 4479, 4911, 5015, 5255, 5447, 5717, 6244, 6339, 6435, 6924]",15866,12020,11728,9278,6924,102,76,96,121,26,"[0, 205, 1023, 1149, 1681, 1914, 2280, 2889, 3346, 3644, 4123, 4786, 5300, 6149, 6567, 7095, 7698, 8662, 9042, 9541, 9699, 10547, 11774, 12705, 13385, 13926, 14763, 15644, 15831, 16331]","[0, 285, 571, 734, 1023, 1156, 1400, 1672, 2017, 2587, 2945, 3331, 3791, 4336, 4897, 5567, 6243, 6937, 7802, 8367, 9032, 9809, 9975, 11398, 12262, 12888, 14000, 14548, 14739, 15886]","[0, 244, 605, 1045, 1505, 1795, 2188, 2770, 3147, 3631, 3934, 4298, 4864, 5445, 5847, 6352, 6799, 7279, 7894, 8160, 8426, 8658, 9273, 9741, 10243, 10685, 11032, 12049, 12145, 12736]","[0, 169, 259, 488, 672, 795, 977, 1293, 1716, 1892, 2378, 2468, 2793, 3080, 3282, 3553, 4067, 4351, 5208, 5686, 5844, 6245, 6635, 7254, 7548, 7753, 8060, 8526, 8735, 9212]","[0, 169, 540, 634, 844, 934, 1113, 1293, 1453, 1629, 1747, 1837, 2017, 2179, 2286, 2972, 3153, 3635, 4284, 4528, 4686, 5139, 5567, 6035, 6733, 6977, 7284, 7456, 7552, 7945]",16331,15886,12736,9212,7945,-465,-3866,-1008,66,-1021,-6294,30,radiant
7568521109,82,76,33,51,83,"[0, 323, 880, 1380, 1620, 2277, 2680, 3184, 3879, 4884, 5532, 5925, 6918, 7445, 8321, 9010, 9878, 10777, 11597, 11925, 12497, 13173, 14124, 14745, 15310, 15924, 17324, 18709, 19545, 20077]","[0, 372, 700, 981, 1437, 1838, 2393, 2904, 3401, 3956, 4272, 4840, 5356, 5760, 6218, 6398, 7237, 7814, 8492, 9039, 9610, 9811, 10577, 11269, 11808, 12264, 13226, 14303, 15195, 15463]","[0, 286, 567, 900, 1185, 1412, 1722, 2011, 2236, 2801, 2967, 3608, 4223, 4973, 5461, 6233, 6684, 7243, 7738, 8056, 8980, 9949, 10813, 11132, 11506, 12130, 12555, 13139, 13789, 14156]","[0, 250, 340, 492, 582, 883, 1095, 1399, 1579, 1951, 2459, 2654, 3025, 3626, 3810, 4187, 4526, 5091, 5333, 6257, 6661, 7399, 8481, 9058, 9153, 9715, 10504, 11476, 12123, 12439]","[100, 350, 550, 791, 881, 1033, 1183, 1566, 1827, 2394, 2802, 3099, 3426, 3696, 4116, 4392, 4660, 5085, 5348, 5515, 5756, 5968, 6360, 6609, 6704, 6947, 7569, 8055, 8443, 8752]",20077,15463,14156,12439,8752,72,98,137,121,100,"[19, 255, 470, 796, 1411, 1667, 2106, 2938, 3276, 3556, 3745, 4259, 4946, 5561, 6244, 7073, 7711, 7985, 8833, 9797, 10365, 11385, 12389, 13090, 14190, 14460, 15279, 15374, 15764, 16580]","[0, 235, 372, 706, 954, 1205, 1462, 1766, 2178, 2506, 2949, 3809, 4105, 4374, 4652, 4950, 5319, 5751, 6189, 7305, 7540, 8284, 8655, 9540, 10016, 10711, 10917, 11012, 11527, 11905]","[19, 222, 460, 638, 1126, 1535, 2048, 2382, 3223, 3521, 4390, 4860, 4961, 5068, 5549, 6038, 6133, 6227, 6923, 7473, 8007, 8381, 8566, 9261, 9958, 10197, 10964, 11176, 11520, 12102]","[0, 432, 573, 663, 802, 927, 1129, 1308, 1893, 2032, 2322, 2619, 2773, 2903, 2997, 3222, 3486, 3990, 4246, 5435, 5530, 5775, 5960, 6328, 6648, 6815, 6910, 7170, 7420, 7516]","[0, 164, 254, 344, 575, 665, 847, 1260, 1485, 1575, 1710, 2146, 2284, 2709, 2803, 2898, 2993, 3284, 3540, 3942, 4037, 4282, 4467, 4562, 4882, 5121, 5216, 5311, 5407, 5503]",16580,11905,12102,7516,5503,3497,3558,2054,4923,3249,17281,30,radiant
7568521216,41,128,47,19,112,"[0, 618, 780, 1177, 1373, 1834, 2032, 2715, 3189, 3439, 3615, 4140, 4944, 5386, 5590, 6154, 6804, 7429, 7814, 8443, 8573, 8909, 11387, 12124, 12939, 13553, 14272, 15366, 16379, 17057]","[0, 374, 720, 1122, 1284, 1751, 2198, 3095, 3185, 3814, 3904, 4537, 5128, 5580, 6233, 6373, 6804, 7175, 7805, 7985, 8628, 8894, 9252, 9842, 10511, 10902, 11517, 12209, 13373, 13878]","[0, 247, 483, 731, 903, 1029, 1365, 1949, 2039, 2241, 2571, 3084, 3486, 3911, 4464, 5311, 6153, 6892, 7544, 7702, 8273, 8738, 9989, 10270, 11048, 11515, 12020, 13096, 13785, 14417]","[0, 210, 300, 481, 571, 756, 893, 1193, 1516, 1606, 1696, 2080, 2682, 2878, 2973, 3246, 3449, 3761, 4023, 4553, 4693, 4877, 5916, 6405, 6882, 7159, 7309, 7711, 8557, 8734]","[0, 273, 397, 534, 624, 759, 849, 1301, 1624, 1889, 1979, 2311, 2876, 3344, 3582, 3902, 4220, 4488, 4673, 4831, 5279, 5606, 6337, 6432, 6634, 6806, 7166, 7568, 8028, 8258]",17057,13878,14417,8734,8258,21,96,137,45,26,"[0, 167, 467, 870, 1272, 1726, 2048, 2261, 2828, 3336, 3847, 4363, 4979, 5332, 5909, 6738, 7619, 8397, 9076, 10042, 11430, 12663, 13092, 13515, 13977, 15027, 15833, 16437, 16533, 17266]","[0, 130, 374, 656, 1101, 1420, 1840, 2050, 2628, 2973, 3338, 3652, 4128, 4319, 4971, 5421, 5877, 6465, 6835, 7636, 7893, 8380, 8591, 8932, 9479, 10083, 10517, 11058, 11892, 12396]","[0, 285, 546, 921, 1499, 1661, 2026, 2116, 3046, 3516, 4306, 5066, 5231, 5422, 5617, 6062, 7294, 7759, 8471, 9113, 9670, 10127, 10551, 11062, 11537, 11881, 12472, 12850, 12946, 13639]","[0, 180, 270, 406, 581, 727, 866, 956, 1323, 1452, 1773, 2015, 2345, 2860, 3719, 4121, 4671, 5207, 5851, 6560, 6870, 7078, 7455, 7834, 8264, 9042, 9883, 10148, 10319, 10586]","[0, 130, 220, 310, 488, 626, 799, 889, 1191, 1449, 1632, 2017, 2107, 2201, 2620, 3158, 3413, 3660, 3951, 4665, 4947, 5117, 5403, 5801, 6144, 6678, 7205, 7544, 7715, 8332]",17266,12396,13639,10586,8332,-209,1482,778,-1852,-74,125,30,dire
7568606319,10,69,17,58,26,"[0, 220, 459, 964, 1419, 1798, 2168, 2321, 2614, 3168, 3641, 4085, 5066, 5466, 6214, 6908, 7979, 8735, 9427, 10227, 11648, 12279, 13322, 14217, 14658, 15809, 16534, 17344, 18535, 19603]","[0, 314, 571, 994, 1283, 1572, 1900, 2222, 2593, 2927, 3347, 4133, 4590, 5604, 6066, 6951, 7562, 8060, 8709, 10034, 10614, 11612, 12677, 13291, 14140, 15279, 16481, 17317, 18472, 18620]","[0, 289, 611, 979, 1398, 1842, 2473, 2817, 3362, 3542, 3694, 4121, 5070, 5553, 6115, 6566, 7133, 8214, 8925, 9689, 10402, 11685, 12299, 13122, 13644, 14463, 14781, 15685, 16800, 17444]","[0, 170, 260, 394, 590, 680, 1131, 1393, 1587, 1722, 1865, 2102, 2570, 2768, 3216, 3556, 3876, 4117, 4506, 4684, 5260, 5470, 5847, 6423, 6710, 6967, 7108, 7574, 7930, 8366]","[100, 515, 605, 806, 936, 1112, 1406, 1544, 1690, 1814, 2106, 2373, 3064, 3213, 3685, 3881, 4422, 4598, 5008, 5103, 5459, 5669, 6052, 6388, 6577, 6902, 7105, 7573, 7831, 8083]",19603,18620,17444,8366,8083,49,25,96,121,51,"[0, 328, 612, 907, 1387, 1824, 2204, 2535, 3160, 3975, 4477, 5085, 5570, 6195, 6815, 7282, 7843, 8815, 9665, 10640, 11081, 11277, 12094, 13418, 14256, 15126, 15807, 17136, 17887, 19379]","[0, 584, 1100, 1425, 1747, 2108, 2649, 3110, 3627, 4051, 4408, 4902, 5414, 6142, 6966, 7373, 7932, 8701, 9076, 9930, 10586, 11181, 11992, 12473, 13469, 14444, 15106, 15683, 16321, 16752]","[0, 240, 636, 807, 1138, 1431, 1912, 2685, 2980, 3336, 3793, 4211, 4385, 5172, 5395, 5583, 6152, 6481, 7158, 7740, 7926, 8371, 9156, 9635, 9747, 10556, 10650, 11119, 11381, 12017]","[0, 170, 260, 350, 506, 640, 999, 1178, 1279, 1514, 1994, 2174, 2353, 2640, 2955, 3280, 3482, 3661, 3923, 4361, 4456, 4609, 4850, 5532, 5702, 6055, 6555, 7088, 7501, 8655]","[0, 239, 402, 538, 719, 817, 1141, 1403, 1542, 1905, 2165, 2385, 2536, 2819, 2913, 3008, 3187, 3324, 3418, 3783, 3878, 3995, 4209, 4775, 4880, 5516, 5907, 6238, 6735, 7894]",19379,16752,12017,8655,7894,224,1868,5427,-289,189,7419,30,radiant
7568781105,46,41,137,65,26,"[608, 1057, 1456, 1872, 2294, 2630, 3083, 3717, 4433, 5524, 5778, 6593, 7253, 7899, 8689, 9284, 10178, 11120, 12363, 13020, 13743, 14489, 15192, 16173, 16819, 17295, 18120, 19042, 19581, 20105]","[493, 846, 1214, 1615, 1865, 2208, 2582, 3020, 3503, 4244, 4706, 5168, 5826, 6265, 6932, 7869, 8227, 8799, 9110, 9750, 10518, 11446, 12357, 13388, 14088, 14289, 14520, 14727, 15499, 16248]","[533, 843, 1537, 1803, 2370, 2875, 3640, 3971, 4640, 5344, 5509, 6544, 6780, 7296, 7749, 7945, 8718, 9243, 10179, 10456, 10963, 11276, 11517, 12432, 12527, 12772, 13542, 13996, 14425, 14785]","[260, 350, 485, 580, 914, 1233, 1460, 1751, 2015, 2540, 2630, 3031, 3512, 3828, 4092, 4680, 5286, 5726, 6055, 6413, 6868, 7465, 7940, 9064, 9434, 9895, 10201, 10602, 11095, 11270]","[260, 395, 547, 637, 866, 1046, 1204, 1343, 1632, 2127, 2217, 2501, 2795, 2985, 3421, 3627, 3955, 4280, 4955, 5144, 5633, 5974, 6144, 6604, 6820, 7377, 7939, 8110, 8580, 9068]",20105,16248,14785,11270,9068,1,13,97,123,110,"[517, 642, 967, 1284, 1542, 1838, 2124, 2371, 2646, 3035, 3814, 4524, 5199, 5730, 6452, 7321, 7951, 8400, 9733, 10605, 11697, 12243, 12873, 13902, 14928, 15507, 16907, 17850, 18705, 19585]","[555, 926, 1141, 1489, 1819, 2032, 2484, 3126, 3559, 3952, 4527, 5201, 6036, 6577, 7148, 7530, 8170, 8565, 8985, 9487, 10277, 10584, 10969, 11616, 11910, 12231, 12817, 13384, 14000, 14961]","[528, 766, 1053, 1530, 1833, 2122, 2547, 3217, 3627, 4332, 4553, 5203, 5533, 6167, 6795, 7486, 7908, 8261, 8522, 8834, 9369, 9972, 10291, 10839, 11116, 11233, 11829, 12365, 12894, 13473]","[260, 387, 477, 726, 1468, 1637, 1727, 1817, 1955, 2290, 2499, 3015, 3261, 3655, 4061, 4526, 4878, 5281, 6208, 6477, 6872, 7625, 7830, 8178, 8524, 9202, 10067, 10330, 10643, 10977]","[312, 402, 492, 622, 770, 918, 1033, 1161, 1289, 1564, 1790, 2019, 2194, 2403, 2865, 2980, 3075, 3384, 3922, 4103, 4360, 4655, 4950, 5064, 5393, 5823, 6009, 6191, 6312, 6646]",19585,14961,13473,10977,6646,520,1287,1312,293,2422,5834,30,dire
7568789619,94,29,106,123,68,"[0, 416, 630, 921, 1212, 1378, 1586, 1844, 2062, 2361, 2960, 3462, 3815, 4634, 5345, 5971, 6554, 7354, 8614, 9632, 10641, 11507, 12682, 13332, 14103, 14896, 15798, 16487, 17612, 19111]","[0, 288, 697, 1159, 1535, 2110, 2650, 3193, 3789, 4283, 5184, 5402, 5492, 6204, 6559, 7277, 7953, 8853, 9348, 9697, 10319, 11124, 12444, 13022, 13419, 13901, 14121, 14716, 15706, 16113]","[0, 170, 374, 769, 1084, 1342, 1669, 2080, 2736, 3356, 3876, 4128, 4491, 4786, 5162, 5483, 6023, 7160, 7832, 8531, 9324, 9735, 10521, 11306, 11536, 12367, 12717, 12903, 13546, 13845]","[100, 346, 436, 653, 743, 1089, 1228, 1318, 1707, 2003, 2347, 2523, 3024, 3555, 4090, 4185, 4411, 5175, 5871, 6078, 6833, 7153, 8129, 8844, 9399, 10108, 10328, 10567, 10932, 11556]","[0, 284, 374, 591, 745, 1162, 1252, 1348, 1692, 1925, 2269, 2422, 2609, 2899, 3171, 3340, 3435, 4035, 4423, 4581, 4806, 5258, 6316, 6881, 7111, 7459, 7721, 7960, 8532, 8923]",19111,16113,13845,11556,8923,41,49,47,19,58,"[0, 205, 495, 854, 1271, 1742, 2330, 2733, 3272, 3812, 4344, 4868, 5691, 6340, 6698, 7609, 8244, 8889, 9640, 10805, 11639, 12476, 12643, 13002, 13866, 14332, 14991, 15745, 17012, 17577]","[0, 251, 508, 722, 1081, 1257, 1944, 2532, 3238, 3689, 4002, 4405, 5112, 5433, 5955, 6430, 7310, 7707, 8232, 8999, 9591, 10461, 11423, 12516, 13019, 14143, 14597, 15070, 16764, 17540]","[0, 272, 430, 826, 1122, 1589, 1810, 2297, 2557, 2852, 3123, 3338, 3832, 4495, 4671, 5176, 5663, 5990, 7066, 7848, 8405, 8696, 8863, 9128, 9514, 10275, 10800, 11613, 12305, 12681]","[100, 570, 828, 1268, 1406, 1737, 1827, 2031, 2440, 2530, 2710, 2865, 3438, 3774, 4006, 4379, 4567, 4908, 5086, 6052, 6388, 6482, 6649, 7114, 7625, 7919, 8124, 8740, 9637, 10194]","[0, 571, 661, 879, 1033, 1123, 1422, 1663, 1942, 2139, 2603, 2796, 3246, 3689, 3931, 4227, 4454, 4548, 4688, 5288, 5659, 6282, 6449, 6579, 6861, 7777, 8317, 9137, 9696, 9892]",17577,17540,12681,10194,9892,1534,-1427,1164,1362,-969,1664,30,radiant
7569025607,21,74,112,85,7,"[0, 169, 440, 875, 1064, 1601, 1967, 2422, 2718, 3249, 3615, 3967, 4956, 5443, 5818, 6642, 7209, 7924, 8587, 9441, 10029, 10345, 11000, 11683, 12077, 13476, 14645, 14890, 16385, 17094]","[0, 243, 536, 731, 1000, 1595, 2003, 2389, 2762, 3222, 3564, 4273, 4905, 5425, 6015, 6441, 6982, 7506, 8285, 8869, 9179, 9790, 10350, 10609, 11382, 12371, 13118, 13400, 14776, 15362]","[0, 205, 295, 665, 755, 1246, 1617, 1954, 2183, 2769, 3020, 3764, 4335, 4936, 5614, 6333, 6884, 7766, 8956, 9657, 9994, 10471, 10701, 11053, 11417, 11801, 12434, 13102, 14236, 15205]","[0, 130, 220, 798, 888, 1484, 1714, 2189, 2279, 2820, 3036, 3246, 3946, 4219, 4664, 5060, 5351, 5782, 6553, 7616, 8015, 8110, 8687, 9157, 9588, 10063, 10775, 10922, 12009, 12348]","[0, 130, 220, 349, 456, 763, 898, 1033, 1157, 1569, 1704, 2083, 2531, 2814, 3197, 3474, 3867, 4560, 4891, 5787, 6192, 6287, 6517, 6887, 7200, 7858, 8493, 8640, 9721, 10267]",17094,15362,15205,12348,10267,126,15,96,27,26,"[0, 367, 643, 1012, 1373, 1621, 1950, 2209, 2669, 3203, 3626, 3904, 4262, 4448, 4543, 4796, 5174, 5392, 5753, 6448, 6963, 8285, 9063, 9800, 9950, 10614, 11838, 12051, 12963, 14018]","[0, 170, 368, 496, 694, 1040, 1355, 1648, 2197, 2565, 3193, 3365, 3863, 4198, 5215, 5610, 6032, 6446, 7045, 7662, 8108, 8203, 8821, 9113, 9445, 9744, 10177, 10943, 12285, 13038]","[0, 204, 444, 724, 973, 1108, 1531, 1655, 2025, 2288, 2548, 2816, 2951, 3100, 3435, 3583, 3895, 4092, 4671, 5098, 5298, 5940, 6525, 6918, 7670, 8089, 8611, 8778, 8919, 9810]","[0, 170, 260, 350, 440, 530, 667, 792, 1066, 1347, 1485, 1575, 1665, 1977, 2154, 2248, 2343, 2438, 2533, 2890, 2985, 3117, 3284, 3378, 3473, 4214, 4347, 4441, 5600, 6030]","[0, 213, 303, 393, 521, 655, 793, 883, 1150, 1334, 1617, 1735, 1825, 1974, 2118, 2212, 2345, 2440, 2535, 2927, 3022, 3376, 3543, 3637, 3894, 4185, 4693, 4824, 5707, 5803]",14018,13038,9810,6030,5803,3076,2324,5395,6318,4464,21577,30,radiant
7569050306,41,13,97,50,87,"[0, 241, 589, 986, 1403, 1770, 2134, 2521, 2924, 3181, 3425, 3913, 4496, 4782, 5179, 6101, 6680, 7511, 8088, 8875, 10039, 10543, 11055, 11448, 12304, 14132, 14739, 15484, 15962, 16610]","[0, 169, 503, 826, 1096, 1351, 1646, 2092, 2419, 2672, 2919, 3120, 3946, 4397, 5481, 6301, 6484, 6732, 7123, 7675, 7860, 8038, 8249, 8689, 9176, 9566, 9854, 10276, 10539, 11073]","[0, 320, 448, 794, 1328, 1812, 2352, 3082, 3326, 3739, 4156, 4380, 4638, 5119, 5573, 5942, 6278, 6570, 6712, 7318, 7548, 7726, 8095, 8429, 8853, 9653, 10023, 10828, 11390, 11961]","[0, 169, 259, 427, 552, 876, 966, 1104, 1263, 1353, 1849, 2022, 2382, 2631, 3288, 3604, 3968, 4261, 4669, 5010, 5415, 5709, 5920, 6114, 6433, 7645, 8454, 8694, 8943, 9195]","[0, 169, 272, 452, 621, 794, 1101, 1428, 1518, 1675, 1765, 1960, 2320, 2628, 3014, 3385, 3568, 3816, 3957, 4226, 4411, 4625, 4836, 5197, 5292, 6027, 6211, 6306, 6402, 6579]",16610,11073,11961,9195,6579,113,102,81,40,27,"[0, 326, 526, 951, 1617, 1958, 2299, 2706, 3037, 3731, 4092, 4218, 5381, 6264, 6359, 7101, 7625, 8034, 8925, 9519, 9801, 9896, 11768, 12147, 12639, 13168, 13934, 14445, 15358, 16217]","[0, 208, 470, 693, 1012, 1409, 1556, 1782, 1987, 2179, 2269, 2619, 3209, 3919, 4077, 5129, 5591, 6045, 6400, 6892, 7384, 7479, 9110, 9638, 10224, 10823, 11390, 12027, 12639, 13203]","[0, 204, 425, 784, 914, 1125, 1574, 1830, 2269, 2645, 2894, 3144, 3519, 3986, 4343, 4933, 5302, 5493, 5960, 6537, 7099, 7266, 8651, 9200, 9659, 10628, 10929, 11253, 11638, 12107]","[0, 169, 259, 395, 559, 748, 883, 1066, 1294, 1431, 1608, 1698, 2568, 2753, 2848, 3314, 3509, 3604, 3836, 4274, 4423, 4593, 5515, 5682, 6011, 6453, 6731, 6826, 7138, 7516]","[0, 169, 259, 459, 634, 805, 895, 1030, 1159, 1306, 1537, 1790, 2042, 2790, 2885, 3386, 3544, 3805, 4034, 4191, 4336, 4431, 5435, 5616, 5711, 5940, 6416, 6511, 6823, 6948]",16217,13203,12107,7516,6948,393,-2130,-146,1679,-369,-573,30,dire
7569069818,25,63,28,20,31,"[0, 291, 875, 1409, 1895, 2146, 2702, 3413, 3946, 4666, 5604, 6378, 7244, 8273, 8983, 9940, 10596, 11017, 11788, 12643, 14026, 15164, 15527, 16828, 17440, 17534, 17966, 18611, 19341, 19999]","[0, 286, 569, 810, 1100, 1371, 1820, 2378, 2540, 3066, 3651, 3991, 4375, 5050, 5690, 6248, 6548, 7149, 7818, 8312, 8920, 9853, 10236, 11178, 11683, 11958, 12438, 13150, 13470, 13949]","[0, 205, 587, 786, 1328, 1453, 1891, 2312, 3070, 3601, 4294, 4921, 5279, 6047, 6591, 7083, 7498, 8258, 8595, 9296, 9978, 10724, 11285, 11445, 11996, 12339, 12923, 13177, 13273, 13526]","[0, 130, 384, 474, 949, 1155, 1846, 2120, 2545, 3014, 3431, 3767, 4292, 4685, 5048, 5564, 5984, 6429, 6689, 7218, 7487, 7864, 8212, 8539, 8731, 8825, 9055, 9357, 9797, 10385]","[0, 130, 220, 358, 488, 578, 1208, 1433, 1634, 1724, 2141, 2637, 2877, 3225, 3373, 4005, 4428, 4709, 4969, 5263, 5568, 5945, 6128, 6571, 6867, 6961, 7191, 7493, 7589, 7685]",19999,13949,13526,10385,7685,93,13,102,107,30,"[0, 210, 373, 987, 1165, 1542, 1737, 1976, 2976, 3145, 3271, 3716, 3944, 4354, 4948, 5287, 5491, 5620, 6125, 6629, 6724, 8141, 8484, 9000, 11195, 12080, 13090, 14341, 15091, 15187]","[0, 321, 611, 854, 1225, 1507, 1672, 1957, 2283, 2864, 3098, 3622, 3819, 4402, 4638, 4886, 5296, 5391, 5590, 5794, 5982, 6431, 6737, 7328, 10062, 11277, 12333, 13563, 14809, 15367]","[0, 247, 411, 617, 937, 1139, 1435, 1602, 2103, 2316, 2742, 3179, 3303, 3485, 3656, 4101, 4196, 4422, 4551, 4646, 4920, 5236, 5464, 5826, 6262, 7023, 7993, 8912, 9519, 9795]","[0, 269, 359, 479, 666, 756, 846, 1271, 1659, 1943, 2033, 2339, 2429, 2795, 2936, 3184, 3279, 3423, 3648, 3780, 3988, 4630, 4942, 5386, 6215, 6925, 7596, 9200, 9773, 10083]","[0, 537, 627, 821, 911, 1049, 1401, 1601, 1840, 1969, 2093, 2238, 2328, 2563, 2811, 3059, 3154, 3286, 3380, 3513, 3692, 4103, 4197, 4645, 5047, 5357, 6028, 6301, 6696, 6878]",15187,15367,9795,10083,6878,4812,-1418,3731,302,807,8234,30,radiant
7569216703,120,21,96,79,20,"[63, 309, 573, 929, 1341, 1735, 2065, 2509, 2931, 3469, 3559, 3874, 4565, 5025, 5800, 6100, 6641, 7448, 8011, 8711, 9170, 9457, 10398, 11031, 11645, 12622, 13612, 14995, 15304, 16000]","[63, 233, 514, 968, 1333, 1985, 2202, 2678, 3120, 3518, 3955, 4429, 5261, 5767, 6485, 6978, 7546, 8340, 8732, 9424, 10085, 10738, 11345, 12147, 12609, 12804, 13289, 14390, 14900, 15921]","[63, 277, 402, 724, 1242, 1366, 1583, 1952, 2299, 2666, 3445, 3973, 4226, 5017, 5839, 6101, 6764, 7887, 8610, 8968, 9512, 10052, 10570, 10916, 11210, 12388, 12823, 13950, 14046, 14418]","[331, 501, 591, 916, 1172, 1262, 1709, 2276, 2366, 2658, 2843, 3014, 3325, 3783, 3970, 4109, 4562, 4657, 5536, 5982, 6492, 6745, 6839, 7305, 7492, 8227, 8321, 9071, 9167, 9312]","[63, 278, 414, 551, 721, 960, 1050, 1251, 1341, 1746, 1931, 2319, 2409, 2594, 2833, 2963, 3219, 3314, 3660, 3979, 4200, 4430, 4664, 4989, 5084, 5672, 5766, 6178, 6524, 6620]",16000,15921,14418,9312,6620,48,13,69,58,119,"[0, 170, 445, 694, 1110, 1527, 1790, 1985, 2535, 3028, 3471, 3851, 4597, 5361, 5735, 6175, 7433, 8176, 8952, 10265, 11155, 12311, 12721, 13628, 15014, 15700, 16128, 17342, 17871, 18666]","[0, 327, 646, 1062, 1295, 1671, 2033, 2414, 2704, 3202, 3834, 4334, 4757, 5375, 5976, 6247, 6729, 7004, 8154, 8459, 9062, 9882, 10341, 10574, 11379, 12195, 13167, 14829, 15909, 16595]","[0, 170, 688, 934, 1186, 1315, 1883, 2118, 2428, 2669, 2996, 3620, 4020, 4685, 5448, 6083, 6560, 7273, 7976, 8549, 9264, 9795, 10198, 10835, 11343, 12420, 12953, 13475, 14023, 14933]","[0, 172, 262, 400, 537, 914, 1300, 1390, 1565, 1655, 2284, 2613, 2930, 3575, 3753, 4180, 4799, 5145, 5886, 6411, 6628, 7202, 7296, 7484, 7977, 8505, 8599, 9275, 9633, 10112]","[0, 170, 414, 504, 594, 684, 774, 864, 954, 1044, 1384, 1611, 1823, 2250, 2431, 2580, 2936, 3211, 3562, 3867, 3962, 4147, 4241, 4446, 4851, 5384, 5478, 6096, 6828, 7030]",18666,16595,14933,10112,7030,-2666,-674,-515,-800,-410,-5065,30,dire
7569457300,94,17,137,105,58,"[2, 362, 646, 1006, 1293, 1821, 2260, 2522, 2916, 3293, 3660, 4244, 5080, 5713, 6563, 7272, 8178, 8947, 10074, 11024, 12160, 13398, 14055, 14202, 15070, 16234, 16397, 17628, 18713, 19305]","[0, 403, 766, 1104, 1515, 1861, 2489, 2816, 3292, 3637, 4210, 4764, 5069, 5627, 5957, 6789, 7517, 7985, 8176, 8866, 9334, 10014, 10703, 11235, 11780, 12517, 12988, 13267, 13660, 14041]","[0, 249, 569, 825, 1067, 1357, 1814, 2310, 2779, 3309, 3861, 3951, 4438, 4752, 5263, 5684, 6004, 6314, 6818, 7123, 7552, 7809, 8066, 8160, 8505, 8677, 9001, 9272, 9417, 9627]","[0, 210, 339, 429, 519, 662, 992, 1127, 1300, 1390, 1525, 1997, 2087, 2333, 2704, 3390, 3667, 3876, 4118, 4969, 5127, 5384, 5761, 5855, 5950, 6045, 6176, 6516, 6805, 7004]","[0, 212, 302, 392, 498, 681, 1095, 1230, 1560, 1717, 1921, 2297, 2424, 2760, 2901, 3049, 3261, 3395, 3647, 4080, 4287, 4808, 5154, 5486, 5581, 5736, 5831, 6004, 6100, 6395]",19305,14041,9627,7004,6395,89,49,28,65,121,"[0, 502, 769, 1126, 1715, 2222, 2745, 3096, 3609, 4184, 4754, 5371, 6159, 6658, 7361, 8226, 9353, 10321, 11091, 11950, 12974, 13426, 15054, 16132, 17224, 18304, 19173, 19955, 21850, 22795]","[0, 324, 597, 1013, 1434, 1858, 2255, 2639, 3160, 3875, 4530, 5066, 5741, 6410, 6906, 7524, 7745, 8895, 9539, 10361, 11076, 11740, 12614, 13505, 14114, 14911, 15609, 16770, 17379, 18013]","[0, 235, 603, 919, 1328, 1528, 1968, 2445, 2808, 3130, 3657, 4145, 4325, 4465, 5169, 5478, 6138, 6635, 7279, 7468, 8322, 8742, 9420, 9649, 10010, 10560, 10930, 11673, 12379, 13016]","[0, 200, 314, 434, 585, 804, 1271, 1704, 1870, 2234, 2715, 2808, 3061, 3811, 4208, 4889, 5097, 5529, 6004, 6432, 6631, 7009, 7663, 8138, 8305, 8948, 9424, 9763, 10417, 10668]","[0, 243, 333, 633, 847, 1083, 1289, 1523, 1613, 1842, 2096, 2186, 2441, 2762, 2911, 3477, 3635, 4249, 4534, 4628, 4878, 5156, 5984, 6447, 6658, 7051, 7474, 7860, 8498, 8826]",22795,18013,13016,10668,8826,-3490,-3972,-3389,-3664,-2431,-16946,30,dire
7569609418,10,98,106,19,3,"[0, 245, 573, 936, 1312, 1728, 2058, 2533, 3124, 3687, 4130, 4878, 5421, 6006, 6599, 7053, 7653, 8444, 9488, 10127, 10867, 11685, 12913, 13338, 13433, 13854, 14740, 15142, 15840, 16530]","[0, 241, 439, 794, 1052, 1579, 1823, 1950, 2659, 2949, 3420, 3609, 4382, 4948, 5527, 5935, 6581, 7151, 7750, 8413, 9096, 9928, 10341, 11269, 11469, 11900, 12343, 13197, 13455, 13642]","[0, 245, 410, 766, 1013, 1300, 1542, 2195, 2659, 3139, 3499, 3861, 4623, 4998, 5410, 6098, 6549, 7242, 8203, 8623, 8934, 9505, 9924, 10382, 10957, 11052, 11277, 11531, 12288, 12826]","[0, 217, 375, 511, 644, 927, 1183, 1307, 1594, 1891, 2405, 2495, 3138, 3675, 3769, 4103, 4515, 4700, 5348, 5807, 6239, 6748, 7296, 7391, 7486, 7657, 7861, 8058, 8652, 9437]","[0, 170, 260, 396, 542, 700, 836, 972, 1279, 1459, 1662, 1851, 2494, 2726, 2820, 3158, 3796, 4074, 4517, 5087, 5437, 5838, 6320, 6573, 6743, 6913, 7082, 7446, 7779, 8610]",16530,13642,12826,9437,8610,70,76,78,20,112,"[0, 204, 569, 983, 1386, 1778, 2493, 3191, 3650, 4065, 4622, 5548, 6157, 6633, 7266, 7952, 8689, 9027, 10504, 11521, 12344, 13428, 14189, 14940, 16086, 17019, 17936, 19088, 20474, 21820]","[0, 208, 516, 857, 1179, 1469, 1902, 2119, 2474, 3263, 3583, 3877, 4233, 4911, 5946, 6787, 7091, 7372, 8073, 8947, 9366, 9965, 10799, 11715, 12615, 13277, 14006, 15241, 16163, 18151]","[0, 209, 334, 621, 989, 1165, 1558, 1889, 2097, 2397, 2895, 3209, 3508, 3756, 4239, 4499, 4870, 5608, 6046, 6694, 7257, 7377, 8117, 8866, 9375, 9888, 10824, 11676, 12351, 13728]","[100, 270, 748, 933, 1368, 1502, 2002, 2175, 2280, 2732, 3142, 3318, 3606, 4002, 4538, 4769, 5073, 5168, 5511, 6216, 6756, 7034, 7387, 7787, 8077, 8433, 8837, 9400, 10156, 10957]","[0, 170, 260, 433, 591, 735, 951, 1092, 1182, 1328, 1463, 1698, 1919, 2318, 2661, 2942, 3617, 3993, 4815, 5375, 5759, 6028, 6452, 6547, 7114, 7570, 8026, 8659, 9351, 10326]",21820,18151,13728,10957,10326,-5290,-4509,-902,-1520,-1716,-13937,30,dire
7569767419,82,17,96,123,110,"[173, 462, 1104, 1376, 1657, 2076, 2787, 3366, 3751, 4332, 4672, 5262, 5815, 6695, 7682, 8847, 9445, 10282, 11738, 12590, 13607, 14679, 16224, 16967, 19036, 19886, 20547, 21289, 22586, 23782]","[116, 441, 716, 1167, 1491, 1864, 2250, 2659, 3006, 3650, 4027, 4336, 4805, 5109, 5294, 6007, 6397, 6532, 7351, 8040, 8497, 9019, 9686, 10379, 11304, 12324, 12418, 13326, 14360, 14769]","[173, 302, 559, 1036, 1351, 1700, 2223, 2868, 3199, 3543, 4091, 4351, 4987, 5619, 6181, 6464, 6694, 7235, 7713, 8266, 8892, 9748, 10701, 11177, 12150, 12627, 12843, 13587, 14089, 14942]","[574, 703, 902, 1259, 1447, 1777, 2044, 2179, 2355, 2494, 3052, 3452, 3637, 3822, 4216, 4489, 4822, 5117, 5465, 5941, 6195, 6808, 7569, 8076, 8887, 9499, 9649, 9993, 10664, 11493]","[306, 435, 850, 1178, 1268, 1358, 1538, 1673, 1808, 1898, 2033, 2123, 2213, 2448, 2633, 3240, 3470, 3765, 4090, 4564, 4711, 5617, 6253, 6486, 6861, 7259, 7431, 7741, 8430, 8936]",23782,14769,14942,11493,8936,49,120,112,128,136,"[0, 278, 567, 1097, 1437, 1649, 2057, 2406, 2813, 3541, 3888, 4316, 4735, 5550, 6344, 6792, 7556, 8390, 8838, 9508, 10007, 10875, 11735, 12282, 12377, 12737, 13739, 14658, 15501, 16050]","[163, 393, 798, 1105, 1474, 1863, 2546, 3019, 3442, 3888, 4222, 4615, 5160, 5980, 6336, 6864, 7188, 7876, 8482, 9170, 9931, 10539, 10838, 10933, 11728, 11981, 13084, 13888, 14451, 15108]","[429, 583, 707, 1600, 1805, 1895, 2316, 2722, 3196, 3711, 4077, 4167, 4626, 5370, 5745, 6108, 6519, 7391, 7909, 8350, 9085, 9243, 9382, 10024, 10263, 10868, 11858, 12253, 12549, 12917]","[163, 317, 407, 635, 811, 911, 1081, 1314, 1491, 1730, 1865, 2000, 2410, 3102, 3197, 3497, 3655, 4370, 4464, 4606, 4886, 5030, 5390, 5614, 5709, 5804, 6427, 6669, 6987, 7083]","[81, 272, 362, 744, 874, 964, 1236, 1626, 1801, 1992, 2308, 2683, 2906, 3424, 3519, 3679, 3923, 4999, 5372, 5618, 6092, 6506, 6866, 7209, 7304, 7722, 8349, 8485, 8626, 8829]",16050,15108,12917,7083,8829,7732,-339,2025,4410,107,13935,30,radiant
7569905905,48,76,33,53,26,"[0, 255, 519, 1093, 1468, 1841, 2430, 2854, 3309, 3497, 4006, 4635, 5187, 5804, 6151, 6892, 8042, 9274, 9924, 10937, 12088, 12889, 13523, 14284, 15621, 16881, 17749, 19023, 19696, 20486]","[0, 248, 601, 879, 1441, 1729, 2077, 2335, 2720, 3107, 3568, 3811, 4281, 4754, 5336, 5911, 6313, 6691, 7232, 7729, 8054, 8427, 9425, 9803, 10564, 10876, 12014, 12814, 13536, 14486]","[0, 280, 925, 1466, 2075, 2482, 3093, 3801, 4472, 5119, 5570, 5940, 6446, 6611, 7389, 7995, 8789, 9733, 10323, 10912, 11515, 11789, 12056, 12402, 13468, 13634, 14268, 15097, 15661, 16022]","[0, 210, 341, 519, 789, 923, 1077, 1806, 2121, 2421, 2902, 3121, 3590, 4402, 4749, 4880, 5511, 5806, 6039, 6605, 6924, 7191, 7869, 8265, 8942, 9557, 10060, 10412, 11001, 11269]","[0, 210, 394, 552, 744, 834, 1056, 1732, 1958, 2379, 2559, 2649, 2758, 3032, 3287, 3382, 3929, 4554, 4649, 4807, 4957, 5406, 5705, 5949, 6119, 6616, 7075, 7407, 7703, 7936]",20486,14486,16022,11269,7936,98,41,112,3,100,"[0, 203, 499, 831, 1113, 1454, 1967, 2375, 2794, 3905, 4542, 4791, 5078, 6049, 6416, 7274, 7986, 8207, 8659, 9173, 10030, 10987, 11366, 11780, 13875, 13969, 15097, 15702, 16938, 17580]","[0, 279, 578, 943, 1195, 1478, 1759, 2013, 2564, 2960, 3401, 4217, 4465, 5233, 5551, 5902, 6729, 6915, 7483, 7910, 8787, 9344, 9511, 9711, 10530, 10789, 11042, 11672, 12271, 12883]","[0, 205, 687, 820, 969, 1211, 1508, 2066, 2450, 2592, 3773, 4239, 4588, 5726, 6109, 6414, 7121, 7215, 7555, 8065, 8959, 9285, 9920, 10672, 10938, 11549, 11644, 12074, 12547, 13001]","[0, 130, 257, 367, 610, 700, 889, 979, 1159, 1604, 2026, 2287, 2377, 2815, 3255, 3757, 4205, 4863, 5106, 5285, 5890, 6364, 6714, 6933, 7451, 7745, 8174, 8489, 9084, 9499]","[0, 130, 309, 399, 549, 639, 729, 948, 1128, 1573, 1763, 2024, 2197, 2917, 3449, 3754, 4273, 4422, 4517, 4675, 5067, 5281, 5523, 5693, 6290, 6845, 7468, 8019, 8280, 8532]",17580,12883,13001,9499,8532,2906,1603,3021,1770,-596,8704,30,radiant
7569953309,46,74,120,65,26,"[0, 541, 942, 1239, 1732, 2097, 2597, 3235, 3721, 4369, 5008, 5358, 5831, 6678, 7268, 7965, 8517, 8961, 9553, 10010, 10348, 11040, 11557, 11812, 11968, 12865, 13294, 14763, 15789, 16595]","[0, 264, 662, 791, 1276, 1448, 2039, 2250, 2761, 3239, 3574, 3814, 4532, 5103, 5684, 6255, 6666, 7029, 7595, 8922, 9563, 10534, 11224, 11697, 12186, 13240, 13536, 14451, 15312, 16277]","[0, 192, 589, 1049, 1266, 1659, 2100, 2394, 2848, 3298, 3857, 4042, 4263, 4920, 5530, 6066, 6438, 7008, 7819, 8147, 8569, 8961, 9825, 10281, 10376, 10660, 10917, 11245, 11979, 12530]","[0, 130, 220, 573, 728, 931, 1243, 1450, 1540, 1750, 2200, 2486, 2576, 3176, 3711, 4113, 4490, 4664, 4759, 5087, 5182, 5661, 6307, 6474, 6569, 7317, 8078, 8616, 9012, 9411]","[0, 192, 362, 549, 639, 897, 1083, 1219, 1459, 1711, 2102, 2192, 2349, 2676, 2794, 2889, 3261, 3401, 3496, 3853, 4023, 4336, 4687, 4992, 5162, 5495, 6079, 6692, 7071, 7284]",16595,16277,12530,9411,7284,49,135,59,123,72,"[0, 247, 640, 926, 1499, 1915, 2507, 2889, 3613, 4396, 4950, 5533, 6114, 6777, 7426, 8085, 9059, 9627, 10378, 11041, 11728, 12506, 13437, 13851, 15214, 15986, 17079, 18375, 19181, 20034]","[0, 248, 710, 1031, 1528, 1957, 2416, 3202, 3676, 4122, 5141, 5992, 6504, 7052, 7758, 8535, 9276, 9931, 10337, 11252, 11808, 12574, 12864, 13253, 14407, 15190, 15998, 16093, 16661, 17538]","[0, 332, 633, 941, 1235, 1568, 1861, 2303, 2752, 3327, 4259, 4751, 5451, 6247, 6558, 7402, 8540, 9154, 9771, 10832, 11728, 12592, 13058, 13472, 14163, 15225, 15745, 16660, 17734, 18386]","[0, 210, 402, 976, 1066, 1707, 1866, 2168, 2348, 2600, 2958, 3227, 3654, 4094, 4631, 5259, 5858, 6336, 6605, 7106, 7612, 8217, 8312, 8527, 9363, 10167, 10461, 10556, 11224, 11477]","[0, 210, 372, 462, 561, 814, 904, 994, 1174, 1591, 1841, 2163, 2379, 2684, 2832, 3165, 3598, 3973, 4488, 5476, 5719, 6132, 6227, 6322, 6950, 7586, 7838, 8579, 9003, 9099]",20034,17538,18386,11477,9099,-3439,-1261,-5856,-2066,-1815,-14437,30,dire
7570164716,74,41,45,14,3,"[0, 404, 788, 1274, 1514, 1934, 2388, 2781, 3407, 3784, 3964, 4584, 5166, 6575, 7143, 8132, 9252, 10152, 10407, 11098, 11527, 12642, 13126, 15263, 16550, 17862, 19291, 20373, 21047, 21687]","[0, 247, 423, 683, 1029, 1270, 1501, 1704, 1947, 2362, 2759, 3333, 4124, 4685, 5075, 5386, 5763, 6675, 7298, 7634, 8280, 8829, 9447, 10952, 12217, 13352, 14043, 14992, 16163, 16780]","[0, 358, 702, 1072, 1605, 2150, 2557, 2770, 3115, 3402, 4022, 4138, 4795, 5162, 5503, 5969, 6140, 7025, 7650, 7808, 8129, 8361, 8640, 9860, 10424, 10718, 12650, 13471, 14460, 14964]","[0, 545, 871, 1005, 1530, 1700, 1851, 2128, 2509, 2649, 2829, 3195, 3724, 4521, 4615, 4990, 5296, 5745, 6000, 6256, 6440, 6672, 6874, 7328, 7623, 7917, 8484, 9862, 10251, 10601]","[0, 210, 300, 410, 572, 791, 993, 1176, 1378, 1503, 1734, 1966, 2056, 2758, 2852, 3084, 3251, 3635, 3958, 4116, 4390, 4856, 5123, 5293, 5820, 6189, 6480, 7024, 7420, 7784]",21687,16780,14964,10601,7784,43,13,63,64,26,"[0, 257, 541, 902, 1112, 1421, 1996, 2086, 2786, 3761, 4440, 5168, 5812, 5994, 6881, 7629, 8346, 8849, 9675, 10828, 11472, 12880, 13467, 14268, 14484, 15728, 16993, 17088, 17685, 18186]","[0, 205, 744, 974, 1344, 1553, 1820, 2082, 2448, 3130, 3737, 4015, 4384, 4603, 4875, 5689, 6528, 7249, 7813, 9131, 10104, 10591, 10981, 11432, 11870, 13099, 13744, 14392, 14765, 15826]","[0, 177, 393, 689, 825, 1267, 1845, 2185, 2527, 2847, 3188, 3722, 3977, 4350, 4899, 5553, 6154, 6669, 7046, 7879, 8343, 8953, 9249, 9679, 10188, 11161, 11685, 12244, 13186, 13691]","[0, 130, 220, 310, 500, 607, 1093, 1183, 1583, 2079, 2721, 2902, 3622, 4051, 4498, 4799, 5203, 6014, 6465, 6828, 7359, 7687, 7971, 8904, 9216, 10079, 10825, 11105, 11459, 11690]","[0, 130, 254, 388, 478, 602, 706, 845, 1025, 1445, 1867, 2344, 2822, 3295, 3505, 3852, 4010, 4233, 4452, 5457, 5686, 6097, 6192, 6442, 6571, 6963, 7724, 7819, 8030, 8261]",18186,15826,13691,11690,8261,3501,954,1273,-1089,-477,4162,30,dire
7570460816,25,71,44,69,85,"[0, 247, 577, 958, 1412, 2004, 2504, 2945, 3548, 3972, 4688, 5292, 5782, 6314, 6979, 7111, 8147, 8801, 9952, 10628, 11591, 12293, 13292, 14366, 14950, 16615, 17215, 17948, 19031, 20826]","[0, 283, 556, 902, 1440, 2073, 2455, 2903, 3251, 3784, 4551, 4741, 5226, 5665, 6349, 6537, 6695, 7571, 8056, 8469, 9710, 9843, 10696, 10900, 11915, 12638, 13060, 13707, 13881, 15355]","[0, 239, 482, 1095, 1417, 1625, 1974, 2394, 2789, 3235, 3430, 4036, 4572, 4994, 5448, 5589, 6126, 6704, 7365, 8129, 9084, 9290, 9886, 10293, 11154, 11727, 12210, 12999, 13578, 14577]","[0, 130, 275, 451, 942, 1218, 1498, 1716, 1949, 2143, 2550, 2870, 3131, 3835, 4101, 4361, 4626, 5174, 5927, 6430, 6915, 7830, 8164, 8688, 9699, 10301, 10849, 11392, 11549, 12523]","[0, 130, 220, 604, 734, 824, 1016, 1153, 1243, 1333, 1423, 1674, 1936, 2084, 2269, 2405, 2563, 2741, 3283, 3545, 4036, 4403, 4700, 4795, 5055, 5378, 5866, 6607, 6890, 7641]",20826,15355,14577,12523,7641,77,10,126,29,86,"[0, 366, 649, 1063, 1428, 1826, 2162, 2658, 3048, 3632, 4755, 5052, 5347, 5864, 6356, 6964, 7523, 7897, 8464, 8996, 9961, 10495, 11669, 12289, 13001, 13301, 13847, 14899, 15937, 16293]","[0, 373, 540, 811, 1225, 1404, 1822, 2388, 2649, 3076, 3423, 3765, 4413, 4773, 5214, 6142, 6603, 7357, 8169, 8934, 9461, 10530, 10854, 11579, 11838, 12393, 12819, 13722, 13908, 14085]","[0, 332, 577, 871, 1176, 1507, 1913, 2356, 2817, 2943, 3219, 3790, 4407, 4845, 5532, 6070, 7049, 7895, 8405, 8957, 9246, 9762, 9857, 10454, 10549, 10750, 10845, 11104, 11766, 12198]","[0, 210, 300, 435, 574, 664, 881, 1065, 1321, 1411, 2017, 2187, 2391, 2795, 3215, 3915, 4073, 4372, 4638, 4796, 5068, 5441, 5996, 6163, 6620, 6821, 6960, 7219, 7932, 8321]","[0, 210, 300, 390, 480, 789, 879, 1106, 1196, 1370, 1922, 2073, 2288, 2657, 3226, 4111, 4269, 4594, 4689, 5019, 5114, 5208, 5352, 5519, 5614, 5815, 5970, 6609, 7197, 7374]",16293,14085,12198,8321,7374,4533,1270,2379,4202,267,12651,30,radiant
7570468116,49,80,28,86,3,"[0, 247, 614, 1093, 1370, 2068, 2367, 2927, 3419, 3768, 4350, 4565, 5527, 6179, 6725, 7429, 8137, 8957, 9767, 10319, 11602, 11905, 12908, 13594, 14245, 14542, 15265, 16139, 17086, 17917]","[0, 206, 409, 684, 927, 1366, 1692, 1986, 2357, 2820, 3290, 3719, 4602, 5125, 5582, 5929, 7269, 7679, 8644, 9278, 11355, 11960, 13457, 14589, 15440, 15712, 17154, 17981, 18220, 19055]","[0, 212, 636, 979, 1395, 1771, 2155, 2698, 3141, 3651, 4115, 4354, 5080, 5549, 5872, 6853, 7400, 7882, 8461, 8906, 9612, 9707, 10838, 11513, 12156, 12584, 13166, 13601, 13840, 14488]","[0, 129, 269, 481, 728, 905, 1040, 1168, 1483, 1573, 1753, 2150, 2537, 3185, 3588, 4017, 4552, 4839, 5310, 5468, 6324, 6604, 7129, 7665, 8003, 8190, 8608, 8943, 9182, 9359]","[0, 129, 564, 911, 1050, 1230, 1836, 1926, 2147, 2237, 2417, 2617, 3091, 3497, 3752, 3873, 4182, 4393, 4928, 5350, 5751, 5982, 6520, 7005, 7188, 7283, 7761, 8081, 8231, 8514]",17917,19055,14488,9359,8514,89,17,71,26,85,"[0, 243, 605, 950, 1233, 1571, 1947, 2418, 3002, 3329, 3806, 4474, 4971, 5945, 6748, 7240, 8240, 9049, 9446, 10930, 12114, 12423, 13617, 13712, 14637, 15767, 16812, 17517, 19122, 20140]","[0, 365, 734, 1149, 1374, 1791, 2167, 2422, 3098, 3861, 4208, 4589, 4974, 5234, 5795, 6242, 6841, 7289, 8404, 9030, 9664, 9846, 10205, 10300, 12995, 13650, 14294, 14389, 15816, 16446]","[0, 209, 440, 902, 1189, 1521, 1878, 2172, 2628, 3255, 3445, 3889, 4398, 4808, 5539, 6023, 6207, 6608, 7158, 7877, 8269, 8860, 9177, 9656, 10386, 11283, 11598, 11853, 12477, 13113]","[0, 209, 299, 635, 725, 908, 1159, 1249, 1697, 1826, 2100, 2467, 2937, 3106, 3681, 3946, 4168, 4478, 4744, 4992, 5384, 5851, 6173, 6373, 6898, 7065, 7263, 7441, 8880, 9275]","[0, 209, 344, 464, 601, 1035, 1169, 1319, 1735, 1825, 2080, 2308, 2616, 2779, 3061, 3156, 3286, 3617, 3970, 4418, 4513, 4764, 5089, 5184, 6109, 6708, 7170, 7845, 8801, 9007]",20140,16446,13113,9275,9007,-2223,2609,1375,84,-493,1352,30,radiant
7570519515,82,49,51,66,86,"[0, 215, 484, 718, 1082, 1442, 1771, 2252, 2831, 3575, 4187, 4867, 5373, 6114, 6649, 7547, 8794, 9777, 10734, 12113, 12775, 14409, 15581, 16664, 17637, 18152, 18948, 19893, 20423, 21319]","[0, 220, 575, 980, 1426, 1805, 2203, 2805, 3143, 3438, 3813, 4331, 4930, 5354, 5603, 6522, 7149, 7817, 8350, 9504, 9934, 10731, 11533, 12454, 13604, 14234, 14918, 16335, 17053, 17763]","[0, 202, 443, 964, 1251, 1719, 2011, 2551, 2997, 3296, 3985, 4639, 5048, 5748, 5880, 6169, 6647, 7097, 7688, 8052, 8311, 9698, 10423, 10805, 11524, 11737, 11877, 12137, 12233, 12890]","[0, 130, 220, 310, 471, 674, 852, 1102, 1276, 1366, 1716, 1827, 2042, 2571, 2779, 3067, 3761, 4039, 4420, 4956, 5270, 5893, 6245, 6726, 6978, 7425, 7818, 8407, 8724, 8895]","[0, 130, 220, 432, 522, 631, 727, 907, 1042, 1207, 1367, 1542, 1632, 2078, 2345, 2664, 2934, 3396, 3804, 4060, 4318, 4664, 5008, 5350, 5587, 5999, 6142, 6347, 6443, 6634]",21319,17763,12890,8895,6634,10,129,23,58,105,"[0, 262, 541, 890, 1259, 1813, 2311, 2681, 3169, 3647, 4321, 4877, 5530, 6150, 6695, 7268, 7890, 8745, 9503, 10386, 11264, 12204, 12639, 13344, 14134, 14812, 15673, 17292, 17994, 19444]","[0, 336, 580, 1306, 1740, 2335, 2828, 3375, 3952, 4652, 5137, 5891, 6634, 7392, 7903, 8524, 9218, 9978, 10994, 11477, 11749, 12522, 12616, 12820, 13737, 14261, 14800, 15967, 16532, 17429]","[0, 253, 622, 1006, 1376, 1758, 2141, 2546, 3145, 3737, 4450, 4788, 5240, 5952, 6609, 7000, 7738, 8587, 9187, 9696, 10246, 10568, 10885, 11509, 12354, 12647, 13072, 14170, 14475, 15419]","[0, 210, 300, 420, 510, 689, 839, 1125, 1323, 1719, 1979, 2288, 2414, 2633, 2961, 3213, 3755, 4157, 4483, 4742, 5037, 5132, 5412, 5579, 5862, 6225, 6402, 7232, 7807, 8437]","[0, 210, 300, 490, 580, 710, 845, 1155, 1377, 1626, 2152, 2371, 2655, 2840, 3127, 3259, 3889, 4328, 4714, 5252, 5347, 5459, 5553, 5720, 6169, 6264, 6436, 7087, 7313, 7634]",19444,17429,15419,8437,7634,1875,334,-2529,458,-1000,-862,30,radiant
7570561812,15,19,96,20,112,"[0, 207, 530, 862, 1137, 1542, 1863, 2199, 2568, 2858, 3831, 4327, 5008, 5400, 5646, 6332, 7090, 8006, 8652, 10048, 10842, 11152, 12007, 13090, 14023, 14882, 15744, 16971, 17399, 18125]","[0, 283, 564, 969, 1250, 1453, 1801, 2201, 2674, 3060, 3851, 4688, 5044, 5934, 6539, 6988, 7655, 8958, 9642, 10497, 10592, 11138, 11268, 11989, 13042, 13721, 14118, 15152, 15501, 16375]","[0, 419, 720, 885, 1206, 1444, 1900, 2490, 2894, 3180, 3680, 4249, 4740, 5465, 5922, 6802, 7181, 8013, 8752, 9256, 9713, 10072, 10167, 11009, 11394, 12791, 13405, 13956, 14359, 15376]","[0, 169, 259, 397, 522, 892, 1084, 1174, 1264, 1490, 1724, 1995, 2131, 2614, 3040, 3278, 3493, 3772, 3867, 4714, 4809, 5125, 5229, 5832, 6483, 7011, 7289, 7840, 7936, 8375]","[0, 249, 339, 467, 641, 731, 861, 1071, 1206, 1341, 1615, 1896, 2082, 2457, 2939, 3225, 3371, 3708, 3974, 4068, 4495, 4590, 4747, 5333, 5659, 6073, 6594, 6890, 7399, 8126]",18125,16375,15376,8375,8126,1,49,61,62,123,"[0, 242, 533, 975, 1343, 1771, 2263, 2547, 2768, 3515, 3776, 4287, 5077, 5172, 5896, 6451, 7277, 8239, 9064, 9945, 10843, 11991, 13640, 14905, 16098, 17233, 18576, 19351, 19855, 20804]","[0, 208, 405, 730, 977, 1301, 1680, 1946, 2583, 3109, 3388, 3761, 4378, 4824, 5027, 5381, 5937, 6338, 7024, 7758, 7916, 8601, 9626, 10224, 10829, 11014, 11390, 11701, 12927, 13588]","[0, 602, 887, 1094, 1371, 1536, 2032, 2766, 3162, 3514, 4135, 4563, 5045, 5645, 6410, 6845, 7401, 8318, 8818, 10035, 10233, 11136, 12462, 12974, 13069, 13547, 14095, 14879, 15771, 16361]","[100, 327, 417, 531, 693, 827, 1027, 1182, 1398, 1533, 2492, 3119, 3389, 3520, 4437, 4531, 4915, 5609, 5796, 6617, 7227, 7691, 8648, 8982, 9113, 9298, 9749, 10239, 10915, 11121]","[0, 227, 317, 430, 553, 784, 964, 1192, 1282, 1545, 1816, 2035, 2305, 2422, 2625, 2719, 3050, 3844, 4130, 4832, 5371, 5874, 6403, 6753, 7325, 7984, 8374, 9648, 10093, 10299]",20804,13588,16361,11121,10299,-2679,2787,-985,-2746,-2173,-5796,30,radiant
7570740708,49,35,28,53,123,"[0, 170, 547, 788, 999, 1303, 1687, 2162, 2612, 3049, 3327, 3942, 4473, 5001, 5729, 6306, 6939, 7120, 7433, 8301, 8652, 8855, 9481, 9989, 10345, 11172, 12143, 12238, 14099, 14844]","[0, 297, 487, 893, 1120, 1518, 1745, 1967, 2383, 2732, 3242, 3879, 4599, 5168, 5701, 6348, 7029, 7518, 8134, 8516, 9138, 9465, 10370, 10952, 11953, 12589, 13356, 14245, 15861, 16449]","[0, 284, 572, 986, 1542, 2333, 2868, 3512, 4115, 4407, 5695, 5903, 6869, 7602, 8199, 8350, 9019, 9700, 10034, 10285, 10848, 10943, 11948, 12176, 12638, 13336, 13896, 14303, 14719, 15031]","[0, 170, 285, 375, 549, 729, 1031, 1242, 1625, 1806, 1986, 2326, 2659, 3168, 3653, 4277, 4823, 5378, 6098, 6361, 6632, 6760, 7040, 7536, 8072, 8528, 9324, 9897, 11337, 11761]","[0, 170, 285, 375, 559, 864, 1041, 1243, 1359, 1969, 2149, 2281, 2695, 2987, 3291, 3441, 4009, 4364, 4631, 4822, 5171, 5266, 5572, 5849, 6232, 6740, 7302, 8223, 8596, 9240]",14844,16449,15031,11761,9240,73,43,29,105,20,"[0, 289, 695, 1056, 1442, 1678, 2215, 3180, 3346, 3634, 3892, 4578, 5036, 5819, 6782, 7867, 8714, 10024, 10778, 12231, 13680, 14428, 15838, 16996, 18668, 19831, 21336, 21431, 22039, 22135]","[0, 291, 653, 1028, 1413, 1938, 2514, 3220, 3749, 4598, 5457, 5973, 6194, 6715, 7242, 7893, 8402, 9003, 9168, 9963, 10580, 10849, 11774, 12294, 12830, 13376, 14059, 14581, 15557, 15677]","[0, 291, 612, 935, 1360, 1724, 2040, 2577, 2725, 3254, 3790, 4302, 4784, 5381, 5932, 6208, 6664, 7315, 7847, 8440, 8793, 9194, 9956, 10604, 11272, 11367, 11894, 12300, 12594, 12765]","[0, 170, 260, 703, 958, 1048, 1221, 1615, 2014, 2277, 2542, 2772, 3177, 3451, 3722, 3871, 4035, 4472, 4813, 5124, 5320, 6199, 6649, 6972, 7274, 7369, 8024, 8538, 9211, 9881]","[100, 322, 412, 549, 639, 959, 1116, 1412, 1578, 1834, 2044, 2229, 2326, 2566, 2761, 2955, 3236, 3415, 3511, 3779, 4195, 4468, 4665, 4760, 5054, 5149, 5435, 5574, 6002, 6098]",22135,15677,12765,9881,6098,-7291,772,2266,1880,3142,769,30,dire
7570812500,10,17,123,38,21,"[0, 242, 521, 717, 1095, 1546, 1893, 2256, 2796, 3431, 3763, 4589, 5462, 6242, 6650, 7328, 8143, 8777, 10206, 10812, 11424, 12149, 13245, 14177, 14977, 15895, 16910, 17004, 17660, 18971]","[0, 277, 602, 970, 1370, 1682, 2193, 2752, 3351, 3889, 4443, 4780, 5879, 6597, 6958, 7546, 8444, 9044, 9845, 10200, 10899, 11675, 12381, 13027, 14038, 14426, 15105, 15802, 16173, 16378]","[0, 317, 407, 595, 798, 1019, 1352, 1536, 1626, 1716, 1851, 2253, 3065, 3550, 4066, 4450, 4890, 5316, 5720, 6282, 7246, 8070, 8684, 9156, 9747, 10677, 11502, 11813, 12372, 13056]","[0, 239, 505, 788, 1338, 1719, 1944, 2325, 2887, 3069, 3416, 4088, 4722, 5421, 5806, 6725, 7603, 7788, 8436, 8831, 9558, 10050, 10796, 11212, 11610, 11985, 13097, 13191, 13747, 14123]","[0, 221, 360, 453, 717, 891, 1142, 1325, 1545, 1804, 2006, 2308, 2959, 3297, 3493, 4119, 4480, 4748, 5259, 5517, 6401, 6729, 7186, 7473, 7638, 7869, 8267, 8661, 8919, 9015]",18971,16378,13056,14123,9015,95,57,98,37,86,"[0, 209, 561, 975, 1173, 1578, 1811, 2659, 3034, 3332, 3894, 4211, 4844, 5431, 5942, 6485, 7265, 7649, 8580, 9179, 10210, 10970, 11445, 12381, 12956, 13678, 14333, 16444, 18210, 18764]","[0, 294, 623, 1036, 1373, 1672, 1879, 2425, 2826, 3174, 3662, 4171, 4380, 4740, 5005, 5194, 5616, 6266, 6746, 7499, 7731, 7955, 8217, 8529, 9128, 9544, 9917, 10294, 10873, 11337]","[0, 258, 458, 820, 1093, 1420, 1802, 2013, 2229, 2546, 2935, 3202, 3292, 3630, 4341, 4604, 4858, 5510, 6615, 7175, 7704, 8421, 8825, 9239, 9529, 9808, 10078, 10602, 11203, 11656]","[0, 170, 260, 398, 528, 618, 727, 817, 952, 1077, 1304, 1443, 1667, 1875, 2214, 2498, 2676, 3041, 3586, 3947, 4041, 4375, 4617, 4787, 5007, 5901, 6159, 6895, 7606, 7912]","[0, 170, 260, 395, 573, 953, 1095, 1309, 1488, 1613, 1901, 2065, 2155, 2295, 2443, 2584, 2854, 3220, 3966, 4116, 4507, 5004, 5246, 5692, 6006, 6372, 6856, 7568, 8343, 8779]",18764,11337,11656,7912,8779,207,5041,1400,6211,236,13095,30,dire
7570954607,36,67,21,37,79,"[0, 244, 658, 1036, 1409, 1786, 2236, 2916, 3346, 3840, 4257, 4541, 5085, 5842, 6403, 6918, 8195, 8477, 8871, 9274, 10611, 10971, 11621, 12424, 13459, 14465, 15268, 15830, 15926, 16717]","[0, 201, 485, 737, 908, 1190, 1457, 1881, 2096, 2392, 2482, 2656, 2826, 3167, 3636, 3902, 4579, 5266, 5947, 6374, 7153, 7327, 8276, 8817, 9175, 9863, 10522, 11415, 11647, 11924]","[0, 331, 612, 906, 1337, 1817, 2271, 2631, 3047, 3810, 3900, 4466, 5265, 5651, 5981, 6608, 7032, 7190, 7742, 8445, 8891, 9091, 10095, 10520, 10802, 11323, 11499, 11800, 12831, 13023]","[0, 294, 384, 831, 1000, 1288, 1455, 1590, 1680, 2214, 2387, 2618, 2875, 3156, 3251, 3361, 4111, 4530, 4815, 5273, 5676, 5985, 6722, 7032, 7391, 8055, 8510, 8886, 9257, 9428]","[0, 130, 220, 310, 418, 557, 730, 961, 1051, 1347, 1437, 1610, 2289, 2653, 2855, 3093, 3714, 3907, 4157, 4452, 5233, 5711, 6324, 6722, 7223, 7982, 8233, 8403, 8781, 8952]",16717,11924,13023,9428,8952,63,98,120,102,112,"[0, 317, 613, 1038, 1410, 1705, 1933, 2334, 2793, 3644, 4134, 4638, 5221, 5944, 6884, 7372, 8067, 8578, 9482, 10042, 10418, 11107, 11881, 12845, 13477, 14633, 15310, 16421, 17441, 18292]","[0, 246, 679, 1098, 1297, 1513, 1973, 2234, 2746, 3467, 4161, 5278, 5673, 6339, 7046, 7622, 8128, 8465, 9083, 9715, 10542, 11137, 11884, 12863, 13406, 13668, 14435, 15629, 16922, 18160]","[0, 288, 622, 1006, 1387, 1757, 2319, 2618, 3299, 3814, 4498, 5290, 5697, 6263, 6653, 7168, 8053, 8477, 9041, 9865, 10757, 10965, 11097, 11656, 12219, 13403, 13849, 14296, 15640, 16265]","[0, 535, 625, 1176, 1306, 1600, 1733, 1993, 2118, 2538, 2930, 3188, 3278, 3827, 4277, 4761, 5576, 6262, 6764, 7184, 7865, 8536, 9258, 10001, 10465, 10746, 11375, 12703, 13118, 14024]","[0, 210, 490, 668, 816, 953, 1133, 1268, 1358, 1925, 2117, 2490, 2741, 3195, 3495, 3894, 4512, 5038, 5333, 5477, 5964, 6110, 6620, 7055, 7372, 7638, 7733, 8720, 9306, 10043]",18292,18160,16265,14024,10043,-1575,-6236,-3242,-4596,-1091,-16740,30,dire
7571447909,41,49,78,53,110,"[0, 207, 517, 970, 1243, 1523, 1801, 2021, 2334, 2887, 3474, 3847, 4252, 4489, 5021, 6010, 6549, 7069, 7564, 8199, 8761, 9252, 10084, 11182, 11940, 12707, 12961, 13519, 14200, 14849]","[0, 280, 581, 946, 1364, 1775, 2318, 2684, 3198, 3780, 4195, 4467, 4933, 5578, 6036, 6696, 7463, 7983, 8182, 8920, 9572, 9784, 10316, 10613, 11293, 11739, 11834, 11928, 12446, 13187]","[0, 169, 330, 623, 970, 1213, 1621, 2002, 2465, 2922, 3347, 3608, 4221, 4817, 5036, 5512, 6323, 6699, 7004, 7795, 8933, 9494, 9808, 10217, 10635, 11529, 11863, 12264, 12811, 12982]","[0, 169, 298, 388, 478, 833, 1151, 1592, 1682, 1889, 2214, 2517, 3307, 3492, 3924, 4438, 4864, 5143, 5479, 6144, 6599, 7091, 8041, 8402, 8667, 9228, 9707, 9801, 10242, 10869]","[0, 169, 259, 366, 456, 662, 914, 1080, 1170, 1260, 1823, 2076, 2267, 2537, 2933, 3473, 3631, 4438, 4695, 5234, 5587, 6045, 6430, 6981, 7572, 8458, 8628, 8797, 9176, 9347]",14849,13187,12982,10869,9347,8,28,97,123,26,"[0, 537, 1100, 1473, 1772, 2014, 2781, 3108, 3843, 4362, 4886, 5516, 6045, 6776, 7572, 7920, 9324, 9943, 10769, 11502, 12011, 13113, 14572, 14666, 15141, 16172, 17262, 18512, 19403, 20248]","[0, 221, 472, 739, 1245, 1864, 2315, 2876, 3311, 3565, 4095, 4336, 4949, 5456, 6192, 6735, 7792, 8646, 9032, 10049, 10290, 10830, 11720, 12346, 12725, 13810, 14405, 15729, 16459, 16881]","[0, 333, 753, 1109, 1519, 1858, 2230, 2685, 3153, 3434, 4131, 4643, 5193, 6042, 6670, 7385, 8206, 8724, 9232, 9389, 9906, 11013, 12282, 12764, 13273, 14187, 14700, 15497, 16407, 17199]","[0, 169, 259, 558, 744, 903, 1164, 1299, 1462, 1662, 2027, 2117, 2351, 2744, 2967, 3188, 3801, 4195, 4733, 5453, 5819, 6380, 6934, 7360, 8028, 8766, 9154, 9995, 10595, 11108]","[0, 235, 389, 496, 631, 721, 895, 1030, 1120, 1612, 2102, 2192, 2311, 2700, 2891, 3051, 3613, 4033, 4295, 4628, 4786, 5113, 5872, 5966, 6302, 6579, 6799, 8109, 8382, 8744]",20248,16881,17199,11108,8744,-5399,-3694,-4217,-239,603,-12946,30,dire
7571494203,4,23,135,86,20,"[0, 241, 518, 901, 1233, 1415, 1671, 1870, 2261, 2689, 3117, 3570, 4189, 4476, 5045, 5778, 6460, 7338, 8035, 8774, 10111, 10895, 11491, 12583, 13161, 14313, 15115, 15934, 16596, 16839]","[0, 244, 485, 894, 1354, 1602, 2047, 2483, 3172, 3554, 4130, 4822, 5161, 5595, 6403, 6904, 7640, 8050, 9047, 9774, 10859, 11227, 11574, 12343, 13371, 14205, 14570, 14861, 15184, 15688]","[0, 208, 588, 763, 1224, 1494, 1929, 2101, 2512, 3174, 3497, 4209, 4512, 4907, 5142, 5747, 6943, 7258, 7988, 8485, 9346, 9828, 10669, 11626, 12495, 13149, 13543, 13947, 14427, 14670]","[0, 169, 600, 779, 998, 1088, 1542, 1680, 1815, 2057, 2482, 2703, 3126, 3752, 4110, 4387, 4977, 5233, 5827, 6168, 7358, 7733, 7975, 8882, 9971, 10380, 10636, 11034, 11250, 11719]","[0, 169, 311, 481, 611, 929, 1133, 1223, 1564, 1802, 1937, 2417, 2537, 2724, 3364, 3641, 3945, 4040, 4521, 4768, 5287, 5454, 5705, 6585, 7140, 7504, 7599, 7859, 8082, 8325]",16839,15688,14670,11719,8325,114,97,120,58,26,"[0, 203, 473, 842, 1255, 1711, 1956, 2348, 2636, 2854, 3602, 4142, 4733, 5293, 5908, 6448, 7569, 8134, 8883, 9390, 9940, 10349, 11054, 11498, 11593, 12369, 13870, 14740, 15887, 18263]","[0, 203, 432, 681, 965, 1384, 1871, 2287, 2951, 3551, 4054, 4451, 4874, 5560, 5745, 6313, 6534, 6973, 7581, 8434, 8627, 8828, 10108, 10540, 11182, 12142, 13208, 14053, 14952, 15623]","[0, 251, 721, 1189, 1560, 1855, 2188, 2432, 3081, 3542, 4242, 5037, 5405, 5905, 6399, 6588, 7215, 8180, 8275, 8675, 8868, 9024, 9996, 10544, 10639, 11617, 11905, 12563, 13215, 13918]","[0, 169, 321, 458, 588, 965, 1074, 1417, 1604, 1946, 2241, 2390, 2747, 3085, 3646, 3777, 4056, 4253, 4431, 4676, 5005, 5284, 5972, 6122, 6576, 6981, 7685, 8034, 8828, 9506]","[0, 169, 284, 374, 504, 638, 728, 922, 1102, 1236, 1669, 1884, 2072, 2275, 2589, 2728, 3144, 3288, 3383, 3646, 3839, 4195, 4667, 4761, 4942, 5477, 5858, 6072, 6663, 7300]",18263,15623,13918,9506,7300,-1424,65,752,2213,1025,2631,30,radiant
7571634401,35,123,17,96,14,"[0, 167, 634, 1076, 1349, 1665, 2718, 3130, 3453, 4354, 4764, 5240, 5456, 5551, 5805, 6322, 6536, 7565, 7955, 9076, 9516, 10148, 10506, 11100, 11575, 11900, 12483, 12776, 13144, 13366]","[0, 129, 306, 632, 722, 916, 1340, 1704, 1794, 2095, 2230, 2664, 2804, 2899, 3113, 4194, 4529, 4800, 5079, 5567, 6406, 6635, 7189, 7820, 8275, 8412, 9604, 10253, 10715, 11861]","[0, 247, 411, 552, 820, 1118, 1386, 1562, 1820, 2124, 2472, 2842, 3328, 3558, 3812, 5333, 6290, 6727, 7044, 7139, 7380, 7475, 8217, 8772, 8901, 8996, 10550, 10836, 10932, 11371]","[0, 164, 560, 852, 1105, 1484, 1736, 2057, 2435, 2884, 3019, 3500, 3939, 4440, 4915, 5484, 5771, 6301, 6395, 6490, 7166, 7373, 7776, 8229, 8324, 8552, 9148, 9243, 9586, 10000]","[0, 129, 310, 553, 738, 846, 1255, 1462, 1552, 1931, 2221, 2979, 3198, 3534, 3629, 3927, 4022, 4779, 4873, 4989, 5763, 5902, 6319, 6727, 6897, 7067, 7807, 7997, 8216, 8775]",13366,11861,11371,10000,8775,82,98,39,53,40,"[0, 571, 784, 1462, 1875, 2632, 3245, 3642, 4119, 4688, 5578, 6204, 6867, 8179, 9118, 10002, 11112, 11451, 11819, 12993, 14029, 15643, 16800, 17737, 18735, 19737, 21294, 22511, 23583, 24660]","[0, 278, 582, 863, 1277, 1738, 2028, 2371, 2814, 3227, 3786, 4135, 4785, 5642, 6276, 6702, 7523, 8250, 8591, 9581, 10294, 11107, 11824, 12727, 13430, 14013, 14795, 15504, 16348, 16944]","[0, 407, 613, 1033, 1477, 1816, 2251, 2674, 3170, 3588, 3994, 4499, 4926, 5546, 6068, 6554, 7072, 7641, 8149, 9134, 9292, 10308, 11034, 11470, 12202, 13174, 13268, 14186, 14985, 15804]","[0, 209, 501, 716, 846, 1031, 1728, 2045, 2513, 2603, 2738, 3100, 3190, 4009, 4158, 4635, 5263, 5809, 6360, 7118, 7788, 7993, 8666, 9544, 10273, 11178, 12254, 13033, 13625, 13880]","[0, 269, 359, 778, 931, 1247, 1522, 1722, 1857, 1947, 2232, 2491, 2629, 3428, 3629, 3982, 4492, 5276, 5611, 6322, 6859, 7398, 8172, 8488, 8802, 9557, 9931, 10188, 10863, 11034]",24660,16944,15804,13880,11034,-11294,-5083,-4433,-3880,-2259,-26949,30,dire
7571688104,94,13,97,84,45,"[0, 200, 497, 773, 1057, 1480, 1743, 2445, 3304, 3799, 4543, 5041, 5509, 6345, 7198, 7846, 8712, 9494, 9664, 10320, 10822, 12042, 12893, 14231, 15049, 15984, 16722, 17857, 19317, 19413]","[0, 280, 579, 876, 1293, 1552, 2103, 2452, 2799, 3264, 3601, 4417, 4759, 5302, 6140, 6831, 7310, 7632, 7727, 8619, 8939, 9034, 9441, 10211, 11078, 11755, 12060, 12775, 13850, 14269]","[0, 167, 483, 812, 1027, 1313, 1667, 2346, 2956, 3337, 3472, 4068, 4282, 4901, 5310, 5552, 5869, 6586, 6681, 6838, 7063, 7158, 7253, 7658, 7986, 8153, 8633, 9223, 9847, 10126]","[0, 269, 359, 493, 583, 983, 1331, 1511, 1782, 2008, 2143, 2233, 2442, 2608, 3063, 3292, 3480, 3638, 3733, 3890, 4254, 4349, 4694, 4788, 5203, 5405, 5889, 6320, 6631, 6727]","[18, 453, 789, 879, 969, 1219, 1416, 1596, 1686, 1998, 2260, 2534, 2677, 2977, 3340, 3504, 3895, 4398, 4493, 4650, 4966, 5061, 5156, 5250, 5578, 5745, 6345, 6441, 6703, 6903]",19413,14269,10126,6727,6903,41,106,33,40,30,"[0, 368, 681, 1063, 1268, 1706, 2138, 2701, 3200, 3434, 4115, 4750, 5469, 6133, 7419, 8301, 9101, 10140, 11560, 12750, 13703, 15539, 16535, 17347, 17936, 18905, 20149, 21111, 22602, 24349]","[0, 412, 711, 1003, 1250, 1429, 1554, 2028, 2315, 2691, 3863, 4007, 4580, 4729, 5134, 5999, 6391, 6614, 7514, 8050, 8350, 9735, 10342, 11056, 11754, 12606, 13107, 13607, 13989, 14830]","[0, 250, 475, 790, 1172, 1608, 1805, 2665, 2831, 2958, 3126, 3358, 3842, 4452, 4911, 5649, 6284, 6661, 6980, 7543, 8360, 8879, 9660, 10030, 10704, 10909, 11700, 12336, 13003, 13718]","[0, 250, 365, 722, 1143, 1278, 1602, 1788, 1878, 1968, 2093, 2237, 3150, 3382, 3722, 4147, 4425, 4638, 5241, 5705, 5875, 6328, 6579, 6835, 7351, 7716, 8207, 8576, 9012, 9732]","[0, 284, 399, 489, 659, 835, 925, 1462, 1670, 1760, 2275, 2419, 2910, 3363, 3618, 3987, 4212, 4546, 5033, 5319, 5657, 5967, 6206, 6372, 6674, 7185, 7611, 7867, 8149, 9203]",24349,14830,13718,9732,9203,-4936,-561,-3592,-3005,-2300,-14394,30,dire
7571869818,94,38,49,110,19,"[0, 256, 576, 948, 1399, 1796, 2123, 2573, 3089, 3501, 4142, 4900, 5443, 6264, 6871, 7549, 8319, 9239, 9833, 10861, 11728, 13228, 14506, 14988, 15596, 16266, 17447, 19009, 20381, 21474]","[0, 296, 605, 888, 1357, 1699, 2546, 3156, 3931, 4370, 4909, 5395, 5956, 6607, 7653, 8250, 8977, 9669, 10402, 11552, 12950, 13845, 14446, 14794, 15707, 15924, 16703, 17875, 19353, 19967]","[0, 283, 553, 968, 1132, 1599, 2061, 2334, 2755, 3367, 3907, 4540, 5106, 5563, 6042, 6427, 7043, 7928, 8596, 9240, 10135, 10320, 11436, 11654, 13041, 13593, 14054, 15106, 16133, 17422]","[0, 172, 262, 421, 559, 1237, 1597, 1732, 1897, 2048, 2391, 2571, 2748, 3094, 3310, 3486, 3930, 4360, 5371, 5927, 6965, 7301, 7831, 8041, 8755, 9404, 9846, 10659, 11336, 11877]","[0, 170, 262, 356, 495, 709, 989, 1124, 1290, 1425, 1860, 2216, 2484, 2778, 3160, 3320, 3906, 4249, 4457, 4725, 5209, 5394, 5901, 6020, 6585, 6799, 7375, 8113, 8871, 9438]",21474,19967,17422,11877,9438,89,35,129,123,58,"[0, 208, 506, 798, 1134, 1478, 1657, 2181, 2527, 2805, 3387, 3785, 4479, 5605, 6197, 6943, 7754, 8726, 9287, 10055, 10903, 12085, 13481, 14283, 15770, 16825, 17182, 17314, 17772, 18036]","[0, 240, 547, 834, 1082, 1345, 1758, 2096, 2625, 3100, 3714, 4003, 4329, 5295, 5572, 6010, 6832, 7014, 7185, 7585, 8053, 8342, 9392, 9813, 10386, 10625, 11047, 11863, 12828, 13171]","[0, 245, 514, 797, 1158, 1283, 1659, 2193, 2526, 2776, 3153, 3550, 4036, 4344, 4809, 5331, 6108, 6657, 7242, 7864, 8227, 8407, 8816, 9757, 9923, 10328, 10564, 10862, 11576, 11672]","[0, 170, 274, 382, 518, 691, 855, 990, 1131, 1274, 1409, 1701, 1918, 2424, 2616, 3057, 3367, 3699, 3913, 4287, 4564, 5121, 5595, 5906, 6267, 6723, 7100, 7195, 7801, 7897]","[0, 170, 296, 465, 573, 935, 1086, 1267, 1487, 1688, 2052, 2298, 2508, 2932, 3282, 3682, 4112, 4207, 4455, 4584, 5140, 5320, 5735, 6020, 6221, 6504, 7218, 7424, 7942, 8288]",18036,13171,11672,7897,8288,3438,6796,5750,3980,1150,21114,30,radiant
7572018617,73,76,137,121,26,"[296, 686, 1229, 1690, 1819, 2470, 2803, 3555, 3825, 4644, 4909, 5538, 6266, 7115, 7943, 9459, 10691, 11465, 12659, 13816, 14756, 15644, 16663, 17294, 18490, 19675, 20381, 21852, 22873, 23964]","[345, 589, 917, 1202, 1583, 2235, 2676, 3207, 3649, 4119, 4515, 4780, 5640, 6563, 6773, 7890, 8228, 8421, 9151, 9723, 10462, 11194, 12006, 12821, 13762, 14399, 15423, 16923, 17450, 18501]","[241, 525, 1061, 1480, 1692, 2269, 2782, 3369, 3903, 4512, 4682, 4772, 5455, 6397, 7033, 8199, 9184, 9378, 10017, 10743, 11363, 11957, 13161, 13490, 14187, 14392, 15137, 16494, 16791, 17365]","[169, 259, 516, 1102, 1235, 1618, 1874, 2139, 2364, 2553, 2723, 2830, 2979, 3548, 3771, 4364, 4668, 5130, 5609, 5805, 6024, 6598, 7229, 7404, 7717, 7902, 8354, 9030, 9404, 9710]","[205, 295, 482, 572, 744, 855, 990, 1264, 1444, 1738, 2081, 2412, 2728, 3213, 3494, 4232, 4676, 4770, 5113, 5522, 5662, 6087, 6671, 6838, 7076, 7171, 7542, 7763, 8014, 8680]",23964,18501,17365,9710,8680,135,41,106,138,20,"[353, 641, 940, 1313, 1837, 2198, 2698, 2873, 3461, 4227, 4966, 5248, 5735, 6389, 7033, 7167, 7988, 8742, 9082, 9445, 9892, 9986, 10081, 10176, 10668, 11054, 11505, 12090, 12542, 12992]","[169, 416, 581, 1048, 1404, 1530, 1831, 2064, 2400, 2545, 2910, 3445, 3926, 4593, 5198, 5465, 5668, 6225, 6893, 7332, 8007, 8503, 8983, 9247, 9630, 9977, 10407, 10684, 11214, 11478]","[203, 487, 795, 1209, 1510, 1638, 2234, 2402, 2755, 3235, 3464, 3829, 4330, 4613, 4961, 5382, 5936, 6386, 6677, 7128, 7829, 8084, 8395, 8490, 8857, 9162, 9384, 9898, 10147, 10899]","[514, 649, 739, 995, 1566, 1703, 1918, 2060, 2429, 2690, 3182, 3395, 3660, 4032, 4323, 4418, 4749, 4843, 5163, 5612, 5920, 6157, 6502, 6808, 6993, 7391, 7717, 8266, 8675, 8771]","[169, 352, 442, 679, 876, 1001, 1177, 1267, 1481, 1924, 2235, 2325, 2627, 2910, 3192, 3287, 3578, 3672, 3858, 3975, 4364, 4458, 4553, 4648, 4902, 5071, 5324, 5469, 5779, 5875]",12992,11478,10899,8771,5875,10972,7023,6466,939,2805,28205,30,radiant
7572766816,61,47,19,14,138,"[0, 240, 430, 554, 819, 961, 1111, 1437, 1882, 2593, 2907, 3501, 4086, 4580, 5123, 5655, 6581, 7466, 8008, 9509, 10188, 10681, 11969, 12896, 13856, 14063, 14639, 15081, 15282, 16143]","[0, 257, 442, 773, 1186, 1548, 2011, 2374, 2672, 3286, 3852, 4665, 5471, 6143, 7055, 7467, 8296, 8990, 9173, 9567, 10085, 10748, 11401, 11942, 12147, 12761, 13148, 13604, 14125, 14425]","[0, 574, 800, 1170, 1608, 1978, 2260, 2499, 2746, 2920, 3500, 3840, 4324, 4715, 5251, 5771, 6769, 7185, 7825, 7920, 8605, 9486, 10323, 10687, 11436, 11968, 12554, 12965, 13061, 13808]","[0, 236, 351, 441, 768, 898, 1110, 1326, 1416, 1670, 2295, 2928, 3452, 3703, 4194, 4382, 4951, 5244, 5338, 5722, 5993, 6631, 7325, 7631, 7911, 8126, 8463, 8743, 8914, 9712]","[0, 236, 351, 457, 632, 762, 868, 974, 1064, 1326, 1754, 2179, 2762, 2999, 3455, 3602, 4077, 4679, 4847, 4942, 5140, 5840, 6360, 6604, 7112, 7494, 8303, 8862, 9191, 9491]",16143,14425,13808,9712,9491,94,69,129,51,26,"[0, 203, 693, 1136, 1463, 2044, 2374, 3279, 3781, 4244, 4856, 5644, 6330, 7146, 7872, 8560, 9475, 10509, 11052, 11759, 12363, 13409, 14129, 15229, 15899, 17600, 18560, 20000, 21646, 22448]","[0, 208, 729, 1164, 1867, 2679, 3291, 3874, 4135, 4316, 5314, 5717, 6325, 6803, 7445, 7740, 7976, 8467, 9287, 10225, 10618, 11095, 11607, 12032, 12540, 13122, 13528, 14798, 16324, 16626]","[0, 245, 611, 907, 1087, 1427, 1636, 2172, 2642, 3054, 3746, 4416, 4758, 5205, 5613, 6000, 6494, 7129, 7286, 8073, 8724, 8980, 9633, 10164, 10829, 11911, 13004, 13925, 15926, 16070]","[0, 169, 327, 466, 596, 800, 890, 1394, 1484, 1736, 2155, 2507, 2803, 2981, 3129, 3224, 3358, 3665, 3759, 3989, 4147, 4504, 5138, 5628, 6273, 6697, 6901, 7281, 8607, 9154]","[0, 169, 332, 519, 760, 964, 1290, 1441, 1629, 1802, 2255, 2475, 2707, 2856, 3062, 3291, 3423, 3689, 3851, 4497, 4701, 4993, 5159, 5285, 5380, 5641, 5916, 6144, 7180, 7488]",22448,16626,16070,9154,7488,-6305,-2201,-2262,558,2003,-8207,30,dire
7573055806,94,120,96,53,26,"[0, 286, 609, 940, 1309, 1593, 1926, 2374, 2775, 3202, 3440, 3969, 4606, 5182, 5881, 6796, 7717, 8720, 9639, 10517, 11535, 12301, 13522, 14287, 15056, 16435, 17295, 18425, 18999, 19900]","[0, 287, 620, 1061, 1871, 1961, 2392, 2773, 3357, 3777, 4307, 4914, 5314, 5902, 6738, 7098, 7942, 8775, 9431, 9972, 10905, 11444, 12364, 12830, 13028, 13846, 14414, 14815, 15244, 15597]","[0, 210, 883, 1203, 1808, 2317, 2674, 3226, 3898, 4290, 4870, 5337, 5845, 6309, 6797, 7099, 7440, 8285, 9156, 9341, 9686, 10107, 10396, 11314, 11409, 12269, 12891, 13468, 13862, 14412]","[0, 210, 300, 474, 719, 1075, 1210, 1618, 1939, 2063, 2494, 2704, 2969, 3576, 3670, 4283, 4623, 5366, 5883, 6062, 6658, 7304, 8334, 9082, 9420, 9951, 10655, 11292, 11966, 12387]","[0, 210, 385, 607, 829, 1213, 1303, 1483, 1627, 1764, 2027, 2327, 2607, 2943, 3086, 3340, 3954, 4323, 4617, 4712, 5172, 5691, 6037, 6204, 6329, 6624, 6829, 6924, 7703, 7886]",19900,15597,14412,12387,7886,106,93,28,5,105,"[0, 182, 487, 817, 1207, 1753, 1981, 2252, 2848, 3266, 4243, 4509, 4947, 5608, 6614, 7230, 7660, 8093, 8588, 9194, 10079, 10777, 11359, 12001, 12700, 13067, 14150, 14957, 15995, 16728]","[0, 165, 408, 644, 1013, 1138, 1416, 1633, 2014, 2460, 2948, 3352, 3968, 4696, 5053, 5434, 6665, 7389, 8408, 9051, 9736, 10660, 10917, 11382, 11987, 12509, 13249, 13425, 13802, 14174]","[0, 166, 408, 573, 894, 1329, 1744, 2120, 2426, 2638, 2966, 3539, 4011, 4621, 5297, 5718, 6025, 6647, 7662, 8289, 8531, 9266, 9973, 10463, 11260, 11791, 12642, 13373, 13550, 14366]","[0, 169, 259, 444, 642, 732, 868, 1263, 1446, 1867, 2354, 2478, 2629, 3185, 3348, 3669, 4058, 4152, 4615, 5001, 5545, 6227, 6484, 6779, 7142, 7805, 8114, 8581, 8758, 8854]","[0, 130, 220, 310, 440, 720, 855, 1077, 1217, 1484, 1920, 2274, 2585, 2835, 3154, 3639, 4293, 4432, 4680, 4916, 5137, 5606, 5938, 6308, 6609, 6981, 7151, 7485, 7995, 8166]",16728,14174,14366,8854,8166,3172,1423,46,3533,-280,7894,30,radiant
7573242905,38,11,106,105,86,"[0, 533, 931, 1173, 1584, 1989, 2466, 2875, 3581, 4347, 4825, 5247, 5756, 6316, 6840, 7722, 8566, 10012, 10692, 11790, 12511, 13856, 14738, 14897, 15945, 16539, 16715, 17557, 18598, 20429]","[0, 328, 650, 859, 1405, 1785, 2284, 2688, 3055, 3454, 4018, 4585, 4941, 5491, 5960, 6497, 7086, 7775, 8309, 8577, 9284, 9872, 10291, 10837, 11172, 11422, 13318, 13621, 14228, 15962]","[0, 357, 755, 1073, 1410, 1737, 2162, 2809, 3146, 3645, 4146, 4698, 5048, 5564, 5886, 6406, 7103, 7296, 7523, 7791, 8256, 8423, 9074, 10562, 10656, 11369, 11954, 12048, 12904, 13612]","[0, 170, 260, 350, 512, 650, 838, 1037, 1376, 1675, 1972, 2541, 2948, 3498, 4185, 4614, 5482, 5887, 6354, 6822, 7208, 7690, 7947, 8272, 8366, 8461, 8877, 8971, 9249, 10278]","[0, 231, 321, 411, 545, 715, 941, 1031, 1544, 1724, 1904, 2203, 2630, 2954, 3049, 3278, 3471, 3681, 3900, 4168, 4591, 4797, 5054, 5427, 5521, 5616, 5963, 6254, 6431, 7135]",20429,15962,13612,10278,7135,71,22,41,119,5,"[0, 205, 511, 772, 1177, 1745, 2037, 2526, 3110, 3796, 4570, 4939, 6072, 6389, 6644, 7235, 7768, 7968, 8797, 9787, 10723, 11616, 12624, 13470, 14048, 15448, 16258, 16352, 17323, 17773]","[0, 334, 662, 916, 1259, 1663, 2039, 2248, 2577, 3138, 3485, 3883, 4577, 5138, 5986, 6081, 6453, 7605, 8091, 9557, 10497, 11605, 12364, 13248, 14256, 15498, 16519, 17834, 18239, 18857]","[0, 170, 332, 572, 775, 999, 1251, 1378, 1582, 1898, 2457, 2817, 3329, 3810, 4141, 4761, 5161, 5888, 6837, 7791, 8819, 9532, 9855, 10794, 12012, 13110, 13689, 14694, 15700, 16341]","[0, 170, 260, 396, 575, 665, 800, 890, 1349, 1698, 1790, 1880, 2436, 2574, 2843, 3158, 3742, 4513, 4735, 5392, 5668, 5921, 6675, 6999, 8318, 9042, 9381, 9816, 10371, 10482]","[0, 251, 341, 431, 600, 690, 825, 915, 1050, 1306, 1416, 1590, 1974, 2068, 2163, 2616, 2999, 3582, 3767, 4099, 4375, 4470, 4610, 4922, 5944, 6623, 6718, 7032, 7420, 7652]",17773,18857,16341,10482,7652,2656,-2895,-2729,-204,-517,-3689,30,radiant
7573302602,46,29,39,121,31,"[0, 213, 685, 1282, 1711, 2166, 2830, 3352, 3993, 4508, 4995, 5530, 6134, 6852, 7607, 8112, 8645, 9245, 9507, 9743, 10389, 11533, 13060, 13154, 14062, 15905, 17447, 18279, 18456, 19292]","[0, 203, 481, 678, 1197, 1478, 1907, 2185, 2596, 3188, 3974, 4546, 5206, 5754, 6061, 6533, 6905, 7758, 8019, 8484, 8876, 9244, 10298, 10392, 10898, 11705, 12423, 12778, 13423, 14158]","[0, 241, 576, 1035, 1360, 1736, 2167, 2613, 3108, 3715, 4365, 4699, 5791, 6101, 6362, 6804, 7251, 7697, 7826, 8163, 8523, 8778, 9799, 9893, 10148, 10499, 10976, 11553, 11835, 12543]","[0, 130, 220, 310, 492, 630, 801, 938, 1076, 1263, 1882, 1972, 2152, 2403, 2498, 2870, 3011, 3241, 3336, 3626, 4421, 4602, 5122, 5382, 5805, 6326, 6829, 7492, 7708, 8527]","[0, 130, 575, 742, 898, 1037, 1171, 1436, 1573, 1760, 2086, 2623, 3056, 3369, 3464, 3668, 3763, 4038, 4133, 4369, 4464, 4631, 5252, 5421, 5591, 6148, 6590, 6759, 7046, 7754]",19292,14158,12543,8527,7754,95,16,71,23,101,"[0, 364, 564, 868, 1394, 1703, 2119, 2631, 3048, 3219, 3655, 4043, 4737, 5105, 5628, 6405, 7170, 7833, 8764, 9243, 10685, 11325, 12152, 12356, 13296, 13638, 14362, 15957, 17209, 18582]","[0, 291, 537, 1255, 1671, 1918, 2148, 2500, 2881, 3090, 3572, 3991, 4838, 5557, 5885, 6896, 7482, 7768, 8100, 9046, 9635, 9898, 10749, 11789, 12318, 12718, 12894, 13865, 14673, 15269]","[0, 210, 300, 407, 603, 732, 979, 1110, 1245, 1910, 2221, 2311, 2401, 2765, 3144, 3880, 4380, 4801, 5323, 6172, 7223, 7807, 8988, 9387, 10050, 10518, 11264, 11873, 12736, 13101]","[0, 377, 728, 1126, 1584, 1997, 2362, 2751, 3091, 3478, 3869, 4067, 4251, 5083, 5794, 7416, 8140, 8657, 8889, 9438, 9759, 10546, 11159, 11253, 11881, 12244, 12487, 12679, 13253, 14250]","[0, 210, 300, 508, 638, 792, 882, 1275, 1410, 1632, 2234, 2609, 2745, 3074, 3277, 3857, 4245, 4340, 4521, 5308, 5466, 5645, 6486, 6580, 6957, 7226, 7610, 8074, 8648, 9244]",18582,15269,13101,14250,9244,710,-1111,-558,-5723,-1490,-8172,30,dire
7573415915,25,18,2,87,5,"[1, 338, 748, 1185, 1560, 2139, 2632, 3051, 3487, 4297, 5075, 6057, 6630, 7879, 8512, 9378, 10191, 10775, 11315, 12244, 12520, 13506, 13874, 13969, 14804, 15349, 15518, 16450, 16578, 16969]","[1, 290, 508, 905, 1248, 1600, 1997, 2161, 2568, 2870, 3318, 3869, 4320, 4707, 5445, 6090, 6851, 7811, 8883, 9473, 10078, 10391, 11884, 12338, 13261, 13933, 14028, 14680, 14776, 14983]","[1, 245, 691, 1024, 1524, 1846, 2496, 2921, 3308, 3764, 4368, 4942, 5235, 5713, 6533, 6791, 7439, 7936, 8031, 9196, 9642, 10130, 11177, 11272, 12305, 12733, 13180, 13275, 13371, 13467]","[1, 131, 571, 696, 855, 1299, 1407, 1497, 1632, 1856, 2084, 2740, 2967, 3463, 3875, 4207, 4613, 4841, 5231, 6204, 6388, 7238, 7764, 7859, 8509, 8853, 9144, 10045, 10141, 10237]","[1, 131, 221, 391, 528, 658, 834, 924, 1059, 1282, 1466, 2004, 2240, 2702, 2995, 3514, 3808, 3997, 4127, 4338, 4522, 5005, 5280, 5375, 5469, 5636, 6399, 6941, 7037, 7133]",16969,14983,13467,10237,7133,114,15,74,58,26,"[1, 342, 669, 961, 1357, 1809, 2188, 2790, 3380, 3760, 4356, 5019, 5376, 6081, 6716, 7495, 8217, 8911, 10909, 11825, 13302, 14805, 16142, 17456, 18003, 18665, 20883, 23411, 24971, 26895]","[1, 389, 630, 1076, 1374, 2032, 2242, 2796, 3463, 3767, 4410, 5083, 5450, 6185, 6663, 7279, 7970, 8702, 9356, 10123, 10951, 11189, 11992, 12866, 13507, 14005, 15881, 16305, 17477, 18453]","[1, 322, 543, 915, 1243, 1690, 1938, 2381, 2845, 3183, 3495, 3675, 4191, 4654, 5059, 5777, 6231, 6992, 7783, 8388, 8960, 10297, 11024, 11375, 12075, 12280, 13659, 15248, 16546, 18024]","[1, 236, 326, 435, 525, 1210, 1317, 1744, 2196, 2357, 2492, 2672, 3042, 3538, 3978, 4217, 4395, 5680, 5839, 6112, 6753, 7344, 7776, 8476, 8947, 9357, 10096, 10429, 11050, 12286]","[1, 236, 326, 416, 550, 687, 777, 912, 1492, 1631, 1814, 1994, 2084, 2446, 2541, 2862, 3056, 3272, 3437, 3898, 4328, 4920, 5015, 5170, 5485, 5690, 6506, 7576, 8197, 9090]",26895,18453,18024,12286,9090,-9926,-3470,-4557,-2049,-1957,-21959,30,dire
7573491301,98,67,33,9,19,"[0, 281, 481, 897, 1301, 1720, 2136, 2617, 3176, 3587, 4941, 5277, 6382, 7092, 7754, 9032, 9780, 10446, 11291, 12000, 12603, 12833, 13605, 14610, 14957, 16175, 17049, 17143, 17795, 18307]","[0, 165, 449, 809, 1167, 1457, 1661, 1896, 2061, 2374, 2711, 3228, 3511, 4051, 4725, 5613, 6313, 6865, 7645, 8152, 8757, 9396, 9691, 10655, 10750, 11558, 12518, 13260, 14014, 14872]","[0, 253, 578, 1015, 1502, 1919, 2373, 2748, 3141, 3599, 4075, 4702, 5369, 6060, 6460, 7070, 7690, 8379, 8956, 9341, 9885, 10238, 11153, 11948, 12259, 12545, 13201, 13829, 14457, 14950]","[0, 180, 314, 786, 969, 1263, 1419, 1567, 1756, 1938, 2678, 2887, 3191, 3430, 3677, 4201, 4393, 4661, 4913, 5676, 6080, 6310, 6720, 7082, 7445, 7751, 8476, 8645, 8952, 9419]","[0, 130, 220, 310, 400, 538, 675, 810, 1030, 1120, 1817, 1961, 2351, 2590, 2770, 3362, 3723, 4036, 4284, 4489, 4647, 4877, 5044, 5675, 5770, 5865, 6580, 6746, 6976, 7275]",18307,14872,14950,9419,7275,10,28,90,85,26,"[0, 247, 406, 602, 789, 1251, 1755, 2426, 2882, 3335, 3793, 4375, 5035, 5504, 6131, 6279, 7078, 7361, 7817, 8318, 9041, 9903, 11055, 11232, 12550, 12835, 13421, 13749, 14053, 15054]","[0, 284, 477, 872, 1198, 1487, 1869, 2510, 2965, 3326, 3730, 3874, 4743, 5322, 5780, 6261, 6544, 7514, 7969, 8279, 8376, 9079, 9485, 10582, 11411, 12173, 12418, 13080, 13214, 13793]","[0, 259, 552, 890, 1140, 1518, 1957, 2499, 2956, 3701, 3899, 4364, 5015, 5516, 6228, 6539, 7026, 7469, 7564, 8347, 8693, 9095, 9785, 10219, 11180, 11527, 12075, 12271, 12658, 13286]","[0, 210, 300, 409, 499, 635, 770, 1042, 1260, 1724, 1814, 2130, 2450, 2604, 2903, 2997, 3092, 3247, 4406, 4886, 5043, 5363, 5764, 5858, 6741, 7093, 7188, 7365, 7706, 8048]","[0, 210, 300, 620, 759, 1180, 1315, 1584, 1803, 2270, 2534, 2696, 3025, 3174, 3560, 3654, 3749, 3879, 4166, 4437, 4541, 4779, 5077, 5512, 5983, 6255, 6425, 6594, 6765, 7216]",15054,13793,13286,8048,7216,3253,1079,1664,1371,59,7426,30,dire
7573544108,89,43,96,58,26,"[209, 450, 888, 1142, 1426, 1882, 2251, 2764, 2924, 3104, 3364, 4269, 4983, 5741, 6330, 7249, 8161, 8901, 10064, 11531, 12544, 13319, 13751, 14755, 15192, 15892, 17053, 18215, 18741, 19806]","[322, 740, 1024, 1598, 2012, 2442, 3053, 3589, 4061, 4577, 5040, 5675, 6042, 6555, 7055, 7392, 7995, 8480, 9330, 9892, 10700, 10929, 11260, 11541, 12065, 12490, 12947, 13576, 14077, 14830]","[260, 497, 942, 1142, 1495, 1882, 2229, 2788, 3114, 3895, 4442, 4657, 5280, 5642, 6077, 6656, 6931, 7295, 7886, 8391, 8928, 9319, 9618, 10297, 10778, 11142, 11553, 11835, 12251, 12622]","[209, 299, 433, 523, 646, 769, 1066, 1212, 1500, 1763, 1962, 2178, 2894, 3422, 3731, 4220, 4407, 4861, 5085, 5748, 6056, 6526, 6991, 7559, 8229, 8687, 9033, 9210, 9345, 9819]","[209, 342, 823, 980, 1117, 1223, 1488, 1641, 2075, 2255, 2391, 2589, 2956, 3110, 3259, 3527, 3622, 3716, 3948, 4428, 4687, 4991, 5161, 5632, 5802, 6279, 6633, 6917, 7088, 7592]",19806,14830,12622,9819,7592,48,49,137,27,105,"[209, 375, 618, 982, 1109, 1488, 1888, 2234, 2753, 3398, 3938, 4803, 6112, 6944, 7655, 8254, 9148, 9981, 10418, 11545, 12413, 13294, 13961, 15006, 15882, 16398, 17031, 18152, 19089, 19750]","[207, 483, 825, 1276, 1484, 1963, 2551, 3313, 3740, 4454, 5159, 5361, 5911, 6306, 6850, 7517, 7748, 8389, 8989, 9391, 9543, 9780, 10073, 10559, 12115, 12708, 13442, 13691, 14408, 14898]","[200, 445, 845, 1052, 1568, 1785, 2240, 2634, 2769, 3593, 3809, 4229, 4681, 5155, 5547, 6233, 6851, 7374, 7961, 8500, 9165, 9259, 9607, 10059, 11961, 12771, 13114, 13725, 14355, 14792]","[177, 312, 406, 634, 797, 977, 1067, 1316, 1500, 2089, 2196, 2521, 3018, 3255, 3719, 4184, 4369, 4625, 4854, 5233, 5433, 5602, 5844, 6060, 6919, 7594, 8093, 8424, 8556, 8733]","[129, 254, 344, 575, 665, 884, 1204, 1294, 1685, 1993, 2130, 2519, 3205, 3346, 3600, 3868, 4110, 4557, 4908, 5077, 5232, 5326, 5626, 5805, 6450, 7097, 7484, 7883, 8704, 8921]",19750,14898,14792,8733,8921,56,-68,-2170,1086,-1329,-2425,30,dire
7573683309,1,41,137,33,121,"[0, 244, 556, 811, 1391, 1766, 2089, 2498, 2768, 3497, 4172, 4939, 5704, 6229, 6631, 7215, 7573, 7720, 8645, 9280, 9912, 10654, 10912, 11833, 12408, 12703, 13159, 13437, 13783, 14193]","[0, 206, 438, 565, 846, 1304, 1468, 1867, 2239, 2599, 3056, 3322, 3767, 4433, 4989, 5954, 6261, 6891, 7266, 7708, 8365, 8752, 9230, 9933, 10569, 11332, 12170, 12859, 13307, 13480]","[0, 205, 484, 779, 1155, 1485, 1963, 2453, 2955, 3207, 3674, 4163, 4341, 4718, 5211, 6052, 6659, 7267, 7611, 8338, 8968, 9312, 9407, 10167, 10853, 11261, 11499, 11763, 12372, 13046]","[0, 170, 295, 385, 499, 717, 1128, 1535, 1783, 1873, 2527, 2801, 2891, 3169, 3388, 3939, 4506, 4732, 4907, 5459, 5932, 6374, 7031, 7584, 8027, 8746, 9042, 9582, 9753, 10271]","[0, 214, 646, 956, 1229, 1395, 1814, 2073, 2180, 2289, 2559, 2928, 3106, 3424, 3518, 4212, 4370, 4508, 4906, 5339, 5543, 5794, 5889, 5984, 6079, 6450, 6875, 6970, 7066, 7210]",14193,13480,13046,10271,7210,94,129,126,65,86,"[0, 217, 506, 879, 1134, 1348, 1788, 1994, 2255, 2753, 3087, 3355, 3568, 4090, 4614, 5308, 6240, 6681, 7322, 8459, 9192, 9979, 10948, 11833, 12999, 13996, 15040, 16101, 17623, 18388]","[0, 260, 510, 904, 1192, 1556, 1944, 2272, 2683, 3233, 3839, 4658, 4913, 5474, 6223, 6913, 7512, 8658, 9046, 9803, 10429, 10939, 11560, 12256, 12981, 13324, 13781, 14672, 15394, 15937]","[0, 219, 579, 1025, 1394, 1609, 2104, 2521, 2848, 3712, 4200, 4664, 5044, 5497, 6106, 6270, 6987, 7731, 8112, 8596, 8954, 9847, 10298, 10730, 11114, 11638, 12307, 12944, 13487, 13716]","[0, 206, 315, 455, 617, 707, 842, 977, 1150, 1580, 1765, 2159, 2343, 2859, 3294, 3389, 3898, 4514, 4805, 5071, 5290, 6099, 6935, 7754, 8200, 8586, 9472, 9862, 10382, 10738]","[0, 170, 260, 857, 987, 1092, 1510, 1878, 2194, 2799, 3217, 3480, 3831, 4076, 4210, 4305, 4667, 5377, 5690, 5876, 6090, 6541, 6852, 7308, 7650, 7987, 8505, 8785, 9208, 9379]",18388,15937,13716,10738,9379,-4195,-2457,-670,-467,-2169,-9958,30,dire
7573878007,48,106,47,26,100,"[0, 202, 399, 775, 939, 1125, 1487, 1957, 2138, 2969, 3396, 3889, 4398, 4948, 5703, 6695, 7587, 8030, 8642, 9035, 10907, 11382, 12155, 13062, 14174, 15337, 16718, 17658, 18676, 19400]","[0, 228, 392, 687, 816, 906, 1119, 1260, 1813, 2168, 2559, 3037, 3468, 4161, 4572, 5288, 6033, 7332, 7856, 8541, 9218, 9490, 9766, 10099, 11072, 11608, 12460, 13437, 14322, 14975]","[0, 189, 487, 855, 1103, 1724, 1971, 2871, 3109, 3520, 4469, 4665, 5018, 5751, 6312, 6990, 7796, 8645, 8859, 9519, 10065, 10770, 11259, 11916, 12303, 12515, 12719, 13077, 13628, 14084]","[100, 298, 388, 478, 568, 756, 893, 1304, 1523, 1925, 2950, 3040, 3448, 3633, 3875, 4602, 4961, 5954, 6257, 6638, 7327, 7744, 8109, 8782, 9197, 9416, 9695, 10185, 10518, 10689]","[0, 154, 244, 378, 468, 583, 718, 1277, 1367, 1663, 2001, 2125, 2215, 2857, 3154, 3672, 4242, 4485, 4985, 5559, 6069, 6307, 6769, 6978, 7364, 7719, 8083, 8440, 8698, 8794]",19400,14975,14084,10689,8794,73,114,49,123,79,"[0, 368, 819, 1102, 1438, 1571, 2059, 2149, 2541, 3279, 3642, 4206, 5037, 6395, 6965, 7844, 8960, 9810, 10654, 11987, 12688, 13408, 14369, 15365, 16354, 17569, 19000, 20372, 21585, 22162]","[0, 327, 693, 1069, 1443, 2074, 2450, 2905, 3355, 3903, 4166, 4502, 5120, 5412, 5594, 5883, 6392, 6846, 7185, 7279, 8219, 8638, 9190, 9285, 10254, 10783, 11479, 11869, 12244, 13042]","[0, 294, 581, 791, 953, 1543, 1994, 2373, 2950, 3245, 3884, 4567, 5115, 5542, 6067, 6227, 6461, 7074, 7465, 8167, 8609, 8867, 9312, 9540, 10160, 10835, 11100, 11768, 12054, 12230]","[0, 209, 299, 389, 479, 676, 812, 902, 1141, 1406, 1702, 1792, 1882, 2197, 2292, 2386, 2691, 3453, 3635, 3863, 4103, 4361, 4527, 4866, 5373, 6194, 6680, 7468, 7879, 8132]","[0, 209, 299, 442, 870, 960, 1281, 1371, 1521, 1830, 2055, 2156, 2282, 2549, 2664, 2787, 2950, 3427, 4244, 4338, 4588, 5262, 5428, 5727, 5912, 6128, 6488, 6808, 6904, 7196]",22162,13042,12230,8132,7196,-2762,1933,1854,2557,1598,5180,30,radiant
7575056413,46,43,96,86,100,"[0, 297, 630, 1087, 1546, 2171, 2725, 3295, 3728, 4491, 5175, 5645, 6389, 7313, 7977, 8577, 9422, 10057, 10809, 11551, 12346, 13004, 13588, 13896, 13991, 16160, 16647, 17524, 18396, 19943]","[0, 322, 653, 983, 1269, 1498, 1854, 2196, 2635, 3200, 3727, 3943, 4561, 5071, 5824, 6352, 6731, 7071, 7322, 7973, 8068, 8785, 9535, 9752, 10039, 10742, 11778, 12330, 12826, 14370]","[0, 315, 621, 1044, 1287, 1754, 2231, 2717, 3228, 3765, 4454, 4957, 5562, 5862, 6613, 6926, 7195, 7727, 7978, 8214, 8643, 9096, 9499, 9902, 9997, 10529, 11209, 11789, 12443, 13124]","[0, 256, 395, 987, 1127, 1295, 1529, 1857, 2300, 2390, 2615, 2705, 2933, 3232, 3730, 4223, 4318, 4756, 4914, 5071, 5264, 5551, 5970, 6203, 6451, 7223, 7606, 8109, 8344, 9734]","[0, 210, 300, 464, 554, 730, 1126, 1264, 1460, 1694, 1919, 2270, 2597, 2765, 2991, 3182, 3277, 3529, 3780, 4221, 4430, 4635, 5038, 5132, 5593, 6293, 6689, 6832, 7009, 7874]",19943,14370,13124,9734,7874,39,21,67,26,3,"[0, 291, 533, 792, 1123, 1461, 1806, 2191, 2881, 3551, 4195, 4782, 5395, 6245, 7190, 7583, 8870, 9401, 10499, 11544, 12198, 13128, 13963, 15055, 16327, 16809, 17089, 18108, 19197, 19554]","[0, 289, 668, 1079, 1529, 1803, 2102, 2477, 2879, 3220, 3701, 4547, 5190, 6052, 6424, 6813, 8047, 8472, 9029, 9780, 10784, 11049, 11289, 11828, 12964, 13131, 13564, 14207, 14785, 15437]","[0, 206, 523, 764, 1134, 1489, 1867, 2235, 2643, 3244, 3924, 4360, 4704, 5124, 5815, 6257, 6918, 7467, 7894, 8459, 8918, 9503, 10421, 11216, 12382, 13077, 13626, 14110, 14632, 15130]","[0, 130, 220, 310, 445, 540, 630, 768, 903, 1212, 1448, 1816, 1936, 2324, 2559, 2653, 3504, 3718, 3903, 4123, 4402, 4739, 5289, 5743, 5938, 6225, 6688, 7074, 7409, 7673]","[0, 130, 220, 310, 444, 548, 744, 880, 1137, 1227, 1362, 1611, 1701, 2012, 2247, 2388, 3001, 3288, 3933, 4371, 4606, 4836, 5283, 5587, 5894, 6061, 6195, 6358, 6535, 6631]",19554,15437,15130,7673,6631,389,-1067,-2006,2061,1243,620,30,radiant
7575309713,53,98,84,28,86,"[1, 287, 574, 980, 1344, 1995, 2433, 2885, 3235, 3842, 4216, 4673, 5423, 6784, 7210, 7889, 8553, 9476, 10306, 11278, 12341, 12508, 13693, 14815, 15457, 16448, 17698, 18561, 20361, 22573]","[1, 285, 612, 904, 1264, 1748, 2243, 2557, 3113, 3578, 4132, 4639, 4819, 5110, 5566, 6142, 6633, 7261, 7802, 8523, 9434, 9618, 10669, 11248, 11896, 13076, 13879, 14699, 16627, 18235]","[1, 171, 351, 486, 576, 930, 1112, 1284, 1615, 2063, 2593, 2905, 3229, 4224, 4738, 5261, 6130, 6415, 7007, 8003, 8227, 9121, 10140, 10462, 10970, 11718, 12239, 12704, 13525, 13976]","[1, 373, 726, 1053, 1454, 2269, 2487, 2655, 3231, 3401, 4134, 4580, 4785, 5004, 5231, 5485, 6312, 6953, 7534, 8647, 8741, 8997, 9334, 9429, 9815, 10563, 10898, 11281, 13012, 13639]","[1, 171, 261, 385, 521, 736, 915, 1005, 1281, 1772, 2055, 2328, 2631, 3414, 3657, 3929, 4174, 4476, 4943, 5311, 5710, 5923, 6286, 6425, 6609, 7306, 7741, 8109, 8833, 9842]",22573,18235,13976,13639,9842,48,97,23,14,64,"[1, 332, 700, 997, 1236, 1618, 2090, 2464, 3044, 3571, 4445, 5181, 5702, 6713, 7430, 8375, 9275, 10083, 10178, 10627, 11568, 12539, 13592, 13981, 15174, 15974, 16519, 17059, 17671, 18254]","[1, 280, 650, 1144, 1747, 2152, 2556, 3026, 3775, 4180, 4800, 5555, 6018, 6760, 7665, 8268, 8660, 9274, 10245, 10893, 11821, 12411, 12802, 13634, 14226, 14991, 15539, 16474, 16887, 16983]","[1, 282, 555, 961, 1176, 1530, 1912, 2406, 2687, 2948, 3715, 4338, 5186, 5806, 6198, 6853, 7658, 8221, 8782, 9617, 10661, 11935, 12827, 13340, 13549, 13788, 13883, 14695, 14952, 16066]","[1, 171, 261, 398, 566, 802, 940, 1238, 1459, 1740, 2217, 2607, 2885, 3631, 4024, 4299, 4858, 5136, 5402, 6027, 6485, 7017, 7220, 7542, 7636, 7875, 7970, 8360, 8537, 9167]","[1, 171, 261, 351, 441, 615, 752, 857, 947, 1190, 2009, 2697, 3080, 3341, 3595, 3780, 4193, 4371, 4667, 4958, 5464, 5655, 5822, 6420, 6514, 7010, 7105, 7264, 7946, 8349]",18254,16983,16066,9167,8349,4319,1252,-2090,4472,1493,9446,30,radiant
7575446802,120,4,97,65,5,"[0, 276, 608, 960, 1390, 1885, 2293, 2976, 3506, 3929, 4658, 5448, 6336, 6929, 7868, 8211, 8520, 9365, 10404, 10643, 11004, 11470, 12340, 12679, 13204, 13624, 13965, 14596, 15792, 16145]","[0, 282, 607, 974, 1240, 1562, 1849, 1939, 2215, 2580, 3194, 3926, 4422, 4920, 5309, 5848, 6798, 7219, 7841, 8326, 8862, 9445, 10412, 10507, 10871, 11567, 12251, 13318, 13795, 14943]","[0, 245, 475, 1067, 1496, 1918, 2334, 2747, 3386, 3706, 4366, 4991, 5819, 6409, 7140, 7605, 8728, 8912, 9778, 10099, 10922, 11548, 11715, 12418, 13176, 13610, 14590, 14843, 15430, 16251]","[0, 170, 276, 411, 531, 692, 1000, 1164, 1436, 1657, 2014, 2415, 2595, 2888, 3299, 3394, 3845, 4137, 4528, 4833, 5355, 5548, 5762, 6060, 6155, 6577, 6779, 7054, 7422, 8314]","[0, 220, 310, 961, 1226, 1461, 1655, 1839, 2236, 2362, 2591, 3309, 3508, 3821, 4213, 4464, 4745, 5037, 5176, 5271, 5539, 5679, 5933, 6071, 6270, 6542, 6808, 7138, 7506, 7898]",16145,14943,16251,8314,7898,29,90,93,58,86,"[0, 207, 385, 671, 911, 1300, 1601, 2014, 2544, 3127, 3508, 3978, 4547, 5110, 5467, 5645, 6255, 7112, 8084, 8799, 9491, 10034, 10610, 11250, 11850, 12413, 12953, 13570, 14036, 14268]","[0, 249, 564, 895, 1242, 1534, 1940, 2574, 2983, 3601, 3834, 4362, 4625, 5281, 5756, 6025, 6465, 7231, 7745, 8784, 9234, 9798, 10393, 11138, 11757, 12188, 12962, 13370, 13785, 14352]","[0, 258, 544, 779, 1273, 1517, 1878, 2229, 2373, 2907, 3466, 3781, 4440, 5274, 5782, 5877, 6646, 7148, 7300, 7992, 8424, 8849, 9084, 9644, 10182, 10941, 11520, 12473, 13278, 13518]","[0, 170, 260, 350, 440, 592, 700, 835, 1121, 1597, 1807, 2144, 2406, 2914, 3075, 3221, 3793, 4272, 4696, 5519, 6078, 6407, 6754, 7199, 7635, 8360, 8663, 9276, 9710, 10239]","[0, 170, 360, 488, 578, 764, 854, 1096, 1510, 1846, 2507, 2779, 3209, 3470, 3636, 3731, 4719, 5094, 5375, 6035, 6349, 6480, 6715, 7050, 7471, 7737, 7955, 8299, 8571, 8808]",14268,14352,13518,10239,8808,1877,591,2733,-1925,-910,2366,30,radiant
7575553506,25,97,80,119,5,"[0, 240, 583, 987, 1376, 1739, 2075, 2289, 3018, 3445, 4425, 4929, 5441, 6409, 6998, 7893, 8834, 9292, 9386, 10519, 11009, 12003, 12959, 13828, 14245, 14835, 14929, 15781, 16487, 16718]","[0, 169, 499, 901, 1184, 1363, 1794, 2298, 2703, 3089, 3600, 4259, 4805, 5844, 6438, 7276, 7766, 8200, 9412, 10120, 10657, 11284, 11903, 12464, 12733, 12828, 12993, 14246, 15651, 16428]","[0, 205, 580, 835, 1204, 1677, 2150, 2778, 3315, 3687, 4437, 4877, 5337, 5928, 6622, 7400, 7775, 8501, 8595, 9250, 10165, 10750, 11379, 11847, 12577, 12868, 12962, 13438, 14298, 14738]","[0, 169, 259, 473, 612, 768, 858, 1221, 1345, 1435, 2008, 2302, 2471, 2763, 3113, 3371, 3694, 4203, 4400, 4742, 4974, 5230, 5550, 5802, 5897, 5992, 6125, 6478, 7035, 7475]","[0, 254, 344, 478, 663, 771, 1093, 1272, 1439, 1574, 1983, 2277, 2367, 2708, 2885, 3157, 3490, 3686, 3780, 4363, 4459, 4730, 5099, 5303, 5632, 6001, 6359, 6713, 7122, 7837]",16718,16428,14738,7475,7837,10,39,129,65,85,"[0, 206, 603, 1165, 1467, 1705, 1961, 2276, 2671, 3056, 3504, 4412, 4902, 5701, 6282, 6943, 7946, 8677, 9892, 10951, 11908, 12578, 13406, 14177, 14902, 15768, 17384, 18073, 18408, 19956]","[0, 290, 464, 799, 1051, 1266, 1601, 2382, 2655, 3157, 3480, 4161, 4845, 5441, 6153, 6784, 7756, 8358, 9454, 10124, 10556, 11095, 11858, 12498, 13448, 14721, 15991, 16643, 17197, 18249]","[0, 214, 527, 788, 1076, 1490, 1924, 2227, 2604, 3057, 3373, 3939, 4496, 4884, 5357, 5955, 6896, 7483, 8117, 8440, 8651, 9098, 9264, 10109, 10766, 11400, 12608, 12919, 14040, 14551]","[0, 169, 259, 349, 479, 677, 1075, 1369, 1760, 2025, 2289, 3005, 3234, 3426, 3845, 4159, 5130, 5668, 6610, 7105, 7292, 7632, 8144, 8349, 8607, 9145, 10094, 10346, 10523, 10782]","[0, 169, 259, 468, 642, 772, 1017, 1482, 1654, 1744, 1834, 2335, 2495, 2639, 2885, 3046, 3711, 3896, 4768, 5016, 5111, 5404, 5570, 5823, 6081, 6599, 7357, 7489, 7941, 8200]",19956,18249,14551,10782,8200,-3238,-1821,187,-3307,-363,-8542,30,dire
7575770400,18,46,97,40,111,"[0, 242, 523, 974, 1387, 1598, 2093, 2677, 3226, 3562, 4155, 4870, 5591, 5907, 6884, 7828, 8599, 10156, 11117, 12318, 12890, 14437, 15431, 16125, 16965, 17941, 19614, 20839, 21993, 22822]","[0, 254, 453, 615, 787, 1083, 1482, 2052, 2569, 2834, 3450, 3888, 4093, 4888, 5771, 6388, 7163, 7831, 8385, 9176, 9681, 10065, 10716, 11207, 12096, 13108, 14773, 15394, 16156, 16919]","[0, 204, 563, 815, 1272, 1478, 1892, 2221, 2854, 2999, 3343, 3957, 4577, 5133, 5694, 5945, 6503, 6695, 6879, 7221, 7643, 8186, 8720, 8903, 9326, 9725, 10951, 11410, 12313, 12922]","[0, 169, 259, 353, 489, 627, 770, 915, 1106, 1435, 1838, 2160, 2481, 2724, 3655, 4098, 4522, 4654, 5127, 5876, 6418, 6999, 7412, 7734, 8260, 8771, 10180, 10546, 10975, 11522]","[0, 169, 305, 441, 580, 670, 809, 1191, 1351, 1666, 1815, 1931, 2202, 2351, 3105, 3303, 3560, 3966, 4150, 4446, 4566, 4912, 5116, 5211, 5790, 6085, 6798, 7252, 7695, 7953]",22822,16919,12922,11522,7953,89,49,104,105,86,"[0, 206, 533, 863, 1576, 1848, 2370, 2701, 3168, 3605, 4269, 4835, 5517, 6133, 7080, 7685, 8367, 9490, 10392, 11189, 12044, 13347, 14245, 15339, 16130, 17095, 18004, 19795, 20528, 20818]","[0, 327, 773, 1101, 1307, 1670, 2062, 2557, 2946, 3543, 4049, 4595, 5495, 6096, 6215, 6690, 7502, 8021, 8660, 9047, 9390, 9802, 10456, 10962, 11550, 11984, 12535, 13316, 13615, 13931]","[0, 323, 559, 1052, 1528, 1946, 2361, 2751, 3123, 3601, 4087, 4432, 5143, 5713, 6022, 6401, 6828, 7206, 7497, 7988, 8445, 8650, 8987, 9665, 10257, 10884, 11613, 12236, 12983, 13079]","[100, 269, 359, 449, 606, 696, 876, 1056, 1308, 1490, 1670, 1760, 2219, 2585, 2679, 2774, 3170, 3299, 3505, 4118, 4319, 4574, 5032, 5320, 5580, 5933, 6383, 7114, 7559, 7879]","[0, 169, 309, 496, 586, 724, 903, 1083, 1303, 1570, 1788, 1878, 2163, 2402, 2496, 2640, 3115, 3334, 3530, 4164, 4259, 4439, 4605, 4814, 5124, 5702, 6266, 6824, 7001, 7097]",20818,13931,13079,7879,7097,2004,2988,-157,3643,856,9334,30,radiant
7575788217,120,97,80,119,58,"[0, 241, 491, 869, 1293, 1681, 1975, 2584, 2986, 3409, 4030, 5116, 5596, 6273, 6901, 7284, 8327, 8524, 9276, 10118, 10364, 10459, 11111, 11710, 12330, 12604, 13380, 13947, 15007, 15242]","[0, 217, 574, 877, 1413, 1579, 2027, 2279, 2566, 3032, 3578, 4283, 4837, 5203, 5966, 6236, 7167, 7615, 8338, 9146, 9431, 9578, 10466, 11561, 12014, 12832, 13586, 14631, 15526, 15895]","[0, 207, 528, 931, 1416, 1716, 2114, 2618, 2900, 3371, 3636, 3983, 4288, 5106, 5649, 6170, 6663, 7680, 8031, 9091, 9457, 9552, 10060, 10661, 11122, 11924, 13150, 13468, 13963, 14553]","[0, 170, 595, 700, 961, 1098, 1330, 1465, 1606, 1933, 2255, 2860, 2950, 3283, 3468, 3563, 4128, 4418, 4637, 5024, 5695, 5976, 6385, 6692, 7021, 7309, 8007, 8716, 9250, 9581]","[0, 207, 297, 435, 605, 695, 975, 1232, 1483, 1675, 1912, 2219, 2421, 2926, 3263, 3373, 3913, 4312, 4584, 4991, 5275, 5370, 5704, 5923, 6347, 6548, 7712, 8406, 9393, 9572]",15242,15895,14553,9581,9572,25,54,129,5,100,"[0, 366, 743, 1123, 1560, 2030, 2451, 3019, 3462, 4198, 4686, 5404, 5773, 6172, 6784, 7446, 8098, 9625, 10336, 10747, 11310, 12694, 13179, 13917, 14612, 15152, 15968, 16531, 17113, 17379]","[0, 170, 409, 569, 1121, 1492, 1839, 2323, 2856, 3439, 4006, 4597, 5086, 5669, 6239, 6862, 7608, 8181, 8657, 9282, 9772, 10765, 11359, 11868, 12815, 13221, 14308, 14946, 15580, 15888]","[0, 258, 432, 804, 1243, 1498, 1972, 2300, 2806, 3264, 4031, 4781, 5215, 5676, 6083, 6663, 7252, 7924, 8706, 9384, 9478, 10839, 11540, 12274, 12813, 13039, 13381, 13732, 14537, 14819]","[0, 219, 309, 413, 670, 878, 968, 1125, 1270, 1360, 1495, 2067, 2277, 2535, 2812, 3223, 3607, 4124, 4463, 4930, 5346, 5844, 6104, 6274, 6781, 7719, 8307, 8797, 9088, 9381]","[0, 170, 260, 350, 568, 658, 856, 991, 1081, 1331, 1466, 1646, 1736, 1928, 2199, 2562, 2831, 3398, 3976, 4522, 4928, 5770, 6166, 6261, 6499, 6890, 7326, 7785, 7962, 8155]",17379,15888,14819,9381,8155,-2137,7,-266,200,1417,-779,30,dire
7576855616,61,48,59,123,64,"[0, 217, 576, 900, 1336, 1743, 2224, 2868, 3627, 4048, 4773, 5352, 6099, 6417, 7436, 8204, 8999, 9736, 10520, 10886, 11516, 12209, 14048, 14183, 15484, 15969, 16063, 16912, 17792, 19262]","[0, 251, 678, 1129, 1501, 1947, 2413, 2656, 3290, 3889, 4489, 4916, 5267, 5553, 6220, 6805, 7246, 8110, 8668, 9618, 10297, 10626, 11507, 12188, 13406, 14658, 15601, 15696, 17137, 18216]","[0, 292, 592, 1044, 1414, 1867, 2281, 2767, 3306, 3905, 4630, 5001, 5621, 6274, 6920, 7447, 7980, 8508, 9173, 9730, 10004, 10524, 11098, 11193, 12105, 12725, 12819, 14304, 15314, 15520]","[0, 170, 260, 400, 534, 624, 714, 894, 1368, 1671, 1806, 1977, 2101, 2246, 2439, 2657, 3285, 3469, 3699, 4431, 4864, 5016, 5763, 6017, 6319, 6838, 6932, 7589, 8740, 9559]","[0, 170, 276, 366, 811, 922, 1072, 1162, 1287, 1486, 1621, 1711, 2054, 2640, 2995, 3517, 3852, 4350, 4796, 5186, 5477, 5706, 5890, 5985, 6913, 7229, 7323, 7472, 8340, 8760]",19262,18216,15520,9559,8760,46,22,14,74,5,"[0, 242, 608, 968, 1269, 1821, 2265, 2715, 3236, 3716, 4302, 4923, 5681, 6593, 7109, 7718, 8520, 9209, 9908, 10447, 11358, 12204, 13172, 14098, 14692, 15202, 16757, 17897, 18618, 18924]","[0, 334, 732, 1150, 1519, 2276, 2858, 3471, 4197, 4659, 5176, 5516, 6160, 6417, 7071, 7638, 8360, 8835, 9727, 11314, 12122, 12596, 13227, 13657, 14446, 15601, 17299, 17550, 18719, 19152]","[0, 287, 595, 1081, 1618, 2176, 2576, 3127, 3584, 3971, 4272, 4726, 5615, 6069, 6453, 6865, 8133, 8975, 10411, 11551, 11971, 12969, 13849, 13944, 14400, 14911, 15962, 16331, 16596, 17282]","[0, 170, 260, 395, 625, 794, 1020, 1734, 1914, 2049, 2265, 2634, 2932, 3314, 3463, 3722, 4200, 4450, 4545, 4808, 5118, 5733, 6452, 6718, 6960, 7396, 8416, 9344, 9646, 10606]","[0, 170, 365, 503, 593, 736, 936, 1106, 1292, 1427, 1582, 1672, 2007, 2343, 2493, 2587, 3256, 3510, 3631, 3878, 4036, 4640, 4989, 5084, 5179, 5654, 6152, 6360, 6727, 6823]",18924,19152,17282,10606,6823,338,-936,-1762,-1047,1937,-1470,30,dire
7577028402,48,35,21,26,100,"[0, 203, 446, 682, 967, 1261, 1781, 2429, 2776, 3443, 3869, 4578, 5192, 5891, 6624, 7347, 8124, 9053, 9847, 10922, 12044, 13014, 14239, 15113, 16212, 18110, 19443, 20405, 21370, 22214]","[0, 219, 618, 950, 1289, 2052, 2573, 3369, 4229, 5206, 6254, 6654, 7566, 8468, 9037, 9675, 10808, 11446, 12315, 13082, 14228, 14943, 15761, 16378, 17870, 19844, 20109, 20639, 21612, 22194]","[0, 204, 599, 809, 1219, 1528, 1952, 2495, 3059, 3565, 4271, 4783, 5611, 6402, 6998, 7601, 8386, 8821, 8998, 9600, 9797, 10535, 11249, 11939, 12957, 13977, 14242, 15029, 15821, 16312]","[0, 130, 569, 659, 749, 885, 975, 1110, 1511, 1960, 2208, 2372, 2810, 3051, 3331, 3464, 4688, 4993, 5087, 5316, 5486, 5804, 6045, 6215, 7139, 7922, 8262, 9132, 9585, 9747]","[0, 130, 220, 376, 512, 702, 882, 1410, 1500, 1968, 2142, 2373, 2625, 2810, 3274, 3369, 4440, 5104, 5290, 5771, 6064, 6531, 6697, 7078, 7855, 8374, 8837, 9315, 9693, 9789]",22214,22194,16312,9747,9789,46,22,96,86,27,"[0, 335, 738, 1225, 1632, 2029, 2395, 2881, 3214, 3655, 3837, 4414, 4811, 5546, 6369, 7014, 7390, 8346, 9447, 10140, 11453, 12280, 13520, 14350, 15181, 15884, 16751, 17188, 17886, 18677]","[0, 329, 645, 1058, 1527, 1942, 2199, 2588, 3059, 3414, 3965, 4851, 5371, 6478, 6763, 7272, 7403, 8227, 8626, 9379, 10316, 10841, 11468, 12019, 12475, 12850, 14107, 14819, 14949, 15562]","[0, 280, 704, 1038, 1519, 1979, 2253, 2415, 2702, 2831, 3152, 3722, 4436, 5214, 5804, 6135, 6708, 7188, 8139, 8747, 9507, 10215, 11056, 11747, 12426, 12559, 13197, 13872, 14570, 15125]","[0, 210, 300, 417, 884, 974, 1064, 1154, 1589, 1889, 1979, 2271, 2426, 2977, 3222, 3388, 3532, 4264, 5203, 5644, 6052, 6635, 7174, 7374, 7556, 8052, 8262, 8949, 9121, 9424]","[0, 210, 300, 435, 615, 769, 859, 997, 1195, 1285, 1375, 1644, 1734, 2123, 2368, 2691, 3217, 3501, 3983, 4362, 4730, 4874, 5185, 5280, 5515, 5788, 6085, 6549, 6819, 6964]",18677,15562,15125,9424,6964,3537,6632,1187,323,2825,14504,30,radiant
7577175100,52,84,4,48,121,"[0, 334, 583, 877, 1249, 1652, 2000, 2563, 3249, 3803, 4622, 5897, 6508, 7020, 7551, 7645, 8396, 9994, 10598, 10993, 11773, 12474, 13046, 13293, 13859, 14475, 14743, 17101, 17268, 17522]","[0, 280, 536, 716, 1229, 1485, 1952, 2293, 2506, 2857, 3316, 4467, 5282, 5424, 5856, 6772, 7519, 8522, 9199, 9670, 10327, 11163, 11904, 13453, 14350, 15515, 16015, 16289, 17107, 17203]","[0, 283, 560, 818, 1196, 1596, 1759, 2297, 3020, 3578, 4000, 4945, 5489, 6017, 6732, 7133, 7929, 8885, 9052, 9763, 10388, 11198, 12037, 13723, 13906, 14371, 15244, 15339, 16569, 16990]","[0, 215, 305, 395, 485, 575, 710, 879, 1186, 1491, 1704, 2678, 2935, 3241, 3707, 4243, 4775, 5761, 6437, 7033, 7871, 8290, 9365, 9979, 11048, 11954, 12528, 13072, 14238, 14737]","[0, 170, 260, 424, 514, 642, 732, 867, 1244, 1426, 1516, 2017, 2152, 2353, 2677, 2822, 2963, 3292, 3387, 3517, 3612, 3707, 4097, 4381, 4476, 4971, 5278, 6110, 6206, 6378]",17522,17203,16990,14737,6378,69,126,21,45,87,"[0, 242, 519, 865, 1167, 1493, 1905, 2390, 2575, 2916, 3302, 3442, 3961, 4470, 5083, 5945, 6790, 7776, 9105, 9980, 10551, 10928, 11981, 12236, 13156, 14210, 15203, 15458, 16792, 17958]","[0, 325, 648, 1020, 1360, 1818, 2277, 2419, 2924, 3486, 3774, 3912, 4420, 5238, 6201, 7148, 7559, 8130, 8365, 9038, 9638, 10552, 11672, 11767, 12845, 13967, 14592, 15368, 15464, 16157]","[0, 242, 652, 933, 1279, 1656, 1993, 2386, 2818, 3315, 3695, 3977, 4321, 5128, 5759, 6698, 7226, 7908, 8534, 9278, 9627, 10434, 11214, 11309, 12071, 12741, 13488, 15053, 15447, 16610]","[0, 170, 260, 350, 526, 616, 706, 908, 1032, 1305, 1616, 1744, 1878, 2290, 2512, 3234, 3560, 4039, 4606, 5005, 5269, 5586, 6509, 6604, 7109, 7640, 8445, 9022, 10068, 11820]","[0, 170, 615, 795, 954, 1089, 1179, 1317, 1407, 1727, 1939, 2029, 2119, 2637, 2966, 3519, 4150, 4411, 4506, 4726, 4857, 5275, 5885, 6107, 6240, 6737, 7396, 7719, 8215, 9454]",17958,16157,16610,11820,9454,-436,1046,380,2917,-3076,831,30,dire
7577206517,48,39,137,65,84,"[0, 274, 695, 1019, 1230, 1395, 1805, 2302, 2570, 3022, 3616, 4261, 4855, 5899, 6597, 7395, 8516, 9654, 10022, 11277, 11813, 12641, 13932, 14674, 15566, 16234, 17317, 17632, 19148, 20303]","[0, 314, 599, 775, 1284, 1541, 2294, 2814, 3496, 3586, 4112, 5166, 5620, 5803, 6397, 7031, 7648, 8803, 9438, 9759, 10227, 10866, 11693, 12443, 13319, 13871, 15319, 15742, 16725, 17398]","[0, 202, 365, 752, 1062, 1467, 1636, 2134, 2588, 3005, 3274, 4144, 4446, 5117, 5476, 5868, 6873, 7563, 8266, 9433, 9773, 10428, 10810, 12040, 12399, 12727, 13595, 13897, 14902, 15348]","[0, 520, 610, 745, 835, 1107, 1319, 1536, 1744, 1952, 2225, 2476, 2995, 3487, 3706, 4041, 4784, 5533, 6081, 6601, 7131, 7754, 8414, 8707, 9126, 9458, 10195, 10705, 12017, 12370]","[0, 204, 294, 440, 584, 1216, 1577, 1729, 1865, 2161, 2499, 3122, 3304, 3579, 3886, 4099, 4859, 5582, 5959, 6730, 6992, 7205, 8062, 8361, 8528, 8623, 9218, 9312, 9967, 10388]",20303,17398,15348,12370,10388,10,126,96,53,121,"[0, 245, 517, 799, 1243, 1609, 2112, 2612, 2981, 3545, 4228, 4779, 5690, 6318, 6938, 7756, 8978, 10328, 11100, 11195, 12107, 12419, 13689, 14452, 15110, 15883, 16456, 16550, 17246, 18249]","[0, 286, 497, 698, 910, 1186, 1512, 1803, 2147, 2656, 2966, 3147, 3388, 3917, 4608, 5188, 5620, 6390, 6927, 8369, 8903, 9596, 10111, 10448, 10543, 10926, 11405, 12131, 12320, 12617]","[0, 209, 376, 740, 1153, 1818, 2208, 2814, 3194, 3637, 4088, 4301, 4891, 5471, 5981, 6365, 6977, 7914, 8328, 8800, 9283, 9513, 9825, 9919, 10406, 10640, 10936, 11436, 11532, 12033]","[0, 209, 299, 433, 830, 1002, 1314, 1523, 1752, 1906, 2075, 2165, 2391, 2751, 3303, 3594, 4541, 5193, 5532, 6117, 6459, 7236, 7766, 8124, 8452, 8965, 9502, 10025, 10566, 10813]","[0, 209, 415, 526, 787, 959, 1223, 1485, 1703, 2298, 2434, 2780, 2915, 3178, 3592, 3832, 4247, 4680, 4970, 5618, 5938, 6189, 6566, 6660, 6755, 6940, 7236, 7330, 7463, 7944]",18249,12617,12033,10813,7944,2054,4781,3315,1557,2444,14151,30,radiant
7577341016,109,126,14,119,85,"[0, 275, 644, 939, 1419, 1963, 2347, 2864, 3412, 3978, 4515, 5000, 5588, 6260, 6842, 7497, 8129, 8683, 9339, 10067, 10796, 11270, 12141, 12980, 14232, 15470, 17537, 18934, 20174, 20270]","[0, 366, 804, 1210, 1633, 2161, 2611, 3160, 3715, 4189, 4745, 5480, 6033, 6665, 7349, 8025, 8572, 8978, 9616, 10337, 10909, 12302, 13204, 13909, 14513, 15495, 16576, 17661, 18862, 18958]","[0, 239, 484, 935, 1303, 1755, 2119, 2658, 3134, 3432, 3885, 4387, 4597, 5081, 5692, 6218, 6442, 7181, 7376, 8177, 8678, 8921, 9165, 9900, 10482, 10646, 11141, 12381, 12580, 12983]","[0, 170, 260, 398, 537, 716, 806, 988, 1542, 1681, 1815, 2552, 2642, 2904, 3134, 3277, 3372, 3505, 3662, 4287, 4445, 4540, 5265, 5984, 6254, 6349, 7164, 8157, 8254, 8350]","[0, 170, 260, 350, 485, 663, 753, 891, 1026, 1116, 1254, 1392, 1528, 1623, 1808, 1949, 2093, 2188, 2345, 2440, 2598, 2693, 2787, 2954, 3224, 3319, 3648, 3988, 4520, 4661]",20270,18958,12983,8350,4661,17,10,16,86,87,"[0, 330, 826, 1387, 1976, 2457, 2962, 3538, 4118, 4631, 5179, 5639, 6309, 6613, 7390, 8112, 9007, 9889, 10815, 11119, 11612, 12762, 13238, 13333, 14185, 14941, 15169, 15682, 17485, 18353]","[0, 282, 654, 1015, 1523, 1972, 2265, 2793, 3001, 3532, 3847, 4150, 4444, 5092, 5956, 6623, 7644, 8568, 9380, 9891, 10577, 11024, 11193, 11684, 11993, 12313, 12560, 12655, 13920, 14641]","[0, 275, 648, 1154, 1601, 2022, 2416, 2870, 3320, 3777, 4231, 4724, 5184, 5484, 6167, 6562, 7379, 8320, 8506, 9056, 9799, 10148, 10353, 10605, 11564, 12365, 12771, 13248, 14086, 14306]","[0, 170, 296, 492, 670, 869, 1006, 1189, 1279, 1553, 1723, 1912, 2153, 2298, 2744, 2958, 3426, 3701, 4122, 4413, 5007, 5930, 6702, 7119, 7286, 8003, 8525, 8966, 9707, 9803]","[0, 221, 352, 461, 635, 770, 860, 1044, 1153, 1590, 1741, 1884, 1974, 2432, 2748, 2951, 3244, 3568, 3792, 3887, 4135, 4230, 4632, 4828, 5276, 5711, 5805, 6081, 6822, 6918]",18353,14641,14306,9803,6918,1917,4317,-1323,-1453,-2257,1201,30,radiant
7577579206,93,120,28,66,123,"[0, 170, 482, 698, 985, 1188, 1681, 2091, 2951, 3888, 4521, 4953, 5660, 6137, 6855, 7273, 7746, 8846, 9247, 10767, 11484, 12493, 13397, 13921, 15029, 15697, 16429, 16761, 17668, 17927]","[0, 288, 562, 894, 1022, 1314, 2053, 2388, 3066, 3321, 4427, 4857, 5521, 6095, 6798, 7233, 7749, 8528, 9015, 9675, 10208, 10690, 11426, 11723, 12676, 13573, 14138, 15080, 15718, 16200]","[0, 204, 530, 767, 997, 1436, 1825, 2237, 2327, 2671, 3171, 3898, 4196, 4741, 5339, 6110, 6528, 7473, 7784, 8326, 8714, 9182, 9971, 10373, 11098, 11724, 12075, 12326, 12949, 13146]","[0, 216, 366, 770, 918, 1113, 1508, 1782, 2333, 2787, 3262, 3595, 3958, 4281, 4980, 5371, 6024, 7056, 7360, 7743, 8217, 8729, 9249, 9558, 9954, 10737, 11235, 11510, 12300, 12560]","[0, 170, 309, 399, 580, 805, 985, 1247, 1337, 1427, 1751, 1977, 2410, 2558, 2932, 3083, 3614, 4175, 4648, 5231, 5636, 6197, 6481, 7042, 7319, 8023, 8373, 8700, 9003, 9128]",17927,16200,13146,12560,9128,48,106,14,53,27,"[0, 208, 483, 863, 1096, 1545, 2030, 2485, 2992, 3679, 4184, 4833, 5575, 6426, 7342, 8246, 9560, 10147, 10860, 11718, 12564, 13471, 14199, 14683, 15308, 16183, 17678, 18466, 19304, 20103]","[0, 276, 602, 1064, 1588, 1978, 2544, 2869, 3766, 4360, 4488, 4742, 5044, 5680, 5956, 6372, 7184, 7476, 7928, 8330, 8646, 9238, 9782, 10203, 10297, 10941, 11036, 11454, 12066, 12162]","[0, 205, 441, 1054, 1278, 1797, 2050, 2501, 2916, 3310, 3697, 3787, 3877, 4486, 4923, 5423, 5892, 6490, 6963, 7272, 7487, 7923, 8267, 8427, 8947, 9277, 9520, 9946, 10232, 10414]","[0, 170, 260, 602, 761, 941, 1300, 1554, 1924, 2285, 2503, 2658, 2826, 3128, 3292, 3387, 3905, 4546, 4921, 5016, 5293, 5663, 6313, 6446, 6589, 6986, 7447, 7598, 7840, 8173]","[0, 220, 310, 682, 772, 989, 1145, 1399, 1534, 1987, 2251, 2341, 2431, 3216, 3452, 3547, 3813, 4180, 4275, 4395, 4489, 4786, 4926, 5021, 5115, 5282, 5415, 5710, 5916, 6012]",20103,12162,10414,8173,6012,-2176,4038,2732,4387,3116,12097,30,radiant
7577870703,10,49,53,97,26,"[0, 204, 473, 802, 1170, 1394, 1899, 2400, 2900, 3260, 4074, 4663, 5294, 5798, 5927, 6371, 7051, 7611, 8159, 9201, 9296, 10612, 11800, 12781, 13592, 13867, 15275, 15441, 15938, 16754]","[0, 314, 604, 1085, 1251, 1496, 2090, 2553, 3137, 3599, 4274, 4618, 5115, 5884, 6284, 6478, 6663, 6994, 7495, 8075, 8615, 9557, 10482, 10967, 11622, 12337, 13142, 14220, 14316, 15049]","[0, 170, 260, 350, 528, 656, 1122, 1245, 1479, 1569, 1905, 2748, 2972, 3298, 3495, 3783, 4169, 4563, 4947, 5542, 6063, 6804, 7444, 7960, 8460, 8913, 9892, 9986, 10248, 10477]","[0, 242, 489, 774, 1059, 1360, 1616, 1958, 2225, 2614, 3051, 3653, 3887, 4466, 4827, 5014, 5528, 6206, 6410, 6783, 7745, 8355, 8671, 9629, 9813, 9908, 10296, 10764, 11304, 11850]","[0, 170, 358, 492, 622, 712, 880, 970, 1060, 1150, 1389, 1562, 1817, 2201, 2466, 2584, 2961, 3056, 3293, 3508, 3906, 4590, 4946, 5246, 5416, 5654, 6220, 6481, 6652, 6877]",16754,15049,10477,11850,6877,48,65,96,20,79,"[0, 294, 572, 736, 1107, 1349, 1928, 2365, 2894, 3660, 4318, 5094, 5821, 6668, 7318, 8029, 8984, 10139, 10957, 11966, 12347, 13198, 14454, 15116, 15955, 16644, 17768, 19200, 20583, 21705]","[0, 209, 497, 829, 1135, 1404, 1747, 2280, 2869, 3665, 3983, 4503, 5004, 5905, 6282, 7145, 7803, 8401, 8967, 9853, 10479, 10752, 11467, 11749, 11954, 12413, 13355, 14137, 14969, 15707]","[0, 255, 611, 899, 1301, 1671, 2044, 2479, 2820, 3279, 3877, 4458, 4979, 5521, 6311, 6992, 7537, 8523, 8859, 9468, 10169, 10599, 10914, 11277, 11774, 12462, 13066, 13465, 14107, 14997]","[0, 170, 260, 445, 940, 1084, 1507, 1687, 1834, 2090, 2380, 2614, 3032, 3531, 3680, 4081, 4440, 5125, 5320, 5966, 6233, 6608, 6999, 7373, 7661, 8107, 8669, 8995, 9590, 10190]","[0, 170, 279, 422, 641, 731, 821, 1050, 1314, 1633, 2210, 2822, 3088, 3409, 3766, 4423, 5086, 5686, 6025, 6535, 6860, 7387, 7626, 7910, 8429, 8596, 8827, 9356, 9777, 9873]",21705,15707,14997,10190,9873,-4951,-658,-4520,1660,-2996,-11465,30,radiant
7578076914,25,70,98,20,121,"[0, 278, 402, 655, 979, 1223, 1762, 2325, 2855, 3249, 3865, 3992, 4177, 4609, 5263, 6044, 6750, 7691, 8506, 9192, 10270, 10996, 12080, 12803, 13569, 14502, 15064, 15742, 15846, 16568]","[0, 628, 805, 963, 1419, 1699, 1941, 2150, 2452, 2542, 3205, 3760, 4097, 4836, 5230, 6033, 6737, 7517, 8081, 8853, 10243, 10587, 11330, 11882, 12719, 13444, 14799, 15145, 15452, 16091]","[0, 278, 563, 1081, 1398, 1758, 2072, 2416, 2826, 3443, 4187, 4328, 4565, 5126, 5861, 6075, 6916, 7606, 8617, 9304, 9474, 9851, 10297, 10806, 11546, 12133, 12399, 12809, 13109, 13282]","[100, 339, 429, 563, 825, 1170, 1260, 1505, 1595, 1685, 2195, 2457, 2607, 2850, 3011, 3240, 3449, 3610, 3938, 4189, 4354, 4656, 5293, 5616, 5764, 6035, 6593, 6742, 6921, 7248]","[0, 218, 308, 479, 663, 799, 1154, 1474, 1593, 1683, 2008, 2098, 2248, 2396, 2643, 3026, 3184, 3386, 3571, 3811, 4271, 4440, 4906, 5165, 5335, 5576, 5782, 5952, 6123, 6352]",16568,16091,13282,7248,6352,113,114,29,53,27,"[0, 289, 650, 992, 1366, 1780, 2140, 2658, 3406, 4102, 4817, 5877, 6840, 7541, 7899, 8435, 8944, 9449, 10105, 10880, 11894, 12428, 13097, 14234, 14768, 15950, 17848, 18638, 19778, 21205]","[0, 293, 612, 935, 1247, 1537, 1732, 2037, 2494, 2823, 3040, 3499, 4439, 4971, 5390, 5877, 6661, 7177, 7650, 7808, 8903, 9386, 9553, 10243, 10742, 11432, 12329, 13201, 13832, 14642]","[0, 208, 569, 772, 1116, 1331, 1603, 2247, 2834, 3516, 3845, 4581, 5222, 5926, 6498, 7022, 7734, 8491, 9463, 10172, 10357, 10451, 10827, 11190, 11627, 12163, 12938, 13918, 14799, 15671]","[0, 170, 260, 901, 1283, 1465, 2051, 2296, 2768, 3285, 3614, 4097, 4836, 5159, 5568, 5957, 6452, 7222, 7656, 7988, 8772, 9314, 10004, 10481, 10989, 11299, 11730, 12140, 13139, 13699]","[0, 170, 260, 350, 577, 707, 944, 1125, 1509, 1715, 1932, 2184, 2922, 3125, 3219, 3411, 3641, 3798, 4159, 4409, 4834, 4976, 5143, 5671, 5869, 6035, 6745, 6840, 7770, 8332]",21205,14642,15671,13699,8332,-4637,1449,-2389,-6451,-1980,-14008,30,dire
7578151603,44,98,23,75,101,"[0, 244, 454, 857, 1436, 1770, 2246, 2669, 3151, 3369, 3782, 4325, 4775, 5637, 6110, 6806, 7642, 8314, 8773, 9617, 10182, 11226, 12143, 12731, 13958, 14870, 15869, 16850, 17196, 17838]","[0, 208, 621, 957, 1373, 1791, 2195, 2509, 2842, 3601, 4441, 4920, 5534, 6789, 7245, 7701, 8201, 8745, 9506, 9995, 10524, 10879, 11060, 11561, 11856, 13053, 13222, 13673, 13896, 14678]","[0, 243, 443, 685, 924, 1110, 1348, 1664, 2238, 2445, 3292, 3833, 4281, 4940, 5738, 6156, 6649, 7373, 7888, 8200, 8515, 8925, 9657, 9963, 10476, 11148, 11343, 12264, 12535, 13281]","[0, 169, 259, 394, 601, 739, 999, 1356, 1446, 1672, 2061, 2448, 2583, 3089, 3437, 3647, 3797, 4153, 4313, 4612, 4724, 4987, 5154, 5879, 5974, 6403, 6497, 6848, 7084, 7611]","[0, 169, 605, 908, 1082, 1216, 1306, 1498, 1874, 1964, 2359, 2600, 2690, 2929, 3078, 3280, 3405, 3668, 3808, 3968, 4290, 4456, 4794, 5013, 5108, 5348, 5442, 5618, 6075, 6171]",17838,14678,13281,7611,6171,38,114,93,123,26,"[0, 243, 537, 844, 1127, 1873, 2318, 2621, 3292, 3551, 4339, 4693, 5407, 5971, 6833, 7287, 8089, 8613, 9744, 10452, 11061, 11767, 12602, 13009, 13718, 14483, 14780, 15574, 16110, 16352]","[0, 281, 599, 827, 1291, 1587, 2072, 2579, 3029, 3513, 3826, 4626, 5270, 6171, 6612, 6706, 7496, 8357, 8674, 9217, 9548, 10142, 10444, 10904, 11395, 12085, 12478, 13262, 13946, 14648]","[0, 275, 478, 875, 1114, 1373, 1742, 2111, 2606, 3151, 3391, 4180, 4686, 5257, 5676, 6102, 6939, 7652, 8072, 8818, 9426, 10166, 11486, 12207, 12707, 13329, 13517, 14303, 15064, 15280]","[0, 169, 303, 441, 647, 1136, 1226, 1445, 1868, 2222, 2462, 2774, 2894, 3254, 3581, 4016, 4433, 5336, 5732, 6204, 6607, 6900, 7518, 8237, 8671, 9118, 9393, 10160, 10783, 10913]","[0, 169, 259, 394, 519, 771, 878, 1058, 1283, 1472, 1738, 2045, 2135, 2745, 3023, 3117, 3583, 3877, 4017, 4323, 4418, 4597, 5277, 5473, 5734, 6325, 6494, 7113, 7284, 7623]",16352,14648,15280,10913,7623,1486,30,-1999,-3302,-1452,-5237,30,dire
7578386514,73,39,129,58,26,"[0, 538, 807, 1376, 1848, 2208, 2753, 3097, 3689, 4106, 4854, 5182, 5995, 6441, 6870, 7812, 8806, 9963, 11166, 11883, 12580, 13530, 14446, 15411, 16270, 18002, 18701, 19441, 20483, 21039]","[0, 279, 561, 878, 1312, 1565, 2084, 2398, 2857, 3191, 3798, 4398, 5070, 5788, 6273, 7144, 7874, 9044, 9706, 10134, 10633, 11655, 12200, 13872, 14551, 15869, 16305, 16802, 17280, 18209]","[0, 361, 690, 936, 1220, 1770, 2368, 2762, 3100, 3670, 4180, 4479, 4956, 5395, 5709, 6384, 6842, 7433, 7647, 7925, 8846, 9276, 9909, 10804, 11310, 12122, 12326, 12713, 13252, 13905]","[100, 653, 743, 833, 1027, 1212, 1320, 1563, 1903, 2088, 2240, 2530, 2899, 3142, 3453, 3718, 4097, 4469, 4829, 5361, 5636, 5924, 6252, 6909, 7262, 7998, 8459, 8787, 9217, 9694]","[0, 285, 440, 530, 763, 925, 1423, 1513, 1696, 1986, 2453, 2692, 3021, 3222, 3617, 4135, 4293, 4658, 5171, 5443, 5601, 5941, 6192, 6918, 7206, 7916, 8166, 8777, 9079, 9467]",21039,18209,13905,9694,9467,48,28,21,100,20,"[0, 278, 677, 1080, 1654, 2057, 2255, 2834, 3257, 3511, 4035, 4744, 5772, 6360, 7332, 8429, 9230, 9325, 10058, 10868, 11705, 12668, 13540, 14440, 15095, 15852, 17338, 17711, 18568, 19549]","[0, 129, 492, 827, 1206, 1586, 1984, 2367, 2815, 3142, 3428, 4107, 4450, 4918, 5519, 6108, 6624, 6989, 7958, 8777, 9491, 9650, 10337, 10592, 10687, 11101, 11846, 12150, 12422, 13226]","[0, 422, 765, 1058, 1389, 1682, 1997, 2531, 2920, 3193, 3817, 4189, 4780, 5082, 5582, 5816, 6329, 6852, 7611, 7947, 8701, 9462, 9777, 9982, 10431, 10526, 10919, 11368, 11826, 12655]","[0, 129, 219, 309, 565, 701, 1066, 1293, 1640, 1865, 2000, 2313, 2646, 2990, 3198, 3576, 4105, 4247, 4514, 4930, 5337, 5507, 5798, 6078, 6490, 6660, 6919, 7687, 8248, 8504]","[0, 206, 326, 516, 784, 964, 1089, 1305, 1487, 1695, 1978, 2240, 2535, 2630, 2928, 3255, 3449, 3665, 3760, 3917, 4147, 4498, 4916, 5121, 5313, 5408, 5853, 6198, 6399, 6624]",19549,13226,12655,8504,6624,1490,4983,1250,1190,2843,11756,30,radiant
7578531212,41,120,98,65,121,"[0, 239, 441, 570, 947, 1099, 1298, 1756, 2094, 2453, 2854, 3279, 3656, 4129, 4972, 5313, 5574, 6838, 7717, 8311, 9065, 9997, 10463, 10674, 11618, 12074, 12586, 12846, 13287, 14297]","[0, 247, 499, 822, 1135, 1386, 1574, 1995, 2171, 2729, 3313, 3502, 4479, 4971, 5972, 6540, 6850, 8236, 8875, 9822, 10694, 11228, 11530, 11970, 12204, 12651, 13450, 13740, 14329, 14804]","[0, 206, 333, 648, 872, 1117, 1315, 1915, 2158, 2774, 3686, 4255, 4421, 5405, 6027, 6624, 7213, 8047, 8851, 9291, 10027, 10647, 11601, 11812, 12253, 12401, 12692, 13147, 13563, 14237]","[0, 170, 341, 526, 898, 1074, 1164, 1631, 1721, 1858, 2253, 2460, 2864, 3246, 3815, 4119, 4509, 5462, 6177, 6503, 7092, 7262, 7639, 7992, 8604, 9022, 9388, 10014, 10185, 10535]","[0, 170, 310, 419, 593, 736, 860, 1257, 1347, 1572, 2041, 2131, 2489, 2728, 3292, 3505, 3645, 4187, 4542, 4779, 5164, 5259, 5586, 5860, 6129, 6224, 6515, 6634, 6876, 7151]",14297,14804,14237,10535,7151,46,23,96,68,26,"[0, 323, 667, 868, 1356, 1660, 2218, 2701, 3203, 3783, 4268, 4915, 5757, 6474, 7195, 7881, 8527, 9574, 10099, 10686, 11056, 11431, 12280, 13706, 15169, 16452, 17986, 18680, 19387, 20128]","[0, 294, 619, 1029, 1318, 1734, 2157, 2549, 3065, 3689, 4128, 4582, 4821, 5476, 5684, 6032, 6386, 6906, 7648, 8436, 9179, 9655, 10171, 10860, 11212, 12021, 13251, 14049, 14964, 16030]","[0, 241, 482, 695, 1114, 1435, 1716, 2107, 2462, 2879, 3014, 3390, 3605, 4200, 4334, 4846, 5521, 5901, 6369, 7034, 7337, 7984, 8828, 9097, 9790, 10546, 11483, 12396, 12962, 13374]","[0, 170, 260, 350, 440, 610, 918, 1172, 1262, 1505, 1852, 2212, 2408, 2730, 2825, 2920, 3249, 3917, 4310, 4657, 5260, 5515, 6024, 6798, 7273, 7960, 9213, 9918, 10492, 10809]","[0, 170, 593, 683, 922, 1012, 1293, 1473, 1590, 1722, 1867, 2003, 2181, 2388, 2521, 2616, 2773, 2997, 3199, 3467, 3562, 3710, 4026, 4950, 5572, 6135, 6506, 6951, 7284, 7455]",20128,16030,13374,10809,7455,-5831,-1226,863,-274,-304,-6772,30,radiant
7578636015,113,46,49,86,85,"[0, 380, 698, 1103, 1906, 2356, 2689, 3051, 3516, 3975, 4516, 5081, 5738, 6278, 7131, 7668, 8699, 9282, 9985, 10926, 11618, 11922, 13668, 13947, 14902, 15831, 16753, 17891, 19053, 19149]","[0, 239, 440, 854, 1384, 1643, 1984, 2421, 3016, 3516, 4270, 4974, 5674, 6268, 7098, 7294, 7801, 8493, 8751, 9475, 10180, 11114, 11893, 12964, 14101, 14864, 15655, 16675, 16861, 18703]","[0, 204, 562, 889, 1333, 1725, 2083, 2173, 2819, 3554, 3933, 4488, 5204, 5688, 6367, 6845, 7453, 8285, 9256, 10104, 11159, 11720, 13243, 13881, 14257, 15289, 15821, 16763, 17424, 18482]","[0, 170, 260, 386, 623, 781, 1213, 1372, 1764, 2053, 2243, 2582, 3060, 4346, 4688, 4876, 5160, 5788, 6364, 7084, 7321, 7416, 8115, 8574, 8893, 9278, 9463, 9792, 9978, 11252]","[0, 170, 260, 395, 530, 706, 913, 1003, 1230, 1669, 1759, 1998, 2137, 2456, 2605, 2699, 2880, 3416, 3613, 4073, 4168, 4544, 4735, 4829, 4924, 5091, 5387, 5901, 6482, 6578]",19149,18703,18482,11252,6578,11,6,96,84,19,"[0, 326, 703, 1072, 1604, 2152, 2717, 3407, 3931, 4582, 5093, 5680, 6356, 6822, 7125, 8329, 9294, 9723, 10466, 11423, 13234, 13329, 14207, 14953, 15651, 16140, 16315, 17629, 19768, 21095]","[0, 279, 477, 800, 1130, 1539, 1904, 2362, 2603, 2772, 3183, 3610, 4375, 4874, 5448, 6172, 6894, 7348, 7751, 8534, 9080, 9872, 10685, 11419, 12211, 13100, 14013, 15214, 17370, 18344]","[0, 209, 498, 796, 1167, 1410, 1746, 2043, 2295, 2685, 2933, 3387, 4037, 4481, 4931, 5682, 6295, 7268, 8006, 8909, 9795, 10596, 10691, 11346, 11882, 12611, 13183, 14573, 15821, 16439]","[0, 170, 305, 395, 560, 660, 1034, 1169, 1341, 1465, 1601, 1751, 2012, 2215, 2388, 2692, 2913, 3063, 3208, 3531, 4832, 4927, 5227, 6268, 6944, 7186, 7659, 8517, 9809, 10695]","[0, 170, 260, 350, 515, 605, 822, 996, 1086, 1176, 1451, 1674, 1971, 2302, 2536, 3410, 3860, 4240, 4586, 4881, 5113, 5455, 5550, 5824, 5919, 6699, 7100, 7923, 9045, 9434]",21095,18344,16439,10695,9434,-1946,359,2043,557,-2856,-1843,30,radiant
7578647418,1,63,120,105,100,"[0, 241, 572, 863, 1194, 1357, 1688, 1896, 2073, 2458, 3084, 3875, 4580, 4986, 5220, 5788, 6624, 7116, 7944, 8039, 8970, 9849, 10941, 11994, 12639, 13681, 14674, 15490, 16430, 17306]","[0, 221, 386, 748, 1246, 1819, 2487, 2879, 3444, 4109, 4467, 5322, 5808, 6447, 6761, 7126, 7472, 7979, 8637, 9288, 10181, 10741, 11685, 12271, 12847, 13304, 13719, 14369, 14911, 15750]","[0, 279, 563, 1008, 1409, 1772, 2185, 2518, 3042, 3672, 4056, 4576, 5086, 5478, 5824, 5919, 6713, 7317, 7917, 8313, 8985, 9692, 10392, 11021, 11941, 12623, 13128, 13772, 14225, 14750]","[0, 170, 278, 413, 543, 711, 880, 1015, 1135, 1643, 1778, 2316, 2447, 2865, 3089, 3188, 3693, 3938, 4212, 4496, 4956, 5225, 5796, 6073, 6425, 6906, 7365, 7577, 8352, 8535]","[0, 208, 298, 424, 691, 856, 1093, 1482, 1618, 1909, 2081, 2579, 2808, 3215, 3309, 3404, 3608, 3905, 4179, 4470, 4837, 5439, 6116, 6531, 6799, 7138, 7399, 7662, 7875, 8163]",17306,15750,14750,8535,8163,94,98,106,65,86,"[0, 389, 559, 981, 1143, 1433, 1821, 2216, 2599, 3018, 3303, 3972, 4423, 5044, 5850, 6517, 7556, 8156, 8810, 9511, 10564, 10892, 11671, 12474, 13265, 14211, 14920, 15607, 16702, 17107]","[0, 305, 601, 1055, 1221, 1628, 2165, 2590, 3188, 4051, 4547, 5227, 5940, 6681, 7220, 7867, 8433, 9020, 9698, 10399, 10950, 11542, 12323, 12960, 13324, 14206, 15220, 15748, 16749, 17575]","[0, 688, 931, 1437, 1730, 2109, 2582, 3394, 3724, 4172, 4549, 5284, 5870, 6236, 6790, 7370, 7834, 8100, 8766, 9333, 9776, 9942, 10746, 10951, 11596, 11996, 12599, 13066, 13773, 14378]","[0, 232, 322, 459, 549, 719, 1110, 1403, 1519, 1813, 1950, 2442, 2806, 3180, 3457, 3946, 4462, 4906, 5501, 5769, 6215, 6381, 6687, 7005, 7193, 7625, 8336, 8636, 9137, 9653]","[0, 232, 358, 497, 736, 906, 1342, 1639, 1787, 2159, 2563, 2759, 3412, 3655, 3940, 4162, 4625, 4771, 5190, 5877, 6142, 6308, 6622, 6920, 7343, 7765, 8090, 8185, 8472, 8998]",17107,17575,14378,9653,8998,199,-1825,372,-1118,-835,-3207,30,radiant
7578648816,80,98,74,105,26,"[0, 256, 536, 992, 1236, 1638, 2198, 2446, 2792, 3254, 3908, 4579, 5077, 5272, 6168, 6663, 7099, 7955, 8944, 9694, 10324, 10634, 11653, 11768, 12444, 12566, 12970, 13718, 14325, 15700]","[0, 294, 544, 1030, 1386, 1623, 1955, 2089, 2713, 3220, 3885, 4450, 5072, 5647, 5929, 6591, 7073, 7610, 7890, 8381, 9328, 9758, 10832, 11109, 11282, 11493, 12099, 12672, 13512, 14167]","[0, 296, 609, 996, 1251, 1482, 1774, 2116, 2782, 3333, 3646, 4095, 4554, 5000, 5792, 6192, 6377, 6957, 7158, 7507, 8301, 8916, 10069, 11112, 11580, 11674, 12077, 12884, 13851, 14500]","[0, 170, 260, 475, 565, 655, 745, 835, 1139, 1401, 1705, 1949, 2440, 2649, 3115, 3377, 3472, 3825, 4036, 4365, 4880, 5253, 5645, 5740, 6231, 6430, 6930, 7187, 7364, 7619]","[0, 170, 260, 394, 518, 608, 724, 814, 1296, 1692, 1821, 1911, 2205, 2438, 2622, 2807, 2902, 3480, 3807, 4139, 4452, 4731, 4984, 5288, 5899, 6182, 6277, 6534, 6711, 7218]",15700,14167,14500,7619,7218,25,120,97,86,83,"[0, 204, 570, 1126, 1801, 2353, 2728, 3437, 3861, 4328, 4841, 5441, 5914, 6462, 6839, 7337, 8079, 9039, 9836, 10565, 11271, 12440, 12717, 13493, 14334, 15825, 16467, 17337, 17908, 19573]","[0, 347, 633, 922, 1383, 1769, 1980, 2604, 2817, 3146, 3780, 4142, 4848, 5099, 5769, 6414, 6806, 7261, 7931, 8446, 9009, 9506, 10314, 10971, 11324, 11802, 12262, 12776, 13466, 14039]","[0, 255, 874, 1037, 1364, 1738, 1962, 2281, 2578, 2826, 3190, 3621, 4163, 4530, 4836, 5684, 6356, 6613, 6894, 7275, 7512, 7992, 8528, 9979, 10264, 10636, 11242, 11732, 12474, 13192]","[0, 209, 368, 504, 641, 839, 958, 1198, 1580, 1670, 1937, 2105, 2331, 2812, 3291, 3554, 4024, 4890, 5200, 5530, 5828, 6497, 6724, 7298, 7513, 7958, 8251, 8747, 9208, 10500]","[0, 170, 260, 503, 713, 1291, 1510, 1938, 2028, 2118, 2253, 2691, 2917, 3199, 3353, 3569, 3828, 4138, 4333, 4569, 4860, 5215, 5405, 5985, 6223, 6389, 6717, 7054, 7311, 7835]",19573,14039,13192,10500,7835,-3873,128,1308,-2881,-617,-5935,30,dire
7578694819,18,106,129,123,110,"[73, 319, 690, 1130, 1546, 1934, 2182, 2651, 3574, 4110, 5015, 5462, 6799, 8406, 9828, 10022, 10708, 11401, 12129, 12770, 14653, 15160, 15786, 16775, 17573, 18834, 19858, 20904, 22725, 22913]","[206, 416, 669, 859, 1115, 1205, 1474, 1778, 2275, 2460, 3318, 3826, 4502, 4952, 5220, 5315, 5948, 6279, 7280, 8008, 8577, 8671, 8982, 9629, 10349, 11045, 11420, 12452, 13588, 14161]","[73, 352, 476, 862, 1120, 1426, 1794, 2135, 2393, 2835, 3327, 3650, 4392, 4747, 5058, 5321, 5901, 6217, 6645, 7180, 7748, 7987, 9002, 9689, 10474, 11284, 11712, 12497, 13285, 14113]","[73, 283, 373, 508, 598, 725, 815, 995, 1085, 1302, 1584, 1837, 2078, 2526, 2839, 3103, 3602, 4107, 4571, 5251, 6024, 6351, 6936, 7434, 8148, 8574, 9353, 10694, 11631, 12619]","[73, 283, 373, 508, 650, 853, 943, 1123, 1251, 1520, 2197, 2640, 3387, 3939, 4285, 4425, 5097, 5775, 6067, 6352, 7102, 7251, 7979, 8492, 9011, 9362, 9756, 10522, 11615, 12284]",22913,14161,14113,12619,12284,73,50,53,96,5,"[390, 599, 1030, 1339, 1797, 2368, 3067, 3373, 4023, 4963, 5871, 6744, 6970, 8441, 9411, 10915, 12806, 13666, 15122, 16340, 17426, 17696, 18961, 19247, 19654, 20236, 21259, 22002, 22299, 22712]","[253, 573, 891, 1439, 1683, 2213, 2730, 3183, 3638, 4239, 4567, 4934, 5390, 5766, 6272, 7072, 7794, 8246, 8812, 9666, 10391, 10634, 11213, 11720, 12583, 13440, 14335, 14961, 15057, 15153]","[220, 350, 633, 888, 1242, 1682, 1939, 2029, 2274, 3018, 3349, 3669, 3794, 4134, 4747, 5303, 5772, 6019, 6117, 6757, 7168, 8014, 8428, 9018, 9916, 10223, 10569, 10827, 11137, 11308]","[120, 325, 600, 805, 1175, 1386, 1854, 2325, 2632, 2944, 3250, 3409, 3499, 3821, 3953, 4349, 4770, 5249, 5344, 6304, 6399, 7073, 7601, 7696, 8080, 8553, 8916, 9011, 9107, 9203]","[120, 302, 470, 560, 716, 854, 1158, 1305, 1676, 1931, 2223, 2360, 2450, 2628, 2857, 3363, 3648, 3861, 4005, 4377, 4889, 4983, 5222, 5482, 5873, 6096, 6542, 6716, 7067, 7163]",22712,15153,11308,9203,7163,201,-992,2805,3416,5121,10551,30,radiant
7578746005,95,17,20,100,45,"[142, 661, 972, 1338, 1557, 1942, 2193, 2628, 3255, 3591, 4131, 4472, 4919, 5372, 6332, 6771, 7467, 7651, 8030, 8973, 9561, 9909, 10912, 12205, 12896, 13757, 14459, 15645, 15741, 16093]","[408, 792, 1086, 1507, 2036, 2567, 3187, 4462, 4800, 5148, 5753, 6465, 6555, 6704, 7382, 7780, 8172, 8356, 9295, 10073, 10709, 11497, 12013, 13028, 13233, 13674, 14171, 14998, 15454, 16015]","[142, 498, 698, 898, 1285, 1968, 2506, 3159, 3294, 4019, 4255, 4613, 4965, 5542, 6038, 6513, 6968, 7396, 8212, 8970, 9382, 9897, 11587, 12112, 12207, 12373, 12761, 13933, 14614, 14829]","[142, 383, 473, 563, 693, 919, 1358, 1810, 2016, 2251, 2522, 2715, 2969, 3164, 3499, 3594, 3851, 4035, 4412, 4806, 4964, 5097, 5420, 5853, 6023, 6264, 6743, 7839, 8263, 8515]","[142, 587, 677, 848, 978, 1155, 1290, 1854, 2071, 2161, 2417, 2507, 2597, 2772, 3000, 3095, 3190, 3497, 3867, 4700, 4911, 5235, 5419, 5852, 5947, 6314, 6490, 6585, 6681, 6987]",16093,16015,14829,8515,6987,1,96,138,106,83,"[187, 357, 756, 1247, 1442, 1804, 1894, 2154, 2775, 3217, 3642, 4227, 4655, 5216, 5412, 5723, 6551, 7308, 8354, 9461, 10323, 11195, 11652, 12533, 13421, 14417, 14963, 15751, 15928, 16846]","[187, 509, 775, 1044, 1439, 2038, 2410, 2925, 3109, 3678, 4243, 4886, 5457, 5811, 6237, 6666, 7421, 8947, 9585, 9778, 10630, 11623, 11718, 12525, 13133, 13858, 14270, 14365, 15162, 15554]","[320, 702, 792, 931, 1591, 2012, 2166, 2388, 2670, 2841, 3024, 3248, 3709, 4372, 4554, 4793, 5435, 6421, 7093, 7381, 7679, 8502, 8859, 9605, 10009, 10702, 10853, 11569, 12160, 12256]","[121, 367, 494, 775, 1103, 1410, 1582, 1800, 1941, 2820, 3235, 3415, 3969, 4489, 4879, 5458, 5841, 6389, 6972, 7165, 7648, 8397, 8492, 8935, 9973, 10483, 10887, 12330, 12507, 12791]","[588, 758, 1105, 1299, 1635, 1763, 2029, 2164, 2375, 2482, 3098, 3611, 4067, 4367, 4461, 4714, 5458, 5997, 6495, 6909, 7169, 8184, 8362, 8529, 8912, 9415, 9510, 9928, 10213, 10309]",16846,15554,12256,12791,10309,-753,461,2573,-4276,-3322,-5317,30,dire
7579518917,48,43,123,97,26,"[0, 174, 479, 722, 1006, 1324, 1627, 2007, 2338, 2834, 3246, 3747, 4423, 5102, 5196, 6335, 7155, 8475, 10047, 11180, 11902, 12845, 13676, 14659, 15894, 16766, 17349, 18433, 18699, 20008]","[0, 506, 756, 1012, 1422, 1670, 2289, 3366, 3791, 4542, 4941, 5462, 6000, 6671, 6804, 7378, 7945, 8265, 8872, 9427, 9827, 10137, 10683, 11413, 12428, 13217, 14263, 14581, 15230, 15761]","[0, 462, 637, 762, 1008, 1133, 1315, 1603, 1796, 2043, 2268, 2599, 3081, 3338, 3609, 4215, 4763, 5333, 6150, 6933, 7239, 8545, 9172, 10065, 10554, 12110, 13122, 14119, 14798, 15725]","[0, 404, 605, 874, 1413, 1760, 2309, 2720, 3265, 3797, 4604, 5099, 5520, 5875, 6257, 6592, 7103, 7773, 8569, 8765, 9071, 9471, 9798, 10500, 11327, 12577, 13258, 14042, 14591, 14867]","[0, 462, 598, 737, 905, 1041, 1176, 1673, 1896, 2178, 2488, 2625, 2765, 3328, 3422, 3729, 3887, 3982, 4368, 4510, 4872, 5225, 5506, 5970, 6270, 6913, 7112, 7288, 7465, 7938]",20008,15761,15725,14867,7938,49,46,28,121,105,"[0, 396, 709, 879, 1140, 1558, 1901, 2430, 2851, 3151, 3484, 4015, 4635, 5061, 6355, 6820, 7344, 7998, 8430, 9501, 9864, 9959, 10510, 11410, 12119, 12815, 13290, 14147, 15124, 15943]","[0, 685, 857, 1224, 1603, 2039, 2334, 2590, 3062, 3560, 4218, 4865, 5295, 5836, 7044, 7792, 8344, 8936, 9104, 9756, 10143, 10441, 11491, 12207, 12302, 12767, 13127, 13640, 14317, 14647]","[0, 206, 477, 889, 1017, 1481, 1949, 2464, 2784, 3222, 3608, 4043, 4604, 4805, 5814, 6196, 6740, 7411, 7891, 8255, 8607, 9015, 9197, 9749, 9844, 10171, 10449, 10544, 11055, 11337]","[0, 438, 528, 666, 756, 975, 1188, 1323, 1727, 2043, 2266, 2410, 2572, 2769, 3392, 3644, 3739, 4541, 4635, 4812, 4995, 5115, 5339, 5506, 5601, 6049, 6327, 6479, 6702, 6908]","[0, 305, 395, 485, 603, 821, 911, 1046, 1181, 1316, 1483, 1699, 1789, 2287, 2861, 2956, 3148, 3582, 3676, 4098, 4288, 4552, 5013, 5180, 5275, 5602, 6250, 6555, 6860, 7268]",15943,14647,11337,6908,7268,4065,1114,4388,7959,670,18196,30,radiant
7579888814,46,39,123,19,73,"[1, 216, 485, 766, 1114, 1509, 2219, 2664, 2866, 3226, 3736, 4238, 4773, 5166, 5677, 6240, 6373, 6819, 7788, 8643, 9551, 10403, 11580, 11876, 13647, 13968, 14557, 15316, 15508, 18276]","[1, 246, 427, 688, 1014, 1389, 1608, 2071, 2524, 3056, 3223, 3526, 3937, 4079, 4798, 5178, 5401, 6580, 7553, 8966, 9302, 10645, 11004, 12091, 13384, 14338, 15563, 16480, 17317, 18771]","[1, 171, 296, 425, 550, 640, 815, 1061, 1151, 1400, 1612, 1702, 2256, 2388, 2854, 3282, 3429, 3831, 4154, 4817, 5121, 6472, 6567, 7365, 8647, 9101, 9897, 10770, 11573, 11708]","[1, 205, 366, 495, 812, 919, 1020, 1241, 1331, 1459, 1872, 1962, 2299, 2393, 2856, 3051, 3270, 3657, 4040, 4785, 5165, 7126, 7717, 8551, 9578, 9940, 10489, 11166, 11337, 12227]","[1, 251, 341, 692, 891, 1147, 1398, 1691, 1781, 2030, 2120, 2267, 2405, 2499, 2702, 3334, 3428, 3523, 4295, 4808, 4902, 5665, 6770, 7284, 8287, 8426, 8927, 9437, 9781, 9877]",18276,18771,11708,12227,9877,68,136,43,96,83,"[1, 245, 594, 920, 1419, 1804, 2186, 2403, 3136, 3961, 4341, 4855, 5439, 6025, 6412, 6788, 7578, 7978, 8582, 8974, 9576, 10021, 10892, 11059, 11548, 12869, 13701, 14842, 16036, 16667]","[1, 318, 857, 1581, 1756, 2269, 2977, 3629, 4111, 4993, 5543, 6234, 6645, 7208, 7653, 8042, 9127, 9642, 10306, 10908, 11857, 12105, 12585, 13785, 13879, 14046, 14863, 15813, 16610, 16861]","[1, 358, 595, 911, 1204, 1704, 2352, 2911, 3360, 3737, 4179, 5182, 5860, 6252, 7001, 7659, 8782, 9435, 9910, 11220, 12158, 12406, 12757, 12960, 13113, 13451, 13930, 14359, 14867, 15182]","[1, 271, 554, 907, 997, 1349, 1548, 1683, 1830, 2356, 2589, 2916, 3120, 3719, 4078, 4244, 4448, 5053, 5445, 5938, 6272, 6582, 7347, 7986, 8080, 9474, 10460, 11416, 12196, 12482]","[1, 507, 659, 937, 1100, 1457, 1713, 1848, 2548, 3090, 3585, 3931, 4254, 4557, 4821, 5088, 5395, 5985, 6215, 6545, 6815, 7435, 7761, 8131, 8488, 9380, 9786, 10291, 10798, 11182]",16667,16861,15182,12482,11182,1609,1910,-3474,-255,-1305,-1515,30,radiant
7580040907,1,49,14,86,123,"[0, 259, 532, 995, 1259, 1622, 1820, 2629, 3037, 3509, 4101, 4744, 5185, 6131, 6313, 6726, 7156, 7933, 8803, 9600, 10562, 10739, 11932, 12504, 13387, 14266, 15146, 15780, 16470, 17191]","[0, 364, 814, 1190, 1482, 2064, 2584, 2984, 3547, 4006, 4595, 5522, 6399, 7188, 7676, 7825, 8323, 8761, 9098, 9523, 9653, 10523, 11260, 11787, 12795, 13173, 13644, 14174, 15147, 15840]","[0, 282, 612, 871, 1227, 1764, 2284, 2824, 3268, 3752, 4412, 5209, 5569, 6644, 6774, 6923, 7505, 8195, 8478, 8588, 8704, 9068, 9550, 10078, 10638, 11019, 11502, 12354, 12872, 13107]","[0, 261, 351, 758, 848, 1064, 1226, 1506, 1668, 1852, 2250, 2721, 3002, 3428, 3999, 4409, 4567, 4946, 5185, 5537, 5770, 5941, 6182, 6352, 6742, 7055, 7435, 7857, 8669, 9347]","[0, 210, 405, 570, 660, 873, 963, 1308, 1452, 1587, 1888, 2233, 2593, 2996, 3140, 3289, 3610, 3815, 4062, 4305, 4403, 4659, 4994, 5475, 6438, 6720, 6895, 6990, 7723, 8081]",17191,15840,13107,9347,8081,12,106,43,31,121,"[0, 236, 434, 918, 1237, 1354, 1494, 1890, 2116, 2392, 2679, 3070, 3333, 4009, 4605, 5443, 6161, 6845, 8380, 9030, 9461, 10231, 11113, 12290, 13259, 14191, 15139, 15868, 16691, 17141]","[0, 250, 518, 848, 1074, 1435, 1675, 2089, 2306, 2804, 2980, 3243, 3631, 3949, 4269, 5175, 5636, 6004, 6749, 7552, 8454, 9096, 10149, 10721, 11582, 12126, 13233, 13814, 14610, 15135]","[0, 547, 821, 1019, 1599, 1763, 2115, 2388, 2547, 3060, 3318, 3535, 3917, 4275, 5219, 5909, 6435, 7114, 8117, 8835, 9379, 9884, 10599, 11199, 11885, 12907, 13229, 13411, 13642, 14321]","[0, 200, 290, 510, 649, 746, 968, 1058, 1148, 1238, 1376, 1514, 1751, 1968, 2096, 2689, 2946, 3223, 3775, 3933, 4526, 4919, 5157, 5457, 5887, 6341, 6546, 6727, 6958, 7350]","[0, 200, 290, 415, 803, 893, 1031, 1245, 1424, 1514, 1724, 1814, 1904, 2044, 2138, 2648, 2743, 2928, 3303, 3774, 4410, 4803, 5041, 5341, 5771, 5938, 6032, 6174, 6405, 6582]",17141,15135,14321,7350,6582,50,705,-1214,1997,1499,3037,30,radiant
7580268816,21,48,13,62,64,"[0, 204, 691, 972, 1371, 1641, 2270, 2811, 3644, 4305, 4787, 5781, 6405, 7303, 8040, 8758, 9601, 10165, 11309, 11948, 12757, 13570, 14418, 15540, 16726, 17689, 19027, 19956, 21185, 23259]","[0, 279, 555, 910, 1244, 1659, 2019, 2383, 2887, 3343, 3934, 4646, 5281, 5824, 6183, 6819, 8107, 8379, 9214, 9770, 10693, 11333, 12197, 12607, 13303, 14727, 16313, 18343, 19029, 21482]","[0, 327, 653, 1033, 1356, 1782, 2372, 2810, 3636, 4116, 4609, 4878, 5417, 6155, 6698, 7140, 7958, 8443, 9130, 9887, 10420, 11160, 11578, 12416, 13188, 13595, 14646, 15248, 15955, 17554]","[0, 187, 622, 789, 947, 1077, 1234, 1344, 1606, 1714, 1804, 2022, 2377, 2696, 3086, 3512, 4501, 5184, 5387, 5867, 6172, 6461, 7208, 7392, 7984, 8611, 9153, 10391, 11081, 13081]","[0, 170, 260, 394, 533, 671, 808, 902, 1139, 1274, 1412, 1614, 1790, 1939, 2166, 2299, 2585, 3041, 3379, 3473, 3568, 3663, 4328, 4613, 4852, 5247, 5932, 6136, 6645, 8706]",23259,21482,17554,13081,8706,25,16,138,67,97,"[0, 340, 664, 1085, 1463, 2163, 2800, 3304, 3990, 4557, 5407, 6617, 7268, 8056, 8877, 9566, 10542, 11994, 13345, 13933, 14760, 16095, 16634, 17669, 18573, 20319, 21788, 21882, 22395, 22491]","[0, 280, 571, 1053, 1414, 1741, 2343, 2727, 3173, 3538, 3954, 4380, 4870, 5526, 6243, 6677, 7390, 8076, 8591, 8860, 9403, 9572, 10401, 11530, 11960, 12399, 12582, 12819, 12915, 13011]","[0, 222, 312, 481, 669, 850, 1034, 1195, 1401, 1673, 1977, 2121, 2430, 2716, 2932, 3111, 3665, 3940, 4458, 4948, 5324, 5770, 6386, 6888, 7992, 8736, 8869, 10006, 10683, 10779]","[0, 283, 490, 672, 922, 1135, 1309, 1693, 1865, 2004, 2473, 2720, 3217, 3484, 4046, 4455, 4926, 5319, 5826, 6466, 6822, 7639, 8572, 8973, 9809, 10776, 10896, 11728, 11824, 11920]","[0, 170, 260, 583, 673, 763, 898, 1033, 1404, 1530, 1701, 1883, 2202, 2618, 2979, 3139, 3596, 3813, 4135, 4361, 4694, 5314, 5707, 5876, 6261, 6821, 7192, 7707, 7878, 8160]",22491,13011,10779,11920,8160,768,8471,6775,1161,546,17721,30,radiant
7580511616,62,106,41,53,40,"[2, 170, 453, 790, 1449, 1731, 2336, 2583, 3223, 4088, 5108, 5334, 6540, 7013, 7354, 7521, 8127, 9606, 10071, 10337, 12628, 13015, 13605, 14793, 15481, 16337, 17141, 18249, 18974, 19278]","[0, 243, 503, 833, 1316, 1729, 2100, 2585, 3100, 4059, 4563, 5537, 6264, 6660, 7165, 7791, 8786, 9152, 9890, 10518, 11716, 12368, 13211, 13651, 14360, 15126, 16198, 17320, 18345, 18899]","[0, 164, 326, 926, 1241, 1562, 1861, 2117, 2523, 2931, 3555, 4098, 4877, 5386, 5968, 6436, 7021, 7787, 8327, 9150, 9864, 10545, 10794, 11584, 11970, 12717, 13292, 14006, 14876, 15762]","[0, 131, 264, 354, 622, 718, 1162, 1252, 1688, 1990, 2322, 2607, 3284, 3433, 4174, 4269, 4768, 5218, 5887, 6452, 7088, 7359, 7945, 8830, 9469, 10231, 11000, 11651, 12020, 12443]","[0, 129, 219, 309, 509, 599, 760, 866, 1129, 1564, 1869, 2119, 2382, 2631, 2823, 3018, 3324, 3776, 4218, 4397, 5334, 5823, 5993, 6409, 7111, 7867, 8140, 8535, 8741, 9217]",19278,18899,15762,12443,9217,89,98,39,19,112,"[0, 291, 536, 1151, 1325, 1690, 2002, 2188, 2494, 3060, 3517, 4044, 4513, 5179, 6028, 6667, 7315, 8476, 9127, 9585, 9743, 10410, 11204, 12557, 12886, 14009, 15062, 15592, 16836, 17896]","[0, 247, 707, 894, 1320, 1686, 2022, 2674, 3005, 4062, 4450, 4865, 4955, 5897, 6425, 6970, 7428, 8152, 8778, 9685, 9909, 10247, 10850, 11681, 12591, 12978, 13582, 14593, 15107, 16095]","[0, 361, 649, 1039, 1402, 1713, 1927, 2360, 2537, 3071, 3161, 3378, 3600, 4336, 4702, 5412, 5830, 6794, 7451, 8063, 8188, 8700, 9357, 9994, 10344, 10843, 11148, 11779, 11875, 12119]","[0, 209, 299, 414, 504, 674, 933, 1113, 1203, 1557, 1764, 1931, 2114, 2403, 2746, 3548, 3658, 4292, 4386, 4607, 4702, 4907, 5073, 5330, 5650, 5817, 6104, 6980, 7076, 7253]","[0, 209, 299, 535, 625, 761, 966, 1146, 1236, 1590, 1719, 1844, 2079, 2787, 2928, 3292, 3459, 4078, 4342, 4563, 4658, 4753, 4919, 5414, 5809, 6139, 6314, 6924, 7020, 7474]",17896,16095,12119,7253,7474,1382,2804,3643,5190,1743,14762,30,radiant
7580525516,109,7,97,65,20,"[0, 216, 462, 965, 1240, 1590, 1874, 2667, 3127, 3569, 3890, 4369, 5011, 5928, 6579, 7172, 8471, 9011, 10241, 11020, 11688, 12525, 12761, 13245, 13830, 15282, 16303, 17536, 18722, 19156]","[0, 205, 621, 956, 1487, 1781, 2266, 2763, 3063, 3601, 4146, 4813, 4903, 5579, 5805, 6075, 6696, 7366, 7769, 8099, 8911, 9051, 9292, 9859, 10444, 11106, 11583, 12405, 13033, 13426]","[0, 241, 606, 732, 1383, 1820, 2431, 2777, 3567, 3953, 4320, 4979, 5436, 6538, 6982, 7598, 8062, 8519, 8952, 9109, 10100, 10790, 11069, 11348, 12099, 12884, 13429, 14109, 14467, 14599]","[0, 130, 220, 462, 552, 669, 759, 1105, 1195, 1469, 1718, 1863, 1953, 2950, 3045, 3190, 3724, 4011, 4357, 4698, 4981, 5257, 5352, 5518, 5956, 6499, 6893, 7098, 7336, 7432]","[0, 130, 270, 452, 729, 914, 1129, 1264, 1354, 1444, 1797, 2149, 2262, 2843, 2966, 3337, 3582, 4061, 4334, 4499, 4773, 4988, 5232, 5586, 5913, 6356, 6661, 6989, 7276, 7447]",19156,13426,14599,7432,7447,12,120,43,100,31,"[0, 284, 592, 867, 1153, 1543, 1793, 2243, 2415, 2896, 3292, 3842, 4349, 4759, 5153, 5918, 6581, 7319, 7894, 8695, 9143, 10198, 10485, 11764, 12423, 13281, 14289, 14981, 15666, 16731]","[0, 282, 526, 860, 1250, 1923, 2250, 2628, 3413, 3904, 4341, 4724, 5276, 5425, 6215, 6585, 7430, 7955, 8306, 9282, 9470, 10158, 10590, 11442, 12072, 12698, 13579, 14039, 14235, 15009]","[0, 246, 336, 674, 956, 1291, 1932, 2187, 2752, 3363, 3889, 3979, 4433, 4941, 5635, 6191, 6433, 6882, 7356, 7997, 8092, 8978, 9340, 9959, 10300, 10910, 11253, 11765, 12275, 12904]","[0, 210, 334, 590, 680, 953, 1238, 1328, 2012, 2504, 2683, 2773, 2944, 3039, 3408, 3784, 4195, 4574, 4716, 4963, 5081, 5420, 5515, 6302, 6502, 6715, 7009, 7214, 7310, 7707]","[0, 210, 300, 390, 480, 627, 844, 1014, 1197, 1790, 1925, 2389, 2634, 2729, 3060, 3208, 3808, 4070, 4412, 4812, 4954, 5169, 5339, 6033, 6372, 6542, 6911, 7191, 7362, 8126]",16731,15009,12904,7707,8126,2425,-1583,1695,-275,-679,1583,30,dire
7580560302,49,43,129,128,121,"[0, 207, 598, 761, 1223, 1703, 2238, 2698, 3001, 3515, 4076, 4592, 5374, 5841, 6412, 6722, 6817, 7387, 8323, 9216, 10231, 11060, 12217, 12888, 13191, 13830, 14661, 15261, 15918, 16194]","[0, 362, 628, 845, 1141, 1418, 1774, 2171, 2761, 3647, 4118, 4411, 5196, 5579, 6025, 6459, 6640, 7076, 7623, 9072, 9816, 10071, 10489, 10894, 11586, 12925, 13020, 13198, 14021, 14981]","[0, 252, 450, 974, 1227, 1521, 1911, 2310, 2803, 3109, 3424, 3893, 4480, 4938, 5415, 5516, 5981, 6460, 6948, 7551, 8073, 8255, 8350, 8731, 9261, 9749, 9844, 10249, 10622, 11189]","[0, 170, 353, 711, 861, 991, 1196, 1405, 1540, 1764, 2014, 2152, 2415, 2509, 2704, 3080, 3175, 3318, 3614, 3890, 4060, 4154, 4415, 4653, 4747, 5343, 5569, 5909, 6201, 6297]","[0, 170, 600, 690, 857, 1080, 1250, 1459, 1594, 2061, 2607, 2697, 2991, 3119, 3433, 3616, 3962, 4199, 4582, 4677, 4870, 4964, 5328, 5471, 5565, 5927, 6022, 6163, 6385, 7189]",16194,14981,11189,6297,7189,47,93,106,123,110,"[0, 241, 522, 858, 1206, 1618, 1818, 2393, 2828, 3203, 3734, 4254, 4530, 5472, 5986, 6682, 7723, 8384, 8847, 9550, 10459, 11552, 12488, 13050, 13656, 14080, 14271, 15099, 15958, 16959]","[0, 170, 483, 700, 1195, 1534, 1838, 1991, 2361, 2852, 3390, 3809, 4596, 5607, 6245, 7047, 7590, 8782, 9679, 10033, 10645, 11069, 11983, 12927, 13640, 14708, 15312, 15855, 16737, 17366]","[0, 170, 440, 719, 1049, 1299, 1795, 2070, 2447, 2707, 3042, 3265, 3441, 4091, 4573, 5563, 6125, 6577, 6950, 7544, 8282, 8617, 9077, 9678, 10208, 10918, 11441, 12425, 13124, 13925]","[100, 270, 360, 497, 856, 1029, 1205, 1373, 1463, 1553, 1741, 1831, 1923, 2125, 2368, 2833, 3814, 4423, 4594, 5047, 5365, 5788, 6245, 6939, 7454, 8199, 8694, 8870, 9346, 10576]","[0, 170, 260, 350, 526, 700, 1062, 1230, 1365, 1455, 1643, 1843, 1946, 2202, 2450, 3012, 3403, 3751, 4078, 5208, 5497, 6116, 6589, 7047, 7421, 7861, 8322, 8498, 8830, 9469]",16959,17366,13925,10576,9469,-765,-2385,-2736,-4279,-2280,-12445,30,dire
7580843816,57,16,10,22,5,"[0, 252, 574, 986, 1351, 1755, 2075, 2446, 2754, 3250, 3959, 4305, 4836, 5470, 5750, 6153, 6516, 7333, 8525, 9412, 10753, 11706, 12846, 13586, 14689, 15282, 16692, 17536, 18979, 20319]","[0, 238, 454, 744, 1094, 1473, 2056, 2446, 2949, 3939, 4387, 4988, 5528, 6028, 6537, 7606, 8096, 8701, 10181, 10726, 11465, 12208, 13312, 13746, 14534, 15305, 15562, 15785, 17259, 18557]","[0, 285, 524, 840, 1243, 1481, 1993, 2421, 2880, 3203, 3941, 4455, 4944, 5039, 5457, 5950, 6604, 7078, 7864, 8454, 9422, 10186, 12179, 12885, 13508, 13603, 14397, 14613, 15079, 16342]","[2, 132, 261, 396, 526, 665, 769, 859, 1036, 1357, 1650, 1788, 2077, 2374, 2791, 3282, 3376, 4017, 4637, 5041, 5406, 6330, 7069, 7322, 8116, 9068, 9474, 9568, 10413, 10509]","[0, 130, 220, 357, 574, 699, 805, 942, 1032, 1122, 1303, 1440, 1674, 1824, 1919, 2265, 2359, 2696, 3525, 3620, 3865, 4142, 4628, 5054, 6422, 7063, 7469, 7563, 8669, 9356]",20319,18557,16342,10509,9356,96,76,89,86,20,"[0, 283, 651, 1189, 1549, 1992, 2285, 3085, 3795, 4371, 4889, 5290, 5806, 6365, 7034, 7646, 8478, 9057, 9619, 10538, 11011, 11252, 11763, 11857, 12244, 12400, 14036, 14787, 15233, 15802]","[0, 320, 606, 949, 1333, 1755, 2199, 2698, 3108, 3554, 3911, 4434, 5063, 6149, 6877, 7340, 8099, 8500, 8595, 9158, 9786, 10288, 10383, 10678, 11476, 11571, 13497, 13894, 14178, 14827]","[0, 288, 491, 787, 1237, 1612, 2126, 2632, 3257, 3682, 4276, 4873, 5433, 6322, 7214, 7984, 8553, 9264, 9688, 10264, 11166, 11916, 12131, 12509, 13258, 13408, 13670, 14344, 14628, 14782]","[0, 210, 349, 483, 617, 707, 842, 1174, 1503, 1638, 2061, 2189, 2279, 2778, 3314, 3409, 3839, 4116, 4313, 4615, 4789, 5161, 5290, 5384, 5479, 5574, 5669, 6066, 6625, 7566]","[0, 210, 300, 533, 668, 808, 994, 1250, 1386, 1519, 1693, 1970, 2124, 2640, 3282, 3425, 3865, 4149, 4543, 4771, 4945, 5130, 5393, 5536, 5631, 5959, 6787, 6881, 6977, 7073]",15802,14827,14782,7566,7073,4517,3730,1560,2943,2283,15033,30,radiant
7580940704,18,120,80,33,26,"[0, 242, 601, 934, 1113, 1488, 1726, 2083, 2471, 2831, 3514, 3986, 4394, 4910, 5576, 6217, 7060, 8218, 9338, 10147, 11101, 11774, 12544, 13644, 14477, 15138, 16601, 17342, 19027, 19615]","[0, 169, 441, 696, 1176, 1554, 1799, 2285, 2833, 3343, 3943, 4721, 5230, 5703, 6637, 7121, 7552, 8365, 9271, 9762, 10247, 10665, 11270, 12183, 13186, 14076, 14765, 15605, 17069, 17556]","[0, 292, 563, 940, 1212, 1554, 1910, 2371, 2757, 3250, 3677, 4076, 4410, 4758, 5520, 6171, 6874, 7720, 8088, 8283, 9095, 9471, 10789, 11427, 12465, 12789, 13604, 14082, 15143, 15756]","[0, 215, 331, 545, 740, 937, 1064, 1579, 1851, 2030, 2294, 2562, 2652, 3029, 3416, 3649, 3995, 4139, 4490, 4584, 4781, 4876, 5675, 6216, 6692, 7008, 7735, 7919, 8885, 9276]","[0, 169, 302, 437, 527, 632, 751, 969, 1069, 1248, 1514, 1688, 1922, 2150, 2747, 2976, 3403, 3714, 4004, 4098, 4300, 4580, 5109, 5410, 5795, 6187, 6875, 7059, 7682, 7935]",19615,17556,15756,9276,7935,114,49,38,121,105,"[0, 167, 488, 692, 906, 1308, 1470, 1822, 2102, 2248, 2895, 3149, 3785, 4237, 4816, 5466, 6184, 6670, 7173, 7785, 8390, 8886, 9269, 9736, 10338, 10978, 11734, 12045, 12489, 13102]","[0, 267, 621, 908, 1323, 1809, 2142, 2594, 3081, 3547, 4203, 4873, 5347, 5824, 6080, 6704, 7468, 7691, 8029, 8931, 9324, 9816, 10211, 10394, 10683, 11336, 12031, 12502, 12598, 13104]","[61, 224, 503, 783, 1252, 1569, 1858, 2293, 2468, 2724, 2960, 3614, 4034, 4392, 4834, 5815, 6042, 6405, 7017, 7568, 7784, 8066, 8339, 8811, 9488, 10115, 10331, 10641, 10775, 11160]","[61, 388, 478, 651, 784, 969, 1059, 1288, 1378, 1514, 1806, 2145, 2294, 2540, 2790, 2957, 3215, 3765, 3996, 4528, 4802, 4964, 5059, 5368, 5553, 5802, 5973, 6327, 6554, 7293]","[329, 458, 548, 638, 789, 959, 1063, 1243, 1368, 1497, 2003, 2496, 2649, 2961, 3252, 3418, 3747, 3961, 4943, 5128, 5223, 5499, 5594, 5805, 6167, 6353, 6549, 6643, 6739, 6916]",13102,13104,11160,7293,6916,6513,4452,4596,1983,1019,18563,30,radiant
7581196114,34,41,28,20,101,"[0, 214, 500, 906, 1289, 1632, 1851, 2111, 2447, 2732, 3010, 3453, 3543, 3638, 3918, 4594, 5207, 5587, 5908, 6286, 6381, 7099, 7559, 8062, 8736, 9064, 9650, 9945, 10236, 10862]","[0, 243, 415, 789, 1193, 1492, 1655, 2041, 2414, 2917, 3271, 4062, 4407, 4698, 5254, 5810, 6157, 6492, 7098, 7574, 7954, 8637, 9518, 10205, 10472, 11329, 12079, 13135, 13749, 14309]","[0, 239, 599, 689, 813, 1348, 1607, 2104, 2399, 2617, 2927, 3174, 3420, 3640, 3872, 4468, 5068, 5289, 5579, 5775, 6051, 6588, 7473, 7614, 8166, 8260, 8436, 8569, 9327, 9849]","[0, 170, 260, 434, 611, 838, 928, 1018, 1152, 1552, 1702, 2053, 2143, 2387, 2666, 3289, 3548, 3642, 3988, 4146, 4290, 5048, 5215, 5330, 5847, 5941, 6117, 6292, 6628, 6897]","[0, 170, 260, 350, 440, 577, 667, 804, 943, 1033, 1183, 1273, 1411, 1506, 1937, 2371, 2690, 2784, 3230, 3388, 3483, 3963, 4130, 4225, 4578, 4672, 4892, 4987, 5278, 5547]",10862,14309,9849,6897,5547,94,25,98,86,26,"[61, 315, 644, 1148, 1465, 1589, 1982, 2368, 2810, 3258, 3874, 4720, 5292, 5688, 6355, 6796, 7224, 8125, 8583, 9768, 10478, 11630, 12830, 13694, 13903, 14695, 15182, 16334, 17066, 17539]","[61, 268, 394, 518, 762, 1050, 1303, 1685, 2064, 2403, 3195, 3934, 4554, 4996, 5090, 5409, 5731, 5990, 6648, 7806, 8365, 8539, 8959, 9362, 9825, 10492, 11150, 11472, 12230, 12774]","[61, 307, 785, 949, 1229, 1789, 2252, 2509, 2909, 3188, 3918, 4262, 4792, 5274, 5474, 5667, 6174, 6868, 7093, 7666, 8107, 8281, 8742, 9379, 9691, 10316, 10971, 11587, 12123, 12219]","[61, 231, 518, 608, 747, 960, 1099, 1189, 1361, 1523, 2187, 2493, 2673, 2912, 3041, 3324, 3762, 4080, 4265, 4738, 4920, 5291, 5555, 5650, 5915, 6248, 6538, 6793, 7314, 7573]","[329, 499, 589, 753, 1021, 1111, 1291, 1381, 1519, 1609, 2025, 2331, 2627, 2866, 3131, 3535, 3737, 3870, 4055, 4779, 5227, 5401, 5568, 5663, 6123, 6570, 6665, 6760, 7173, 7269]",17539,12774,12219,7573,7269,-6677,1535,-2370,-676,-1722,-9910,30,dire
7581204412,95,23,69,3,20,"[417, 676, 938, 1188, 1510, 1894, 2494, 2864, 3323, 3791, 4308, 4672, 5143, 5673, 6096, 6628, 7410, 8215, 9142, 9998, 10561, 11324, 12065, 13037, 13881, 14535, 15480, 15917, 16985, 17544]","[151, 435, 773, 972, 1349, 1739, 1911, 2406, 2783, 2922, 3899, 4332, 4773, 5323, 5945, 6473, 7229, 7435, 8237, 8700, 8992, 9087, 9399, 9769, 10355, 10875, 11612, 11836, 12820, 13363]","[151, 321, 661, 868, 1372, 1731, 2298, 2554, 2852, 3327, 4169, 4542, 4846, 5304, 5770, 5997, 6403, 6819, 7344, 7917, 8246, 8435, 8822, 9166, 9820, 9987, 10430, 10846, 11260, 11491]","[151, 370, 460, 584, 713, 1007, 1453, 1595, 1780, 1956, 2226, 2452, 2677, 2977, 3328, 3929, 4304, 4521, 4885, 5291, 5731, 5862, 6619, 7093, 7560, 7808, 8449, 8543, 9761, 10030]","[0, 170, 459, 595, 685, 849, 1028, 1268, 1403, 1741, 2350, 2558, 2786, 2935, 3268, 3436, 3732, 3827, 4319, 4675, 5108, 5203, 5298, 5470, 5880, 6157, 6628, 6797, 7083, 7424]",17544,13363,11491,10030,7424,48,34,28,136,30,"[321, 411, 571, 993, 1320, 1572, 1824, 2330, 2760, 3204, 3823, 4113, 4811, 5312, 5505, 5845, 6705, 7176, 7802, 8322, 8854, 9582, 9940, 11246, 11717, 12257, 12352, 13682, 14690, 16049]","[53, 254, 489, 861, 1144, 1357, 1683, 1939, 2254, 2393, 2920, 3156, 3342, 3484, 3732, 4058, 4385, 4774, 5012, 5231, 5572, 6410, 6505, 6971, 7499, 7859, 8391, 8904, 9716, 10345]","[53, 177, 339, 640, 851, 941, 1068, 1278, 1761, 1851, 2250, 2361, 2451, 2776, 2955, 3266, 3782, 4164, 4396, 4675, 5084, 5214, 5309, 5832, 6253, 6524, 6619, 7182, 7636, 8013]","[53, 180, 270, 360, 539, 663, 753, 877, 1097, 1187, 1586, 1762, 1998, 2158, 2444, 2558, 2814, 3159, 3391, 3535, 3899, 3994, 4089, 4558, 4707, 4945, 5259, 6035, 6489, 6968]","[53, 143, 233, 372, 549, 639, 802, 968, 1353, 1443, 2083, 2173, 2263, 2406, 2501, 2596, 2977, 3072, 3167, 3308, 3465, 3560, 3655, 4147, 4242, 4373, 4503, 5064, 5518, 5943]",16049,10345,8013,6968,5943,1495,3018,3478,3062,1481,12534,30,radiant
7581551218,44,76,43,65,20,"[58, 306, 515, 719, 1306, 1656, 1841, 2046, 2747, 3271, 3754, 4548, 5116, 5610, 6040, 6649, 7394, 8119, 8922, 9489, 10112, 10950, 11741, 12827, 13594, 14856, 14951, 15475, 15960, 16798]","[58, 383, 752, 1057, 1337, 1702, 1947, 2364, 3040, 3874, 4301, 4871, 5371, 5625, 6774, 7316, 7854, 8790, 9306, 9924, 10226, 11294, 11892, 12221, 12620, 13173, 13540, 13894, 14487, 15467]","[326, 568, 1140, 1742, 2150, 2404, 2766, 3351, 3722, 4485, 4683, 5127, 5710, 6643, 7722, 8165, 8557, 8885, 9226, 10211, 10812, 11598, 12027, 12122, 12872, 13384, 14103, 14451, 15023, 15944]","[58, 228, 318, 408, 498, 653, 743, 833, 1215, 1341, 1502, 1734, 1914, 2168, 2749, 3301, 3565, 3949, 4168, 4661, 5009, 6155, 6628, 6798, 7203, 7856, 8138, 8307, 8614, 9248]","[58, 228, 383, 539, 715, 843, 933, 1023, 1203, 1484, 1732, 1910, 2134, 2449, 2804, 3035, 3227, 4080, 4451, 5026, 5202, 5345, 5550, 5645, 6118, 6407, 6880, 7010, 7242, 7845]",16798,15467,15944,9248,7845,4,28,126,105,27,"[0, 204, 467, 593, 966, 1434, 1944, 2203, 2427, 2672, 3120, 3410, 3817, 4270, 4871, 5417, 6148, 6970, 7654, 8603, 9162, 10150, 10405, 11208, 11918, 12443, 13325, 13805, 14698, 15177]","[0, 246, 512, 1021, 1234, 1669, 1962, 2648, 2773, 3103, 3996, 4370, 4888, 5521, 6048, 6442, 6813, 7594, 7689, 8105, 8377, 9103, 9658, 10163, 10722, 11026, 12430, 13000, 13382, 13732]","[0, 206, 534, 708, 916, 1131, 1382, 1636, 1726, 1899, 2572, 2789, 2982, 3560, 3867, 4317, 4920, 5736, 6225, 6632, 7130, 8778, 8873, 9233, 9418, 9973, 10976, 11697, 12314, 12917]","[0, 170, 260, 398, 759, 893, 1028, 1632, 1840, 1980, 2255, 2498, 2588, 2939, 3246, 3341, 3543, 3929, 4024, 4769, 5102, 5669, 6036, 6203, 6297, 6815, 7511, 7850, 7947, 8297]","[0, 214, 304, 394, 580, 764, 948, 1083, 1173, 1480, 1937, 2027, 2163, 2366, 2948, 3043, 3400, 3972, 4120, 4640, 4797, 5178, 5273, 5628, 5769, 6308, 7149, 7477, 7574, 7883]",15177,13732,12917,8297,7883,1621,1735,3027,951,-38,7296,30,radiant
7581657607,113,93,28,56,26,"[0, 275, 591, 924, 1334, 1699, 1972, 2678, 2803, 3728, 4201, 4970, 5148, 5608, 6244, 6990, 7682, 8176, 8755, 9438, 9625, 10489, 11073, 11854, 12597, 13355, 14202, 14570, 15366, 16184]","[0, 321, 581, 779, 1030, 1433, 1925, 2311, 2520, 2782, 3045, 3389, 3825, 4277, 4987, 5728, 6406, 7265, 8044, 8711, 9317, 10202, 10860, 11504, 12155, 13146, 13962, 14419, 14675, 15698]","[0, 241, 473, 960, 1358, 1885, 2131, 2472, 2703, 3138, 3614, 4296, 4527, 4872, 5194, 5764, 6253, 6648, 7094, 7770, 8284, 8538, 9016, 9410, 9597, 10176, 10732, 11001, 11475, 12076]","[0, 170, 278, 419, 631, 779, 1001, 1294, 1673, 2113, 2362, 2885, 3242, 3337, 3700, 4185, 4457, 4766, 5276, 6260, 6459, 6750, 7041, 7437, 8161, 8827, 9040, 9135, 9680, 9963]","[0, 170, 297, 435, 641, 820, 1064, 1598, 1723, 1863, 2048, 2375, 2465, 2560, 2783, 3114, 3496, 3702, 3849, 4203, 4522, 4623, 4845, 5127, 5348, 5824, 6252, 6660, 7136, 7733]",16184,15698,12076,9963,7733,49,21,126,114,58,"[0, 241, 573, 821, 1236, 1643, 1937, 2325, 3116, 3494, 4273, 4868, 5115, 5815, 6284, 6963, 7224, 7685, 8432, 9544, 10024, 10690, 11536, 11870, 12744, 13934, 14638, 15185, 15876, 16378]","[0, 170, 511, 801, 1039, 1330, 1793, 2215, 2891, 3334, 3794, 4096, 4714, 5438, 5867, 5961, 6443, 7378, 7875, 8517, 9018, 9863, 10629, 11284, 12104, 13216, 13917, 14447, 14899, 15238]","[0, 208, 495, 743, 1118, 1578, 1948, 2239, 2550, 2863, 3573, 3752, 4839, 5379, 5751, 6144, 6428, 6669, 7459, 7781, 8175, 8642, 9322, 9731, 10236, 11059, 11539, 11969, 12441, 12787]","[0, 218, 372, 580, 1063, 1291, 1426, 1841, 2141, 2241, 2671, 2815, 3108, 3782, 4008, 4102, 4543, 4823, 5011, 5304, 5752, 6424, 7126, 7543, 7730, 8007, 8271, 8576, 8753, 8849]","[0, 170, 260, 411, 549, 684, 835, 1072, 1485, 1575, 2007, 2285, 2697, 3028, 3197, 3400, 3690, 4080, 4458, 4632, 4741, 5017, 5436, 5802, 6296, 6962, 7466, 7679, 7856, 8156]",16378,15238,12787,8849,8156,-194,460,-711,1114,-423,246,30,dire
7581700206,95,36,14,53,26,"[0, 517, 788, 1028, 1283, 1783, 1923, 2810, 3207, 3523, 3880, 4402, 4602, 5617, 6316, 6942, 7635, 8294, 8898, 9056, 9631, 10509, 11232, 11986, 12281, 12376, 13383, 13477, 14023, 14556]","[0, 491, 737, 991, 1270, 1530, 1968, 2488, 2988, 3193, 3283, 3561, 3914, 4892, 5071, 5340, 5954, 6354, 7096, 7823, 8088, 8385, 8570, 8927, 9728, 10076, 10615, 10709, 10996, 11193]","[0, 381, 577, 860, 1260, 1633, 1908, 2314, 3120, 3470, 3808, 4058, 4642, 5073, 5216, 5427, 5889, 6021, 6227, 6585, 6814, 7040, 7323, 7634, 8032, 8703, 9133, 9445, 9751, 9990]","[0, 302, 536, 626, 878, 1004, 1134, 1495, 1698, 2179, 2269, 2413, 2503, 2842, 3116, 3364, 3851, 4233, 5397, 5831, 6060, 6518, 6703, 6926, 7221, 7316, 7974, 8068, 8220, 8411]","[0, 337, 427, 563, 697, 862, 992, 1176, 1442, 1597, 1697, 1841, 2081, 2760, 2855, 3185, 3470, 3688, 4126, 4284, 4513, 4608, 4793, 4887, 5443, 5538, 5795, 5889, 6030, 6126]",14556,11193,9990,8411,6126,47,41,28,121,3,"[0, 543, 864, 1150, 1359, 1734, 2254, 2598, 2946, 3430, 4371, 4888, 5505, 5984, 6407, 6983, 7657, 8252, 9029, 9358, 9915, 10493, 10901, 11593, 13201, 14232, 14994, 16172, 17125, 18919]","[0, 214, 455, 662, 876, 1270, 1591, 1969, 2249, 2635, 3074, 3905, 4252, 4623, 5152, 5480, 6308, 6848, 7677, 8155, 8665, 9190, 9781, 10306, 10517, 11121, 11895, 13575, 14297, 14696]","[0, 307, 475, 821, 1189, 1279, 1959, 2049, 2357, 2571, 3584, 4039, 4815, 5170, 5429, 6085, 6546, 6888, 7212, 7764, 8347, 9010, 9446, 10008, 10686, 11426, 11631, 12480, 13195, 14082]","[0, 268, 441, 548, 683, 773, 1184, 1274, 1364, 1498, 1838, 2183, 2700, 2912, 3084, 3313, 3524, 3692, 4005, 4136, 4999, 5184, 5351, 5445, 6085, 6519, 6614, 7480, 7787, 8331]","[0, 401, 531, 621, 715, 853, 1171, 1261, 1369, 1510, 1884, 2229, 2359, 2454, 2622, 2891, 3178, 3319, 3541, 3710, 3867, 4052, 4219, 4313, 4524, 4848, 5112, 5822, 6143, 6963]",18919,14696,14082,8331,6963,-4363,-3503,-4092,80,-837,-12715,30,dire
7581788819,10,71,97,5,86,"[0, 208, 504, 843, 1255, 1532, 1866, 2747, 3139, 4011, 4479, 5452, 6418, 6686, 7442, 8059, 8858, 10027, 10749, 10843, 10985, 11484, 12376, 12946, 14094, 14452, 15088, 15374, 15702, 18425]","[0, 482, 790, 1051, 1569, 1699, 2293, 2658, 3036, 3414, 3959, 4579, 5108, 6082, 6510, 7187, 7942, 8406, 9180, 9384, 9983, 10313, 10862, 11382, 12275, 13147, 13630, 14486, 15486, 16668]","[0, 247, 539, 739, 1142, 1623, 1819, 2083, 2531, 2755, 3440, 3770, 3967, 4313, 4804, 5214, 5816, 6741, 7200, 7486, 7581, 7676, 8476, 9162, 10188, 10772, 11461, 12046, 12352, 13910]","[0, 230, 405, 495, 631, 902, 1039, 1386, 1476, 1763, 2405, 2976, 3378, 3723, 3925, 4161, 4527, 5192, 5440, 5534, 5629, 5906, 6338, 6898, 7107, 7446, 7540, 7635, 8032, 8380]","[0, 568, 706, 796, 973, 1103, 1380, 1717, 2092, 2619, 2937, 3237, 3524, 3753, 4450, 4896, 5465, 6023, 6271, 6365, 6548, 6735, 7196, 7291, 7587, 7845, 7939, 8188, 8578, 9012]",18425,16668,13910,8380,9012,106,69,93,65,58,"[0, 322, 818, 1241, 1656, 1823, 2228, 2708, 3119, 3613, 3836, 4126, 5318, 6154, 7104, 7438, 7769, 8788, 9271, 9933, 11351, 11446, 12616, 13682, 14191, 14740, 15134, 16329, 17079, 18168]","[0, 204, 509, 1073, 1528, 1726, 2198, 2481, 3241, 3731, 4152, 4342, 5206, 5850, 6505, 6648, 6743, 8034, 8678, 9283, 10338, 10802, 11287, 11780, 12097, 12608, 12827, 13567, 13929, 14532]","[0, 244, 487, 684, 1059, 1555, 1803, 2307, 2700, 3245, 3731, 4138, 4334, 4795, 5895, 6339, 6835, 7238, 7877, 8884, 9771, 10617, 11654, 12139, 12527, 13052, 13647, 14592, 15105, 15505]","[0, 169, 273, 520, 715, 805, 1043, 1178, 1563, 1929, 2177, 2540, 2884, 3497, 4022, 4116, 4746, 4993, 5336, 6256, 6718, 7096, 7426, 7720, 8075, 8170, 8636, 8989, 9364, 9742]","[0, 169, 259, 383, 618, 1004, 1390, 1570, 2028, 2339, 2528, 2908, 3708, 4149, 4525, 4721, 5450, 6079, 6748, 7871, 8451, 8932, 9498, 9593, 9876, 10439, 10916, 11883, 12357, 12588]",18168,14532,15505,9742,12588,257,2136,-1595,-1362,-3576,-4140,30,radiant
7582214316,1,47,23,105,26,"[0, 377, 659, 1024, 1619, 2032, 2400, 3060, 3675, 4051, 4157, 4585, 5004, 5581, 6026, 6688, 7901, 8781, 9798, 10708, 11396, 12148, 12242, 13409, 14467, 15477, 16532, 17824, 20589, 22102]","[0, 201, 492, 701, 1113, 1284, 1652, 2291, 2596, 2964, 3488, 3949, 4418, 5055, 5494, 6085, 6522, 7082, 7608, 8021, 8864, 9148, 9242, 9702, 10406, 10661, 11112, 12062, 13095, 13618]","[0, 495, 728, 991, 1482, 1647, 2010, 2397, 2821, 3286, 3686, 4256, 4918, 5220, 5401, 5933, 6335, 6806, 7241, 7886, 8447, 8751, 9114, 9794, 10332, 10851, 11212, 12050, 12885, 13573]","[0, 398, 488, 599, 798, 1146, 1236, 1778, 2271, 2475, 2565, 2797, 2977, 3148, 3243, 3960, 4369, 4464, 5051, 5819, 6640, 6936, 7073, 7243, 7716, 8199, 8482, 8858, 9430, 9867]","[0, 265, 444, 853, 1104, 1194, 1333, 1697, 1849, 2223, 3179, 3398, 3578, 3809, 3904, 4127, 4311, 4502, 4806, 5185, 5578, 5751, 5845, 6067, 6274, 6634, 6812, 7113, 7560, 8114]",22102,13618,13573,9867,8114,69,17,21,86,72,"[0, 369, 618, 828, 993, 1227, 1513, 1930, 2060, 2322, 2864, 3532, 4010, 4508, 5325, 5691, 6105, 6747, 7473, 8014, 8620, 9788, 10390, 10804, 11598, 12423, 13001, 13498, 14417, 15223]","[0, 366, 650, 1207, 1384, 1707, 2329, 2934, 3380, 4465, 4822, 5219, 5683, 5897, 6341, 6656, 7385, 7625, 7978, 8821, 9445, 9973, 11237, 11688, 12445, 13087, 13943, 14290, 14787, 15653]","[0, 241, 558, 813, 1061, 1484, 1804, 2210, 2977, 3784, 4004, 4422, 5257, 5533, 5878, 6798, 7624, 8199, 8797, 9418, 10021, 11330, 11803, 12490, 12829, 13556, 14037, 14410, 15253, 15411]","[0, 380, 470, 560, 874, 1317, 1543, 1891, 2134, 3035, 3436, 3920, 4561, 4703, 5338, 5501, 5749, 5893, 6286, 6663, 6834, 7841, 8531, 8953, 9258, 9748, 10090, 10498, 10918, 11179]","[0, 646, 736, 1054, 1178, 1399, 1751, 2223, 2464, 3384, 3604, 3694, 4174, 4393, 4788, 5090, 5386, 5481, 5695, 5852, 6077, 6918, 7351, 7648, 7878, 8133, 8337, 9105, 9335, 9431]",15223,15653,15411,11179,9431,6879,-2035,-1838,-1312,-1317,377,30,radiant
7582264918,93,106,96,123,26,"[0, 320, 551, 831, 1100, 1428, 1636, 2241, 2415, 2786, 3252, 3687, 4270, 4410, 5078, 5602, 6316, 6927, 8005, 8099, 9301, 10002, 10767, 11548, 12204, 12803, 12898, 14070, 14841, 15391]","[0, 293, 661, 1020, 1345, 1784, 2430, 2845, 3142, 3839, 4303, 4895, 5375, 5961, 6257, 6527, 7073, 7594, 8235, 8497, 8969, 9382, 9568, 9806, 10450, 11054, 11773, 12621, 13245, 13862]","[0, 209, 490, 872, 1111, 1610, 1811, 2254, 2673, 3543, 3853, 4555, 4827, 5076, 5646, 5891, 6205, 7038, 7641, 7982, 8840, 8935, 9268, 9506, 9792, 10325, 10686, 12796, 13001, 13475]","[0, 252, 342, 534, 711, 847, 937, 1433, 1637, 2110, 2245, 2462, 2907, 3610, 3818, 3948, 4253, 4526, 5010, 5460, 6221, 6316, 6456, 7361, 8145, 8240, 8666, 9094, 9647, 10164]","[0, 356, 834, 1017, 1171, 1310, 1411, 1750, 1886, 2091, 2312, 2521, 2735, 2990, 3139, 3233, 3999, 4184, 4528, 4670, 5041, 5184, 5279, 5517, 5612, 5904, 6096, 7138, 7234, 7411]",15391,13862,13475,10164,7411,18,97,23,105,45,"[0, 245, 532, 948, 1398, 1728, 2147, 2905, 3534, 4123, 4541, 5059, 5609, 7071, 7689, 8671, 9650, 10386, 11418, 12408, 13313, 14311, 15426, 16201, 17461, 18492, 19697, 19791, 20358, 21058]","[0, 167, 568, 906, 1268, 1936, 2219, 2771, 3487, 4170, 4588, 5172, 5819, 6262, 6911, 7464, 8103, 8771, 9150, 9935, 10538, 11292, 12166, 13043, 13514, 13954, 15108, 15653, 15846, 16853]","[0, 250, 602, 984, 1345, 1752, 1925, 2394, 2753, 3675, 4168, 4677, 5245, 6058, 6336, 6765, 7282, 7776, 8364, 8757, 8852, 9141, 9984, 10165, 11128, 11747, 12702, 12963, 13872, 14348]","[0, 129, 377, 467, 604, 861, 951, 1131, 1325, 1983, 2261, 2351, 2639, 2816, 3064, 3339, 3615, 3893, 4683, 5284, 5379, 5767, 6651, 6924, 7244, 8220, 8487, 8581, 8677, 9052]","[0, 129, 270, 386, 745, 986, 1081, 1307, 1397, 1798, 1955, 2262, 2406, 3068, 3217, 3810, 4391, 4666, 5254, 5743, 6148, 6570, 7097, 7895, 8335, 9313, 9667, 9761, 9857, 10115]",21058,16853,14348,9052,10115,-5667,-2991,-873,1112,-2704,-11123,30,dire
7582314402,89,120,112,121,96,"[0, 291, 526, 856, 1667, 1960, 2316, 2807, 3467, 3970, 4500, 5108, 5499, 6256, 6984, 7561, 8096, 8551, 9112, 9925, 10486, 11965, 12987, 14074, 15140, 16365, 17091, 18429, 19617, 20816]","[0, 330, 574, 786, 1243, 1578, 2003, 2530, 2869, 3126, 3760, 4082, 4788, 5406, 6012, 6653, 7622, 8599, 8924, 9388, 10184, 10477, 11057, 11196, 11550, 11852, 12353, 12610, 13237, 13333]","[0, 245, 526, 931, 1306, 2059, 2284, 2529, 3139, 3576, 4079, 4642, 5172, 5793, 6468, 6920, 7479, 7838, 8411, 8776, 9393, 9626, 10197, 10386, 10904, 11453, 12068, 12720, 13523, 13748]","[0, 209, 351, 493, 863, 1051, 1190, 1404, 1539, 1800, 1949, 2136, 2281, 2478, 3660, 3845, 4339, 4627, 4727, 4905, 5444, 5954, 6306, 6476, 6645, 6854, 7179, 7729, 8113, 8375]","[0, 209, 372, 556, 787, 1133, 1345, 1451, 1664, 1904, 2158, 2248, 2430, 2715, 3451, 3778, 4033, 4530, 4647, 4883, 5204, 5570, 5999, 6316, 6485, 6861, 7347, 7960, 8510, 8710]",20816,13333,13748,8375,8710,49,4,92,33,100,"[0, 632, 967, 1225, 1596, 1985, 2425, 3190, 3780, 4422, 5021, 5689, 6481, 7426, 7710, 7859, 8460, 9423, 9811, 10227, 10958, 11239, 11742, 12322, 13532, 14674, 15508, 16462, 17590, 18248]","[0, 273, 644, 938, 1352, 1561, 2037, 2485, 2805, 3153, 3555, 3986, 4245, 4896, 5119, 5770, 6272, 7170, 7810, 8099, 8937, 9370, 9810, 10223, 11582, 12312, 13556, 14706, 15184, 15758]","[0, 240, 499, 925, 1098, 1298, 1828, 2376, 2879, 3249, 3837, 4272, 4633, 5125, 5496, 5843, 6239, 6512, 6919, 7393, 7829, 8398, 8894, 9168, 9584, 10272, 10783, 10964, 11773, 11869]","[0, 200, 310, 473, 575, 772, 936, 1173, 1440, 1701, 2039, 2538, 2962, 3377, 3526, 3838, 4059, 4395, 4796, 5024, 5523, 5988, 6414, 6759, 7668, 8096, 9002, 9543, 9932, 10452]","[0, 200, 308, 470, 595, 685, 775, 1087, 1352, 1531, 1666, 1929, 2159, 2473, 2622, 2894, 3376, 3946, 4071, 4500, 4819, 5216, 5610, 6094, 7054, 7441, 8077, 8457, 8809, 9387]",18248,15758,11869,10452,9387,2568,-2425,1879,-2077,-677,-732,30,dire
7582625110,97,105,96,107,102,"[0, 174, 617, 996, 1441, 1870, 2491, 2931, 3472, 4300, 4757, 5690, 6125, 6919, 7855, 8564, 9212, 9594, 10496, 11183, 13244, 13752, 14469, 16266, 16965, 18877, 20527, 21685, 23165, 23351]","[0, 174, 537, 793, 1226, 1614, 1986, 2255, 2501, 3093, 3854, 5095, 5533, 5989, 6433, 6617, 7048, 8134, 8396, 8835, 10634, 11407, 12031, 13416, 13735, 15080, 15801, 16668, 17150, 17411]","[0, 208, 408, 876, 1289, 1684, 1890, 2320, 2484, 3127, 3533, 3945, 4360, 4900, 5482, 5994, 6473, 6935, 7029, 7289, 7384, 7804, 8944, 9914, 10231, 10499, 11533, 12232, 13122, 14449]","[0, 89, 179, 505, 735, 940, 1030, 1165, 1255, 1653, 2358, 2592, 2892, 3514, 4189, 4618, 4713, 4934, 5174, 5444, 6448, 6737, 7110, 7922, 8464, 9135, 9813, 10148, 11165, 11741]","[0, 89, 237, 374, 604, 710, 1179, 1334, 1469, 1708, 2035, 2269, 2621, 2997, 3463, 3647, 3781, 4073, 4485, 4656, 4802, 5332, 5717, 6005, 6170, 6719, 7445, 7829, 8698, 9309]",23351,17411,14449,11741,9309,49,21,41,26,51,"[0, 395, 836, 1225, 1621, 2041, 2653, 3051, 4051, 4156, 5162, 5868, 6602, 7377, 7695, 8213, 8917, 9578, 10024, 10569, 11365, 12043, 12995, 13357, 13777, 14266, 14445, 15050, 15605, 16074]","[0, 324, 613, 1025, 1464, 1691, 2178, 2475, 2767, 3065, 3335, 4014, 4717, 5384, 5593, 6329, 6852, 7717, 8375, 8937, 10199, 10432, 10951, 11046, 12001, 12168, 12699, 13154, 13250, 14578]","[0, 312, 513, 791, 1042, 1218, 1795, 2050, 2411, 2635, 2980, 3788, 4544, 5185, 5723, 6044, 6571, 7166, 7801, 8432, 9398, 9597, 9942, 10289, 11173, 11437, 11984, 12343, 13125, 13342]","[0, 318, 491, 915, 1005, 1133, 1359, 1531, 1898, 2036, 2386, 2923, 3221, 3501, 3650, 3950, 4045, 4684, 5054, 5479, 6059, 6463, 6787, 7424, 7603, 7856, 8585, 8713, 9150, 10870]","[0, 274, 364, 501, 591, 715, 979, 1069, 1240, 1498, 1783, 2381, 2556, 2789, 2988, 3327, 3528, 4410, 4661, 5385, 5786, 6053, 6291, 6386, 7044, 7295, 7754, 7930, 8026, 8518]",16074,14578,13342,10870,8518,7277,2833,1107,871,791,12879,30,radiant
7582691602,25,93,65,51,110,"[0, 276, 604, 1052, 1342, 1797, 2291, 2626, 3484, 4065, 4567, 4952, 5405, 5750, 6354, 7505, 8569, 9236, 9875, 10979, 11933, 12604, 13849, 13944, 14765, 15746, 16646, 18701, 19956, 22234]","[0, 326, 697, 1124, 1377, 1761, 2008, 2357, 2648, 2970, 3320, 3689, 4441, 5197, 5809, 7079, 7843, 8440, 9206, 9851, 10576, 10671, 11785, 12609, 13245, 14178, 14463, 15100, 15361, 15779]","[0, 208, 384, 511, 985, 1137, 1351, 1548, 1824, 2077, 2589, 3132, 3385, 4355, 4527, 5202, 6115, 6290, 6677, 7235, 7936, 8031, 8301, 8783, 9040, 9685, 10413, 10753, 10959, 11258]","[0, 170, 301, 435, 525, 655, 794, 929, 1019, 1154, 1617, 1751, 2003, 2856, 2951, 3659, 4032, 4660, 5088, 5759, 6142, 6497, 7066, 7445, 7650, 8002, 8337, 9338, 9783, 10788]","[0, 170, 260, 464, 657, 826, 952, 1086, 1211, 1383, 1605, 1695, 1948, 2136, 2384, 3084, 3518, 4131, 4556, 5352, 5706, 5954, 6720, 6815, 7184, 7738, 7927, 8867, 9073, 10129]",22234,15779,11258,10788,10129,70,14,129,119,111,"[0, 332, 677, 1114, 1485, 2130, 2595, 2956, 3945, 4509, 5113, 5606, 6138, 6604, 6936, 7131, 8023, 8740, 9826, 10193, 10287, 11577, 12945, 13785, 14604, 15259, 15678, 16562, 16794, 17129]","[0, 277, 545, 905, 1319, 1652, 1932, 2303, 2516, 3123, 3808, 3898, 4388, 4977, 5741, 5836, 6387, 7074, 7721, 8125, 8443, 10000, 10765, 11922, 12393, 12843, 13102, 13512, 14257, 14398]","[0, 204, 535, 862, 1143, 1475, 1962, 2423, 2912, 3259, 3877, 4291, 4563, 5069, 5527, 6197, 6898, 7384, 7639, 7734, 8481, 9398, 10538, 10833, 11224, 12040, 12265, 12675, 13422, 13564]","[0, 170, 671, 1008, 1564, 1818, 2143, 2278, 2793, 2922, 3377, 3724, 3814, 3909, 4103, 4279, 4463, 5057, 5447, 5542, 5998, 6546, 6931, 7662, 7966, 8318, 8618, 9298, 10443, 10650]","[0, 170, 260, 464, 668, 772, 1036, 1434, 1573, 1707, 2182, 2321, 2411, 2545, 2640, 2770, 3181, 3538, 3903, 4218, 4440, 4886, 5478, 6063, 6387, 6916, 7060, 7470, 8633, 8907]",17129,14398,13564,10650,8907,5105,1381,-2306,138,1222,5540,30,radiant
7582756500,120,12,86,14,3,"[0, 240, 613, 1132, 1595, 2093, 2484, 3118, 3728, 4293, 4939, 5481, 6149, 6817, 7389, 8156, 8878, 10229, 10891, 12117, 12696, 13374, 13992, 14619, 16184, 16529, 16671, 16766, 16984, 19340]","[0, 243, 429, 800, 1210, 1629, 2142, 2665, 3056, 3422, 3822, 4092, 4620, 5758, 6103, 6554, 6991, 7224, 7837, 8482, 9286, 10479, 11100, 11899, 12549, 13377, 14339, 14458, 14790, 15239]","[0, 220, 310, 463, 649, 828, 1115, 1357, 1548, 1788, 1926, 2188, 2415, 2734, 3084, 3429, 4040, 4573, 4969, 5821, 5916, 6336, 6561, 6897, 7484, 7726, 8154, 8358, 8619, 10092]","[0, 278, 679, 987, 1313, 1682, 1887, 2134, 2378, 3023, 3476, 3710, 4015, 4635, 5012, 5476, 5881, 6158, 6407, 6565, 7009, 7427, 8010, 8462, 8898, 9065, 9159, 9299, 9493, 9609]","[0, 170, 260, 429, 632, 866, 1047, 1182, 1289, 1424, 1514, 1882, 2073, 2401, 2665, 2760, 2918, 3069, 3525, 3897, 3992, 4396, 4490, 4713, 5003, 5170, 5310, 5405, 5591, 6170]",19340,15239,10092,9609,6170,17,13,38,53,5,"[0, 368, 722, 1226, 1769, 2281, 2940, 3477, 4174, 4618, 5388, 6221, 6828, 7604, 8355, 8892, 9899, 10953, 11714, 12774, 13720, 14550, 15473, 17155, 18219, 18705, 20369, 21463, 22308, 23478]","[0, 293, 581, 989, 1511, 1953, 2493, 3032, 3473, 4041, 4557, 5181, 5787, 6505, 7266, 8025, 8774, 9440, 10949, 12421, 13272, 13484, 14025, 15166, 15333, 15937, 17738, 18339, 19791, 20670]","[0, 242, 404, 736, 1133, 1708, 2030, 2450, 3322, 3695, 4255, 4680, 4923, 5165, 5505, 6130, 6637, 7128, 7759, 8165, 8718, 8813, 9426, 10390, 10557, 11302, 12222, 12974, 14409, 15191]","[0, 170, 260, 436, 613, 882, 1052, 1333, 1423, 1610, 1981, 2490, 2728, 3657, 3877, 4418, 4905, 5054, 5417, 6062, 6371, 6743, 7287, 7698, 8741, 9159, 9904, 10624, 11906, 12464]","[0, 170, 260, 350, 528, 618, 772, 952, 1080, 1191, 1326, 1535, 1682, 2052, 2259, 2399, 2832, 3118, 3212, 3604, 3912, 4253, 4674, 5209, 5619, 5786, 6151, 6626, 7944, 8387]",23478,20670,15191,12464,8387,-4138,-5431,-5099,-2855,-2217,-19740,30,dire
7582859002,48,106,96,86,21,"[0, 206, 489, 957, 1348, 1776, 2469, 3011, 3524, 4177, 5071, 5793, 6667, 7759, 8685, 9422, 10346, 10969, 11688, 12309, 13050, 14112, 15131, 15937, 16919, 18389, 19512, 20231, 22032, 23681]","[0, 214, 510, 807, 968, 1298, 1476, 2115, 2769, 3208, 3789, 4205, 4548, 4985, 5510, 5977, 6977, 7492, 8101, 8618, 8916, 9572, 10286, 10740, 11394, 12309, 13105, 13962, 15079, 15593]","[0, 258, 530, 819, 1174, 1393, 1757, 2357, 2803, 3314, 3815, 4546, 5025, 5702, 6145, 6441, 6728, 7181, 7415, 8195, 8856, 9540, 10158, 10426, 11028, 11713, 12214, 12475, 13474, 14042]","[0, 218, 359, 498, 951, 1360, 1580, 1870, 2008, 2424, 2629, 3178, 3394, 3935, 4914, 5139, 5373, 5580, 5675, 5873, 6628, 6946, 7589, 7944, 8509, 9961, 10289, 10383, 11299, 11810]","[0, 170, 260, 394, 583, 699, 789, 1080, 1232, 1394, 1576, 1982, 2720, 3053, 3756, 3851, 4130, 4337, 4482, 4910, 5268, 5668, 6193, 6561, 7173, 7975, 8438, 8985, 9763, 10531]",23681,15593,14042,11810,10531,25,97,14,45,26,"[0, 286, 590, 1090, 1413, 1503, 1945, 2208, 2725, 3138, 3880, 4357, 4711, 5536, 6421, 6990, 8504, 10038, 10579, 11581, 12427, 13489, 14175, 14708, 15201, 15748, 16699, 17425, 17951, 18584]","[0, 209, 520, 820, 1242, 1420, 1778, 2019, 2653, 2949, 3450, 3557, 4367, 5144, 5838, 6466, 7433, 8582, 9114, 9744, 9962, 10359, 11144, 11948, 12923, 13018, 13684, 14528, 15136, 15232]","[0, 279, 515, 679, 1177, 1267, 1457, 1832, 2321, 2708, 3177, 3714, 4347, 4706, 4801, 5195, 5933, 6466, 7141, 7643, 7980, 8075, 8350, 8782, 9109, 9279, 9756, 10393, 10645, 10816]","[0, 215, 305, 395, 584, 762, 867, 957, 1209, 1299, 1784, 1920, 2194, 2556, 2651, 2746, 3468, 4008, 4718, 5147, 5453, 5905, 6391, 6485, 6686, 6830, 6971, 7065, 7451, 7666]","[0, 170, 312, 438, 615, 792, 885, 975, 1155, 1245, 1517, 1607, 2488, 2823, 2981, 3076, 3233, 3977, 4285, 4798, 5105, 5355, 5620, 5789, 6208, 6458, 6677, 6846, 7147, 7318]",18584,15232,10816,7666,7318,5097,361,3226,4144,3213,16041,30,radiant
7583012200,89,106,137,112,105,"[0, 321, 625, 1048, 1256, 1628, 2355, 2621, 3145, 3698, 4447, 5148, 5565, 6279, 7260, 8132, 8969, 9596, 10353, 10867, 11270, 12003, 12378, 13626, 14775, 15272, 16077, 16726, 17576, 18442]","[0, 243, 446, 536, 735, 934, 1522, 1867, 2158, 2611, 2985, 3584, 4215, 4748, 4847, 5388, 5919, 6517, 7075, 7736, 8064, 8819, 9845, 10554, 11534, 12074, 12416, 12887, 13515, 14326]","[0, 296, 533, 977, 1172, 1512, 2129, 2566, 3072, 3331, 4207, 4703, 5176, 5976, 6071, 6624, 7360, 7798, 8158, 8861, 9316, 9615, 10227, 11091, 12102, 12681, 12943, 13461, 13724, 14005]","[0, 209, 299, 389, 479, 697, 1075, 1291, 1381, 1507, 1717, 1841, 2217, 2511, 2825, 3093, 3407, 3891, 4582, 4739, 5144, 5484, 5746, 6159, 6351, 6985, 7270, 7466, 7691, 8059]","[0, 209, 299, 389, 479, 657, 1035, 1170, 1322, 1489, 1705, 1795, 2010, 2159, 2254, 2599, 2864, 3574, 4056, 4252, 4460, 4660, 5035, 5523, 6028, 6590, 6962, 7105, 7201, 7432]",18442,14326,14005,8059,7432,73,46,50,19,111,"[0, 263, 527, 991, 1528, 2095, 2284, 2623, 2982, 3638, 4502, 5049, 6274, 7237, 8104, 9160, 10104, 10489, 11444, 12027, 12989, 13420, 14662, 15414, 15887, 17075, 18134, 19501, 21099, 22274]","[0, 205, 530, 693, 1212, 1577, 1902, 2423, 2918, 3550, 4162, 4733, 5490, 6408, 6984, 7727, 8391, 9060, 9830, 10439, 11072, 11644, 12896, 13284, 13568, 14104, 14937, 15819, 16941, 17756]","[0, 166, 479, 971, 1422, 1913, 2523, 2929, 3605, 4063, 4402, 5049, 5517, 6023, 6649, 7173, 8228, 8458, 8981, 9399, 10233, 10573, 10914, 11663, 12089, 12961, 13626, 14134, 15056, 15729]","[0, 168, 334, 588, 762, 913, 1070, 1323, 1503, 1633, 2028, 2240, 2584, 2939, 3173, 3673, 4094, 4324, 4508, 4932, 5090, 5188, 5983, 6149, 6548, 7073, 7214, 7395, 7653, 8301]","[0, 229, 349, 439, 529, 619, 917, 1007, 1187, 1367, 1568, 1851, 2090, 2239, 2646, 2831, 3334, 3564, 3734, 3967, 4127, 4222, 4527, 4693, 4898, 5083, 5178, 5272, 5530, 5716]",22274,17756,15729,8301,5716,-3832,-3430,-1724,-242,1716,-7512,30,dire
7583124505,14,49,129,74,121,"[0, 207, 631, 917, 1123, 1409, 1730, 2220, 3116, 3626, 3906, 4758, 4987, 5658, 6076, 6406, 7415, 8197, 8635, 9264, 9891, 10737, 11659, 13047, 14377, 14818, 15504, 16247, 17000, 17863]","[0, 255, 567, 779, 1231, 1500, 1746, 2010, 2100, 2615, 3105, 3783, 4877, 5820, 6456, 6929, 7637, 8274, 8873, 9627, 10124, 11190, 11880, 12704, 13541, 14169, 15015, 15109, 15967, 16943]","[0, 366, 722, 969, 1437, 1717, 2003, 2393, 2850, 3453, 4246, 4434, 5131, 5280, 5729, 6109, 6673, 7203, 7605, 8634, 8886, 9795, 11002, 12346, 12917, 13345, 13565, 14027, 15120, 16463]","[0, 169, 284, 422, 556, 658, 788, 878, 968, 1411, 1794, 2307, 2994, 3509, 3992, 4357, 4664, 5225, 5463, 6542, 6747, 7575, 8260, 8828, 9429, 10021, 10462, 10556, 11215, 12087]","[0, 169, 284, 374, 480, 614, 770, 1254, 1887, 2332, 2512, 2960, 3256, 3923, 4331, 4825, 5027, 5444, 5628, 6686, 6891, 7602, 8057, 8637, 9243, 9829, 10127, 10221, 10903, 11524]",17863,16943,16463,12087,11524,82,61,76,66,45,"[0, 203, 511, 906, 1320, 1775, 2101, 2494, 2712, 3205, 3877, 3967, 5120, 5464, 6238, 6785, 7024, 8163, 8925, 10057, 11148, 11660, 11755, 12070, 12380, 12719, 14221, 14926, 15332, 15428]","[0, 331, 599, 1051, 1376, 1667, 2185, 2814, 3199, 3853, 4422, 4512, 4692, 5566, 5749, 6262, 6862, 7165, 7586, 7840, 8329, 8839, 8934, 9568, 10169, 10564, 12068, 13170, 13813, 14120]","[0, 258, 635, 1087, 1252, 1665, 2347, 2717, 3546, 4009, 4387, 5408, 5588, 6242, 6776, 7530, 7911, 8713, 9183, 9538, 9745, 10248, 10560, 10909, 11162, 11679, 12670, 13591, 13779, 13875]","[0, 169, 309, 491, 628, 777, 984, 1308, 2135, 2543, 2831, 3265, 3880, 4393, 4711, 5204, 5544, 5851, 6180, 6564, 6771, 6972, 7067, 7161, 7341, 7787, 8505, 9244, 9600, 9867]","[0, 169, 259, 379, 469, 655, 838, 1220, 1391, 1571, 2111, 2321, 2548, 2767, 3191, 3976, 4625, 5024, 5119, 5467, 5769, 6221, 6316, 6410, 6638, 6970, 8332, 9054, 9150, 9246]",15428,14120,13875,9867,9246,2435,2823,2588,2220,2278,12344,30,radiant
7583211100,48,36,53,2,20,"[0, 281, 957, 1156, 1532, 1767, 2116, 2668, 3137, 3549, 4268, 4779, 5338, 6007, 6806, 7610, 8309, 9118, 10388, 11980, 12983, 13983, 14589, 15108, 15839, 16740, 17772, 18062, 18376, 19462]","[0, 324, 609, 997, 1411, 1984, 2444, 2941, 3729, 4429, 5564, 5969, 6620, 7045, 7338, 7611, 8202, 8786, 9549, 10526, 10941, 11519, 12234, 12782, 13192, 13816, 14760, 14955, 15319, 15572]","[0, 209, 299, 654, 789, 1136, 1434, 1778, 2535, 2625, 3398, 3929, 4417, 4679, 5523, 5729, 6098, 6304, 6778, 7455, 8412, 8585, 9172, 10119, 10718, 11318, 12056, 12197, 12924, 13508]","[0, 376, 771, 1200, 1558, 2018, 2402, 3068, 3562, 3860, 4765, 5305, 6246, 7069, 7403, 7703, 8147, 8412, 8635, 9880, 10038, 10250, 10432, 11274, 11760, 12018, 12576, 12670, 12821, 13140]","[0, 209, 410, 543, 941, 1031, 1661, 2311, 2546, 2707, 3188, 3441, 3733, 3995, 4215, 4430, 4711, 4806, 5029, 6165, 6492, 6700, 7035, 7501, 7781, 8192, 8736, 8905, 9296, 9801]",19462,15572,13508,13140,9801,94,49,74,138,68,"[0, 202, 540, 704, 1151, 1581, 1766, 2294, 2629, 3177, 3431, 3732, 4376, 4816, 5646, 6205, 7037, 7547, 8326, 9163, 9963, 10931, 11657, 12198, 13227, 14245, 15399, 16631, 17538, 18171]","[0, 200, 438, 842, 1004, 1369, 1691, 2057, 2270, 2743, 3201, 3500, 4314, 4899, 5444, 6242, 6791, 7219, 7856, 7987, 8328, 8977, 9725, 10324, 11018, 11539, 12588, 13777, 14243, 14503]","[0, 202, 361, 805, 1194, 1368, 1785, 2132, 2556, 3161, 3323, 3482, 3787, 4224, 4892, 5373, 5702, 6593, 7388, 8060, 8392, 8998, 9329, 9571, 9823, 11136, 11775, 13204, 13436, 13688]","[0, 129, 219, 352, 491, 630, 991, 1447, 1537, 1709, 2103, 2231, 2411, 2607, 2885, 3152, 3404, 3697, 3936, 4381, 4502, 5037, 5609, 6063, 6564, 7091, 7885, 8578, 9229, 9873]","[0, 129, 219, 309, 399, 782, 986, 1177, 1390, 1676, 1766, 2046, 2272, 3064, 3388, 3814, 4016, 4442, 4681, 4818, 5164, 5562, 5844, 6195, 6525, 7238, 7858, 8831, 9138, 9309]",18171,14503,13688,9873,9309,1291,1069,-180,3267,492,5939,30,dire
7583651901,95,137,29,26,123,"[0, 302, 953, 1249, 1808, 2530, 2742, 3123, 3617, 4101, 4838, 5327, 5766, 6396, 7037, 7221, 7579, 8098, 8493, 9295, 10461, 10556, 11721, 12532, 12921, 13728, 15127, 16210, 16805, 16935]","[0, 342, 594, 797, 964, 1279, 1746, 1881, 2335, 2580, 3139, 3229, 3755, 4336, 4809, 5007, 6254, 6489, 6936, 7361, 8587, 9005, 9804, 9898, 10240, 10498, 10991, 11500, 12603, 12699]","[0, 275, 505, 670, 1100, 1267, 1643, 1812, 2107, 2479, 2863, 3109, 3526, 4140, 4331, 4830, 5407, 5886, 6559, 7107, 7984, 8481, 8850, 9022, 9292, 11049, 11587, 11681, 12520, 12978]","[0, 229, 540, 793, 1005, 1438, 1779, 1925, 2312, 2585, 3059, 3149, 3239, 3458, 3757, 3955, 4243, 4714, 4956, 5113, 5649, 5819, 6037, 6391, 6655, 7538, 8016, 8653, 8985, 9462]","[0, 598, 888, 978, 1145, 1280, 1459, 1594, 1720, 2106, 2415, 2505, 2678, 2827, 3043, 3311, 4177, 4407, 4702, 5007, 5472, 5648, 6009, 6103, 6243, 7002, 7747, 8256, 8352, 8487]",16935,12699,12978,9462,8487,36,28,96,112,136,"[0, 253, 552, 926, 1174, 1664, 2163, 3079, 3755, 4326, 5073, 5992, 6533, 7372, 9097, 9765, 10296, 11883, 13141, 13872, 15537, 16455, 17550, 18318, 19248, 19891, 19986, 21093, 22249, 22733]","[0, 252, 609, 846, 1319, 1681, 2232, 3177, 3467, 3557, 3862, 4629, 5404, 5982, 6648, 7558, 7921, 8848, 9624, 10428, 10911, 11355, 11980, 12528, 13397, 14183, 14654, 15344, 16249, 17311]","[0, 209, 517, 973, 1294, 1435, 1796, 2010, 2504, 2888, 3152, 3658, 4092, 4630, 4988, 5384, 6159, 7014, 7938, 8369, 9412, 9891, 10400, 11045, 11539, 12280, 12684, 13226, 13508, 14543]","[0, 170, 488, 622, 794, 884, 1022, 1328, 1643, 1733, 1823, 2155, 2245, 2394, 2933, 3338, 3521, 4396, 4860, 5110, 5647, 5997, 6268, 7088, 7634, 8176, 8271, 9172, 9941, 11163]","[0, 170, 480, 570, 660, 750, 888, 1409, 1574, 1746, 1873, 2113, 2400, 2585, 2991, 3278, 3373, 3705, 4322, 4525, 4814, 5403, 5863, 6312, 7358, 8018, 8620, 8983, 9707, 10602]",22733,17311,14543,11163,10602,-5798,-4612,-1565,-1701,-2115,-15791,30,dire
7583888910,54,69,123,97,121,"[64, 312, 723, 1160, 1705, 2045, 2505, 2917, 3599, 4169, 4652, 5263, 5642, 6354, 7124, 7930, 8615, 9341, 10347, 11200, 11619, 12443, 13655, 13795, 14646, 15278, 16161, 16916, 18724, 19089]","[0, 169, 403, 662, 1063, 1445, 1841, 2091, 2762, 3491, 3963, 4093, 4662, 5242, 5661, 6218, 6872, 7319, 7607, 8134, 8386, 9469, 10172, 10296, 10762, 11291, 11386, 11999, 12835, 13091]","[64, 295, 430, 639, 774, 1372, 1564, 1654, 2089, 2344, 2453, 2683, 2867, 3278, 3941, 4333, 4723, 5031, 5386, 5816, 6016, 6946, 7531, 7728, 8206, 8812, 8907, 9484, 10534, 11026]","[64, 231, 519, 884, 1289, 1617, 2129, 2717, 3128, 3433, 4054, 4634, 5157, 5484, 6125, 6613, 7176, 7581, 8370, 8956, 9166, 9655, 10183, 10721, 10908, 11470, 11565, 12777, 13671, 13862]","[332, 462, 587, 783, 1047, 1155, 1617, 1914, 2237, 2539, 2629, 2936, 3026, 3174, 3458, 3553, 3800, 4231, 4359, 4672, 4872, 5459, 5772, 5867, 6016, 6345, 6440, 6967, 7587, 7688]",19089,13091,11026,13862,7688,82,120,55,65,105,"[0, 335, 899, 1176, 1343, 1510, 1903, 2608, 3176, 3662, 4379, 5439, 6080, 6506, 7369, 8139, 8871, 10109, 11014, 11602, 12895, 13648, 14551, 15092, 15792, 16370, 17839, 19160, 20933, 21775]","[0, 284, 562, 899, 1071, 1287, 1550, 2055, 2477, 3563, 4170, 4880, 5412, 5665, 6342, 6765, 7313, 7766, 7955, 8497, 9701, 9933, 10785, 11724, 12115, 12454, 12932, 13467, 13916, 14777]","[0, 246, 488, 905, 1029, 1617, 1745, 2282, 2382, 2778, 3458, 3858, 4442, 4696, 5210, 5923, 6505, 6860, 7123, 7865, 9000, 9094, 10134, 10512, 10890, 11120, 12154, 12434, 13081, 13279]","[0, 210, 373, 676, 771, 1326, 1455, 1728, 1818, 2473, 2861, 3260, 3538, 3881, 4214, 4572, 5286, 5735, 5830, 6046, 7004, 7271, 7441, 7710, 8166, 8471, 9290, 9580, 10104, 10600]","[0, 254, 394, 588, 764, 1008, 1108, 1472, 1847, 2398, 2799, 3170, 3349, 3511, 3831, 4078, 4723, 5357, 5546, 5915, 7082, 7300, 8125, 8529, 8874, 9401, 10392, 10597, 11517, 11613]",21775,14777,13279,10600,11613,-2686,-1686,-2253,3262,-3925,-7288,30,radiant
7584103800,18,49,112,129,5,"[0, 253, 644, 927, 1140, 1471, 2012, 2421, 2800, 3368, 3983, 4345, 5299, 5870, 6717, 7401, 8348, 8888, 10296, 11276, 12051, 13129, 13646, 15349, 15920, 17903, 18891, 19268, 19698, 22007]","[0, 213, 674, 972, 1383, 1880, 2179, 2539, 2977, 3409, 4011, 4907, 5328, 5626, 6411, 6859, 7193, 7789, 8960, 10055, 10731, 11056, 11151, 12310, 12751, 13796, 14317, 15145, 15920, 16861]","[0, 170, 260, 350, 559, 698, 870, 1008, 1282, 1798, 2178, 2492, 2670, 2764, 3258, 3542, 4225, 4826, 5316, 6632, 7249, 7569, 8173, 8756, 9174, 10426, 11068, 11860, 12259, 13575]","[0, 170, 337, 534, 1054, 1370, 1691, 1979, 2401, 2656, 3066, 3331, 3509, 3603, 3930, 4306, 4651, 4847, 5565, 5838, 6236, 6487, 6851, 7525, 7816, 8451, 8974, 9302, 9479, 10361]","[0, 170, 260, 685, 818, 908, 1079, 1217, 1527, 1944, 2163, 2536, 2714, 2808, 3256, 3485, 4052, 4249, 4407, 4872, 5193, 5397, 5715, 6236, 6762, 7434, 7744, 8072, 8249, 9191]",22007,16861,13575,10361,9191,48,28,106,64,26,"[0, 204, 525, 649, 1131, 1421, 1773, 2739, 3122, 3886, 4492, 4989, 6156, 6805, 7800, 8664, 9406, 9799, 10875, 11745, 12686, 13702, 14341, 14642, 15738, 16348, 16443, 17371, 18497, 19705]","[0, 243, 555, 870, 1691, 1935, 2263, 2816, 3462, 4049, 4966, 5491, 5924, 6633, 7166, 7445, 8652, 8984, 9695, 10037, 10617, 10852, 11278, 11373, 11782, 12102, 12282, 12971, 13526, 13800]","[0, 272, 531, 899, 1116, 1576, 1958, 2364, 2858, 3262, 4170, 4513, 5289, 5755, 6033, 6391, 7215, 7778, 7936, 8338, 8742, 9001, 9647, 10451, 10654, 11004, 11382, 11703, 12221, 12317]","[0, 170, 260, 350, 878, 968, 1109, 1337, 1504, 1801, 2026, 2193, 2626, 2813, 3278, 3539, 3909, 4373, 4531, 4875, 5094, 5468, 6260, 7047, 7216, 7611, 7781, 8113, 8451, 8865]","[0, 170, 312, 402, 492, 689, 779, 1041, 1180, 1363, 1769, 1859, 2122, 2270, 2419, 2687, 3678, 3858, 4209, 4391, 4658, 5248, 5573, 6063, 6157, 6477, 6658, 6915, 7092, 7188]",19705,13800,12317,8865,7188,2302,3061,1258,1496,2003,10120,30,radiant
7584141103,49,23,4,64,87,"[0, 208, 491, 780, 1065, 1385, 1597, 1773, 2081, 2519, 2879, 3534, 3965, 4237, 4955, 5509, 6048, 6450, 7271, 7950, 9215, 9962, 10713, 11007, 12671, 13581, 15329, 16477, 17417, 18075]","[0, 313, 667, 1035, 1525, 1898, 2508, 2958, 3414, 3866, 4603, 4917, 5183, 6079, 6996, 7553, 8315, 8445, 9264, 10135, 10675, 11428, 12168, 12497, 13429, 14001, 15030, 15340, 15921, 16271]","[0, 257, 602, 860, 1385, 1747, 2021, 2277, 2483, 2662, 3184, 3309, 3912, 4299, 4568, 5229, 5940, 7109, 7736, 8784, 9472, 10225, 11291, 11814, 12711, 13900, 13995, 14533, 15161, 15485]","[0, 170, 260, 350, 533, 623, 811, 901, 991, 1128, 1731, 1821, 1911, 2345, 2619, 3042, 3340, 3935, 4638, 5024, 5383, 5666, 6028, 6258, 7145, 7511, 8131, 8591, 9842, 10192]","[0, 170, 260, 350, 582, 716, 851, 941, 1031, 1121, 1532, 1841, 1931, 2025, 2580, 2675, 2906, 3082, 3486, 3825, 4111, 4206, 4865, 5095, 6209, 6466, 6860, 7476, 8057, 8307]",18075,16271,15485,10192,8307,70,71,104,112,111,"[0, 255, 727, 1085, 1453, 1818, 2164, 2667, 3135, 3536, 3741, 4716, 5272, 6043, 6697, 7267, 7892, 8786, 9281, 9818, 10412, 11436, 12136, 13305, 14251, 14546, 15128, 16729, 17532, 17628]","[0, 283, 717, 1049, 1550, 1921, 2385, 2672, 3063, 3395, 3744, 4299, 5092, 5830, 6110, 6741, 7656, 8369, 9151, 9399, 10135, 10343, 10971, 11912, 12027, 12244, 12914, 13787, 14544, 14640]","[0, 257, 416, 868, 998, 1365, 1838, 2441, 2910, 3285, 3999, 4212, 4783, 5754, 6061, 6255, 6844, 7107, 7202, 7727, 7928, 8232, 8838, 9424, 9623, 10277, 11795, 12113, 12647, 13268]","[0, 170, 260, 398, 528, 667, 954, 1299, 1488, 1736, 1960, 2287, 2697, 3482, 3577, 4018, 4837, 5181, 5591, 6089, 6308, 6930, 7131, 7753, 7983, 8389, 9189, 9508, 10323, 10458]","[0, 170, 260, 739, 924, 1058, 1192, 1405, 1560, 1695, 1832, 1922, 2059, 2608, 2823, 2962, 3318, 3548, 3750, 4101, 4195, 4610, 4777, 5007, 5101, 5622, 6016, 6363, 6711, 6860]",17628,14640,13268,10458,6860,447,1631,2217,-266,1447,5476,30,dire
7584179905,48,22,32,53,84,"[0, 215, 524, 804, 1042, 1425, 1651, 2047, 2561, 3145, 3680, 4497, 5258, 5941, 6462, 6982, 7749, 9184, 10347, 11908, 12768, 13948, 14682, 15831, 16650, 17736, 19364, 21283, 23394, 24341]","[0, 251, 652, 1102, 1549, 1995, 2373, 3080, 3722, 4215, 4644, 5165, 5578, 6582, 7179, 7559, 8121, 8750, 9492, 10257, 11257, 12222, 12565, 12804, 13105, 13236, 14111, 14932, 16460, 16772]","[0, 242, 498, 782, 1038, 1167, 1684, 2189, 2279, 2531, 2752, 3131, 3828, 4244, 4911, 5471, 5887, 6967, 8136, 9077, 10063, 10344, 11110, 11480, 11575, 11669, 12228, 13130, 13634, 14532]","[0, 130, 237, 327, 462, 552, 788, 1130, 1254, 1570, 1894, 2231, 2469, 3005, 3508, 3872, 4149, 4487, 4826, 5521, 6334, 6885, 7451, 7801, 8430, 8652, 9414, 10070, 10820, 11298]","[0, 130, 267, 375, 465, 555, 645, 825, 923, 1071, 1452, 1704, 1841, 2103, 2197, 2566, 2661, 2877, 3460, 3618, 3965, 4116, 4344, 4627, 4722, 4854, 5580, 6840, 7856, 8232]",24341,16772,14532,11298,8232,46,42,74,85,21,"[0, 284, 519, 976, 1334, 1769, 2209, 2568, 3277, 3878, 4768, 5710, 6157, 6825, 7291, 7784, 8574, 9515, 10455, 10715, 11643, 12603, 13086, 13999, 15398, 16111, 16899, 17487, 17583, 18072]","[0, 328, 623, 936, 1400, 1896, 2343, 3225, 3817, 4222, 4971, 5423, 5879, 6540, 6974, 7157, 8176, 8702, 9800, 10119, 10281, 10915, 11291, 12168, 13223, 13955, 14442, 15096, 15192, 16106]","[0, 403, 809, 1250, 1664, 2430, 2936, 3556, 4126, 4593, 5182, 5485, 6055, 6489, 6794, 7275, 7814, 7972, 8277, 8926, 9513, 9966, 10535, 11429, 12008, 12319, 12618, 13027, 13123, 13345]","[0, 210, 340, 430, 582, 734, 864, 1039, 1177, 1311, 1697, 1976, 2116, 2338, 2587, 2898, 3056, 3480, 3684, 4472, 4567, 4727, 4941, 5478, 5967, 6295, 6628, 7120, 7291, 7462]","[0, 210, 300, 434, 571, 707, 934, 1159, 1322, 1412, 1731, 1869, 2036, 2185, 2358, 2507, 2665, 2823, 3183, 3383, 3514, 3644, 3738, 4314, 4895, 5099, 5321, 5999, 6095, 6211]",18072,16106,13345,7462,6211,6269,666,1187,3836,2021,13979,30,radiant
7584193705,78,46,13,86,58,"[0, 207, 370, 751, 1075, 1165, 1623, 1890, 2433, 2742, 3064, 3711, 4543, 4940, 5354, 5935, 6816, 7318, 7571, 8145, 9016, 10013, 11066, 11196, 11738, 12110, 12826, 13666, 14178, 14957]","[0, 247, 421, 736, 935, 1378, 1505, 2012, 2529, 3053, 3541, 4408, 4992, 5700, 6455, 6974, 7873, 8644, 8988, 9841, 10395, 10717, 11584, 11731, 12509, 12604, 13621, 14473, 15210, 16067]","[0, 370, 612, 896, 1142, 1362, 1495, 1818, 1951, 2347, 2814, 3251, 3791, 4326, 4904, 5704, 6180, 6903, 7661, 8364, 9047, 9519, 10012, 10106, 10727, 10822, 11551, 12080, 12720, 13112]","[0, 169, 306, 430, 555, 703, 841, 982, 1163, 1433, 1663, 1887, 2112, 2868, 3053, 3630, 4046, 4204, 4610, 4842, 5012, 5794, 6950, 7119, 7289, 7459, 7710, 8157, 8772, 9192]","[0, 169, 259, 349, 474, 564, 654, 822, 984, 1294, 1578, 1896, 2270, 2672, 2900, 3589, 3897, 4236, 4679, 5206, 5346, 5788, 6256, 6350, 6913, 7046, 7262, 7356, 7576, 8046]",14957,16067,13112,9192,8046,67,47,137,19,110,"[0, 244, 625, 944, 1144, 1631, 1919, 2356, 2683, 2979, 3333, 3701, 3958, 4592, 5010, 5629, 6049, 6616, 7338, 7866, 8752, 10336, 10973, 12855, 13354, 14585, 15086, 15644, 16594, 17271]","[0, 250, 722, 1103, 1417, 1940, 2608, 2998, 3496, 4039, 4675, 5183, 5797, 6289, 6807, 7058, 7459, 7654, 8215, 8956, 9559, 10269, 10411, 11089, 11717, 12054, 12466, 13168, 13896, 14604]","[0, 169, 674, 990, 1323, 1583, 2102, 2557, 2806, 3341, 3844, 4213, 4509, 5080, 5961, 6270, 6666, 7199, 7586, 8155, 8777, 9505, 9705, 10764, 11441, 12164, 12498, 13326, 13891, 14295]","[0, 169, 284, 419, 597, 722, 1186, 1321, 1493, 1677, 1857, 2102, 2364, 2877, 3279, 3499, 3931, 4130, 4497, 4855, 5196, 5819, 6329, 7507, 7729, 8604, 8699, 9414, 9893, 10531]","[0, 169, 325, 797, 982, 1125, 1315, 1523, 1673, 1933, 2484, 2838, 3066, 3398, 3493, 3588, 3980, 4276, 4628, 5193, 5648, 6375, 6630, 7541, 8334, 9731, 10268, 10750, 11765, 11886]",17271,14604,14295,10531,11886,-2314,1463,-1183,-1339,-3840,-7213,30,radiant
7584220301,48,17,98,86,84,"[0, 293, 654, 903, 1075, 1236, 1552, 1900, 2172, 2498, 2987, 3288, 3744, 4592, 5191, 5813, 7139, 8280, 9507, 11125, 12223, 13198, 13897, 15288, 16482, 17596, 18648, 20563, 21610, 22663]","[0, 403, 763, 1207, 1750, 2125, 2708, 3138, 3520, 3990, 4516, 5120, 5601, 6381, 7072, 7268, 8229, 9763, 10194, 11174, 11880, 12263, 12434, 12981, 13076, 13972, 14169, 14783, 15449, 16300]","[0, 170, 337, 646, 857, 1032, 1356, 2313, 2454, 2742, 3151, 3429, 4094, 4772, 5638, 5907, 6718, 7401, 7825, 8892, 9245, 9635, 9938, 10178, 10602, 11457, 11659, 11754, 13045, 13603]","[0, 218, 395, 485, 799, 934, 1071, 1457, 1547, 1758, 1902, 2087, 2177, 3037, 3764, 3858, 4538, 4783, 5275, 5563, 5884, 6324, 6418, 6756, 6941, 7437, 7574, 8476, 9088, 9862]","[0, 170, 260, 350, 474, 564, 654, 758, 848, 938, 1028, 1167, 1257, 1591, 1732, 1826, 2056, 2698, 3012, 3106, 3201, 3642, 3736, 3941, 4230, 4742, 5050, 5560, 5818, 6376]",22663,16300,13603,9862,6376,106,114,97,105,3,"[0, 325, 854, 1190, 1561, 1966, 2421, 3050, 3875, 4338, 5281, 5771, 6243, 6811, 7488, 8181, 8924, 9459, 9885, 11160, 11786, 12736, 13486, 14904, 15745, 16644, 18176, 18817, 19115, 19897]","[0, 208, 539, 830, 1256, 1670, 2129, 2472, 3272, 3684, 4315, 4810, 5466, 6243, 6523, 7210, 7918, 8742, 9285, 10031, 10513, 10895, 11760, 13530, 14285, 15178, 16056, 17098, 17968, 18064]","[0, 204, 447, 764, 1232, 1642, 1979, 2552, 3282, 3701, 4544, 5395, 5856, 6303, 6830, 8014, 8319, 8558, 9215, 9413, 10137, 11618, 11978, 12762, 13544, 15340, 16317, 16537, 16933, 18152]","[0, 170, 260, 695, 834, 1157, 1247, 1426, 1734, 1868, 2347, 2437, 2593, 3054, 3221, 3526, 3783, 4123, 4218, 5032, 5454, 6125, 6291, 6880, 7147, 7774, 8202, 8422, 8657, 8753]","[0, 170, 260, 350, 520, 833, 970, 1060, 1540, 1750, 2131, 2267, 2423, 2771, 2957, 3262, 3483, 3578, 3673, 4354, 4571, 5415, 5879, 6548, 6915, 7252, 7641, 7861, 8004, 8259]",19897,18064,18152,8753,8259,2766,-1764,-4549,1109,-1883,-4321,30,radiant
7584272611,61,6,14,103,110,"[0, 361, 758, 1197, 1650, 2208, 2867, 3521, 4275, 4844, 5467, 6529, 7705, 9014, 10176, 10987, 12102, 13221, 13681, 14997, 16179, 18440, 21103, 22749, 23972, 25745, 27072, 28374, 29134, 30868]","[0, 259, 465, 712, 1095, 1515, 2028, 2447, 3015, 3506, 3975, 4642, 5313, 5856, 6412, 6793, 7359, 7661, 7923, 8327, 8596, 9565, 10102, 11240, 12243, 12869, 13952, 14563, 15231, 16784]","[0, 170, 510, 803, 1001, 1460, 1966, 2056, 2628, 2718, 3062, 3283, 3574, 3784, 3969, 4137, 4718, 4913, 5487, 5671, 5964, 6334, 7099, 7636, 7869, 8239, 8479, 8684, 8780, 9585]","[0, 170, 598, 688, 778, 960, 1177, 1267, 1639, 1863, 2094, 2184, 2439, 2580, 2765, 2860, 3269, 3427, 3522, 3806, 3951, 4278, 5044, 5422, 5652, 6022, 6307, 6513, 6761, 7658]","[0, 170, 260, 402, 541, 631, 781, 920, 1146, 1282, 1439, 1824, 2163, 2407, 2592, 2687, 3096, 3254, 3389, 3568, 3925, 4260, 4797, 5107, 5532, 5902, 6224, 6467, 6721, 7618]",30868,16784,9585,7658,7618,11,10,114,86,84,"[75, 447, 678, 1136, 1532, 2134, 2584, 3121, 3663, 4318, 5010, 5205, 5505, 5962, 6874, 7749, 7913, 8778, 10135, 10279, 11149, 11633, 12674, 13059, 13563, 14319, 15856, 16921, 17388, 18252]","[75, 328, 529, 898, 1189, 1528, 1926, 2393, 2589, 2831, 3700, 4231, 4816, 5831, 6133, 6668, 7669, 8389, 9151, 9928, 10794, 11499, 12012, 12470, 13512, 14217, 15518, 16824, 17553, 17985]","[75, 284, 561, 834, 1266, 1625, 1862, 2250, 2570, 2786, 3154, 3405, 3495, 3714, 4052, 4461, 4749, 5049, 5951, 6603, 7233, 7486, 8173, 8918, 9502, 9597, 9712, 10654, 10963, 11170]","[75, 296, 386, 525, 749, 1026, 1116, 1382, 1516, 1655, 1938, 2122, 2457, 2895, 3121, 3270, 3480, 4162, 4611, 4791, 4948, 5167, 5575, 5810, 6347, 6486, 7204, 7799, 8014, 8439]","[75, 245, 335, 425, 561, 776, 912, 1047, 1391, 1604, 2061, 2151, 2260, 2637, 2732, 2881, 3144, 3283, 3622, 3889, 4046, 4141, 4236, 4421, 4853, 5023, 5887, 6462, 6633, 7111]",18252,17985,11170,8439,7111,12616,-1201,-1585,-781,507,9556,30,radiant
7584380217,11,10,84,14,5,"[0, 324, 698, 1289, 1788, 2347, 2843, 3286, 3798, 4277, 4667, 4805, 5430, 5579, 5674, 6169, 6984, 8214, 8459, 9209, 9843, 10188, 10965, 11292, 12347, 12843, 13424, 14281, 14739, 15374]","[0, 244, 527, 899, 1232, 1796, 2339, 3007, 3414, 3700, 4011, 4382, 4969, 5711, 6420, 6978, 7685, 7830, 8688, 9942, 10711, 11100, 11982, 12554, 13764, 14580, 15250, 16326, 16422, 16924]","[0, 239, 442, 742, 1045, 1292, 1536, 1978, 2141, 2571, 2881, 3007, 3116, 3609, 3784, 4373, 4859, 5489, 5601, 6141, 6434, 6604, 7452, 8437, 9134, 9685, 10220, 11425, 11596, 11927]","[0, 169, 259, 382, 680, 923, 1127, 1462, 1767, 2049, 2366, 2921, 3189, 3519, 3684, 3953, 4635, 5191, 5286, 6422, 6592, 6958, 7810, 8411, 9108, 9659, 10790, 11469, 11640, 11977]","[0, 169, 259, 396, 486, 656, 884, 1264, 1433, 1559, 1694, 1895, 2131, 2665, 2805, 2899, 3367, 3613, 3708, 4295, 4390, 4485, 5152, 5321, 5865, 6466, 6635, 7559, 7730, 8023]",15374,16924,11927,11977,8023,25,93,69,86,88,"[0, 407, 745, 1211, 1937, 2377, 2866, 3440, 4092, 4959, 5665, 6174, 7161, 7933, 8386, 9194, 10800, 10895, 12049, 12886, 13532, 14416, 16588, 16682, 17507, 18935, 19283, 20605, 22224, 23096]","[0, 206, 868, 1231, 1733, 2054, 2438, 3122, 3528, 4083, 4690, 5416, 5943, 6552, 6767, 7598, 8365, 9015, 9480, 10178, 10937, 11962, 12241, 12892, 13307, 14489, 15608, 16158, 18100, 18707]","[0, 291, 535, 714, 1052, 1543, 1751, 2146, 2559, 3055, 3690, 4260, 4686, 5154, 5547, 6084, 6429, 6971, 7630, 8130, 9059, 9616, 10615, 11261, 11780, 12425, 13009, 13299, 13865, 14383]","[0, 169, 304, 428, 558, 741, 831, 1047, 1350, 1892, 2148, 2511, 2905, 3054, 3431, 3647, 3895, 4325, 4762, 5118, 5374, 5626, 6251, 6453, 6639, 6958, 7474, 8138, 8745, 9018]","[0, 169, 325, 442, 621, 711, 889, 1089, 1324, 1433, 1745, 1835, 2149, 2541, 2670, 2798, 3182, 3277, 3681, 3917, 4138, 4279, 5222, 5666, 5852, 6214, 6398, 6493, 6809, 6997]",23096,18707,14383,9018,6997,-7722,-1783,-2456,2959,1026,-7976,30,dire
7584695605,48,17,53,96,5,"[0, 255, 537, 922, 1340, 1778, 2288, 2729, 3230, 3602, 4113, 4682, 5366, 6275, 6844, 7342, 8188, 9388, 10338, 11212, 11660, 12595, 14071, 15311, 16389, 17204, 17299, 18717, 19857, 20493]","[0, 169, 453, 773, 1179, 1598, 1993, 2165, 2634, 3018, 3520, 4137, 4580, 5176, 5540, 5843, 6631, 7695, 8380, 9305, 9798, 10260, 10816, 11165, 12325, 12808, 13499, 14415, 15033, 15483]","[0, 352, 529, 639, 1184, 1274, 1484, 1608, 2002, 2294, 2460, 2721, 2935, 3383, 3796, 4005, 4465, 4969, 5439, 6092, 6530, 6652, 7330, 7553, 8468, 9386, 9725, 10813, 11340, 12306]","[0, 164, 480, 679, 1014, 1337, 1668, 2061, 2510, 3156, 3690, 4410, 5118, 5624, 5980, 6397, 6797, 7233, 7768, 8523, 9025, 9531, 9861, 10066, 10858, 11183, 11278, 12206, 12840, 13466]","[0, 219, 313, 498, 805, 1001, 1360, 1450, 1584, 2026, 2116, 2331, 2428, 2915, 3169, 3378, 3699, 3990, 4196, 4527, 5096, 5190, 5474, 5723, 6241, 6517, 6673, 6973, 7521, 7617]",20493,15483,12306,13466,7617,73,49,98,9,79,"[0, 330, 534, 807, 1230, 1675, 2035, 2491, 3123, 3962, 4729, 5414, 6428, 7073, 7743, 9336, 10571, 11230, 12342, 13372, 14380, 15119, 16131, 17150, 17507, 18031, 19305, 19929, 20382, 20744]","[0, 318, 653, 1027, 1445, 1940, 2417, 3027, 3516, 3881, 4401, 4783, 5402, 5795, 6197, 6672, 7346, 7529, 7998, 8483, 9124, 9485, 10015, 10679, 11223, 11768, 12100, 12586, 13056, 13904]","[0, 684, 1004, 1335, 1494, 1750, 2104, 2362, 2705, 2939, 3587, 4109, 4748, 5085, 5600, 6396, 7407, 8110, 8726, 9524, 9982, 10521, 11061, 11325, 11944, 13026, 13313, 13645, 14161, 14701]","[0, 408, 546, 722, 890, 1076, 1166, 1346, 1481, 1751, 1970, 2188, 2828, 3332, 3650, 4903, 5506, 5697, 6019, 6590, 6685, 6850, 7455, 7749, 8240, 8631, 8996, 9503, 9599, 9764]","[0, 263, 353, 443, 533, 736, 826, 1050, 1185, 1709, 1889, 2027, 2207, 2396, 2810, 3318, 3797, 3892, 4304, 4911, 5207, 5707, 5922, 6282, 6664, 7255, 7542, 7637, 7844, 7940]",20744,13904,14701,9764,7940,-251,1579,-2395,3702,-323,2312,30,radiant
7584866405,73,98,45,14,86,"[0, 377, 867, 1184, 1710, 2155, 2667, 2948, 3198, 3635, 4375, 4822, 5493, 6603, 7274, 8717, 9803, 11507, 13249, 14607, 15458, 17284, 18326, 19819, 21472, 22316, 24158, 25183, 27545, 28538]","[0, 707, 943, 1398, 2055, 2387, 2884, 3302, 3718, 3808, 4103, 4391, 4481, 5105, 5314, 5609, 6470, 7580, 8934, 9449, 9667, 10440, 10776, 11477, 12274, 12915, 13577, 13920, 15738, 16628]","[0, 370, 565, 790, 1174, 1370, 1765, 1935, 2154, 2383, 2621, 2909, 3049, 3521, 3715, 3974, 4344, 5031, 5621, 5816, 6043, 6723, 7059, 7600, 8001, 8486, 8928, 9389, 9843, 10391]","[0, 303, 704, 912, 1108, 1506, 1695, 2151, 2570, 2940, 3396, 3486, 3737, 4234, 4666, 4857, 5349, 5551, 6316, 6708, 6885, 7065, 7592, 8397, 8819, 8914, 9186, 9381, 9587, 10250]","[0, 232, 322, 500, 704, 842, 932, 1105, 1195, 1392, 1630, 1720, 2100, 2393, 2626, 3031, 3352, 3720, 4240, 4789, 4966, 5061, 5502, 5673, 5984, 6079, 6927, 7122, 7680, 8048]",28538,16628,10391,10250,8048,75,106,137,20,91,"[0, 245, 754, 1072, 1444, 1806, 2291, 2630, 2958, 3585, 3962, 4122, 4764, 5524, 6319, 6841, 7305, 8498, 8836, 9479, 10569, 10951, 11342, 12054, 12953, 13818, 14745, 16080, 16695, 17138]","[0, 282, 452, 759, 1120, 1450, 1614, 2118, 2330, 2871, 3474, 3814, 4317, 5099, 5544, 6277, 6655, 7044, 7347, 8008, 8356, 8820, 9381, 9931, 10283, 10642, 11127, 11385, 11771, 12446]","[0, 169, 452, 788, 1156, 1402, 1777, 2161, 2602, 3308, 3764, 4389, 4651, 5455, 5805, 6330, 6919, 7507, 7803, 8098, 8619, 8953, 9398, 9963, 10315, 10965, 11679, 12301, 12924, 13068]","[0, 169, 400, 536, 666, 829, 1069, 1618, 2016, 2430, 2830, 3041, 3355, 3880, 4236, 4470, 4885, 5273, 5368, 5733, 6185, 6542, 6672, 6766, 7118, 7458, 7943, 8037, 8133, 8437]","[0, 169, 366, 456, 857, 947, 1121, 1654, 1897, 2448, 2583, 2743, 3005, 3673, 3996, 4191, 4705, 4982, 5338, 5533, 6000, 6216, 6311, 6452, 6804, 7155, 7640, 8002, 8388, 8484]",17138,12446,13068,8437,8484,11400,4182,-2677,1813,-436,14282,30,dire
7585578410,48,137,126,53,121,"[0, 244, 460, 1000, 1359, 1641, 1856, 2433, 2876, 3217, 3733, 4262, 4952, 5935, 7192, 7924, 8890, 9881, 10306, 11007, 11902, 12377, 13284, 13979, 14972, 15610, 16559, 17513, 18418, 18595]","[0, 284, 424, 1327, 1546, 1834, 2247, 2732, 3401, 3539, 4186, 4916, 5274, 5985, 6696, 7316, 7573, 8090, 8605, 9459, 10082, 10212, 11010, 11104, 11693, 12143, 12706, 13226, 13526, 13703]","[0, 283, 411, 744, 951, 1364, 1715, 2094, 2599, 2900, 3481, 4282, 4408, 5313, 5809, 5903, 6712, 7705, 8199, 8799, 9284, 9628, 10556, 10723, 11238, 12055, 12752, 13362, 13817, 14472]","[0, 310, 400, 823, 958, 1185, 1275, 1766, 2406, 2624, 3460, 4022, 4549, 5269, 5857, 6249, 6430, 6780, 7358, 7730, 8236, 8857, 9553, 10065, 10888, 11258, 11759, 12878, 13685, 14900]","[0, 210, 352, 515, 626, 756, 846, 1108, 1198, 1288, 1468, 1774, 2048, 2622, 3017, 3148, 3264, 3753, 4082, 4606, 4844, 4939, 5340, 5434, 5963, 6166, 6775, 7577, 7855, 8087]",18595,13703,14472,14900,8087,10,135,74,20,26,"[0, 166, 490, 874, 1215, 1581, 1971, 2454, 2936, 3492, 3809, 4111, 4742, 5353, 6191, 7119, 7826, 8669, 9438, 10656, 12590, 13185, 14158, 15279, 16180, 17239, 17964, 18950, 19502, 20756]","[0, 244, 562, 992, 1389, 1871, 2336, 2719, 3484, 3781, 4243, 4662, 5168, 5435, 6582, 7062, 7967, 8525, 9177, 10130, 11072, 11555, 11856, 12448, 12943, 13756, 14279, 14484, 15163, 16742]","[0, 292, 619, 962, 1260, 1587, 1871, 2298, 2447, 2943, 3116, 3216, 3536, 3717, 4480, 4874, 5579, 6096, 6191, 6518, 6720, 7195, 7983, 8866, 9260, 9735, 10334, 11173, 11590, 12492]","[0, 130, 254, 344, 517, 626, 1008, 1098, 1449, 1875, 2085, 2211, 2301, 2434, 2868, 3087, 3455, 3597, 3947, 4363, 4862, 4957, 5227, 5438, 5770, 6082, 6176, 6425, 6729, 7430]","[0, 130, 220, 456, 595, 733, 1148, 1238, 1411, 1664, 1886, 1976, 2160, 2255, 2574, 3008, 3437, 3592, 3747, 4165, 4781, 4876, 5282, 5483, 5796, 6125, 6281, 6622, 6718, 7539]",20756,16742,12492,7430,7539,-2161,-3039,1980,7470,548,4798,30,radiant
7585844612,106,114,14,86,5,"[0, 413, 871, 1297, 1821, 2207, 2680, 3249, 3754, 4267, 5028, 5556, 6293, 7263, 7965, 8568, 9818, 10048, 11136, 11756, 12602, 13436, 14040, 14792, 15577, 16308, 17928, 18825, 20397, 21069]","[0, 339, 658, 1038, 1411, 1737, 2185, 2604, 3123, 3447, 4442, 4798, 5980, 6629, 6964, 7539, 8232, 9474, 10721, 11741, 12510, 14056, 14683, 15952, 16134, 16653, 16748, 16932, 17993, 19197]","[0, 256, 660, 1006, 1431, 1850, 2181, 2717, 3216, 3927, 4436, 4692, 5219, 5744, 5875, 6207, 6781, 7030, 7744, 8198, 8496, 8812, 9578, 10229, 10761, 11931, 12239, 12666, 13338, 13655]","[0, 299, 389, 543, 677, 831, 921, 1044, 1178, 1483, 2103, 2396, 3059, 3435, 3813, 4169, 4604, 5168, 5608, 6109, 6549, 6678, 6896, 7365, 7692, 8192, 8761, 9272, 10131, 10330]","[0, 219, 309, 466, 603, 693, 783, 873, 1008, 1170, 1543, 1671, 2039, 2155, 2250, 2345, 2903, 3183, 3458, 3946, 4157, 4502, 4597, 4751, 5185, 5672, 5842, 6647, 7399, 7759]",21069,19197,13655,10330,7759,48,17,18,72,83,"[0, 330, 688, 1058, 1502, 1995, 2598, 3251, 3745, 4239, 4993, 5802, 6513, 7170, 8286, 9106, 10272, 10925, 12154, 12967, 13949, 14761, 15695, 16649, 17488, 18623, 19727, 20744, 21790, 21967]","[0, 330, 884, 1283, 1738, 2323, 2904, 3422, 3938, 4416, 5083, 5843, 6216, 6736, 7793, 8486, 9098, 9766, 10436, 10770, 11214, 12246, 13760, 14558, 16211, 16724, 17590, 18304, 19321, 20471]","[0, 281, 488, 919, 1198, 1607, 1944, 2524, 2979, 3406, 3990, 4510, 4878, 5274, 5660, 6193, 7189, 7819, 8218, 8524, 8706, 9378, 10194, 10678, 11865, 12032, 13231, 13406, 13990, 14167]","[0, 214, 341, 478, 608, 712, 1008, 1205, 1340, 1458, 1703, 2044, 2544, 2850, 3366, 3554, 3937, 4258, 4353, 4895, 5382, 5577, 5816, 6100, 6623, 6892, 7339, 7558, 7970, 8147]","[0, 169, 259, 349, 532, 669, 848, 1028, 1204, 1369, 1641, 1778, 1981, 2361, 2668, 3081, 3457, 3552, 3682, 3888, 4020, 4215, 4454, 4662, 4847, 5014, 5474, 5649, 6103, 6280]",21967,20471,14167,8147,6280,-898,-1274,-512,2183,1479,978,30,dire
7585988215,93,74,96,40,21,"[0, 281, 558, 1533, 1846, 2176, 2553, 3077, 3649, 4377, 4941, 5773, 6035, 6818, 7378, 8244, 9352, 9811, 10648, 11490, 12179, 13424, 14266, 15132, 15707, 16142, 16562, 17238, 18506, 18889]","[0, 210, 373, 653, 1011, 1384, 1747, 1968, 2371, 2876, 3295, 3694, 3802, 4509, 4945, 5445, 6173, 6990, 7570, 7911, 8456, 9135, 10096, 10970, 11618, 12577, 12671, 13219, 14245, 14811]","[0, 210, 385, 865, 1195, 1520, 2026, 2498, 3078, 3584, 4283, 4752, 5349, 6030, 6533, 7026, 7838, 8555, 9068, 9372, 9652, 9947, 10535, 11155, 11821, 12254, 12859, 14054, 15194, 15290]","[0, 210, 300, 695, 822, 1015, 1152, 1517, 1905, 2078, 2397, 2541, 2631, 3314, 3547, 3989, 4392, 4763, 5228, 5416, 5907, 6476, 7029, 7580, 7964, 8131, 8554, 9016, 10696, 11077]","[100, 310, 400, 768, 858, 1033, 1251, 1551, 1731, 2178, 2413, 2557, 2714, 3425, 3657, 4265, 4881, 5170, 5532, 5835, 6177, 6455, 6766, 7896, 8307, 8546, 8833, 9230, 10179, 10659]",18889,14811,15290,11077,10659,61,70,49,53,79,"[0, 284, 600, 971, 1387, 1585, 2087, 2468, 2850, 3225, 3495, 3959, 5135, 5426, 5997, 6591, 6787, 7351, 7955, 8751, 10422, 10978, 11471, 12294, 12790, 13554, 13935, 14107, 14203, 14930]","[0, 258, 455, 740, 946, 1274, 1668, 1811, 2283, 2635, 2740, 3000, 3489, 3983, 4296, 4660, 5029, 5927, 6140, 6756, 7566, 8072, 8537, 9077, 10157, 10674, 11622, 12117, 12991, 13087]","[0, 253, 495, 673, 1011, 1135, 1669, 1777, 1957, 2567, 2924, 3222, 4116, 4265, 4632, 4892, 5541, 6220, 6637, 6949, 7366, 7541, 7796, 8080, 9488, 9827, 10280, 10423, 10641, 10737]","[0, 130, 220, 386, 521, 611, 796, 1191, 1674, 1779, 1915, 2069, 2991, 3221, 3316, 3410, 3889, 4192, 4567, 4952, 5760, 6210, 6359, 6768, 7631, 8599, 8693, 8965, 10104, 10322]","[0, 130, 220, 622, 790, 1011, 1101, 1191, 1592, 1682, 1772, 1862, 2534, 2683, 2885, 3068, 3281, 3778, 3920, 4015, 4192, 4491, 4585, 4719, 4982, 5098, 5192, 5457, 5880, 5997]",14930,13087,10737,10322,5997,3959,1724,4553,755,4662,15653,30,radiant
7586016207,16,20,54,69,37,"[0, 165, 510, 886, 1327, 1994, 2447, 2988, 3501, 4480, 5098, 5645, 6511, 7850, 7945, 8462, 9960, 11090, 12609, 13146, 13489, 14123, 14383, 15065, 16200, 16937, 17417, 17960, 18801, 19743]","[0, 287, 731, 1218, 1713, 2199, 2572, 3123, 3550, 3895, 4441, 5024, 5114, 6182, 6754, 7235, 7694, 9011, 9733, 10496, 11326, 11623, 12724, 13317, 14117, 14784, 14879, 15449, 16596, 17957]","[0, 202, 471, 829, 1162, 1484, 1741, 2291, 2592, 2720, 3215, 3754, 4298, 5025, 5299, 5683, 6265, 6792, 7418, 8064, 8908, 9557, 10409, 11237, 11762, 12512, 13836, 14600, 15805, 16913]","[0, 130, 325, 428, 654, 1225, 1613, 1793, 2012, 2436, 2628, 3405, 3616, 4202, 4621, 5007, 5530, 5883, 6206, 6687, 7136, 7491, 7974, 8680, 9427, 10262, 10566, 10901, 11827, 12935]","[0, 130, 290, 385, 555, 645, 814, 994, 1132, 1350, 1479, 1569, 1686, 2240, 2358, 2556, 2721, 3593, 4064, 4158, 4253, 4348, 4814, 5154, 5609, 5937, 6241, 6542, 6928, 7575]",19743,17957,16913,12935,7575,18,106,96,26,5,"[0, 320, 602, 1012, 1350, 1733, 2186, 2675, 3226, 3520, 4367, 4863, 5596, 6145, 6662, 7601, 8180, 9307, 9999, 11238, 12952, 14069, 15129, 15223, 16304, 17474, 18366, 18853, 19717, 21211]","[0, 329, 741, 1229, 1554, 1971, 2637, 3203, 3789, 4317, 4771, 4992, 6017, 6433, 7363, 8074, 8937, 9805, 10367, 11234, 12855, 13884, 14996, 15519, 16170, 16337, 17465, 18267, 18444, 19613]","[0, 207, 639, 885, 1353, 1642, 2184, 2765, 3226, 4132, 4591, 5311, 5916, 6327, 7353, 7761, 8433, 8815, 9036, 9243, 10056, 10323, 11573, 11773, 12431, 13066, 13496, 13674, 13851, 14534]","[0, 215, 845, 935, 1063, 1202, 1327, 1678, 1768, 2138, 2568, 2658, 2875, 3184, 3459, 4167, 4623, 4860, 5081, 5322, 5962, 6340, 6994, 7088, 7370, 7537, 8154, 8321, 8498, 8838]","[0, 170, 260, 398, 534, 624, 788, 1059, 1193, 1283, 1418, 1508, 1707, 1856, 2005, 2149, 2412, 2646, 2867, 3024, 3319, 3486, 4106, 4200, 4482, 4892, 5140, 5281, 5458, 5554]",21211,19613,14534,8838,5554,-1468,-1656,2379,4097,2021,5373,30,radiant
7586185405,73,39,28,33,100,"[1, 251, 582, 797, 1207, 1642, 2150, 2890, 3627, 4125, 4916, 5699, 6506, 7516, 8154, 9165, 10712, 11331, 13078, 13914, 14761, 15662, 16314, 17233, 18180, 18767, 20277, 21405, 22183, 23558]","[1, 283, 556, 855, 1336, 1547, 1910, 2096, 2495, 3054, 3572, 4055, 4735, 5769, 5991, 6346, 6593, 7047, 7396, 7914, 9200, 9835, 10534, 10916, 11787, 12316, 13007, 13569, 14398, 14604]","[1, 459, 905, 1172, 1547, 1998, 2246, 2706, 3066, 3156, 3995, 4153, 4476, 4983, 5340, 6094, 6894, 7265, 7948, 8593, 9121, 9663, 10210, 10702, 11180, 11454, 11941, 12380, 12987, 13469]","[1, 171, 463, 567, 702, 963, 1310, 1560, 1667, 1841, 2082, 2208, 2351, 2740, 2910, 3146, 3452, 3595, 3982, 4140, 4396, 4675, 5093, 5585, 6125, 6458, 7050, 7408, 7938, 8407]","[1, 256, 416, 506, 690, 920, 1091, 1500, 1709, 1883, 2244, 2540, 2676, 2974, 3225, 3466, 3757, 3852, 4037, 4195, 4451, 4701, 5009, 5239, 5591, 5954, 6378, 6518, 7020, 7226]",23558,14604,13469,8407,7226,113,63,65,58,136,"[1, 274, 520, 810, 1022, 1421, 1651, 1986, 2202, 2471, 2899, 3588, 3696, 4178, 4622, 5012, 6058, 6448, 6936, 7537, 7672, 8313, 9166, 9519, 10744, 11517, 12540, 13278, 13534, 14489]","[1, 598, 793, 1275, 1687, 1937, 2358, 2811, 3172, 3827, 4178, 4690, 5050, 5292, 5540, 5853, 6311, 7110, 7703, 8475, 8957, 10339, 11625, 12372, 12920, 13740, 13939, 14844, 15738, 16743]","[1, 209, 645, 888, 1295, 1684, 2347, 2795, 2884, 3174, 3956, 4421, 5008, 5493, 6036, 6599, 7314, 8056, 8628, 9244, 9886, 10895, 11343, 11980, 12608, 13117, 13394, 13685, 14062, 14686]","[1, 239, 480, 669, 799, 1257, 1425, 1810, 1899, 2248, 2372, 2658, 2843, 3090, 3288, 3398, 3750, 4135, 4306, 4540, 4634, 5165, 5687, 5977, 6251, 6418, 6548, 6814, 7020, 7403]","[1, 239, 364, 502, 775, 900, 1035, 1244, 1354, 1934, 2040, 2499, 2661, 3078, 3264, 3359, 3912, 4185, 4629, 4774, 4868, 4963, 5486, 5941, 6383, 6657, 7161, 7351, 7655, 7995]",14489,16743,14686,7403,7995,9069,-2139,-1217,1004,-769,5948,30,radiant
7586617402,109,126,29,21,112,"[0, 318, 560, 1087, 1485, 1720, 2301, 2730, 3142, 3877, 4258, 4845, 5689, 6087, 6181, 6805, 7622, 8412, 9213, 10136, 10660, 11578, 12130, 12669, 13425, 14515, 15350, 16117, 17236, 18330]","[0, 298, 619, 913, 1204, 1402, 1651, 2035, 2497, 3301, 3840, 4235, 4851, 5093, 5711, 6131, 6633, 7125, 7794, 8182, 9124, 10276, 10507, 10849, 11497, 11969, 12732, 13728, 14723, 16186]","[0, 207, 405, 798, 1092, 1384, 1584, 2141, 2400, 2721, 2856, 3017, 3381, 3906, 4228, 4714, 5322, 5788, 6434, 6529, 7230, 7885, 8415, 8698, 8982, 9420, 9761, 10298, 10650, 11318]","[0, 213, 352, 442, 579, 839, 1068, 1275, 1455, 1678, 2227, 2317, 2680, 3077, 3344, 3630, 3950, 4190, 4359, 4887, 5175, 5818, 6060, 6348, 6754, 7192, 7428, 7702, 8005, 8641]","[0, 170, 260, 441, 531, 621, 906, 1008, 1194, 1747, 2030, 2120, 2210, 2649, 2909, 3053, 3211, 3306, 3400, 3647, 3931, 4116, 4282, 4377, 4472, 5305, 5550, 5680, 6017, 6421]",18330,16186,11318,8641,6421,41,25,53,96,20,"[0, 320, 788, 1172, 1596, 1950, 2456, 2828, 3361, 4014, 4663, 5664, 6200, 6829, 7224, 8101, 8851, 9486, 10626, 12390, 13342, 14471, 15024, 16170, 16811, 17806, 19039, 20006, 20483, 21318]","[0, 588, 860, 1107, 1655, 2010, 2440, 2750, 3349, 3796, 4446, 4820, 5013, 5262, 5446, 5984, 6320, 6933, 7292, 8178, 9018, 9563, 10435, 11331, 12075, 13230, 13707, 14111, 14809, 14905]","[0, 268, 614, 741, 837, 1047, 1464, 1989, 2306, 2645, 3014, 3490, 3801, 4728, 5032, 5371, 5818, 6218, 6739, 7634, 8226, 8720, 9380, 10030, 10756, 11289, 12159, 12676, 13462, 14525]","[0, 248, 375, 517, 899, 1109, 1279, 1594, 2057, 2277, 2725, 3203, 3538, 3927, 4240, 4945, 5517, 6223, 6669, 7278, 7822, 7917, 8302, 8953, 9698, 10695, 11450, 11892, 12480, 12664]","[0, 234, 632, 1043, 1179, 1679, 2045, 2289, 2668, 2842, 3222, 3519, 3690, 4203, 4393, 4778, 4970, 5065, 5249, 5810, 6157, 6252, 6418, 6866, 7156, 7840, 8045, 8365, 8711, 9021]",21318,14905,14525,12664,9021,-2988,1281,-3207,-4023,-2600,-11537,30,dire
7586877601,94,43,21,5,100,"[0, 210, 439, 713, 999, 1417, 1870, 2122, 2746, 3219, 4172, 4840, 5339, 5708, 6094, 6690, 7310, 8012, 9210, 9833, 11185, 11644, 13235, 14014, 14438, 14918, 15824, 16780, 17513, 18108]","[0, 337, 582, 956, 1353, 1807, 2243, 2585, 2928, 3510, 4324, 5180, 5615, 6223, 6843, 7272, 8498, 8911, 9776, 10300, 10953, 11313, 12009, 12180, 12752, 12875, 13512, 14647, 15240, 16409]","[0, 293, 512, 823, 1022, 1359, 1718, 2099, 2549, 3358, 3800, 4360, 4920, 5281, 5716, 6061, 6593, 6894, 7573, 8057, 8502, 8987, 9241, 9422, 9964, 10495, 10915, 11346, 11967, 12447]","[0, 331, 754, 844, 981, 1358, 1578, 1687, 2237, 2372, 2932, 3437, 3665, 3904, 4213, 4308, 5150, 5324, 5622, 5717, 5922, 6017, 6251, 6582, 6713, 6907, 7001, 7467, 7698, 8392]","[0, 210, 300, 470, 597, 727, 937, 1078, 1168, 1384, 1781, 2007, 2332, 2571, 2750, 3003, 3342, 3497, 3795, 4042, 4440, 4785, 5027, 5137, 5251, 5372, 5466, 6158, 6380, 6683]",18108,16409,12447,8392,6683,95,39,28,58,20,"[0, 130, 520, 811, 1258, 1455, 2449, 2903, 3465, 4179, 4771, 5383, 6366, 7635, 8452, 9237, 9475, 10305, 10843, 11149, 11576, 12466, 13439, 14592, 15321, 16080, 17007, 17596, 18405, 19238]","[0, 205, 455, 907, 1197, 1532, 2001, 2476, 3067, 3359, 3449, 4135, 4611, 5190, 5708, 6450, 6869, 7483, 8305, 8958, 9571, 10287, 11340, 11929, 12370, 12799, 13386, 13578, 13926, 15163]","[0, 206, 539, 951, 1222, 1417, 1544, 1974, 2143, 2516, 2640, 2820, 3381, 4044, 4273, 5000, 5535, 6073, 6446, 6934, 7290, 7710, 8470, 9204, 9525, 10674, 10999, 11751, 12099, 12751]","[0, 130, 220, 345, 435, 762, 852, 1226, 1361, 1451, 1624, 1855, 1945, 2663, 2892, 3461, 3619, 4171, 4547, 5085, 5391, 5937, 6175, 6699, 7023, 7607, 8081, 8399, 8879, 9801]","[0, 130, 438, 563, 653, 757, 1069, 1354, 1533, 1751, 1841, 2083, 2319, 2924, 3153, 3392, 3678, 3964, 4149, 4579, 4853, 4948, 5417, 5739, 5969, 6416, 6845, 7238, 7676, 8357]",19238,15163,12751,9801,8357,-1130,1246,-304,-1409,-1674,-3271,30,dire
7587043018,2,74,42,123,86,"[0, 275, 564, 954, 1477, 1816, 2546, 3013, 3486, 4152, 5170, 5830, 6484, 6998, 8773, 9296, 11172, 12323, 13384, 14196, 15408, 16040, 16279, 17016, 17677, 18896, 19146, 19240, 19485, 19581]","[0, 330, 589, 824, 1196, 1607, 2053, 2414, 2909, 3415, 3892, 4818, 5177, 5882, 6015, 6854, 7732, 8893, 10012, 11279, 12212, 13097, 13336, 13895, 14609, 14976, 15071, 15630, 16835, 17627]","[0, 244, 571, 851, 1166, 1523, 1756, 2215, 2611, 3152, 3340, 3642, 4099, 4329, 4499, 4889, 5519, 6557, 7277, 8042, 8194, 9445, 9848, 10023, 10843, 11821, 12126, 12650, 13444, 14377]","[0, 221, 363, 504, 683, 871, 961, 1135, 1276, 1679, 1769, 1950, 2187, 2321, 2452, 2791, 3858, 4303, 4993, 5498, 6486, 6950, 7189, 7283, 7816, 8312, 8545, 8946, 9740, 10091]","[0, 219, 343, 433, 563, 701, 803, 893, 983, 1290, 1486, 1576, 1893, 2186, 2712, 3061, 3709, 4082, 4546, 5002, 5407, 5801, 6182, 6334, 6429, 7149, 7244, 7572, 7950, 8046]",19581,17627,14377,10091,8046,13,69,8,101,5,"[0, 290, 646, 1057, 1509, 1838, 2251, 2985, 3834, 4350, 4926, 6229, 6809, 7589, 8506, 8937, 9288, 9863, 9958, 10716, 11172, 12714, 14445, 15370, 16460, 17159, 19529, 20144, 21504, 22362]","[0, 329, 653, 981, 1348, 1840, 2811, 3095, 3576, 3943, 4499, 5429, 6149, 6633, 7548, 8515, 9102, 9910, 11148, 11403, 12432, 14183, 15694, 16450, 18835, 19445, 20291, 21671, 22877, 23628]","[0, 328, 649, 1024, 1220, 1779, 2189, 2681, 3223, 3653, 4077, 4744, 5424, 5978, 6399, 6757, 6916, 7213, 7430, 7733, 7861, 8827, 9536, 10379, 11171, 11673, 13125, 13842, 14777, 16031]","[0, 169, 305, 482, 572, 795, 1249, 1339, 1429, 1564, 2193, 2437, 2635, 2775, 3299, 3540, 4193, 4344, 4702, 5017, 5534, 6565, 7409, 7503, 8252, 8347, 9592, 9995, 10638, 11003]","[0, 169, 259, 408, 517, 741, 831, 966, 1056, 1285, 1563, 1886, 2118, 2330, 3409, 3754, 4118, 4213, 4829, 5206, 5300, 5875, 6570, 7061, 7574, 7669, 8199, 8579, 9171, 9657]",22362,23628,16031,11003,9657,-2781,-6001,-1654,-912,-1611,-12959,30,dire
7587097513,102,120,129,58,26,"[0, 206, 478, 727, 1096, 1547, 2067, 2470, 2945, 3319, 3862, 4234, 4672, 5282, 6126, 6495, 7264, 8017, 8646, 9392, 10194, 11018, 11848, 12831, 13922, 14669, 16040, 16913, 18037, 18479]","[0, 315, 652, 1000, 1433, 1845, 2300, 2737, 3174, 3623, 4390, 5047, 5641, 6240, 6882, 7650, 8201, 8743, 9316, 10518, 11060, 11410, 11955, 12642, 13614, 14439, 15108, 15526, 16423, 17060]","[0, 255, 531, 810, 1104, 1314, 1559, 2026, 2447, 2899, 3705, 4090, 5037, 5380, 5690, 6406, 6945, 7666, 8109, 8823, 9561, 9901, 10633, 11278, 11997, 12318, 12988, 13259, 13778, 14502]","[200, 370, 460, 550, 736, 913, 1040, 1130, 1369, 1630, 1900, 2171, 2361, 2547, 2893, 3023, 3180, 3474, 3740, 3977, 4110, 4340, 4970, 5389, 5777, 6188, 6780, 6967, 7395, 7757]","[0, 170, 260, 350, 440, 579, 792, 882, 972, 1062, 1381, 1566, 1822, 2020, 2281, 2546, 2866, 3069, 3520, 3678, 3901, 4159, 4674, 4950, 5338, 5766, 6399, 6493, 6699, 6876]",18479,17060,14502,7757,6876,53,106,19,138,51,"[0, 205, 597, 897, 1147, 1750, 2198, 2478, 3102, 3489, 4137, 4754, 5208, 5754, 6455, 7007, 7668, 8707, 9597, 9824, 10797, 11417, 12389, 13297, 14291, 15073, 15760, 16879, 17918, 18347]","[0, 254, 581, 1032, 1475, 1836, 2209, 2780, 3355, 3565, 4159, 4400, 4833, 5281, 6018, 6350, 7015, 7844, 8156, 8667, 9017, 9711, 10399, 11143, 11999, 12358, 12888, 13288, 13994, 14819]","[0, 255, 454, 1225, 1464, 1753, 2152, 2699, 3104, 3516, 4040, 4288, 4638, 5136, 5231, 5868, 6125, 6782, 7082, 7460, 7621, 8179, 8468, 9081, 9770, 10144, 10591, 10909, 11170, 11444]","[0, 170, 260, 444, 574, 917, 1007, 1167, 1448, 1584, 2029, 2165, 2273, 2667, 2833, 2928, 3406, 3826, 4433, 4622, 5227, 5487, 5680, 5999, 6313, 6480, 6685, 7300, 7647, 7927]","[0, 170, 260, 350, 526, 780, 870, 1098, 1503, 1709, 2052, 2214, 2304, 2591, 2686, 3039, 3161, 3582, 3766, 4036, 4130, 4495, 4590, 4756, 5073, 5240, 5787, 6105, 6201, 6297]",18347,14819,11444,7927,6297,132,2241,3058,-170,579,5840,30,radiant
7587417311,61,10,23,19,84,"[0, 251, 537, 900, 1389, 1834, 2336, 2784, 3302, 3713, 4196, 4762, 5380, 6200, 7149, 7522, 8053, 8588, 9303, 10277, 11074, 11685, 12849, 13137, 13620, 14743, 15619, 15714, 15810, 15978]","[0, 253, 688, 1139, 1546, 1927, 2417, 3044, 3562, 3958, 4422, 4876, 5703, 6167, 6734, 7254, 7945, 8505, 8675, 9297, 9535, 9859, 10661, 11721, 12185, 13477, 13673, 14371, 14517, 15018]","[0, 292, 615, 928, 1363, 1880, 2434, 3192, 3664, 4052, 4806, 5271, 5361, 6073, 6529, 6658, 6919, 7224, 7562, 7657, 8871, 9596, 10469, 10966, 11537, 12105, 12932, 13562, 14392, 14488]","[0, 207, 314, 434, 569, 751, 935, 1153, 1436, 1526, 1740, 1918, 2008, 2556, 2927, 3181, 3359, 3867, 4093, 4311, 5364, 5585, 5958, 6670, 6837, 7927, 8154, 8551, 9202, 9854]","[0, 169, 259, 379, 469, 604, 760, 994, 1174, 1264, 1836, 1926, 2287, 2603, 2787, 2882, 2977, 3121, 3215, 3395, 3719, 3814, 4018, 4190, 4469, 5233, 5415, 5761, 6167, 6536]",15978,15018,14488,9854,6536,48,106,21,5,88,"[0, 327, 753, 1148, 1669, 2093, 2690, 3302, 3916, 4546, 5184, 6058, 6782, 7542, 8333, 9055, 10226, 11214, 12169, 13292, 14209, 14993, 16355, 17427, 18574, 19858, 21359, 22286, 24086, 25817]","[0, 329, 724, 1217, 1541, 2050, 2685, 3331, 3914, 4551, 5191, 5643, 6537, 7077, 8087, 8773, 9816, 10676, 11413, 12510, 13174, 13621, 14509, 15819, 16373, 16952, 17835, 18751, 19991, 20996]","[0, 242, 592, 940, 1270, 1829, 2281, 2679, 3128, 3580, 4191, 4696, 5005, 5803, 6314, 6744, 7665, 8005, 8750, 9296, 9391, 10214, 10801, 10968, 11628, 11935, 12711, 12806, 13792, 14178]","[0, 169, 284, 374, 513, 603, 776, 1273, 1363, 1453, 1603, 1813, 2243, 2801, 2985, 3245, 3576, 3671, 3914, 4156, 4731, 5163, 5513, 5798, 6429, 6755, 8000, 8502, 9161, 9821]","[0, 208, 368, 480, 570, 707, 886, 976, 1110, 1248, 1514, 1794, 2394, 3033, 3417, 3844, 4175, 4418, 4797, 5051, 5714, 5881, 6111, 6305, 6609, 6935, 7742, 7963, 8932, 9744]",25817,20996,14178,9821,9744,-9839,-5978,310,33,-3208,-18682,30,dire
7587585409,53,48,104,33,5,"[0, 327, 686, 1030, 1439, 1971, 2653, 3153, 3403, 3826, 4230, 4725, 5717, 6202, 7002, 7442, 8472, 8672, 9213, 10506, 11516, 12449, 13648, 14816, 16193, 16288, 17552, 17871, 19917, 22342]","[0, 242, 575, 996, 1421, 1872, 2500, 3035, 3681, 4402, 5088, 5952, 6590, 7310, 7774, 7869, 8536, 9405, 10547, 11104, 11905, 12907, 14289, 15416, 16130, 17829, 18666, 18965, 19999, 20769]","[0, 278, 733, 1106, 1640, 1937, 2513, 3028, 3490, 3935, 4505, 5112, 5399, 6019, 6554, 7026, 7725, 7819, 8188, 9410, 9784, 10163, 10907, 11524, 12722, 12951, 13567, 14176, 16090, 17104]","[0, 170, 260, 350, 533, 623, 807, 1069, 1378, 1650, 2057, 2411, 2788, 3281, 3635, 4063, 4555, 5083, 5475, 6213, 6797, 7334, 7907, 8477, 9130, 9697, 10802, 11494, 12747, 13396]","[0, 170, 279, 414, 551, 1006, 1217, 1354, 1489, 1579, 1830, 1974, 2183, 2503, 2777, 2872, 3030, 3285, 3427, 3963, 4140, 4324, 4477, 4772, 5240, 5614, 6230, 6325, 7606, 7983]",22342,20769,17104,13396,7983,73,22,2,84,74,"[0, 297, 725, 1223, 1696, 2254, 2975, 3560, 4771, 5433, 6441, 7205, 8735, 9779, 11200, 12057, 13624, 14768, 16275, 16973, 18033, 19278, 20858, 21034, 21649, 22104, 23886, 23981, 25301, 25753]","[0, 249, 580, 989, 1496, 2089, 2669, 2966, 3708, 4281, 4711, 5076, 5567, 6105, 6446, 6988, 7600, 9498, 9862, 11239, 11863, 13171, 14365, 15331, 16730, 17501, 17837, 18686, 19384, 19480]","[0, 202, 446, 862, 1107, 1613, 2137, 2654, 3225, 3723, 4285, 4539, 5181, 5713, 6074, 6323, 7095, 7738, 8266, 8719, 9495, 9842, 10466, 11008, 11664, 12077, 12842, 13129, 13604, 13700]","[0, 130, 220, 310, 448, 538, 721, 831, 1006, 1157, 1292, 1537, 1990, 2133, 2505, 3035, 3521, 4081, 4692, 5282, 5606, 5818, 6377, 6844, 6938, 7105, 8453, 9207, 10154, 10601]","[0, 130, 220, 357, 447, 537, 717, 807, 942, 1152, 1571, 1910, 2217, 2600, 2895, 3354, 3668, 4299, 4521, 4679, 5021, 5205, 5638, 5733, 6612, 7072, 8046, 8141, 8612, 8902]",25753,19480,13700,10601,8902,-3411,1289,3404,2795,-919,3158,30,radiant
7588356005,138,21,76,83,84,"[0, 265, 586, 863, 1188, 1643, 2016, 2354, 2845, 3551, 3938, 4406, 5092, 5442, 6052, 6592, 7055, 7832, 8327, 9086, 9460, 9827, 10501, 11496, 12202, 12756, 13622, 13909, 14513, 16444]","[0, 616, 830, 1156, 1280, 1528, 1683, 1967, 2356, 2653, 2896, 3377, 3788, 4269, 4613, 5075, 5169, 5900, 6192, 6557, 6651, 6960, 7669, 8051, 8772, 9070, 9210, 9372, 9587, 10287]","[0, 302, 465, 626, 915, 1238, 1411, 1610, 1821, 2125, 2511, 2779, 2959, 3228, 3639, 4114, 4390, 5465, 5824, 6372, 6627, 6722, 7391, 7800, 8182, 8708, 9098, 9192, 9574, 10242]","[0, 226, 316, 610, 700, 1172, 1601, 1711, 2086, 2377, 3308, 3481, 3571, 3719, 4292, 4511, 4605, 4917, 5330, 5619, 5751, 6065, 6429, 6714, 7359, 7669, 8052, 8146, 8243, 8805]","[0, 226, 316, 493, 583, 713, 803, 893, 983, 1145, 1235, 1575, 2003, 2200, 2420, 2618, 2712, 3085, 3233, 3425, 3570, 3665, 4012, 4212, 4450, 4974, 5118, 5212, 5572, 6134]",16444,10287,10242,8805,6134,35,95,15,123,75,"[0, 284, 536, 774, 1147, 1561, 1940, 2586, 3333, 3591, 4699, 4789, 5456, 6363, 6698, 7828, 8615, 9254, 9799, 10242, 10901, 11448, 12362, 12973, 13964, 14491, 15148, 15645, 16655, 17495]","[0, 257, 616, 1187, 1567, 1790, 2587, 2909, 3692, 4067, 4702, 5590, 6224, 6536, 7206, 7938, 8738, 9331, 10053, 10811, 12072, 12698, 13587, 14409, 15249, 15857, 16203, 16762, 17291, 17906]","[0, 252, 463, 734, 923, 1359, 1576, 1945, 2237, 2493, 3037, 3833, 4142, 4768, 5311, 5802, 6610, 6808, 7564, 8098, 8701, 9204, 9879, 10309, 10839, 11588, 12105, 12662, 13334, 13547]","[0, 170, 260, 401, 491, 632, 722, 984, 1156, 1337, 1775, 1995, 2330, 2681, 3321, 3540, 4104, 4690, 5183, 5278, 5731, 6395, 6777, 7047, 7450, 7725, 8148, 8972, 9597, 10198]","[0, 170, 260, 489, 643, 773, 1025, 1240, 1491, 1581, 2307, 2682, 2862, 3201, 3386, 4001, 4645, 4860, 5186, 5500, 6065, 6270, 6761, 7233, 7794, 7961, 8230, 8479, 8882, 9856]",17495,17906,13547,10198,9856,-1051,-7619,-3305,-1393,-3722,-17090,30,dire
7588454903,1,69,80,123,112,"[0, 240, 508, 710, 1125, 1449, 1753, 2044, 2211, 2465, 3285, 4136, 4555, 5328, 5834, 6209, 7385, 8161, 8978, 9958, 10941, 11583, 12005, 12771, 13588, 14622, 15259, 16547, 18423, 19342]","[0, 324, 684, 1056, 1492, 1945, 2336, 2767, 3348, 3777, 3985, 4422, 4911, 5394, 5932, 6185, 6810, 7647, 8066, 9030, 9760, 10429, 11399, 11596, 12238, 13085, 13868, 14428, 15769, 16417]","[0, 279, 526, 899, 1309, 1791, 2162, 2780, 3149, 3581, 3927, 4295, 4813, 5404, 5879, 6434, 7073, 7904, 8583, 9553, 10387, 10557, 10892, 10986, 11749, 12348, 13090, 13871, 14970, 15623]","[0, 170, 285, 471, 607, 697, 804, 1315, 1657, 1837, 2235, 2610, 2748, 2978, 3263, 3787, 4262, 4564, 4949, 5494, 5865, 6065, 6308, 6620, 7296, 8158, 8467, 8664, 9558, 10590]","[0, 170, 334, 424, 609, 743, 833, 1013, 1103, 1464, 2194, 2452, 2586, 2865, 3036, 3130, 3494, 3589, 3979, 4587, 5291, 5486, 5718, 6145, 6715, 7250, 8205, 8784, 9757, 10583]",19342,16417,15623,10590,10583,94,90,136,58,91,"[0, 279, 535, 738, 973, 1482, 1847, 2339, 2765, 3198, 3668, 4436, 4896, 6041, 6639, 7316, 8200, 8710, 9482, 10668, 11667, 12409, 13275, 14207, 14776, 15759, 16656, 17601, 18027, 18549]","[0, 440, 694, 902, 1162, 1514, 2051, 2460, 3246, 3630, 4277, 4822, 5400, 5886, 6519, 6825, 7394, 7772, 8347, 8604, 8897, 9934, 10361, 11013, 11829, 12294, 12818, 13022, 13167, 13599]","[0, 537, 1003, 1291, 1646, 1947, 2242, 2724, 3076, 3557, 3647, 4061, 4637, 5068, 5687, 6460, 6706, 7207, 7354, 7741, 8400, 9202, 9407, 9808, 10171, 10681, 10886, 11159, 11255, 12225]","[0, 232, 322, 412, 502, 716, 806, 1145, 1280, 1435, 1611, 1735, 1982, 2515, 2811, 3222, 3404, 3672, 4111, 4870, 5145, 5616, 6598, 6692, 7187, 8391, 8645, 8849, 9077, 9570]","[0, 269, 558, 695, 832, 968, 1058, 1234, 1373, 1597, 1826, 1916, 2054, 2546, 2736, 3118, 3330, 3425, 3540, 3731, 3916, 4337, 4576, 4868, 5170, 5684, 5889, 6093, 6236, 6332]",18549,13599,12225,9570,6332,793,2818,3398,1020,4251,12280,30,radiant
7588655005,94,96,106,123,112,"[0, 289, 647, 936, 1334, 1748, 2028, 2505, 2985, 3422, 3884, 4345, 4882, 5476, 5749, 6617, 7310, 8232, 9271, 10610, 11038, 12192, 13016, 13305, 13915, 14825, 15904, 16569, 17761, 19566]","[0, 277, 519, 939, 1312, 1654, 1977, 2402, 2845, 3197, 4376, 5133, 5650, 6225, 7102, 7685, 8098, 8301, 8729, 9217, 9827, 10189, 10886, 11343, 12001, 12258, 13333, 13789, 14483, 15314]","[0, 322, 650, 922, 1411, 1801, 2152, 2614, 3019, 3468, 3935, 4253, 4704, 5140, 5372, 5585, 6421, 7274, 8420, 8740, 8835, 9277, 10021, 10962, 11633, 11970, 12146, 12240, 12336, 13377]","[0, 170, 260, 398, 553, 927, 1017, 1157, 1632, 1812, 2246, 2912, 3053, 3148, 3243, 3460, 3645, 4263, 4583, 4952, 5129, 5395, 5667, 5908, 6233, 6475, 6726, 7011, 7846, 8529]","[0, 170, 260, 714, 804, 894, 984, 1124, 1329, 1619, 1891, 2246, 2421, 2561, 2911, 3210, 3494, 3893, 3988, 4317, 4678, 4773, 5104, 5679, 5774, 5941, 6819, 6953, 7084, 7710]",19566,15314,13377,8529,7710,120,10,69,33,20,"[0, 295, 458, 824, 1138, 1465, 1849, 2255, 2937, 3442, 3967, 4635, 5218, 5789, 7206, 7592, 8772, 9522, 10259, 11066, 11457, 12194, 12865, 13912, 14694, 15852, 17015, 17292, 18083, 18349]","[0, 170, 440, 763, 1087, 1251, 1852, 2333, 2602, 3011, 3252, 3787, 4181, 4844, 5827, 6369, 7240, 7477, 8009, 9275, 9801, 10572, 11135, 12030, 12449, 13317, 14633, 15847, 16786, 17309]","[0, 242, 482, 1236, 1527, 1813, 2107, 2638, 3201, 3614, 4115, 4821, 5359, 6021, 7389, 7754, 8442, 9046, 9468, 10496, 11133, 11661, 12283, 12972, 13618, 14594, 14925, 15546, 16143, 16582]","[0, 170, 260, 350, 566, 745, 1071, 1243, 1431, 1625, 2140, 2537, 2746, 3406, 3900, 4413, 4908, 5356, 5733, 6499, 7239, 7797, 8319, 9044, 9750, 10403, 10883, 11400, 12102, 12273]","[0, 271, 413, 658, 826, 956, 1277, 1456, 1671, 1933, 2398, 2627, 2762, 3158, 3563, 3831, 4249, 4792, 5075, 5379, 5657, 6106, 6456, 6758, 7126, 7666, 8121, 8858, 9601, 9886]",18349,17309,16582,12273,9886,1217,-1995,-3205,-3744,-2176,-9903,30,radiant
7588849413,95,60,97,65,91,"[0, 279, 649, 972, 1812, 2379, 2823, 3357, 3954, 4111, 4698, 5175, 5794, 6193, 7055, 8356, 9651, 10014, 10869, 11163, 11551, 12829, 14026, 14789, 15479, 16133, 16912, 17007, 17198, 18477]","[0, 293, 459, 973, 1356, 1741, 2163, 2569, 3078, 3366, 3861, 4252, 4912, 5341, 5872, 6248, 6963, 7565, 8444, 8693, 9038, 10213, 10886, 11475, 11570, 11926, 12424, 13061, 13157, 13749]","[0, 331, 650, 855, 1320, 1680, 2203, 2842, 3296, 3756, 4355, 4854, 5130, 5492, 5677, 6434, 7180, 7369, 8020, 8114, 8966, 9817, 10471, 10975, 11070, 11658, 12054, 12149, 12245, 12782]","[0, 210, 300, 416, 651, 776, 941, 1148, 1355, 1877, 2167, 2540, 3098, 3330, 3613, 3971, 4607, 5208, 5986, 6150, 6600, 7182, 7421, 7959, 8054, 8467, 8561, 8842, 9006, 9394]","[0, 310, 400, 490, 808, 942, 1151, 1241, 1395, 1485, 2020, 2211, 2344, 2576, 2810, 3217, 3411, 3506, 3736, 3830, 3925, 4254, 4519, 4806, 4976, 5146, 5315, 5485, 5717, 5983]",18477,13749,12782,9394,5983,41,22,112,123,102,"[0, 204, 474, 680, 876, 1418, 1808, 1955, 2195, 2659, 3174, 3692, 4051, 4737, 5115, 5804, 6457, 7104, 7672, 9071, 9833, 10710, 11602, 12761, 14367, 15500, 16460, 18040, 18729, 20034]","[0, 293, 614, 1262, 1488, 1905, 2460, 2595, 2981, 3811, 4417, 4755, 5311, 6279, 6774, 6868, 7329, 8201, 8296, 9255, 9912, 10973, 11465, 12110, 12952, 13647, 14438, 15652, 17062, 17886]","[0, 130, 220, 569, 778, 1158, 1455, 1718, 2129, 2617, 2752, 3143, 3651, 4240, 4952, 5441, 5638, 5965, 6179, 6974, 7499, 7855, 8210, 8732, 9639, 10534, 11084, 11719, 12274, 13232]","[0, 130, 265, 619, 799, 975, 1197, 1332, 1422, 1920, 2055, 2195, 2314, 2752, 3120, 3214, 3381, 3718, 3813, 4902, 5426, 5710, 6135, 6592, 7111, 7437, 7791, 8964, 10009, 10719]","[0, 130, 220, 376, 518, 648, 738, 954, 1082, 1272, 1407, 1595, 1780, 2490, 3063, 3187, 3365, 3695, 3792, 4629, 5149, 5457, 5670, 5836, 6257, 6541, 6963, 7889, 8444, 9110]",20034,17886,13232,10719,9110,-1557,-4137,-450,-1325,-3127,-10596,30,dire
7589043306,17,14,43,19,20,"[329, 619, 960, 1288, 1628, 2146, 2620, 3004, 3498, 3913, 4473, 4846, 5372, 5771, 5876, 6012, 6658, 7616, 8918, 9252, 9796, 10266, 10462, 11643, 12290, 12812, 13214, 14710, 14806, 15824]","[61, 340, 853, 1172, 1699, 2026, 2406, 2768, 2903, 3435, 3693, 4003, 4545, 4911, 5042, 5489, 6592, 7293, 7502, 8653, 9224, 9750, 9845, 9939, 11060, 11400, 12123, 12604, 13347, 14094]","[0, 170, 531, 793, 1364, 1699, 1987, 2154, 2497, 3386, 3802, 3976, 4404, 4535, 5130, 5563, 6820, 7561, 8145, 8650, 9638, 10045, 10140, 10447, 10885, 11741, 12228, 13113, 13334, 14069]","[61, 231, 321, 711, 933, 1367, 1457, 1552, 1735, 2018, 2404, 2494, 2584, 2717, 2968, 3154, 3855, 4407, 4845, 5368, 5793, 5888, 5983, 6265, 6711, 6878, 7296, 8176, 8272, 8792]","[61, 231, 389, 568, 739, 929, 1403, 1493, 1628, 2063, 2198, 2288, 2422, 2829, 2924, 3177, 3720, 4151, 4341, 4773, 5198, 5341, 5436, 5709, 6125, 6292, 6433, 6914, 7010, 7364]",15824,14094,14069,8792,7364,42,98,80,72,26,"[0, 285, 642, 964, 1380, 1899, 2180, 2816, 3265, 3727, 4298, 4634, 5369, 5978, 6576, 6950, 7829, 8633, 9660, 10221, 10618, 11634, 12648, 13827, 14510, 15951, 17073, 18400, 19506, 20194]","[0, 454, 859, 1154, 1396, 1988, 2078, 2444, 3077, 3566, 4320, 4957, 5614, 6102, 6662, 7069, 7226, 7839, 9393, 10306, 10583, 11333, 12377, 13639, 14023, 14684, 15523, 16338, 16697, 17633]","[0, 291, 559, 964, 1138, 1418, 1865, 2511, 3022, 3349, 4080, 4615, 5169, 6528, 7089, 7394, 7776, 8219, 8671, 9080, 9765, 10426, 11349, 12405, 13022, 13934, 14699, 15272, 15981, 16731]","[0, 252, 342, 432, 571, 741, 846, 1277, 1810, 1990, 2466, 2643, 2899, 3192, 3879, 4325, 4482, 4735, 5096, 5803, 5898, 6526, 7036, 7959, 8126, 8493, 8882, 9231, 9841, 10007]","[0, 170, 260, 350, 440, 610, 797, 1116, 1206, 1386, 1673, 2145, 2408, 2942, 3411, 3695, 3868, 4207, 4494, 4968, 5229, 5987, 6486, 7208, 7449, 8173, 8452, 8546, 8842, 9020]",20194,17633,16731,10007,9020,-4370,-3539,-2662,-1215,-1656,-13442,30,dire
7589891206,10,61,108,123,20,"[0, 206, 443, 678, 960, 1321, 1805, 2280, 2843, 3183, 3765, 4163, 4814, 5449, 6166, 6675, 7433, 7922, 8805, 9880, 10271, 10678, 11306, 12093, 12902, 14072, 15130, 15848, 16870, 17202]","[0, 164, 456, 896, 1303, 1687, 2257, 2777, 3773, 4621, 5085, 5844, 7041, 8059, 8876, 9278, 9902, 10821, 11079, 11780, 12590, 13417, 14162, 14472, 14766, 15256, 16489, 16583, 17833, 18209]","[0, 167, 367, 776, 1204, 1537, 1815, 2630, 3365, 3612, 3990, 4589, 5216, 6122, 6709, 7417, 8063, 8374, 8875, 9616, 10345, 10869, 11337, 11942, 12432, 12743, 13069, 13498, 14018, 14114]","[0, 129, 219, 309, 512, 769, 871, 1130, 1497, 1769, 2186, 2355, 2658, 3337, 3822, 4048, 4453, 4907, 5112, 5341, 6124, 6444, 6677, 7324, 7703, 8039, 8684, 9342, 9689, 9785]","[100, 229, 363, 463, 604, 734, 984, 1119, 1389, 1575, 1964, 2133, 2313, 2899, 3203, 3343, 3602, 3919, 4182, 4411, 5178, 5428, 5829, 6546, 6766, 7000, 7176, 7270, 7537, 7633]",17202,18209,14114,9785,7633,89,21,90,53,19,"[0, 313, 688, 923, 1137, 1523, 1741, 2083, 2336, 3044, 3565, 3978, 4502, 4681, 5324, 6023, 7131, 7947, 8706, 9634, 10781, 11460, 12398, 13447, 14085, 14346, 16251, 17208, 18367, 19627]","[0, 658, 948, 1165, 1411, 1775, 2326, 2688, 3153, 3569, 4059, 4752, 5193, 5401, 5700, 6338, 6523, 7216, 7640, 8078, 8378, 8864, 10168, 10439, 10733, 11101, 11853, 12683, 12947, 13912]","[0, 328, 606, 941, 1312, 1601, 2159, 2454, 2674, 3006, 3568, 3936, 4312, 4581, 4972, 5412, 6041, 6413, 6859, 7283, 7493, 7739, 8397, 9092, 9515, 9971, 10815, 10999, 11672, 12655]","[0, 268, 358, 466, 684, 857, 1061, 1422, 1557, 1992, 2331, 2523, 2622, 2817, 3066, 3311, 3521, 4434, 5037, 5370, 5605, 6007, 6874, 7320, 7604, 7904, 8820, 9274, 10362, 10858]","[0, 268, 358, 460, 624, 761, 965, 1169, 1388, 1672, 1807, 1951, 2041, 2136, 2231, 2615, 2995, 3379, 3901, 4244, 4339, 4562, 5017, 5260, 5450, 5617, 6261, 6547, 6990, 7486]",19627,13912,12655,10858,7486,-2425,4297,1459,-1073,147,2405,30,radiant
7590250603,48,53,47,123,137,"[0, 256, 585, 1036, 1363, 1632, 1942, 2544, 2996, 3398, 4169, 4706, 5746, 6498, 7254, 7973, 8961, 9925, 10577, 11471, 11760, 12123, 12673, 13323, 13939, 14501, 15138, 16455, 17702, 18431]","[0, 170, 260, 434, 524, 663, 753, 1073, 1281, 1544, 2155, 2617, 3277, 3735, 4025, 4574, 5479, 6138, 6423, 7578, 7921, 8108, 8482, 8901, 10226, 10570, 10664, 11015, 11598, 12039]","[0, 252, 494, 829, 1201, 1500, 1907, 2521, 2947, 3209, 3538, 3988, 4078, 4588, 5054, 5474, 6113, 7268, 7787, 8057, 8664, 8759, 9072, 9385, 9683, 9778, 9872, 10693, 11088, 11464]","[0, 270, 360, 719, 890, 994, 1084, 1264, 1399, 1539, 2280, 2462, 2581, 3045, 3378, 3669, 4241, 4683, 5306, 5589, 5709, 5894, 6605, 6785, 7717, 8020, 8114, 8389, 8748, 9321]","[0, 244, 334, 579, 873, 1099, 1272, 1827, 2191, 2528, 3650, 4005, 4095, 4588, 4736, 4882, 5224, 5583, 5677, 5947, 6364, 6778, 6872, 7133, 7688, 7996, 8127, 8610, 8958, 9144]",18431,12039,11464,9321,9144,49,46,80,27,86,"[0, 273, 521, 1003, 1221, 1921, 2400, 2819, 3193, 4215, 4595, 5139, 5855, 6576, 6899, 7594, 8547, 8642, 9361, 10259, 11201, 11860, 12695, 13597, 14970, 15445, 16257, 16467, 16976, 17677]","[0, 300, 496, 730, 961, 1230, 1544, 1823, 2504, 2806, 3232, 3633, 3723, 4438, 4855, 5285, 6715, 7627, 8258, 9272, 9867, 10714, 11504, 12329, 13532, 14040, 14704, 15384, 15966, 17241]","[0, 280, 599, 867, 992, 1361, 1774, 2070, 2524, 3025, 3422, 4054, 4587, 5080, 5872, 6623, 6906, 7394, 8060, 9522, 10309, 11717, 12254, 13322, 14416, 15325, 16369, 17128, 17341, 18910]","[0, 195, 285, 716, 806, 896, 1112, 1430, 1884, 2136, 2352, 3022, 3293, 4096, 4356, 4451, 4699, 5120, 5347, 6394, 6816, 7337, 8028, 8427, 8597, 9011, 9303, 9756, 10069, 10720]","[0, 195, 285, 471, 611, 929, 1283, 1410, 1840, 2146, 2400, 2596, 2916, 3516, 3838, 4093, 4618, 4957, 5344, 5674, 6651, 7059, 7385, 7727, 8170, 8505, 9009, 9268, 9538, 10534]",17677,17241,18910,10720,10534,754,-5202,-7446,-1399,-1390,-14683,30,dire
7590356016,73,90,106,86,26,"[0, 553, 1016, 1400, 1604, 1932, 2362, 2711, 3305, 3860, 4499, 4874, 5524, 6155, 7154, 8331, 9356, 10092, 10851, 11584, 12685, 14491, 15355, 15996, 17018, 17499, 18477, 19058, 19264, 19560]","[0, 722, 1158, 1488, 1831, 2121, 2539, 3287, 3977, 4529, 5107, 5662, 6286, 6891, 7432, 7841, 8561, 8997, 9417, 9793, 10379, 10874, 11367, 12374, 12988, 13477, 13849, 14172, 14453, 15034]","[0, 416, 795, 1164, 1620, 1911, 2430, 2882, 3305, 3811, 4225, 4723, 4999, 5390, 6174, 6808, 7337, 7929, 8401, 9171, 9844, 10754, 11293, 11507, 12015, 12603, 13265, 13602, 14060, 14951]","[0, 297, 588, 678, 882, 1281, 1460, 1660, 1927, 2062, 2152, 2315, 2563, 2818, 3314, 3644, 4258, 4353, 4448, 4724, 5401, 5757, 6115, 6634, 7069, 7239, 7521, 7758, 8039, 8448]","[0, 297, 387, 486, 583, 711, 941, 1141, 1406, 1733, 1836, 1970, 2286, 2523, 2708, 2803, 3309, 3485, 3727, 4032, 4967, 5344, 5761, 5969, 6269, 6488, 6983, 7177, 7706, 7958]",19560,15034,14951,8448,7958,18,28,43,19,20,"[0, 324, 842, 1180, 1633, 1963, 2251, 2565, 3171, 3767, 4374, 5837, 6497, 7275, 7876, 8354, 8988, 9820, 10608, 11819, 12756, 13077, 15220, 15931, 17101, 17842, 19014, 19795, 21622, 22607]","[0, 395, 725, 1011, 1497, 2021, 2543, 2826, 3346, 3769, 4273, 4916, 5805, 6264, 6636, 6961, 7308, 7869, 8319, 8992, 9191, 9536, 10465, 10853, 11645, 12368, 13100, 13301, 14097, 14702]","[0, 296, 497, 799, 958, 1245, 1614, 1961, 2399, 2731, 3281, 3978, 4290, 4726, 5161, 5698, 6258, 7125, 7364, 8071, 8578, 8835, 9740, 9916, 10410, 11023, 11538, 11750, 12825, 13112]","[0, 239, 329, 509, 682, 807, 970, 1060, 1150, 1375, 1510, 1941, 2329, 2535, 2935, 3160, 3639, 3824, 3919, 4314, 4456, 4982, 5546, 5835, 6031, 6496, 6762, 6972, 7856, 8270]","[0, 372, 555, 739, 829, 988, 1123, 1213, 1303, 1438, 1620, 2149, 2425, 2608, 2703, 2954, 3223, 3529, 3761, 4156, 4250, 4345, 4624, 4909, 5264, 5540, 5716, 5811, 7032, 7319]",22607,14702,13112,8270,7319,-3047,332,1839,178,639,-59,30,dire
7590828718,129,17,95,31,26,"[328, 573, 749, 1188, 1942, 2246, 2481, 3090, 3476, 4170, 4563, 5129, 5472, 6303, 6737, 7316, 8073, 8774, 9519, 10701, 12255, 12549, 13306, 14347, 15294, 16056, 16833, 18301, 18636, 19045]","[0, 294, 663, 1040, 1493, 1847, 2550, 3384, 3685, 4160, 4666, 4850, 5943, 6685, 7218, 7815, 8586, 9366, 10046, 11514, 11986, 12461, 12956, 14430, 14910, 15515, 16534, 17389, 17724, 18129]","[60, 269, 445, 612, 959, 1231, 1403, 1755, 2232, 2785, 3080, 3430, 4198, 4735, 5200, 5567, 6485, 7178, 7859, 8580, 9201, 9762, 10385, 11248, 11758, 12610, 13703, 15884, 16921, 17831]","[60, 230, 357, 447, 537, 627, 1052, 1232, 1491, 1866, 2312, 2436, 3147, 3415, 3633, 3786, 4658, 5006, 5483, 6146, 6351, 6511, 6943, 7931, 8026, 8364, 9003, 9991, 10326, 10776]","[60, 230, 320, 556, 1008, 1098, 1188, 1583, 1673, 1891, 2231, 2415, 3203, 3756, 4125, 4252, 4650, 4962, 5251, 5736, 5941, 6298, 6465, 7071, 7395, 8074, 8169, 8869, 9238, 9334]",19045,18129,17831,10776,9334,63,57,123,2,105,"[0, 170, 468, 723, 971, 1100, 1382, 1561, 2003, 2295, 2732, 3331, 3691, 4086, 4561, 4956, 5722, 6232, 6537, 7237, 7652, 8190, 8672, 9446, 10210, 10304, 10822, 10917, 12180, 12715]","[0, 241, 437, 1009, 1335, 1626, 2091, 2551, 2713, 3060, 3481, 3847, 4150, 4782, 5062, 5327, 5931, 6382, 6956, 7231, 7571, 7863, 8116, 8301, 8914, 9506, 9693, 11595, 11853, 12023]","[0, 216, 355, 625, 759, 1071, 1489, 1625, 1715, 2076, 2346, 2979, 3069, 3478, 3867, 3962, 4291, 4461, 4659, 5181, 5312, 5864, 6344, 6808, 7085, 8096, 8386, 8741, 10679, 11274]","[0, 246, 460, 737, 1021, 1270, 1441, 1727, 2133, 2940, 3303, 3985, 4161, 4513, 4937, 5343, 5582, 5891, 6316, 7064, 7159, 7613, 8131, 8316, 8542, 9015, 9110, 9205, 9463, 9833]","[0, 170, 260, 648, 944, 1034, 1292, 1404, 1494, 1630, 1855, 2218, 2308, 2546, 2730, 2825, 3148, 3243, 3632, 3972, 4326, 4626, 4840, 5025, 5120, 5322, 5718, 5813, 6744, 6977]",12715,12023,11274,9833,6977,6330,6106,6557,943,2357,22293,30,radiant
7591136209,46,106,28,53,5,"[0, 294, 568, 953, 1351, 1679, 2132, 2491, 2994, 3255, 3554, 4076, 4342, 4819, 5234, 5494, 6217, 6927, 7774, 8623, 9807, 10749, 11863, 12657, 13152, 13781, 14953, 15719, 16394, 16574]","[0, 252, 579, 876, 1443, 1950, 2246, 2617, 3240, 3545, 3858, 4188, 4844, 5267, 6069, 6200, 6774, 7219, 8075, 8834, 10215, 10572, 10936, 11956, 12605, 13537, 14324, 14500, 14838, 15572]","[0, 208, 495, 795, 1289, 1692, 1853, 1988, 2408, 2923, 3427, 3842, 4580, 4997, 5635, 6198, 7334, 7700, 8771, 9833, 10968, 11659, 12456, 13405, 14383, 15659, 16738, 17527, 18542, 18799]","[0, 550, 677, 1314, 1720, 1972, 2206, 2386, 2808, 3063, 3325, 3515, 4241, 4665, 5336, 5736, 6486, 6581, 7392, 7815, 8906, 9438, 10106, 10437, 11263, 12000, 12210, 12386, 12482, 12890]","[0, 170, 307, 585, 788, 975, 1416, 1595, 1685, 1775, 1910, 2023, 2446, 2689, 3066, 3253, 3770, 4078, 4801, 5224, 5957, 6052, 6359, 6571, 6860, 7132, 7307, 7483, 7617, 7713]",16574,15572,18799,12890,7713,1,129,90,17,121,"[0, 316, 635, 993, 1360, 1735, 2077, 2574, 3196, 3581, 4345, 4816, 5513, 6005, 6956, 7473, 8269, 9052, 9147, 9367, 10060, 10768, 11660, 12582, 13601, 14448, 15783, 16872, 18498, 20345]","[0, 241, 530, 721, 934, 1260, 1505, 2086, 2502, 2703, 3176, 3666, 4224, 4930, 5834, 6274, 7026, 7315, 7410, 7665, 8172, 8320, 8734, 9912, 10541, 10636, 10919, 11741, 12904, 13899]","[0, 423, 553, 673, 783, 1110, 1314, 1448, 1753, 2330, 2933, 3162, 3460, 4343, 4521, 5125, 5628, 6130, 6707, 7515, 8025, 8558, 9231, 9684, 10789, 11186, 11807, 12702, 13980, 15030]","[0, 291, 657, 1067, 1290, 1380, 2189, 2735, 2955, 3900, 4385, 4643, 5023, 6080, 6260, 7100, 7386, 7825, 8554, 9389, 9484, 9889, 10055, 10671, 10947, 11294, 11997, 12750, 13470, 14291]","[0, 170, 351, 471, 619, 709, 799, 1342, 1432, 1713, 2031, 2180, 2671, 3030, 3125, 3412, 3824, 4319, 4497, 5123, 5507, 5904, 6280, 6499, 7033, 7128, 7607, 7702, 9077, 9873]",20345,13899,15030,14291,9873,-3771,1673,3769,-1401,-2160,-1890,30,dire
7591146603,8,106,102,123,112,"[0, 574, 844, 1168, 1513, 2055, 2418, 3091, 3593, 4175, 4595, 5002, 5720, 6339, 7022, 8188, 8759, 9531, 9903, 10624, 10887, 11914, 13212, 13888, 14461, 15070, 15619, 16689, 17775, 18497]","[0, 319, 646, 897, 1296, 1663, 2031, 2405, 2910, 3409, 4252, 4727, 5430, 6092, 6484, 6775, 7550, 8224, 8748, 9432, 9527, 10160, 10640, 11529, 12209, 12999, 13197, 13732, 14721, 15003]","[0, 368, 539, 880, 1084, 1283, 1409, 1499, 1589, 1972, 2440, 2737, 3040, 3826, 4184, 4568, 4663, 5448, 6236, 6478, 6645, 7134, 7373, 7722, 8360, 8686, 8884, 9633, 10892, 11317]","[0, 210, 300, 506, 596, 906, 996, 1342, 1470, 1711, 2205, 2588, 3594, 3864, 4122, 4812, 4993, 5342, 6046, 6283, 6462, 6578, 7033, 7520, 7991, 8441, 8536, 9319, 9804, 10187]","[0, 271, 379, 469, 606, 774, 909, 1657, 1747, 1985, 2168, 2464, 2680, 3031, 3217, 3636, 3854, 4211, 4830, 5359, 5585, 6072, 6818, 7323, 7713, 7969, 8064, 8629, 9865, 10153]",18497,15003,11317,10187,10153,136,14,137,20,91,"[0, 167, 485, 836, 1331, 1978, 2429, 3132, 3907, 4440, 5060, 5774, 6142, 6495, 7438, 7739, 8613, 9517, 10179, 11765, 12963, 13596, 13864, 14801, 15311, 16554, 17042, 17983, 18690, 19233]","[0, 130, 438, 646, 927, 1179, 1686, 2000, 2313, 3061, 3577, 3896, 4328, 4915, 5505, 6087, 6867, 7484, 7752, 8186, 8940, 9741, 10394, 11113, 11954, 12649, 13112, 13663, 14116, 14553]","[0, 205, 525, 771, 1069, 1475, 2129, 2301, 2773, 3236, 3597, 4089, 4571, 5015, 5387, 6130, 6774, 7780, 8458, 9116, 10001, 10345, 10567, 10751, 11385, 11971, 12403, 12927, 13185, 13824]","[0, 177, 285, 375, 510, 669, 1111, 1246, 1381, 1683, 1858, 2191, 2472, 2767, 3012, 3390, 3548, 3909, 4156, 4978, 5982, 6404, 6779, 6926, 7327, 8055, 8441, 8946, 9204, 9512]","[0, 130, 265, 440, 614, 845, 1026, 1300, 1832, 1967, 2407, 2701, 2890, 2984, 3329, 3459, 3858, 4264, 4501, 4873, 5257, 5469, 5681, 5776, 6006, 6328, 6513, 7095, 7353, 7635]",19233,14553,13824,9512,7635,-736,450,-2507,675,2518,400,30,dire
7592853213,15,93,21,33,19,"[0, 254, 584, 826, 1197, 1528, 1898, 2096, 2559, 2780, 3502, 4535, 4947, 5322, 6003, 6492, 6934, 7798, 8577, 9150, 9794, 10462, 11638, 12356, 12937, 13555, 14585, 15900, 16381, 17693]","[0, 287, 487, 773, 1181, 1394, 1748, 2168, 2591, 3167, 4100, 4650, 5169, 6002, 6327, 7431, 8144, 8789, 9377, 10017, 11058, 11728, 12143, 12496, 13855, 14469, 15533, 16618, 17028, 17314]","[0, 243, 367, 694, 1260, 1633, 2082, 2431, 3218, 3606, 3902, 4524, 4758, 5020, 5375, 5940, 6476, 7359, 8399, 9829, 10981, 11866, 12455, 12797, 13328, 14422, 15818, 16444, 17128, 17817]","[0, 169, 259, 397, 532, 667, 1021, 1148, 1326, 1547, 1955, 2273, 2613, 2762, 2952, 3441, 3607, 4149, 4557, 5534, 5767, 6126, 6398, 6691, 7478, 7956, 8797, 9001, 9389, 9918]","[0, 217, 307, 397, 612, 747, 858, 999, 1177, 1563, 1895, 2315, 2482, 2752, 2981, 3157, 3572, 4428, 4523, 5041, 5493, 5743, 6177, 6316, 6663, 7063, 7712, 7916, 8517, 9234]",17693,17314,17817,9918,9234,4,46,129,72,65,"[0, 169, 756, 1136, 1587, 2011, 2344, 2946, 3267, 3477, 3640, 4223, 4976, 5527, 6002, 7045, 7881, 8685, 9462, 9556, 10378, 10964, 11226, 12217, 12508, 13185, 14249, 14343, 15138, 16996]","[0, 284, 588, 840, 1090, 1330, 1642, 2098, 2607, 3176, 3610, 4488, 5041, 6016, 6565, 7009, 8054, 8491, 9338, 9559, 10074, 10955, 11320, 12048, 12444, 12539, 12907, 13240, 14142, 14292]","[0, 208, 454, 769, 1019, 1419, 1740, 2214, 2576, 2990, 3560, 3955, 4501, 4996, 5614, 6668, 7226, 7480, 7967, 8136, 8400, 8854, 9500, 10114, 10792, 11082, 11593, 12013, 12464, 13242]","[0, 206, 296, 386, 476, 651, 974, 1154, 1272, 1648, 1921, 2246, 2611, 3000, 3248, 3704, 4224, 4670, 5297, 5521, 5853, 6149, 6539, 7718, 7913, 8008, 8265, 8568, 8959, 10142]","[0, 169, 333, 471, 621, 751, 1202, 1467, 1867, 2111, 2519, 2687, 3074, 3317, 3515, 4699, 5182, 5399, 6032, 6290, 6429, 6807, 7086, 7753, 8355, 8501, 8921, 9230, 9579, 10404]",16996,14292,13242,10142,10404,697,3022,4575,-224,-1170,6900,30,radiant
7593018617,82,129,50,79,5,"[0, 204, 441, 836, 1136, 1496, 2064, 2269, 2764, 3467, 4081, 5057, 5526, 6354, 7485, 8192, 9405, 9956, 11067, 12160, 13216, 13772, 14392, 15360, 16715, 17401, 18566, 19564, 19660, 20021]","[0, 291, 576, 821, 1204, 1536, 1991, 2600, 3106, 3604, 4286, 4949, 5396, 5866, 6743, 7333, 7734, 8364, 8788, 9539, 9913, 10777, 11338, 11697, 11967, 12164, 12258, 12645, 12863, 13062]","[0, 244, 497, 787, 1248, 1623, 1981, 2518, 2929, 3276, 3589, 4200, 4756, 5290, 5576, 6080, 6685, 7208, 7882, 8542, 9298, 9724, 10722, 10971, 11361, 11456, 12016, 12111, 12891, 13319]","[0, 170, 260, 350, 490, 620, 710, 845, 935, 1042, 1380, 1705, 2161, 2256, 2507, 2851, 3211, 3503, 3687, 3860, 4335, 4743, 5131, 5373, 5653, 5823, 6653, 7043, 7375, 7546]","[100, 313, 449, 587, 677, 925, 1015, 1185, 1275, 1448, 1846, 2084, 2228, 2323, 2555, 2733, 3214, 3515, 3699, 3857, 4410, 4687, 5037, 5279, 5559, 5729, 5970, 6396, 6567, 6738]",20021,13062,13319,7546,6738,89,49,23,123,9,"[0, 290, 530, 731, 1116, 1553, 1868, 2358, 2716, 3190, 3782, 4407, 5054, 5825, 6302, 6733, 7464, 7622, 8611, 9506, 9873, 10815, 11788, 12817, 13902, 15419, 16700, 16969, 18241, 19319]","[0, 209, 517, 682, 1214, 1625, 1938, 2558, 2935, 3412, 3666, 4090, 4880, 5591, 6404, 6949, 7447, 8374, 8468, 9234, 9881, 10743, 11676, 12298, 12913, 13628, 14435, 15413, 15949, 17008]","[0, 279, 441, 617, 788, 1050, 1253, 1628, 1999, 2477, 2679, 3081, 3462, 4107, 4570, 5173, 5702, 6336, 6586, 7070, 7632, 7784, 8416, 8724, 9345, 10616, 11093, 13060, 13788, 14757]","[0, 218, 406, 496, 717, 1165, 1255, 1545, 1720, 1994, 2248, 2764, 2944, 3480, 3763, 3858, 4154, 4823, 5188, 5346, 6145, 6479, 6735, 7327, 7851, 8646, 9297, 10458, 11180, 11621]","[0, 270, 458, 596, 807, 1034, 1392, 1673, 1918, 2255, 2674, 3064, 3485, 3846, 4122, 4607, 5050, 5418, 5575, 5957, 6230, 6505, 7002, 7333, 7474, 8216, 8527, 9443, 9839, 10403]",19319,17008,14757,11621,10403,702,-3946,-1438,-4075,-3665,-12422,30,dire
7593062809,12,61,96,19,26,"[0, 270, 645, 735, 1174, 1474, 1757, 2174, 2962, 3344, 3783, 4309, 4969, 5741, 6425, 6965, 7525, 8248, 9247, 9342, 9865, 11502, 12542, 13430, 13992, 14087, 14540, 15409, 16204, 16880]","[0, 231, 510, 754, 1309, 1728, 2172, 2471, 3103, 3951, 4309, 4743, 4833, 5556, 6259, 6719, 7561, 7837, 8288, 8570, 9057, 10758, 11388, 11768, 12632, 12872, 13528, 13718, 13976, 14252]","[0, 304, 469, 722, 1153, 1604, 1941, 2323, 2661, 3190, 3534, 4079, 4430, 5009, 5604, 5841, 6465, 7067, 7202, 7297, 7787, 8805, 9500, 9595, 9821, 9916, 10011, 10703, 11148, 11534]","[0, 195, 331, 421, 541, 718, 841, 1021, 1454, 1813, 2259, 2791, 3076, 3809, 4464, 4767, 5047, 5252, 5393, 5488, 5582, 6484, 7184, 7406, 7500, 7595, 7690, 7785, 8043, 8455]","[0, 538, 628, 757, 965, 1115, 1205, 1512, 1870, 2169, 2259, 2506, 2596, 2999, 3184, 3279, 3436, 3531, 3661, 3756, 3972, 4417, 4728, 4823, 5195, 5365, 5460, 5819, 6149, 6459]",16880,14252,11534,8455,6459,73,94,23,100,86,"[0, 250, 703, 1246, 1637, 1810, 2380, 2884, 3210, 4407, 4985, 5847, 6399, 7458, 8397, 9519, 10186, 11221, 11911, 13581, 14988, 15161, 16374, 17588, 18582, 19813, 20869, 21262, 22215, 23114]","[0, 324, 540, 751, 998, 1212, 1384, 1837, 2052, 2324, 2681, 2947, 3242, 3632, 4245, 4949, 5403, 6049, 7021, 7640, 8399, 8566, 9222, 10044, 10938, 11390, 12513, 13622, 14448, 15265]","[0, 279, 603, 904, 1192, 1518, 1825, 2809, 3462, 4067, 4642, 5275, 5801, 6130, 6426, 6917, 7813, 8259, 8671, 9741, 10268, 10373, 10869, 11272, 11489, 12297, 12714, 13175, 13622, 13915]","[0, 170, 260, 439, 529, 619, 709, 889, 979, 1253, 1463, 1785, 2080, 2174, 2365, 2491, 2994, 3666, 3761, 4402, 4759, 4929, 5716, 5886, 6174, 7011, 7551, 7921, 8404, 8968]","[0, 170, 374, 727, 896, 1036, 1175, 1422, 1643, 1924, 2110, 2283, 2761, 2905, 3305, 3400, 3706, 4312, 4434, 5006, 5224, 5660, 6230, 6400, 6764, 7348, 7820, 8190, 8926, 9226]",23114,15265,13915,8968,9226,-6234,-1013,-2381,-513,-2767,-12908,30,dire
7593576711,94,90,20,71,85,"[0, 245, 491, 855, 1135, 1537, 1857, 2267, 2809, 2937, 3204, 3674, 4045, 4410, 4676, 5362, 6045, 7006, 7897, 8919, 9484, 10411, 11515, 12379, 13192, 13884, 14560, 15251, 15981, 16899]","[0, 444, 828, 1190, 1537, 2033, 2548, 3284, 3513, 3867, 4626, 5306, 6237, 6521, 6731, 7763, 8328, 8984, 9557, 10546, 10936, 11219, 11682, 12708, 13473, 14377, 15419, 16043, 16355, 16745]","[0, 247, 473, 1017, 1420, 1701, 1961, 2177, 2477, 3008, 3535, 3958, 4712, 4894, 5587, 6383, 6726, 7172, 7643, 8188, 8310, 8831, 8956, 9098, 9726, 10487, 10845, 11014, 11341, 11518]","[0, 222, 337, 498, 588, 718, 808, 943, 1033, 1123, 1587, 1820, 2470, 2760, 2953, 3337, 4057, 4825, 5421, 5725, 6432, 6675, 7020, 7246, 7429, 8159, 8758, 9318, 9753, 10184]","[0, 170, 285, 422, 512, 759, 885, 1020, 1110, 1284, 1549, 1639, 1933, 2027, 2122, 2462, 2649, 2860, 3068, 3369, 3463, 3788, 3883, 4199, 4365, 4686, 5559, 5654, 6139, 6568]",16899,16745,11518,10184,6568,49,120,43,123,30,"[0, 267, 549, 1081, 1277, 1520, 1976, 2750, 3055, 3361, 4237, 4960, 5898, 6149, 6873, 7532, 8186, 9316, 10178, 10760, 12033, 12661, 13497, 14524, 15033, 15754, 16385, 17092, 17757, 18923]","[0, 306, 577, 957, 1361, 1705, 2355, 2567, 2844, 3370, 3786, 4240, 4749, 5319, 6105, 6254, 6848, 7381, 8077, 8713, 9632, 10374, 11360, 11825, 12159, 12799, 13302, 13956, 14941, 15440]","[0, 233, 408, 665, 794, 984, 1238, 1625, 1790, 2187, 2624, 3203, 3795, 3988, 4400, 4839, 5481, 5898, 6574, 7157, 7708, 8666, 8989, 9460, 9857, 10262, 10545, 10692, 10825, 11466]","[0, 266, 459, 549, 764, 971, 1296, 1448, 1538, 2053, 2368, 2749, 3287, 3601, 4039, 4356, 4841, 5440, 5637, 6135, 6553, 6879, 7118, 7472, 7723, 7932, 8217, 8349, 8908, 9672]","[0, 240, 367, 590, 680, 785, 1314, 1503, 1637, 1727, 2042, 2380, 2882, 3075, 3493, 3642, 3978, 4148, 4475, 4924, 5382, 5711, 6025, 6195, 6605, 7093, 7307, 7587, 8056, 8402]",18923,15440,11466,9672,8402,-2024,1305,52,512,-1834,-1989,30,radiant
7594024404,12,13,96,123,128,"[0, 245, 715, 994, 1322, 1798, 2214, 2515, 2754, 3056, 3571, 3989, 4260, 4606, 5131, 5315, 5528, 5703, 6105, 7982, 9023, 9712, 10362, 10831, 11124, 11730, 11997, 13747, 14466, 14562]","[0, 283, 614, 900, 1192, 1413, 1705, 1958, 2328, 2963, 3156, 3841, 4031, 4299, 4817, 5247, 5733, 5828, 6503, 6808, 7256, 7748, 8096, 8522, 9164, 9578, 9986, 10834, 10931, 11027]","[0, 208, 573, 789, 1115, 1324, 1710, 2090, 2487, 3171, 3261, 3492, 3937, 4162, 4907, 5094, 5498, 5593, 5968, 6231, 6831, 7260, 7547, 7752, 8033, 8226, 8321, 8749, 9044, 9140]","[0, 170, 260, 350, 485, 575, 757, 895, 985, 1325, 1462, 1814, 1910, 2397, 2537, 2711, 2805, 2900, 3067, 3540, 4464, 4886, 5222, 5418, 5789, 5991, 6086, 7188, 7358, 7454]","[0, 170, 339, 478, 730, 820, 1001, 1091, 1181, 1350, 1478, 1665, 1755, 1850, 1990, 2104, 2319, 2414, 2524, 3175, 3588, 3865, 3960, 4055, 4149, 4244, 4339, 4954, 5220, 5316]",14562,11027,9140,7454,5316,93,71,120,110,20,"[0, 218, 529, 1096, 1312, 1737, 2223, 2651, 3077, 3336, 3932, 4573, 5181, 5756, 6222, 6856, 7397, 8295, 8803, 9528, 10345, 11174, 11836, 12526, 13115, 13770, 14615, 15021, 15911, 16583]","[0, 247, 602, 981, 1313, 1675, 2042, 2409, 3399, 3895, 4517, 5123, 6014, 6347, 6870, 7623, 7959, 8470, 9150, 9566, 9957, 10583, 11092, 11731, 12460, 13021, 13841, 15128, 15591, 16454]","[0, 245, 506, 677, 1016, 1213, 1623, 2032, 2449, 2955, 3896, 4226, 4443, 5039, 5516, 5906, 6441, 7241, 7840, 8239, 8503, 9171, 10015, 10121, 11160, 12027, 12938, 13387, 14279, 15092]","[0, 170, 629, 766, 902, 1221, 1631, 1745, 2242, 2509, 2925, 3108, 3377, 4176, 4592, 4856, 5090, 5770, 6555, 6943, 7110, 7418, 7834, 8157, 8598, 9391, 10374, 10846, 11323, 11849]","[0, 170, 285, 422, 512, 724, 951, 1088, 1269, 1441, 1668, 1812, 2361, 2694, 2987, 3250, 3852, 4769, 5203, 5467, 5769, 5936, 6108, 6406, 6772, 7131, 7934, 8491, 8750, 9186]",16583,16454,15092,11849,9186,-2021,-5427,-5952,-4395,-3870,-21665,30,dire
7594159214,46,93,98,65,20,"[0, 290, 566, 819, 1299, 1661, 2186, 2579, 2984, 3510, 3937, 4696, 5541, 6050, 6619, 7333, 7727, 8261, 9692, 10094, 10717, 10945, 11546, 12379, 13233, 13760, 14979, 15364, 16078, 16313]","[0, 242, 491, 833, 1165, 1608, 1908, 2251, 2506, 2663, 3183, 3877, 4237, 4883, 5606, 5992, 6833, 7368, 8354, 9238, 10097, 10743, 11491, 11751, 12352, 12994, 13466, 14216, 14748, 15231]","[0, 207, 616, 1076, 1362, 2185, 2521, 3112, 3871, 4574, 5235, 5504, 6503, 7133, 7446, 8014, 9032, 9930, 10132, 11054, 11682, 11933, 12847, 13414, 13754, 14580, 15379, 15625, 16603, 17276]","[0, 169, 259, 414, 504, 763, 1041, 1485, 1575, 1888, 2160, 2445, 3017, 3741, 4314, 4891, 5766, 6202, 6927, 7558, 7944, 8696, 9330, 9508, 10036, 10669, 11174, 11562, 12026, 12122]","[0, 169, 304, 469, 608, 968, 1148, 1843, 2023, 2673, 2808, 2988, 3483, 4068, 4372, 4466, 5011, 5277, 5505, 6021, 6490, 6935, 7336, 7585, 7890, 8486, 9151, 9444, 9831, 9959]",16313,15231,17276,12122,9959,48,13,102,123,26,"[0, 208, 410, 696, 1044, 1170, 1625, 1847, 2222, 2861, 3390, 3894, 4294, 5173, 5855, 6636, 7579, 7787, 8119, 9069, 9847, 10768, 11675, 12508, 13600, 14527, 16091, 16964, 17763, 19125]","[0, 328, 619, 1027, 1445, 1832, 2149, 2557, 3019, 3344, 3934, 4209, 4421, 4771, 5197, 5684, 6212, 6711, 8132, 8643, 9355, 10039, 10534, 11699, 12439, 12632, 13038, 13676, 14557, 15225]","[0, 203, 405, 919, 1162, 1587, 2189, 2713, 3151, 3654, 4151, 5097, 5621, 6083, 6809, 7471, 7845, 8212, 8972, 9604, 10009, 10291, 10741, 11902, 12482, 12775, 13091, 13276, 13744, 14784]","[0, 169, 259, 424, 597, 787, 1220, 1676, 2174, 2664, 2935, 3201, 3291, 3404, 3775, 4159, 4459, 4852, 5465, 5867, 6369, 6609, 7128, 7666, 8087, 8331, 8610, 9380, 10348, 11137]","[0, 217, 357, 447, 630, 770, 925, 1060, 1409, 1734, 1923, 2100, 2190, 2484, 2700, 3358, 3453, 3592, 4140, 4444, 5272, 5408, 5702, 6279, 6559, 6729, 7120, 7587, 7887, 8272]",19125,15225,14784,11137,8272,-2812,6,2492,985,1687,2358,30,radiant
7594427402,70,13,96,105,5,"[0, 204, 488, 814, 981, 1318, 1642, 1803, 2336, 2925, 3304, 3650, 4018, 4632, 5388, 5929, 6392, 6698, 7361, 8465, 9279, 10208, 10811, 11747, 12543, 13407, 14259, 14428, 14952, 15571]","[0, 326, 563, 898, 1125, 1605, 1822, 2111, 2403, 2733, 3166, 3491, 3928, 4550, 5116, 5682, 6365, 6561, 7062, 7911, 8300, 8982, 9510, 10259, 10885, 11480, 12174, 12268, 12843, 13521]","[0, 215, 606, 1035, 1289, 1840, 2138, 2352, 2721, 3263, 3687, 4064, 4244, 4595, 5244, 5716, 6040, 6708, 7255, 7585, 8144, 8711, 9191, 9925, 10819, 11222, 12039, 12197, 12684, 13029]","[0, 169, 464, 599, 689, 1408, 1623, 1713, 1852, 2092, 2227, 2856, 3269, 3447, 4421, 4618, 5166, 6066, 6627, 7454, 7666, 7927, 8141, 8601, 8971, 9213, 9595, 9764, 9969, 10607]","[0, 169, 514, 946, 1036, 1338, 1473, 1563, 1886, 2198, 2333, 2566, 3122, 3310, 3658, 3855, 4179, 4574, 4759, 5699, 5970, 6233, 6376, 6597, 6692, 6859, 7365, 7459, 7555, 7944]",15571,13521,13029,10607,7944,21,49,54,19,121,"[0, 169, 857, 1138, 1508, 2086, 2383, 2682, 3014, 3429, 3679, 3978, 4627, 5341, 5765, 6280, 6781, 8091, 8694, 9464, 10072, 11123, 11720, 12354, 12764, 13635, 14409, 15503, 16139, 16834]","[0, 286, 528, 818, 1175, 1542, 2081, 2839, 3380, 3832, 4663, 4948, 5474, 5916, 6677, 7380, 8168, 8561, 9566, 10487, 10978, 12146, 12593, 13137, 13573, 14144, 14768, 15758, 16231, 16327]","[0, 203, 367, 601, 846, 974, 1372, 1758, 2150, 2491, 2734, 2850, 3536, 4508, 4797, 5251, 5645, 5963, 6364, 6997, 7595, 8241, 9011, 9808, 10636, 11185, 12088, 13232, 13727, 14748]","[0, 169, 371, 513, 603, 836, 1096, 1502, 1639, 1729, 1819, 2136, 2607, 2921, 3106, 3284, 3596, 3827, 4072, 4419, 4617, 4913, 5241, 5407, 5502, 5804, 6226, 6546, 6934, 7030]","[0, 169, 259, 367, 505, 595, 855, 1065, 1155, 1338, 1428, 1643, 1972, 2394, 2579, 2673, 2894, 3385, 3543, 4063, 4210, 4402, 4569, 4961, 5333, 5832, 6231, 6661, 6838, 6934]",16834,16327,14748,7030,6934,-1263,-2806,-1719,3577,1010,-1201,30,dire
7594577403,36,76,16,20,110,"[0, 336, 703, 893, 1017, 1386, 1718, 2274, 2700, 3000, 3247, 3832, 4659, 5154, 5643, 5983, 6431, 6713, 7861, 8464, 9250, 9967, 11497, 12266, 13513, 14441, 15352, 15803, 16319, 17721]","[0, 280, 527, 989, 1250, 1614, 2103, 2274, 3329, 3785, 4187, 4860, 5517, 6030, 6512, 6784, 7161, 7621, 8173, 8710, 9074, 9331, 9858, 10387, 10482, 10942, 11333, 11909, 12257, 13052]","[0, 280, 567, 895, 1361, 1894, 2309, 3166, 4076, 4689, 5034, 5815, 6345, 6708, 7285, 7717, 7952, 8530, 8946, 9308, 9733, 10177, 11913, 12372, 13055, 13638, 14031, 14261, 14529, 15109]","[0, 500, 590, 680, 770, 908, 1088, 1298, 1653, 1788, 1878, 2235, 2615, 3218, 3367, 3701, 3796, 4084, 4374, 4469, 4564, 4703, 5126, 5717, 6255, 6531, 6899, 7204, 7583, 8085]","[0, 232, 322, 412, 630, 811, 991, 1420, 1764, 2127, 2292, 2670, 3050, 3275, 3561, 3861, 3992, 4236, 4497, 4592, 5019, 5216, 5806, 6251, 6705, 6871, 7047, 7277, 7420, 8171]",17721,13052,15109,8085,8171,129,106,70,53,128,"[0, 301, 569, 836, 1290, 1657, 2105, 2349, 2824, 3283, 3764, 3990, 4447, 5020, 5285, 6107, 6202, 7747, 8197, 8840, 9203, 9971, 10436, 10856, 11055, 11623, 11993, 12524, 13246, 14507]","[0, 512, 830, 1081, 1396, 1671, 2000, 2748, 2978, 3068, 3283, 3427, 3656, 4007, 4384, 4974, 5188, 6061, 6531, 7046, 7741, 8202, 8981, 9076, 9312, 9811, 10357, 11051, 11748, 13401]","[0, 481, 793, 1006, 1528, 1931, 2374, 2620, 2785, 3204, 3435, 3845, 4116, 4301, 4666, 5025, 5354, 5676, 6227, 7166, 7651, 8394, 9166, 9532, 9952, 10323, 10836, 11397, 11933, 12692]","[0, 262, 352, 459, 598, 703, 838, 1054, 1274, 1364, 1501, 1645, 1871, 2189, 2339, 3328, 3477, 4991, 5149, 5629, 6111, 6578, 7602, 7822, 8112, 8820, 8915, 9320, 10388, 11029]","[0, 192, 282, 409, 547, 683, 912, 1280, 1370, 1460, 1598, 1742, 1832, 2075, 2336, 2690, 2867, 3410, 3736, 4094, 4257, 4588, 5333, 5503, 5815, 5985, 6155, 6529, 7140, 8520]",14507,13401,12692,11029,8520,3214,-349,2417,-2944,-349,1989,30,radiant
7594924106,73,95,120,123,5,"[1, 352, 694, 1241, 1595, 1851, 2164, 2600, 3171, 3897, 4336, 5194, 6019, 6847, 8181, 9067, 10098, 11162, 12402, 13364, 13852, 14155, 14394, 16401, 17282, 17838, 19251, 20012, 20355, 20817]","[1, 204, 567, 923, 1293, 1838, 2113, 2481, 2957, 3211, 3762, 4162, 4603, 5032, 5585, 6169, 6848, 7763, 8633, 9381, 10594, 11351, 12190, 13872, 14873, 15467, 16791, 17567, 18604, 19839]","[1, 620, 847, 1154, 1402, 1729, 2111, 2412, 2689, 2928, 3269, 3835, 4351, 5016, 5603, 5903, 6425, 7457, 8098, 8363, 9158, 9938, 10105, 11613, 12397, 13463, 14369, 14930, 15176, 15592]","[1, 291, 430, 626, 754, 963, 1053, 1420, 1521, 1630, 2283, 2373, 2663, 2871, 3214, 3363, 3840, 4145, 4512, 4803, 5162, 5376, 5543, 6199, 6491, 6732, 7682, 7992, 8088, 8384]","[1, 598, 740, 877, 1068, 1281, 1371, 1581, 1752, 1923, 2191, 2374, 2608, 2771, 3074, 3294, 3669, 3928, 4190, 4348, 4508, 4814, 5053, 5796, 6088, 6330, 7092, 7306, 7477, 7897]",20817,19839,15592,8384,7897,39,18,102,26,110,"[1, 289, 631, 916, 1337, 1675, 2260, 2869, 3577, 3779, 4033, 4439, 4789, 5438, 6034, 6662, 7058, 7857, 8081, 8692, 9495, 9783, 10800, 10895, 11521, 12254, 13199, 13800, 14786, 15492]","[1, 209, 487, 910, 1318, 1698, 2186, 2921, 3662, 4433, 5035, 6046, 6485, 7256, 7775, 8929, 9709, 10721, 12067, 12594, 13520, 13754, 14537, 14938, 15251, 16362, 16730, 16825, 17648, 18222]","[1, 209, 519, 943, 1226, 1351, 1775, 2110, 2268, 2714, 3065, 3629, 4057, 4833, 5236, 5535, 5755, 5889, 6891, 7498, 8019, 8326, 9009, 9213, 9754, 10579, 11319, 11967, 12486, 13606]","[1, 384, 572, 736, 866, 1008, 1186, 1649, 1739, 1906, 2041, 2547, 2891, 3179, 3459, 3681, 4075, 4336, 4759, 4956, 5403, 5545, 5885, 6089, 6183, 6604, 6774, 6967, 7388, 7980]","[1, 170, 260, 424, 572, 678, 784, 964, 1104, 1271, 1615, 1759, 1955, 2313, 2408, 3025, 3281, 3564, 4133, 4291, 4830, 5100, 5593, 5876, 5970, 6137, 6394, 6489, 6764, 7175]",15492,18222,13606,7980,7175,5325,1617,1986,404,722,10054,30,radiant
7594930014,82,13,29,86,5,"[0, 170, 482, 855, 1053, 1658, 2288, 2908, 3190, 3725, 4266, 4880, 5581, 6442, 7120, 8161, 9131, 10063, 10774, 11661, 12460, 13063, 13764, 14144, 14838, 15520, 16388, 17165, 17365, 17506]","[0, 241, 523, 787, 914, 1204, 1425, 1683, 1991, 2702, 3272, 3811, 4349, 4980, 5513, 5896, 6293, 6569, 7449, 8186, 8451, 8890, 9600, 10171, 10814, 11197, 12239, 12498, 13238, 13863]","[0, 219, 533, 812, 1174, 1551, 1919, 2371, 2766, 3037, 3560, 4062, 4699, 5474, 6184, 6711, 7430, 8089, 8504, 8810, 9348, 9790, 9956, 10051, 10606, 11233, 11693, 12156, 12457, 12974]","[0, 170, 345, 435, 569, 694, 905, 1040, 1225, 1662, 1844, 2102, 2519, 2812, 3198, 3450, 3717, 4151, 4984, 5670, 6184, 6279, 6445, 6624, 7103, 7860, 8113, 8903, 9198, 9340]","[0, 221, 413, 551, 682, 889, 1179, 1323, 1665, 2064, 2264, 2354, 2590, 2936, 3191, 3285, 3610, 3933, 4362, 4630, 4849, 5019, 5260, 5501, 5871, 6088, 6501, 6781, 7050, 7378]",17506,13863,12974,9340,7378,95,59,129,105,26,"[0, 209, 492, 849, 1227, 1560, 1981, 2461, 2829, 3523, 4015, 4467, 4957, 5697, 6424, 7281, 7941, 8650, 9907, 10609, 11561, 12548, 14471, 14965, 16111, 17622, 18487, 19873, 21485, 22952]","[0, 278, 609, 938, 1292, 1635, 2079, 2575, 3102, 3564, 4186, 4546, 4961, 5857, 6631, 7010, 7687, 8188, 8876, 9391, 9962, 10635, 11784, 12370, 12801, 13697, 13923, 14674, 15400, 15959]","[0, 246, 518, 798, 1087, 1533, 1697, 2040, 2536, 2778, 2957, 3416, 3881, 4572, 4980, 5437, 6462, 6734, 7273, 7695, 8237, 8614, 9606, 9968, 10458, 11122, 11348, 12065, 12756, 13151]","[0, 170, 308, 444, 574, 932, 1022, 1648, 1849, 2214, 2432, 2719, 3103, 3435, 3952, 4527, 5039, 5298, 5787, 5944, 6279, 6471, 7353, 7670, 8015, 8454, 8680, 9328, 9796, 10412]","[0, 214, 356, 494, 669, 759, 909, 1184, 1385, 1577, 1851, 2019, 2199, 2530, 2715, 2825, 3225, 3488, 4066, 4223, 4483, 4602, 5355, 5873, 5968, 6455, 6926, 7699, 8119, 8559]",22952,15959,13151,10412,8559,-5446,-2096,-177,-1072,-1181,-9972,30,dire
7595374901,11,17,40,84,93,"[1, 253, 574, 815, 1144, 1573, 1991, 2770, 3214, 3669, 3855, 4640, 5076, 5548, 6088, 6679, 7275, 8185, 8888, 9436, 10262, 10688, 11125, 12036, 12463, 13333, 14800, 16007, 17529, 17928]","[1, 406, 686, 1135, 1514, 1970, 2830, 3280, 3888, 4381, 5033, 5841, 6398, 7019, 7718, 8014, 8785, 9055, 9150, 9512, 9828, 10790, 10885, 11706, 12404, 12979, 13410, 15413, 16141, 16588]","[1, 278, 589, 923, 1164, 1654, 2025, 2426, 2957, 3624, 4217, 5222, 5407, 5811, 6209, 6722, 7253, 7865, 8367, 9205, 9508, 9705, 9909, 10774, 12016, 12595, 12727, 13711, 14548, 14766]","[1, 171, 261, 396, 533, 708, 845, 1086, 1620, 2006, 2145, 2553, 2940, 3466, 3680, 3949, 4715, 4925, 5395, 5706, 6401, 6496, 6911, 7345, 7529, 8578, 8673, 9893, 10485, 11061]","[1, 171, 261, 395, 485, 740, 830, 920, 1100, 1238, 1374, 1807, 2103, 2357, 2452, 2877, 3278, 4008, 4487, 5084, 5474, 6179, 6369, 6576, 7942, 8201, 8594, 9806, 10699, 10917]",17928,16588,14766,11061,10917,18,13,71,121,85,"[1, 320, 653, 1091, 1451, 2338, 2807, 3349, 3737, 4394, 4889, 5452, 6061, 6635, 7394, 8066, 8981, 9888, 10825, 12420, 13434, 13962, 15442, 16522, 16915, 18232, 19209, 19304, 19705, 20850]","[1, 326, 730, 1138, 1553, 2010, 2381, 2998, 3713, 4098, 5221, 5926, 6644, 7126, 7749, 8153, 8727, 9396, 10208, 10915, 11678, 11773, 12927, 14343, 14818, 15686, 17282, 17377, 17511, 18548]","[1, 206, 549, 794, 1121, 1318, 1714, 1915, 2136, 2471, 3198, 3465, 3960, 4551, 5532, 5921, 6442, 7111, 7866, 8480, 8727, 8822, 10320, 11109, 11242, 11925, 12526, 12621, 12983, 14044]","[1, 217, 307, 397, 567, 657, 792, 882, 972, 1111, 1536, 1626, 1819, 2099, 2672, 2767, 2924, 3561, 3746, 4693, 4940, 5035, 5202, 6098, 6192, 6359, 6475, 6570, 6749, 7366]","[1, 171, 261, 413, 503, 721, 858, 1116, 1248, 1389, 1524, 1974, 2283, 2464, 2698, 2793, 2975, 3415, 3769, 4349, 4778, 4937, 5104, 5651, 5807, 6011, 6150, 6245, 6396, 7013]",20850,18548,14044,7366,7013,-2922,-1960,722,3695,3904,3439,30,radiant
7595378008,49,76,65,112,20,"[0, 254, 527, 847, 1099, 1603, 2084, 2676, 3534, 3781, 4576, 5346, 5912, 6296, 7347, 7825, 8350, 9198, 9924, 10790, 11459, 12044, 12610, 13194, 13682, 14325, 14420, 14793, 15966, 16705]","[0, 274, 628, 958, 1207, 1579, 2048, 2435, 2831, 3360, 4087, 4542, 4925, 5708, 6959, 7696, 8136, 9056, 10095, 11345, 11967, 12264, 12988, 13396, 14306, 14784, 15269, 15806, 16608, 16704]","[0, 206, 367, 601, 803, 1243, 1725, 2186, 2655, 3174, 4008, 4296, 4728, 5278, 6513, 7025, 8230, 8739, 9345, 10437, 10786, 11812, 11907, 12733, 13242, 13866, 13961, 14560, 15059, 15155]","[0, 217, 327, 421, 511, 601, 1032, 1196, 1286, 1440, 2127, 2466, 2879, 3028, 3447, 3935, 4294, 4551, 5202, 6279, 6884, 8250, 8731, 9073, 9877, 10656, 10826, 11201, 12299, 12856]","[0, 170, 359, 494, 584, 910, 1281, 1371, 1461, 1719, 2213, 2380, 2728, 3027, 3405, 3598, 4095, 4541, 5057, 5975, 6070, 6528, 6677, 7163, 8138, 8531, 8776, 9072, 9786, 10095]",16705,16704,15155,12856,10095,138,15,137,96,100,"[0, 242, 514, 844, 1123, 1561, 1729, 2083, 2749, 2954, 3297, 3841, 4609, 5289, 5891, 6220, 6840, 7954, 8990, 9311, 9406, 10257, 10352, 11178, 12239, 13066, 13854, 15032, 16586, 17211]","[0, 170, 383, 624, 984, 1395, 1868, 1958, 2300, 2778, 2907, 3157, 3339, 3840, 4101, 4610, 5040, 5735, 6073, 6167, 6437, 7422, 8513, 8704, 9053, 10068, 11346, 11670, 12893, 13094]","[0, 255, 584, 877, 1766, 2020, 2436, 2928, 3526, 3813, 3987, 4178, 4823, 5006, 5258, 5750, 6378, 6653, 6914, 7008, 7205, 8376, 8922, 9199, 9809, 10856, 11378, 11714, 12398, 13145]","[0, 170, 280, 414, 537, 695, 833, 960, 1547, 1804, 1894, 2042, 3081, 3481, 3885, 4015, 4303, 4744, 4839, 4933, 5028, 5614, 6013, 6441, 6971, 7497, 8160, 8464, 9776, 9947]","[0, 215, 305, 395, 563, 885, 1172, 1280, 1597, 1809, 1899, 2298, 2651, 2746, 2886, 2981, 3105, 3502, 3653, 3747, 3842, 4350, 5231, 5417, 5766, 6265, 6787, 7016, 7610, 7706]",17211,13094,13145,9947,7706,-506,3610,2010,2909,2389,10412,30,radiant
7595464805,48,17,120,65,5,"[0, 359, 590, 921, 1359, 2005, 2475, 2993, 3585, 4187, 4829, 5501, 6235, 7256, 8276, 9412, 10457, 10552, 11555, 12132, 13166, 14146, 15061, 16560, 18300, 19647, 21061, 22830, 23981, 25059]","[0, 388, 996, 1259, 1736, 2070, 2407, 2844, 3115, 3938, 4426, 4792, 5218, 5848, 6586, 7284, 7989, 8732, 9276, 9756, 10798, 11437, 12058, 13149, 13632, 14165, 15352, 16163, 16776, 17459]","[0, 247, 558, 918, 1339, 1594, 2133, 2546, 3019, 3540, 4027, 4538, 4940, 5261, 6390, 6959, 7179, 7607, 8148, 8800, 9395, 9865, 10447, 10940, 11757, 12253, 12776, 13475, 14273, 14694]","[0, 538, 628, 718, 838, 1249, 1430, 1565, 1886, 2113, 2388, 2607, 3156, 3931, 4280, 4785, 5304, 5399, 6097, 6447, 7013, 7350, 7517, 7794, 8376, 8854, 9326, 9952, 10832, 11121]","[0, 270, 360, 450, 617, 970, 1129, 1301, 1436, 1581, 1868, 1958, 2223, 2419, 2768, 3016, 3321, 3510, 3605, 4007, 4505, 4600, 5169, 5340, 6237, 6514, 7112, 7702, 7996, 8522]",25059,17459,14694,11121,8522,98,10,55,53,19,"[0, 287, 532, 910, 1248, 1584, 1989, 2533, 3049, 3175, 3561, 4435, 5009, 5583, 6149, 6474, 7320, 7763, 8140, 8781, 8913, 9825, 10671, 11003, 11861, 12413, 12873, 12978, 13973, 14218]","[0, 129, 331, 610, 813, 1149, 1513, 1894, 2267, 2779, 3295, 3701, 4046, 4598, 5185, 5559, 5995, 6764, 7311, 7892, 8602, 9085, 9828, 10274, 10543, 11178, 11635, 11729, 12133, 12288]","[0, 287, 452, 665, 880, 1005, 1256, 1769, 2217, 2585, 3352, 3770, 4384, 4863, 5387, 5591, 6136, 6568, 7017, 7663, 8033, 8656, 9084, 9754, 10031, 10462, 11003, 11463, 11718, 11889]","[0, 129, 219, 358, 448, 538, 628, 911, 1121, 1294, 1418, 1686, 1994, 2265, 2563, 2658, 3587, 3806, 4216, 4503, 4997, 5337, 5892, 6267, 6361, 6702, 7026, 7310, 7406, 7782]","[0, 129, 267, 401, 491, 581, 793, 1225, 1315, 1405, 1586, 1996, 2274, 2423, 2792, 2887, 3343, 3747, 3842, 4078, 4231, 4479, 4794, 4964, 5230, 5397, 5718, 5948, 6044, 6140]",14218,12288,11889,7782,6140,10841,5171,2805,3339,2382,24538,30,radiant
7595475910,7,37,96,42,87,"[0, 206, 445, 811, 1188, 1528, 1704, 2164, 2490, 3070, 3160, 4167, 4635, 4989, 5228, 5628, 6312, 6960, 7303, 8138, 8706, 8880, 9880, 10227, 10883, 11036, 11681, 11775, 14479, 15248]","[0, 182, 272, 489, 998, 1180, 1433, 1733, 2079, 2242, 2585, 3895, 4157, 4555, 4914, 5210, 6271, 7074, 7608, 8417, 8893, 9662, 10248, 10674, 10904, 11037, 11481, 11781, 13112, 13945]","[0, 168, 500, 816, 1201, 1529, 1724, 2184, 2787, 2877, 3004, 3272, 3723, 4660, 4912, 5598, 6672, 6819, 7474, 8310, 9278, 9927, 10510, 11046, 11655, 11750, 12029, 12578, 13198, 13551]","[0, 253, 496, 816, 1192, 1493, 1901, 2465, 2709, 2896, 3118, 3630, 4120, 4495, 4888, 5545, 6377, 6780, 7480, 8124, 9097, 9595, 9834, 10423, 10688, 10783, 10878, 11042, 11947, 12481]","[0, 130, 264, 829, 966, 1102, 1211, 1438, 1596, 2037, 2127, 2784, 3011, 3598, 3769, 3938, 4687, 5277, 5903, 6592, 7123, 7764, 8003, 8187, 8394, 8763, 8858, 8990, 10525, 10878]",15248,13945,13551,12481,10878,93,102,129,26,91,"[0, 249, 558, 909, 1375, 1624, 2186, 2718, 3033, 3744, 4292, 4905, 5483, 6120, 6639, 7208, 8731, 8936, 9588, 10129, 10634, 11727, 12721, 13684, 14807, 15758, 16480, 17507, 18694, 18790]","[0, 267, 498, 782, 1185, 1562, 2309, 2699, 3417, 4271, 4954, 5185, 5826, 6269, 6930, 7377, 8130, 8887, 9125, 10042, 10348, 11495, 11867, 12472, 13085, 13915, 15560, 16663, 17680, 17776]","[0, 343, 712, 1117, 1454, 1778, 2561, 2766, 3448, 3796, 4254, 4555, 4954, 5507, 5958, 6178, 6881, 7330, 7587, 7905, 8401, 8810, 9496, 9995, 10833, 11758, 12966, 13795, 14219, 14676]","[0, 586, 731, 872, 1217, 1355, 1569, 1835, 2195, 2521, 2967, 3057, 3201, 3344, 3493, 3678, 4088, 4460, 4771, 4928, 5319, 6129, 6296, 6615, 6983, 7188, 8006, 8676, 9107, 9203]","[0, 267, 357, 738, 916, 1043, 1385, 1565, 1837, 2148, 2376, 2466, 2646, 2786, 3376, 3561, 3841, 4095, 4546, 4830, 5013, 5843, 6190, 6607, 7135, 7574, 8189, 8808, 9105, 9201]",18790,17776,14676,9203,9201,-3542,-3831,-1125,3278,1677,-3543,30,dire
7595488105,48,49,19,86,3,"[269, 478, 775, 1053, 1288, 1394, 1653, 2307, 2509, 2907, 3600, 4024, 4575, 5271, 5814, 6588, 7462, 8509, 9336, 10017, 10607, 11586, 12322, 13299, 13586, 13681, 14920, 15539, 16190, 16486]","[136, 384, 745, 1066, 1642, 1976, 2372, 2628, 3387, 3837, 4164, 4927, 5563, 5980, 6336, 6738, 7510, 8352, 9208, 9893, 10089, 10592, 11358, 12179, 12549, 12757, 13127, 13412, 13767, 14203]","[269, 550, 869, 1167, 1591, 1816, 2334, 3158, 3539, 3894, 4465, 5210, 5672, 5858, 6043, 6285, 6578, 7037, 7502, 8368, 8504, 9062, 10135, 10535, 10721, 10816, 11127, 11221, 11407, 12172]","[72, 333, 466, 604, 812, 949, 1039, 1375, 1631, 1831, 2167, 2549, 2718, 3039, 3195, 3671, 4202, 4784, 5090, 5665, 6128, 6865, 7398, 7905, 8235, 8462, 9272, 9739, 10169, 10340]","[136, 345, 435, 525, 655, 784, 968, 1273, 1694, 1784, 1874, 2227, 2413, 2508, 2731, 2968, 3215, 3812, 4043, 4393, 4533, 5183, 5630, 5724, 5819, 5914, 6102, 6196, 6551, 6987]",16486,14203,12172,10340,6987,113,6,21,58,20,"[60, 340, 584, 999, 1283, 1573, 1990, 2337, 2523, 2872, 3479, 4547, 5138, 5711, 6395, 6697, 7449, 8079, 8787, 9890, 10813, 11359, 11849, 13332, 14970, 15796, 16170, 17936, 19443, 21644]","[60, 225, 466, 869, 1173, 1556, 1840, 2206, 2432, 2801, 3448, 3766, 4446, 5116, 5702, 6175, 7045, 7540, 7915, 8150, 8939, 9939, 10328, 10943, 12048, 12490, 13362, 14623, 15971, 16858]","[60, 262, 460, 709, 799, 1433, 1738, 2137, 2792, 3307, 3808, 4170, 4709, 4992, 5365, 5682, 5839, 6420, 7155, 8416, 9040, 9607, 9799, 10266, 11326, 11725, 12117, 13031, 13478, 14069]","[328, 457, 547, 685, 1038, 1180, 1514, 1667, 1757, 2130, 2403, 2677, 3023, 3653, 4164, 4426, 5026, 5162, 5519, 6289, 6618, 7133, 7624, 8196, 8930, 9384, 9830, 10594, 11721, 12805]","[60, 189, 279, 416, 506, 1174, 1363, 1453, 1664, 1843, 2116, 2427, 3105, 3363, 3708, 4037, 4194, 4374, 4469, 5156, 5423, 5622, 5717, 6016, 6942, 7222, 7508, 8272, 8717, 9228]",21644,16858,14069,12805,9228,-5158,-2655,-1897,-2465,-2241,-14416,30,dire
7595612013,39,93,137,90,86,"[0, 246, 570, 893, 1380, 1798, 2238, 2709, 3150, 3596, 4341, 4849, 5118, 5472, 6027, 6601, 7695, 8196, 9091, 9640, 10706, 11614, 12583, 13290, 14154, 15137, 15572, 16596, 17720, 18933]","[0, 206, 765, 1128, 1294, 1678, 2013, 2561, 3091, 3711, 4077, 4666, 5093, 5764, 6314, 6851, 7442, 7979, 8443, 9176, 9845, 10617, 11222, 11675, 12212, 13186, 14265, 15377, 16423, 17294]","[0, 169, 450, 696, 947, 1457, 1780, 2308, 2583, 3081, 3613, 4462, 4790, 4939, 5375, 5801, 6383, 6762, 6943, 7322, 7932, 8401, 9406, 9928, 10362, 10823, 11897, 12711, 13321, 14051]","[0, 269, 398, 590, 768, 891, 1071, 1251, 1380, 1567, 1850, 2194, 2509, 2869, 3341, 4028, 4676, 5086, 5415, 5803, 6281, 6765, 7181, 7482, 8210, 8581, 9716, 9927, 10786, 11222]","[100, 316, 485, 623, 713, 921, 1093, 1435, 1584, 1674, 1809, 2056, 2349, 2543, 2763, 3094, 3538, 3879, 4150, 4599, 5217, 5965, 6336, 6563, 7043, 7215, 7764, 8250, 8748, 9527]",18933,17294,14051,11222,9527,89,120,49,26,5,"[0, 238, 451, 770, 1071, 1354, 1708, 2228, 2550, 2871, 3207, 3794, 4387, 5215, 5889, 6168, 7074, 7446, 8167, 9012, 9665, 10042, 11146, 11720, 12584, 13469, 13563, 13658, 14745, 15097]","[64, 302, 591, 986, 1226, 1652, 2184, 2519, 2698, 3638, 3954, 4374, 4876, 5539, 5785, 6362, 6991, 7724, 7900, 8134, 8666, 9519, 10289, 11120, 12050, 12668, 13021, 13587, 13942, 14331]","[332, 552, 744, 950, 1316, 1588, 1882, 2053, 2420, 2806, 3345, 3995, 4480, 5150, 5435, 5816, 6535, 6911, 7233, 7691, 8094, 8693, 9285, 9433, 9921, 10612, 11469, 11564, 12376, 12588]","[64, 271, 405, 533, 672, 802, 996, 1121, 1233, 1576, 1666, 2161, 2382, 2531, 2673, 2768, 3061, 3384, 3478, 3791, 4240, 4410, 4759, 4929, 5134, 5633, 6015, 6185, 6518, 6689]","[64, 233, 342, 476, 647, 890, 1025, 1115, 1205, 1641, 1904, 2234, 2746, 2895, 3142, 3318, 3476, 3571, 3890, 3985, 4207, 4302, 4576, 4710, 4805, 5008, 5339, 5434, 5784, 6139]",15097,14331,12588,6689,6139,3836,2963,1463,4533,3388,16183,30,radiant
7595761202,18,39,29,86,20,"[0, 248, 536, 846, 1425, 1823, 2229, 2875, 3408, 3964, 4669, 5265, 5706, 6387, 6878, 7706, 8995, 9876, 10737, 11253, 12053, 13013, 13346, 14797, 15631, 15798, 16131, 16722, 16871, 17702]","[0, 365, 729, 1058, 1581, 1893, 2331, 2924, 3160, 3707, 4318, 4699, 5213, 5995, 6267, 6506, 7204, 7862, 8576, 9462, 10248, 10685, 11293, 12914, 13729, 13896, 14383, 14536, 14989, 15519]","[0, 329, 561, 838, 1077, 1314, 1603, 1899, 2295, 2846, 3383, 4004, 4599, 5511, 6076, 6524, 7097, 7412, 7652, 8047, 8231, 8541, 8949, 9956, 10489, 11164, 11686, 11955, 12098, 12630]","[0, 170, 260, 722, 825, 915, 1280, 1457, 1747, 2072, 2435, 2667, 2904, 3479, 3621, 3860, 4417, 4749, 5324, 5802, 6061, 6531, 7082, 7825, 8100, 8342, 8715, 8918, 9297, 10600]","[100, 270, 360, 450, 624, 714, 804, 1003, 1311, 1416, 1683, 1773, 2006, 2376, 2501, 2740, 3498, 3681, 3855, 4234, 4462, 4798, 4965, 5703, 5918, 6085, 6265, 6359, 6455, 6587]",17702,15519,12630,10600,6587,70,96,120,33,114,"[0, 170, 435, 943, 1397, 1861, 2588, 2931, 3562, 4072, 4930, 5659, 6247, 7025, 7653, 8424, 9392, 10620, 11673, 12736, 13795, 14688, 15260, 16745, 17387, 19365, 20120, 20976, 22141, 23158]","[0, 204, 610, 996, 1404, 1932, 2532, 3119, 3930, 4193, 4908, 5731, 6480, 6665, 7257, 7914, 8989, 9934, 10575, 11288, 11883, 12353, 12988, 13383, 13956, 15046, 15693, 16703, 17490, 17986]","[0, 207, 534, 1011, 1383, 1825, 2222, 2730, 3217, 3731, 4180, 4747, 5315, 5464, 6092, 6755, 7939, 8617, 9521, 9949, 10545, 11624, 12328, 13040, 13423, 14238, 15129, 15959, 16915, 17685]","[0, 170, 290, 707, 897, 1159, 1289, 1606, 1873, 2088, 2700, 3159, 3803, 4315, 4881, 5524, 5858, 6241, 6834, 7348, 7980, 8424, 9165, 9490, 9894, 10459, 10867, 11274, 12032, 13143]","[0, 170, 290, 440, 658, 906, 1293, 1558, 2163, 2253, 2590, 2874, 3024, 3305, 3490, 3771, 4105, 4488, 4755, 4913, 5222, 5716, 5921, 6216, 6561, 7378, 7948, 8413, 8897, 9621]",23158,17986,17685,13143,9621,-5456,-2467,-5055,-2543,-3034,-18555,30,dire
7596368016,89,22,69,123,9,"[0, 245, 488, 901, 1191, 1722, 2438, 3174, 3786, 4461, 5017, 6003, 6451, 7161, 8499, 9054, 10180, 10813, 10907, 11718, 12426, 13640, 14613, 15262, 16517, 17228, 18354, 19328, 20913, 22157]","[0, 325, 637, 1055, 1572, 1992, 2370, 2927, 3550, 4225, 4856, 5283, 6424, 7118, 7782, 8094, 8732, 9788, 10724, 11922, 12845, 13663, 14712, 15292, 16248, 16931, 18092, 18595, 19656, 20982]","[0, 292, 560, 926, 1562, 1903, 2264, 2908, 3331, 3970, 4514, 4954, 5636, 6196, 6706, 7495, 8385, 9386, 10178, 10731, 11280, 11912, 12653, 12859, 13778, 14594, 15512, 15732, 17705, 18644]","[0, 170, 304, 494, 655, 785, 972, 1264, 1548, 1737, 1888, 2285, 2647, 2949, 3348, 3497, 3745, 4188, 4790, 5318, 5722, 6137, 6555, 6680, 7541, 8125, 9350, 9507, 10762, 11801]","[0, 218, 358, 522, 695, 889, 1082, 1286, 1564, 1819, 2183, 2391, 3026, 3324, 3747, 4080, 4557, 4766, 5336, 5832, 6464, 6894, 7350, 7806, 8628, 8933, 9639, 10117, 10875, 11767]",22157,20982,18644,11801,11767,94,73,129,26,5,"[0, 253, 603, 958, 1360, 1799, 2219, 2641, 3145, 3697, 4429, 5160, 5744, 6016, 6669, 7414, 8440, 9306, 9848, 9943, 10937, 11820, 12930, 13619, 14674, 15805, 16891, 17761, 18561, 18657]","[0, 426, 766, 1127, 1482, 1813, 1990, 2498, 3001, 3621, 4411, 4904, 5428, 6106, 6457, 7601, 8530, 9664, 10869, 11515, 12508, 12891, 13228, 13601, 13696, 14649, 15434, 15567, 16159, 16382]","[0, 278, 587, 880, 1281, 1735, 2280, 2815, 3320, 3718, 4358, 4625, 4937, 5501, 5829, 6442, 6987, 7463, 7882, 8169, 8578, 8833, 9203, 9407, 9976, 10653, 10927, 11431, 11970, 12206]","[0, 172, 274, 364, 552, 874, 999, 1284, 1420, 1603, 1991, 2168, 2540, 2635, 2800, 3088, 3443, 3564, 4008, 4247, 4447, 4542, 4666, 4881, 5042, 5359, 5453, 5711, 5862, 6320]","[0, 170, 285, 420, 550, 687, 853, 1113, 1276, 1412, 1811, 1938, 2117, 2212, 2420, 2890, 3024, 3167, 3955, 4050, 4277, 4372, 4466, 4869, 4964, 5278, 5395, 5490, 5641, 5818]",18657,16382,12206,6320,5818,3500,4600,6438,5481,5949,25968,30,radiant
7596687303,18,120,135,20,121,"[0, 316, 624, 871, 1285, 1637, 1952, 2505, 2990, 3793, 4480, 5074, 5752, 6444, 7125, 8204, 8859, 9509, 11035, 11853, 13141, 13925, 14982, 15872, 16587, 17688, 18355, 19216, 20227, 21705]","[0, 248, 531, 898, 1237, 1527, 2161, 2671, 3079, 3378, 3791, 4366, 4852, 5338, 5769, 6544, 7105, 7493, 7805, 8302, 9486, 9825, 10074, 10807, 11404, 11710, 12244, 12775, 13413, 14287]","[0, 283, 565, 733, 859, 1103, 1314, 1449, 1751, 2168, 2396, 2726, 2868, 3300, 3596, 4213, 4691, 5054, 5503, 5868, 6289, 6741, 7255, 8800, 9080, 9524, 10126, 10221, 10662, 11384]","[0, 210, 346, 528, 666, 802, 908, 1074, 1216, 1441, 1670, 2201, 2489, 2667, 3380, 3678, 3933, 4226, 5013, 5214, 5652, 5765, 6049, 6813, 6956, 7149, 7344, 7523, 7734, 8287]","[0, 210, 347, 437, 624, 1170, 1307, 1442, 1617, 2028, 2465, 2748, 2838, 2994, 3280, 3649, 3788, 3930, 4463, 4558, 4946, 5122, 5623, 6108, 6203, 6603, 7016, 7726, 7953, 8195]",21705,14287,11384,8287,8195,114,28,106,5,26,"[0, 182, 490, 1006, 1306, 1631, 2211, 2498, 2896, 3172, 3621, 3785, 4254, 4767, 5311, 5514, 6125, 6971, 7403, 7970, 8869, 9870, 10520, 10928, 11551, 11940, 12586, 12907, 13468, 14219]","[0, 130, 377, 576, 1222, 1348, 1792, 2016, 2593, 3042, 3658, 4137, 4587, 5472, 6009, 6443, 7401, 7875, 8303, 9084, 9778, 10031, 11015, 11499, 12171, 12558, 13194, 13511, 13607, 14116]","[0, 279, 651, 964, 1373, 2061, 2393, 2845, 3589, 4210, 4771, 5657, 5977, 6618, 6881, 7412, 8149, 8262, 8847, 9393, 9790, 10473, 11072, 11167, 12042, 12696, 13439, 13902, 14167, 14439]","[0, 233, 366, 902, 1126, 1445, 1662, 2105, 2371, 2461, 2641, 2767, 3262, 3567, 3754, 3849, 4216, 4487, 4667, 5103, 5378, 5756, 6063, 6365, 6552, 6665, 7083, 7463, 7899, 7995]","[0, 130, 220, 310, 560, 698, 834, 1156, 1422, 1644, 1824, 2030, 2120, 2394, 2594, 2689, 3277, 3907, 4139, 4297, 4572, 4982, 5400, 5679, 5990, 6205, 6891, 7200, 7371, 7542]",14219,14116,14439,7995,7542,7486,171,-3055,292,653,5547,30,radiant
7596756308,10,120,28,65,20,"[63, 345, 585, 867, 1193, 1966, 2472, 2915, 3562, 4103, 4472, 5111, 5362, 5604, 6209, 6944, 7470, 8282, 8945, 9463, 11281, 12185, 13364, 14118, 14950, 15606, 16779, 17686, 18651, 19858]","[63, 295, 649, 1025, 1403, 1834, 2197, 2330, 2688, 3187, 3582, 3967, 4089, 4679, 5186, 5843, 6661, 6879, 7492, 8438, 9483, 9989, 11056, 11791, 11886, 12618, 13226, 13444, 13895, 14661]","[331, 641, 1042, 1292, 1798, 2098, 2552, 3001, 3476, 3894, 4345, 5404, 5939, 6622, 6845, 7320, 7889, 8282, 8376, 8616, 9030, 9689, 10477, 10991, 11086, 11649, 11743, 12208, 12637, 13094]","[63, 428, 518, 608, 743, 873, 980, 1173, 1694, 1892, 2291, 2745, 2984, 3393, 3577, 4236, 4689, 4925, 5478, 5930, 6635, 6852, 7811, 8344, 8704, 9297, 9466, 9636, 9807, 10250]","[63, 442, 637, 727, 898, 1154, 1255, 1470, 1737, 1924, 2059, 2198, 2385, 2570, 2823, 3204, 3362, 3476, 3570, 3927, 4561, 5039, 5689, 5946, 6041, 6422, 6597, 6884, 7064, 7432]",19858,14661,13094,10250,7432,69,93,126,79,9,"[0, 374, 606, 891, 1170, 1300, 1675, 2210, 2746, 3111, 3862, 4330, 4500, 5623, 6335, 7080, 7625, 8863, 9991, 10993, 11668, 12030, 12357, 12708, 14534, 15046, 15959, 16827, 17646, 17992]","[0, 170, 537, 771, 1137, 1496, 1978, 2385, 2763, 3100, 3756, 4123, 4635, 5287, 5984, 6503, 7283, 8540, 8905, 9515, 10235, 10921, 11720, 12726, 13927, 14381, 16125, 16959, 17455, 18515]","[0, 328, 700, 1117, 1534, 1863, 2347, 3030, 3564, 3736, 4197, 4557, 5285, 5698, 6562, 6922, 7778, 8389, 8934, 9665, 10298, 10529, 10623, 10965, 12078, 12335, 13207, 13753, 14401, 14968]","[0, 321, 411, 621, 759, 849, 1140, 1360, 1495, 1585, 2093, 2217, 2506, 2969, 3259, 3562, 3807, 4177, 4695, 5051, 5481, 6255, 6855, 7231, 7571, 7903, 8474, 8938, 9236, 9671]","[0, 440, 530, 694, 863, 953, 1192, 1412, 1595, 1721, 2213, 2303, 2508, 2798, 3061, 3155, 3313, 3979, 4358, 4743, 5442, 5980, 6149, 6439, 7067, 7478, 8072, 8456, 8916, 9442]",17992,18515,14968,9671,9442,1866,-3854,-1874,579,-2010,-5293,30,dire
7597199202,74,80,93,121,26,"[0, 316, 598, 886, 1260, 1678, 1924, 2508, 2990, 3214, 3500, 3973, 4595, 5544, 5872, 6331, 6672, 7432, 7868, 8262, 8420, 8706, 9028, 9713, 10375, 11210, 11928, 12475, 13178, 13663]","[0, 297, 647, 1075, 1348, 2088, 2451, 2915, 3152, 3242, 3410, 3706, 4321, 5033, 5390, 6107, 6686, 7872, 8527, 8714, 9388, 10007, 10361, 10785, 11324, 11491, 11954, 12372, 12866, 13149]","[0, 285, 555, 948, 1256, 1593, 1946, 2364, 2782, 3448, 4041, 4963, 5883, 6799, 7353, 7448, 8156, 9100, 9868, 10423, 10719, 11678, 12042, 12798, 13277, 13715, 14312, 14774, 15497, 15674]","[0, 254, 387, 593, 764, 926, 1254, 1434, 1741, 1926, 2162, 2342, 2874, 3404, 3617, 4134, 4292, 4950, 5207, 5897, 6772, 7415, 7575, 7899, 8125, 8802, 9077, 9547, 10209, 10461]","[100, 309, 442, 612, 798, 1008, 1423, 1513, 1603, 1817, 2224, 2404, 2853, 3462, 3556, 3827, 4340, 4831, 5015, 5293, 6091, 6382, 6476, 6681, 6776, 6987, 7282, 7512, 8006, 8510]",13663,13149,15674,10461,8510,13,107,20,48,112,"[0, 590, 843, 1223, 1431, 1723, 2110, 2479, 3040, 3637, 4261, 5015, 5469, 5654, 6138, 6590, 7163, 7543, 7828, 8456, 8898, 9651, 10287, 10946, 11656, 12517, 13548, 14022, 15668, 16360]","[0, 199, 575, 849, 1312, 1605, 1902, 2237, 2603, 3594, 4283, 5222, 5548, 5746, 6013, 6866, 7555, 8343, 8727, 9761, 9945, 10654, 11021, 11862, 13039, 13850, 14527, 15381, 16350, 17209]","[0, 323, 642, 967, 1206, 1661, 1949, 2490, 2738, 2908, 3258, 3472, 4045, 4397, 4491, 4858, 5162, 5602, 5770, 6192, 6729, 7263, 7619, 7932, 8578, 9438, 10066, 10161, 10785, 11198]","[0, 199, 289, 637, 811, 901, 1036, 1662, 1786, 2022, 2393, 3429, 3671, 3820, 3914, 4225, 4446, 4779, 5221, 6583, 6870, 7377, 7861, 8283, 8796, 9296, 9978, 10347, 10921, 11605]","[0, 199, 289, 409, 602, 737, 872, 1008, 1255, 1796, 2044, 2644, 2837, 2986, 3080, 3529, 3672, 4083, 4177, 4814, 4979, 5231, 5708, 6066, 6525, 7120, 7389, 7484, 8306, 8402]",16360,17209,11198,11605,8402,-2697,-4060,4476,-1144,108,-3317,30,radiant
7597227611,15,93,28,5,87,"[0, 324, 639, 1030, 1431, 1903, 2499, 2971, 3554, 3911, 4585, 5750, 6347, 6911, 7767, 8715, 9304, 10459, 11422, 12229, 12732, 13806, 14621, 15839, 16876, 17648, 19416, 20849, 23043, 24984]","[0, 243, 451, 831, 1170, 1490, 1971, 2587, 3039, 3473, 3870, 4506, 5057, 6153, 6916, 7488, 8339, 8850, 10282, 11117, 11697, 12513, 13440, 14655, 15313, 16023, 17298, 18979, 20310, 22311]","[0, 274, 641, 970, 1348, 2048, 2231, 2864, 2954, 3451, 3850, 4030, 4514, 5223, 5626, 5794, 6316, 6691, 7645, 8507, 8602, 8954, 9939, 10883, 11177, 11271, 12376, 12723, 13287, 14663]","[0, 217, 307, 397, 532, 776, 889, 1085, 1224, 1335, 1610, 1811, 2062, 2433, 2573, 2761, 3009, 3597, 3922, 4298, 4752, 4856, 5621, 5920, 6494, 6663, 7688, 8415, 8945, 9934]","[0, 170, 260, 396, 535, 671, 761, 1038, 1166, 1339, 1600, 1780, 1957, 2426, 2740, 3097, 3345, 3720, 4174, 4633, 4957, 5068, 5468, 5745, 6039, 6413, 7048, 7736, 8453, 9620]",24984,22311,14663,9934,9620,71,105,44,100,26,"[0, 207, 745, 1063, 1356, 1972, 2253, 2843, 3260, 3682, 4121, 4417, 4966, 5459, 5607, 6257, 6820, 7245, 7806, 7901, 9749, 10093, 10982, 11711, 12485, 12937, 13166, 13641, 13947, 14314]","[0, 328, 696, 1103, 1432, 1839, 2268, 2861, 3499, 4029, 4555, 4645, 5212, 5894, 6391, 7025, 7467, 8018, 8208, 8428, 9682, 10233, 11308, 11493, 12206, 12496, 12954, 13661, 13954, 14050]","[0, 208, 501, 785, 1147, 1341, 1784, 2045, 2438, 2839, 3353, 3928, 4270, 4699, 5193, 5865, 6268, 6962, 7273, 7368, 8039, 9278, 10041, 10353, 11680, 12436, 12665, 12760, 12856, 12952]","[0, 170, 260, 385, 742, 832, 1187, 1413, 1710, 1862, 2371, 2775, 2909, 3137, 3285, 3562, 3720, 4088, 4394, 4489, 5246, 5790, 6591, 6903, 7358, 7708, 7994, 8403, 8499, 8595]","[0, 217, 380, 520, 722, 941, 1035, 1262, 1352, 1486, 1621, 1851, 1941, 2084, 2232, 2948, 3174, 3477, 3667, 3815, 4146, 4525, 5066, 5654, 6608, 6873, 7003, 7182, 7278, 7374]",14314,14050,12952,8595,7374,10670,8261,1711,1339,2246,24227,30,radiant
7597255404,73,98,120,123,58,"[0, 289, 562, 1124, 1514, 1872, 2135, 2380, 2700, 3127, 3880, 4236, 4909, 5844, 7186, 7760, 8810, 10160, 10962, 12129, 13200, 14168, 14927, 15772, 16148, 16987, 17452, 18844, 19347, 19980]","[0, 258, 610, 1255, 1489, 1779, 2087, 2349, 2725, 3127, 3805, 4743, 4995, 5727, 6250, 6865, 7507, 7850, 8656, 9868, 10697, 11269, 11641, 12126, 12449, 12650, 13356, 14141, 15411, 16326]","[0, 281, 547, 869, 1274, 1890, 2477, 3276, 3657, 4330, 4950, 5749, 6178, 6714, 6983, 7595, 8126, 8772, 9269, 10419, 11051, 11476, 12119, 12312, 12406, 12635, 13183, 13899, 15351, 15920]","[0, 170, 260, 496, 630, 767, 1054, 1277, 1412, 1644, 1973, 2187, 2326, 3097, 3303, 3532, 3787, 4225, 4596, 5452, 5732, 6216, 6564, 6970, 7102, 7492, 7900, 8407, 9309, 9694]","[0, 170, 260, 396, 726, 816, 991, 1113, 1265, 1709, 1934, 2259, 2385, 2723, 2842, 2971, 3507, 3636, 4058, 4607, 4945, 5416, 5989, 6084, 6276, 6454, 6793, 7242, 7578, 7952]",19980,16326,15920,9694,7952,11,90,96,27,20,"[0, 170, 551, 838, 1251, 1490, 2123, 2911, 3446, 3941, 4468, 5240, 5798, 6477, 7270, 7878, 8850, 9837, 10796, 11337, 11778, 12311, 13299, 14293, 15260, 16290, 17278, 18542, 18813, 19755]","[0, 335, 757, 1005, 1260, 1608, 1991, 2778, 3286, 3832, 4568, 5239, 5892, 6517, 7157, 7771, 8513, 9210, 10137, 10635, 11469, 12138, 13172, 14128, 15112, 15858, 16591, 17289, 17695, 18008]","[0, 207, 517, 810, 1280, 1684, 2063, 2884, 3276, 3773, 4405, 4899, 5455, 5908, 6275, 6584, 7094, 7589, 8068, 8245, 8677, 9093, 9548, 10880, 11637, 12237, 12743, 13214, 13893, 14779]","[0, 213, 364, 499, 726, 950, 1087, 1432, 1658, 1748, 1928, 2588, 2760, 2956, 3177, 3272, 3526, 3791, 4085, 4336, 4911, 5354, 5767, 6143, 6834, 7356, 7616, 8160, 8506, 8887]","[0, 170, 285, 390, 480, 659, 830, 1153, 1591, 1907, 2120, 2644, 2857, 3026, 3217, 3471, 3636, 4006, 4531, 4775, 5175, 5405, 5682, 6075, 6644, 7091, 7357, 7828, 8494, 8795]",19755,18008,14779,8887,8795,225,-1682,1141,807,-843,-352,30,dire
7597320600,10,73,19,65,105,"[0, 290, 530, 851, 1397, 1804, 2175, 2617, 3117, 3451, 4110, 4632, 5089, 5360, 6075, 6811, 8081, 8711, 9580, 10276, 12213, 12839, 13823, 15160, 15776, 16678, 17724, 18989, 20406, 21503]","[0, 287, 505, 814, 1024, 1272, 1362, 1893, 2214, 2614, 2988, 3930, 4115, 4543, 5420, 6500, 7350, 8143, 9336, 10325, 11665, 11759, 13634, 14658, 15578, 16034, 16731, 17660, 18631, 19883]","[0, 278, 538, 815, 1153, 1520, 1979, 2269, 2906, 3592, 4038, 4291, 4649, 5102, 5795, 6151, 6830, 7095, 7701, 7989, 8967, 9369, 10280, 10607, 11414, 11974, 12444, 12830, 13126, 13702]","[0, 170, 260, 350, 489, 635, 846, 1026, 1304, 1495, 1721, 2248, 2679, 3120, 3389, 3892, 4893, 5270, 5531, 5795, 6430, 6999, 7859, 8190, 8646, 8812, 9324, 10270, 11127, 11538]","[0, 221, 382, 560, 897, 1073, 1163, 1343, 1621, 2100, 2392, 2766, 2987, 3150, 3443, 3849, 4281, 4735, 5298, 5393, 5846, 5940, 6441, 6665, 6961, 7127, 7458, 8361, 9027, 9874]",21503,19883,13702,11538,9874,14,113,71,53,26,"[0, 170, 968, 1323, 1578, 1887, 2675, 3085, 3220, 3710, 3940, 4812, 5063, 5811, 6768, 7236, 8014, 8940, 9139, 9940, 10997, 11533, 12066, 12753, 13562, 13896, 15574, 16296, 16392, 17303]","[0, 256, 491, 699, 1079, 1540, 1863, 2317, 2671, 3053, 3568, 4265, 5426, 6097, 6875, 7358, 7521, 8645, 9225, 9898, 10515, 11380, 11635, 12266, 12670, 13251, 13896, 14582, 14838, 15741]","[0, 252, 495, 877, 1089, 1417, 1866, 2256, 2707, 3144, 3800, 4153, 4406, 4794, 5293, 5437, 6311, 7396, 7958, 8384, 9196, 9413, 10178, 10491, 10746, 11621, 12217, 12683, 13335, 14449]","[0, 170, 312, 451, 541, 631, 840, 992, 1127, 1445, 1761, 1982, 2367, 3228, 3673, 3817, 4007, 4419, 4717, 5276, 5971, 6356, 6575, 7000, 7251, 7905, 8216, 8921, 9017, 9842]","[0, 214, 578, 712, 900, 1270, 1551, 1852, 2110, 2499, 2634, 2953, 3486, 3780, 4342, 4505, 4645, 5061, 5193, 5740, 6810, 6904, 7137, 7304, 7436, 7819, 8116, 8537, 8633, 9001]",17303,15741,14449,9842,9001,4200,4142,-747,1696,873,10164,30,radiant
7597334717,17,16,10,14,5,"[0, 376, 849, 1240, 1744, 2291, 2874, 3394, 3959, 4469, 5081, 5518, 5764, 6230, 7143, 8659, 9144, 9733, 10579, 11052, 11667, 12396, 13557, 14132, 14933, 15680, 17071, 18170, 18508, 18604]","[0, 245, 537, 1005, 1400, 1924, 2612, 3113, 3502, 4012, 4327, 5210, 5560, 6126, 6562, 7127, 8463, 8558, 9210, 9867, 10380, 10867, 11304, 11398, 12212, 12786, 13484, 13779, 14239, 14335]","[0, 290, 576, 834, 1172, 1503, 1877, 2347, 2711, 3387, 4089, 4319, 4893, 5331, 6061, 6694, 7274, 7857, 8226, 9006, 9407, 10834, 11073, 11271, 11414, 12506, 13023, 13631, 13916, 14012]","[0, 169, 302, 673, 809, 948, 1374, 1615, 1791, 2303, 2983, 3197, 3530, 3970, 4396, 4851, 5387, 5658, 5861, 6366, 6461, 6705, 7319, 7413, 8887, 9142, 9424, 9628, 9724, 9820]","[0, 203, 327, 462, 598, 747, 882, 1062, 1169, 1353, 1639, 1784, 1874, 1969, 2349, 2873, 3094, 3189, 3561, 3808, 3932, 4102, 4558, 4821, 5284, 5719, 5970, 6249, 6420, 6591]",18604,14335,14012,9820,6591,25,48,49,84,86,"[0, 313, 648, 1062, 1442, 1938, 2723, 3439, 4160, 4799, 5552, 6531, 7059, 7549, 8239, 8333, 8794, 9386, 9898, 10778, 12104, 12741, 13408, 14421, 14890, 15528, 16053, 17095, 18111, 20129]","[0, 266, 670, 1515, 1900, 2280, 2955, 3577, 3999, 4225, 4843, 5488, 6071, 6700, 7661, 8336, 8904, 9856, 10736, 11414, 12358, 13595, 14390, 15933, 16273, 16479, 17309, 18611, 19138, 21117]","[0, 266, 677, 1003, 1409, 1655, 2323, 3023, 3493, 3733, 4036, 4674, 5421, 5966, 6599, 7031, 7392, 8242, 8800, 9198, 9932, 10164, 10419, 11346, 11966, 12208, 12824, 13540, 14096, 15577]","[0, 194, 284, 579, 791, 940, 1230, 1736, 1941, 2112, 2437, 3024, 3195, 3494, 3912, 4006, 4469, 5079, 5533, 6191, 7272, 7442, 7904, 8585, 9270, 9365, 9799, 10316, 11462, 13092]","[0, 194, 284, 465, 644, 781, 1129, 1353, 1491, 1703, 2195, 2704, 2823, 3180, 3485, 3617, 4001, 4534, 4794, 5271, 6182, 6831, 7387, 8072, 8413, 8508, 8662, 8975, 9575, 11078]",20129,21117,15577,13092,11078,-1525,-6782,-1565,-3272,-4487,-17631,30,dire
7597391314,109,128,7,123,102,"[0, 204, 541, 1008, 1394, 1813, 2215, 2526, 3036, 3533, 3857, 4473, 4849, 5181, 5800, 6160, 6941, 7525, 8222, 9240, 10003, 10920, 11690, 11785, 12766, 13926, 14573, 15619, 15901, 16241]","[0, 280, 622, 1034, 1637, 2061, 2617, 3116, 3559, 3774, 4086, 4810, 5066, 5406, 6363, 7209, 7744, 8849, 9366, 9910, 10499, 11095, 11828, 11923, 13373, 14394, 15076, 15664, 15760, 16147]","[0, 362, 818, 1258, 1692, 2196, 2748, 3193, 3727, 4070, 4507, 4597, 5300, 5607, 6726, 6876, 7748, 8045, 8273, 8446, 8702, 9234, 10012, 10107, 10831, 12677, 13401, 14101, 14476, 14613]","[0, 170, 260, 398, 567, 706, 943, 1078, 1217, 1307, 1483, 2150, 2505, 2728, 3235, 3783, 4109, 4318, 4504, 4768, 5202, 5490, 5821, 5969, 6420, 7403, 8160, 8639, 9430, 9765]","[0, 170, 260, 399, 592, 780, 920, 1123, 1538, 1743, 1985, 2112, 2483, 2790, 3454, 3765, 4282, 4449, 4902, 4997, 5191, 5285, 5616, 5711, 6005, 6580, 6846, 7293, 7511, 7744]",16241,16147,14613,9765,7744,106,77,8,86,84,"[0, 366, 745, 1185, 1585, 2205, 2768, 3156, 3614, 4275, 4794, 5428, 6044, 6404, 7084, 7578, 7940, 8506, 9124, 9935, 10696, 12004, 13770, 15476, 16261, 16355, 17275, 18238, 19385, 20848]","[0, 246, 558, 1097, 1551, 1864, 2293, 2729, 3027, 3252, 3867, 4480, 4660, 5616, 5911, 6356, 7054, 7356, 8157, 9139, 9998, 10347, 11085, 11945, 12493, 12773, 13095, 14851, 15474, 16641]","[0, 241, 694, 1131, 1492, 1818, 2135, 2481, 2970, 3853, 4383, 5123, 5324, 5900, 6088, 6385, 6738, 7321, 8198, 8897, 9487, 10303, 11624, 11829, 12809, 12903, 13482, 13806, 14375, 15927]","[0, 213, 303, 468, 662, 865, 1054, 1162, 1416, 1724, 1949, 2383, 2563, 2711, 3152, 3247, 3342, 3459, 3910, 4477, 4572, 4929, 5772, 6997, 7320, 7414, 7656, 8029, 8720, 9897]","[0, 170, 260, 380, 515, 605, 855, 945, 1197, 1591, 1816, 2094, 2481, 2748, 2897, 2992, 3179, 3273, 3834, 4236, 4551, 4726, 5303, 6056, 6504, 6598, 7082, 7683, 8099, 9135]",20848,16641,15927,9897,9135,-4607,-494,-1314,-132,-1391,-7938,30,dire
7597714703,72,69,81,112,136,"[0, 404, 703, 1199, 1524, 1893, 2508, 3004, 3597, 4430, 5227, 5918, 6621, 7259, 8117, 8793, 9596, 10776, 11855, 12254, 12771, 13572, 14886, 15516, 16788, 16883, 17297, 17622, 18603, 18699]","[0, 273, 721, 1067, 1522, 1947, 2765, 3203, 3781, 4406, 4668, 5060, 5490, 6105, 6565, 7078, 7645, 8161, 8792, 9612, 9967, 10561, 10966, 11504, 12331, 12585, 13345, 13863, 14210, 16571]","[0, 236, 445, 831, 1162, 1678, 1964, 2254, 2416, 3236, 3510, 3971, 4541, 4814, 5412, 5808, 6693, 7382, 8228, 8808, 9530, 10218, 11025, 11245, 11883, 11978, 13574, 14471, 14567, 15606]","[0, 198, 335, 474, 655, 792, 1211, 1301, 1481, 1661, 2002, 2823, 2967, 3116, 3298, 3833, 4464, 5305, 5554, 6159, 6361, 6844, 7213, 7447, 7802, 8035, 8984, 9079, 9897, 9993]","[0, 198, 288, 494, 584, 722, 812, 993, 1479, 1688, 1917, 2148, 2339, 2543, 2690, 2784, 2988, 3446, 3589, 4140, 4282, 4637, 4866, 5008, 5363, 5458, 5753, 5894, 5990, 6208]",18699,16571,15606,9993,6208,106,42,123,93,33,"[0, 349, 551, 954, 1322, 1913, 2239, 2561, 2992, 3623, 4038, 4699, 5185, 5752, 6701, 7244, 8232, 8752, 9415, 11525, 12644, 13163, 14085, 14430, 15973, 16372, 17517, 18488, 19807, 20628]","[0, 226, 610, 868, 1257, 1703, 1901, 2259, 2537, 2905, 3146, 3694, 3983, 4720, 5119, 5398, 5920, 6471, 7027, 8016, 8616, 8969, 9477, 10103, 10936, 11653, 12467, 13624, 14911, 16551]","[0, 192, 332, 422, 720, 854, 1167, 1305, 1654, 1947, 2415, 2588, 2939, 3503, 3955, 4622, 5077, 5172, 5519, 6238, 7001, 7265, 7631, 8398, 8919, 9636, 10293, 11072, 11635, 11977]","[0, 354, 527, 940, 1183, 1406, 1746, 2139, 2506, 2919, 3447, 3796, 4414, 4899, 5748, 6140, 6772, 7408, 8031, 8749, 9582, 10587, 11205, 11825, 13444, 14538, 14678, 15211, 16247, 16468]","[0, 460, 550, 687, 893, 1322, 1602, 1796, 2235, 2603, 2990, 3264, 3533, 3807, 4458, 4796, 5366, 5567, 6121, 6513, 6958, 7475, 8057, 8311, 9120, 9611, 10124, 10701, 11255, 11824]",20628,16551,11977,16468,11824,-1929,20,3629,-6475,-5616,-10371,30,radiant
7598302418,21,19,53,96,100,"[0, 213, 574, 911, 1111, 1495, 2012, 2588, 3340, 4047, 4866, 5892, 6214, 6693, 7547, 9026, 9446, 10061, 10373, 12081, 12619, 12714, 13137, 13819, 14601, 15165, 15260, 15800, 16699, 18032]","[0, 242, 526, 935, 1347, 1606, 2105, 2829, 3596, 4022, 4366, 5005, 5312, 5638, 6497, 7069, 7725, 8148, 8529, 9520, 10228, 10834, 11680, 11959, 12631, 13123, 13264, 13929, 14533, 15323]","[0, 169, 476, 566, 656, 873, 1370, 1586, 1948, 2303, 2621, 3363, 3669, 3818, 4327, 4761, 5247, 5939, 6438, 7240, 8045, 8908, 9575, 9915, 10966, 12246, 12341, 13013, 13672, 14505]","[0, 169, 422, 666, 921, 1169, 1760, 2171, 2710, 2881, 3387, 3712, 4048, 4595, 4969, 5582, 6147, 6242, 6337, 6836, 7201, 7633, 8222, 9218, 9698, 9967, 11027, 11351, 11803, 12478]","[0, 169, 259, 394, 484, 623, 1035, 1359, 1494, 1711, 2186, 2516, 2606, 3026, 3475, 4063, 4319, 4948, 5081, 5422, 5662, 6070, 6402, 6890, 7527, 7739, 8076, 8282, 8569, 9067]",18032,15323,14505,12478,9067,25,10,123,129,20,"[0, 626, 918, 1291, 1633, 2033, 2645, 3081, 3616, 4050, 4653, 5089, 5635, 6126, 6859, 7594, 8171, 9262, 9879, 10427, 11307, 13155, 13789, 14616, 15244, 18597, 18854, 19590, 20951, 21047]","[0, 270, 579, 989, 1319, 1728, 2105, 2601, 3135, 3694, 4244, 4910, 5583, 6052, 6813, 7141, 7328, 7883, 8400, 9106, 9601, 10106, 10382, 11315, 11577, 12275, 13157, 13633, 14172, 14875]","[0, 234, 324, 682, 861, 1015, 1105, 1822, 2034, 2124, 2401, 2491, 2721, 2906, 3046, 3403, 3737, 3882, 4208, 4867, 5014, 5109, 5615, 6256, 6447, 8158, 8740, 8834, 9230, 9334]","[0, 254, 571, 900, 1244, 1564, 2044, 2378, 2699, 2965, 3100, 3383, 3681, 3944, 4341, 4436, 4610, 4962, 5827, 6105, 6822, 7021, 7362, 7922, 8302, 8843, 9878, 10257, 10434, 10787]","[0, 234, 324, 421, 556, 780, 882, 1315, 1479, 1746, 1881, 1971, 2587, 2772, 3046, 3289, 3703, 3986, 4278, 4641, 5189, 5792, 5887, 6099, 6193, 6495, 6775, 6943, 7315, 7602]",21047,14875,9334,10787,7602,-3015,448,5171,1691,1465,5760,30,radiant
7598302507,70,49,96,123,20,"[0, 241, 490, 894, 1157, 1611, 2175, 2301, 2504, 2893, 3255, 3866, 4316, 4912, 5399, 5815, 6521, 7160, 7762, 8739, 10031, 11026, 12082, 12545, 13441, 14291, 14933, 16295, 16485, 17018]","[0, 287, 480, 570, 695, 914, 1206, 1378, 1782, 2100, 2529, 2752, 3238, 3961, 4213, 4980, 5580, 5939, 6218, 7100, 7394, 8068, 8856, 9228, 9804, 10523, 10942, 12890, 13583, 14078]","[0, 243, 525, 813, 976, 1224, 1431, 1819, 2165, 2703, 3291, 3593, 4183, 5065, 5799, 6289, 6730, 6936, 7467, 7755, 8500, 8646, 9378, 9803, 10063, 10682, 10777, 12746, 13558, 14030]","[0, 170, 260, 401, 491, 702, 837, 1046, 1265, 1369, 1504, 1754, 2342, 2680, 2884, 3209, 3473, 3568, 3937, 4264, 4766, 5040, 5559, 6400, 6700, 6932, 7245, 8788, 9489, 10077]","[0, 219, 309, 483, 573, 737, 872, 996, 1086, 1356, 1566, 1921, 2194, 2528, 2719, 2893, 3363, 3664, 3852, 4179, 4815, 4910, 5236, 5418, 5628, 5832, 6129, 7417, 7600, 7696]",17018,14078,14030,10077,7696,18,59,69,105,26,"[292, 534, 841, 1191, 1527, 1799, 2435, 2894, 3337, 4001, 4767, 5319, 5880, 6827, 7592, 8353, 8950, 9828, 10845, 11743, 12686, 13347, 14185, 14524, 15341, 16210, 16751, 17154, 17617, 18584]","[159, 451, 852, 1304, 1687, 2141, 2785, 3265, 3738, 4274, 5009, 5403, 6155, 6746, 7647, 8449, 9283, 10542, 11317, 12198, 12352, 12636, 13287, 13973, 15018, 15958, 16610, 17551, 17790, 18380]","[159, 415, 994, 1196, 1569, 2010, 2303, 3050, 3661, 4165, 4785, 5185, 5864, 6473, 6912, 7319, 7745, 8154, 8719, 9456, 9972, 10227, 10825, 11352, 12207, 13084, 14212, 15111, 15671, 16633]","[527, 697, 832, 968, 1103, 1228, 1432, 1719, 1855, 2063, 2316, 2565, 2912, 3638, 3782, 4184, 4892, 5433, 5591, 5979, 6438, 6584, 6981, 7076, 7305, 7664, 7998, 8826, 9401, 9879]","[292, 462, 659, 834, 972, 1157, 1301, 1625, 1849, 2197, 2496, 2653, 2872, 3411, 3673, 3992, 4176, 4778, 4936, 5233, 5441, 5655, 5911, 6081, 6534, 7105, 7448, 8037, 8535, 9325]",18584,18380,16633,9879,9325,-1566,-4302,-2603,198,-1629,-9902,30,dire
7598355413,70,23,69,123,79,"[1, 282, 637, 952, 1361, 1773, 2370, 2809, 3108, 3415, 3646, 4229, 4749, 5859, 6330, 7100, 7726, 8815, 9542, 10315, 10985, 11080, 11655, 12398, 12902, 13827, 14524, 15399, 15747, 16954]","[1, 402, 695, 1185, 1681, 2013, 2182, 2477, 3097, 3749, 4267, 5226, 5837, 6544, 7076, 7243, 7783, 8086, 8624, 9133, 9527, 10100, 10729, 11066, 11333, 11849, 12216, 12618, 12977, 13183]","[1, 247, 405, 855, 1075, 1311, 1912, 2272, 2692, 2859, 3134, 3264, 3720, 4131, 4810, 5057, 5383, 5940, 6080, 6487, 6735, 7122, 8004, 8467, 8721, 9537, 10075, 11458, 11832, 11928]","[1, 171, 291, 500, 659, 789, 1134, 1270, 1360, 1633, 1984, 2123, 2361, 2802, 2897, 2992, 3499, 3699, 4206, 4971, 5352, 5618, 6449, 6675, 6790, 7639, 7800, 8202, 8402, 9053]","[1, 171, 291, 461, 597, 1042, 1262, 1665, 1769, 1859, 2402, 2492, 2708, 3265, 3499, 3744, 4195, 4493, 4676, 5281, 5686, 6013, 6470, 6810, 7019, 7417, 7678, 8155, 8664, 8835]",16954,13183,11928,9053,8835,21,97,40,96,85,"[1, 327, 657, 1031, 1629, 2141, 2404, 2880, 3372, 3791, 4491, 5034, 5633, 6180, 6702, 7906, 8702, 9010, 9716, 10252, 11187, 12138, 12467, 13086, 13972, 14527, 15330, 16929, 17865, 18404]","[1, 210, 571, 1102, 1521, 2038, 2412, 2917, 3540, 3903, 4185, 4466, 4916, 5156, 5420, 5713, 6168, 6812, 7702, 8389, 9463, 9946, 10625, 11063, 11892, 12094, 12705, 12800, 13372, 14075]","[1, 244, 574, 751, 999, 1410, 1839, 2027, 2411, 3004, 3336, 3879, 4085, 4179, 4519, 5394, 6040, 6637, 7533, 8128, 8994, 9411, 9859, 10287, 10766, 11220, 11315, 12069, 13124, 13767]","[1, 171, 261, 387, 524, 722, 961, 1051, 1305, 1495, 2180, 2669, 2924, 3194, 3632, 4074, 4644, 5249, 5832, 6053, 6522, 7186, 7410, 8214, 8398, 8944, 9039, 9345, 9603, 9787]","[1, 510, 600, 735, 1003, 1217, 1402, 1538, 1797, 1887, 2245, 2810, 2949, 3043, 3292, 3851, 4281, 4464, 4932, 5281, 6085, 6180, 6347, 6442, 6626, 6793, 6888, 7252, 7555, 7651]",18404,14075,13767,9787,7651,-1450,-892,-1839,-734,1184,-3731,30,radiant
7598478916,46,98,25,20,19,"[0, 280, 525, 868, 1061, 1435, 1790, 2097, 2466, 2681, 3077, 3852, 4377, 5166, 5787, 5955, 6413, 7172, 7794, 8665, 9020, 9857, 10583, 11725, 12486, 12844, 12938, 14210, 15209, 15638]","[0, 229, 509, 751, 1234, 1475, 1956, 2294, 2996, 3534, 3884, 4560, 5249, 5855, 6489, 6971, 7483, 8082, 8691, 9497, 9734, 10035, 10565, 11112, 11207, 12043, 12559, 13216, 13753, 14232]","[0, 276, 564, 805, 1242, 1370, 1868, 2111, 2585, 3027, 3665, 4028, 4678, 5229, 6173, 6753, 7613, 8493, 8750, 9703, 10257, 10553, 10647, 11547, 11981, 12224, 12479, 13047, 13401, 13640]","[0, 195, 686, 810, 900, 1260, 1350, 1440, 1783, 1987, 2309, 2501, 2681, 2922, 3092, 3186, 3462, 3705, 3844, 4239, 4380, 4533, 5181, 5611, 5781, 5951, 6120, 6476, 6728, 7114]","[0, 195, 285, 375, 530, 620, 830, 920, 1167, 1652, 1789, 2081, 2261, 2472, 2836, 3170, 3521, 3968, 4111, 4629, 4724, 4819, 5156, 5323, 5588, 5758, 5852, 6448, 6625, 6827]",15638,14232,13640,7114,6827,49,76,129,79,9,"[0, 244, 504, 872, 1217, 1638, 1919, 2510, 2671, 3111, 3694, 4050, 4868, 5381, 5816, 6718, 7398, 8512, 9299, 10047, 10287, 11361, 12022, 12716, 13747, 15248, 16474, 17189, 18714, 19666]","[0, 243, 540, 855, 1180, 1718, 2113, 2671, 3117, 3482, 4045, 4428, 4833, 5486, 5948, 6610, 7287, 7652, 8190, 8982, 9613, 10015, 11016, 11838, 12545, 13368, 14192, 15064, 16240, 17007]","[0, 294, 560, 1152, 1651, 1980, 2398, 2909, 3420, 3841, 4503, 4956, 5546, 5888, 6416, 6633, 7325, 7947, 8296, 8996, 9960, 10477, 10942, 11900, 12309, 13154, 13810, 14823, 15743, 16298]","[0, 170, 592, 765, 990, 1311, 1535, 1919, 2279, 2369, 2689, 2796, 3465, 4111, 4337, 4897, 5805, 6162, 6305, 6919, 7399, 7668, 8117, 8688, 9008, 10130, 10718, 11542, 12789, 13070]","[0, 170, 285, 419, 529, 718, 853, 1139, 1330, 1533, 1815, 2011, 2381, 2873, 3238, 3455, 4228, 4536, 5049, 5270, 5725, 6033, 6511, 7004, 7244, 8192, 8888, 9413, 10124, 10330]",19666,17007,16298,13070,10330,-4028,-2775,-2658,-5956,-3503,-18920,30,dire
7598915010,18,106,135,9,26,"[0, 207, 480, 771, 1149, 1407, 1925, 2251, 2530, 2759, 3216, 3486, 4041, 4544, 5243, 5598, 6416, 6902, 7896, 8044, 8522, 9252, 10024, 10945, 11532, 12513, 12690, 13344, 13525, 14608]","[0, 326, 574, 895, 1167, 1530, 1970, 2182, 2674, 3050, 3366, 3779, 4161, 4724, 5555, 5649, 6656, 6896, 7873, 8379, 8588, 8968, 9434, 9912, 10443, 11335, 11475, 12494, 12843, 13499]","[0, 323, 489, 836, 1296, 1622, 2039, 2604, 3132, 3591, 4069, 4476, 4801, 5210, 5789, 6019, 6506, 7119, 7541, 8298, 8555, 9309, 9899, 10260, 10478, 11285, 11687, 12119, 12392, 13066]","[0, 169, 259, 575, 838, 1194, 1453, 1608, 1791, 2164, 2569, 2934, 3103, 3519, 3868, 3962, 4215, 4678, 5132, 5841, 6173, 6506, 7082, 7370, 7942, 8149, 8562, 8877, 9070, 9513]","[0, 169, 259, 349, 514, 652, 916, 1104, 1453, 1772, 1944, 2168, 2258, 2620, 2979, 3073, 3168, 3495, 3590, 3945, 4040, 4386, 4778, 4972, 5218, 5921, 6141, 6235, 6375, 6762]",14608,13499,13066,9513,6762,48,129,97,105,112,"[0, 208, 525, 787, 1132, 1589, 2058, 2319, 2586, 2987, 3532, 4197, 4759, 5301, 6094, 6938, 7807, 8419, 9659, 10838, 12233, 13641, 14930, 15925, 16555, 17409, 20070, 21811, 23733, 24103]","[0, 244, 524, 856, 1174, 1736, 2233, 2694, 2888, 3238, 3694, 3983, 4989, 5501, 5983, 6722, 6978, 7650, 8740, 8879, 9620, 10464, 11435, 12021, 12251, 12544, 14455, 15401, 16219, 17441]","[0, 280, 576, 859, 1344, 1711, 2286, 2950, 3407, 3893, 4394, 4816, 5513, 6105, 6650, 7532, 7884, 8824, 9490, 9584, 10612, 10908, 11862, 12717, 13379, 13976, 15433, 16072, 16783, 17153]","[0, 218, 308, 755, 845, 1076, 1373, 1508, 2000, 2197, 2332, 2422, 3018, 3325, 3467, 4678, 4836, 5315, 6208, 7146, 7991, 8158, 8541, 8635, 8865, 9042, 9952, 11331, 12207, 13073]","[0, 169, 307, 397, 740, 904, 1128, 1263, 1779, 1950, 2230, 2468, 3008, 3302, 3397, 3984, 4142, 4477, 5363, 5775, 6184, 7007, 7969, 8256, 8549, 9246, 10185, 10766, 12287, 12583]",24103,17441,17153,13073,12583,-9495,-3942,-4087,-3560,-5821,-26905,30,dire
7599033210,96,128,93,123,86,"[0, 655, 1102, 1354, 1606, 1992, 2408, 2786, 3166, 3569, 3924, 4593, 5158, 5589, 6250, 7015, 7327, 7537, 8334, 9752, 10271, 10599, 11402, 11890, 12487, 12835, 13134, 13867, 13963, 14315]","[0, 429, 719, 1093, 1471, 1876, 2298, 2619, 3023, 3273, 3601, 4339, 4811, 5374, 5778, 6580, 6859, 7152, 7407, 8031, 8700, 9375, 10217, 10903, 11423, 11882, 11977, 12401, 12497, 13178]","[0, 315, 637, 971, 1216, 1612, 1857, 1947, 2483, 2603, 3269, 3761, 4298, 5001, 5615, 6048, 6772, 7179, 7274, 8245, 8488, 9353, 10015, 10183, 10752, 11298, 12091, 12812, 12908, 13062]","[0, 303, 536, 665, 755, 958, 1320, 1492, 1710, 1847, 1937, 2295, 2479, 2734, 2874, 3053, 3648, 4106, 4371, 4819, 5355, 5503, 5985, 6158, 6455, 6767, 6862, 7128, 7551, 7647]","[0, 254, 344, 454, 583, 757, 847, 937, 1117, 1293, 1383, 1632, 1817, 2072, 2181, 2275, 2921, 3179, 3291, 3421, 4053, 4597, 4819, 5160, 5316, 6338, 6657, 6832, 6928, 7280]",14315,13178,13062,7647,7280,41,106,23,20,21,"[0, 164, 438, 841, 1168, 1446, 1557, 1898, 2230, 2608, 3098, 3646, 4145, 5064, 5632, 6298, 7166, 7787, 8512, 9094, 10065, 10919, 11449, 12774, 13455, 14435, 15093, 16650, 18268, 19987]","[0, 201, 516, 881, 1207, 1775, 2074, 2638, 3288, 3547, 3717, 4401, 4858, 5291, 5912, 6824, 7365, 8942, 9943, 10795, 11580, 12329, 12932, 13330, 13968, 15182, 15475, 16328, 17313, 18301]","[0, 168, 507, 831, 999, 1504, 1755, 2317, 2688, 3270, 3730, 4326, 5250, 5970, 6539, 6848, 7599, 8263, 9026, 9345, 9899, 10288, 10455, 11443, 11895, 12979, 13397, 14005, 14777, 15470]","[0, 129, 291, 381, 567, 909, 1016, 1369, 1684, 1774, 2256, 2796, 3017, 3665, 4171, 4480, 4740, 4898, 5320, 5598, 6020, 6403, 7021, 7590, 8151, 8668, 8809, 9737, 10333, 10666]","[0, 129, 244, 346, 486, 794, 933, 1530, 1688, 1883, 2073, 2258, 2348, 2967, 3531, 3840, 4100, 4535, 5383, 5920, 6247, 6497, 6829, 7487, 7775, 8469, 8813, 9357, 9730, 10279]",19987,18301,15470,10666,10279,-5672,-5123,-2408,-3019,-2999,-19221,30,dire
7599079114,1,17,16,14,3,"[0, 255, 520, 924, 1291, 1707, 2119, 2279, 2451, 3574, 4008, 4394, 4965, 5545, 6203, 6552, 7299, 8093, 8681, 9978, 10988, 12061, 12911, 13946, 14815, 16962, 18357, 19597, 21371, 22107]","[0, 325, 652, 1069, 1483, 1939, 2357, 2805, 3906, 4607, 5219, 5822, 6458, 7027, 7522, 7938, 8783, 9424, 10259, 11654, 12032, 12917, 13769, 14045, 14347, 15234, 16566, 17231, 17722, 17983]","[0, 211, 606, 1064, 1433, 1844, 2126, 2706, 3743, 4138, 4570, 4907, 5596, 6325, 6879, 7267, 7960, 9265, 9710, 10130, 10471, 11332, 11790, 12130, 12643, 13734, 14485, 14828, 15956, 16201]","[0, 90, 275, 766, 1200, 1578, 1717, 2072, 2162, 2868, 3223, 3568, 3772, 4013, 4420, 4587, 5171, 5460, 5808, 6128, 6223, 6685, 7060, 7202, 7343, 7527, 8172, 8311, 8885, 8981]","[0, 90, 180, 317, 455, 545, 635, 836, 1138, 1580, 1761, 2141, 2654, 2856, 3490, 3585, 4158, 4447, 4661, 5012, 5107, 5201, 5414, 5553, 5648, 6728, 7431, 7526, 8246, 8379]",22107,17983,16201,8981,8379,46,120,2,84,26,"[0, 280, 651, 1021, 1265, 1664, 2167, 2780, 3300, 3601, 4426, 5050, 5445, 5990, 6685, 7269, 8522, 9204, 10058, 11076, 12480, 13190, 14324, 16603, 17409, 18071, 18166, 18931, 20345, 20441]","[0, 367, 700, 1113, 1645, 2025, 2725, 3355, 3956, 4524, 4913, 5394, 5604, 6163, 6679, 7251, 7731, 8172, 8899, 9751, 10848, 11165, 11961, 12915, 13568, 14421, 14516, 15315, 16884, 17247]","[0, 279, 599, 877, 1253, 1541, 1845, 2336, 2658, 3306, 3684, 3971, 4501, 4822, 5055, 5984, 6205, 6299, 6875, 7429, 7883, 7977, 8235, 8989, 9156, 9445, 9631, 9726, 10155, 10251]","[0, 210, 300, 483, 610, 720, 884, 1064, 1272, 1379, 1690, 1874, 1964, 2094, 2223, 2548, 2769, 3039, 3261, 3781, 4144, 4335, 4430, 5138, 5409, 5620, 5754, 5879, 6877, 7289]","[0, 210, 347, 437, 573, 663, 753, 938, 1074, 1266, 1451, 1762, 1852, 2281, 2376, 2774, 3043, 3137, 3359, 3702, 4172, 4266, 4361, 5069, 5307, 5551, 5684, 5863, 6597, 6693]",20441,17247,10251,7289,6693,1666,736,5950,1692,1686,11730,30,radiant
7599121510,19,10,98,26,83,"[0, 370, 698, 1106, 1525, 1972, 2420, 2995, 3385, 3976, 4414, 5075, 5552, 6373, 6540, 7217, 8271, 9315, 9802, 10530, 11181, 11740, 13322, 13945, 14414, 15063, 15984, 16557, 17486, 17582]","[0, 242, 555, 885, 1295, 1679, 1927, 2697, 2898, 3310, 3595, 4052, 4612, 5124, 5641, 6154, 7468, 8220, 9259, 10417, 10794, 11291, 12315, 13111, 13767, 14540, 14957, 15052, 15662, 15975]","[0, 329, 689, 1013, 1395, 1722, 2304, 2498, 2662, 3088, 3375, 4031, 4727, 5349, 5443, 6353, 7007, 7598, 8023, 9298, 9620, 10620, 11294, 11693, 12875, 13387, 13619, 14243, 14975, 15896]","[0, 382, 472, 562, 697, 831, 1093, 1216, 1306, 1519, 1609, 1973, 2201, 2841, 3016, 3373, 3972, 4305, 4637, 5234, 5624, 6260, 6699, 6892, 7062, 7417, 7587, 8326, 8461, 8813]","[0, 170, 260, 394, 586, 951, 1131, 1528, 1662, 1886, 2013, 2150, 2400, 3075, 3301, 3654, 4639, 4852, 5398, 6013, 6189, 6513, 6750, 7040, 7363, 7662, 7757, 8160, 8445, 8748]",17582,15975,15896,8813,8748,46,11,14,30,5,"[0, 281, 686, 825, 1445, 1842, 2084, 2664, 3314, 3543, 4277, 4616, 5154, 5864, 6481, 7142, 7919, 8645, 9258, 9891, 11132, 12509, 12987, 13842, 14581, 15642, 16532, 18101, 19677, 20177]","[0, 414, 895, 1264, 1799, 2232, 2743, 3408, 4154, 4415, 5108, 5727, 6387, 7064, 8243, 8819, 9167, 9461, 9718, 10674, 11420, 12120, 12499, 13183, 14310, 15347, 16831, 18723, 20130, 20581]","[0, 241, 526, 786, 1210, 1740, 2101, 2486, 3007, 3553, 4198, 4847, 5360, 5920, 6791, 7006, 7482, 7749, 8250, 8913, 9171, 9858, 10163, 11128, 11295, 12224, 12786, 13518, 14046, 14508]","[0, 170, 296, 434, 818, 1176, 1311, 1539, 1911, 2111, 2980, 3070, 3398, 3637, 3879, 4275, 4472, 4566, 4661, 5145, 5710, 6360, 6672, 7456, 7829, 8098, 8768, 9454, 10406, 10969]","[0, 510, 649, 862, 1339, 1508, 1643, 2120, 2255, 2382, 2607, 2885, 3155, 3351, 3499, 3752, 3994, 4124, 4219, 4519, 4826, 5390, 5587, 5762, 5977, 6374, 6636, 7164, 7951, 8182]",20177,20581,14508,10969,8182,-2595,-4606,1388,-2156,566,-7403,30,dire
7600037606,4,129,126,31,27,"[0, 287, 666, 1028, 1313, 1533, 1794, 2239, 2526, 3291, 3771, 4161, 4730, 5238, 5709, 6577, 7596, 8514, 9382, 10283, 11038, 12222, 13039, 14012, 14836, 15340, 16097, 16297, 16447, 17323]","[0, 217, 739, 967, 1410, 1609, 2030, 2542, 2833, 3250, 3826, 4502, 5030, 5472, 6210, 6668, 7176, 7437, 7705, 8551, 9223, 9538, 10456, 11260, 11895, 12742, 13208, 13621, 14195, 14439]","[0, 362, 565, 788, 1202, 1488, 1945, 2523, 2905, 3571, 3751, 4395, 4700, 5489, 6128, 6623, 6922, 7297, 7630, 8180, 8678, 8773, 9271, 9920, 10208, 10530, 10760, 10960, 11273, 11706]","[0, 169, 329, 419, 509, 600, 739, 930, 1020, 1349, 1529, 1854, 2348, 2443, 2678, 2911, 3276, 3481, 3793, 4380, 4518, 4688, 5341, 6018, 6222, 6574, 6879, 7154, 7542, 8009]","[0, 169, 326, 416, 599, 689, 824, 1049, 1139, 1383, 1563, 1861, 2187, 2282, 2517, 3028, 3347, 3500, 3925, 4285, 4427, 4522, 4914, 5008, 5103, 5951, 6181, 6275, 6371, 6548]",17323,14439,11706,8009,6548,34,41,96,110,86,"[0, 243, 583, 967, 1251, 1511, 2013, 2257, 2664, 3024, 3759, 4010, 4315, 5173, 5894, 6464, 6841, 7291, 7483, 7819, 8155, 8400, 8741, 8835, 9553, 10485, 11194, 12389, 12663, 13196]","[0, 207, 493, 829, 1188, 1508, 1666, 2063, 2465, 2748, 3199, 3435, 4017, 4525, 5277, 5936, 6589, 7183, 7778, 8278, 9075, 9642, 10013, 10894, 11510, 12275, 12786, 14136, 14595, 15087]","[0, 207, 861, 1138, 1637, 2002, 2324, 2632, 3261, 3657, 4106, 4600, 5400, 6044, 6398, 7529, 8278, 8856, 9286, 9707, 10137, 10700, 11373, 11467, 11562, 11833, 11967, 13394, 13632, 13820]","[0, 169, 259, 426, 574, 710, 848, 938, 1073, 1236, 1581, 1671, 1846, 2088, 2731, 3054, 3376, 3832, 4265, 4748, 5092, 5314, 5501, 5888, 6271, 6456, 6760, 7734, 7914, 8204]","[0, 169, 336, 426, 652, 795, 885, 975, 1284, 1447, 1898, 2032, 2675, 3136, 3676, 3999, 4367, 4618, 4767, 5274, 5369, 5464, 5651, 5745, 6232, 6417, 6750, 7632, 8023, 8519]",13196,15087,13820,8204,8519,4127,-648,-2114,-195,-1971,-801,30,radiant
7600161008,114,60,21,14,86,"[0, 344, 635, 1087, 1466, 2271, 2659, 3204, 3712, 4399, 4799, 5228, 5318, 5645, 5794, 6216, 7025, 7712, 8350, 9234, 10106, 11222, 11977, 12855, 13209, 13304, 13560, 13861, 14500, 16066]","[0, 297, 499, 881, 1078, 1208, 1459, 1981, 2545, 3042, 3711, 4104, 4581, 5081, 5573, 5939, 6235, 6786, 7969, 8490, 9230, 9729, 10110, 10784, 11017, 11339, 11912, 12337, 12920, 14263]","[0, 382, 717, 1053, 1414, 1664, 1913, 2468, 3099, 3562, 3950, 4150, 4502, 5227, 5893, 6284, 7045, 7626, 8963, 9322, 10086, 10550, 11365, 12319, 12975, 13706, 14172, 15052, 15663, 17127]","[0, 260, 350, 440, 916, 1046, 1469, 1884, 2051, 2190, 2540, 2911, 3145, 3472, 3621, 3716, 4062, 4416, 5194, 5431, 6190, 6357, 6733, 7059, 7153, 7248, 7647, 7946, 8123, 8698]","[0, 260, 394, 484, 574, 704, 847, 1090, 1304, 1495, 2183, 2343, 2739, 3005, 3227, 3361, 3518, 3911, 4513, 4974, 5216, 5383, 5692, 5969, 6063, 6158, 6253, 6402, 6746, 7548]",16066,14263,17127,8698,7548,18,97,69,58,45,"[0, 167, 538, 628, 996, 1309, 1694, 1998, 2498, 2862, 3295, 4068, 4565, 5362, 6629, 7180, 8278, 9069, 9254, 10595, 11143, 11238, 12127, 12665, 13718, 14519, 15942, 16642, 17808, 18699]","[0, 239, 486, 664, 862, 952, 1215, 1395, 1802, 2025, 2901, 3289, 3774, 4076, 4955, 5190, 5750, 5930, 6554, 6904, 7091, 7186, 7661, 8333, 8892, 9270, 9968, 10498, 11220, 11731]","[0, 164, 437, 688, 969, 1377, 1768, 1963, 2188, 2397, 2874, 3423, 3646, 3870, 4349, 4856, 5696, 6228, 6413, 7322, 7658, 7753, 7953, 8452, 8973, 9251, 10097, 10625, 10958, 11905]","[0, 130, 220, 438, 830, 1026, 1929, 2154, 2262, 2393, 2501, 2785, 2929, 3302, 3753, 4094, 4476, 4632, 4977, 5338, 5634, 5811, 6293, 6835, 7246, 7464, 8180, 8605, 9034, 9479]","[0, 130, 220, 316, 453, 627, 798, 1288, 1378, 1591, 1932, 2177, 2321, 2461, 3146, 3241, 3991, 4173, 4756, 5297, 5567, 5662, 5757, 6007, 6368, 6685, 6890, 7176, 7512, 7975]",18699,11731,11905,9479,7975,-2633,2532,5222,-781,-427,3913,30,radiant
7600393009,48,22,129,30,84,"[0, 294, 555, 895, 1300, 1532, 1798, 2941, 3340, 3805, 4452, 5020, 5769, 6573, 7452, 8290, 9169, 9263, 10419, 11354, 11624, 13112, 13594, 14252, 15303, 16350, 16445, 18095, 19186, 19282]","[0, 253, 585, 1009, 1384, 1801, 2543, 3142, 3825, 4464, 5132, 5627, 6522, 7039, 7764, 8495, 9170, 9742, 9990, 10922, 11592, 12105, 12686, 13244, 13626, 14406, 14699, 15296, 16256, 16953]","[0, 212, 758, 1063, 1374, 1843, 2203, 2821, 3151, 3503, 3873, 4263, 5004, 5471, 6030, 6866, 7700, 8295, 9167, 9621, 9716, 10281, 11120, 11675, 12017, 13017, 13310, 14415, 14875, 14971]","[0, 130, 297, 387, 477, 801, 891, 1111, 1292, 1636, 1869, 1997, 2321, 2551, 2905, 3250, 4090, 4388, 5519, 6084, 7109, 7877, 8372, 8822, 9171, 9397, 9959, 10243, 10932, 11232]","[0, 130, 220, 395, 531, 621, 757, 1168, 1343, 1496, 1977, 2188, 3043, 3224, 3480, 3867, 4474, 4912, 5534, 6105, 6788, 7429, 7524, 7824, 8077, 8171, 8504, 10011, 10477, 10733]",19282,16953,14971,11232,10733,1,39,38,123,83,"[0, 293, 619, 1267, 1635, 2044, 2323, 2817, 3142, 3737, 4386, 4952, 5351, 5749, 6811, 7482, 8437, 9504, 10308, 11447, 12172, 12818, 14205, 14891, 16176, 16911, 19131, 20171, 21789, 22729]","[0, 405, 696, 893, 1269, 1646, 2084, 2627, 3014, 3600, 4184, 4712, 5066, 5817, 6550, 7131, 7274, 8187, 9037, 9982, 10602, 11896, 12975, 13574, 15053, 15554, 16518, 17124, 17645, 18339]","[0, 247, 495, 788, 1187, 1672, 1909, 2330, 2543, 2943, 3292, 3419, 3550, 4558, 5260, 5673, 6710, 8161, 8594, 8991, 9483, 9792, 10550, 11133, 11698, 12620, 13068, 13544, 14326, 14680]","[0, 210, 339, 473, 635, 806, 1080, 1344, 1584, 1674, 1975, 2065, 2236, 2501, 2893, 3157, 3568, 4039, 4390, 4693, 5450, 6105, 6505, 6600, 7818, 8530, 9243, 9700, 9977, 10222]","[0, 210, 406, 607, 777, 948, 1300, 1525, 1661, 2014, 2343, 2518, 2780, 3045, 3355, 3582, 4080, 4476, 5064, 5323, 5526, 5919, 6319, 6414, 7307, 8132, 9448, 9543, 10245, 10476]",22729,18339,14680,10222,10476,-3447,-1386,291,1010,257,-3275,30,dire
7600480014,48,120,97,86,79,"[0, 243, 640, 1021, 1347, 1751, 2169, 2652, 3156, 3767, 4329, 5046, 5436, 6512, 7277, 8088, 8793, 9923, 10346, 10756, 11789, 12361, 12836, 12931, 13516, 14153, 14247, 15252, 16122, 16946]","[0, 204, 535, 824, 1285, 1658, 2202, 2547, 3087, 3496, 3764, 4293, 4639, 5008, 5595, 5920, 6383, 7425, 8008, 8557, 9880, 10308, 10716, 11537, 12476, 13380, 14156, 14810, 15398, 15948]","[0, 252, 602, 886, 1213, 1541, 2016, 2536, 3147, 3397, 3790, 4403, 4648, 5245, 5867, 6266, 6466, 7369, 7749, 8409, 8504, 9357, 9451, 9943, 10287, 10942, 11036, 11592, 11769, 11913]","[0, 170, 655, 766, 901, 1108, 1322, 1452, 1715, 1972, 2107, 2327, 2417, 2814, 2995, 3539, 3761, 4518, 4880, 5471, 5928, 6023, 6117, 6483, 6617, 7071, 7368, 7555, 7787, 7883]","[0, 170, 260, 394, 484, 841, 1025, 1204, 1385, 1503, 1691, 2105, 2516, 2956, 3180, 3385, 3675, 4220, 4343, 4437, 4578, 4754, 5035, 5322, 5417, 5818, 5912, 6284, 6591, 6687]",16946,15948,11913,7883,6687,106,93,23,123,105,"[0, 279, 562, 918, 1289, 1613, 1864, 2368, 2698, 3190, 3575, 4122, 4644, 5206, 5772, 6314, 7062, 7405, 8033, 8481, 9242, 10073, 10696, 10992, 11622, 12369, 14088, 14623, 14759, 15106]","[0, 323, 533, 889, 979, 1464, 1712, 2018, 2277, 2778, 3290, 3856, 4418, 5207, 5697, 6363, 7426, 7725, 8607, 9101, 9577, 10666, 11391, 12573, 13536, 14127, 14512, 15503, 16349, 17154]","[0, 209, 616, 895, 1263, 1393, 1959, 2410, 2908, 3616, 4245, 4805, 5828, 6465, 6966, 7165, 8054, 8315, 9187, 9624, 10034, 10775, 11487, 12005, 12770, 13466, 14366, 15218, 15841, 16485]","[0, 270, 573, 663, 821, 1027, 1403, 1586, 1676, 1961, 2119, 2586, 3072, 3311, 3488, 3843, 4510, 4814, 5225, 5764, 6009, 6651, 7058, 7803, 8535, 8952, 10133, 10518, 10910, 11735]","[0, 170, 311, 425, 515, 645, 851, 1457, 1580, 1948, 2083, 2390, 3011, 3498, 3935, 4255, 4725, 4904, 5575, 6034, 6411, 7003, 7316, 7687, 8251, 8582, 9217, 9754, 9925, 10334]",15106,17154,16485,11735,10334,1840,-1206,-4572,-3852,-3647,-11437,30,dire
7600548215,19,48,98,66,5,"[0, 252, 522, 845, 1250, 1660, 2039, 2669, 2992, 3530, 4117, 4442, 4719, 5258, 5643, 6112, 6542, 7264, 7359, 8194, 9675, 10460, 12103, 12407, 13260, 13846, 14594, 15737, 15941, 17313]","[0, 208, 489, 816, 1109, 1280, 1562, 2494, 2940, 3239, 3617, 3881, 4260, 4636, 5182, 5500, 6502, 7134, 7868, 8518, 10078, 10895, 11766, 12731, 13448, 14656, 15827, 16230, 16847, 18081]","[0, 206, 588, 1294, 1593, 2058, 2471, 3123, 3379, 3625, 5136, 5599, 6213, 6819, 7121, 7216, 8193, 8492, 9019, 9114, 11181, 11845, 12912, 13345, 14391, 14989, 15569, 15951, 16079, 16394]","[0, 170, 260, 434, 585, 904, 1172, 1574, 1895, 2161, 2569, 2994, 3460, 3609, 3743, 3901, 4291, 4707, 4865, 5539, 6829, 7461, 7882, 8151, 9120, 9783, 10162, 11053, 11186, 11282]","[0, 170, 347, 839, 979, 1107, 1197, 1369, 1663, 1802, 2183, 2360, 2782, 4089, 4436, 4531, 5945, 6040, 6135, 7159, 7728, 8814, 9512, 9816, 10451, 10960, 11055, 11239, 11335, 11544]",17313,18081,16394,11282,11544,90,69,93,20,26,"[56, 237, 396, 778, 1113, 1552, 2033, 2622, 3129, 3779, 4473, 5593, 7105, 7728, 8445, 9285, 10570, 11541, 12692, 13589, 13683, 14474, 15429, 16190, 17056, 18506, 19156, 19466, 21148, 21973]","[56, 146, 351, 575, 902, 1194, 1715, 2037, 2177, 2831, 3159, 3672, 4792, 5200, 6044, 6702, 7042, 7923, 8605, 9107, 9223, 9862, 10566, 11014, 12115, 13349, 14069, 14588, 15731, 16654]","[56, 219, 849, 1249, 1696, 2270, 2798, 3047, 3816, 4632, 5284, 5758, 6858, 7077, 7839, 8324, 9152, 9639, 10697, 11098, 11192, 11756, 12201, 12721, 12816, 13229, 13529, 13813, 14694, 14925]","[56, 146, 507, 861, 1309, 1843, 2205, 2900, 3202, 3506, 3669, 3989, 4173, 4376, 4781, 5391, 5924, 6186, 6551, 6646, 6740, 6907, 7160, 7326, 7421, 8543, 8638, 8922, 9715, 9946]","[324, 414, 706, 875, 1119, 1471, 1606, 1819, 2036, 2288, 2580, 3290, 3551, 3754, 4147, 4341, 4740, 5039, 5597, 5840, 5934, 6116, 6398, 6564, 6659, 7267, 7362, 7971, 8148, 8431]",21973,16654,14925,9946,8431,-4660,1427,1469,1336,3113,2685,30,radiant
7600575200,18,49,19,53,26,"[0, 260, 582, 906, 1399, 1857, 2380, 2835, 3386, 3963, 4534, 5196, 6068, 6713, 7359, 8049, 9066, 9978, 11704, 12675, 13539, 14588, 14822, 15258, 15352, 15745, 16595, 16753, 17040, 17136]","[0, 221, 471, 800, 1014, 1176, 1758, 2298, 2546, 3070, 3620, 3937, 4672, 5501, 5929, 6362, 7013, 7288, 7942, 8686, 9216, 9667, 10498, 10849, 11458, 11742, 12967, 13061, 13662, 14136]","[0, 240, 450, 774, 1073, 1394, 1725, 2052, 2427, 2812, 3100, 3663, 3948, 4237, 4460, 5009, 5575, 6142, 6481, 6893, 7185, 7513, 8013, 8382, 9524, 11040, 11907, 12001, 12831, 13091]","[0, 170, 260, 721, 855, 945, 1201, 1291, 1429, 1688, 1870, 2318, 2632, 3089, 3366, 3715, 4416, 4794, 5240, 5546, 6035, 6350, 6944, 7349, 8430, 9298, 9887, 10110, 10657, 10865]","[0, 170, 299, 389, 479, 569, 749, 839, 973, 1063, 1198, 1372, 1601, 2193, 2360, 2501, 3084, 3484, 3627, 4039, 4198, 4359, 4529, 4699, 5466, 6134, 6697, 7014, 7543, 7810]",17136,14136,13091,10865,7810,81,86,95,27,126,"[0, 206, 541, 960, 1249, 1699, 2141, 2676, 3331, 3893, 4363, 5265, 5826, 6433, 7001, 7861, 8728, 9827, 10136, 11191, 12170, 13355, 13978, 15197, 16174, 16595, 18153, 19281, 20719, 20815]","[0, 256, 646, 926, 1181, 1392, 1518, 1860, 2572, 2977, 3426, 3943, 4324, 4740, 5248, 5869, 6292, 7809, 8351, 8581, 10182, 11248, 11891, 12590, 13542, 13768, 14235, 15162, 17438, 17668]","[0, 329, 632, 887, 1329, 1750, 2187, 2412, 2930, 3323, 3857, 4198, 4509, 4984, 5317, 5910, 6483, 7076, 7809, 8108, 8814, 9500, 10637, 11323, 12052, 12541, 13124, 15246, 16864, 17493]","[0, 170, 260, 399, 540, 901, 1037, 1176, 1621, 1845, 1980, 2250, 2482, 2905, 3375, 3525, 3865, 4696, 4791, 5323, 5417, 5957, 6303, 6685, 7541, 7977, 8339, 8549, 9966, 10152]","[0, 170, 260, 398, 488, 706, 845, 1029, 1317, 1407, 1542, 1877, 2366, 2633, 2826, 2981, 3381, 3932, 4027, 4185, 4435, 4907, 5289, 6021, 6596, 6711, 7017, 8432, 9253, 9626]",20815,17668,17493,10152,9626,-3679,-3532,-4402,713,-1816,-12716,30,radiant
7600731101,4,22,48,51,65,"[0, 210, 457, 857, 1142, 1370, 1585, 2515, 2605, 2927, 3678, 4696, 5285, 6060, 6804, 6934, 7621, 8282, 8638, 9722, 10584, 11206, 12038, 12529, 13653, 13748, 14757, 16176, 17784, 18547]","[0, 295, 648, 1107, 1568, 1961, 2413, 3136, 3586, 3968, 4366, 5084, 5438, 5989, 6462, 7015, 7606, 8666, 9511, 9937, 11030, 11592, 12039, 12601, 13290, 13772, 15332, 16767, 18543, 19032]","[0, 315, 599, 1036, 1288, 1631, 1992, 2416, 2895, 3335, 4118, 4819, 5451, 6120, 6828, 7634, 8530, 9603, 9954, 10792, 11497, 11835, 12595, 13557, 14373, 15092, 16155, 16379, 17403, 18502]","[0, 210, 300, 570, 781, 931, 1189, 1431, 1820, 2160, 3006, 3301, 3525, 3985, 4594, 4689, 4953, 5427, 6090, 7228, 7395, 8375, 8500, 8595, 9094, 9356, 10222, 10317, 11865, 12587]","[0, 210, 300, 507, 646, 736, 864, 1248, 1338, 1550, 2018, 2678, 3112, 3470, 3820, 3952, 4258, 4914, 5189, 5882, 6106, 6530, 6796, 7081, 7672, 7803, 8418, 8714, 9192, 9956]",18547,19032,18502,12587,9956,17,93,96,79,20,"[0, 283, 702, 1153, 1650, 2096, 2506, 2853, 3457, 3863, 4441, 4954, 5654, 6306, 6794, 8271, 8990, 9259, 10066, 10730, 10887, 11383, 12266, 12635, 14523, 15183, 16138, 16233, 17026, 17212]","[0, 243, 500, 741, 1187, 1751, 2039, 2543, 2932, 3294, 3714, 3942, 4591, 5156, 5711, 6188, 6732, 7517, 8129, 8939, 9876, 10448, 11502, 12179, 13027, 13863, 15163, 15258, 15880, 16608]","[0, 165, 417, 944, 1434, 1805, 2399, 2941, 3347, 3796, 4242, 4632, 5146, 5748, 6139, 6638, 7237, 7567, 8191, 8825, 10102, 10399, 11170, 11559, 12909, 13258, 14409, 14504, 14916, 15102]","[0, 130, 220, 857, 1079, 1386, 1573, 1797, 1918, 2135, 2516, 2754, 3392, 3649, 4190, 4789, 5192, 5461, 5759, 6250, 7136, 7372, 8503, 8772, 10130, 10386, 11507, 11723, 11900, 12301]","[0, 130, 220, 353, 557, 762, 852, 1127, 1403, 1512, 1782, 1872, 2045, 2519, 2965, 3201, 3753, 3972, 4373, 4808, 5330, 5585, 6352, 6496, 6925, 7178, 7772, 7867, 8272, 8458]",17212,16608,15102,12301,8458,1335,2424,3400,286,1498,8943,30,radiant
7600736706,62,54,35,72,3,"[0, 212, 555, 893, 1248, 1709, 2122, 2481, 2736, 3188, 3727, 4246, 4513, 5101, 6116, 6784, 7141, 7682, 8515, 9070, 10024, 10625, 12061, 13432, 14163, 14316, 16058, 17510, 18247, 18379]","[0, 199, 522, 775, 1547, 1834, 2451, 2931, 3622, 3970, 4421, 5184, 5982, 7062, 8099, 8920, 9275, 10079, 11069, 11739, 11896, 12444, 13204, 13593, 14250, 14449, 15975, 16598, 16843, 17139]","[0, 280, 531, 913, 1176, 1520, 2068, 2608, 3353, 4467, 5047, 5856, 6526, 7038, 7625, 8724, 9860, 10262, 10668, 10924, 11650, 12181, 12276, 13579, 14756, 14851, 15840, 16111, 16330, 16613]","[0, 130, 220, 310, 447, 627, 717, 852, 1032, 1250, 1429, 1519, 1663, 1950, 2305, 2620, 2777, 2956, 3225, 3644, 4359, 4538, 4678, 5710, 6309, 6474, 7286, 7752, 7848, 7991]","[0, 130, 220, 310, 532, 907, 1244, 1442, 1622, 1793, 1977, 2067, 2423, 2572, 2867, 3292, 3647, 3809, 3976, 4238, 4476, 4571, 4814, 5091, 5295, 5390, 5706, 5800, 6105, 6201]",18379,17139,16613,7991,6201,10,22,2,9,43,"[0, 292, 654, 1019, 1438, 1890, 2544, 3125, 3968, 4268, 4774, 5195, 5961, 6577, 7148, 7737, 9082, 9519, 10702, 11199, 11830, 12514, 13612, 15129, 16353, 17825, 18469, 19011, 20119, 21563]","[0, 170, 430, 804, 1138, 1502, 1788, 2520, 3400, 3649, 4088, 4838, 5335, 5828, 6575, 6670, 7569, 8708, 9539, 9817, 10557, 11283, 11832, 12227, 13470, 14549, 15966, 16060, 17606, 18158]","[0, 242, 486, 798, 924, 1370, 1537, 1936, 2274, 2532, 2950, 3301, 3551, 3800, 3976, 4510, 4966, 5709, 6389, 7198, 7764, 8294, 8718, 9614, 10556, 11237, 12468, 12562, 13246, 13867]","[0, 170, 260, 470, 560, 690, 882, 1241, 1537, 1872, 2395, 2575, 2718, 2955, 3296, 3593, 4128, 4315, 4967, 5715, 6006, 6635, 7370, 7700, 8415, 8963, 9139, 9233, 10441, 11057]","[0, 170, 301, 470, 609, 1024, 1241, 1554, 2032, 2256, 2391, 2636, 2825, 3083, 3224, 3319, 3619, 4052, 4554, 5276, 5847, 6251, 6418, 6623, 7084, 7931, 8107, 8342, 8632, 9538]",21563,18158,13867,11057,9538,-3184,-1019,2746,-3066,-3337,-7860,30,dire
7601046103,57,109,96,86,5,"[0, 381, 718, 1118, 1573, 2301, 2850, 3773, 4257, 4787, 5298, 5836, 6079, 6647, 7402, 7929, 8753, 10318, 10964, 11533, 12547, 13730, 14198, 14971, 15247, 16580, 18145, 19770, 21602, 21779]","[0, 329, 691, 905, 1512, 1778, 2161, 2837, 3423, 3671, 4241, 4654, 5373, 5933, 6468, 6844, 7501, 8810, 9487, 10362, 11215, 12393, 13096, 13474, 14392, 15703, 16664, 17571, 18074, 18559]","[0, 294, 663, 1098, 1579, 2040, 2542, 3150, 3691, 4102, 4626, 5215, 5896, 5991, 6689, 6990, 7251, 7500, 8052, 8641, 9311, 10206, 10548, 11213, 11734, 12430, 12524, 13279, 13662, 14517]","[0, 170, 260, 399, 569, 659, 794, 1018, 1243, 1381, 1565, 1675, 1765, 2027, 2701, 3329, 3587, 4541, 4923, 5437, 5680, 6185, 6754, 7095, 7299, 7576, 7719, 8587, 9499, 9676]","[0, 170, 260, 391, 647, 737, 868, 1141, 1370, 1460, 2021, 2135, 2225, 2367, 3124, 3219, 3314, 3758, 3982, 4077, 4471, 5110, 5276, 5482, 5758, 6229, 6323, 7467, 8683, 9134]",21779,18559,14517,9676,9134,18,85,88,13,84,"[0, 328, 589, 1086, 1532, 1965, 2564, 3095, 3587, 4358, 5064, 5754, 6645, 7588, 8682, 9521, 10432, 10743, 11456, 13074, 14173, 14535, 15343, 16308, 17106, 18700, 19603, 20580, 21763, 22027]","[0, 204, 636, 952, 1281, 1625, 2078, 2398, 2938, 3953, 4231, 4539, 5113, 5682, 6818, 7207, 7732, 8284, 8831, 9441, 9716, 10037, 10131, 11245, 11813, 12550, 13036, 13228, 14675, 14771]","[0, 170, 260, 372, 506, 631, 770, 910, 1044, 1552, 1827, 2199, 2631, 3060, 3585, 3680, 4316, 4821, 5491, 6738, 6833, 6928, 7401, 9589, 9986, 10482, 10576, 10875, 11969, 12312]","[0, 241, 367, 583, 954, 1096, 1338, 1546, 1717, 2215, 2820, 3010, 3269, 4021, 4620, 5089, 5772, 6637, 6731, 7500, 7973, 8068, 8947, 9686, 10311, 10622, 11062, 11157, 12228, 12324]","[0, 170, 260, 350, 489, 627, 761, 851, 987, 1167, 1302, 1392, 1552, 1647, 1979, 2119, 2361, 2672, 2811, 3433, 3528, 3623, 3894, 4406, 4501, 4997, 5091, 5234, 5614, 5710]",22027,14771,12312,12324,5710,-248,3788,2205,-2648,3424,6521,30,radiant
7601831103,10,76,96,53,100,"[0, 239, 566, 844, 1128, 1530, 1735, 2282, 2849, 3591, 4023, 4741, 5483, 6039, 6454, 6820, 7735, 8297, 8713, 10640, 11397, 12847, 14018, 14562, 14974, 15250, 16381, 17321, 17747, 19278]","[0, 207, 455, 737, 991, 1403, 1727, 2135, 2350, 3308, 3555, 3788, 3950, 4614, 5350, 5653, 6366, 6803, 7122, 7571, 7942, 8299, 8803, 9061, 9543, 9768, 10714, 10809, 11981, 12511]","[0, 170, 368, 732, 1195, 1406, 1694, 2111, 2492, 2848, 3285, 3605, 3951, 4923, 5273, 5685, 6186, 6527, 6755, 7577, 7782, 8245, 9011, 9307, 9648, 10796, 11324, 11691, 12450, 13197]","[0, 170, 260, 394, 528, 864, 1226, 1449, 1539, 1752, 1842, 2074, 2369, 2765, 2984, 3235, 3456, 3751, 4136, 4934, 5115, 5828, 6213, 6673, 7702, 7797, 8542, 9366, 10363, 10630]","[0, 170, 260, 350, 478, 695, 785, 1066, 1156, 1381, 1471, 1561, 1785, 2144, 2363, 2494, 2803, 2898, 3160, 3691, 3965, 4305, 4543, 4638, 5171, 5677, 6177, 6772, 7237, 7718]",19278,12511,13197,10630,7718,48,137,43,123,21,"[0, 205, 748, 980, 1220, 1680, 2199, 2686, 3173, 3401, 3929, 4577, 5392, 5542, 6821, 7316, 8169, 9274, 10584, 11505, 12584, 13702, 14382, 15171, 16790, 17789, 18871, 20345, 20989, 21585]","[0, 243, 577, 919, 1196, 1532, 1843, 2595, 3233, 3622, 4136, 4423, 5563, 5771, 6420, 7383, 8069, 8421, 8830, 9694, 9862, 10207, 10471, 11115, 11514, 12585, 13168, 13467, 14112, 14571]","[0, 207, 467, 756, 1082, 1461, 1865, 2028, 2676, 2923, 3512, 3813, 4204, 4646, 5465, 6061, 6846, 7817, 8481, 8639, 9268, 9495, 9589, 10048, 11212, 12326, 12984, 13851, 14028, 14375]","[0, 170, 309, 399, 519, 920, 1089, 1507, 1940, 2157, 2842, 3001, 3502, 3870, 4701, 5125, 5793, 6058, 6214, 6930, 7428, 7926, 8020, 8428, 9637, 10097, 10576, 12046, 12563, 12882]","[0, 170, 319, 409, 575, 700, 1054, 1144, 1346, 1475, 1733, 1877, 2191, 2656, 3407, 3556, 3714, 4156, 4482, 4911, 5006, 5101, 5195, 5470, 6131, 6578, 6865, 7506, 8175, 8271]",21585,14571,14375,12882,8271,-2307,-2060,-1178,-2252,-553,-8350,30,radiant
7601988906,98,18,23,65,86,"[0, 294, 631, 872, 1194, 1771, 1861, 2435, 2986, 3425, 4098, 4652, 5337, 5882, 6442, 6795, 6997, 7941, 8144, 10323, 10811, 11616, 12365, 12618, 12789, 13206, 14055, 14396, 15134, 15660]","[0, 206, 484, 886, 1169, 1602, 1881, 2152, 2640, 3124, 3895, 4479, 5138, 5962, 6378, 6803, 7457, 8103, 8197, 8292, 8818, 9735, 10258, 10979, 11248, 11961, 12657, 13721, 14549, 14883]","[0, 257, 500, 802, 1178, 1595, 1987, 2448, 2665, 3040, 3605, 4154, 4470, 5028, 5652, 6049, 6285, 6986, 7175, 7484, 8154, 8779, 9109, 9843, 9938, 10835, 11075, 11272, 11410, 11695]","[0, 169, 259, 732, 902, 1253, 1358, 1540, 1917, 2444, 3160, 3404, 3613, 4185, 4319, 4656, 4751, 4962, 5094, 5846, 6129, 6468, 7013, 7279, 7569, 8231, 8325, 9141, 9270, 9769]","[0, 169, 276, 446, 663, 884, 1022, 1204, 1405, 1593, 2026, 2248, 2478, 2753, 2848, 3267, 3411, 3506, 3600, 4374, 5036, 5203, 5495, 5739, 5976, 6071, 6263, 6497, 6593, 7131]",15660,14883,11695,9769,7131,48,114,129,26,5,"[0, 169, 519, 835, 1081, 1490, 1870, 2381, 3021, 3598, 4172, 4748, 5083, 5676, 6619, 7459, 8405, 9766, 10942, 12824, 13695, 14531, 15605, 16571, 17680, 18972, 20391, 21685, 22752, 23626]","[0, 323, 732, 1090, 1539, 2180, 2711, 2801, 3440, 3530, 4034, 4503, 5347, 6500, 7214, 7823, 9384, 10059, 11173, 11607, 12428, 13112, 13347, 13873, 15055, 15951, 16445, 16862, 17238, 17599]","[0, 297, 504, 903, 1197, 1361, 1779, 2251, 2681, 3097, 3686, 3951, 4834, 5328, 5947, 6474, 7055, 7933, 9147, 9446, 10358, 10677, 10995, 11640, 12248, 13185, 14074, 14758, 15264, 16110]","[0, 169, 259, 368, 458, 595, 722, 812, 902, 1167, 1479, 1574, 1911, 2554, 2900, 3188, 3661, 4031, 4278, 5056, 5388, 5488, 5731, 6035, 6538, 7117, 7961, 8511, 8607, 8946]","[0, 169, 259, 349, 510, 600, 783, 873, 1195, 1285, 1510, 1713, 2012, 2555, 2751, 2983, 3569, 3952, 4515, 4756, 5181, 5351, 5589, 5943, 6583, 7162, 7690, 8194, 8290, 8720]",23626,17599,16110,8946,8720,-7966,-2716,-4415,823,-1589,-15863,30,dire
7602415801,25,70,60,86,31,"[0, 287, 656, 1028, 1557, 1936, 2382, 2791, 3353, 4259, 4823, 5416, 6450, 7130, 7781, 8728, 9772, 10700, 11370, 12251, 14833, 15541, 15927, 16022, 16572, 17190, 17977, 19439, 19916, 20892]","[0, 327, 640, 923, 1444, 1751, 2452, 2821, 3264, 3762, 4024, 4149, 4514, 5517, 5872, 6523, 7324, 7690, 8118, 9040, 10069, 10781, 11825, 12230, 12801, 13461, 14269, 14364, 14796, 15057]","[0, 250, 651, 1025, 1427, 1810, 2263, 2858, 3420, 3945, 4592, 4937, 5178, 5472, 5858, 6148, 6619, 6928, 7372, 7550, 8412, 9546, 9953, 10397, 10714, 11255, 11755, 12430, 12755, 13156]","[0, 169, 259, 349, 439, 573, 759, 939, 1119, 1344, 1776, 1866, 2073, 2448, 2686, 3029, 3277, 3690, 4238, 4333, 4771, 5163, 5609, 5983, 6316, 6719, 6933, 7028, 7247, 7343]","[0, 169, 344, 434, 671, 805, 1254, 1498, 1682, 2085, 2303, 2428, 2665, 3013, 3142, 3357, 3747, 3993, 4257, 4352, 5110, 5334, 5572, 5667, 5933, 6100, 6310, 6614, 6710, 6964]",20892,15057,13156,7343,6964,44,96,32,88,5,"[0, 291, 571, 1007, 1388, 1865, 2267, 2705, 3098, 3472, 4015, 4542, 5476, 6096, 7087, 7744, 8749, 10302, 11087, 12255, 12648, 13631, 14331, 15148, 16514, 17099, 18173, 19595, 21024, 22169]","[0, 241, 583, 918, 1251, 1581, 1833, 2226, 2479, 2817, 3748, 4581, 5027, 5230, 5793, 6086, 6679, 7206, 7977, 8899, 9261, 9748, 10307, 11072, 11171, 11674, 11953, 13087, 13546, 14319]","[0, 281, 501, 798, 1047, 1293, 1507, 1957, 2159, 2386, 2910, 3325, 3907, 4110, 4442, 4935, 5315, 6122, 6775, 7588, 8141, 8236, 9534, 10020, 10851, 11258, 11633, 12533, 13300, 14132]","[0, 169, 259, 423, 560, 777, 867, 1008, 1136, 1272, 1721, 2234, 2512, 2715, 3233, 3327, 3548, 3811, 3984, 4465, 4664, 4759, 6050, 6371, 6485, 6805, 6899, 7249, 7881, 8139]","[0, 169, 259, 478, 568, 765, 873, 1010, 1100, 1190, 1589, 1973, 2347, 2557, 2732, 2826, 3047, 3474, 3633, 4005, 4200, 4295, 4461, 4670, 4775, 5431, 5525, 5904, 6474, 7154]",22169,14319,14132,8139,7154,-1277,738,-976,-796,-190,-2501,30,dire
7602497900,13,104,93,14,121,"[0, 326, 581, 909, 1156, 1576, 1983, 2553, 3005, 3484, 4247, 4979, 5371, 5972, 6527, 6829, 7263, 7814, 8372, 9546, 10286, 10838, 11569, 12297, 13705, 14430, 14623, 16108, 17632, 18727]","[0, 321, 659, 1069, 1539, 2022, 2548, 3080, 3555, 4046, 4826, 5276, 6148, 6676, 6937, 7543, 8177, 9660, 10303, 12017, 12946, 13715, 14340, 15107, 16047, 17022, 17532, 17910, 19865, 20752]","[0, 283, 564, 726, 1159, 1394, 1530, 1658, 1833, 1962, 2335, 2702, 3147, 3588, 4137, 4921, 5465, 6495, 7280, 7934, 8257, 8621, 9160, 9593, 10016, 10855, 10950, 11574, 12350, 12751]","[0, 169, 318, 408, 590, 832, 1023, 1158, 1364, 1503, 1898, 2412, 2620, 2858, 3048, 3465, 3725, 4093, 4332, 4804, 5181, 5990, 6201, 6295, 6821, 7368, 7878, 8082, 9035, 9419]","[0, 169, 309, 491, 719, 849, 1066, 1191, 1318, 1493, 1700, 2017, 2427, 2565, 2660, 2916, 3074, 3259, 3354, 4331, 4489, 4793, 5006, 5147, 5442, 6333, 6630, 6891, 7504, 7875]",18727,20752,12751,9419,7875,46,4,81,84,86,"[0, 402, 685, 993, 1314, 1677, 2040, 2413, 2883, 3529, 3843, 4409, 5163, 5942, 6663, 7709, 8898, 9955, 10572, 11297, 11652, 12215, 13652, 14755, 15325, 15684, 17888, 18667, 20155, 20251]","[0, 239, 659, 1100, 1447, 1903, 2336, 3011, 3474, 3999, 4517, 5225, 5771, 6624, 7231, 7965, 8867, 9052, 9578, 9746, 10655, 10970, 11604, 12078, 12582, 12677, 13910, 14788, 15711, 16097]","[0, 204, 707, 995, 1279, 1598, 2095, 2418, 2782, 3714, 4279, 4791, 5546, 6183, 6589, 6757, 7263, 7551, 7870, 8299, 9499, 10011, 11087, 11793, 12054, 12159, 13982, 14734, 15117, 15687]","[0, 169, 259, 349, 477, 601, 743, 1020, 1192, 1439, 1529, 1709, 1799, 2230, 2341, 2512, 2780, 2986, 3247, 3341, 3632, 3909, 4284, 4378, 4473, 4568, 5354, 5957, 6454, 6870]","[0, 169, 259, 349, 485, 624, 759, 1032, 1122, 1570, 1660, 1928, 2018, 2353, 2501, 2691, 3105, 3290, 3611, 3833, 3991, 4086, 4781, 4931, 5026, 5157, 5507, 5763, 6237, 6659]",20251,16097,15687,6870,6659,-1524,4655,-2936,2549,1216,3960,30,radiant
7602528301,48,21,98,123,110,"[0, 328, 660, 1071, 1484, 1890, 2589, 3106, 3640, 4280, 4870, 5599, 6130, 7156, 8469, 8763, 9433, 10680, 12304, 13382, 14039, 15142, 16370, 17258, 18329, 19527, 20444, 23012, 23967, 24063]","[0, 244, 619, 868, 1126, 1417, 1594, 2031, 2241, 2567, 3177, 3468, 4035, 4595, 5361, 5824, 6571, 6836, 7297, 7933, 8671, 9823, 10104, 10724, 11752, 12579, 12743, 13256, 14185, 14990]","[0, 364, 645, 916, 1218, 1594, 2026, 2916, 3963, 4383, 4659, 5244, 5595, 6786, 7570, 7928, 8510, 8713, 9022, 9213, 9999, 11771, 12031, 12470, 13569, 13898, 13993, 14087, 14870, 15632]","[0, 170, 260, 350, 520, 610, 700, 1251, 1801, 2173, 2538, 2658, 2932, 3625, 3923, 4142, 4393, 4576, 4671, 5062, 5157, 5527, 6195, 6587, 7189, 7650, 7872, 8476, 8572, 8888]","[0, 170, 260, 399, 536, 672, 905, 995, 1188, 1481, 1835, 1925, 2015, 2161, 2500, 2719, 2904, 2999, 3119, 3471, 3566, 4157, 4401, 4495, 4719, 5185, 5288, 5718, 5970, 6171]",24063,14990,15632,8888,6171,72,13,71,53,86,"[0, 246, 370, 768, 1159, 1611, 2035, 2395, 2871, 3462, 4222, 5043, 5558, 6019, 6495, 7019, 7847, 8568, 9246, 9995, 10748, 11440, 12569, 13340, 14071, 15128, 16217, 17029, 18717, 19555]","[0, 333, 653, 1101, 1461, 1916, 2271, 2566, 3070, 3523, 4502, 5308, 5829, 6211, 6852, 7559, 8329, 9096, 9937, 11052, 11936, 12509, 13152, 13902, 14464, 15299, 16225, 16933, 17171, 18257]","[0, 204, 588, 994, 1487, 1931, 2412, 2966, 3955, 4340, 5054, 5786, 6458, 6688, 7237, 7908, 8906, 9782, 10270, 11454, 11829, 12106, 12750, 13300, 13448, 14452, 15494, 16105, 16506, 17493]","[0, 170, 260, 380, 950, 1085, 1193, 1283, 1373, 1551, 1936, 2265, 2576, 2889, 3444, 3707, 4267, 5036, 5320, 5939, 6339, 6790, 7534, 7994, 8508, 9058, 10015, 10573, 11453, 12010]","[0, 219, 360, 528, 715, 852, 1094, 1184, 1320, 1571, 2026, 2417, 2756, 3246, 3639, 3823, 4320, 4772, 5493, 6182, 6453, 6886, 7566, 7745, 7840, 8645, 9532, 10134, 10230, 10800]",19555,18257,17493,12010,10800,4508,-3267,-1861,-3122,-4629,-8371,30,dire
7602639202,14,95,39,86,85,"[0, 273, 622, 879, 1482, 1790, 2256, 2673, 3132, 3767, 4288, 4938, 5465, 6281, 6808, 7345, 7988, 8411, 9366, 9970, 10779, 11203, 11733, 11828, 12619, 14617, 15188, 15951, 17574, 18392]","[0, 599, 991, 1262, 1829, 2028, 2612, 2866, 3546, 3796, 4304, 4979, 5602, 6105, 6612, 6881, 7273, 8050, 8638, 9516, 10192, 11023, 11994, 12516, 13120, 13627, 14798, 16370, 17301, 18643]","[0, 219, 385, 747, 1111, 1411, 1670, 2386, 2635, 3177, 3909, 4691, 5593, 6074, 6539, 6833, 7322, 7895, 8196, 8878, 9213, 9857, 10511, 10606, 10701, 11485, 11988, 12360, 13148, 13975]","[0, 219, 357, 558, 696, 824, 959, 1094, 1232, 1456, 1767, 2627, 2826, 3327, 3670, 3980, 4466, 4917, 5459, 6011, 6446, 7155, 7629, 7855, 8098, 8465, 8598, 8975, 9397, 10082]","[0, 244, 334, 424, 671, 761, 1068, 1203, 1412, 1758, 2123, 2511, 2784, 2968, 3592, 3735, 3893, 4203, 4457, 5442, 5537, 5949, 6117, 6246, 6500, 7476, 7880, 8166, 8588, 9251]",18392,18643,13975,10082,9251,1,7,21,76,5,"[0, 328, 649, 977, 1434, 1919, 2427, 2870, 3294, 3648, 4448, 4941, 5443, 6075, 7073, 7872, 8778, 9715, 10378, 11350, 12368, 13896, 14871, 16111, 17717, 18562, 19637, 20296, 20828, 21113]","[0, 205, 495, 700, 1114, 1497, 1836, 2055, 2329, 2539, 2666, 2876, 3085, 3805, 3979, 4455, 5121, 5801, 6307, 7432, 8047, 8561, 9459, 10134, 10628, 10944, 11085, 11799, 12270, 13408]","[0, 332, 508, 693, 1035, 1434, 1609, 1955, 2045, 2974, 3401, 3832, 4163, 4644, 5284, 6694, 7476, 8266, 8765, 9138, 9853, 10500, 11316, 12015, 12627, 12722, 13104, 13556, 13733, 13829]","[0, 170, 260, 387, 517, 653, 743, 923, 1013, 1522, 1612, 1740, 1830, 2546, 2675, 3292, 3846, 4252, 4779, 4937, 5485, 5580, 6087, 6935, 7747, 7842, 7982, 8349, 8526, 8622]","[0, 170, 260, 398, 661, 751, 879, 1037, 1127, 1237, 1547, 1637, 1727, 1822, 2206, 2523, 2921, 3016, 3320, 3478, 3573, 3668, 4237, 4684, 5296, 5391, 5732, 6480, 6974, 7259]",21113,13408,13829,8622,7259,-2721,5235,146,1460,1992,6112,30,dire
7602747503,25,71,93,87,121,"[0, 240, 657, 1071, 1400, 1731, 2350, 2983, 3409, 3868, 4530, 5051, 5503, 7093, 7760, 8192, 9197, 9930, 10729, 11825, 12375, 13293, 14032, 14835, 15684, 16106, 16667, 17729, 18754, 18960]","[0, 282, 636, 1082, 1466, 1830, 2305, 2835, 3450, 3860, 4580, 4907, 5890, 6394, 6971, 7334, 8122, 8724, 9434, 9681, 10676, 11366, 12152, 13218, 14154, 14498, 15087, 15182, 16064, 16608]","[0, 293, 1155, 1282, 1460, 1755, 2118, 2665, 2880, 3561, 3704, 3914, 4420, 4931, 5665, 6416, 7090, 7987, 9070, 9622, 10199, 11897, 12792, 14073, 14738, 14905, 15679, 15774, 16078, 16284]","[0, 170, 385, 475, 802, 892, 1483, 1639, 1972, 2503, 2593, 2683, 3185, 3433, 4001, 4214, 4420, 4951, 5351, 5598, 5895, 6080, 6246, 7368, 7608, 7775, 8224, 8319, 8520, 8726]","[0, 170, 260, 350, 440, 530, 634, 756, 894, 1054, 1360, 1450, 1540, 2265, 2691, 2857, 3148, 3289, 3611, 4036, 4348, 4761, 5469, 6556, 7156, 7452, 7960, 8055, 8388, 8594]",18960,16608,16284,8726,8594,6,106,14,114,5,"[0, 294, 616, 1030, 1419, 1898, 2276, 2701, 3490, 4149, 4642, 5319, 5966, 6625, 7297, 8087, 9182, 9840, 10596, 12874, 14420, 15062, 16074, 16261, 17226, 18761, 20246, 20799, 22595, 24358]","[0, 283, 409, 626, 993, 1312, 1761, 2015, 2524, 3214, 3705, 4290, 4797, 5260, 5880, 6355, 6978, 7748, 8400, 9160, 9885, 11372, 12076, 12171, 13264, 14005, 14922, 15017, 16333, 17611]","[0, 170, 372, 824, 1592, 1804, 2266, 2374, 2857, 3058, 3868, 4231, 4906, 5277, 5726, 5820, 6079, 6500, 6891, 7327, 7971, 8430, 8813, 8908, 9382, 9716, 10531, 10747, 11355, 12056]","[0, 170, 260, 396, 755, 845, 1079, 1230, 2105, 2243, 2834, 2924, 3245, 3340, 3750, 3844, 4184, 4279, 4437, 5057, 5515, 6175, 6529, 6686, 7104, 7406, 8048, 8324, 8636, 9337]","[0, 170, 277, 367, 497, 587, 715, 805, 1075, 1187, 1376, 1466, 1556, 1651, 1939, 2033, 2245, 2359, 2856, 3393, 3692, 4018, 4184, 4369, 4936, 5166, 5399, 5862, 6248, 6752]",24358,17611,12056,9337,6752,-5398,-1003,4228,-611,1842,-942,30,dire
7602837205,10,49,136,91,101,"[0, 204, 565, 885, 1321, 1703, 1990, 2518, 2993, 3495, 4050, 4670, 5265, 5812, 6501, 7417, 8320, 8938, 9458, 10330, 10992, 12052, 12785, 13800, 15054, 15779, 17149, 17621, 18509, 19794]","[0, 303, 511, 976, 1390, 1874, 2318, 3043, 3641, 4119, 4555, 5320, 5879, 6113, 6622, 7355, 7919, 8331, 8425, 9079, 9309, 10340, 10638, 11217, 11885, 12483, 14360, 15006, 15299, 16170]","[0, 272, 436, 674, 1147, 1539, 2285, 2749, 3163, 3879, 4268, 4887, 5319, 5957, 6940, 7802, 8473, 9192, 9364, 9459, 9736, 10283, 10734, 11421, 11844, 12117, 13673, 14071, 14352, 15584]","[0, 199, 289, 379, 560, 650, 1237, 1474, 1628, 2284, 2544, 2647, 2821, 2993, 3431, 4103, 4489, 4757, 4851, 4946, 5176, 5483, 5649, 5744, 5953, 6425, 7159, 7426, 7679, 8095]","[0, 467, 557, 693, 1062, 1196, 1286, 1551, 1661, 1886, 2021, 2173, 2307, 2669, 3024, 3515, 3673, 3941, 4035, 4175, 4405, 4949, 5159, 5475, 5769, 5936, 6840, 7189, 7285, 7787]",19794,16170,15584,8095,7787,48,60,112,20,79,"[0, 248, 774, 934, 1185, 1469, 1635, 2002, 2343, 2946, 3419, 4072, 4753, 5325, 6088, 6861, 7600, 8333, 9131, 10598, 11523, 12502, 13466, 13944, 15523, 16443, 16943, 17038, 18494, 18962]","[0, 282, 580, 842, 1137, 1422, 1985, 2310, 2434, 2788, 3208, 3625, 4192, 4714, 5250, 5675, 6013, 6268, 7011, 7777, 8342, 8686, 9237, 9532, 10244, 10339, 11034, 11334, 12081, 12528]","[0, 325, 635, 926, 1285, 1488, 1837, 2083, 2536, 2804, 3518, 4114, 4465, 4810, 5493, 5737, 5956, 6331, 6888, 7675, 8254, 9054, 9313, 9727, 10171, 10599, 10785, 11316, 11858, 12181]","[0, 210, 397, 527, 851, 989, 1079, 1169, 1297, 1477, 1612, 1822, 1912, 2395, 2996, 3172, 3386, 3481, 4159, 4943, 5281, 5586, 6019, 6247, 6773, 7035, 7129, 7430, 8174, 8572]","[0, 210, 325, 415, 550, 686, 879, 969, 1059, 1278, 1550, 1760, 1898, 2302, 3095, 3316, 3749, 3844, 4143, 4636, 4999, 5295, 5888, 6233, 6642, 6908, 7075, 7336, 7594, 7804]",18962,12528,12181,8572,7804,832,3642,3403,-477,-17,7383,30,radiant
7602935601,76,120,104,138,100,"[0, 248, 462, 780, 1086, 1282, 1639, 1803, 2235, 2817, 3217, 3821, 4386, 4759, 5687, 6262, 6910, 7997, 8912, 9803, 10422, 11450, 12095, 13005, 13335, 13760, 14734, 15445, 15876, 16878]","[0, 282, 567, 903, 1031, 1284, 1992, 2301, 2609, 3218, 3773, 4362, 4949, 5701, 6151, 6886, 7738, 8258, 8719, 9182, 9730, 10760, 11307, 12506, 13035, 13950, 14621, 15512, 16106, 17480]","[0, 334, 606, 816, 1065, 1540, 1858, 2399, 2653, 3264, 3692, 4250, 4802, 5422, 6028, 6259, 7099, 7401, 7768, 8019, 8547, 8870, 9167, 9670, 10175, 10412, 10844, 11237, 11458, 11812]","[0, 210, 300, 426, 565, 731, 905, 1241, 1466, 1747, 1951, 2227, 2379, 2723, 3195, 3425, 4063, 4330, 4655, 5314, 6048, 6310, 6832, 7575, 8307, 8579, 9504, 10026, 10690, 11215]","[0, 210, 300, 436, 526, 958, 1093, 1183, 1573, 2208, 2382, 2658, 2748, 3016, 3471, 3656, 4006, 4277, 4699, 4948, 5270, 5607, 5915, 6443, 6848, 7018, 7482, 7733, 8237, 8927]",16878,17480,11812,11215,8927,12,35,20,123,40,"[0, 215, 532, 769, 1179, 1269, 1680, 1925, 2492, 2897, 3279, 3826, 4291, 5060, 5709, 6266, 7025, 7710, 8047, 8806, 9450, 10266, 10974, 11861, 12879, 13950, 15117, 16118, 16905, 17704]","[0, 210, 407, 656, 1041, 1303, 1677, 2153, 2961, 3455, 3856, 4280, 4819, 5021, 6145, 6613, 7484, 7578, 8357, 9010, 9368, 9463, 9630, 10375, 11412, 11875, 12075, 12565, 13172, 13305]","[0, 252, 448, 882, 1291, 1610, 2047, 2182, 2534, 3126, 3517, 3752, 4149, 4587, 4916, 5323, 5643, 5961, 6919, 7507, 7999, 8511, 9262, 9386, 10637, 11760, 12257, 12430, 12970, 13203]","[0, 130, 220, 401, 932, 1311, 1401, 1491, 1630, 1947, 2037, 2208, 2436, 2750, 3159, 3254, 3628, 4124, 4549, 5178, 5526, 5983, 6387, 6925, 8432, 9225, 9849, 10228, 11016, 11112]","[0, 130, 220, 310, 440, 530, 667, 757, 946, 1397, 1625, 1929, 2191, 2434, 2929, 3164, 3349, 3540, 3635, 4107, 4201, 4296, 4542, 4659, 5592, 6161, 6561, 6656, 7020, 7151]",17704,13305,13203,11112,7151,-826,4175,-1391,103,1776,3837,30,dire
7603672316,98,10,21,86,84,"[0, 207, 447, 1154, 1604, 2136, 2273, 3032, 3635, 4848, 5715, 5850, 6417, 7154, 7771, 8594, 9288, 9614, 10004, 10577, 11180, 11584, 12269, 12934, 13516, 13838, 14096, 14541, 15482, 16194]","[0, 248, 528, 819, 1180, 1465, 1963, 2592, 3052, 3559, 4219, 4445, 5074, 5554, 6197, 7446, 8095, 8821, 9586, 10234, 10955, 11696, 12710, 13430, 14174, 14687, 15067, 15332, 15653, 16316]","[0, 284, 445, 985, 1298, 1579, 2064, 2360, 2860, 3259, 3530, 3841, 4403, 4774, 5456, 5953, 6560, 7458, 7973, 8597, 9227, 9984, 10791, 11606, 12525, 12692, 13104, 13751, 14415, 14511]","[100, 270, 360, 450, 736, 1001, 1151, 1241, 1423, 1908, 2579, 2791, 3019, 3409, 3704, 4074, 4443, 4620, 4990, 5254, 5479, 5757, 5924, 6305, 6724, 7095, 7658, 8246, 8511, 8877]","[0, 170, 260, 396, 526, 616, 755, 995, 1130, 1493, 1894, 2304, 2582, 3042, 3489, 3993, 4151, 4328, 4509, 4603, 5054, 5249, 5601, 6052, 6295, 6704, 6905, 7142, 7283, 7379]",16194,16316,14511,8877,7379,109,52,69,20,90,"[0, 280, 544, 845, 1246, 1419, 1842, 2218, 2638, 3066, 3546, 3688, 4341, 5003, 5806, 6130, 6688, 7422, 8207, 9104, 9962, 11147, 12063, 12934, 13530, 14530, 15606, 17034, 17975, 19405]","[0, 256, 615, 1019, 1400, 1926, 2361, 2705, 3327, 4004, 4335, 4602, 5612, 6583, 7308, 7756, 8323, 8754, 9322, 9907, 10002, 10747, 11532, 12124, 12556, 13717, 14867, 16033, 17597, 18582]","[0, 209, 514, 708, 1148, 1631, 1833, 2069, 2409, 2813, 4057, 4340, 4752, 5220, 5654, 6231, 6574, 7123, 7911, 8293, 8548, 9241, 10000, 10670, 11202, 12129, 12889, 14020, 14699, 15089]","[0, 170, 674, 794, 1187, 1388, 1478, 1790, 1925, 2182, 2553, 2823, 2913, 3317, 3584, 3703, 3861, 3956, 4260, 4454, 4660, 5312, 5476, 5885, 6055, 6495, 6824, 7882, 8504, 8937]","[0, 170, 285, 405, 627, 804, 941, 1408, 1543, 1965, 2197, 2589, 2730, 3079, 3292, 3549, 3842, 4133, 4571, 4728, 4877, 5568, 5707, 6012, 6107, 6412, 7001, 7206, 7545, 7964]",19405,18582,15089,8937,7964,-3211,-2266,-578,-60,-585,-6700,30,dire
7604119300,13,41,78,123,136,"[0, 297, 571, 915, 1403, 1653, 1990, 2698, 2877, 2967, 3716, 4097, 4704, 5050, 5318, 6160, 6642, 7731, 8028, 8534, 8718, 9025, 9602, 9787, 10251, 10654, 13184, 13730, 14622, 15018]","[0, 170, 494, 659, 936, 1101, 1675, 1921, 2152, 2422, 2808, 2986, 3452, 3722, 4095, 4666, 5242, 6408, 7065, 7510, 8229, 8529, 9552, 10467, 11037, 11132, 12505, 13251, 13727, 14204]","[0, 242, 408, 772, 1070, 1687, 1976, 2304, 2762, 3548, 3951, 4450, 5208, 5674, 5769, 6231, 6513, 7244, 7502, 7752, 8010, 8165, 8831, 9505, 10434, 10747, 11773, 11901, 12241, 12574]","[0, 170, 391, 481, 700, 986, 1397, 1532, 1667, 2181, 2559, 2649, 2894, 3104, 3199, 3486, 3650, 4466, 4736, 5060, 5284, 5379, 5945, 6313, 6637, 6967, 8573, 8830, 9168, 9264]","[0, 170, 260, 402, 532, 622, 930, 1176, 1316, 1406, 1944, 2034, 2814, 2909, 3050, 3461, 3649, 4623, 4718, 4876, 4970, 5065, 5277, 5623, 5717, 5812, 6114, 6208, 6544, 7169]",15018,14204,12574,9264,7169,48,129,25,30,100,"[0, 205, 557, 844, 1050, 1581, 1968, 2757, 3101, 3523, 4035, 4694, 5337, 5970, 6864, 7426, 8293, 8889, 9597, 10657, 11526, 12736, 13136, 14178, 14697, 16142, 17221, 17591, 19171, 20126]","[0, 296, 458, 877, 1524, 1897, 2095, 2385, 2857, 3559, 3985, 4406, 4856, 5229, 5537, 5815, 6517, 6796, 7747, 8332, 8760, 10105, 11165, 12295, 12747, 13338, 13630, 14893, 16074, 16850]","[0, 287, 669, 908, 1196, 1632, 2245, 2467, 2942, 3415, 3882, 4421, 4832, 5343, 5949, 6460, 7198, 7404, 8361, 9256, 9529, 10138, 10789, 11418, 12068, 12708, 12905, 13416, 14162, 14730]","[0, 170, 260, 350, 440, 530, 940, 1187, 1624, 1766, 2391, 2579, 3169, 3372, 3585, 3680, 4367, 4600, 5470, 5994, 6375, 6917, 7260, 7683, 7887, 8295, 9057, 9358, 10202, 10554]","[0, 170, 260, 394, 725, 815, 905, 1165, 1593, 2086, 2900, 3231, 3411, 3966, 4316, 4585, 5157, 5342, 5676, 6297, 6481, 6893, 7216, 7450, 7701, 8242, 8579, 8764, 9559, 9840]",20126,16850,14730,10554,9840,-5108,-2646,-2156,-1290,-2671,-13871,30,dire
7604869804,49,123,17,96,21,"[0, 205, 533, 1073, 1319, 1734, 1896, 2519, 2984, 3546, 4148, 4779, 5254, 5811, 6576, 7172, 7815, 8387, 9116, 9543, 10236, 10823, 11005, 11542, 12149, 12925, 13871, 14421, 14911, 15439]","[0, 565, 706, 796, 986, 1406, 1496, 1902, 2328, 2433, 2772, 3207, 3614, 4110, 4426, 4652, 4747, 5356, 5844, 6306, 7103, 7384, 7737, 8223, 8653, 9211, 10062, 10435, 11518, 12254]","[0, 288, 460, 744, 1046, 1452, 1702, 2100, 2526, 3073, 3804, 4416, 4843, 5437, 6011, 6644, 7333, 8053, 8484, 9074, 9735, 10368, 10463, 10964, 11532, 11857, 12656, 13070, 13517, 13950]","[0, 297, 457, 774, 1103, 1584, 1914, 2572, 2953, 3397, 4070, 4897, 5607, 6351, 6979, 7191, 7457, 7806, 8040, 8252, 8859, 9286, 9381, 10061, 10490, 10649, 11563, 12463, 13243, 13420]","[0, 430, 544, 988, 1078, 1209, 1333, 1519, 1970, 2136, 2584, 3271, 3514, 4041, 4625, 5120, 5305, 5527, 5768, 6460, 6668, 7049, 7144, 7518, 7875, 8221, 8631, 8874, 9228, 9599]",15439,12254,13950,13420,9599,138,22,19,79,91,"[0, 170, 377, 657, 1067, 1308, 1634, 2061, 2548, 2875, 3487, 4091, 4461, 4871, 5640, 6327, 6948, 7818, 8941, 9962, 10772, 11870, 13493, 14126, 14850, 15952, 17140, 17993, 19267, 20189]","[0, 280, 612, 1030, 1471, 1965, 2417, 2871, 3471, 3965, 4641, 4731, 5348, 5848, 6036, 7116, 7713, 8432, 9144, 10215, 10940, 11729, 12842, 13315, 14059, 14956, 15690, 16031, 16628, 17242]","[0, 325, 530, 656, 1365, 1723, 1902, 2037, 2467, 2727, 3204, 3333, 4180, 4520, 4616, 5060, 5630, 5933, 6525, 7208, 7365, 7772, 8582, 8958, 9508, 10810, 10905, 11269, 11708, 12421]","[0, 170, 260, 350, 515, 680, 1103, 1238, 1472, 1690, 1906, 2152, 2326, 2520, 2815, 3666, 4103, 4260, 4500, 5170, 5444, 5705, 6633, 6909, 7114, 7729, 8077, 8517, 8987, 9732]","[0, 170, 260, 350, 560, 725, 861, 1044, 1328, 1418, 1598, 1743, 1835, 1931, 2032, 2138, 2420, 2577, 2839, 3417, 3657, 3800, 4411, 4578, 4730, 5050, 5190, 5478, 5745, 5987]",20189,17242,12421,9732,5987,-4750,-4988,1529,3688,3612,-909,30,radiant
7604869900,12,13,98,9,26,"[0, 278, 549, 861, 1263, 1547, 2258, 2522, 3080, 3683, 4122, 4790, 5275, 5942, 6323, 6825, 7457, 8358, 9151, 9623, 10019, 10267, 11086, 11950, 12719, 13670, 14839, 15652, 16360, 17393]","[0, 284, 621, 1030, 1447, 1828, 2267, 2775, 3401, 3743, 4078, 4783, 5010, 5105, 5506, 6016, 6823, 7550, 8038, 8466, 9136, 9407, 9743, 10265, 10621, 11245, 11339, 11628, 12409, 12972]","[0, 206, 499, 1154, 1598, 2265, 2633, 3152, 3673, 4064, 4621, 5444, 6076, 6322, 6643, 7353, 7899, 8922, 9225, 9754, 10018, 10185, 10765, 11579, 12222, 13025, 13668, 13763, 14781, 15221]","[0, 220, 378, 503, 633, 772, 972, 1062, 1478, 1613, 2146, 2571, 2830, 3067, 3162, 3280, 3658, 4058, 4548, 4906, 5110, 5874, 6095, 6557, 6775, 7159, 7395, 7827, 8422, 8770]","[0, 169, 259, 441, 615, 872, 962, 1123, 1322, 1457, 1966, 2211, 2301, 2547, 2681, 2877, 3123, 3544, 3639, 3823, 3955, 4629, 4977, 5221, 5672, 5914, 6083, 6253, 6505, 6676]",17393,12972,15221,8770,6676,41,120,112,19,20,"[0, 242, 552, 1066, 1493, 1945, 2265, 2628, 2941, 3376, 3535, 3847, 4423, 5135, 5637, 6135, 6984, 7394, 7696, 8504, 9136, 10238, 11052, 11805, 12538, 13551, 14233, 15349, 15918, 16737]","[0, 316, 750, 1147, 1525, 1975, 2137, 2775, 3688, 4144, 4481, 5178, 5594, 6611, 7052, 7321, 8283, 8901, 9758, 10529, 11114, 11930, 12639, 13131, 13874, 14754, 15547, 15977, 16765, 17778]","[0, 169, 598, 866, 1198, 1439, 1649, 2077, 2406, 2713, 3066, 3585, 3992, 4441, 5027, 5382, 6182, 6277, 6935, 7746, 8432, 8527, 9285, 9694, 10161, 10966, 11520, 12186, 13175, 13720]","[0, 169, 301, 391, 521, 682, 790, 971, 1189, 1447, 1613, 1941, 2054, 2731, 2880, 3261, 3572, 3766, 4268, 4918, 5496, 6137, 6303, 6770, 7072, 7598, 8441, 8802, 8973, 10003]","[0, 169, 259, 464, 635, 995, 1085, 1175, 1709, 2282, 2493, 2722, 2812, 3308, 3457, 3649, 4121, 4216, 4452, 4945, 5331, 5972, 6138, 6422, 6971, 7355, 7869, 8159, 8332, 8729]",16737,17778,13720,10003,8729,656,-4806,1501,-1233,-2053,-5935,30,radiant
7604962313,98,19,41,45,83,"[0, 213, 501, 828, 1028, 1680, 2066, 2325, 3069, 3430, 3614, 4132, 4622, 5139, 5616, 6390, 7171, 7754, 8135, 8607, 8749, 9512, 10268, 10363, 10729, 11573, 11907, 12483, 13007, 13185]","[0, 325, 730, 1127, 1458, 1720, 1975, 2289, 2556, 3094, 3713, 4233, 4429, 4747, 5061, 5965, 6685, 7249, 7779, 8311, 8579, 8984, 9583, 9769, 10279, 10985, 11080, 11496, 12102, 12530]","[0, 212, 492, 690, 865, 1159, 1532, 1911, 2286, 3079, 4127, 4632, 5104, 5252, 5447, 6066, 6697, 7125, 7609, 8000, 8501, 9151, 9425, 10166, 10737, 11177, 11703, 12319, 12923, 13474]","[0, 130, 267, 451, 541, 860, 1246, 1336, 1655, 2188, 2684, 3050, 3263, 3658, 3753, 4028, 4593, 5337, 5952, 6342, 6486, 7297, 7638, 7733, 8065, 8249, 8435, 8723, 8981, 9077]","[0, 130, 220, 310, 400, 538, 673, 809, 1128, 1218, 1644, 1854, 1944, 2166, 2261, 2356, 2628, 3104, 3529, 4061, 4231, 4746, 4988, 5158, 5381, 5854, 6281, 6622, 6910, 7273]",13185,12530,13474,9077,7273,70,74,104,53,86,"[60, 385, 702, 1078, 1545, 1826, 2473, 3310, 3726, 4533, 5118, 5674, 6609, 7543, 8602, 8759, 9655, 10256, 10625, 11167, 11541, 12012, 13020, 14250, 14982, 16364, 17271, 18228, 19301, 20110]","[60, 390, 776, 1024, 1428, 1739, 2116, 2537, 3165, 3545, 3758, 3896, 4541, 5063, 5914, 6185, 6935, 7196, 7629, 8297, 8852, 9853, 10265, 10742, 11525, 12376, 12869, 13818, 14341, 15061]","[60, 345, 618, 814, 1402, 1920, 2524, 2747, 3280, 3406, 3934, 4097, 4699, 5793, 6310, 6678, 7182, 7276, 7994, 8285, 8754, 9080, 9667, 10160, 10714, 11937, 12543, 12921, 13098, 13376]","[328, 538, 658, 854, 1009, 1169, 1350, 1516, 1775, 1950, 2075, 2223, 2465, 3047, 3422, 3740, 4236, 4628, 4977, 5271, 6155, 6350, 7559, 7998, 8637, 9031, 9503, 9960, 10485, 10923]","[60, 270, 434, 568, 704, 1017, 1396, 1566, 1702, 1872, 1962, 2124, 2366, 3164, 3616, 3726, 4325, 4419, 4565, 4660, 5541, 5766, 6083, 6609, 6914, 7575, 7936, 8410, 8662, 8949]",20110,15061,13376,10923,8949,-6925,-2531,98,-1846,-1676,-12880,30,dire
7605068005,10,23,136,57,20,"[0, 273, 470, 835, 1340, 1706, 2180, 2477, 2982, 3343, 3879, 4508, 5102, 5775, 6327, 7289, 8433, 9338, 9928, 11397, 12139, 12918, 13097, 13937, 14231, 14732, 15953, 17053, 18146, 18494]","[0, 374, 740, 1274, 1402, 1994, 2428, 2743, 3328, 3770, 4573, 5338, 5885, 6211, 6761, 6981, 7653, 8068, 8711, 9258, 9918, 10415, 10902, 11436, 11530, 11625, 11887, 12397, 12994, 13247]","[0, 251, 570, 815, 1157, 1527, 1768, 2172, 2357, 2634, 3053, 3324, 3896, 4189, 4580, 4918, 5872, 6292, 6751, 7577, 8207, 8302, 9161, 9370, 9464, 9583, 9825, 10093, 10687, 11342]","[0, 170, 260, 350, 489, 579, 669, 759, 1119, 1209, 1344, 1686, 2196, 2713, 3110, 3448, 3937, 4225, 4356, 4514, 4780, 4875, 5072, 5261, 5355, 5865, 5960, 6165, 6858, 7283]","[0, 170, 260, 350, 440, 578, 668, 758, 980, 1165, 1481, 1742, 1844, 2140, 2427, 2681, 3216, 3400, 3559, 4580, 4799, 4894, 5037, 5132, 5226, 5321, 5416, 5621, 5942, 6038]",18494,13247,11342,7283,6038,1,74,96,26,105,"[0, 257, 531, 946, 1076, 1609, 1966, 2448, 3037, 3582, 3920, 4516, 4803, 5372, 5907, 6920, 7817, 8525, 9351, 10356, 11520, 12707, 13717, 15114, 15531, 16845, 17872, 19386, 20180, 22190]","[0, 208, 528, 864, 1383, 1680, 2097, 2630, 2945, 3368, 3657, 4119, 4440, 4715, 5019, 5594, 6279, 6710, 7558, 7716, 8166, 9427, 9999, 10523, 10707, 11612, 11958, 12505, 12916, 14073]","[0, 504, 742, 1089, 1340, 1804, 2070, 2354, 2668, 3038, 3369, 3587, 4067, 4370, 4666, 5077, 5363, 6342, 6853, 7192, 7286, 7840, 8879, 9082, 9350, 10090, 10401, 11012, 11155, 11812]","[0, 288, 416, 506, 683, 888, 1023, 1177, 1267, 1402, 1539, 1629, 1883, 2371, 2504, 2901, 3149, 3333, 4137, 4295, 4446, 5284, 5562, 5978, 6218, 7026, 7337, 7542, 7927, 8023]","[0, 236, 326, 416, 546, 737, 872, 1101, 1191, 1382, 1520, 1610, 1771, 2402, 2497, 2787, 3213, 3598, 4369, 4775, 4869, 5011, 5385, 5588, 5772, 6124, 6435, 6674, 6818, 6914]",22190,14073,11812,8023,6914,-3696,-826,-470,-740,-876,-6608,30,dire
7605501015,1,98,19,40,88,"[0, 207, 480, 800, 1243, 1806, 2449, 2847, 3169, 3650, 4271, 4927, 5227, 5925, 6534, 7279, 8011, 8983, 9865, 10683, 11434, 11957, 12978, 13951, 15213, 16480, 17557, 18537, 19469, 20633]","[0, 329, 648, 936, 1347, 1939, 2157, 2842, 3113, 3759, 4775, 5009, 6105, 6894, 7090, 8059, 8767, 9514, 10618, 11376, 11835, 12543, 13385, 13988, 14667, 15908, 16284, 16887, 17064, 17685]","[0, 282, 532, 937, 1396, 1568, 2039, 2366, 2851, 3112, 3859, 4366, 4913, 5439, 5745, 5840, 6201, 6887, 7563, 7913, 8529, 8768, 9307, 9402, 10108, 10824, 11217, 11650, 12018, 12720]","[0, 170, 260, 394, 620, 792, 1165, 1340, 1505, 1678, 2486, 2720, 2810, 3048, 3296, 3660, 3925, 4462, 4793, 5029, 5363, 5602, 5916, 6165, 6620, 7395, 7667, 8082, 8438, 8719]","[0, 170, 304, 394, 571, 661, 815, 1159, 1549, 1686, 2027, 2747, 2950, 3250, 3345, 3935, 4214, 4432, 4711, 4869, 5292, 5431, 5670, 5809, 6075, 6340, 6693, 7786, 7963, 8169]",20633,17685,12720,8719,8169,17,41,104,65,20,"[0, 280, 605, 1052, 1502, 1968, 2135, 2305, 2881, 3090, 3664, 4607, 4973, 5613, 6139, 6351, 6701, 6904, 7576, 8064, 8393, 9317, 9979, 10129, 10791, 11296, 11743, 12267, 13071, 13654]","[0, 206, 497, 798, 1166, 1381, 1581, 1831, 2136, 2311, 2755, 3403, 3644, 4152, 4499, 5292, 5870, 6336, 6515, 7064, 7517, 8231, 8671, 9415, 9906, 10160, 10658, 11449, 12072, 12510]","[0, 244, 450, 687, 1363, 1492, 1997, 2348, 2807, 3217, 3605, 4090, 4951, 5519, 6032, 6618, 7338, 7960, 8427, 9254, 9527, 10137, 10484, 11400, 11825, 11919, 12106, 12373, 12729, 13001]","[0, 213, 303, 393, 591, 681, 898, 1500, 1916, 2051, 2229, 2570, 2741, 3056, 3541, 3753, 4186, 4403, 4669, 5050, 5350, 5525, 6179, 6595, 6976, 7228, 7839, 8074, 8819, 8915]","[0, 170, 260, 350, 525, 741, 914, 1306, 1521, 1656, 2065, 2344, 2581, 2935, 3366, 3578, 3828, 4082, 4350, 4790, 4934, 5221, 5316, 5613, 5833, 6085, 6227, 6463, 6710, 6843]",13654,12510,13001,8915,6843,6979,5175,-281,-196,1326,13003,30,radiant
7605620914,114,90,97,19,20,"[0, 329, 586, 1020, 1382, 1557, 2141, 2486, 3349, 3732, 4197, 4542, 5045, 5676, 5975, 6603, 7023, 7577, 7779, 8355, 9215, 9584, 10273, 10929, 12121, 12650, 13581, 13912, 14922, 15957]","[0, 285, 652, 818, 1234, 1607, 2019, 2875, 3728, 4317, 4746, 5248, 5644, 5878, 6061, 6679, 7474, 7691, 8094, 8518, 8704, 9550, 9915, 10597, 11213, 11441, 12600, 13352, 13827, 14974]","[0, 240, 445, 804, 1160, 1660, 2083, 2322, 2631, 3142, 3624, 4307, 4798, 5234, 5764, 6056, 6346, 6651, 6746, 6840, 7038, 7431, 7869, 8304, 8611, 9157, 9290, 9384, 9843, 10143]","[0, 169, 259, 379, 519, 655, 792, 1078, 1388, 1659, 2056, 2200, 2336, 2485, 2969, 3371, 3675, 4110, 4249, 4739, 4928, 5671, 6345, 6439, 6559, 6654, 6986, 7234, 7821, 7917]","[0, 269, 359, 524, 663, 753, 921, 1235, 1625, 1715, 2119, 2263, 2500, 2649, 2744, 3036, 3279, 3374, 3574, 3668, 3808, 4140, 4307, 4401, 4532, 4627, 5265, 5625, 6175, 6271]",15957,14974,10143,7917,6271,38,93,137,66,86,"[0, 169, 454, 844, 1493, 1843, 2194, 2649, 3334, 3754, 4470, 5077, 5691, 6757, 7591, 8213, 9210, 10461, 11492, 12382, 13224, 14284, 14708, 15614, 16357, 17463, 18607, 19023, 19491, 20552]","[0, 246, 441, 736, 994, 1526, 1862, 2301, 2732, 3173, 3660, 4251, 4817, 5237, 5926, 6467, 7261, 7889, 8494, 9516, 10499, 11346, 12044, 12519, 13162, 14360, 15928, 16336, 16960, 17577]","[0, 284, 605, 1193, 1651, 2067, 2625, 3071, 3491, 4176, 4686, 4776, 5293, 5725, 6493, 6695, 7722, 8437, 9185, 9700, 10124, 10679, 11110, 12133, 13087, 13803, 14778, 15121, 15558, 16029]","[0, 220, 310, 445, 596, 850, 1052, 1268, 1523, 1855, 2251, 2712, 2978, 3271, 3682, 3946, 4437, 4721, 5087, 5491, 6192, 6787, 7008, 7429, 7843, 8541, 9158, 9305, 9641, 9889]","[0, 169, 295, 472, 676, 920, 1085, 1258, 1568, 1777, 2181, 2516, 2606, 2900, 3744, 4171, 4429, 4587, 5038, 5501, 5790, 6437, 7039, 7612, 7920, 8612, 9051, 9145, 9510, 9792]",20552,17577,16029,9889,9792,-4595,-2603,-5886,-1972,-3521,-18577,30,dire
7605720616,120,129,114,40,26,"[0, 326, 689, 1013, 1347, 1862, 2191, 2559, 3048, 3462, 3949, 4329, 4802, 5378, 5981, 6244, 6787, 7294, 8148, 9229, 9712, 10143, 10609, 10806, 11199, 12016, 12323, 13144, 13316, 13905]","[0, 284, 651, 1016, 1230, 1796, 2202, 2620, 3136, 3794, 4351, 4865, 5337, 6049, 6344, 6438, 7150, 7498, 7843, 8733, 9210, 9597, 10042, 10239, 10334, 10501, 11065, 12015, 12538, 13044]","[0, 289, 456, 828, 1234, 1474, 1740, 2226, 2586, 3071, 3466, 3835, 4140, 4943, 5274, 5719, 6662, 7424, 7685, 8342, 8914, 9610, 10120, 10317, 10597, 10764, 10978, 11787, 11986, 12321]","[0, 169, 259, 399, 489, 619, 831, 1398, 1488, 1681, 1816, 1953, 2043, 2346, 2514, 2608, 3141, 3326, 3451, 4227, 4515, 4668, 5154, 5595, 5794, 6380, 6761, 7484, 7655, 8043]","[0, 169, 259, 349, 524, 745, 835, 974, 1064, 1448, 1629, 1729, 1819, 2102, 2235, 2377, 3096, 3325, 3540, 3904, 4257, 4762, 5532, 5804, 5974, 6216, 6386, 6555, 6726, 7290]",13905,13044,12321,8043,7290,73,43,137,19,121,"[0, 330, 663, 1098, 1528, 1658, 2058, 2703, 3600, 3952, 4307, 4998, 5824, 6732, 7551, 7943, 8937, 10654, 11336, 11928, 12566, 13456, 14367, 15821, 17216, 18288, 19826, 21741, 23169, 23559]","[0, 203, 735, 1122, 1680, 2061, 2477, 2952, 3404, 4168, 4563, 5036, 6179, 6509, 7090, 7744, 7975, 8133, 9182, 9734, 10256, 10722, 11757, 13267, 13902, 14159, 14998, 16248, 16968, 17948]","[0, 333, 702, 1064, 1343, 1695, 2148, 2558, 3006, 3242, 3760, 4434, 5176, 5921, 6302, 6497, 6871, 7462, 7909, 8561, 9087, 9682, 9958, 11094, 11722, 12472, 13043, 14043, 14220, 14525]","[0, 169, 324, 414, 675, 765, 855, 1184, 1324, 1767, 1966, 2165, 2588, 2885, 3131, 3421, 3516, 3952, 4459, 4769, 5203, 5463, 5824, 6660, 7234, 7629, 8055, 8736, 9003, 9203]","[0, 169, 298, 501, 746, 853, 1051, 1445, 1585, 1725, 1859, 2003, 2401, 2837, 3026, 3221, 3316, 3942, 4205, 4417, 4798, 4992, 5306, 5879, 6049, 6753, 7258, 7709, 8020, 8429]",23559,17948,14525,9203,8429,-9654,-4904,-2204,-1160,-1139,-19061,30,dire
7606077915,95,120,128,92,31,"[57, 233, 512, 836, 1041, 1610, 2140, 2360, 2665, 2932, 3199, 3999, 4418, 4893, 5259, 5471, 5931, 6726, 7538, 7965, 8401, 9230, 9598, 10027, 10628, 10896, 12142, 12849, 13481, 13755]","[57, 221, 502, 746, 1116, 1456, 1812, 2124, 2467, 2852, 2942, 3723, 4182, 4510, 5078, 5491, 6608, 7177, 7330, 7649, 8193, 8398, 8529, 8789, 8884, 10040, 10668, 11279, 11618, 11714]","[325, 455, 733, 905, 1249, 1655, 2154, 2414, 2633, 3064, 3503, 3895, 4653, 4847, 5145, 5425, 6478, 6976, 7424, 8260, 8355, 9184, 9452, 9624, 9919, 10539, 10633, 11037, 11133, 11407]","[57, 237, 327, 640, 730, 908, 1414, 1713, 1965, 2104, 2389, 2924, 3275, 3434, 3860, 4137, 4578, 4966, 5188, 5866, 5961, 6348, 6560, 6753, 6975, 7258, 7352, 8224, 8429, 8703]","[57, 187, 277, 367, 457, 685, 868, 1003, 1093, 1183, 1273, 1787, 2050, 2145, 2451, 2681, 3103, 3309, 3404, 4159, 4254, 4838, 4933, 5111, 5206, 5810, 6277, 6681, 6777, 7280]",13755,11714,11407,8703,7280,15,74,57,85,20,"[0, 623, 783, 1292, 1534, 1860, 2384, 2867, 3359, 3961, 4394, 4852, 5379, 5983, 6407, 7941, 8890, 9472, 10375, 11594, 13034, 14550, 15718, 16854, 18115, 18801, 20371, 21428, 22541, 24842]","[0, 396, 870, 1129, 1722, 2159, 2642, 3124, 3750, 4195, 4578, 5237, 5691, 6174, 6356, 7044, 7292, 8171, 8945, 9956, 10915, 11826, 12539, 13169, 14539, 15127, 16100, 16858, 18031, 19366]","[0, 244, 535, 854, 1538, 1789, 1918, 2381, 2994, 3567, 4070, 4240, 4825, 5421, 6049, 6564, 6907, 7676, 8208, 8471, 9230, 9895, 10774, 11715, 12373, 12741, 13373, 13859, 14174, 15526]","[0, 418, 508, 678, 768, 945, 1388, 1568, 1715, 2040, 2434, 2649, 2879, 3082, 3177, 3880, 4276, 4464, 4559, 4987, 5194, 5556, 5905, 6252, 6719, 7262, 7762, 8069, 8384, 9977]","[0, 312, 457, 593, 853, 983, 1073, 1253, 1523, 1758, 1893, 2062, 2326, 2576, 2718, 3042, 3227, 3571, 4014, 4286, 4623, 5263, 5789, 6317, 6803, 7165, 7579, 7830, 8483, 9627]",24842,19366,15526,9977,9627,-11087,-7652,-4119,-1274,-2347,-26479,30,dire
7606260002,73,21,28,45,26,"[0, 366, 833, 1212, 1631, 2058, 2379, 3066, 3338, 3772, 4976, 5667, 6517, 7868, 8460, 9172, 9648, 11106, 12452, 12932, 13842, 14862, 15886, 16405, 17852, 18685, 19936, 21950, 23217, 24239]","[0, 260, 591, 1000, 1708, 2038, 2467, 2557, 3314, 4208, 4779, 5686, 6178, 6736, 7257, 7643, 8086, 8346, 9424, 9827, 10165, 10490, 11034, 11797, 12419, 13360, 13536, 14649, 15290, 15941]","[0, 369, 497, 972, 1319, 1611, 1990, 2151, 2432, 2649, 3085, 3669, 4016, 4662, 5158, 5572, 6139, 6365, 6710, 7180, 7671, 7818, 8048, 8376, 8686, 9617, 9991, 10417, 10594, 11005]","[0, 364, 454, 544, 681, 771, 1131, 1337, 1427, 1945, 2463, 2706, 3171, 3904, 4279, 4595, 4831, 5006, 5270, 5864, 6031, 6524, 7027, 7194, 7335, 7786, 8362, 8970, 9147, 9474]","[0, 210, 344, 434, 572, 708, 798, 937, 1340, 1677, 2204, 2702, 2888, 3138, 3415, 3817, 4199, 4632, 4922, 5283, 5432, 6287, 6742, 6924, 7018, 7713, 7889, 8258, 8481, 8621]",24239,15941,11005,9474,8621,98,15,106,65,83,"[0, 503, 830, 1131, 1452, 1652, 2019, 2487, 3053, 3600, 4069, 4691, 5136, 5816, 6259, 6750, 7468, 8475, 9111, 10536, 11092, 12477, 12806, 14066, 14953, 16029, 16737, 17891, 18698, 18985]","[0, 198, 420, 630, 765, 1002, 1328, 1577, 2048, 2471, 2852, 3268, 3433, 3863, 4225, 4541, 4848, 5875, 6263, 6786, 7762, 8313, 9212, 9885, 10359, 11666, 11853, 12410, 12506, 12769]","[0, 322, 572, 1034, 1159, 1531, 2019, 2614, 3345, 3509, 4136, 4646, 5029, 5473, 5622, 5858, 6296, 7269, 7534, 7813, 8253, 8761, 9708, 10350, 11337, 11504, 11934, 12573, 12983, 13549]","[0, 198, 288, 412, 825, 955, 1568, 1835, 1973, 2063, 2312, 2678, 2942, 3281, 3790, 4515, 4909, 5498, 5593, 6047, 6433, 7326, 7655, 8267, 8994, 9418, 9513, 9832, 10591, 11200]","[0, 198, 288, 423, 513, 643, 733, 880, 1288, 1421, 1654, 1834, 2054, 2317, 2601, 2696, 2853, 3187, 3282, 3592, 3749, 4364, 4740, 4962, 5360, 5799, 5952, 6733, 7040, 7217]",18985,12769,13549,11200,7217,5254,3172,-2544,-1726,1404,5560,30,dire
7606543711,18,65,104,121,84,"[0, 333, 653, 1050, 1373, 1775, 2192, 2940, 3353, 3725, 4583, 5323, 5894, 6697, 7460, 8243, 9068, 10060, 11021, 12181, 12837, 13244, 14547, 14849, 16659, 18350, 19748, 20823, 21476, 22273]","[0, 170, 378, 763, 1040, 1363, 1615, 2024, 2235, 3106, 3785, 4159, 4853, 5437, 6044, 6861, 7370, 7822, 8534, 9332, 9673, 10535, 10965, 11929, 12450, 12932, 14187, 14434, 14697, 14928]","[0, 323, 488, 811, 1232, 1710, 1871, 1961, 2535, 3256, 3640, 3944, 4084, 4575, 4823, 5117, 5541, 6102, 6658, 7021, 7710, 8520, 8614, 9570, 10622, 11069, 11812, 11907, 12003, 12343]","[0, 170, 260, 437, 616, 1112, 1202, 1292, 1382, 1620, 1875, 2020, 2114, 2361, 2709, 3208, 3696, 3913, 4698, 5078, 5727, 6006, 6148, 7096, 7357, 8312, 8656, 8821, 9228, 9459]","[0, 170, 260, 405, 535, 671, 859, 989, 1079, 1169, 1625, 1857, 1947, 2091, 2507, 2701, 2981, 3215, 3874, 4384, 4479, 4794, 5074, 5311, 5605, 6378, 6844, 6973, 7069, 7550]",22273,14928,12343,9459,7550,123,106,11,97,93,"[0, 202, 570, 1088, 1505, 1915, 2206, 2499, 2876, 3220, 3650, 4154, 4856, 5491, 6293, 7205, 8294, 9070, 9855, 10876, 11945, 12068, 13252, 13984, 14709, 15536, 16629, 17624, 18425, 19331]","[0, 253, 584, 871, 1367, 1774, 2373, 3433, 3841, 4149, 4438, 4996, 5556, 6272, 6683, 7427, 8261, 8390, 8685, 9532, 10686, 11903, 12846, 14606, 15135, 15986, 16382, 17982, 18826, 19853]","[0, 199, 862, 1332, 1776, 2340, 2751, 3399, 3802, 4394, 5026, 5597, 6424, 6728, 8027, 8690, 9441, 10190, 10873, 12290, 12715, 12913, 13626, 14097, 14432, 15134, 15624, 15719, 16643, 17863]","[0, 130, 296, 592, 729, 952, 1042, 1332, 1477, 1626, 1851, 2006, 2276, 2524, 3047, 3142, 3611, 4014, 4326, 5390, 5900, 6572, 7377, 8086, 8612, 8864, 9212, 9865, 10256, 10773]","[0, 130, 220, 422, 512, 651, 741, 876, 1011, 1101, 1326, 1462, 1955, 2169, 2626, 2947, 3185, 3492, 3757, 4073, 4701, 4796, 5458, 6081, 6414, 6636, 6730, 7513, 8137, 8534]",19331,19853,17863,10773,8534,2942,-4925,-5520,-1314,-984,-9801,30,radiant
7606980009,67,36,20,53,105,"[0, 169, 575, 894, 1286, 1491, 1878, 2292, 2751, 3011, 3469, 3643, 4603, 5029, 5568, 6135, 6638, 6989, 7564, 7991, 9606, 10023, 11394, 12223, 12895, 13393, 14606, 15463, 16753, 17373]","[0, 165, 456, 775, 1022, 1146, 1307, 1561, 1651, 2248, 2447, 3154, 3904, 4211, 4931, 6282, 6961, 7741, 8050, 8145, 8615, 9122, 9841, 10316, 10457, 10949, 11472, 12076, 13038, 13440]","[0, 242, 549, 825, 1328, 1759, 1957, 2554, 2778, 3083, 3306, 3568, 4133, 4227, 5083, 5756, 5878, 6459, 6868, 7485, 8269, 8539, 9335, 9607, 9702, 10153, 10577, 10820, 11497, 11963]","[0, 130, 220, 465, 677, 811, 1150, 1471, 1605, 1695, 1868, 2292, 2644, 2821, 3453, 3829, 4086, 4281, 4905, 5000, 6267, 6537, 6796, 7027, 7663, 8075, 8605, 9282, 9869, 10004]","[0, 130, 586, 713, 1262, 1598, 1722, 2440, 2594, 2763, 2853, 2943, 3510, 3719, 4115, 4682, 4777, 4871, 5102, 5447, 6207, 6328, 6498, 6668, 6838, 7332, 7998, 8168, 9285, 9555]",17373,13440,11963,10004,9555,43,21,92,19,100,"[0, 374, 820, 1073, 1562, 2201, 2550, 3216, 4002, 4379, 4938, 5532, 5914, 6859, 7317, 7566, 8137, 9548, 10869, 11485, 11690, 12614, 12934, 13658, 14637, 15919, 16964, 17375, 17999, 18095]","[0, 267, 567, 783, 1069, 1159, 1625, 1817, 2466, 2889, 3772, 4202, 4852, 5634, 6405, 7001, 7783, 8596, 10015, 10407, 10612, 11044, 11557, 12739, 13757, 14289, 15590, 16196, 17256, 17352]","[0, 305, 593, 863, 1173, 1592, 1977, 2366, 2672, 3050, 3628, 4350, 5052, 5692, 6038, 6395, 7292, 7585, 8240, 9018, 9715, 10808, 11162, 11659, 12039, 12779, 13378, 13554, 13776, 14202]","[0, 246, 373, 463, 597, 807, 1027, 1117, 1333, 1778, 2158, 2649, 2778, 3095, 3319, 3753, 4576, 4900, 5657, 6016, 6221, 6682, 7141, 7864, 8450, 8802, 9527, 10081, 10258, 10451]","[0, 636, 1020, 1205, 1295, 1385, 2076, 2166, 2465, 2665, 3236, 3604, 3694, 4066, 4471, 4620, 5221, 5598, 6254, 6412, 6689, 7691, 8163, 9093, 9612, 10128, 10726, 11268, 11653, 11749]",18095,17352,14202,10451,11749,-722,-3912,-2239,-447,-2194,-9514,30,radiant
7607071600,18,129,120,79,86,"[0, 242, 509, 813, 1264, 1562, 1852, 2204, 2734, 3178, 3957, 4695, 5548, 6098, 7020, 7657, 8382, 9435, 10763, 11319, 12199, 13056, 13903, 14487, 15058, 15980, 17335, 18175, 19242, 20998]","[0, 249, 412, 692, 1200, 1488, 1749, 2015, 2275, 2514, 2849, 3182, 3625, 4302, 4741, 5766, 5992, 6516, 7132, 7227, 8533, 9125, 10408, 10988, 11473, 12244, 12992, 13782, 14520, 15748]","[0, 344, 664, 965, 1402, 1788, 2309, 2654, 3275, 3660, 3971, 4478, 5393, 5816, 6625, 7470, 8087, 8687, 9541, 9880, 10387, 10763, 11830, 12229, 13164, 14019, 14794, 15421, 15679, 16482]","[0, 170, 599, 689, 857, 986, 1076, 1211, 1526, 1711, 1902, 2008, 2412, 2627, 3159, 3659, 4320, 4954, 5063, 5279, 6137, 6370, 6667, 6981, 7313, 7737, 8055, 8587, 8973, 10015]","[0, 170, 260, 385, 636, 979, 1126, 1406, 1604, 1900, 2221, 2465, 2764, 3015, 3344, 3668, 3852, 4303, 4907, 5171, 5925, 6286, 6517, 7210, 7874, 8307, 8600, 9010, 9378, 9994]",20998,15748,16482,10015,9994,95,106,49,123,64,"[0, 243, 605, 856, 1469, 1829, 2390, 2889, 3301, 3757, 4342, 4839, 5510, 6024, 6612, 7278, 8261, 9115, 9929, 10976, 11098, 11294, 12020, 12911, 13887, 14873, 15588, 16200, 17006, 17249]","[0, 328, 733, 1120, 1567, 1840, 2211, 2704, 3169, 3522, 3908, 4399, 4699, 5014, 5582, 5677, 6368, 6932, 7273, 7736, 8318, 8914, 9571, 9912, 10627, 11181, 11884, 12661, 12960, 13526]","[0, 170, 453, 672, 1087, 1349, 1666, 2159, 2402, 2788, 3227, 3516, 4213, 4714, 5292, 5654, 6174, 6415, 6821, 7276, 7370, 7790, 7957, 8692, 9260, 9764, 9859, 10762, 11066, 11421]","[0, 170, 260, 413, 543, 719, 809, 1188, 1278, 1605, 1928, 2124, 2286, 2642, 2869, 3291, 3588, 4071, 4214, 4611, 5458, 5728, 6102, 6272, 6817, 7338, 7863, 8854, 9343, 9857]","[0, 170, 260, 395, 525, 692, 905, 1103, 1193, 1559, 1739, 1867, 2005, 2154, 2293, 2463, 2787, 3112, 3245, 3812, 3906, 4231, 4878, 5257, 5425, 5520, 5615, 6115, 6279, 6478]",17249,13526,11421,9857,6478,3749,2222,5061,158,3516,14706,30,radiant
7607094907,16,89,107,75,50,"[73, 240, 561, 1188, 1530, 1992, 2321, 2987, 3634, 3798, 4095, 4432, 4919, 5138, 5581, 5807, 7099, 7546, 7956, 9256, 9780, 10395, 11289, 11979, 12255, 12563, 12948, 13242, 13922, 14338]","[0, 291, 516, 606, 888, 1017, 1622, 1927, 2270, 2397, 2757, 3221, 3744, 4181, 4721, 5145, 5812, 6735, 7179, 7979, 8513, 8842, 8937, 9938, 10774, 11379, 11602, 11896, 12569, 13198]","[73, 354, 634, 856, 1406, 1829, 2721, 3259, 3739, 3979, 4646, 5547, 5876, 6414, 7040, 7357, 8261, 8685, 9294, 9877, 10591, 10980, 11392, 12119, 12264, 12618, 13007, 13538, 14156, 14473]","[206, 336, 426, 516, 843, 933, 1161, 1423, 1552, 1642, 2404, 3206, 3886, 4431, 4748, 4942, 5431, 5970, 6597, 7260, 7877, 8194, 8561, 8754, 9098, 9540, 9717, 9967, 10342, 10537]","[73, 203, 293, 655, 745, 862, 1229, 1610, 1780, 1870, 2004, 2231, 2778, 3391, 3885, 4034, 4572, 5018, 5176, 5656, 5855, 6104, 6996, 7340, 7434, 7601, 8183, 8685, 8917, 9171]",14338,13198,14473,10537,9171,71,93,19,85,64,"[176, 388, 730, 1195, 1419, 1888, 2018, 2724, 2972, 3443, 3770, 4450, 4865, 5172, 5918, 6470, 6802, 7330, 8053, 8539, 9145, 9737, 10573, 11155, 11763, 12496, 13056, 14098, 14876, 15135]","[178, 459, 732, 1052, 1385, 1594, 1759, 2171, 2467, 3108, 3505, 3916, 4158, 4533, 4872, 5690, 6043, 6318, 6765, 7194, 7404, 7748, 7915, 8343, 8721, 9089, 9660, 11852, 12282, 12580]","[121, 402, 634, 919, 1203, 1534, 1889, 2196, 2654, 3449, 4029, 4280, 4370, 4648, 4968, 5377, 5792, 6068, 6413, 6749, 7121, 7216, 7783, 8260, 8833, 9278, 9678, 9955, 10763, 11070]","[178, 388, 478, 831, 961, 1051, 1225, 1561, 1763, 3182, 3362, 3452, 3759, 3925, 4020, 4396, 4878, 4973, 5488, 5854, 6038, 6231, 6577, 6834, 7079, 7174, 8479, 9179, 9356, 9452]","[712, 924, 1014, 1317, 1447, 1671, 1891, 2314, 2569, 2845, 3078, 3335, 3489, 3584, 3965, 4237, 4394, 4642, 4737, 4895, 5079, 5357, 5727, 5984, 6123, 6218, 6686, 7358, 7535, 7631]",15135,12580,11070,9452,7631,-797,618,3403,1085,1540,5849,30,radiant
7607426114,48,78,13,86,138,"[0, 286, 531, 1064, 1564, 1901, 2532, 2975, 3345, 3875, 4257, 4698, 5637, 6184, 6985, 7789, 8719, 9413, 10492, 11653, 12462, 12992, 13850, 14967, 15931, 16691, 17612, 19186, 20327, 20727]","[0, 170, 438, 747, 994, 1202, 1329, 1654, 1988, 2352, 2706, 3296, 4264, 4791, 5343, 5904, 6687, 7175, 7837, 8826, 9162, 9436, 9789, 10351, 10695, 11719, 12488, 13713, 14493, 15343]","[0, 312, 551, 820, 1152, 1416, 1634, 1945, 2476, 2995, 3587, 3901, 4394, 5171, 5507, 5879, 6641, 7040, 7410, 8039, 8674, 9600, 10449, 11054, 11792, 12344, 12857, 13630, 14365, 14834]","[0, 170, 307, 427, 662, 801, 994, 1454, 1718, 1931, 2180, 2308, 2715, 3178, 3348, 3617, 3865, 4313, 4612, 4823, 5286, 5728, 6000, 6324, 6793, 7093, 7490, 8718, 9073, 9870]","[0, 170, 260, 380, 600, 726, 816, 951, 1375, 1515, 1650, 1815, 2338, 2820, 3118, 3433, 3726, 4022, 4321, 4585, 4781, 5011, 5106, 5758, 5943, 6148, 6467, 7056, 7390, 7735]",20727,15343,14834,9870,7735,21,98,19,100,26,"[0, 542, 971, 1339, 1713, 2124, 2537, 2863, 3439, 3757, 4150, 4577, 4667, 5055, 5648, 6251, 6744, 7396, 7721, 8371, 9017, 10024, 10613, 11239, 12069, 12836, 13398, 13770, 13956, 14602]","[0, 204, 499, 783, 1028, 1362, 1659, 1874, 2114, 2537, 3054, 3535, 3970, 4645, 5238, 6133, 6742, 7258, 8014, 8557, 9423, 10211, 10908, 12023, 12397, 12763, 13360, 13775, 13943, 14871]","[0, 256, 604, 921, 1221, 1549, 2176, 2795, 3150, 3753, 4096, 4458, 4893, 5088, 5433, 5888, 6422, 6587, 6912, 7273, 7842, 8109, 8861, 9345, 10198, 10638, 11024, 11440, 11915, 12476]","[0, 239, 354, 489, 624, 800, 935, 1101, 1281, 1371, 1687, 1899, 2131, 2489, 2584, 2891, 3120, 3285, 3778, 4013, 4419, 4586, 5003, 5281, 5421, 5833, 5928, 6297, 6440, 6716]","[0, 170, 285, 410, 581, 759, 894, 1060, 1195, 1550, 1703, 1832, 2026, 2203, 2500, 2702, 3109, 3388, 4044, 4263, 4448, 4633, 4800, 5078, 5265, 5432, 5595, 5689, 5869, 6046]",14602,14871,12476,6716,6046,6125,472,2358,3154,1689,13798,30,radiant
7607461619,14,13,53,107,31,"[0, 244, 554, 802, 1523, 2074, 2534, 2869, 3563, 3809, 4787, 5376, 5770, 6396, 7162, 7742, 8308, 8921, 10221, 10754, 11740, 13060, 13671, 15109, 15374, 17063, 17659, 18414, 19296, 21218]","[0, 203, 486, 853, 1144, 1626, 1867, 2339, 3062, 3486, 4170, 4643, 5140, 5372, 6064, 7355, 8047, 8906, 9854, 10176, 11109, 11792, 12490, 13739, 13905, 14780, 15336, 16111, 17262, 18751]","[0, 213, 407, 497, 782, 872, 1127, 1343, 1526, 1616, 1968, 2600, 2962, 3664, 4314, 5880, 6311, 6832, 7912, 8444, 8991, 10051, 10273, 11559, 11950, 12714, 13487, 14077, 14674, 15375]","[0, 130, 316, 557, 687, 812, 976, 1220, 1527, 1927, 2435, 3066, 3267, 3663, 4240, 4636, 5043, 5668, 6337, 6764, 7135, 7847, 8683, 9616, 9786, 10663, 11044, 11505, 12048, 12891]","[0, 481, 623, 761, 1101, 1319, 1843, 2202, 2605, 2695, 3340, 3888, 4316, 4536, 5239, 5334, 5830, 6073, 7004, 7514, 8006, 8403, 8682, 9414, 9578, 10419, 10810, 11270, 11682, 12213]",21218,18751,15375,12891,12213,15,120,21,20,91,"[0, 210, 471, 752, 1185, 1618, 1979, 2637, 3074, 3594, 4122, 4850, 5374, 6159, 6733, 7533, 7980, 8619, 8977, 9906, 10852, 11725, 12319, 12544, 13278, 13626, 14807, 15726, 16900, 17034]","[0, 281, 533, 833, 1285, 1617, 2097, 2715, 3169, 3954, 4526, 5063, 5402, 5984, 6334, 7055, 7919, 8223, 8318, 8461, 9116, 9379, 9992, 10823, 11029, 11534, 11629, 11923, 12666, 13026]","[0, 295, 578, 814, 904, 1356, 1939, 2403, 2762, 3126, 3793, 4165, 4844, 5463, 5929, 6290, 7180, 7666, 7867, 8139, 8918, 9012, 10134, 10721, 10816, 11194, 11365, 12044, 12585, 13214]","[0, 532, 622, 712, 802, 892, 1068, 1344, 1518, 2144, 2426, 2656, 2746, 2930, 3025, 3477, 3923, 4017, 4234, 4363, 4762, 6075, 6170, 6265, 6452, 6720, 6815, 6957, 7393, 7753]","[0, 210, 337, 427, 517, 624, 763, 981, 1117, 1256, 1538, 1834, 1930, 2163, 2293, 2615, 2899, 2993, 3100, 3279, 3678, 3951, 4092, 4694, 4811, 4905, 5044, 5232, 5481, 5841]",17034,13026,13214,7753,5841,4184,5725,2161,5138,6372,23580,30,radiant
7607666802,93,49,135,52,86,"[0, 283, 681, 967, 1341, 1678, 1992, 2400, 2683, 3117, 3630, 4151, 4539, 4688, 5451, 6055, 6622, 7404, 7888, 8352, 9232, 9866, 10210, 10985, 11636, 12682, 13255, 13995, 14506, 14776]","[0, 282, 702, 973, 1343, 1714, 2126, 2596, 2890, 3684, 4325, 4660, 5289, 5624, 6098, 6715, 7450, 7674, 7768, 8184, 8533, 8987, 9750, 10362, 11202, 11443, 12173, 12463, 12768, 13131]","[0, 331, 718, 976, 1382, 1681, 2359, 2630, 3073, 3725, 4404, 4959, 5165, 5860, 6435, 6926, 7466, 7688, 8133, 8604, 8855, 9335, 9965, 10391, 10882, 10977, 11371, 11906, 12300, 12396]","[100, 360, 1008, 1168, 1455, 1612, 1702, 1837, 1927, 2272, 2738, 2929, 3198, 3523, 3912, 4338, 4496, 4795, 5200, 5397, 5773, 6227, 6405, 6826, 7015, 7346, 7474, 7788, 7918, 8197]","[0, 210, 334, 428, 622, 821, 1025, 1406, 1496, 1781, 2159, 2591, 3064, 3389, 3574, 3899, 4104, 4565, 4816, 5061, 5535, 6604, 6698, 7122, 7312, 7456, 7791, 8461, 8844, 9080]",14776,13131,12396,8197,9080,109,98,137,27,45,"[0, 167, 524, 861, 1304, 1639, 1903, 2311, 2782, 3197, 3801, 4403, 4918, 5784, 6169, 6749, 7674, 9023, 9744, 11093, 12144, 13442, 13767, 14518, 15313, 16253, 16836, 18270, 19976, 21427]","[0, 178, 413, 655, 1060, 1443, 1838, 2008, 2489, 2949, 3399, 3919, 4095, 4863, 5275, 5992, 6150, 6955, 7379, 7697, 8802, 10336, 10954, 11259, 12107, 13201, 13771, 15122, 16010, 16872]","[0, 169, 586, 935, 1397, 1725, 2224, 2495, 2895, 3271, 3406, 3729, 4127, 4771, 5147, 5614, 6085, 6415, 6994, 7299, 7892, 8919, 9639, 9903, 10446, 11174, 11504, 11983, 12634, 13178]","[0, 165, 300, 440, 648, 784, 874, 1132, 1222, 1312, 1447, 1787, 2121, 2528, 2771, 2959, 3250, 3847, 4101, 4368, 5021, 5116, 5598, 5693, 6351, 7367, 7514, 8121, 8643, 9346]","[0, 130, 220, 356, 535, 699, 1064, 1366, 1456, 1773, 1987, 2233, 2476, 2840, 3083, 3308, 3512, 3994, 4177, 4335, 4980, 5219, 5578, 5673, 6502, 7268, 7715, 8466, 8988, 9705]",21427,16872,13178,9346,9705,-6651,-3741,-782,-1149,-625,-12948,30,dire
7607767417,41,28,35,123,26,"[0, 290, 502, 762, 1318, 1563, 2153, 2727, 3083, 3209, 3547, 3773, 4368, 4626, 5433, 6232, 7458, 8034, 9035, 9379, 9830, 10430, 10978, 11596, 12390, 12970, 13768, 14760, 15075, 15952]","[0, 531, 899, 1277, 1453, 1580, 2074, 2544, 3467, 3885, 4335, 4858, 5642, 6605, 7609, 7740, 8795, 9262, 9582, 10025, 10284, 10826, 11464, 12198, 13099, 13370, 13842, 14619, 15106, 15582]","[0, 263, 438, 642, 816, 1140, 1266, 1426, 1678, 2215, 2749, 3108, 3415, 3603, 4350, 4893, 5808, 6515, 6735, 6829, 7516, 8761, 9275, 9498, 10029, 10623, 11450, 11707, 13133, 13697]","[0, 228, 542, 632, 767, 857, 1133, 1359, 1535, 1625, 1805, 2018, 2360, 2548, 2838, 2983, 3743, 4112, 4374, 4711, 5067, 5496, 5684, 5982, 6373, 6751, 7137, 7617, 7875, 8189]","[0, 228, 318, 452, 622, 712, 898, 1247, 1386, 1476, 1656, 2039, 2129, 2314, 2643, 2737, 3399, 3601, 3696, 4287, 4546, 5070, 5255, 5384, 5822, 6187, 6558, 7158, 7683, 7994]",15952,15582,13697,8189,7994,98,19,95,60,37,"[0, 285, 574, 935, 1274, 1470, 1917, 2718, 3179, 3946, 4783, 5364, 5625, 6524, 6836, 7352, 7447, 8294, 9349, 9845, 10758, 11061, 11980, 12635, 13935, 14388, 15134, 15875, 16659, 16755]","[0, 254, 499, 949, 1290, 1699, 2112, 2531, 2965, 3337, 3928, 4626, 5033, 5395, 5797, 6750, 6884, 7470, 8870, 9810, 10391, 10693, 10860, 11605, 12595, 13464, 13797, 14853, 16018, 16182]","[0, 170, 344, 480, 570, 705, 887, 1131, 1355, 1937, 2624, 2898, 3107, 3552, 3864, 4805, 5129, 5568, 6098, 7113, 7564, 7708, 7926, 8416, 9116, 9660, 10321, 10797, 11852, 12317]","[0, 288, 460, 791, 1076, 1541, 1895, 2578, 2912, 3393, 3869, 4493, 5310, 5964, 6320, 6998, 7093, 7445, 8116, 8731, 9564, 9911, 10736, 10986, 11297, 11577, 12004, 12293, 12780, 13055]","[0, 206, 296, 386, 524, 998, 1181, 1404, 1584, 1710, 2292, 2766, 3084, 3936, 4085, 4640, 4741, 5003, 5738, 6184, 6656, 7311, 7727, 8083, 8394, 9031, 9261, 9843, 10130, 10226]",16755,16182,12317,13055,10226,-803,-600,1380,-4866,-2232,-7121,30,dire
7607899304,129,22,41,105,112,"[0, 210, 542, 788, 1343, 1589, 1897, 2379, 2625, 3014, 3397, 3637, 4064, 4494, 4912, 5426, 6362, 6794, 7597, 8036, 8609, 9394, 10483, 11519, 11972, 13051, 14548, 15031, 15703, 16720]","[0, 333, 753, 1163, 1451, 1947, 2683, 2945, 3471, 4176, 4655, 5502, 6065, 7261, 7669, 8328, 8704, 8951, 9468, 10110, 10883, 11645, 12884, 13559, 14489, 14995, 15665, 16200, 16697, 17591]","[0, 217, 620, 865, 1171, 1497, 1825, 2496, 2813, 3486, 3812, 4089, 4624, 5372, 5687, 5945, 6437, 7010, 7439, 7791, 8163, 8594, 10382, 11246, 11808, 12880, 13753, 14181, 14958, 15690]","[0, 170, 260, 350, 480, 617, 833, 1230, 1320, 1805, 1940, 2287, 2695, 2951, 3506, 3601, 3822, 3917, 4550, 4820, 5263, 5537, 5758, 6214, 6672, 7072, 7628, 7784, 8061, 8401]","[0, 170, 260, 350, 572, 662, 966, 1101, 1191, 1843, 1978, 2176, 2362, 2607, 2878, 3071, 3413, 3642, 3848, 3943, 4185, 4280, 4374, 4913, 5168, 5734, 6000, 6095, 6375, 6623]",16720,17591,15690,8401,6623,49,45,32,21,37,"[0, 218, 521, 1122, 1571, 2022, 2586, 3124, 3619, 3867, 4258, 5094, 5693, 6100, 6414, 7389, 7962, 8673, 9792, 10189, 11053, 11359, 11834, 11929, 13155, 13805, 15044, 15364, 16138, 16592]","[0, 254, 502, 873, 1199, 1541, 1960, 2406, 3112, 3293, 3624, 4195, 4664, 4922, 5475, 5980, 6637, 7396, 8694, 9685, 10175, 11058, 11714, 11809, 12506, 12824, 13836, 14407, 14851, 15498]","[0, 279, 548, 684, 890, 1307, 1604, 1929, 2534, 2850, 3352, 3697, 4066, 4247, 4801, 5421, 5840, 6401, 6582, 7135, 7569, 8340, 8514, 8867, 9405, 9629, 10693, 11153, 11934, 12324]","[0, 518, 608, 867, 1020, 1202, 1508, 1775, 1865, 2087, 2428, 2608, 2783, 3214, 3308, 3485, 3905, 4196, 4701, 5486, 5850, 6168, 6539, 7063, 7591, 7954, 9125, 9713, 10291, 10468]","[0, 170, 260, 350, 730, 865, 1002, 1137, 1528, 1755, 2085, 2544, 2781, 2941, 3139, 3398, 3641, 3882, 4569, 4961, 5146, 5613, 6098, 6193, 6481, 6575, 7499, 7729, 9003, 9560]",16592,15498,12324,10468,9560,128,2093,3366,-2067,-2937,583,30,radiant
7608021100,52,93,129,9,112,"[0, 289, 577, 950, 1285, 2007, 2382, 3007, 3309, 3616, 4105, 4633, 5595, 6679, 7031, 7449, 8326, 8902, 9623, 10280, 11291, 11899, 12422, 13102, 13734, 14307, 14881, 16269, 17029, 17210]","[0, 286, 605, 821, 985, 1453, 1902, 2291, 2861, 3349, 3695, 4370, 5065, 5707, 6159, 6760, 7002, 7500, 8203, 8931, 9579, 9923, 10636, 11550, 12386, 13312, 13782, 14357, 15140, 15827]","[0, 283, 531, 807, 1122, 1412, 1695, 1996, 2365, 2869, 3336, 3848, 4588, 5128, 5859, 6227, 6939, 7559, 8065, 8707, 9050, 9714, 10636, 11212, 12054, 12501, 12733, 13647, 15038, 15527]","[0, 222, 361, 555, 741, 1062, 1214, 1502, 1592, 1682, 1868, 2297, 2604, 3122, 3498, 3593, 3913, 4059, 4372, 4666, 4930, 5024, 5737, 5965, 6060, 6390, 6609, 7602, 8056, 8346]","[100, 270, 404, 494, 584, 767, 857, 947, 1109, 1199, 1455, 1703, 1996, 2427, 2686, 2781, 3118, 3454, 3548, 3781, 4305, 4399, 4494, 4661, 5091, 5327, 5713, 6292, 6768, 6949]",17210,15827,15527,8346,6949,48,106,97,123,105,"[0, 251, 654, 1021, 1473, 2091, 2457, 3008, 3604, 4108, 4830, 5463, 6136, 6599, 7079, 8030, 9544, 10496, 11289, 12028, 13593, 14590, 15369, 16517, 17577, 18607, 19802, 20403, 20823, 21636]","[0, 324, 539, 986, 1279, 1602, 1856, 2109, 2684, 3207, 3677, 3871, 4362, 4885, 5421, 5887, 6285, 7065, 7272, 7762, 8599, 8911, 9473, 9813, 10510, 11014, 11424, 11786, 11882, 12382]","[0, 278, 602, 972, 1381, 1711, 1992, 2519, 3018, 3594, 4164, 4866, 5725, 5921, 6471, 6716, 7422, 7750, 8150, 8417, 8879, 9632, 10468, 10766, 11311, 11560, 12039, 12355, 12769, 13455]","[0, 170, 310, 430, 560, 688, 826, 1068, 1346, 1575, 1710, 1865, 2198, 2552, 2819, 3013, 3616, 3892, 4111, 4434, 5003, 5356, 6090, 6466, 6899, 7341, 7671, 8100, 8498, 8837]","[0, 170, 260, 380, 555, 764, 854, 1036, 1194, 1397, 1532, 1676, 1805, 1915, 2226, 2321, 2695, 2790, 2977, 3259, 3574, 3668, 3970, 4175, 4460, 4712, 5161, 5451, 5798, 6021]",21636,12382,13455,8837,6021,-4426,3445,2072,-491,928,1528,30,radiant
7608027516,90,69,51,105,83,"[0, 289, 600, 968, 1097, 1421, 1716, 2688, 3115, 3432, 4269, 4633, 4809, 5428, 5806, 6414, 6819, 7491, 8565, 9175, 9574, 10281, 11139, 11583, 12299, 13406, 14168, 14618, 14796, 15308]","[0, 324, 610, 944, 1358, 1718, 2264, 2698, 3114, 3841, 4554, 4962, 5345, 5938, 6626, 7221, 7915, 8466, 8945, 9691, 10689, 11182, 11831, 12197, 12534, 13026, 13525, 14004, 14316, 14803]","[0, 243, 402, 691, 1072, 1442, 1690, 2116, 2724, 3348, 4107, 4333, 4710, 5419, 5722, 5932, 6346, 6603, 7611, 8401, 8863, 9195, 9457, 9987, 10678, 11125, 11335, 12073, 12479, 13115]","[0, 169, 337, 474, 582, 712, 802, 937, 1283, 1418, 1702, 1987, 2126, 2631, 2725, 3124, 3371, 3887, 4438, 4689, 4874, 5081, 5712, 6065, 6414, 6856, 7025, 7195, 7680, 8635]","[0, 169, 259, 349, 503, 682, 784, 1012, 1102, 1256, 1584, 1971, 2406, 2706, 2800, 2895, 3084, 3346, 3831, 4317, 4678, 4889, 4984, 5172, 5364, 5615, 5709, 6008, 6197, 6444]",15308,14803,13115,8635,6444,94,120,129,9,20,"[0, 213, 532, 910, 1335, 1674, 2129, 2524, 3039, 3329, 4009, 4836, 5419, 6060, 6833, 7678, 9516, 10548, 11447, 12603, 13905, 14892, 15670, 16470, 17217, 18294, 19383, 20980, 22008, 23460]","[0, 169, 415, 778, 1195, 1534, 1965, 2576, 3032, 3583, 4134, 4724, 5358, 5900, 6448, 6958, 7606, 8576, 9208, 9605, 10048, 10545, 11247, 11767, 12506, 13323, 14249, 15678, 16175, 16657]","[0, 217, 609, 904, 1278, 1620, 2029, 2357, 2650, 3040, 3224, 3971, 5002, 5605, 6504, 7609, 8421, 8797, 9303, 9696, 10322, 10800, 11093, 11732, 12260, 12828, 12922, 13893, 14541, 15064]","[0, 169, 374, 518, 1100, 1482, 1709, 1936, 2111, 2620, 2728, 3181, 3582, 3836, 4000, 4369, 5147, 5503, 5745, 5998, 6560, 7390, 7624, 8117, 8883, 9292, 10047, 10867, 11088, 11536]","[0, 169, 296, 386, 623, 713, 1066, 1228, 1318, 1408, 1702, 2174, 2687, 3008, 3253, 3468, 3955, 4262, 4410, 4644, 5065, 5440, 5769, 6321, 6491, 7065, 7989, 8756, 9052, 9304]",23460,16657,15064,11536,9304,-8152,-1854,-1949,-2901,-2860,-17716,30,dire
7608138213,18,129,23,105,58,"[0, 252, 573, 887, 1629, 1949, 2388, 2773, 3148, 3547, 4526, 5280, 5774, 6644, 7176, 7968, 8576, 9582, 10764, 11877, 13328, 14185, 14867, 16048, 16967, 17772, 20149, 21304, 22910, 24728]","[0, 215, 573, 1057, 1389, 1870, 2116, 2610, 2923, 3122, 3460, 4012, 4562, 5085, 5347, 5902, 6516, 7052, 7257, 7747, 8550, 9223, 9953, 10810, 11392, 11955, 13010, 13837, 14582, 16206]","[0, 250, 623, 921, 1168, 1574, 2066, 2585, 2703, 2925, 3491, 4004, 4543, 4935, 5137, 5789, 6190, 7160, 7556, 8236, 9150, 9867, 10297, 10956, 11315, 11979, 12681, 13045, 13774, 15196]","[0, 130, 220, 372, 507, 804, 985, 1217, 1437, 1540, 1945, 2115, 2205, 2504, 2661, 2926, 3512, 4119, 4369, 4840, 5254, 5521, 5785, 6426, 6726, 7477, 8144, 8363, 9149, 10588]","[0, 130, 220, 310, 493, 583, 703, 1104, 1194, 1319, 1803, 2063, 2442, 2653, 2748, 3000, 3280, 3706, 3960, 4346, 5177, 5418, 5648, 5976, 6370, 6872, 7604, 7920, 8526, 9723]",24728,16206,15196,10588,9723,98,128,41,136,79,"[0, 297, 739, 1061, 1361, 1824, 2233, 3148, 3614, 3988, 4743, 5326, 6101, 6546, 7849, 8479, 9153, 9804, 10459, 11311, 11781, 12983, 13229, 14291, 15148, 15713, 15970, 16695, 17328, 17424]","[0, 293, 579, 869, 1208, 1773, 2035, 2375, 2903, 3385, 4232, 4757, 5493, 5748, 6441, 7037, 7528, 8112, 8557, 9402, 9967, 10228, 10460, 10802, 11637, 11939, 12884, 13340, 13706, 14007]","[0, 317, 519, 609, 917, 1085, 1302, 1649, 1893, 2095, 2623, 2837, 3275, 3514, 4044, 4557, 5246, 5474, 5865, 6499, 6785, 7413, 7857, 8375, 8914, 9505, 10086, 10930, 11587, 11683]","[0, 210, 300, 435, 644, 1092, 1182, 1317, 1452, 1780, 2005, 2225, 2456, 2720, 3199, 3515, 3850, 3945, 4358, 4748, 4967, 5212, 5759, 6034, 6820, 7279, 7899, 8211, 8472, 8643]","[0, 210, 300, 406, 541, 671, 805, 960, 1065, 1155, 1533, 1841, 2066, 2468, 2798, 3104, 3306, 3840, 4155, 4348, 4466, 4817, 5322, 5491, 5823, 6100, 6481, 6856, 7326, 7709]",17424,14007,11683,8643,7709,7304,2199,3513,1945,2014,16975,30,radiant
7608344219,48,106,104,22,84,"[0, 322, 529, 940, 1335, 1785, 2366, 2735, 3307, 3701, 4318, 5004, 5698, 6223, 7002, 7820, 8619, 9484, 10256, 11081, 12460, 13280, 14606, 15615, 16521, 18068, 19546, 20834, 21493, 22292]","[0, 283, 611, 936, 1375, 1621, 1793, 2231, 2515, 2931, 3522, 4097, 4385, 4943, 5651, 6244, 6988, 7787, 8689, 9414, 10174, 11137, 12258, 12690, 13643, 14538, 15413, 15588, 17223, 17877]","[0, 328, 632, 1029, 1450, 1897, 2302, 3094, 3538, 3971, 4379, 4918, 5467, 5745, 6053, 6467, 7231, 8149, 8414, 9049, 9778, 10153, 10483, 10577, 11120, 11999, 12886, 13281, 13758, 14267]","[0, 169, 259, 407, 543, 739, 834, 1152, 1242, 1415, 1550, 1640, 1880, 2091, 2429, 2930, 3564, 4173, 4527, 5109, 6073, 6254, 6459, 6748, 7654, 8361, 9076, 9251, 9988, 10991]","[0, 169, 264, 402, 492, 640, 774, 1098, 1235, 1526, 1660, 1794, 2076, 2321, 2625, 3205, 3614, 4507, 4734, 5840, 6158, 6597, 7282, 7376, 8175, 9421, 10087, 10706, 11503, 11701]",22292,17877,14267,10991,11701,18,50,96,5,86,"[0, 251, 647, 1014, 1382, 1798, 2111, 2607, 3158, 3743, 4250, 4802, 5380, 5945, 6655, 7308, 8095, 8951, 9956, 11159, 11873, 12919, 14568, 14894, 15269, 15364, 17381, 18280, 19474, 20005]","[0, 239, 575, 890, 1264, 1712, 2172, 2684, 3094, 3547, 4110, 4523, 5201, 5722, 6469, 7035, 7781, 8360, 8919, 9940, 10286, 10381, 11224, 12024, 12696, 12987, 13935, 14427, 14993, 15089]","[0, 244, 681, 1009, 1473, 1812, 2274, 2672, 3271, 3828, 4216, 4636, 5022, 5379, 5883, 6408, 6918, 7372, 8011, 8394, 9331, 9697, 10783, 11709, 12230, 12633, 13340, 14111, 14717, 15197]","[0, 169, 259, 349, 596, 735, 825, 915, 1181, 1317, 1496, 1728, 1818, 1913, 2514, 2636, 2730, 2888, 3101, 3259, 3443, 3538, 4068, 4322, 4417, 4512, 5279, 5733, 6154, 6422]","[0, 169, 304, 440, 570, 786, 922, 1142, 1380, 1517, 1775, 1865, 2092, 2236, 2898, 3113, 3254, 3449, 3634, 3792, 4149, 4244, 5277, 5443, 5593, 5688, 6101, 6276, 6462, 6558]",20005,15089,15197,6422,6558,2287,2788,-930,4569,5143,13857,30,radiant
7608362808,48,23,49,27,102,"[0, 245, 496, 1054, 1450, 1749, 2136, 2476, 2955, 3335, 3853, 4536, 5317, 5825, 7009, 7214, 8376, 9152, 10143, 11656, 12402, 12564, 13184, 14506, 14673, 16578, 17161, 17463, 18367, 19088]","[0, 245, 592, 1074, 1284, 1452, 1824, 2333, 2749, 3004, 3516, 3963, 4395, 5231, 5878, 6511, 7189, 7480, 8008, 8554, 9249, 9886, 10644, 11475, 11642, 12340, 13016, 13558, 14240, 14607]","[0, 292, 602, 982, 1275, 1528, 2105, 2459, 2886, 3294, 3471, 4014, 4388, 5176, 5543, 5865, 6302, 6935, 7375, 8012, 8280, 9027, 9281, 9997, 10506, 10681, 11495, 11946, 12336, 12930]","[0, 209, 299, 487, 666, 891, 1148, 1336, 1472, 1892, 2276, 2741, 2921, 3511, 4087, 4629, 5133, 5262, 5642, 5841, 6218, 6778, 7403, 8046, 8697, 9328, 9896, 10152, 10583, 11048]","[0, 209, 444, 701, 822, 956, 1120, 1255, 1529, 1798, 2224, 2544, 2724, 3116, 3733, 3881, 4039, 4134, 4534, 5435, 5703, 6088, 6342, 6934, 7101, 7552, 7855, 8231, 8673, 9313]",19088,14607,12930,11048,9313,4,135,50,19,5,"[0, 164, 582, 964, 1370, 1760, 2296, 2826, 3188, 3476, 4005, 4480, 5209, 5915, 7043, 8021, 8860, 9466, 10116, 10767, 11646, 12354, 13186, 13662, 15884, 16051, 17307, 17876, 18809, 19435]","[0, 240, 488, 689, 1019, 1484, 1809, 2358, 2596, 3166, 3462, 3844, 4427, 4938, 5291, 6095, 6679, 7393, 7797, 8174, 8422, 8681, 9284, 9943, 10933, 11558, 12136, 12408, 13154, 13486]","[0, 520, 760, 1038, 1367, 1699, 2015, 2662, 3185, 3527, 3944, 4153, 4780, 4875, 5077, 5691, 6465, 7161, 7473, 7793, 8203, 8298, 8720, 8814, 9113, 9779, 10474, 11175, 11715, 12263]","[0, 129, 303, 476, 611, 895, 1020, 1292, 1382, 1546, 1636, 1772, 2282, 2430, 3012, 3610, 4008, 4513, 5022, 5647, 5895, 6261, 6900, 6994, 7987, 8858, 9551, 10018, 10362, 10548]","[0, 129, 244, 334, 516, 606, 696, 963, 1098, 1188, 1447, 1584, 1921, 2016, 2158, 2437, 2657, 2842, 3073, 3167, 3415, 3510, 3823, 3917, 4579, 4942, 5509, 5872, 6667, 6853]",19435,13486,12263,10548,6853,-347,1121,667,500,2460,4401,30,radiant
7608505603,18,106,98,86,5,"[0, 283, 654, 1041, 1460, 1878, 2247, 2851, 3463, 3972, 4652, 5394, 6186, 6961, 7716, 8559, 9426, 10172, 11189, 12468, 13785, 15332, 16508, 17133, 17780, 19659, 21616, 22921, 24248, 26165]","[0, 330, 532, 849, 1183, 1600, 1885, 2175, 2530, 2978, 3442, 3911, 4408, 4935, 5365, 5951, 6561, 7342, 7958, 8716, 9976, 10378, 10871, 12129, 12856, 14114, 15419, 16680, 17947, 19059]","[0, 241, 492, 826, 1307, 1715, 1998, 2088, 2620, 2758, 2927, 3296, 3472, 4123, 4374, 4948, 5343, 6253, 6718, 6979, 7416, 8127, 8457, 8950, 9273, 9753, 10775, 11592, 12517, 13285]","[0, 170, 260, 388, 737, 952, 1086, 1387, 1871, 2088, 2391, 2801, 2891, 3114, 3384, 3776, 3934, 4177, 4272, 4366, 4981, 5492, 5587, 5987, 6222, 6698, 6793, 7480, 7945, 8709]","[0, 170, 260, 461, 779, 914, 1004, 1094, 1263, 1353, 1708, 1937, 2038, 2186, 2366, 2460, 2667, 2959, 3099, 3366, 3641, 4280, 4375, 4775, 4870, 5037, 5264, 5468, 5709, 6202]",26165,19059,13285,8709,6202,70,76,71,14,3,"[0, 302, 637, 842, 1478, 1648, 2095, 2576, 2906, 3452, 4120, 4515, 4882, 5566, 6088, 6862, 7877, 8486, 9348, 10139, 11070, 11165, 11547, 12142, 13203, 14133, 15169, 15263, 15617, 15955]","[0, 286, 532, 934, 1264, 1558, 1731, 2272, 2697, 3040, 3552, 4032, 4662, 5234, 5780, 6407, 7182, 8089, 8736, 9137, 9436, 10454, 11116, 11918, 12884, 13864, 14478, 14707, 14803, 14980]","[0, 325, 639, 1098, 1614, 2026, 2472, 2893, 3267, 3608, 4036, 4384, 4840, 5490, 6107, 6541, 7267, 7777, 8402, 8894, 9402, 9497, 10008, 10474, 11025, 11860, 12125, 13020, 13144, 13457]","[0, 500, 653, 871, 1372, 1651, 2086, 2260, 2463, 2650, 3143, 3376, 3569, 3996, 4230, 4324, 4782, 5035, 5214, 5754, 6166, 6295, 6821, 7011, 7196, 7824, 8143, 8237, 8571, 8794]","[0, 232, 322, 412, 750, 1182, 1405, 1788, 2052, 2186, 2932, 3332, 3738, 3941, 4157, 4297, 4611, 4901, 5080, 5407, 5599, 6211, 6532, 6819, 7101, 7463, 7996, 8142, 8447, 8624]",15955,14980,13457,8794,8624,10210,4079,-172,-85,-2422,11610,30,radiant
7608734818,94,90,129,9,26,"[0, 243, 482, 740, 915, 1222, 1750, 2242, 2658, 3161, 3660, 3950, 4537, 5265, 5946, 6541, 7235, 8077, 8728, 9251, 9789, 10596, 11870, 12479, 12984, 13271, 14227, 14614, 15579, 16137]","[0, 289, 615, 1144, 1403, 1951, 2623, 2919, 3483, 3842, 4775, 5161, 5712, 6330, 7063, 7674, 8265, 9157, 9872, 10551, 10808, 11017, 11596, 11927, 12177, 12591, 13354, 14004, 14352, 15000]","[0, 254, 578, 792, 1276, 1527, 1757, 2204, 2412, 2799, 3151, 3758, 4353, 4851, 5183, 5539, 5912, 6826, 7363, 7934, 8519, 8935, 9731, 9989, 10479, 10850, 11048, 11426, 11522, 11901]","[0, 218, 357, 909, 1076, 1166, 1446, 1941, 2072, 2741, 3528, 3678, 3961, 4187, 4602, 4886, 5028, 5466, 6063, 6479, 6906, 7203, 7621, 7806, 8011, 8106, 8482, 8822, 9049, 9362]","[0, 170, 332, 422, 600, 690, 780, 1088, 1178, 1478, 1871, 1961, 2141, 2290, 2578, 2727, 2911, 3456, 3738, 3958, 4053, 4243, 4455, 4550, 4755, 4964, 5058, 5443, 5539, 5635]",16137,15000,11901,9362,5635,95,106,96,105,21,"[0, 229, 527, 1004, 1203, 1694, 2010, 2205, 2778, 3276, 3839, 4172, 5019, 5463, 6161, 7164, 8147, 8984, 9926, 10719, 11653, 12785, 13643, 14450, 16000, 16824, 17787, 18613, 19500, 20640]","[0, 232, 502, 869, 1357, 1647, 2101, 2510, 2922, 3664, 4175, 4590, 5168, 5429, 5864, 6351, 6877, 7017, 7762, 8061, 8956, 9556, 10029, 10575, 11445, 12365, 13107, 13331, 13735, 14104]","[0, 232, 592, 916, 1276, 1559, 1937, 2351, 2635, 3060, 3375, 3866, 4386, 4638, 4948, 5546, 5767, 6331, 7230, 7324, 8036, 8705, 9397, 9816, 10526, 11110, 11650, 12274, 13015, 13485]","[0, 195, 285, 419, 509, 689, 824, 950, 1186, 1723, 1963, 2138, 2326, 2566, 2958, 3344, 3586, 3726, 4250, 4344, 4692, 5106, 5824, 6153, 6666, 7521, 7861, 8658, 9086, 9551]","[0, 246, 336, 683, 819, 909, 1128, 1218, 1426, 1713, 2036, 2155, 2346, 2588, 2817, 3605, 3826, 4301, 4795, 5287, 5688, 6174, 6762, 7213, 8011, 8587, 8953, 9263, 9567, 10028]",20640,14104,13485,9551,10028,-4503,896,-1584,-189,-4393,-9773,30,radiant
7609066006,94,120,123,96,112,"[0, 257, 883, 1249, 1579, 2039, 2468, 2971, 3438, 4002, 4491, 5296, 5872, 6489, 7134, 7759, 8595, 9592, 10567, 11617, 12641, 13509, 13986, 14782, 15622, 17023, 18013, 19211, 20391, 21740]","[0, 259, 594, 943, 1305, 1896, 2342, 2755, 3623, 4079, 4642, 5287, 5657, 6139, 7053, 7620, 8708, 9349, 9882, 10226, 10763, 11309, 11836, 12958, 13702, 14132, 14485, 14763, 15353, 16028]","[0, 169, 336, 426, 628, 848, 1201, 1385, 1624, 2272, 2652, 2998, 3130, 3475, 4063, 4314, 5668, 5916, 6118, 6285, 6379, 6883, 7547, 8290, 8731, 9184, 10200, 10676, 11555, 11966]","[0, 207, 716, 1125, 1474, 1674, 1870, 2077, 2440, 2713, 3598, 3988, 4129, 4297, 4657, 5068, 5963, 6773, 6975, 7100, 7302, 7707, 8510, 9269, 9963, 10452, 10657, 10931, 11439, 11535]","[0, 169, 334, 468, 621, 723, 813, 991, 1126, 1693, 2099, 2851, 2941, 3493, 3954, 4178, 4638, 4886, 5028, 5123, 5463, 5909, 6356, 6853, 7392, 7856, 8274, 8548, 8873, 9204]",21740,16028,11966,11535,9204,4,105,107,19,53,"[0, 274, 482, 837, 1703, 2015, 2473, 3015, 3271, 3726, 3921, 4011, 4265, 5112, 5850, 6450, 6627, 7305, 7835, 9117, 9719, 10403, 10955, 11442, 12297, 13017, 13733, 14544, 15230, 15857]","[0, 169, 298, 418, 771, 936, 1103, 1536, 1705, 2266, 3417, 3581, 4040, 4591, 4989, 5205, 5992, 6456, 6828, 7380, 7977, 8470, 8823, 8954, 9735, 10467, 11875, 12171, 12881, 13618]","[0, 250, 566, 890, 1377, 1795, 2005, 2297, 2739, 3231, 3994, 4702, 4916, 5250, 5593, 6313, 6446, 6946, 7770, 8548, 8973, 9744, 10328, 10456, 11110, 11833, 12454, 12701, 12856, 12952]","[0, 205, 491, 907, 1277, 1513, 1882, 2203, 2412, 2789, 3280, 3836, 4023, 4478, 4977, 5504, 5778, 6234, 6520, 7269, 7857, 8295, 8791, 9351, 9556, 10080, 10346, 10920, 11458, 11948]","[0, 169, 259, 379, 553, 800, 1124, 1303, 1393, 1674, 1843, 2328, 3152, 3844, 4029, 4653, 4995, 5314, 5518, 6275, 6541, 6963, 7817, 7985, 8174, 8823, 9566, 9899, 10099, 10849]",15857,13618,12952,11948,10849,5883,2410,-986,-413,-1645,5249,30,radiant
7609240510,70,23,17,109,21,"[62, 302, 814, 1057, 1382, 1854, 2138, 2462, 2905, 3481, 4236, 4860, 5324, 5995, 6565, 7449, 8217, 8824, 9259, 10151, 10755, 11776, 13379, 14432, 15328, 15669, 17154, 17922, 18842, 19171]","[62, 278, 553, 928, 1214, 1467, 1997, 2493, 2992, 3470, 4388, 5015, 5644, 6141, 6287, 6830, 7432, 8085, 8714, 9176, 9675, 10739, 11152, 11926, 12566, 12796, 13320, 14276, 15017, 15113]","[62, 305, 694, 1099, 1460, 1782, 1917, 2680, 2935, 3864, 4574, 5293, 5985, 6201, 6857, 7442, 8023, 8630, 9492, 9980, 10565, 11053, 11797, 12321, 13146, 13692, 14436, 14996, 16081, 16457]","[62, 231, 321, 740, 923, 1053, 1503, 2132, 2497, 2827, 3209, 3502, 3633, 3830, 4252, 4497, 5151, 5691, 6201, 6359, 6675, 7250, 7761, 8173, 8780, 9009, 9877, 10676, 11075, 11559]","[430, 651, 842, 965, 1131, 1367, 1502, 1725, 1954, 2333, 2762, 3228, 3472, 3567, 3706, 3801, 4150, 4335, 4648, 4806, 4901, 5417, 5897, 6325, 6784, 7149, 7805, 8381, 8693, 8895]",19171,15113,16457,11559,8895,36,48,14,20,91,"[0, 251, 569, 814, 1229, 1748, 2148, 2326, 3106, 3668, 4203, 4758, 5280, 6875, 7465, 8158, 8603, 9686, 9870, 10521, 11212, 11827, 11993, 12372, 13216, 14047, 14631, 15450, 15785, 16666]","[0, 207, 484, 735, 1309, 1455, 1749, 2081, 2551, 2939, 3595, 3793, 4473, 5150, 5775, 6628, 7252, 8462, 9626, 10696, 11435, 12033, 12231, 12969, 13064, 14412, 14877, 15348, 15937, 16805]","[0, 205, 371, 573, 817, 1179, 1705, 2246, 2606, 3173, 3541, 3680, 4138, 4753, 5117, 5671, 5766, 6365, 6549, 6813, 7522, 7896, 8942, 9350, 9445, 10927, 11366, 11834, 12168, 12522]","[0, 169, 259, 349, 560, 816, 943, 1033, 1175, 1496, 1631, 1815, 2058, 2615, 2818, 3204, 3901, 4307, 4491, 4910, 5642, 5847, 6038, 6224, 6345, 7253, 7723, 8222, 8497, 8670]","[0, 169, 293, 383, 521, 705, 1003, 1247, 1472, 1676, 1947, 2199, 2307, 2695, 3079, 3333, 3428, 3997, 4201, 4626, 4975, 5180, 5346, 5478, 5573, 6077, 6908, 7600, 7813, 8141]",16666,16805,12522,8670,8141,2505,-1692,3935,2889,754,8391,30,dire
7609245218,95,15,52,19,9,"[0, 216, 644, 993, 1243, 1413, 1744, 2039, 2341, 2738, 3173, 4032, 4367, 5068, 5523, 6195, 6770, 7261, 7987, 8891, 9546, 10103, 10614, 11234, 12110, 12936, 13562, 13925, 14485, 15445]","[0, 206, 435, 683, 877, 1273, 1923, 2391, 2737, 3245, 3678, 4031, 4631, 5532, 5908, 6003, 6645, 7328, 7535, 8136, 8617, 9265, 9549, 9644, 10182, 11040, 11848, 12576, 12884, 13661]","[0, 254, 631, 998, 1244, 1647, 2213, 2393, 2717, 3254, 3888, 4448, 4971, 5760, 6247, 6703, 7590, 7829, 8128, 8708, 9295, 9886, 10538, 10843, 11024, 11745, 11840, 12396, 13066, 13902]","[0, 234, 349, 439, 576, 794, 977, 1237, 1560, 1688, 2417, 2612, 2990, 3632, 3944, 4206, 4605, 4814, 5017, 5294, 5388, 6367, 6896, 7309, 7524, 8591, 8733, 8828, 9225, 9585]","[0, 502, 617, 755, 879, 1049, 1339, 1683, 1857, 2109, 2624, 2804, 3132, 3852, 4067, 4605, 5008, 5408, 5923, 6439, 6644, 7108, 7203, 7488, 7834, 8055, 8150, 8427, 8587, 9154]",15445,13661,13902,9585,9154,18,13,65,53,51,"[0, 245, 490, 680, 1168, 1258, 1531, 1704, 2024, 2438, 2988, 3836, 4418, 4862, 5919, 6543, 6791, 7660, 8896, 9781, 10780, 11279, 12325, 13059, 14081, 15181, 15980, 17910, 18618, 18876]","[0, 297, 546, 990, 1286, 1660, 2029, 2534, 2817, 3243, 3646, 3893, 4458, 4831, 5613, 6405, 6727, 7396, 7874, 8513, 9118, 9600, 10496, 11354, 12095, 12668, 13658, 14353, 14984, 15626]","[0, 329, 619, 905, 1187, 1935, 2192, 2596, 2851, 3200, 3371, 4137, 4292, 4666, 5370, 5894, 6734, 7553, 8221, 9175, 9467, 9837, 10768, 11360, 11923, 12271, 12492, 13107, 13578, 14419]","[0, 170, 260, 350, 530, 783, 873, 1008, 1098, 1357, 1555, 1664, 1995, 2323, 2634, 3200, 4007, 4119, 4214, 4738, 4832, 5257, 6583, 6750, 6979, 7480, 7862, 8270, 8524, 9269]","[0, 170, 295, 481, 618, 871, 961, 1134, 1224, 1314, 1592, 1972, 2218, 2750, 3033, 3415, 4038, 4241, 4439, 5037, 5465, 6023, 7031, 7911, 8265, 8477, 8662, 9020, 9226, 9544]",18876,15626,14419,9269,9544,-3431,-1965,-517,316,-390,-5987,30,dire
7609292902,74,42,99,86,19,"[0, 171, 453, 865, 1364, 1876, 2355, 2792, 3327, 3536, 4125, 4647, 5152, 5344, 5929, 6238, 6913, 7349, 7541, 8134, 8387, 8931, 9721, 10692, 11594, 12117, 12812, 13417, 13741, 14329]","[0, 125, 327, 492, 750, 1259, 1560, 1883, 2295, 2629, 3047, 3290, 3773, 4404, 4922, 5563, 6015, 6357, 6501, 7283, 7868, 8661, 9206, 9838, 10471, 11366, 11741, 11915, 12635, 12993]","[0, 258, 631, 917, 1264, 1516, 2122, 2449, 2868, 3644, 3797, 4172, 4724, 5420, 6209, 6810, 7524, 7812, 7922, 8426, 8884, 9172, 9695, 10345, 11019, 12046, 12823, 12922, 13567, 14229]","[0, 136, 270, 395, 586, 866, 956, 1046, 1463, 1688, 2027, 2152, 2530, 2872, 3078, 3226, 3430, 3871, 4189, 4283, 4584, 4979, 5202, 5913, 6092, 6515, 6700, 6799, 6976, 7521]","[0, 90, 180, 270, 409, 539, 719, 933, 1104, 1194, 1415, 1505, 1595, 1690, 1821, 2140, 2490, 2858, 2973, 3494, 3926, 4021, 4628, 5319, 5528, 5695, 5880, 5974, 6354, 6814]",14329,12993,14229,7521,6814,12,120,96,9,105,"[0, 288, 661, 1019, 1185, 1504, 1833, 2301, 2737, 3331, 3885, 4290, 4986, 5470, 6082, 6776, 7560, 8680, 9945, 11133, 12394, 13041, 14101, 14321, 15087, 16079, 16909, 18951, 20090, 21084]","[0, 361, 676, 1052, 1342, 1586, 2098, 2278, 2583, 2847, 3444, 3908, 4546, 5066, 5528, 6205, 7019, 7697, 8450, 9252, 10032, 10444, 11044, 12212, 12629, 13188, 13789, 14390, 15215, 15632]","[0, 285, 594, 839, 1390, 1720, 2130, 2507, 2972, 3245, 3647, 4226, 4490, 5101, 5690, 6163, 6642, 7396, 8301, 8791, 9396, 10025, 10518, 11280, 11483, 12266, 12559, 13125, 13615, 14176]","[0, 302, 489, 667, 757, 1155, 1399, 1708, 2003, 2225, 3019, 3220, 3486, 3669, 4131, 4534, 5170, 5681, 6580, 7097, 7674, 8168, 8335, 8849, 8944, 9336, 9888, 10727, 11860, 12478]","[0, 250, 340, 547, 688, 839, 1020, 1200, 1290, 1514, 1787, 2066, 2250, 2605, 2846, 3110, 3403, 3978, 4530, 5055, 5516, 5683, 5850, 6528, 6877, 7227, 7857, 8463, 9134, 9387]",21084,15632,14176,12478,9387,-6755,-2639,53,-4957,-2573,-16871,30,dire
7609332606,49,29,120,123,5,"[0, 204, 487, 696, 978, 1466, 1866, 2148, 2635, 2832, 3380, 4044, 4647, 5243, 5719, 6455, 7370, 8361, 8716, 9913, 11145, 11710, 12871, 13635, 14014, 15010, 15814, 16551, 17891, 18460]","[0, 295, 579, 1001, 1250, 1534, 1821, 2193, 2573, 3073, 3464, 3921, 4471, 5196, 5979, 6834, 7808, 8395, 9007, 10092, 11450, 11856, 12443, 13081, 13610, 14245, 14678, 15129, 15673, 16403]","[0, 288, 498, 941, 1346, 1727, 2138, 2590, 3029, 3336, 3590, 4059, 4753, 5258, 5604, 6480, 6974, 7341, 7697, 8285, 9169, 10111, 10926, 11470, 11889, 12224, 12976, 13819, 14504, 15256]","[0, 390, 480, 570, 660, 750, 887, 977, 1067, 1411, 1826, 1965, 2224, 2557, 2750, 3001, 3351, 4068, 4327, 4717, 5292, 5891, 6289, 6796, 6936, 7263, 7467, 7740, 8128, 8405]","[0, 214, 353, 498, 765, 904, 994, 1131, 1243, 1368, 1599, 1845, 2012, 2141, 2248, 2758, 3013, 3322, 3469, 3735, 4227, 4400, 4800, 5092, 5296, 5733, 5979, 6367, 7127, 7579]",18460,16403,15256,8405,7579,90,93,109,96,65,"[327, 740, 908, 1218, 1512, 1907, 2305, 2972, 3679, 4200, 5070, 5523, 6025, 6708, 7233, 7452, 8447, 8911, 9163, 9303, 9581, 10174, 10958, 11840, 12412, 13097, 13393, 14097, 14576, 15083]","[0, 220, 420, 792, 1034, 1397, 1859, 2450, 2750, 3180, 3769, 4270, 4958, 5646, 6336, 6955, 7575, 8143, 8690, 9619, 9890, 10196, 10711, 11260, 11757, 12211, 12790, 13348, 13907, 14797]","[59, 229, 319, 409, 543, 673, 1068, 1294, 1660, 1948, 2278, 2368, 2624, 2856, 3075, 3169, 3477, 4064, 4221, 4905, 5395, 5588, 5977, 6182, 6561, 7113, 7816, 8209, 8685, 9235]","[59, 229, 644, 932, 1305, 1542, 1877, 2331, 2719, 3067, 3774, 4067, 4503, 5132, 5298, 5749, 6344, 7024, 7441, 7888, 8154, 8752, 9190, 9743, 10211, 11053, 11592, 12044, 12184, 12949]","[59, 229, 333, 423, 513, 688, 858, 1056, 1448, 1789, 2300, 2537, 2827, 3450, 3929, 4023, 4448, 4622, 4928, 5075, 5374, 5469, 5612, 5779, 5874, 6131, 6225, 6637, 6733, 6910]",15083,14797,9235,12949,6910,3377,1606,6021,-4544,669,7129,30,radiant
7609349210,70,13,96,5,79,"[0, 243, 523, 685, 1066, 1526, 2057, 2673, 3243, 3781, 4399, 4991, 5741, 6308, 7038, 7690, 8566, 9557, 10269, 10961, 13219, 13997, 14698, 15683, 17042, 17728, 18878, 20181, 21340, 22202]","[0, 278, 569, 904, 1276, 1629, 1956, 2370, 3144, 3584, 3946, 4205, 5024, 5382, 5772, 6267, 7183, 7551, 8107, 8202, 9316, 9841, 10681, 11130, 11911, 12875, 13654, 13749, 14307, 14866]","[0, 309, 596, 974, 1316, 1605, 2136, 2636, 3064, 3544, 3976, 4596, 5113, 5389, 5919, 6399, 7447, 7824, 8401, 8550, 9166, 9624, 10061, 10838, 11396, 11740, 12157, 12720, 13175, 13406]","[0, 504, 594, 684, 823, 1317, 1532, 1679, 1992, 2137, 2520, 2798, 3122, 3430, 3525, 3765, 4257, 4790, 5036, 5131, 5379, 5702, 5970, 6623, 6857, 7154, 7583, 7790, 8135, 8440]","[0, 169, 305, 520, 610, 740, 877, 1224, 1503, 1648, 1917, 2149, 2547, 2696, 2966, 3292, 4229, 4459, 4553, 4698, 5616, 5711, 5877, 6258, 6443, 6740, 7050, 7195, 7482, 7900]",22202,14866,13406,8440,7900,46,18,97,20,65,"[0, 329, 629, 1031, 1408, 1883, 2255, 2857, 3108, 3669, 4598, 5478, 6027, 6840, 7358, 8019, 8388, 8825, 9488, 10911, 11539, 12392, 13180, 13275, 13767, 14481, 15800, 16452, 17336, 18431]","[0, 250, 728, 1148, 1505, 1871, 2145, 2688, 3378, 3977, 4802, 5553, 6237, 6940, 7710, 8541, 9068, 9706, 10809, 12682, 12777, 13934, 14372, 14952, 15335, 15837, 16374, 17159, 17634, 18129]","[0, 206, 739, 1141, 1438, 2096, 2434, 2923, 3478, 3882, 4394, 4853, 5014, 5187, 5736, 6324, 6419, 7114, 7504, 8416, 8637, 9243, 9939, 10367, 10632, 10969, 11575, 12142, 12485, 12789]","[0, 169, 259, 398, 535, 643, 789, 1063, 1153, 1243, 1584, 1768, 1880, 2134, 2400, 2584, 2960, 3187, 3436, 4304, 4422, 4702, 5018, 5188, 5358, 6011, 6180, 6440, 6721, 7017]","[0, 169, 333, 423, 557, 731, 1072, 1511, 1601, 1691, 1994, 2474, 2696, 3042, 3339, 3691, 3878, 4036, 4241, 5165, 5286, 5491, 5657, 5804, 5899, 6481, 6835, 7020, 7298, 7612]",18431,18129,12789,7017,7612,3771,-3263,617,1423,288,2836,30,radiant
7609482509,89,120,96,9,79,"[0, 252, 502, 1042, 1322, 1728, 2154, 2550, 2911, 3536, 4056, 4350, 5209, 5828, 6434, 7183, 8278, 9340, 10286, 11102, 12356, 12938, 13216, 14664, 16168, 17398, 19128, 20135, 21274, 22855]","[0, 281, 561, 854, 1254, 1588, 1920, 2385, 2976, 3474, 4095, 4374, 4779, 5423, 5894, 6729, 7438, 7848, 8365, 8939, 9648, 10204, 10522, 11301, 12348, 12710, 13257, 13665, 14022, 14516]","[0, 169, 477, 918, 1334, 1624, 2169, 2588, 2922, 3698, 4194, 4643, 5466, 5891, 6304, 6899, 7203, 7575, 8386, 8950, 9125, 9606, 9716, 10134, 10658, 11150, 11784, 12221, 12685, 13369]","[0, 169, 259, 417, 507, 687, 846, 999, 1096, 1307, 1593, 1798, 2086, 2298, 2613, 2799, 3191, 3522, 3662, 4006, 4346, 4579, 4759, 5221, 5512, 5682, 6140, 6357, 6697, 7016]","[100, 269, 359, 573, 924, 1014, 1349, 1484, 1574, 1742, 1946, 2036, 2290, 2502, 2633, 2761, 3467, 3652, 3851, 3979, 4333, 4537, 4637, 5154, 5622, 5815, 6151, 6424, 6520, 6616]",22855,14516,13369,7016,6616,12,52,23,65,85,"[0, 238, 539, 855, 1196, 1441, 1681, 2146, 2604, 2913, 3311, 3630, 4322, 5000, 5534, 6162, 6411, 6928, 7403, 7742, 8437, 9288, 10269, 11307, 11586, 12516, 13426, 14421, 15513, 15990]","[0, 277, 1123, 1457, 1862, 2171, 2407, 2880, 3581, 4329, 4779, 5692, 6279, 6782, 7361, 8058, 9037, 9925, 10668, 11266, 12360, 13099, 13637, 13940, 14690, 15655, 16263, 17141, 17772, 18097]","[0, 169, 553, 805, 1268, 1628, 1845, 2305, 2896, 3324, 3659, 4209, 4793, 5637, 6221, 6970, 7675, 8174, 8795, 9578, 10391, 10662, 10962, 11481, 12183, 13076, 13714, 13840, 15203, 16171]","[2, 171, 286, 395, 577, 707, 797, 977, 1067, 1539, 1754, 2054, 2846, 3337, 3701, 4194, 4528, 4992, 5541, 5927, 6157, 6615, 7012, 7241, 7586, 8313, 9042, 9298, 9849, 10268]","[0, 169, 284, 672, 811, 1010, 1197, 1377, 1568, 1781, 2085, 2321, 2823, 3289, 3519, 4007, 4382, 5124, 5368, 5635, 5911, 6034, 6569, 6798, 6893, 7279, 7484, 7654, 7953, 8049]",15990,18097,16171,10268,8049,6865,-3581,-2802,-3252,-1433,-4203,30,dire
7609815506,35,8,49,84,123,"[0, 325, 663, 1112, 1719, 2184, 2705, 3244, 3839, 4425, 4957, 5451, 6260, 6945, 7581, 8336, 9755, 10570, 11229, 12167, 12776, 13642, 14332, 14929, 15524, 16175, 17215, 18608, 19501, 20499]","[0, 252, 517, 919, 1203, 1594, 1947, 2303, 2702, 3168, 3648, 4232, 4962, 5734, 6238, 6640, 7264, 8175, 8631, 9406, 10906, 11487, 12343, 13221, 13851, 15056, 15956, 17225, 17593, 17689]","[0, 252, 564, 763, 1063, 1274, 1404, 1644, 1949, 2529, 2928, 3613, 4167, 4827, 5453, 5749, 6633, 7303, 7888, 8501, 9202, 9823, 10217, 11266, 11687, 11917, 12497, 13303, 13684, 13780]","[0, 170, 260, 394, 484, 574, 749, 887, 977, 1111, 1239, 1377, 1719, 1992, 2087, 2274, 2487, 2786, 3361, 3696, 4110, 4722, 4921, 5299, 5798, 6714, 6965, 7879, 8596, 8728]","[0, 170, 608, 784, 958, 1094, 1263, 1353, 1509, 1644, 1849, 2438, 2786, 2934, 3320, 3415, 3739, 4346, 4597, 4917, 5391, 5843, 6031, 6293, 6846, 7382, 7843, 8270, 8702, 8953]",20499,17689,13780,8728,8953,25,59,14,5,86,"[0, 328, 819, 1178, 1722, 2176, 2927, 3483, 4037, 4702, 5449, 5983, 6618, 7566, 8118, 8605, 9543, 10348, 11078, 12064, 13458, 14066, 14766, 15134, 15627, 16608, 17484, 18222, 19936, 21193]","[0, 207, 367, 659, 919, 1520, 2317, 2737, 3130, 3739, 4169, 4656, 5531, 5679, 6334, 6587, 7329, 7829, 8668, 9727, 9860, 10514, 11471, 12071, 12757, 13646, 14483, 15103, 16078, 16776]","[0, 280, 551, 867, 1162, 1455, 1879, 2254, 2649, 2988, 3387, 3739, 4560, 4708, 5267, 5617, 5967, 6061, 6655, 7740, 8267, 8362, 8955, 9536, 10316, 10784, 11056, 11460, 11967, 13005]","[0, 170, 260, 467, 601, 816, 1182, 1362, 1452, 1587, 1767, 1946, 2036, 2694, 3038, 3444, 3848, 4031, 4481, 4940, 5479, 5887, 6446, 6799, 7273, 7623, 8218, 8492, 9607, 10692]","[0, 170, 360, 495, 664, 842, 1059, 1287, 1421, 1612, 2050, 2187, 2382, 2754, 3117, 3491, 4059, 4410, 4639, 5210, 5383, 5624, 6313, 6768, 7168, 7795, 7976, 8383, 9637, 10163]",21193,16776,13005,10692,10163,-694,913,775,-1964,-1210,-2180,30,dire
7610125407,97,48,16,121,87,"[0, 130, 497, 835, 1157, 1651, 2156, 2503, 3002, 3732, 4693, 5386, 6189, 6849, 7335, 8235, 9140, 10202, 11172, 12080, 13002, 13487, 14453, 15608, 16904, 18081, 19338, 20476, 22038, 23781]","[0, 246, 655, 1037, 1365, 1957, 2563, 3037, 3583, 4127, 4695, 5424, 6051, 6916, 7584, 8498, 9399, 10283, 11199, 12357, 13360, 14742, 15492, 16295, 17415, 18861, 19877, 20981, 22972, 23506]","[0, 249, 487, 851, 1163, 1458, 1673, 1931, 2712, 3180, 3701, 4348, 4849, 5514, 6059, 6838, 7645, 8483, 9223, 9699, 10146, 10437, 11135, 11800, 12395, 12865, 12960, 13608, 14400, 15231]","[0, 130, 615, 750, 864, 1197, 1287, 1377, 1887, 1977, 2197, 2335, 2613, 2908, 3323, 3723, 3889, 4541, 4643, 4864, 5384, 5484, 5915, 6085, 6534, 6776, 6946, 7294, 7916, 9059]","[0, 130, 220, 356, 449, 559, 649, 739, 916, 1027, 1161, 1301, 1680, 1828, 1923, 2109, 2233, 2418, 2519, 2740, 3007, 3181, 3423, 3593, 3872, 4114, 4284, 4454, 5275, 6458]",23781,23506,15231,9059,6458,113,7,9,19,5,"[0, 289, 539, 922, 1381, 1558, 1828, 2400, 2998, 3518, 4261, 4578, 5198, 5842, 6426, 7306, 8211, 8611, 9396, 10120, 10403, 11646, 12411, 13367, 14094, 15120, 16105, 17094, 17633, 18974]","[0, 216, 591, 1029, 1346, 1635, 2117, 2479, 3099, 3580, 4105, 4284, 4781, 5543, 6210, 6738, 7218, 7643, 7967, 8477, 9316, 10449, 11190, 11815, 12326, 13797, 14658, 15221, 15317, 16167]","[0, 254, 540, 1065, 1474, 1709, 2145, 2437, 3122, 3499, 3949, 4463, 4876, 5357, 6309, 6697, 7411, 8085, 8807, 9129, 9691, 10759, 11490, 11978, 12215, 13073, 13600, 14061, 14242, 14695]","[0, 170, 260, 395, 529, 619, 758, 897, 1338, 1428, 1811, 1995, 2550, 2955, 3271, 3901, 4336, 4607, 4792, 5014, 5404, 5961, 6374, 6998, 7289, 7456, 7763, 8049, 8441, 8939]","[0, 170, 318, 531, 670, 760, 1094, 1184, 1499, 1638, 2008, 2201, 2373, 2651, 2756, 2851, 3008, 3218, 3403, 3680, 4272, 4420, 4677, 4772, 4866, 5097, 5302, 5397, 5493, 5876]",18974,16167,14695,8939,5876,4807,7339,536,120,582,13384,30,radiant
7610281513,48,17,49,109,5,"[0, 250, 621, 1050, 1388, 1901, 2524, 3098, 3782, 4298, 5032, 5890, 6611, 7111, 8192, 8806, 9467, 9818, 10215, 10634, 11062, 11998, 12771, 12866, 13788, 14819, 14986, 15708, 16841, 16937]","[0, 364, 607, 1061, 1393, 1793, 2083, 2749, 3264, 3453, 4402, 4741, 5324, 6166, 6920, 7195, 8235, 8747, 9317, 9880, 10069, 10321, 10773, 11601, 11727, 11912, 12313, 12932, 14831, 14927]","[0, 323, 603, 897, 1301, 1722, 2212, 2703, 3322, 3648, 4160, 4778, 5203, 5866, 6984, 7672, 8834, 9240, 9958, 11273, 11661, 12283, 12378, 12685, 13178, 13470, 13797, 14182, 14544, 14678]","[0, 170, 260, 364, 516, 653, 783, 921, 1103, 1295, 1522, 1822, 2063, 2275, 3111, 3272, 3632, 3726, 3968, 4432, 4587, 4682, 4893, 5427, 5656, 5911, 6311, 6455, 6590, 6686]","[0, 170, 260, 350, 457, 547, 677, 776, 945, 1035, 1170, 1260, 1364, 1700, 2128, 2284, 2469, 2563, 2787, 2945, 3145, 3343, 3614, 3784, 4184, 4369, 4510, 4605, 4701, 4835]",16937,14927,14678,6686,4835,69,41,51,40,84,"[0, 323, 569, 906, 1341, 1740, 2167, 2731, 3617, 4532, 5275, 5706, 6366, 7103, 8004, 8549, 9115, 10254, 10918, 12200, 13421, 14684, 15577, 16733, 17236, 17810, 19015, 20098, 20830, 22681]","[0, 245, 478, 938, 1311, 1769, 2109, 2439, 2737, 3238, 3867, 4276, 4966, 5603, 6192, 6666, 7339, 7986, 8829, 9437, 10901, 11473, 12605, 13042, 13944, 14714, 15511, 16073, 17673, 20102]","[0, 207, 580, 904, 1211, 1537, 1956, 2413, 2731, 3385, 4093, 4850, 5419, 6075, 6341, 6927, 7584, 8319, 8736, 9519, 10207, 10958, 11748, 11958, 12821, 13407, 14154, 14934, 15846, 17045]","[0, 170, 616, 735, 1067, 1376, 1633, 2032, 2291, 2953, 3487, 3842, 4260, 4800, 5194, 5800, 6454, 7103, 7548, 7836, 8254, 8779, 9553, 10035, 10305, 10661, 11451, 12164, 12756, 13365]","[0, 170, 260, 418, 543, 678, 813, 903, 993, 1330, 1508, 1663, 1817, 2044, 2139, 2374, 2893, 3206, 3505, 3609, 3995, 4222, 4590, 5360, 5734, 6367, 6985, 7827, 8255, 8729]",22681,20102,17045,13365,8729,-5744,-5175,-2367,-6679,-3894,-23859,30,dire
7610326311,21,27,102,65,85,"[2, 659, 1176, 1409, 2084, 2677, 3154, 3907, 4603, 5115, 5812, 6433, 7915, 8607, 9699, 10461, 10983, 11775, 11933, 12306, 13304, 14419, 14956, 16674, 17578, 18267, 18940, 19665, 20670, 22448]","[2, 357, 614, 1237, 1694, 1933, 2254, 2831, 3208, 3422, 3868, 4508, 4821, 5383, 5585, 5815, 6442, 7177, 7642, 8120, 8779, 9405, 9800, 11361, 12261, 12516, 12787, 14854, 15193, 16469]","[0, 439, 816, 1181, 1398, 1834, 2157, 2470, 2859, 2996, 3809, 4027, 4619, 5211, 5766, 5999, 6577, 7419, 8054, 8304, 9306, 9735, 9830, 10867, 11489, 11969, 12730, 13996, 14544, 15457]","[0, 450, 595, 775, 1096, 1226, 1316, 1654, 1807, 2251, 2696, 3568, 4220, 4637, 5151, 5349, 6123, 6834, 7284, 7841, 8436, 9151, 9451, 9798, 10559, 10654, 11174, 12352, 12691, 13530]","[0, 214, 492, 691, 963, 1349, 1485, 1760, 1928, 2309, 2925, 3154, 3531, 3866, 4417, 4725, 5683, 6909, 7173, 7462, 8094, 8638, 8733, 8969, 9527, 9622, 10887, 12160, 12806, 12902]",22448,16469,15457,13530,12902,89,78,53,17,20,"[0, 207, 297, 591, 814, 1011, 1298, 1639, 1931, 2462, 2983, 3394, 4025, 4658, 5123, 5346, 6188, 7021, 9008, 10015, 10793, 11944, 13580, 14308, 14402, 15303, 17256, 18781, 18877, 19775]","[0, 348, 544, 775, 1309, 1541, 1747, 2069, 2309, 2740, 3180, 3731, 4026, 4568, 5029, 5405, 5882, 7301, 8021, 8484, 8669, 9203, 10906, 11073, 11464, 12950, 14872, 15770, 15866, 16915]","[0, 176, 337, 457, 638, 846, 936, 1119, 1529, 2224, 2503, 2866, 3161, 3626, 4561, 4656, 5082, 5744, 6632, 7508, 7716, 8626, 9765, 10531, 11222, 12527, 13138, 14614, 15030, 15627]","[0, 287, 691, 900, 1282, 1697, 2094, 2432, 2979, 3512, 4053, 4645, 5060, 5678, 6394, 6652, 7099, 7758, 7853, 8574, 8750, 9879, 10313, 10762, 11402, 12281, 13074, 13943, 14039, 14662]","[0, 176, 266, 386, 476, 833, 923, 1106, 1335, 1538, 1852, 1942, 2284, 2902, 3249, 3344, 3539, 3936, 4496, 5479, 5573, 6325, 6697, 6866, 7347, 7776, 8766, 9900, 10251, 10422]",19775,16915,15627,14662,10422,2673,-446,-170,-1132,2480,3405,30,dire
7610361001,93,78,15,58,19,"[0, 246, 497, 694, 1099, 1584, 1926, 2192, 2643, 3601, 4163, 4673, 5144, 5554, 5958, 6863, 7649, 8548, 8969, 9751, 10808, 11513, 11904, 12410, 13542, 14090, 14749, 15698, 15985, 16855]","[0, 210, 300, 533, 833, 1068, 1561, 2082, 2252, 2762, 3261, 3632, 4361, 4716, 5199, 6051, 6293, 6489, 7213, 7443, 8483, 8901, 9716, 10147, 10673, 11267, 11898, 12903, 13528, 14242]","[0, 285, 619, 988, 1199, 1440, 1674, 2089, 2294, 3024, 3325, 3852, 4443, 4934, 5409, 6316, 6897, 7526, 8041, 8376, 8707, 9567, 10120, 10610, 11085, 11527, 12099, 12304, 13097, 13683]","[0, 261, 351, 492, 630, 1235, 1392, 1501, 1818, 2229, 2453, 2722, 3015, 3346, 3495, 4512, 4891, 5609, 5835, 6100, 6594, 7232, 7493, 8017, 8238, 8581, 9142, 10274, 10689, 11209]","[0, 249, 425, 515, 656, 858, 948, 1038, 1402, 1835, 2150, 2285, 2551, 2663, 2859, 3546, 3948, 4813, 5377, 5535, 5821, 5916, 6482, 6621, 6851, 7472, 7968, 8916, 9093, 9494]",16855,14242,13683,11209,9494,41,49,21,56,85,"[0, 289, 566, 835, 1092, 1602, 1893, 2392, 2840, 3267, 3708, 3956, 4232, 4839, 5141, 6042, 6863, 7442, 7892, 8546, 9656, 10597, 11428, 11946, 12213, 12649, 13254, 14352, 15126, 15758]","[0, 165, 463, 856, 1040, 1339, 1620, 2133, 2223, 2313, 2853, 3317, 3621, 4129, 4601, 5044, 5772, 6163, 6741, 7428, 8034, 8591, 9299, 9724, 10411, 11294, 12026, 12302, 12639, 13569]","[0, 199, 601, 924, 1138, 1405, 1812, 2324, 2714, 2850, 3362, 3812, 4071, 4544, 4886, 5109, 5890, 6172, 6715, 7377, 7998, 8804, 9243, 9685, 10454, 11142, 11274, 11550, 12074, 12495]","[0, 130, 245, 353, 443, 582, 754, 1095, 1220, 1430, 1718, 1897, 2150, 2441, 2808, 3234, 3915, 4115, 4387, 4659, 5023, 5538, 5853, 6281, 6634, 7070, 7328, 7423, 7921, 8134]","[0, 130, 245, 452, 542, 753, 843, 1133, 1269, 1429, 1581, 1671, 1809, 2184, 2388, 2611, 3003, 3098, 3424, 3757, 4243, 4413, 4686, 4904, 5246, 5644, 6072, 6423, 6594, 6807]",15758,13569,12495,8134,6807,1097,673,1188,3075,2687,8720,30,radiant
7610580601,93,129,23,91,123,"[0, 255, 644, 921, 1140, 2056, 2583, 2877, 3326, 3657, 3954, 4906, 5346, 6050, 6864, 8079, 8897, 9316, 9894, 10434, 11401, 12125, 12602, 13259, 14352, 14781, 16175, 16389, 17130, 17564]","[0, 208, 560, 848, 1102, 1523, 2078, 2492, 2800, 3094, 3694, 3985, 4510, 5141, 5605, 6304, 7058, 7831, 8673, 9278, 9968, 10630, 11218, 11825, 12556, 13113, 13893, 14849, 15706, 15802]","[0, 326, 540, 838, 1171, 1538, 1806, 2461, 3142, 3854, 4354, 4758, 5202, 5882, 6509, 7024, 7874, 8566, 9213, 9721, 10712, 11367, 12210, 12874, 13507, 14566, 15477, 15683, 15954, 16339]","[0, 170, 346, 474, 612, 1011, 1264, 1423, 1688, 2279, 2471, 2715, 2947, 3208, 3456, 3984, 4485, 4670, 4875, 5399, 6053, 6241, 6562, 6762, 7136, 7339, 7848, 7942, 8104, 8413]","[0, 170, 264, 708, 798, 929, 1110, 1269, 1419, 1651, 1821, 1911, 2175, 2522, 2688, 3086, 3946, 4393, 4650, 4977, 5537, 5632, 5871, 6358, 6907, 7074, 7599, 7800, 8085, 8181]",17564,15802,16339,8413,8181,89,49,96,27,5,"[0, 204, 527, 857, 1153, 1565, 1969, 2485, 2822, 3461, 4043, 4836, 5676, 6571, 7520, 8026, 8913, 9874, 10724, 11067, 12237, 13291, 14407, 15347, 16503, 17619, 18048, 19168, 20457, 20798]","[0, 248, 544, 847, 1217, 1469, 2182, 2587, 3102, 3524, 4078, 4422, 5131, 5359, 5990, 6433, 6653, 7200, 7415, 7849, 7943, 8491, 9579, 9837, 10024, 10707, 11792, 12540, 13101, 13410]","[0, 209, 463, 840, 1158, 1367, 1672, 2367, 2738, 3203, 3636, 4163, 4624, 5411, 6298, 6393, 6693, 6969, 7369, 7464, 7794, 8087, 8610, 8869, 9322, 9739, 10553, 10877, 11344, 11732]","[0, 170, 297, 387, 539, 629, 808, 898, 1084, 1357, 1447, 1963, 2152, 2466, 2772, 2867, 3087, 3182, 3413, 3508, 3602, 3697, 3887, 3982, 4443, 4693, 6074, 6433, 6611, 7027]","[0, 170, 260, 397, 500, 639, 774, 864, 999, 1159, 1401, 1702, 2064, 2415, 2766, 3071, 3291, 3386, 3571, 3666, 4116, 4211, 4401, 4621, 4715, 4882, 5374, 5468, 5646, 5742]",20798,13410,11732,7027,5742,-3234,2392,4607,1386,2439,7590,30,radiant
7610750910,1,23,28,19,110,"[0, 266, 568, 827, 1039, 1289, 1621, 2052, 2494, 2794, 3462, 3755, 4022, 4263, 4792, 5373, 5665, 6094, 7576, 8547, 9558, 10440, 11321, 12101, 13372, 14207, 15492, 16510, 17459, 18498]","[0, 270, 775, 1073, 1277, 1659, 2039, 2746, 3099, 3690, 4102, 4410, 5361, 5867, 6489, 6687, 7521, 8143, 8472, 8970, 9662, 10079, 10694, 11626, 12099, 12586, 12893, 13562, 13829, 14302]","[0, 230, 431, 764, 1121, 1484, 1770, 2401, 2947, 3560, 4149, 4701, 4855, 5400, 5829, 6385, 6896, 7290, 8131, 8608, 8972, 9253, 9669, 10540, 11167, 12171, 12311, 12576, 13156, 13476]","[0, 195, 285, 375, 465, 555, 739, 1040, 1291, 1546, 1912, 2062, 2153, 2458, 3087, 3325, 3859, 4102, 4609, 4889, 5376, 5549, 5790, 6348, 6655, 7005, 7282, 7803, 8055, 8335]","[0, 195, 285, 375, 465, 620, 797, 1036, 1126, 1272, 1825, 1915, 2147, 2242, 2729, 2993, 3153, 3394, 4207, 4559, 5094, 5379, 5634, 5801, 6263, 6442, 6536, 6716, 7017, 7113]",18498,14302,13476,8335,7113,15,54,33,100,87,"[0, 208, 529, 912, 1283, 1690, 2192, 2525, 2943, 3663, 3804, 4315, 4893, 5681, 5831, 6842, 7562, 8260, 8449, 9581, 10180, 10664, 11433, 12191, 12396, 13052, 13676, 14538, 15371, 15928]","[0, 244, 479, 675, 1010, 1172, 1421, 1933, 2328, 2656, 2957, 3493, 3864, 4325, 4915, 5762, 6483, 6969, 7064, 7955, 8647, 9143, 9605, 10252, 11323, 11892, 12425, 13024, 13986, 14628]","[0, 331, 531, 767, 1183, 1443, 1854, 2342, 2842, 3367, 3851, 4757, 5398, 6134, 6434, 6958, 7778, 8061, 8450, 8982, 9455, 10075, 11217, 11650, 12203, 12626, 13175, 13577, 14080, 14869]","[0, 170, 305, 395, 565, 690, 830, 945, 1531, 1731, 1821, 2134, 2389, 2690, 2959, 3262, 3428, 3650, 3952, 4373, 4962, 5248, 5505, 5747, 6238, 6566, 6815, 6985, 7486, 7872]","[0, 170, 260, 360, 494, 636, 726, 1071, 1321, 1521, 1611, 1923, 2370, 2754, 2849, 3071, 3377, 3646, 3741, 3898, 4056, 4249, 4869, 5036, 5385, 5587, 5727, 5822, 6253, 6566]",15928,14628,14869,7872,6566,2570,-326,-1393,463,547,1861,30,dire
7610800301,18,74,137,79,9,"[0, 208, 527, 842, 1061, 1362, 1523, 2168, 2638, 3041, 3427, 3862, 4910, 5510, 6095, 6561, 7194, 8128, 8644, 9609, 10431, 11099, 11835, 11929, 12964, 13298, 13393, 14120, 14673, 15450]","[0, 205, 407, 702, 910, 1211, 1581, 2079, 2503, 2593, 2819, 3495, 3978, 4338, 4549, 4644, 4840, 4971, 5086, 5493, 6373, 6925, 7572, 7870, 8166, 9263, 9553, 10167, 10671, 11471]","[0, 288, 996, 1476, 2079, 2455, 2834, 3247, 3665, 4262, 4724, 5118, 5606, 6088, 6183, 6400, 6863, 7501, 7750, 8484, 9058, 9626, 10156, 10250, 10345, 10775, 11371, 11536, 11782, 11878]","[0, 169, 327, 502, 677, 784, 994, 1129, 1265, 1502, 1637, 1817, 2411, 2636, 2731, 2826, 2983, 3127, 3392, 3708, 4151, 4537, 4962, 5056, 5531, 5626, 5839, 6133, 6481, 7005]","[0, 213, 303, 505, 635, 803, 893, 1138, 1228, 1466, 1708, 1918, 2413, 2562, 2885, 3136, 3293, 3388, 3569, 4060, 4451, 4907, 5332, 5436, 5531, 6010, 6151, 6245, 6727, 6823]",15450,11471,11878,7005,6823,21,19,28,121,20,"[0, 250, 499, 933, 1384, 1836, 2171, 2630, 3066, 3870, 4532, 5040, 5544, 5966, 6625, 7367, 7819, 8462, 9045, 9302, 9827, 10485, 11380, 12624, 13201, 14431, 15514, 16125, 17069, 17948]","[0, 205, 486, 730, 1050, 1362, 1673, 1972, 2454, 2977, 3384, 4173, 4656, 4948, 5415, 5925, 6503, 7042, 7654, 7951, 8420, 8791, 9525, 10564, 10809, 11166, 11805, 12437, 13390, 13921]","[0, 291, 491, 827, 1423, 1825, 2515, 3248, 3646, 4137, 4598, 5298, 5821, 6138, 6565, 7398, 7777, 8500, 9197, 9622, 10088, 10483, 10799, 11143, 12257, 13196, 13573, 14112, 14575, 15292]","[0, 206, 296, 386, 780, 989, 1502, 1804, 1894, 2222, 2687, 2961, 3137, 3478, 3800, 4302, 4883, 5627, 5936, 6509, 7139, 7549, 7821, 9055, 9150, 9993, 10449, 10936, 11493, 12018]","[0, 169, 259, 349, 549, 679, 1077, 1284, 1396, 1760, 1986, 2315, 2405, 2639, 3058, 3426, 3736, 4017, 4280, 4375, 4577, 4807, 5079, 5173, 5548, 5805, 6260, 6567, 7056, 7342]",17948,13921,15292,12018,7342,-2498,-2450,-3414,-5013,-519,-13894,30,dire
7610815600,18,120,129,105,26,"[57, 453, 680, 1099, 1493, 1985, 2265, 2693, 3207, 3708, 4218, 4842, 5328, 6466, 7112, 8179, 8708, 9477, 9977, 10335, 11233, 11717, 12435, 13053, 13147, 14099, 14757, 15892, 16946, 17568]","[57, 354, 745, 1166, 1674, 1927, 2462, 2951, 3661, 4406, 4881, 5394, 6021, 6203, 6738, 6934, 7514, 7818, 8355, 8548, 9195, 9839, 10740, 11099, 11731, 12164, 12378, 13105, 14995, 15480]","[325, 550, 844, 1221, 1845, 2092, 2446, 2873, 2963, 3580, 3836, 4374, 4640, 4935, 5541, 5970, 6703, 6922, 7372, 7714, 8042, 8355, 9214, 9573, 9873, 10474, 10940, 11660, 12766, 13068]","[157, 382, 497, 635, 835, 970, 1181, 1383, 1473, 1919, 2225, 2482, 2945, 3373, 3984, 4257, 4573, 4758, 5693, 5788, 6307, 6814, 7458, 8154, 8537, 9019, 9403, 10174, 11054, 11416]","[57, 282, 397, 562, 922, 1012, 1102, 1198, 1322, 1683, 1861, 2037, 2267, 2438, 2623, 2718, 3060, 3245, 3400, 3495, 3800, 4371, 5114, 5549, 5753, 5920, 6015, 6582, 6921, 7187]",17568,15480,13068,11416,7187,1,78,137,58,123,"[0, 170, 641, 1070, 1471, 1917, 2236, 2674, 3365, 3859, 4403, 4802, 5818, 6468, 7573, 8661, 9618, 10470, 12073, 13550, 14661, 15594, 16600, 17245, 18340, 19477, 20508, 21259, 21715, 21811]","[0, 244, 524, 807, 1035, 1441, 1932, 2397, 2871, 3348, 4099, 4773, 5204, 5774, 6405, 6639, 7662, 8597, 9922, 10398, 11210, 12233, 12708, 13313, 14496, 15308, 15717, 16440, 16817, 17135]","[0, 241, 720, 1061, 1399, 1738, 1955, 2552, 3018, 3279, 3642, 4087, 4495, 4950, 5374, 5933, 6475, 6810, 7742, 8872, 9659, 10198, 10741, 11125, 11700, 11978, 12418, 13072, 13447, 13731]","[0, 217, 332, 803, 983, 1136, 1226, 1595, 1849, 1984, 2209, 2353, 2753, 3057, 3298, 3548, 3806, 4203, 4916, 5596, 5900, 6034, 6277, 6521, 7123, 7375, 7519, 8073, 8521, 9028]","[0, 170, 285, 393, 483, 573, 757, 847, 1226, 1526, 1834, 2144, 2310, 2772, 2968, 3316, 3748, 4294, 5007, 5655, 5912, 6211, 6447, 6542, 6815, 7131, 7403, 7768, 7947, 8162]",21811,17135,13731,9028,8162,-4243,-1655,-663,2388,-975,-5148,30,dire
7611209103,44,28,121,62,85,"[0, 239, 647, 961, 1447, 1658, 2205, 2607, 2879, 3441, 3737, 4149, 4925, 5376, 5809, 6004, 6816, 7496, 8267, 9110, 9738, 10753, 11605, 11808, 12962, 13975, 15177, 15914, 16390, 17088]","[0, 290, 652, 1122, 1488, 2017, 2437, 2753, 3377, 3750, 4369, 4739, 5533, 6038, 6563, 6763, 7277, 8048, 8713, 8870, 9247, 9538, 9800, 10321, 11111, 11790, 11885, 12351, 12836, 13296]","[0, 170, 260, 616, 746, 974, 1183, 1273, 1493, 1823, 2258, 2384, 2932, 3489, 3876, 4312, 4570, 5066, 6021, 6226, 6618, 7079, 7421, 7670, 8482, 9027, 9299, 9874, 10813, 11208]","[0, 368, 630, 990, 1345, 1745, 1880, 2259, 2750, 3337, 3977, 4181, 4856, 5332, 5593, 5942, 6357, 6957, 7472, 8011, 8241, 8754, 9029, 9363, 9565, 9861, 10099, 10550, 10850, 11123]","[0, 170, 260, 565, 775, 865, 1077, 1266, 1356, 1482, 1662, 1845, 2465, 2845, 2940, 3542, 3981, 4686, 5114, 5632, 6046, 6731, 7008, 7174, 7509, 7947, 8042, 8317, 8713, 8973]",17088,13296,11208,11123,8973,109,120,129,101,5,"[0, 295, 536, 820, 1019, 1347, 1653, 2059, 2502, 3555, 4122, 4635, 5015, 5658, 6321, 7417, 8154, 9067, 10276, 11491, 12159, 13224, 14029, 15467, 16534, 17540, 19260, 20912, 21999, 22776]","[0, 366, 664, 1084, 1338, 1680, 2008, 2461, 2827, 3154, 3661, 4222, 4946, 5394, 5961, 6652, 7448, 7642, 8175, 8838, 9289, 9505, 10117, 10691, 11746, 12254, 13290, 14014, 14697, 14793]","[0, 267, 357, 557, 836, 1411, 1538, 1834, 2179, 2641, 3002, 3480, 4095, 4662, 5264, 6222, 6849, 7187, 7371, 7878, 8170, 8510, 8931, 9336, 9659, 9995, 10984, 11744, 12295, 12391]","[0, 526, 616, 745, 835, 1236, 1326, 1461, 1596, 1979, 2399, 2642, 2822, 3011, 3499, 3878, 4165, 4260, 4746, 5333, 5823, 5918, 6198, 6689, 7031, 7363, 8138, 8677, 9039, 9173]","[0, 302, 437, 652, 806, 1027, 1389, 1670, 1805, 2120, 2602, 2848, 3303, 3485, 3870, 4348, 4675, 4780, 5084, 5681, 5909, 6077, 6366, 6566, 6821, 7100, 8201, 8872, 9159, 9255]",22776,14793,12391,9173,9255,-5688,-1497,-1183,1950,-282,-6700,30,radiant
7611332019,18,59,86,97,66,"[0, 250, 531, 745, 1203, 1678, 1966, 2460, 2852, 3603, 4005, 4761, 5450, 6139, 6713, 7137, 7379, 8485, 8933, 9189, 9469, 9564, 10067, 10879, 11715, 12149, 13416, 14418, 14873, 15587]","[0, 202, 416, 624, 1023, 1437, 1896, 2218, 2773, 3350, 3910, 4311, 4650, 5024, 5458, 6129, 6440, 6766, 7263, 7687, 8134, 8567, 9217, 9699, 10206, 10376, 10576, 11234, 11435, 12128]","[0, 129, 219, 344, 1004, 1259, 1432, 1669, 1759, 2026, 2163, 2253, 2766, 2930, 3195, 3780, 4305, 5050, 5417, 5691, 5989, 6235, 6364, 6688, 7662, 7815, 8535, 9246, 9890, 10275]","[0, 198, 548, 763, 1496, 1866, 2052, 2329, 2474, 2860, 3269, 3616, 3868, 4385, 5070, 5593, 5858, 6053, 6173, 6716, 7042, 7278, 7591, 7942, 8639, 8734, 9384, 9996, 10187, 10575]","[0, 129, 219, 385, 501, 626, 872, 1053, 1240, 1423, 1589, 1869, 2447, 2874, 3186, 3379, 3537, 4064, 4341, 4553, 5081, 5358, 5656, 6190, 6569, 7273, 7960, 8305, 9018, 9458]",15587,12128,10275,10575,9458,50,106,96,121,105,"[108, 397, 929, 1215, 1625, 1950, 2524, 2891, 3475, 4055, 4448, 4909, 5941, 6570, 7238, 7543, 7922, 8643, 9744, 10570, 11419, 12151, 13173, 13716, 14827, 15523, 16090, 16908, 18131, 18653]","[108, 393, 660, 942, 1085, 1493, 1863, 2215, 2729, 3144, 3657, 4145, 4541, 4880, 5732, 6312, 6662, 6931, 7748, 8191, 8765, 10161, 10598, 11097, 12025, 12718, 13056, 14075, 15202, 15605]","[509, 762, 1071, 1468, 1760, 2143, 2553, 2930, 3484, 3738, 4187, 4779, 5395, 5837, 6292, 6759, 7802, 8387, 8913, 9399, 9763, 10839, 11397, 12234, 13097, 13777, 14054, 14391, 15467, 15644]","[108, 317, 432, 522, 663, 850, 1104, 1295, 1671, 1805, 2047, 2438, 2723, 3084, 3815, 4221, 4580, 4753, 5223, 5884, 6058, 6745, 6950, 7465, 8589, 9074, 9463, 9993, 10815, 11147]","[108, 317, 432, 604, 694, 862, 997, 1087, 1508, 1645, 1870, 2156, 2732, 2912, 3546, 3912, 4388, 4720, 5375, 6049, 6336, 6785, 7104, 7620, 8133, 8485, 9247, 9866, 10327, 10900]",18653,15605,15644,11147,10900,-3066,-3477,-5369,-572,-1442,-13926,30,dire
7611472802,95,129,114,5,91,"[0, 283, 482, 822, 1295, 1647, 2158, 2804, 3309, 3924, 4814, 5633, 5993, 6434, 7125, 7418, 8585, 9609, 10812, 12270, 13263, 13709, 14369, 15718, 17220, 18180, 19713, 20022, 20908, 21049]","[0, 249, 571, 873, 1480, 1957, 2244, 2740, 3026, 3382, 3932, 4266, 5178, 5748, 6315, 6756, 7929, 8467, 9378, 10055, 10770, 12123, 12265, 12669, 13854, 14574, 14759, 15310, 15562, 16167]","[0, 214, 566, 1035, 1444, 1938, 2528, 3237, 3857, 4152, 4828, 5221, 6210, 6375, 6761, 7301, 8032, 8527, 9028, 9815, 10771, 11172, 11519, 11793, 12897, 13373, 14974, 16405, 16657, 16798]","[0, 130, 220, 310, 485, 649, 883, 1040, 1405, 1778, 2068, 2443, 3012, 3355, 4134, 4229, 4579, 4674, 5279, 5919, 6261, 6970, 7282, 7556, 8238, 8868, 10162, 10966, 11432, 11573]","[0, 130, 220, 344, 694, 918, 1008, 1175, 1489, 1641, 1930, 2165, 2539, 2679, 2774, 2907, 3472, 3776, 4229, 4807, 5084, 5605, 5700, 5974, 6892, 7368, 8380, 9022, 9274, 9452]",21049,16167,16798,11573,9452,46,86,135,23,100,"[0, 322, 487, 802, 1164, 1567, 1786, 2112, 2517, 3039, 3386, 4053, 4198, 4761, 5051, 5656, 6706, 7564, 8053, 8607, 9060, 10101, 11054, 11911, 12042, 12137, 12656, 12750, 14712, 15617]","[0, 261, 351, 441, 739, 1058, 1148, 1328, 1418, 1508, 1684, 1933, 2078, 2437, 4207, 4451, 4826, 4967, 5806, 6078, 6273, 8180, 8654, 9501, 9596, 10722, 11767, 12380, 14373, 15289]","[0, 210, 755, 918, 1293, 1398, 1488, 1741, 1867, 1996, 2238, 2483, 2813, 3266, 3968, 4612, 4948, 5472, 6106, 6815, 7257, 7797, 8411, 9122, 9380, 10459, 10736, 11075, 11431, 12615]","[0, 282, 447, 693, 863, 1085, 1329, 1714, 1898, 2241, 2708, 2798, 2995, 3307, 3850, 4405, 4780, 4901, 5558, 5678, 6314, 7342, 7615, 8274, 8534, 9691, 10050, 10493, 11322, 12126]","[0, 210, 380, 470, 778, 904, 994, 1174, 1264, 1511, 1601, 1939, 2216, 2490, 3451, 4248, 4623, 4812, 5391, 5524, 5681, 6115, 6210, 6863, 6958, 8667, 9325, 9419, 9811, 10195]",15617,15289,12615,12126,10195,5432,878,4183,-553,-743,9197,30,radiant
7611703304,109,97,22,105,20,"[0, 246, 663, 955, 1328, 1626, 1936, 2302, 2769, 2933, 3251, 3645, 3979, 4437, 4936, 6074, 6959, 7658, 8449, 9209, 10012, 10554, 11201, 11867, 12335, 13325, 14021, 14796, 15492, 16735]","[0, 290, 622, 831, 1473, 1735, 2385, 2792, 3412, 3886, 4395, 5368, 5854, 6431, 7229, 8028, 9039, 9228, 9846, 10084, 10451, 10912, 12091, 12293, 13678, 14269, 15070, 16102, 16420, 16516]","[0, 293, 562, 925, 1164, 1498, 1918, 2125, 2862, 3190, 3744, 4513, 4797, 5117, 5713, 6458, 7094, 7667, 8298, 8918, 9394, 9902, 10461, 10663, 11312, 12197, 12610, 13237, 13703, 13831]","[0, 170, 260, 366, 577, 792, 987, 1077, 1766, 1856, 1995, 2340, 2764, 3179, 3312, 3961, 4401, 4496, 5057, 5295, 5640, 5735, 5944, 6367, 6925, 7263, 8023, 8933, 9162, 9551]","[0, 170, 343, 530, 620, 710, 1105, 1244, 1561, 1651, 1741, 1998, 2261, 2757, 3078, 3306, 3775, 4071, 4413, 4880, 5274, 5418, 5671, 5873, 6382, 6621, 6716, 6935, 7240, 7392]",16735,16516,13831,9551,7392,10,36,96,53,136,"[0, 243, 492, 840, 1127, 1616, 1881, 2369, 2907, 3348, 3616, 4094, 4738, 5642, 6381, 6896, 8088, 8839, 8974, 9597, 10095, 10781, 11663, 13011, 13257, 14177, 15539, 16460, 17971, 19008]","[0, 340, 657, 1104, 1507, 2127, 2501, 3010, 3974, 4680, 5094, 5755, 6658, 7350, 7877, 8407, 8627, 9346, 9748, 10438, 10821, 11634, 12342, 13183, 14479, 14869, 15719, 16118, 17583, 18088]","[0, 268, 429, 725, 863, 1270, 1490, 1891, 2274, 2619, 3004, 3952, 4331, 4713, 5392, 5570, 6531, 7319, 7576, 8089, 8268, 8835, 9307, 9892, 9986, 10216, 10460, 10814, 11765, 12221]","[0, 501, 630, 765, 904, 1127, 1309, 1399, 1489, 2075, 2459, 2871, 3375, 3669, 4158, 4562, 4937, 5327, 5959, 6511, 6983, 7181, 7700, 8199, 9155, 9657, 9814, 10440, 10812, 11338]","[0, 278, 368, 458, 592, 994, 1127, 1217, 1307, 1563, 1691, 2039, 2184, 2452, 2885, 3137, 3719, 3877, 4172, 4816, 5087, 5746, 6145, 6330, 6424, 7095, 7461, 7960, 8458, 8870]",19008,18088,12221,11338,8870,-2273,-1572,1610,-1787,-1478,-5500,30,dire
7611725802,95,96,21,86,26,"[0, 332, 993, 1396, 2023, 2375, 2928, 3377, 3713, 4288, 4886, 5544, 6095, 6368, 6959, 7444, 7875, 8725, 9394, 9504, 10090, 11017, 11817, 12277, 13370, 13488, 14401, 15366, 15764, 16520]","[0, 170, 737, 1111, 1846, 2135, 2514, 3389, 3649, 4014, 4825, 5735, 6200, 6688, 7192, 7639, 8027, 8739, 9509, 10286, 10987, 11641, 11941, 12681, 12775, 13424, 14317, 14412, 14765, 15542]","[0, 260, 537, 933, 1142, 1471, 1803, 2321, 2775, 3395, 3622, 4118, 4884, 5032, 5727, 6126, 6850, 7196, 7414, 7820, 8296, 8669, 9233, 9328, 9700, 9922, 10563, 10658, 10817, 11866]","[0, 170, 431, 658, 1012, 1210, 1543, 1822, 1912, 2406, 2653, 3342, 4381, 4731, 5192, 5911, 6250, 6679, 6895, 7169, 7624, 8109, 8606, 8873, 9057, 9152, 9823, 9918, 10400, 12338]","[0, 170, 354, 489, 689, 862, 1029, 1119, 1227, 1718, 1930, 2409, 3224, 3372, 3958, 4259, 4467, 4651, 4746, 5338, 5624, 5777, 6230, 6978, 7072, 7201, 7296, 7516, 7612, 8756]",16520,15542,11866,12338,8756,15,25,97,105,51,"[0, 209, 551, 786, 1001, 1613, 2312, 2402, 3382, 3988, 4230, 4826, 5415, 6429, 7150, 7983, 8739, 9625, 10255, 11470, 12009, 12989, 14232, 15005, 16005, 17399, 18347, 19279, 20344, 22461]","[0, 255, 484, 771, 1023, 1711, 2052, 2549, 3279, 3619, 4088, 4326, 4584, 5058, 5676, 6495, 6940, 7998, 8576, 9249, 9817, 10471, 11380, 12238, 12996, 14238, 15418, 16825, 17569, 18129]","[0, 205, 495, 659, 846, 1113, 1696, 1859, 2507, 2925, 3625, 3995, 4260, 4812, 5014, 5965, 6380, 7270, 8116, 8625, 9267, 9742, 10841, 11733, 11976, 12679, 13957, 14052, 14762, 16078]","[0, 170, 466, 599, 761, 1262, 1616, 1706, 2145, 2502, 2774, 2864, 3653, 4293, 4442, 5525, 6295, 6542, 7138, 7465, 7891, 8308, 9116, 9719, 10192, 11292, 11724, 12365, 13121, 14006]","[0, 170, 260, 350, 477, 813, 948, 1162, 1402, 1594, 1914, 2261, 2522, 3126, 3275, 3626, 4352, 4704, 5222, 5649, 5743, 6252, 7247, 7833, 8017, 9173, 9623, 9718, 10196, 10902]",22461,18129,16078,14006,10902,-5941,-2587,-4212,-1668,-2146,-16554,30,dire
7611842709,18,129,106,105,79,"[0, 181, 516, 922, 1203, 1641, 1929, 2163, 2416, 2870, 3241, 3888, 4772, 5439, 6097, 6885, 7647, 8389, 8904, 9556, 10026, 10564, 11726, 12294, 12709, 12852, 13727, 14919, 15557, 16258]","[0, 141, 445, 854, 1224, 1517, 2038, 2527, 2984, 3369, 3782, 4178, 4878, 5383, 5889, 6641, 7013, 7228, 7674, 8607, 9369, 9661, 9869, 10392, 10907, 11002, 11160, 12330, 13536, 14150]","[0, 203, 514, 891, 1063, 1344, 1721, 1970, 2268, 2594, 2890, 3230, 3567, 4284, 4675, 5165, 5957, 6359, 6893, 7151, 7764, 8231, 8755, 9615, 10367, 10509, 11147, 12090, 12705, 12801]","[0, 90, 180, 317, 455, 957, 1094, 1220, 1396, 1592, 1767, 2262, 2422, 2709, 2990, 3405, 3883, 3977, 4437, 4540, 4996, 5273, 5554, 5807, 6398, 6989, 7286, 8013, 8659, 8755]","[0, 90, 180, 270, 378, 525, 925, 1015, 1105, 1466, 1556, 2047, 2229, 2666, 2891, 3162, 3513, 3882, 4193, 4339, 4632, 4726, 4821, 4965, 5273, 5448, 5543, 6301, 6747, 7091]",16258,14150,12801,8755,7091,95,78,13,58,5,"[111, 361, 673, 1216, 1546, 2034, 2585, 2931, 3546, 3999, 4633, 5255, 5734, 6357, 7299, 8066, 8992, 9871, 10917, 11917, 12899, 13597, 14559, 15334, 16247, 17293, 18152, 18649, 19858, 19954]","[244, 494, 852, 1213, 1554, 1881, 2241, 2918, 3248, 3738, 4595, 4892, 5441, 6044, 6562, 7249, 7773, 8372, 9472, 10132, 11360, 11916, 13001, 13536, 14176, 14981, 15518, 15613, 16253, 16887]","[111, 512, 781, 1146, 1403, 1726, 2237, 2676, 2845, 3618, 4250, 4634, 5237, 5698, 6266, 6747, 7749, 8448, 8811, 9542, 10466, 10760, 11717, 12472, 13504, 14243, 14644, 14988, 15715, 16586]","[379, 629, 719, 853, 991, 1121, 1211, 1461, 1609, 1850, 2193, 2425, 2695, 2870, 3145, 3294, 3479, 4073, 4440, 4650, 5345, 5477, 5851, 6343, 6841, 7552, 8063, 8158, 8745, 9393]","[111, 410, 500, 720, 810, 1029, 1305, 1559, 1694, 1844, 2328, 2418, 2790, 2932, 3240, 3417, 3618, 4044, 4269, 4475, 4933, 5333, 5710, 6199, 7108, 7603, 7854, 8028, 8670, 8841]",19954,16887,16586,9393,8841,-3696,-2737,-3785,-638,-1750,-12606,30,dire
7611956203,113,28,120,105,20,"[0, 272, 668, 954, 1547, 2071, 2335, 2816, 3245, 3601, 3974, 4492, 4967, 5912, 6625, 7291, 8192, 8722, 9663, 10372, 11095, 12016, 12784, 13629, 14516, 15544, 16188, 17306, 18310, 19515]","[0, 130, 506, 753, 1162, 1424, 1803, 2222, 2587, 2973, 3482, 3930, 4508, 5492, 6126, 7151, 7541, 8495, 8712, 9201, 9603, 10166, 10650, 10994, 11324, 12537, 13115, 13467, 13786, 14096]","[0, 238, 588, 965, 1328, 1703, 2419, 2985, 3549, 3962, 4523, 5038, 5309, 5919, 6383, 6869, 7130, 7960, 8705, 8925, 9823, 10513, 11250, 11720, 12043, 12435, 12897, 12992, 13450, 13760]","[0, 467, 557, 691, 829, 969, 1342, 1574, 1878, 2271, 2573, 2713, 2938, 3549, 3899, 4292, 4580, 4920, 5119, 5770, 6167, 6690, 7335, 7642, 7879, 8551, 8722, 8865, 9042, 9352]","[0, 199, 289, 533, 911, 1125, 1419, 1778, 1925, 2285, 2800, 3016, 3480, 3988, 4280, 4705, 5178, 5484, 5695, 5853, 5999, 6154, 6321, 6487, 6724, 7237, 7498, 7639, 7816, 8126]",19515,14096,13760,9352,8126,63,137,23,72,121,"[0, 243, 495, 888, 1263, 1623, 1965, 2520, 2888, 3518, 3879, 4371, 4731, 4879, 5387, 5924, 6240, 6978, 7394, 8330, 9191, 10220, 10864, 11647, 12447, 12623, 13076, 14321, 15185, 16161]","[0, 323, 584, 912, 1203, 1529, 1799, 1979, 2157, 2359, 3060, 3515, 4506, 4884, 5862, 6108, 6891, 7346, 7963, 9480, 10198, 10971, 11720, 11905, 12650, 12983, 13835, 14381, 14891, 16430]","[0, 280, 488, 858, 1541, 1650, 2265, 2695, 3070, 3513, 3658, 4153, 4568, 5101, 5870, 6447, 6942, 7520, 7949, 9007, 9289, 9550, 10340, 10574, 10950, 11044, 12282, 12768, 13029, 13650]","[0, 170, 260, 350, 526, 668, 758, 972, 1062, 1264, 1409, 1499, 2227, 2380, 2735, 2830, 2988, 3082, 3323, 4311, 4454, 4779, 5018, 5251, 5775, 6331, 7004, 7099, 7379, 7781]","[0, 170, 490, 669, 965, 1055, 1267, 1447, 1704, 1906, 2188, 2278, 2491, 2703, 2924, 3170, 3364, 3458, 3555, 4062, 4377, 5022, 5336, 5596, 6292, 6606, 7036, 7206, 7458, 7866]",16161,16430,13650,7781,7866,3354,-2334,110,1571,260,2961,30,dire
7611958600,94,7,23,105,65,"[0, 335, 567, 799, 1359, 1888, 2228, 2773, 3256, 3722, 4547, 5075, 5456, 6119, 6668, 7136, 8231, 9007, 9735, 10216, 11155, 12064, 12582, 13456, 13928, 15105, 16479, 17365, 18549, 19944]","[0, 325, 615, 956, 1165, 1548, 2001, 2502, 2980, 3309, 3868, 4434, 4772, 5444, 5790, 7213, 7752, 8635, 9026, 9211, 9757, 10536, 10923, 11258, 11832, 12586, 13379, 14247, 15314, 15844]","[0, 262, 695, 1060, 1363, 1972, 2353, 2533, 3347, 3640, 4525, 4821, 5467, 6469, 7022, 7614, 8066, 9195, 9885, 10149, 10777, 11160, 11546, 12349, 12877, 13726, 14235, 14731, 15704, 15963]","[0, 169, 259, 349, 451, 875, 1385, 1800, 1969, 2361, 2543, 2677, 2953, 3390, 3737, 3917, 4266, 5265, 5704, 5889, 6277, 6566, 6774, 7454, 7995, 9076, 9563, 9733, 10984, 11318]","[100, 271, 410, 500, 667, 1023, 1248, 1863, 2016, 2126, 2379, 2640, 2837, 3470, 3874, 4234, 4651, 5576, 5860, 6234, 6445, 6825, 6920, 7124, 7630, 8567, 8964, 9116, 10338, 10771]",19944,15844,15963,11318,10771,89,69,128,79,9,"[0, 214, 530, 766, 1073, 1400, 1879, 2211, 2540, 3103, 3571, 3854, 4558, 5181, 5844, 6711, 7875, 8188, 9180, 10107, 11044, 11915, 12379, 13915, 14429, 14596, 15633, 16441, 16831, 17058]","[0, 235, 540, 897, 1033, 1237, 1584, 1837, 2308, 2870, 3620, 4097, 4469, 5136, 5848, 6335, 7108, 7363, 7850, 8287, 8734, 8989, 9411, 10111, 10615, 11088, 11376, 12985, 13241, 13519]","[0, 352, 681, 885, 1178, 1434, 1797, 2261, 2521, 2846, 3424, 3817, 4448, 4932, 5180, 5745, 6107, 6547, 7242, 8175, 8673, 9179, 9876, 10529, 10820, 11373, 11665, 11760, 12395, 12959]","[0, 200, 290, 479, 616, 1180, 1270, 1514, 1703, 2209, 2704, 2838, 3240, 3404, 3499, 4087, 4272, 4367, 4694, 4851, 5009, 5496, 5663, 6093, 6358, 6727, 6866, 7437, 7533, 7807]","[0, 468, 618, 921, 1011, 1303, 1530, 1729, 1819, 2040, 2331, 2519, 2724, 2873, 3034, 3417, 3724, 3922, 4182, 4339, 4497, 4743, 4910, 5086, 5181, 5348, 5720, 6168, 6264, 6549]",17058,13519,12959,7807,6549,2886,2325,3004,3511,4222,15948,30,radiant
7612109715,109,38,106,85,27,"[0, 322, 520, 841, 1203, 1575, 2018, 2286, 2766, 3199, 3701, 4233, 4981, 5732, 6377, 7325, 8325, 9203, 10140, 11202, 12159, 13183, 14442, 15421, 16099, 16567, 17858, 19108, 20007, 20808]","[0, 367, 577, 1026, 1187, 1775, 1987, 2681, 3165, 3484, 4274, 4867, 5350, 6170, 6664, 7390, 8055, 8727, 10020, 10777, 11564, 11824, 12306, 13172, 13580, 14106, 14877, 15417, 15851, 16223]","[0, 372, 658, 917, 1286, 1661, 2051, 2824, 3169, 3463, 3943, 4408, 4745, 5077, 5433, 5867, 6628, 7132, 7624, 8170, 8806, 9031, 9862, 10358, 10937, 11275, 11480, 11670, 12104, 12367]","[0, 210, 338, 517, 656, 786, 876, 1410, 1641, 1731, 1988, 2263, 2421, 2594, 2724, 3057, 3350, 3445, 3799, 4160, 4394, 4545, 4821, 4916, 5196, 5501, 5708, 5852, 5948, 6044]","[0, 210, 334, 468, 558, 771, 861, 1070, 1301, 1436, 1645, 1735, 2139, 2486, 2617, 2839, 3132, 3227, 3594, 3925, 4148, 4243, 4565, 4956, 5311, 5691, 5860, 6079, 6250, 6420]",20808,16223,12367,6044,6420,12,13,129,9,123,"[0, 252, 574, 827, 1429, 1762, 2323, 2506, 3076, 3379, 3886, 4440, 5190, 5597, 6259, 6805, 7444, 7722, 8801, 9198, 9717, 10699, 11457, 11810, 13179, 13742, 14440, 15124, 16052, 16381]","[0, 245, 520, 808, 1098, 1188, 1520, 1655, 2171, 3071, 3744, 3962, 4646, 5092, 5607, 6093, 6967, 7356, 8082, 8575, 8877, 9580, 10567, 11266, 12603, 13153, 14000, 15028, 15480, 15827]","[0, 532, 696, 893, 1299, 1722, 1922, 2411, 2849, 3326, 3963, 4534, 5138, 5712, 6285, 6535, 6990, 7599, 8049, 8144, 8826, 9631, 10171, 10840, 11949, 13069, 14118, 14402, 15015, 15490]","[0, 192, 282, 459, 973, 1063, 1654, 1891, 2376, 2709, 2889, 3238, 4024, 4317, 4524, 4842, 5065, 5616, 5953, 6086, 6453, 7053, 7349, 7767, 8270, 8614, 8826, 9359, 9952, 10093]","[0, 192, 282, 455, 630, 756, 1003, 1138, 1370, 1538, 1718, 2052, 2530, 2794, 3033, 3128, 3411, 3861, 4153, 4537, 5083, 5665, 5870, 6340, 6684, 7487, 7581, 8044, 8568, 8822]",16381,15827,15490,10093,8822,4427,396,-3123,-4049,-2402,-4751,30,dire
7612131018,49,78,21,58,9,"[0, 213, 437, 681, 1137, 1457, 2006, 2400, 2947, 3320, 4012, 4651, 5665, 6397, 7223, 8085, 8678, 9956, 10535, 11124, 11219, 11762, 12916, 13699, 14385, 15530, 16137, 16674, 17468, 18024]","[0, 250, 527, 847, 1096, 1502, 1954, 2265, 2665, 3127, 3683, 4153, 4622, 4956, 5564, 6104, 6478, 7659, 8275, 9448, 9697, 10110, 10623, 10717, 11325, 12078, 12631, 13366, 14209, 14648]","[0, 325, 700, 1155, 1458, 1752, 2229, 2600, 3050, 3639, 3940, 4630, 5204, 6003, 6807, 7161, 7523, 7896, 8259, 9105, 9481, 10318, 10859, 11310, 11405, 12055, 12584, 13146, 13780, 13876]","[0, 474, 564, 698, 852, 959, 1049, 1435, 1574, 1688, 1904, 2221, 2611, 2856, 3313, 3580, 3889, 4356, 4590, 4773, 4868, 5016, 5452, 5628, 5896, 6226, 6449, 6696, 6954, 7050]","[0, 166, 304, 474, 665, 800, 966, 1192, 1282, 1372, 1741, 1923, 2358, 2554, 2818, 3087, 3227, 3570, 3665, 4073, 4583, 4723, 4890, 4984, 5079, 5246, 5406, 5543, 5801, 6020]",18024,14648,13876,7050,6020,73,69,137,5,65,"[0, 366, 1039, 1509, 1853, 2149, 2672, 3186, 3695, 4112, 4866, 5255, 5669, 6375, 7039, 7777, 8699, 9573, 10719, 11581, 13195, 14172, 14702, 15863, 17208, 17955, 18692, 19325, 20791, 21875]","[0, 210, 539, 687, 1083, 1502, 1664, 2201, 2734, 3147, 3764, 3971, 4620, 5053, 5771, 6519, 7537, 8083, 8390, 9291, 9564, 10066, 10858, 11274, 12360, 12662, 13278, 13558, 14402, 15051]","[0, 293, 501, 834, 1077, 1364, 1663, 2007, 2308, 2930, 3467, 4034, 4737, 5386, 5872, 6274, 6989, 7862, 8315, 8819, 9159, 9883, 10402, 10778, 11683, 11985, 12641, 12965, 13151, 13907]","[0, 210, 372, 538, 742, 832, 1014, 1504, 1639, 2077, 2593, 2761, 2851, 3113, 3208, 3454, 3701, 4167, 4464, 4811, 5487, 5885, 6199, 6784, 7303, 7807, 7977, 8304, 8902, 9862]","[0, 210, 367, 543, 713, 850, 1297, 1652, 1787, 2219, 2642, 2732, 3220, 3569, 4017, 4565, 4913, 5125, 5321, 5937, 6735, 7119, 7547, 8079, 8271, 8894, 9363, 9457, 9763, 10643]",21875,15051,13907,9862,10643,-3851,-403,-31,-2812,-4623,-11720,30,dire
7612171311,89,23,60,9,45,"[0, 130, 331, 691, 984, 1261, 1609, 1974, 2389, 2863, 3531, 4156, 4734, 5458, 6141, 6921, 7871, 8813, 9820, 11128, 12106, 13043, 14089, 15155, 16488, 17350, 17748, 18688, 19427, 20372]","[0, 237, 594, 1083, 1342, 1649, 2235, 2547, 3370, 3933, 4726, 5633, 6004, 6822, 7076, 7171, 7586, 8089, 8752, 9710, 10155, 10596, 11043, 11294, 11957, 12628, 12887, 13714, 14288, 14930]","[0, 214, 486, 770, 1100, 1390, 1915, 2306, 2867, 3333, 4193, 4675, 5327, 5782, 6123, 6735, 7414, 8013, 8499, 9780, 10526, 10860, 11136, 11538, 12248, 12597, 13008, 13300, 14358, 15003]","[0, 130, 220, 421, 544, 680, 826, 1054, 1184, 1871, 2307, 2702, 2933, 3268, 3573, 3668, 3953, 4433, 4746, 5372, 5612, 5738, 5891, 6259, 6489, 6804, 6899, 7145, 7630, 8042]","[100, 230, 368, 488, 693, 783, 873, 1001, 1292, 1584, 2056, 2371, 2655, 2883, 3298, 3393, 3686, 3834, 4409, 5138, 5624, 5838, 6225, 6478, 6751, 6993, 7329, 7544, 7796, 8058]",20372,14930,15003,8042,8058,73,49,13,128,85,"[0, 371, 827, 1139, 1599, 1897, 2376, 3278, 4156, 5108, 6095, 6405, 7474, 8500, 10294, 11321, 11996, 13212, 14522, 15027, 15431, 15999, 16586, 17933, 18976, 20043, 21651, 23306, 24498, 25904]","[0, 300, 628, 892, 1274, 1601, 2059, 2580, 3041, 3320, 3983, 4553, 5160, 5634, 6392, 6842, 7176, 7596, 8290, 8858, 9442, 10105, 10606, 11690, 12152, 12840, 14108, 14941, 15778, 16501]","[0, 330, 650, 943, 1362, 1563, 1812, 2137, 2463, 3043, 3223, 3751, 4336, 4707, 5495, 6144, 7016, 7769, 8669, 8799, 9485, 9718, 10572, 11415, 12167, 12926, 14000, 14717, 15436, 15707]","[0, 214, 402, 545, 750, 895, 1034, 1124, 1509, 2057, 2391, 2578, 2855, 3103, 3627, 3933, 4091, 4452, 4875, 4970, 5307, 5401, 5788, 6337, 6951, 7481, 8348, 8657, 9092, 9949]","[2, 212, 302, 439, 1019, 1109, 1248, 1468, 1626, 1868, 2104, 2194, 2421, 2642, 2965, 3060, 3303, 3397, 3622, 3717, 3812, 3977, 4233, 4590, 4808, 5024, 5553, 5783, 6306, 6790]",25904,16501,15707,9949,6790,-5532,-1571,-704,-1907,1268,-8446,30,dire
7612195805,48,78,19,123,103,"[0, 273, 601, 1043, 1330, 1828, 2243, 2676, 3155, 3649, 4252, 4962, 5428, 6120, 7088, 8004, 8724, 9619, 10528, 11751, 12829, 13630, 14841, 15582, 16329, 17009, 17589, 18640, 19601, 20766]","[0, 277, 559, 1095, 1386, 1656, 2122, 2516, 3114, 3385, 4078, 4737, 5318, 5795, 6142, 6596, 7405, 7724, 8920, 9547, 10053, 11092, 11988, 12585, 13395, 14167, 14751, 15148, 15610, 16168]","[0, 273, 565, 848, 1259, 1694, 1955, 2298, 2984, 3348, 3812, 4377, 4916, 5174, 5479, 5611, 6222, 6767, 7281, 7438, 7965, 8512, 8816, 9301, 10014, 10109, 10443, 11190, 11704, 12322]","[0, 199, 289, 444, 534, 624, 795, 1002, 1213, 1525, 1946, 2458, 2623, 2945, 3495, 3676, 4033, 4252, 4840, 4997, 5241, 5673, 6131, 7209, 7631, 7960, 8087, 8290, 8701, 8978]","[0, 195, 285, 375, 465, 600, 735, 825, 969, 1291, 1542, 2070, 2208, 2303, 2446, 2540, 2698, 2953, 3274, 3431, 3570, 3888, 4032, 4443, 4648, 4743, 4838, 4932, 5154, 5431]",20766,16168,12322,8978,5431,89,13,129,110,138,"[0, 220, 492, 773, 1273, 1656, 2073, 2485, 2730, 3116, 3629, 3947, 4748, 5657, 6349, 6905, 7932, 9393, 10412, 11574, 12479, 13335, 14102, 14659, 16433, 17504, 18658, 19916, 21192, 22248]","[0, 277, 522, 770, 1139, 1427, 1870, 2183, 2619, 3206, 3528, 3672, 4386, 5017, 5535, 5853, 6390, 6764, 7143, 8335, 8892, 9118, 9410, 9504, 9848, 11053, 11811, 12412, 12809, 13601]","[0, 206, 455, 766, 892, 1172, 1531, 1692, 2031, 2553, 3053, 3197, 3556, 4191, 4786, 5439, 5860, 6369, 6863, 7671, 8154, 8559, 8855, 9473, 10169, 10884, 11382, 11790, 12098, 12351]","[0, 170, 260, 350, 486, 860, 972, 1153, 1339, 1674, 1993, 2277, 2475, 2678, 2898, 3046, 3619, 4013, 4301, 5020, 5420, 5942, 6184, 6353, 6720, 7101, 7407, 7737, 8130, 8463]","[0, 170, 309, 443, 578, 767, 902, 1256, 1346, 1709, 1933, 2242, 2508, 2755, 2975, 3212, 3732, 3949, 4107, 4571, 4848, 5074, 5241, 5335, 5592, 5849, 6312, 6498, 6774, 7181]",22248,13601,12351,8463,7181,-1482,2567,-29,515,-1750,-179,30,radiant
7612206614,113,21,129,109,64,"[0, 200, 522, 781, 1145, 1435, 1769, 2126, 2780, 2956, 3489, 4232, 4815, 5443, 5868, 6462, 6978, 7206, 8011, 9006, 9558, 10482, 11229, 11991, 12245, 13646, 13943, 15030, 15243, 16045]","[0, 204, 498, 1029, 1333, 1735, 2001, 2370, 2723, 3230, 3824, 4265, 5407, 5852, 6167, 6719, 7529, 7759, 8092, 8550, 9050, 9235, 9955, 10599, 11280, 12507, 13047, 13866, 14443, 15288]","[0, 200, 408, 720, 1035, 1424, 1808, 2108, 2638, 3084, 3542, 3760, 4412, 4852, 5440, 5714, 6085, 6490, 7117, 7740, 8123, 8308, 8736, 9930, 10219, 11025, 11170, 11456, 11694, 12113]","[0, 130, 220, 358, 448, 819, 955, 1045, 1240, 1860, 2085, 2201, 2406, 2725, 2946, 3307, 3723, 3913, 4033, 4546, 5139, 5567, 5845, 5940, 6034, 6936, 7195, 7691, 8014, 8494]","[0, 130, 220, 404, 900, 1016, 1343, 1559, 1812, 2123, 2742, 3362, 3615, 3860, 4009, 4104, 4642, 4737, 5293, 5583, 5859, 6244, 7072, 7801, 7970, 8719, 8965, 9261, 9642, 9980]",16045,15288,12113,8494,9980,22,76,29,123,100,"[0, 410, 659, 1082, 1523, 2052, 2450, 2837, 3429, 4198, 4884, 5406, 6620, 7325, 8387, 9107, 9733, 10506, 11146, 11972, 13027, 14115, 15181, 15991, 16468, 17429, 18012, 18956, 19871, 20292]","[0, 281, 482, 648, 1098, 1312, 1537, 1661, 1868, 2289, 2649, 2973, 3582, 4102, 4717, 5310, 6220, 6995, 7786, 8425, 8894, 9649, 10269, 11444, 12495, 12990, 14059, 15048, 15878, 16637]","[0, 210, 537, 884, 1299, 1665, 2359, 2517, 2795, 3189, 3883, 3973, 4737, 5251, 5906, 6506, 6937, 7233, 7686, 7900, 8776, 9430, 10068, 10855, 11662, 11928, 12374, 13044, 13814, 14481]","[0, 245, 335, 459, 629, 948, 1216, 1356, 1491, 1977, 2358, 2533, 3233, 3490, 4108, 4475, 4739, 5139, 5552, 5800, 6453, 7123, 7488, 9116, 10081, 10176, 10621, 10969, 11318, 11842]","[0, 257, 347, 437, 653, 743, 868, 958, 1093, 1687, 1867, 1991, 2696, 2791, 3250, 3603, 3985, 4331, 4426, 4551, 4915, 5460, 5627, 6515, 6963, 7058, 7267, 7518, 7776, 8015]",20292,16637,14481,11842,8015,-4247,-1349,-2368,-3348,1965,-9347,30,dire
7612212318,95,126,129,40,121,"[0, 251, 919, 1262, 1769, 2344, 2989, 3280, 3783, 4306, 4926, 5532, 5919, 6731, 7504, 8594, 9160, 9880, 11369, 12090, 13160, 13637, 14550, 15824, 16333, 17355, 17991, 18693, 18975, 20125]","[0, 319, 664, 1071, 1409, 1870, 2206, 3016, 3468, 4285, 4864, 5216, 5538, 6091, 6633, 6976, 7979, 8458, 9572, 9990, 10557, 10652, 11184, 11566, 12640, 13554, 13854, 15028, 16100, 16664]","[0, 135, 390, 553, 803, 1085, 1251, 1908, 2253, 2944, 3463, 3777, 4295, 4429, 5073, 5399, 5663, 6498, 7041, 7449, 8387, 8534, 9555, 10004, 10909, 11148, 11679, 12989, 14568, 14857]","[0, 129, 302, 392, 570, 707, 1051, 1141, 1428, 1785, 2021, 2301, 2572, 2946, 3443, 4112, 4751, 5294, 6146, 6804, 7281, 7467, 8085, 8407, 9130, 9828, 10466, 11290, 11914, 12426]","[0, 129, 219, 309, 399, 489, 579, 762, 988, 1309, 1537, 1764, 1854, 2048, 2248, 2669, 3073, 3347, 4060, 4365, 4693, 4788, 5127, 5332, 5662, 5901, 6112, 6580, 7052, 7478]",20125,16664,14857,12426,7478,84,90,96,37,53,"[0, 294, 733, 1167, 1410, 1899, 2276, 2673, 3103, 3647, 4199, 4806, 5336, 6323, 6851, 7695, 8044, 8692, 9113, 9528, 9890, 10802, 11686, 11856, 12399, 12630, 13541, 14230, 14799, 15495]","[0, 356, 684, 1007, 1429, 1721, 2142, 2782, 2872, 3527, 3902, 4528, 4899, 5347, 5884, 7085, 7385, 7940, 8640, 9032, 9407, 9775, 10363, 10705, 11558, 12422, 12853, 13435, 13707, 14266]","[0, 209, 567, 797, 953, 1203, 1408, 2160, 2365, 2504, 2853, 3228, 3813, 4268, 4689, 4934, 5527, 6238, 6854, 7160, 7711, 8039, 8441, 8611, 9013, 9541, 10141, 10558, 10965, 11714]","[0, 209, 299, 518, 608, 792, 983, 1231, 1360, 1617, 1903, 2086, 2369, 2742, 2977, 3605, 3907, 4439, 4819, 5056, 5364, 5479, 5720, 6124, 6994, 7499, 7668, 8836, 9279, 9713]","[0, 209, 299, 419, 716, 851, 975, 1155, 1620, 1970, 2174, 2324, 2516, 3085, 3412, 3795, 4083, 4555, 5003, 5098, 5537, 6202, 6368, 6793, 7825, 8336, 8682, 9332, 9604, 9738]",15495,14266,11714,9713,9738,4630,2398,3143,2713,-2260,10624,30,radiant
7612312609,138,97,137,65,91,"[59, 229, 459, 752, 1198, 1791, 2311, 2922, 3388, 4008, 4609, 5241, 5895, 6345, 7329, 7817, 8390, 9793, 10281, 11327, 12366, 12829, 13816, 14735, 15947, 16904, 18041, 19861, 21509, 22457]","[327, 618, 961, 1530, 2068, 2434, 2927, 3455, 4296, 4764, 5340, 5527, 6789, 7071, 7573, 7994, 8401, 9307, 9685, 10164, 10673, 11395, 12353, 12573, 13645, 14107, 14611, 15551, 16369, 16696]","[0, 397, 716, 1036, 1284, 1709, 2115, 2563, 2755, 3442, 3670, 4168, 4812, 5376, 5902, 6530, 7338, 7936, 8070, 8718, 8945, 9040, 9748, 11024, 11644, 12255, 12947, 13871, 14865, 15702]","[59, 229, 405, 611, 1026, 1337, 1515, 2284, 2475, 2720, 2861, 3098, 3462, 3709, 4046, 4454, 4838, 5251, 5636, 6278, 6673, 7028, 7689, 7887, 8271, 8741, 9056, 9780, 10472, 11252]","[59, 229, 398, 488, 749, 1023, 1647, 1943, 2033, 2609, 2872, 3262, 3499, 3659, 4004, 4206, 4364, 4717, 4812, 5194, 5337, 5616, 5924, 6551, 6789, 7004, 7364, 8086, 8778, 9001]",22457,16696,15702,11252,9001,10,17,52,19,5,"[0, 250, 501, 745, 1143, 1433, 1970, 2286, 2478, 2828, 3348, 4436, 4813, 5513, 5877, 6364, 7072, 7538, 8082, 8881, 10077, 10415, 11201, 11296, 12227, 12961, 13687, 14221, 14651, 15474]","[0, 170, 539, 913, 1548, 1800, 2041, 2575, 2953, 3161, 3296, 3790, 4105, 4618, 4892, 5348, 5816, 6427, 6880, 7318, 8177, 8913, 9765, 9860, 10213, 10587, 11222, 11702, 12472, 12596]","[0, 244, 479, 774, 1147, 1674, 1846, 2028, 2274, 2747, 3171, 3422, 4122, 4558, 5104, 5607, 6257, 6351, 6971, 7659, 8533, 8878, 9479, 9704, 10176, 10598, 11235, 11624, 11720, 11891]","[0, 170, 347, 437, 610, 890, 980, 1375, 1499, 1932, 2312, 2692, 2892, 3268, 3530, 3712, 4139, 4405, 4702, 4962, 5317, 5412, 5692, 5931, 6345, 6883, 7068, 7350, 7882, 8129]","[0, 170, 260, 350, 440, 877, 967, 1137, 1227, 1435, 1570, 1660, 1935, 2178, 2273, 2565, 2898, 3137, 3280, 3540, 4082, 4177, 4344, 4439, 4891, 5353, 5794, 6058, 6551, 6647]",15474,12596,11891,8129,6647,6983,4100,3811,3123,2354,20371,30,radiant
7612444217,19,41,96,86,121,"[0, 327, 533, 955, 1294, 1676, 2084, 2582, 2710, 3004, 3597, 4081, 4515, 4889, 5301, 5396, 6069, 6516, 7202, 7320, 8753, 9337, 9576, 10160, 10500, 10667, 11180, 12111, 12735, 12869]","[0, 205, 485, 721, 1078, 1358, 1853, 2273, 2485, 2741, 2913, 3174, 3584, 3863, 4313, 4682, 5016, 5466, 5973, 6326, 7145, 7711, 8398, 9101, 9634, 9930, 10221, 11528, 12155, 12674]","[0, 298, 460, 663, 1400, 1559, 1821, 2252, 2563, 2931, 3255, 3853, 4164, 4521, 5018, 5462, 5814, 5972, 6067, 6269, 6862, 7200, 7637, 8332, 8839, 8934, 9029, 9698, 9983, 10328]","[0, 170, 260, 350, 682, 772, 1114, 1399, 1489, 1696, 2038, 2221, 2357, 2573, 2964, 3095, 3228, 3666, 3975, 4070, 4796, 4982, 5603, 6080, 6249, 6444, 6725, 7477, 7648, 7877]","[0, 170, 260, 397, 487, 621, 840, 1081, 1234, 1324, 1537, 1662, 1817, 1911, 2530, 2724, 2955, 3113, 3243, 3338, 3820, 3959, 4292, 4655, 4749, 4844, 4939, 6317, 6621, 6717]",12869,12674,10328,7877,6717,46,78,23,9,27,"[0, 206, 403, 769, 976, 1583, 1924, 2337, 2748, 3258, 3633, 4323, 5022, 5936, 6541, 7602, 8340, 9014, 9879, 10891, 11432, 11744, 12686, 13731, 14906, 16780, 18109, 18886, 19735, 20628]","[0, 205, 615, 859, 1063, 1638, 1931, 2257, 2546, 3077, 3504, 4012, 4387, 5009, 6049, 6685, 7121, 7514, 8393, 9043, 9957, 10981, 11710, 12167, 12357, 13444, 14396, 14909, 15745, 16308]","[0, 258, 733, 1035, 1327, 1656, 2191, 2700, 3408, 3751, 4885, 5311, 5891, 6461, 6918, 7531, 7986, 8081, 8747, 9189, 9653, 10176, 10478, 11062, 11361, 12078, 12801, 13422, 13831, 14944]","[0, 218, 355, 445, 570, 801, 970, 1060, 1207, 1520, 2225, 2461, 2819, 3165, 3516, 3898, 4650, 4881, 5061, 5569, 5849, 6661, 7038, 7473, 7642, 8608, 9399, 9849, 10477, 11158]","[0, 216, 306, 396, 577, 853, 1172, 1262, 1583, 1739, 2225, 2407, 2910, 3112, 3434, 3772, 4110, 4205, 4385, 4933, 5033, 5365, 5740, 6198, 6542, 7244, 8441, 8891, 9539, 10492]",20628,16308,14944,11158,10492,-7759,-3634,-4616,-3281,-3775,-23065,30,dire
7612885808,69,94,23,20,123,"[0, 232, 592, 860, 1088, 1351, 2247, 2659, 2920, 3286, 4020, 4559, 5540, 6049, 6472, 6943, 7676, 8305, 8853, 9545, 9963, 10457, 10711, 11506, 12296, 12684, 13291, 13786, 14916, 15172]","[0, 232, 407, 599, 976, 1353, 1637, 2145, 2688, 3106, 3795, 4144, 4798, 5418, 5975, 6618, 7419, 7854, 8141, 9069, 9688, 9870, 10085, 10941, 11536, 12659, 13421, 14179, 15605, 15709]","[0, 665, 954, 1302, 1705, 2157, 2528, 3146, 3651, 3996, 4224, 4672, 5227, 5767, 6408, 6971, 7700, 8009, 8104, 8550, 9365, 10140, 10367, 10903, 12023, 12692, 13474, 13665, 14223, 14319]","[0, 329, 419, 539, 646, 1006, 1279, 1622, 1896, 2166, 2508, 2781, 3050, 3149, 3260, 3354, 3564, 3722, 3817, 3967, 4133, 4337, 4558, 5058, 5683, 6200, 6562, 6975, 7604, 7775]","[0, 249, 339, 459, 549, 639, 912, 1002, 1092, 1336, 1518, 1755, 2318, 2509, 2656, 2788, 3129, 3395, 3525, 3787, 3882, 3977, 4071, 4413, 5192, 5675, 5962, 6549, 7269, 7621]",15172,15709,14319,7775,7621,70,106,96,53,5,"[0, 367, 717, 1256, 1739, 2304, 2559, 3121, 3579, 4097, 4662, 5219, 5926, 6720, 7330, 8726, 9486, 10837, 11590, 12293, 13669, 14857, 16213, 17219, 18195, 19480, 19655, 20328, 21643, 22925]","[0, 295, 609, 846, 1090, 1453, 1832, 2235, 3302, 3930, 4493, 4718, 4925, 5396, 6048, 6561, 7311, 8398, 9104, 10273, 10812, 12158, 12729, 13310, 14100, 15063, 16283, 17001, 17802, 18506]","[0, 245, 598, 765, 1156, 1554, 2009, 2372, 2636, 3052, 3513, 3811, 4150, 4749, 5350, 5945, 6789, 7376, 8130, 8486, 9233, 9877, 10363, 10963, 11474, 11823, 12888, 13708, 14774, 15209]","[0, 210, 538, 698, 788, 1300, 1474, 2070, 2398, 2741, 2997, 3232, 3368, 3711, 4282, 4926, 5475, 5937, 6521, 7340, 8050, 8885, 9504, 9941, 10690, 11634, 11809, 13007, 13531, 14297]","[0, 210, 330, 490, 1078, 1311, 1441, 1856, 2186, 2343, 2700, 2790, 3107, 3361, 3745, 4201, 4453, 4887, 5481, 5981, 6650, 7146, 7540, 7820, 8138, 8902, 9755, 10375, 11161, 12213]",22925,18506,15209,14297,12213,-7753,-2797,-890,-6522,-4592,-22554,30,dire
7613053405,48,98,23,68,20,"[0, 325, 657, 1024, 1346, 1760, 1888, 2527, 2898, 3229, 3640, 4021, 4604, 5317, 6223, 6816, 7496, 8317, 9158, 9867, 10137, 11462, 12150, 12925, 13896, 14832, 15733, 16338, 17122, 17992]","[0, 257, 491, 704, 998, 1243, 1370, 1870, 2357, 3090, 3555, 3978, 4713, 5400, 5869, 6473, 6704, 7245, 8288, 8798, 9876, 10239, 10757, 11523, 12581, 13060, 13607, 13998, 14375, 15403]","[0, 247, 583, 835, 1121, 1372, 1876, 2608, 2987, 3449, 4266, 4814, 5104, 5591, 6124, 6569, 6853, 7490, 7916, 8283, 8902, 9649, 10093, 10467, 10852, 11434, 12553, 12986, 13082, 13734]","[0, 170, 260, 394, 513, 647, 737, 1163, 1288, 1378, 2102, 2528, 2684, 2885, 3337, 3552, 3737, 4047, 4449, 4883, 5228, 5624, 5924, 6375, 6655, 6830, 7234, 7502, 7673, 8521]","[0, 170, 352, 486, 576, 666, 756, 1077, 1167, 1444, 1798, 2171, 2282, 2569, 3265, 3395, 3580, 4418, 4661, 4868, 5138, 5379, 5473, 5568, 5847, 6151, 6696, 7077, 7275, 7605]",17992,15403,13734,8521,7605,138,36,129,119,85,"[0, 255, 689, 1130, 1623, 2094, 2533, 3052, 3584, 4048, 4273, 4715, 5443, 6256, 7137, 7777, 9321, 10211, 11082, 11903, 12189, 13255, 13807, 14400, 15656, 16370, 17289, 18002, 19168, 19399]","[0, 365, 655, 983, 1467, 1797, 2481, 3039, 3555, 4175, 4737, 5214, 5964, 6455, 7254, 7632, 8909, 9917, 10675, 11225, 12643, 12981, 13721, 14074, 14965, 15617, 16564, 17451, 18151, 18443]","[0, 244, 493, 691, 1316, 1517, 2018, 2365, 2996, 3356, 3581, 4009, 4357, 5128, 5972, 6735, 7568, 8329, 8887, 9553, 10772, 11207, 11535, 11871, 12536, 13305, 13590, 14395, 15069, 15509]","[0, 170, 280, 405, 604, 694, 1080, 1478, 1613, 1780, 2383, 2473, 2646, 3240, 3718, 3861, 4485, 4759, 5036, 5329, 5710, 5969, 6173, 6597, 6989, 7573, 7748, 8127, 8419, 8650]","[0, 170, 260, 396, 643, 782, 928, 1251, 1421, 1593, 1856, 2046, 2183, 2612, 3291, 3510, 4294, 4551, 4894, 5198, 5472, 5677, 6004, 6211, 6532, 6871, 7121, 7675, 8116, 8529]",19399,18443,15509,8650,8529,-1407,-3040,-1775,-129,-924,-7275,30,radiant
7613240917,109,19,23,121,112,"[0, 209, 576, 855, 1135, 1382, 1804, 2044, 2431, 3084, 3399, 4232, 4626, 5093, 6318, 6935, 7281, 8245, 8877, 9684, 10014, 10394, 11133, 11648, 12371, 13227, 14933, 15258, 16032, 17042]","[0, 244, 461, 937, 1350, 1790, 2054, 2662, 2954, 3449, 3821, 3949, 4391, 5021, 5774, 5994, 6127, 6222, 6547, 6642, 7094, 7350, 8172, 8720, 8936, 9464, 10516, 10811, 11299, 12040]","[0, 289, 453, 748, 1164, 1571, 2190, 2765, 3342, 3781, 4025, 4657, 5394, 6205, 6715, 7348, 7761, 8094, 8498, 8708, 9190, 9515, 9955, 10309, 10782, 11173, 12099, 12415, 12751, 13385]","[0, 170, 358, 571, 750, 875, 1012, 1157, 1441, 1817, 2079, 2681, 2996, 3186, 3380, 4266, 4360, 4596, 4774, 5041, 5415, 5510, 5734, 6041, 6366, 6851, 8037, 8222, 8528, 8820]","[0, 170, 260, 418, 548, 673, 811, 946, 1287, 1498, 1588, 2006, 2186, 2324, 2518, 2908, 3288, 3419, 3598, 3693, 3901, 3996, 4230, 4325, 4463, 4630, 5380, 5773, 5908, 6379]",17042,12040,13385,8820,6379,48,126,84,43,123,"[0, 170, 440, 901, 1300, 1550, 1761, 2094, 2600, 3059, 3483, 4304, 5066, 5963, 6841, 7447, 8476, 9427, 10576, 11246, 12182, 12704, 13222, 14595, 15500, 16442, 17073, 17495, 18686, 19627]","[0, 286, 617, 946, 1277, 1637, 2052, 2436, 2850, 3251, 4421, 5367, 5989, 6635, 7380, 7768, 8799, 9362, 10084, 10702, 11254, 11928, 13035, 14239, 14861, 15782, 16695, 17700, 18174, 18779]","[0, 170, 260, 399, 562, 652, 742, 871, 1255, 1624, 2245, 2800, 3308, 3638, 3942, 4480, 5146, 6121, 6860, 7039, 8070, 8341, 8906, 9551, 10109, 10609, 11463, 12114, 12693, 13896]","[0, 253, 463, 825, 1119, 1505, 1918, 2315, 2491, 2711, 3457, 3634, 4421, 4818, 5264, 5511, 6377, 6824, 7276, 7699, 7856, 8194, 8918, 9644, 10129, 10654, 11250, 11345, 12076, 12519]","[0, 170, 309, 448, 724, 860, 998, 1652, 1742, 1832, 2170, 2321, 2885, 3178, 3479, 3647, 4276, 4886, 5172, 5838, 6689, 7149, 7928, 8318, 8570, 9124, 9516, 9870, 10363, 10817]",19627,18779,13896,12519,10817,-2585,-6739,-511,-3699,-4438,-17972,30,dire
7613249411,23,10,21,19,84,"[0, 293, 670, 984, 1350, 1745, 2238, 2593, 3191, 3944, 4463, 5088, 5700, 6330, 7013, 7560, 8283, 8961, 9583, 9854, 10381, 10652, 11071, 12074, 12773, 13553, 14057, 14744, 15338, 16111]","[0, 285, 568, 1010, 1556, 1975, 2358, 2704, 3079, 3435, 3975, 4431, 5293, 5974, 6651, 7020, 7468, 8023, 8556, 9035, 9360, 9904, 10112, 10491, 10887, 11438, 12124, 12481, 12918, 13145]","[0, 204, 490, 903, 1271, 1735, 2107, 2550, 2989, 3393, 4249, 4813, 5384, 5874, 6315, 6908, 7327, 7827, 8256, 8856, 9475, 10189, 10550, 10802, 11002, 11313, 11626, 11866, 12591, 13032]","[0, 221, 311, 480, 570, 725, 815, 954, 1044, 1205, 1460, 1597, 1741, 2057, 2365, 2459, 3056, 3721, 4094, 4389, 4508, 4923, 5017, 5112, 5683, 5823, 6047, 6270, 6540, 6636]","[0, 170, 299, 527, 617, 707, 797, 887, 977, 1177, 1312, 1455, 1934, 2137, 2322, 2464, 2626, 2964, 3178, 3444, 3539, 3634, 3779, 3874, 3994, 4089, 4183, 4359, 5300, 5396]",16111,13145,13032,6636,5396,46,2,107,121,83,"[0, 205, 559, 809, 1171, 1582, 1974, 2606, 3130, 3606, 4141, 4690, 5700, 6433, 7444, 8177, 9030, 9813, 10592, 11436, 12633, 13321, 14441, 15405, 16292, 17776, 18659, 19554, 20710, 21645]","[0, 248, 540, 1107, 1489, 2016, 2486, 3493, 4044, 4853, 5509, 6022, 6400, 6905, 8093, 8573, 9236, 9529, 10913, 11880, 12618, 13236, 13626, 14662, 14938, 15532, 16095, 16714, 17581, 17878]","[0, 255, 524, 846, 1228, 1526, 1785, 2347, 2823, 3156, 3705, 4001, 4514, 4987, 5677, 6144, 6783, 7176, 7984, 8655, 9484, 10046, 10618, 11263, 11790, 12867, 13340, 13928, 14291, 14497]","[0, 205, 295, 464, 634, 841, 931, 1260, 1350, 1698, 1882, 2117, 2375, 2470, 3295, 3438, 3749, 3844, 4107, 4674, 5240, 5335, 5922, 6631, 6726, 7055, 7463, 7864, 8304, 8585]","[0, 170, 260, 350, 682, 772, 910, 1106, 1243, 1421, 1511, 1679, 1817, 2086, 2860, 3031, 3380, 3577, 4044, 4282, 4732, 5062, 5565, 6269, 6486, 7050, 7410, 7736, 8099, 8305]",21645,17878,14497,8585,8305,-5534,-4733,-1465,-1949,-2909,-16590,30,dire
7613422607,70,86,84,121,88,"[0, 242, 566, 959, 1293, 1701, 2120, 2596, 3044, 3560, 4031, 4424, 4770, 5381, 6383, 7352, 7928, 8864, 9150, 9788, 11412, 12255, 13130, 14452, 15568, 16313, 17174, 17268, 17540, 17878]","[0, 284, 603, 1022, 1281, 1685, 2352, 2881, 3386, 3561, 4052, 4639, 5139, 5973, 7082, 8002, 8467, 8724, 9624, 10060, 10754, 11228, 11921, 12713, 14335, 14823, 15248, 15713, 16418, 16906]","[0, 283, 480, 875, 1219, 1579, 2066, 2266, 2617, 2790, 3287, 3416, 3913, 4111, 4931, 5135, 5886, 6515, 7056, 7303, 8172, 8552, 8865, 9585, 10837, 11270, 11540, 11794, 11890, 12628]","[0, 169, 259, 394, 484, 620, 710, 845, 935, 1046, 1478, 1568, 1775, 2047, 2404, 2759, 3090, 3527, 3622, 3717, 4246, 4480, 4793, 5050, 5767, 6006, 6101, 6195, 6291, 6387]","[0, 169, 309, 446, 536, 626, 995, 1085, 1175, 1313, 1494, 1693, 1783, 2120, 2611, 2965, 3182, 3545, 4154, 4298, 4439, 4624, 5150, 5407, 5597, 5836, 5931, 6025, 6121, 6217]",17878,16906,12628,6387,6217,106,19,54,119,5,"[0, 297, 490, 708, 1158, 1539, 1976, 2355, 2873, 3516, 4386, 4837, 5380, 5529, 5969, 6645, 7012, 8207, 8515, 9722, 10470, 10880, 11537, 12604, 13198, 14291, 15002, 16029, 16753, 17339]","[0, 242, 522, 957, 1547, 1913, 2531, 2915, 3214, 3580, 4020, 4635, 5066, 5974, 6367, 6462, 7686, 8779, 9332, 10022, 10776, 11509, 12007, 12628, 12836, 13312, 14638, 15853, 16372, 16896]","[0, 284, 532, 820, 1071, 1494, 1864, 2550, 3205, 3779, 4431, 4945, 5299, 6117, 6683, 7158, 7778, 8444, 8689, 9430, 10030, 10714, 11616, 12103, 12336, 12553, 13757, 14417, 15165, 15647]","[0, 510, 666, 802, 971, 1108, 1275, 1626, 1915, 2126, 2409, 2499, 2589, 2883, 3194, 3289, 3913, 4409, 4992, 5979, 6335, 6530, 6780, 6875, 6969, 7191, 7842, 8136, 8484, 8715]","[0, 169, 259, 403, 534, 716, 806, 1314, 1767, 1992, 2414, 2524, 2614, 2879, 2974, 3069, 3416, 3811, 3906, 4434, 4841, 4936, 5186, 5281, 5479, 5863, 6604, 6943, 7395, 7721]",17339,16896,15647,8715,7721,539,10,-3019,-2328,-1504,-6302,30,dire
7613436713,13,93,55,85,19,"[0, 207, 480, 760, 1088, 1379, 1780, 2214, 2786, 3222, 3751, 4202, 4352, 4953, 5548, 6537, 7699, 8426, 9410, 10226, 10892, 11828, 12577, 13156, 14091, 14912, 15674, 16734, 17046, 17237]","[0, 200, 519, 846, 1059, 1574, 1935, 2378, 2732, 3090, 3411, 4010, 4529, 5346, 5913, 6402, 7215, 7594, 8468, 9411, 9719, 10434, 11677, 12171, 12591, 13566, 13756, 13851, 14179, 14546]","[0, 239, 544, 897, 1356, 1590, 1983, 2143, 2518, 3066, 3289, 3807, 4403, 4813, 5464, 5917, 6776, 7275, 8096, 8687, 9097, 9625, 10471, 10795, 11498, 12136, 12615, 12710, 13080, 13249]","[0, 132, 247, 381, 488, 626, 753, 939, 1119, 1397, 1670, 1760, 1886, 2047, 2151, 2619, 3479, 3663, 4730, 5033, 5128, 5266, 5505, 5724, 5983, 6426, 7068, 7315, 7704, 7929]","[0, 132, 627, 772, 1123, 1257, 1347, 1437, 1796, 2010, 2234, 2351, 2469, 2617, 2783, 3209, 3908, 4462, 4995, 5369, 5464, 5602, 6111, 6262, 6405, 7003, 7253, 7412, 7643, 8165]",17237,14546,13249,7929,8165,89,59,129,65,52,"[0, 331, 571, 896, 1202, 1610, 1900, 2357, 2689, 3068, 3450, 4152, 4675, 5363, 6056, 6747, 7804, 8545, 9821, 10991, 12039, 12922, 14524, 15780, 16834, 17901, 18741, 20089, 20968, 21722]","[0, 282, 583, 946, 1156, 1490, 1852, 2633, 3022, 3767, 4286, 5140, 5655, 6190, 6929, 7533, 7799, 8291, 8454, 8612, 9270, 9516, 10093, 10638, 11187, 11645, 11740, 12875, 13198, 13689]","[0, 257, 419, 647, 944, 1303, 1598, 2008, 2468, 3195, 3905, 4451, 5293, 5958, 6475, 7029, 7259, 7662, 7825, 8014, 8525, 9144, 9577, 10485, 10926, 11356, 11466, 12215, 12752, 13063]","[100, 310, 400, 539, 773, 925, 1147, 1659, 2021, 2428, 2925, 3418, 3593, 3777, 4405, 4613, 4879, 4973, 5173, 5331, 5795, 6060, 6762, 7102, 7799, 8076, 8452, 9016, 9112, 9377]","[0, 210, 300, 390, 480, 619, 754, 987, 1125, 1415, 1939, 2279, 2436, 2669, 2928, 3229, 3600, 3694, 3852, 4112, 4270, 4535, 4952, 5047, 5210, 5449, 5591, 6187, 6283, 6975]",21722,13689,13063,9377,6975,-4485,857,186,-1448,1190,-3700,30,dire
7613494811,48,69,49,9,85,"[0, 296, 921, 1420, 1620, 1825, 2371, 2919, 3382, 3916, 4298, 4462, 4730, 5508, 5954, 6859, 7793, 9142, 10036, 11069, 11809, 12471, 12988, 13798, 14604, 15381, 15751, 16300, 17397, 17493]","[0, 297, 614, 905, 1236, 1516, 1797, 2279, 2576, 2816, 3664, 4263, 5050, 5771, 6064, 6509, 7474, 8080, 8884, 9645, 10386, 10744, 11497, 11969, 12567, 13035, 13498, 13996, 14583, 15065]","[0, 319, 637, 1071, 1467, 1754, 2221, 2594, 3193, 3663, 4402, 4610, 4948, 5469, 6089, 6475, 7193, 7834, 8314, 8885, 9337, 10034, 10580, 11389, 12198, 12579, 12674, 13428, 13879, 14355]","[0, 246, 353, 539, 728, 944, 1197, 1409, 1604, 1951, 2285, 2413, 2848, 3091, 3475, 3680, 4209, 4517, 4740, 4943, 5188, 5428, 5583, 5776, 5918, 6148, 6410, 6550, 6977, 7329]","[0, 210, 369, 504, 594, 734, 914, 1155, 1290, 1469, 1685, 1775, 1979, 2161, 2491, 2598, 2844, 2982, 3077, 3557, 3836, 4163, 4343, 4614, 4891, 5100, 5220, 5487, 5964, 6477]",17493,15065,14355,7329,6477,72,46,129,58,123,"[0, 238, 761, 1009, 1548, 1869, 2340, 2867, 3498, 3948, 4569, 5256, 5907, 6746, 7859, 8375, 9070, 10076, 11225, 11383, 12204, 13148, 13886, 14713, 15754, 16771, 17578, 18162, 19079, 19310]","[0, 130, 470, 693, 866, 1226, 1475, 1929, 2286, 2724, 3329, 3804, 4779, 5805, 6512, 7248, 8080, 8763, 9313, 9795, 10482, 10909, 11908, 12833, 13296, 14356, 15400, 16021, 17004, 17865]","[0, 207, 413, 700, 1151, 1514, 1853, 2217, 2625, 3168, 3616, 4310, 5066, 5823, 6420, 6835, 7359, 7881, 8738, 9425, 9951, 10620, 11229, 11610, 11989, 12718, 13464, 13960, 14714, 14999]","[0, 173, 346, 439, 641, 783, 873, 1008, 1422, 1557, 2026, 2424, 2981, 3544, 4064, 4266, 4870, 5057, 5319, 5507, 5910, 6106, 6417, 7162, 7571, 8066, 9516, 9850, 10465, 11341]","[0, 130, 292, 431, 567, 742, 902, 1216, 1387, 1605, 1722, 1964, 2276, 2901, 3081, 3569, 3802, 3896, 4264, 4805, 5260, 5597, 5782, 6392, 6757, 7280, 7938, 8297, 8906, 9426]",19310,17865,14999,11341,9426,-1817,-2800,-644,-4012,-2949,-12222,30,dire
7614970519,41,28,76,110,114,"[0, 232, 577, 802, 1302, 1542, 1860, 2382, 2978, 3511, 3962, 4411, 5012, 5451, 6060, 6475, 7274, 8061, 8828, 9607, 10102, 10724, 11058, 11667, 12410, 13036, 13551, 14026, 15144, 15824]","[0, 231, 518, 840, 1290, 1611, 1964, 2724, 3171, 3593, 4152, 4761, 5320, 5722, 6467, 6786, 7644, 8221, 8800, 8894, 9094, 9870, 10521, 10942, 11537, 11775, 12116, 12682, 13329, 13930]","[0, 305, 624, 950, 1341, 1669, 2087, 2624, 3155, 3704, 4073, 4693, 5335, 5888, 6567, 6750, 7072, 7699, 8170, 8662, 9225, 9771, 10523, 11166, 11709, 12401, 13206, 13300, 13894, 13990]","[100, 294, 419, 509, 685, 882, 1100, 1273, 1648, 1930, 2175, 2361, 2673, 2954, 3375, 3661, 4162, 4718, 5123, 5521, 5795, 5996, 6555, 6886, 7078, 7584, 7935, 8066, 8990, 9651]","[0, 194, 319, 409, 539, 704, 1042, 1310, 1445, 1604, 1694, 1844, 2034, 2183, 2278, 2651, 2951, 3182, 3412, 3697, 4155, 4250, 4918, 5386, 5481, 5648, 5918, 6260, 6527, 7413]",15824,13930,13990,9651,7413,95,13,96,105,103,"[0, 350, 670, 989, 1395, 1904, 2239, 2786, 3285, 3763, 4308, 4963, 5582, 5849, 6455, 7195, 8194, 9031, 9908, 10997, 11743, 12264, 13028, 13761, 14214, 15491, 16279, 17027, 17844, 18230]","[0, 301, 540, 839, 1175, 1492, 1793, 2057, 2426, 2792, 3309, 3837, 4355, 4709, 4976, 5739, 6447, 7241, 8053, 8446, 9164, 9928, 10451, 10804, 11249, 12022, 13042, 13915, 14566, 15796]","[0, 531, 849, 1223, 1739, 2141, 2510, 2795, 3309, 3600, 4184, 4602, 5006, 5396, 5538, 6008, 6615, 7205, 7808, 8615, 9365, 9509, 9859, 10332, 10427, 10736, 11246, 11759, 12329, 12841]","[0, 363, 453, 586, 716, 925, 1015, 1105, 1243, 1333, 1468, 1752, 2066, 2682, 3030, 3498, 3756, 4055, 4150, 4982, 5420, 5981, 6515, 7056, 7151, 7656, 8457, 8551, 8920, 9849]","[0, 194, 284, 374, 504, 765, 900, 990, 1208, 1582, 1717, 1861, 1972, 2067, 2266, 2577, 3095, 3596, 3812, 4730, 5024, 5119, 5343, 5437, 5532, 5794, 6503, 6631, 6937, 8602]",18230,15796,12841,9849,8602,-2406,-1866,1149,-198,-1189,-4510,30,radiant
7615326007,1,129,13,123,58,"[0, 169, 566, 925, 1324, 1488, 2098, 2477, 2768, 3158, 3708, 4276, 5660, 6128, 7011, 7489, 8662, 9648, 10843, 11804, 12872, 13840, 14958, 15697, 16087, 17218, 18413, 19484, 20793, 21196]","[0, 130, 414, 727, 973, 1550, 1724, 1853, 2314, 2537, 3168, 3728, 4467, 5161, 5829, 6375, 7243, 7935, 8281, 8710, 9425, 10095, 10606, 11271, 11944, 12220, 12841, 13318, 13882, 15331]","[0, 288, 606, 870, 1286, 1655, 2048, 2289, 2901, 3664, 4194, 4981, 5682, 6101, 6848, 7429, 7891, 8504, 8599, 9192, 9389, 9972, 10307, 10741, 10919, 11624, 12386, 13073, 13553, 13956]","[0, 130, 220, 310, 437, 835, 1046, 1181, 1518, 1608, 2276, 2572, 2990, 3248, 3562, 3844, 4399, 4752, 5182, 5590, 5770, 5926, 6093, 6339, 6633, 7226, 7912, 8267, 8554, 9296]","[0, 176, 266, 356, 800, 930, 1109, 1244, 1334, 1531, 1879, 2097, 2623, 2871, 3125, 3405, 3836, 4206, 4389, 4668, 4788, 4920, 5087, 5288, 5429, 5936, 6144, 6610, 7018, 7421]",21196,15331,13956,9296,7421,48,46,78,27,105,"[0, 282, 515, 894, 1194, 1485, 1949, 2321, 2904, 3256, 3596, 4273, 5047, 5771, 6526, 7687, 8559, 9467, 10605, 11668, 13091, 13814, 14852, 15610, 16100, 17120, 17849, 19020, 20383, 20928]","[0, 319, 664, 1076, 1356, 1743, 2262, 2683, 3261, 3812, 4324, 4980, 5070, 5392, 5996, 6548, 7429, 8113, 9291, 9779, 10577, 11019, 12193, 12821, 13136, 14023, 14322, 14506, 14752, 16321]","[0, 246, 451, 682, 1044, 1527, 1765, 1987, 2404, 2776, 3417, 3650, 3899, 4434, 4721, 5123, 5748, 6471, 7074, 7438, 8017, 8474, 8776, 9469, 9808, 10548, 10724, 10990, 11295, 12165]","[0, 210, 390, 496, 648, 738, 896, 1081, 1341, 1431, 1787, 2093, 2192, 2491, 2984, 3269, 4144, 4284, 5035, 5414, 6039, 6342, 6618, 6946, 7116, 7726, 8026, 8196, 8554, 9376]","[0, 210, 300, 428, 518, 608, 976, 1166, 1346, 1442, 1731, 1821, 2073, 2507, 2736, 3334, 3865, 4135, 4653, 4895, 5062, 5533, 5982, 6296, 6466, 7010, 7444, 7614, 8117, 8657]",20928,16321,12165,9376,8657,268,-990,1791,-80,-1236,-247,30,radiant
7615645410,13,18,23,58,5,"[0, 206, 569, 852, 1106, 1425, 1727, 2278, 2657, 3051, 3497, 4229, 5409, 6046, 6566, 7077, 7276, 8089, 9217, 9539, 10313, 11147, 11632, 11896, 11990, 13246, 13897, 14152, 14832, 15569]","[0, 254, 570, 1118, 1656, 2080, 2731, 3083, 3689, 4202, 4375, 4811, 5751, 6463, 7271, 7896, 8100, 8733, 9031, 9826, 10710, 11542, 11722, 12367, 13082, 14042, 14827, 15386, 15698, 15794]","[0, 217, 393, 834, 1522, 1777, 2258, 2777, 3140, 3652, 4283, 4913, 5394, 6208, 6590, 7036, 7867, 8183, 8967, 9542, 9693, 10183, 10664, 10990, 11507, 11864, 12572, 12942, 13249, 13558]","[0, 170, 260, 394, 582, 877, 1000, 1474, 1579, 1794, 1992, 2336, 2748, 3262, 3658, 3976, 4071, 4425, 4849, 5121, 5859, 6186, 6366, 6710, 7460, 7668, 8394, 8610, 8917, 9013]","[100, 270, 395, 546, 757, 896, 1094, 1229, 1419, 1554, 1753, 2090, 2734, 2918, 3383, 3776, 3918, 4061, 4364, 4604, 4766, 4977, 5232, 5327, 5802, 5997, 6328, 6617, 6713, 6809]",15569,15794,13558,9013,6809,82,55,19,62,40,"[0, 239, 533, 900, 1101, 1514, 1876, 2421, 2674, 3205, 3516, 4054, 4827, 5369, 6014, 6904, 7837, 9065, 10305, 11578, 12849, 13902, 15176, 15970, 16573, 17939, 19522, 20878, 22677, 24432]","[0, 206, 410, 534, 1247, 1516, 1758, 2923, 3352, 3975, 4541, 5237, 5683, 6058, 6796, 7397, 8412, 9055, 9734, 10065, 10584, 11190, 12143, 12699, 13360, 14030, 14355, 14525, 16139, 16813]","[0, 245, 540, 882, 1319, 1637, 2053, 2235, 2482, 2973, 3555, 4136, 4653, 5272, 5483, 6632, 7443, 7705, 7975, 8669, 9221, 9823, 10586, 11613, 11869, 12298, 13000, 13466, 13672, 14380]","[0, 170, 260, 350, 536, 684, 810, 1104, 1459, 1640, 1833, 2073, 3043, 3245, 3394, 3986, 4684, 4790, 5235, 5631, 6095, 6309, 7041, 7965, 8221, 8396, 8581, 9028, 10431, 10799]","[0, 170, 260, 350, 501, 595, 685, 889, 1101, 1279, 1552, 1895, 2190, 2432, 2984, 3211, 3857, 3976, 4583, 5045, 5363, 5577, 6963, 7290, 7815, 8158, 8456, 9205, 10177, 10772]",24432,16813,14380,10799,10772,-8863,-1019,-822,-1786,-3963,-16453,30,dire
7615652918,21,36,96,109,20,"[0, 311, 561, 899, 1271, 1836, 2173, 2581, 2994, 3661, 3934, 4426, 5011, 5745, 6546, 6716, 7188, 7447, 7877, 8727, 9308, 9790, 10458, 11517, 12174, 12431, 12780, 13121, 13217, 13606]","[0, 238, 509, 711, 1031, 1198, 1498, 1773, 2245, 2595, 2820, 3266, 3541, 4172, 4560, 5259, 5875, 6100, 6305, 7263, 7867, 8150, 8536, 9015, 10057, 10314, 11041, 11999, 12269, 13025]","[0, 266, 775, 1183, 1466, 1642, 2132, 2567, 2982, 3439, 3960, 4344, 4776, 5533, 6076, 6240, 6698, 7364, 7619, 8339, 8847, 9299, 9788, 10105, 10371, 11257, 11669, 12085, 12376, 12636]","[0, 195, 374, 464, 636, 742, 877, 1088, 1178, 1559, 1785, 2089, 2398, 2710, 3393, 3582, 4205, 4300, 4488, 5216, 5672, 6910, 7148, 7776, 8466, 9705, 10070, 10329, 10602, 10755]","[0, 195, 285, 375, 684, 774, 1031, 1263, 1353, 1653, 1834, 2008, 2279, 2572, 2815, 2928, 3309, 3455, 3745, 4143, 4699, 5083, 5297, 5699, 6040, 6664, 6924, 7510, 7774, 7941]",13606,13025,12636,10755,7941,52,93,71,123,121,"[0, 256, 457, 837, 1174, 1475, 2046, 2664, 3068, 3408, 3727, 4247, 4760, 5461, 6255, 6890, 7445, 7807, 8667, 9194, 9352, 10164, 11336, 12029, 12508, 12781, 13558, 14321, 15649, 16870]","[0, 208, 509, 634, 888, 1129, 1334, 1744, 2076, 2268, 2674, 3336, 3952, 4631, 5229, 5830, 6936, 7472, 8123, 8408, 9092, 9636, 10743, 11795, 12583, 13764, 14136, 15251, 15875, 17008]","[0, 170, 370, 549, 1105, 1710, 2035, 2651, 3141, 3775, 4359, 4980, 5537, 6096, 6667, 7590, 8098, 8779, 9121, 9493, 10145, 10806, 11453, 11548, 11931, 12831, 13583, 14361, 15278, 15745]","[0, 170, 260, 402, 882, 1347, 1482, 1972, 2252, 2644, 3387, 3987, 4167, 4538, 5171, 5626, 6364, 7167, 7479, 7708, 8270, 8880, 9548, 10089, 10674, 11112, 11296, 12513, 13116, 13475]","[100, 316, 406, 496, 586, 740, 920, 1175, 1265, 1355, 1525, 1895, 2075, 2331, 2479, 2804, 3166, 3339, 3496, 3591, 3749, 4048, 4419, 4739, 4879, 5299, 5769, 6158, 6597, 7122]",16870,17008,15745,13475,7122,-3264,-3983,-3109,-2720,819,-12257,30,dire
7615934413,98,106,78,121,26,"[0, 326, 636, 921, 1305, 1717, 1987, 2800, 2973, 3525, 4226, 4836, 5402, 6073, 6627, 7326, 7758, 8768, 9825, 10351, 10538, 11157, 12111, 13277, 14072, 14628, 15026, 15742, 17245, 17472]","[0, 605, 973, 1350, 1733, 1971, 2528, 2817, 3177, 3646, 4208, 4611, 5455, 6001, 6743, 7268, 8039, 8702, 9378, 9741, 10415, 11117, 11786, 12575, 13115, 13899, 14821, 15483, 16158, 16580]","[0, 170, 331, 649, 902, 1284, 1374, 1831, 2365, 2609, 3032, 3839, 4346, 5079, 5719, 6080, 6783, 7291, 7996, 8306, 9068, 9300, 10180, 10840, 10934, 11382, 11945, 12502, 13214, 13570]","[0, 338, 428, 567, 701, 791, 930, 1231, 1321, 1751, 2075, 2357, 2611, 2904, 3214, 3602, 3696, 4451, 4850, 5234, 5934, 6029, 6287, 6636, 6847, 7077, 7282, 7953, 8865, 9072]","[0, 435, 525, 615, 705, 892, 982, 1216, 1306, 1517, 1843, 2019, 2623, 2916, 3078, 3427, 3571, 4107, 4426, 4696, 4909, 5104, 5470, 5970, 6283, 6513, 6718, 7119, 7505, 7601]",17472,16580,13570,9072,7601,72,21,66,80,19,"[0, 208, 658, 991, 1363, 1575, 2085, 2482, 2874, 3480, 4016, 4456, 4645, 5094, 5522, 5953, 6308, 6970, 7065, 7454, 7757, 8682, 9322, 10121, 10483, 11133, 12098, 12961, 13547, 14004]","[0, 325, 684, 1138, 1473, 1774, 2165, 2865, 3447, 3666, 4095, 4615, 5013, 5613, 6174, 6611, 7431, 8193, 8766, 9081, 9686, 10887, 11338, 11644, 11914, 12495, 13159, 13488, 13889, 14589]","[0, 170, 290, 468, 639, 906, 1064, 1244, 1711, 1801, 1930, 2348, 2853, 3222, 3393, 3800, 4518, 4920, 5349, 5753, 6691, 7134, 7682, 8356, 8525, 9074, 9502, 10038, 10804, 11509]","[0, 170, 472, 670, 949, 1584, 2004, 2632, 3021, 3111, 3369, 3879, 4008, 4298, 4713, 4954, 5286, 5513, 6015, 6418, 6725, 7202, 7566, 7661, 7942, 8733, 9386, 10008, 10386, 10700]","[0, 170, 334, 424, 549, 750, 949, 1303, 1393, 1493, 1630, 1857, 1947, 2042, 2219, 2495, 2840, 3288, 3978, 4680, 4855, 5198, 5527, 6070, 6164, 6431, 6801, 7387, 7638, 7952]",14004,14589,11509,10700,7952,3468,1991,2061,-1628,-351,5541,30,radiant
7616110516,18,98,43,45,121,"[0, 243, 407, 691, 1032, 1601, 1939, 2318, 2754, 3093, 3792, 4561, 5461, 6448, 6961, 7939, 8765, 9795, 10125, 10939, 11522, 11850, 13667, 14298, 15456, 15788, 17228, 18208, 18850, 19511]","[0, 250, 491, 891, 1304, 1604, 1994, 2489, 2893, 3240, 3938, 4604, 5309, 5976, 6108, 6372, 6833, 7756, 8173, 8778, 9550, 9688, 9819, 10410, 11727, 12896, 13430, 13525, 13709, 14556]","[0, 213, 550, 809, 957, 1279, 1920, 2260, 2603, 2993, 3608, 4380, 4838, 5405, 5573, 5915, 6213, 6513, 7172, 7967, 8776, 9527, 9739, 10084, 11486, 12253, 12347, 12998, 13350, 14513]","[0, 182, 320, 410, 500, 653, 840, 1065, 1200, 1375, 2146, 2470, 2662, 3145, 3367, 3618, 3775, 3870, 4100, 4620, 4981, 5128, 5309, 5461, 5860, 6833, 7062, 7406, 7574, 8119]","[0, 130, 220, 310, 537, 642, 939, 1362, 1713, 2053, 2362, 2506, 2849, 3239, 3334, 3587, 3753, 4033, 4263, 4546, 4964, 5059, 5193, 5485, 6529, 6971, 7292, 7591, 7687, 8276]",19511,14556,14513,8119,8276,53,46,78,100,30,"[59, 375, 586, 988, 1279, 1515, 2429, 2748, 2966, 3363, 4057, 4460, 5049, 5869, 6843, 7252, 7777, 8276, 8942, 9811, 10769, 11923, 12473, 13293, 14393, 15202, 15974, 16527, 17353, 17721]","[59, 316, 740, 1204, 1416, 1685, 1894, 2261, 2648, 3103, 3600, 4106, 4352, 4599, 5676, 6452, 7243, 7982, 8757, 9636, 10579, 11544, 12692, 13268, 13892, 14468, 15279, 15845, 16530, 17035]","[59, 308, 591, 848, 1084, 1337, 1700, 2103, 2434, 2806, 3389, 3941, 4515, 5367, 6030, 6522, 6913, 7310, 7890, 8560, 9189, 9716, 10428, 11321, 11753, 11953, 12625, 13429, 14016, 14197]","[59, 269, 359, 497, 627, 761, 869, 1449, 1539, 1694, 2239, 2457, 2654, 2803, 3266, 3600, 3795, 4117, 4261, 4683, 5168, 5652, 6021, 6187, 6533, 6945, 7520, 7869, 8124, 8230]","[327, 537, 627, 786, 976, 1066, 1277, 1586, 1713, 1803, 1983, 2216, 2403, 2552, 3239, 3338, 3706, 3973, 4121, 4398, 5107, 5769, 6101, 6470, 6716, 7124, 7511, 7606, 7783, 8289]",17721,17035,14197,8230,8289,1790,-2479,316,-111,-13,-497,30,dire
7616158604,67,109,112,137,100,"[0, 89, 417, 674, 799, 923, 1262, 1721, 2110, 2348, 2808, 3231, 3947, 5218, 5821, 6194, 6803, 7885, 8546, 9097, 9913, 10878, 11811, 12281, 13352, 14279, 14600, 15596, 16734, 17869]","[0, 169, 259, 349, 439, 529, 709, 1282, 1514, 1719, 1985, 2187, 2879, 3312, 3765, 3970, 4466, 4759, 5480, 5877, 6423, 7039, 7628, 8013, 8713, 9632, 10486, 11264, 11633, 12373]","[0, 474, 716, 930, 1570, 1765, 1983, 2271, 2813, 3237, 3793, 4217, 4663, 4938, 5502, 5932, 6153, 7263, 7943, 8954, 9636, 10362, 10783, 11240, 11434, 11765, 12276, 12927, 13409, 14373]","[0, 240, 416, 747, 873, 1086, 1372, 1633, 2021, 2426, 2677, 3068, 3694, 4394, 4764, 5247, 6174, 6521, 6895, 7160, 7957, 8311, 8750, 9234, 10188, 10996, 11226, 11813, 12537, 13213]","[0, 169, 259, 349, 603, 693, 873, 1008, 1098, 1370, 1550, 1928, 2447, 2865, 3332, 3836, 4423, 4751, 5447, 5645, 6316, 6547, 6714, 6808, 7167, 7648, 7878, 8268, 8670, 9456]",17869,12373,14373,13213,9456,49,21,76,9,65,"[0, 409, 606, 885, 1336, 1708, 2234, 2738, 3127, 3900, 4563, 5118, 5327, 5568, 6546, 7139, 7555, 8157, 9017, 9832, 10184, 10502, 11254, 11833, 12558, 12725, 13420, 14308, 15063, 15159]","[0, 324, 748, 1121, 1462, 1787, 2253, 2766, 3055, 3572, 4013, 4517, 4657, 5290, 5631, 6075, 6336, 6803, 6898, 7055, 7749, 8468, 8964, 9058, 10164, 10446, 11170, 11817, 12553, 12649]","[0, 337, 703, 1049, 1503, 1802, 2263, 2718, 3530, 3850, 4288, 4687, 4962, 5111, 5445, 5809, 6102, 6596, 6709, 7254, 7540, 7759, 8651, 9019, 9718, 9885, 10852, 10983, 11443, 11700]","[0, 249, 339, 476, 706, 963, 1165, 1394, 1591, 1980, 2323, 2628, 2988, 3528, 3861, 4441, 4599, 4782, 4877, 5245, 5558, 5661, 6316, 6527, 6873, 7115, 7352, 7573, 7890, 8024]","[0, 249, 339, 429, 612, 826, 979, 1223, 1383, 1636, 1891, 2468, 2866, 3142, 3907, 4001, 4321, 4795, 5083, 5240, 5335, 5430, 6223, 6548, 6803, 6970, 7446, 7711, 8146, 8242]",15159,12649,11700,8024,8242,2710,-276,2673,5189,1214,11510,30,dire
7616192306,73,21,78,45,20,"[328, 692, 1121, 1323, 1699, 2528, 3005, 3825, 4499, 5641, 6409, 7047, 7998, 8624, 9124, 10364, 10933, 11869, 12734, 13841, 15187, 16129, 17386, 18547, 19661, 20514, 21921, 22288, 23509, 24660]","[58, 633, 874, 1296, 1707, 2069, 2784, 3392, 3938, 5024, 5314, 5933, 6735, 6830, 7830, 8342, 9121, 9873, 10602, 11101, 11690, 12160, 12409, 12959, 13256, 14149, 14581, 14965, 15630, 16452]","[58, 314, 601, 802, 1160, 1489, 2052, 2525, 3249, 3793, 4255, 4382, 4788, 5355, 6351, 6630, 7112, 7819, 8074, 8445, 9241, 9782, 10163, 10708, 11114, 11800, 12129, 12223, 12698, 13846]","[58, 415, 697, 787, 923, 1659, 1794, 2163, 2405, 2752, 3015, 3392, 3688, 4088, 4799, 5182, 5883, 6455, 6964, 7496, 8117, 8230, 8815, 9047, 9569, 9997, 10349, 10518, 10855, 11325]","[58, 576, 666, 756, 846, 1006, 1217, 1408, 1578, 1790, 1970, 2132, 2312, 2484, 2723, 2939, 3266, 3593, 3688, 3845, 4255, 4350, 4517, 4797, 4896, 5444, 5729, 5870, 6170, 6639]",24660,16452,13846,11325,6639,48,29,106,100,64,"[0, 205, 490, 990, 1245, 1796, 2038, 2200, 2362, 2730, 3206, 3856, 4472, 5115, 5878, 6562, 7009, 8071, 8804, 9534, 10477, 11911, 12817, 14087, 15175, 16251, 17167, 18025, 18865, 19953]","[0, 243, 509, 925, 1217, 1396, 1800, 2369, 3005, 3651, 4165, 4990, 5475, 5942, 6446, 6840, 7121, 7875, 8225, 9223, 10060, 10477, 11205, 12257, 12794, 13357, 13737, 14696, 15022, 15721]","[0, 473, 746, 1029, 1286, 1673, 1763, 2104, 2513, 2693, 3073, 3228, 3487, 3827, 4394, 4694, 4942, 5618, 5713, 6055, 6449, 6909, 7004, 8116, 8518, 8879, 9116, 10012, 10499, 11031]","[0, 254, 381, 755, 915, 1067, 1340, 2078, 2321, 2501, 2791, 3190, 3280, 3960, 4921, 5061, 5555, 5871, 5966, 6350, 6652, 7136, 7695, 8153, 8534, 9107, 9298, 10008, 10267, 10518]","[0, 254, 344, 676, 766, 1045, 1135, 1225, 1403, 1583, 1964, 2475, 2565, 2969, 3364, 3557, 3838, 4068, 4333, 4545, 4909, 5547, 5717, 6802, 6972, 7426, 7596, 8425, 8950, 9265]",19953,15721,11031,10518,9265,4707,731,2815,807,-2626,6434,30,dire
7616790114,96,120,95,53,112,"[328, 684, 948, 1434, 1784, 2529, 2854, 3421, 3909, 4721, 5260, 5697, 6176, 6415, 7147, 7807, 8144, 8676, 9167, 9724, 10371, 10998, 11649, 12702, 13736, 13903, 14099, 14672, 15119, 15825]","[60, 456, 743, 1186, 1680, 2084, 2887, 3488, 4028, 4313, 4962, 5527, 5862, 6338, 7001, 7561, 7910, 8167, 8878, 9734, 10066, 10549, 11516, 11854, 12187, 13097, 13674, 14427, 14766, 15353]","[60, 390, 641, 731, 949, 1287, 1614, 1886, 2240, 2711, 3082, 3331, 3894, 4537, 4984, 5565, 6501, 7202, 8032, 8325, 9310, 9964, 10779, 10874, 11502, 11669, 12283, 13766, 14379, 15016]","[60, 476, 610, 938, 1479, 1894, 2140, 2230, 2320, 2605, 3230, 3470, 4030, 4526, 5176, 5614, 6360, 6599, 7058, 7286, 8053, 9445, 9764, 10035, 10536, 10900, 11462, 12080, 12907, 14292]","[60, 294, 384, 782, 1025, 1391, 1481, 1644, 1781, 2066, 2330, 2464, 2746, 2937, 3208, 3580, 3738, 4173, 4419, 4514, 5254, 5681, 6143, 6238, 6628, 6875, 7132, 7621, 7792, 8561]",15825,15353,15016,14292,8561,46,17,23,123,5,"[0, 203, 490, 903, 1029, 1263, 1673, 2103, 2474, 3160, 3731, 4332, 5540, 6297, 7389, 8133, 9895, 10258, 10907, 11577, 12368, 13006, 13348, 14668, 15415, 16663, 17437, 17661, 18234, 18500]","[0, 462, 858, 1265, 1604, 2027, 2187, 2919, 3611, 4057, 4521, 4909, 5130, 5428, 6179, 6607, 7801, 8081, 8453, 9040, 9281, 9376, 9730, 11112, 12121, 12971, 13388, 14344, 15039, 15682]","[0, 334, 775, 1309, 1709, 2077, 2637, 3192, 4009, 4562, 4856, 5731, 6283, 6822, 7616, 8003, 8838, 9695, 10052, 10643, 11260, 11355, 11962, 13185, 13678, 14495, 15182, 15922, 16494, 17215]","[0, 348, 513, 684, 995, 1125, 1436, 1526, 1616, 1966, 2241, 2651, 2741, 3008, 3509, 3880, 4292, 4387, 4813, 5168, 5453, 5750, 5844, 7015, 7777, 8034, 8823, 9233, 9640, 9927]","[0, 564, 700, 837, 1013, 1225, 1417, 1622, 2161, 2546, 2699, 3248, 3603, 3886, 4260, 4457, 5157, 5252, 5438, 6044, 6253, 6423, 6592, 7593, 8136, 8468, 8785, 9329, 9769, 10137]",18500,15682,17215,9927,10137,-2675,-329,-2199,4365,-1576,-2414,30,dire
7616882903,1,76,98,27,5,"[0, 154, 410, 691, 937, 1295, 1587, 1911, 2153, 2394, 2683, 2864, 3453, 3968, 4566, 5152, 5786, 6482, 7211, 7829, 8687, 9379, 10584, 11139, 12308, 13359, 14047, 14908, 15932, 17122]","[0, 242, 528, 767, 1192, 1614, 2368, 2706, 3033, 3457, 4086, 4794, 5347, 6210, 6803, 7403, 7517, 8735, 9288, 9822, 10176, 10698, 11571, 12482, 13211, 14251, 14654, 15848, 16639, 17216]","[0, 239, 488, 791, 1084, 1610, 1874, 2211, 2417, 2772, 3411, 3858, 4739, 5255, 5883, 6382, 7026, 7950, 8710, 9620, 10237, 10518, 11143, 12134, 12682, 13344, 13667, 14097, 14803, 15442]","[0, 154, 244, 488, 717, 936, 1219, 1309, 1399, 1571, 1937, 2152, 2638, 3255, 3404, 4146, 4241, 4579, 4935, 5191, 5831, 6097, 6516, 6738, 6956, 7126, 7421, 8081, 8660, 8995]","[0, 154, 244, 462, 721, 894, 1065, 1155, 1370, 1732, 2004, 2149, 2547, 2977, 3178, 3549, 3644, 3998, 4237, 4615, 4886, 5542, 5847, 5942, 6037, 6344, 6528, 6729, 7016, 7328]",17122,17216,15442,8995,7328,72,21,129,85,105,"[0, 258, 610, 898, 1311, 1609, 1900, 2345, 2815, 3242, 3845, 4292, 5114, 5618, 6186, 6983, 7752, 8923, 9612, 10945, 11618, 12258, 13317, 13996, 14845, 16129, 17449, 17894, 19017, 20230]","[0, 378, 629, 927, 1309, 1641, 2065, 2561, 3017, 3311, 3955, 4374, 4802, 5429, 6049, 6740, 7423, 7811, 8604, 9326, 10050, 10652, 10998, 11301, 12234, 13045, 13964, 14648, 15515, 15940]","[0, 290, 722, 1037, 1357, 1765, 2140, 2602, 3142, 3754, 4211, 4969, 5462, 5751, 6228, 6501, 7326, 7747, 8411, 8982, 9129, 9827, 10597, 11167, 12025, 12769, 13298, 13785, 14654, 15383]","[0, 209, 299, 409, 545, 669, 844, 1070, 1202, 1375, 1533, 1715, 2156, 2399, 2598, 2979, 3521, 3763, 4187, 4517, 4687, 4947, 5371, 5702, 6051, 6621, 7150, 7449, 7946, 8271]","[0, 209, 636, 726, 845, 1005, 1095, 1350, 1575, 1710, 1845, 2288, 2819, 2914, 3141, 3455, 3724, 3857, 4125, 4551, 4646, 4958, 5323, 5418, 5929, 6299, 6928, 7164, 7586, 7792]",20230,15940,15383,8271,7792,-3108,1276,59,724,-464,-1513,30,dire
7617757908,46,25,78,86,30,"[0, 290, 593, 959, 1163, 1525, 1893, 2340, 2739, 3183, 3728, 4538, 5363, 6057, 6566, 7311, 8308, 9363, 10065, 10891, 12089, 12874, 13930, 15572, 16961, 17687, 18850, 20223, 21432, 21769]","[0, 252, 536, 951, 1247, 1631, 2056, 2559, 3173, 3879, 4266, 4894, 5427, 5672, 6409, 7109, 8526, 9564, 10250, 10741, 11212, 11693, 12054, 13397, 14532, 15371, 15600, 16190, 16780, 17150]","[0, 282, 596, 925, 1356, 1644, 2174, 2580, 3032, 3344, 3633, 4094, 4676, 5468, 5842, 5936, 6502, 7069, 7544, 8040, 8819, 9653, 10792, 11627, 12140, 12847, 13348, 13805, 14302, 15215]","[0, 221, 413, 592, 777, 907, 1092, 1227, 1349, 1488, 1748, 2033, 2288, 2631, 2893, 3296, 4029, 4604, 4966, 5732, 6023, 6424, 6954, 7764, 8761, 9705, 10018, 10476, 11195, 11476]","[0, 169, 259, 397, 524, 654, 926, 1164, 1273, 1381, 1627, 1855, 1981, 2379, 3250, 3362, 3770, 4337, 4476, 4633, 5137, 5703, 5870, 6757, 7078, 7617, 8005, 8772, 9371, 10068]",21769,17150,15215,11476,10068,48,49,39,123,84,"[0, 205, 638, 962, 1415, 1730, 2048, 2417, 2929, 3402, 3910, 4447, 5226, 6004, 6792, 7632, 8406, 9356, 10105, 11007, 11767, 12407, 14250, 15213, 15308, 16432, 17408, 18898, 18994, 19761]","[0, 242, 405, 665, 964, 1441, 1881, 2137, 2491, 2816, 3379, 4170, 4920, 5631, 6341, 7081, 7973, 8164, 9071, 10222, 10951, 11759, 12449, 13009, 13286, 14275, 14598, 15696, 16819, 17297]","[0, 254, 450, 755, 1016, 1189, 1440, 1979, 2231, 3063, 3274, 4217, 4702, 5427, 5954, 6333, 6893, 7435, 7946, 8862, 9560, 10373, 10677, 11491, 11718, 12962, 13886, 14576, 15517, 16326]","[0, 215, 389, 479, 730, 1234, 1679, 1815, 2005, 2144, 2555, 3098, 3296, 3910, 4311, 4439, 4879, 5570, 5873, 6335, 6948, 7767, 7980, 9446, 9709, 9898, 9992, 10703, 11281, 11913]","[0, 169, 259, 349, 547, 682, 772, 862, 1023, 1158, 1305, 1545, 1745, 1948, 2227, 2321, 2551, 2646, 2755, 2912, 3007, 3668, 3811, 4162, 4257, 4548, 4642, 5448, 6368, 6926]",19761,17297,16326,11913,6926,2008,-147,-1111,-437,3142,3455,30,radiant
7617881416,126,95,96,121,101,"[332, 724, 1039, 1237, 1535, 1950, 2400, 2867, 3484, 4080, 4375, 5047, 5646, 6121, 6297, 6726, 7487, 7990, 8583, 9600, 10491, 10857, 11852, 12610, 13172, 13773, 14158, 14253, 14560, 15627]","[64, 310, 568, 1017, 1262, 1511, 1855, 2066, 2345, 2542, 2984, 3974, 4327, 4828, 5279, 5905, 7152, 7523, 8241, 9151, 9523, 9980, 10356, 11898, 12813, 13389, 14098, 14193, 14594, 15296]","[64, 351, 677, 996, 1327, 1867, 2260, 2606, 2942, 3492, 3966, 4329, 4959, 5157, 5696, 6076, 7398, 8034, 8355, 8797, 9344, 10590, 11145, 12100, 12974, 13249, 14041, 14584, 14962, 15733]","[64, 325, 415, 572, 708, 831, 1054, 1144, 1500, 1696, 1838, 2299, 2532, 2800, 3115, 3292, 4064, 4222, 4426, 4584, 5159, 5525, 5778, 6523, 6798, 6892, 7285, 7380, 7476, 7902]","[64, 274, 364, 490, 629, 882, 1105, 1321, 1549, 1729, 1864, 2228, 2597, 2795, 2889, 2984, 3590, 3784, 3934, 4433, 4740, 5106, 6111, 6503, 6778, 7068, 7819, 7914, 8010, 8632]",15627,15296,15733,7902,8632,70,53,135,104,123,"[0, 216, 559, 845, 1125, 1475, 1727, 2198, 2613, 2900, 3541, 4321, 4546, 6171, 6788, 7520, 7809, 8319, 8856, 9762, 10591, 11243, 11645, 12226, 12634, 13262, 14528, 15770, 16487, 17210]","[0, 130, 220, 606, 776, 1176, 1704, 1908, 2074, 2723, 2878, 3358, 3675, 4178, 4688, 5035, 5388, 6210, 6801, 7124, 7505, 8046, 8448, 8877, 9112, 9724, 10626, 11822, 12604, 13251]","[0, 206, 447, 741, 1028, 1451, 1762, 2059, 2268, 2449, 2754, 3280, 3503, 4222, 4616, 4933, 5210, 5780, 6497, 6941, 7343, 7695, 8334, 8748, 9163, 9919, 10095, 11240, 11951, 12183]","[0, 239, 592, 867, 1124, 1564, 1777, 1907, 2457, 2699, 3113, 3642, 4141, 4891, 5177, 5528, 6081, 6904, 7124, 7514, 8083, 8640, 9201, 9561, 9910, 10293, 10621, 11329, 11891, 11987]","[0, 130, 220, 418, 611, 845, 1511, 1678, 1768, 1996, 2387, 2720, 2893, 3554, 3875, 4215, 4922, 5414, 5775, 6151, 6710, 7037, 7341, 8021, 8762, 9111, 9945, 10769, 11194, 11617]",17210,13251,12183,11987,11617,-1583,2045,3550,-4085,-2985,-3058,30,dire
7618039602,52,61,2,105,121,"[94, 351, 728, 1076, 1581, 2025, 2829, 3427, 4202, 4500, 5442, 6184, 7126, 7971, 8421, 9058, 10013, 10622, 11361, 12277, 13040, 13856, 14423, 16119, 17028, 18072, 19012, 19589, 20580, 21353]","[0, 273, 558, 921, 1159, 1490, 1716, 2066, 2259, 2768, 3155, 3679, 4129, 4848, 5356, 6252, 6862, 7577, 8072, 9021, 9765, 10103, 10769, 11550, 12321, 13323, 13883, 14837, 15975, 16874]","[0, 219, 774, 1179, 1637, 2333, 2915, 3159, 3810, 4395, 5320, 5911, 6283, 7734, 8238, 8963, 10008, 10711, 11267, 11754, 12422, 13057, 13302, 13457, 13552, 14089, 14351, 14932, 15677, 15991]","[245, 414, 577, 697, 858, 1119, 1254, 1817, 2330, 2420, 3002, 3142, 3353, 3943, 4171, 4514, 4867, 5007, 5447, 5868, 6759, 7126, 7577, 7805, 7900, 8666, 8916, 9011, 9793, 10109]","[79, 263, 387, 523, 613, 703, 889, 1076, 1537, 1627, 2341, 2538, 2798, 3548, 3693, 3900, 4187, 4506, 4600, 5050, 5494, 5971, 6137, 6396, 6491, 7244, 7448, 7543, 7845, 8171]",21353,16874,15991,10109,8171,89,33,38,19,5,"[61, 269, 637, 991, 1364, 1716, 1999, 2226, 2956, 3354, 3657, 4046, 4716, 5331, 5900, 6510, 7429, 7996, 9112, 9818, 10615, 11382, 12821, 13669, 14460, 15319, 15930, 16866, 17376, 18124]","[61, 302, 668, 1155, 1596, 2200, 2877, 3266, 4181, 4646, 5352, 5714, 6103, 6373, 6574, 7246, 7589, 8062, 8622, 9134, 9898, 10475, 11007, 11571, 12302, 12936, 13619, 14091, 14327, 14484]","[329, 571, 868, 1343, 1675, 2156, 2449, 2733, 3040, 3541, 3933, 4133, 4740, 5248, 5479, 5938, 6376, 6821, 7202, 7559, 7843, 8270, 9051, 9436, 9818, 10148, 10597, 11029, 11274, 11519]","[61, 230, 350, 566, 727, 967, 1150, 1662, 1921, 2011, 2236, 2326, 2492, 2645, 3044, 3430, 4059, 4523, 4620, 4715, 4999, 5300, 5983, 6317, 7279, 7787, 8426, 8864, 8960, 9056]","[61, 230, 384, 504, 643, 808, 1065, 1638, 1863, 1953, 2178, 2268, 2440, 2643, 2891, 3031, 3189, 3284, 3574, 3669, 3953, 4230, 4707, 4802, 5007, 5356, 5540, 5635, 6026, 6122]",18124,14484,11519,9056,6122,3229,2390,4472,1053,2049,13193,30,radiant
7618139706,60,18,129,86,128,"[0, 291, 563, 835, 1521, 1768, 2083, 2648, 3278, 3657, 4338, 5120, 5507, 6074, 6592, 6984, 7426, 8337, 8934, 9464, 9847, 10224, 10727, 11560, 12149, 12423, 12737, 13554, 14930, 15999]","[0, 328, 642, 1083, 1505, 1713, 1997, 2524, 2888, 3192, 3585, 4132, 4660, 5644, 6359, 6835, 7858, 8961, 9056, 10060, 10676, 11126, 11527, 12450, 13252, 13865, 14495, 14937, 15381, 16104]","[0, 331, 579, 932, 1264, 1505, 1934, 2059, 2383, 2711, 3329, 3885, 4518, 5259, 5953, 6234, 6690, 7087, 7182, 7757, 8051, 8607, 8803, 9219, 9936, 10669, 10764, 10985, 11512, 12067]","[0, 209, 299, 471, 645, 735, 825, 950, 1254, 1415, 1958, 2716, 3196, 3452, 4180, 4275, 4576, 5427, 5522, 5943, 6037, 6628, 7088, 7291, 7781, 8459, 8804, 9318, 10286, 10688]","[0, 209, 299, 389, 957, 1047, 1137, 1434, 1610, 1752, 2210, 2719, 3199, 3690, 4040, 4328, 4444, 4931, 5300, 5816, 6399, 6713, 6924, 7116, 7608, 7775, 7906, 8127, 8708, 9503]",15999,16104,12067,10688,9503,73,10,120,105,121,"[0, 207, 335, 860, 1074, 1807, 2242, 2789, 3662, 4066, 4688, 5277, 5552, 6101, 6978, 8029, 9135, 10423, 11002, 11223, 12397, 12983, 14789, 15512, 16303, 17209, 17602, 19042, 19462, 19743]","[0, 129, 360, 768, 1019, 1454, 1778, 2138, 2497, 2876, 3167, 3822, 4219, 4906, 5471, 6067, 6688, 6998, 7650, 8205, 8588, 8956, 10599, 11419, 12381, 13465, 14444, 16485, 17212, 18182]","[0, 248, 528, 911, 1274, 1716, 2077, 2502, 3042, 3510, 4211, 4996, 5543, 5803, 6344, 7170, 7979, 8074, 8872, 9591, 10511, 11021, 11764, 12243, 12770, 13658, 14684, 15802, 16561, 17107]","[0, 129, 219, 433, 570, 832, 967, 1327, 1683, 1821, 2183, 2498, 2694, 2870, 3063, 3428, 3668, 4078, 4525, 4955, 5228, 5591, 5925, 6331, 6607, 7191, 7502, 8051, 9080, 9660]","[0, 129, 263, 353, 443, 619, 805, 1016, 1326, 1416, 1593, 1683, 1918, 2218, 2365, 2650, 2870, 3214, 3796, 4178, 4468, 4773, 5191, 5492, 5697, 5998, 6290, 6619, 7086, 7351]",19743,18182,17107,9660,7351,-3744,-2078,-5040,1028,2152,-7682,30,dire
7618205704,82,2,106,65,83,"[0, 245, 526, 938, 1312, 1969, 2414, 2983, 3500, 3999, 4426, 4853, 5620, 6194, 6934, 8324, 9183, 10243, 10978, 12245, 13409, 14420, 14708, 16223, 16902, 18238, 19508, 20526, 21721, 22283]","[0, 279, 479, 805, 1366, 1810, 2268, 2561, 2701, 3017, 3723, 4271, 5250, 5734, 6230, 7335, 7798, 8545, 9412, 9851, 10801, 11771, 12507, 13610, 14414, 15745, 16600, 17002, 18005, 18634]","[0, 309, 590, 835, 1081, 1340, 1856, 1990, 2403, 2575, 2965, 3327, 3554, 4144, 4711, 5414, 6094, 6725, 7446, 7955, 8626, 8951, 9290, 10095, 10756, 11342, 12409, 12993, 13781, 14523]","[0, 195, 285, 422, 638, 768, 997, 1087, 1465, 1637, 2206, 2431, 2788, 3038, 3319, 4089, 5210, 5694, 6020, 6589, 7154, 7392, 7869, 8151, 8660, 9246, 10115, 10553, 11417, 12567]","[0, 195, 285, 375, 584, 852, 1153, 1291, 1508, 1731, 1866, 2152, 2242, 2584, 2801, 3435, 3781, 4216, 4365, 4676, 5010, 5214, 5381, 5698, 6120, 6580, 7236, 7566, 8111, 8605]",22283,18634,14523,12567,8605,10,23,114,88,5,"[0, 240, 482, 778, 1319, 1744, 2304, 2791, 3261, 3821, 4451, 5248, 5914, 6499, 7124, 7501, 8304, 8818, 9324, 9781, 10237, 10822, 12454, 13288, 14235, 14774, 15705, 16199, 16732, 18477]","[0, 216, 613, 1236, 1921, 2193, 2561, 2782, 3317, 3850, 4214, 4882, 5393, 6129, 6756, 7272, 7603, 7749, 8114, 8839, 8978, 9240, 10114, 10439, 11052, 11254, 11545, 11754, 12022, 12433]","[0, 326, 688, 1072, 1451, 1864, 2200, 2826, 3113, 3897, 4424, 5132, 5515, 5766, 6068, 6481, 6923, 7365, 7663, 8207, 8610, 9104, 9638, 10255, 10854, 11092, 11451, 11638, 11768, 13302]","[0, 170, 260, 500, 724, 814, 940, 1174, 1591, 1726, 2427, 2820, 3353, 3764, 3970, 4065, 4582, 4819, 5374, 5558, 5904, 6159, 6931, 7213, 7383, 7624, 7794, 7964, 8135, 9460]","[0, 170, 260, 386, 476, 648, 738, 873, 1208, 1478, 1698, 2032, 2174, 2479, 2938, 3148, 3429, 3523, 3749, 3936, 4031, 4163, 5132, 5227, 5322, 5488, 5632, 5839, 5980, 6452]",18477,12433,13302,9460,6452,3806,6201,1221,3107,2153,16488,30,radiant
7618629204,89,22,69,21,20,"[0, 164, 366, 612, 931, 1257, 1920, 2163, 2668, 3053, 3546, 4299, 4789, 5903, 6444, 7416, 8424, 9543, 9981, 10245, 10907, 11002, 12340, 13177, 14170, 14540, 16401, 17012, 17108, 17909]","[0, 172, 430, 804, 1239, 1603, 1893, 2354, 2741, 3581, 4482, 4731, 5593, 6527, 7112, 7296, 7768, 8291, 9167, 9901, 10432, 11955, 12600, 13121, 13477, 13958, 14718, 15614, 16100, 16622]","[0, 207, 634, 976, 1269, 1551, 1980, 2405, 2935, 3377, 4184, 4753, 5490, 6460, 7077, 7716, 8158, 9045, 9672, 10215, 10880, 11801, 12658, 13022, 13277, 13765, 14783, 15141, 15794, 16255]","[0, 131, 611, 970, 1100, 1288, 1391, 1525, 1797, 2062, 2568, 2804, 3056, 3458, 3859, 4152, 4432, 4874, 5415, 5869, 6138, 7271, 7510, 7797, 7963, 8460, 9102, 9768, 10038, 10677]","[0, 129, 219, 358, 523, 699, 1020, 1110, 1307, 1555, 2287, 2658, 2910, 3519, 3800, 4121, 4266, 4657, 5836, 5994, 6269, 7053, 7316, 7776, 7945, 8127, 8873, 9048, 9144, 9540]",17909,16622,16255,10677,9540,114,19,53,109,79,"[0, 245, 531, 891, 1256, 1589, 2034, 2566, 2873, 3426, 3613, 3853, 4148, 4632, 5117, 6260, 7002, 8003, 8543, 9600, 10422, 10517, 11436, 12486, 12960, 13898, 14623, 15227, 15986, 16960]","[0, 291, 500, 918, 1300, 1589, 2041, 2627, 3233, 3586, 4186, 4617, 4830, 5561, 6150, 6739, 7502, 8856, 9365, 9612, 10667, 10927, 11140, 11724, 12411, 12827, 13401, 14020, 14703, 14978]","[0, 209, 299, 466, 604, 773, 942, 1117, 1303, 1552, 1853, 2474, 2989, 3873, 4145, 5070, 5334, 6040, 6363, 6720, 7668, 8250, 8657, 9241, 9759, 10527, 10870, 11406, 11949, 12290]","[2, 299, 595, 1090, 1487, 1863, 2253, 2636, 3047, 3484, 3715, 4054, 4506, 5138, 5252, 6367, 6831, 7828, 8210, 8551, 9059, 9275, 9825, 10388, 10609, 11574, 12091, 12408, 12806, 13017]","[0, 209, 299, 401, 491, 627, 746, 1155, 1474, 1993, 2555, 2768, 2906, 3347, 3442, 3814, 4174, 4760, 4855, 5191, 6099, 6397, 6648, 6969, 7064, 7159, 7583, 7874, 8180, 8276]",16960,14978,12290,13017,8276,949,1644,3965,-2340,1264,5482,30,dire
7618832016,48,23,112,58,20,"[0, 165, 326, 706, 1056, 1292, 1614, 1909, 2463, 2813, 3162, 3881, 4425, 5170, 5936, 6457, 6936, 7661, 8390, 8778, 9947, 10972, 12118, 12975, 13466, 13926, 14682, 15407, 15503, 16364]","[0, 217, 461, 844, 1387, 2052, 2301, 2852, 3239, 3952, 4532, 5065, 5741, 6262, 6895, 7604, 7827, 8231, 9009, 10125, 11407, 12229, 12324, 12714, 13158, 13781, 13978, 14872, 15138, 15330]","[0, 218, 624, 991, 1248, 1460, 1899, 2189, 2603, 3177, 3621, 4352, 4940, 5462, 6162, 6468, 6810, 7175, 8000, 8237, 8440, 9387, 9899, 10864, 11094, 12018, 12215, 13365, 13629, 13992]","[0, 130, 224, 314, 496, 813, 920, 1700, 1966, 2440, 3028, 3763, 4235, 4462, 4809, 4967, 5218, 5376, 5902, 6245, 7265, 7652, 7985, 8874, 9347, 10112, 10419, 10805, 11552, 12079]","[0, 182, 272, 631, 838, 928, 1073, 1163, 1338, 1602, 1858, 2280, 2539, 2812, 3265, 3434, 3618, 3900, 4153, 4760, 5382, 5987, 6354, 6587, 6967, 7507, 7704, 8300, 8396, 8492]",16364,15330,13992,12079,8492,78,22,70,123,84,"[330, 576, 945, 1070, 1673, 1965, 2325, 2719, 3184, 3683, 4224, 4353, 4736, 5355, 5740, 6798, 7973, 9255, 9936, 10465, 10729, 11047, 11836, 12528, 13366, 13857, 14080, 15593, 16766, 17301]","[0, 333, 706, 1034, 1361, 1696, 2026, 2369, 2732, 2892, 3428, 3698, 4497, 4856, 5176, 5810, 7062, 7684, 8183, 8975, 9477, 9963, 11259, 11712, 12452, 12934, 13325, 15113, 15713, 16136]","[62, 361, 570, 875, 1103, 1481, 1961, 2458, 2728, 3128, 3663, 4137, 5011, 5405, 6200, 6687, 7483, 8210, 9123, 9943, 10083, 10605, 11552, 12301, 12714, 13044, 13175, 13429, 14694, 15467]","[62, 322, 412, 502, 715, 845, 983, 1163, 1616, 1706, 2082, 2172, 2573, 2833, 2982, 3325, 4257, 4653, 4942, 5533, 5848, 6137, 6669, 7195, 7485, 7799, 7894, 8810, 9601, 10381]","[62, 272, 381, 515, 653, 788, 1192, 1372, 1609, 1750, 2367, 2457, 2586, 2754, 3019, 3674, 4396, 4872, 5287, 5625, 5765, 6020, 6722, 6947, 7042, 7690, 8337, 9822, 10493, 10833]",17301,16136,15467,10381,10833,-937,-806,-1475,1698,-2341,-3861,30,radiant
7618866208,113,12,29,31,75,"[0, 295, 619, 1077, 1489, 1842, 2218, 2342, 2592, 3700, 4115, 4997, 5179, 6105, 6712, 7537, 8350, 9341, 9751, 10982, 11292, 12071, 13242, 13650, 14888, 16529, 17797, 18550, 18646, 19458]","[0, 248, 485, 771, 1020, 1345, 1668, 1914, 2243, 2645, 2991, 3225, 3716, 4211, 4999, 5358, 5849, 6389, 6795, 7625, 8012, 8889, 9559, 9967, 10616, 11154, 12053, 12429, 13289, 14802]","[0, 246, 526, 852, 1208, 1532, 1936, 2290, 2538, 3005, 3516, 3808, 4003, 4430, 5181, 5276, 5896, 6628, 6965, 7536, 7914, 8129, 9142, 10424, 10948, 12058, 12849, 13415, 13714, 14278]","[0, 210, 330, 420, 628, 763, 898, 988, 1209, 1389, 1498, 1732, 1822, 2310, 3238, 3486, 3852, 3946, 4157, 4315, 4446, 4540, 4883, 5780, 5993, 6216, 6575, 6709, 6805, 7505]","[0, 210, 330, 466, 591, 725, 815, 953, 1062, 1262, 1690, 1924, 2014, 2634, 3131, 3434, 3964, 4261, 4444, 4772, 4867, 4961, 5372, 5467, 5689, 6046, 6422, 6614, 6710, 6954]",19458,14802,14278,7505,6954,28,95,114,7,79,"[51, 219, 498, 806, 1024, 1396, 1813, 2082, 2592, 2858, 3172, 4119, 4624, 4773, 5601, 6105, 6563, 7098, 7821, 8300, 10206, 10896, 11527, 11884, 12833, 13502, 14142, 15992, 16703, 17167]","[319, 501, 819, 1018, 1262, 1509, 1637, 1880, 2204, 2332, 2550, 2928, 3202, 3502, 4133, 4629, 4938, 5417, 5745, 6457, 6981, 7714, 8402, 9085, 9524, 9944, 10539, 11096, 12037, 12740]","[51, 219, 466, 608, 865, 1107, 1339, 1624, 2277, 2804, 2983, 3391, 4072, 4426, 4914, 5274, 5462, 5556, 5973, 6583, 7268, 7539, 8063, 8654, 8955, 9049, 9755, 10185, 10726, 11083]","[51, 181, 271, 361, 451, 632, 810, 970, 1153, 1253, 1425, 2219, 2647, 2869, 3357, 3452, 3659, 4079, 4302, 4697, 5133, 5227, 5439, 6161, 6401, 6942, 7118, 7441, 7810, 7987]","[51, 181, 271, 361, 495, 669, 796, 931, 1100, 1226, 1316, 1568, 1997, 2146, 2580, 2818, 2913, 3226, 3455, 3703, 4300, 4394, 4671, 5175, 5454, 6104, 6326, 6421, 6790, 7252]",17167,12740,11083,7987,7252,2291,2062,3195,-482,-298,6768,30,radiant
7618873617,113,93,29,105,45,"[0, 571, 901, 1119, 1497, 1784, 2209, 2717, 3242, 3772, 4147, 4999, 5661, 6400, 6610, 7664, 8688, 9241, 9858, 11684, 12162, 13596, 14347, 15565, 16420, 16785, 17546, 17640, 19132, 19561]","[0, 200, 506, 694, 818, 1076, 1346, 1749, 1981, 2121, 2211, 2551, 3206, 4010, 4502, 4868, 5389, 5911, 6275, 8327, 8761, 9678, 10187, 10769, 10863, 10958, 11655, 11803, 12287, 12441]","[0, 168, 439, 600, 889, 1367, 1713, 2118, 2448, 2699, 3123, 3629, 4260, 4631, 5269, 5544, 5955, 6448, 6844, 7979, 8675, 9381, 10097, 10497, 10591, 10686, 11138, 11232, 12147, 12572]","[0, 129, 219, 548, 674, 848, 1223, 1722, 1818, 1908, 2305, 2523, 2667, 3471, 3691, 3966, 4060, 4306, 4401, 5510, 5961, 6950, 7297, 7777, 7903, 7998, 8458, 8552, 9269, 10116]","[0, 129, 219, 309, 448, 624, 750, 840, 974, 1184, 1323, 1688, 1891, 2079, 2631, 2726, 3093, 3293, 3433, 3528, 3665, 3832, 4174, 4403, 4497, 4592, 5170, 5264, 5887, 6252]",19561,12441,12572,10116,6252,46,137,98,53,86,"[0, 248, 493, 805, 1125, 1469, 1879, 2433, 3208, 3582, 3982, 4904, 5254, 6023, 6616, 8177, 8868, 9564, 10237, 11030, 11280, 12028, 12920, 13630, 14813, 15857, 17594, 18824, 20190, 20980]","[0, 243, 766, 1021, 1308, 1691, 2222, 2892, 3656, 4086, 4636, 5557, 6231, 6792, 7804, 8787, 9016, 9619, 10399, 11390, 11624, 12179, 12895, 13377, 14082, 14560, 16511, 17763, 18250, 19232]","[0, 248, 446, 888, 1377, 1929, 2374, 2755, 3451, 4144, 4659, 5129, 5351, 5530, 5625, 6541, 6770, 7124, 7597, 8165, 8679, 8954, 9438, 9894, 10273, 11153, 11806, 12775, 13409, 13673]","[0, 261, 467, 557, 647, 862, 1155, 1527, 2081, 2270, 2807, 3024, 3669, 3848, 4227, 4829, 5358, 5745, 6013, 6702, 6831, 7092, 7331, 7534, 8036, 8430, 9420, 10616, 11568, 12118]","[0, 209, 336, 679, 878, 1093, 1183, 1488, 1696, 1877, 2057, 2560, 2786, 2965, 3415, 3769, 4257, 4717, 5218, 6153, 6624, 7157, 7597, 8081, 8883, 9891, 10093, 11163, 11816, 12143]",20980,19232,13673,12118,12143,-1419,-6791,-1101,-2002,-5891,-17204,30,dire
7619033614,6,14,49,79,121,"[0, 165, 530, 774, 1199, 1488, 2014, 2299, 2432, 3142, 3730, 4212, 4533, 4909, 5140, 5401, 6199, 6761, 7346, 8174, 9000, 10096, 11625, 12377, 12944, 13655, 14195, 14330, 14466, 14941]","[0, 251, 531, 672, 926, 1168, 1842, 1969, 2059, 2709, 2989, 3396, 3790, 4190, 4304, 4530, 5023, 5118, 5792, 6239, 6983, 7528, 7952, 8272, 8834, 9096, 9190, 9285, 9381, 9793]","[0, 167, 363, 492, 733, 1052, 1417, 1604, 1830, 2125, 2476, 2774, 3049, 3285, 3590, 4035, 4576, 4671, 5116, 5315, 5899, 6688, 6816, 7013, 7375, 7714, 7987, 8082, 8231, 8673]","[0, 129, 219, 357, 496, 630, 1022, 1112, 1202, 2191, 2416, 2786, 2991, 3190, 3284, 3745, 4561, 4656, 4957, 5264, 5546, 6116, 6961, 7247, 7342, 7437, 7531, 7660, 7756, 8023]","[0, 129, 219, 353, 443, 579, 836, 984, 1121, 1211, 1628, 1764, 2056, 2255, 2403, 2674, 3111, 3206, 3541, 3848, 4158, 4924, 5463, 5558, 5700, 5795, 5889, 6123, 6219, 6315]",14941,9793,8673,8023,6315,46,126,43,128,20,"[0, 331, 856, 1195, 1694, 2025, 2388, 2851, 3648, 4121, 4795, 5219, 5489, 6288, 7003, 7578, 8107, 9096, 9852, 10469, 11113, 11991, 12498, 13230, 14073, 14849, 16308, 17437, 19378, 20283]","[0, 319, 601, 1002, 1374, 1826, 2200, 3159, 3634, 4082, 4327, 4885, 5457, 6001, 6953, 7725, 8513, 9393, 9972, 10798, 10893, 12022, 12755, 13260, 13646, 14587, 16002, 17264, 19295, 20314]","[0, 209, 488, 748, 978, 1286, 1573, 1787, 2009, 2234, 2496, 2674, 3107, 3491, 3969, 4436, 4869, 5621, 6159, 6630, 7032, 7440, 7714, 8383, 8756, 9639, 10511, 11728, 13063, 13556]","[0, 209, 356, 490, 641, 887, 1071, 1255, 1478, 1617, 2211, 2489, 2669, 2953, 3186, 3454, 3934, 4672, 5132, 5600, 5960, 6229, 6429, 6992, 7087, 7461, 8882, 9662, 10578, 11070]","[0, 209, 301, 598, 688, 874, 1009, 1099, 1284, 1386, 1521, 1713, 1893, 2391, 2854, 3122, 3280, 3856, 4039, 4323, 4913, 5362, 5683, 5959, 6054, 6428, 7096, 7808, 9103, 9390]",20283,20314,13556,11070,9390,-5342,-10521,-4883,-3047,-3075,-26868,30,dire
7619114301,39,41,23,9,86,"[0, 241, 450, 777, 1194, 1510, 1922, 2563, 3188, 3556, 3905, 4104, 4758, 5235, 5765, 6104, 6674, 7360, 7828, 8306, 8527, 9010, 9721, 10561, 10656, 11141, 11622, 12466, 13320, 13984]","[0, 280, 474, 843, 1421, 1748, 2035, 2319, 2672, 3089, 3602, 3926, 4491, 4953, 5386, 5735, 6239, 6702, 6927, 7728, 8006, 8394, 8651, 9158, 9253, 9836, 10463, 11613, 12292, 12570]","[0, 243, 442, 740, 1354, 1673, 2084, 2219, 2534, 3175, 3850, 4121, 4714, 5114, 5476, 6164, 6686, 7282, 8131, 8400, 8655, 8750, 9190, 9374, 9775, 10117, 10211, 11255, 11351, 11577]","[0, 220, 397, 542, 705, 868, 1016, 1197, 1287, 1540, 1983, 2127, 2478, 2620, 2873, 3526, 3950, 4108, 4732, 5293, 5388, 5558, 6036, 6153, 6442, 6809, 7615, 8232, 8439, 8941]","[0, 217, 307, 624, 909, 1125, 1261, 1498, 1729, 2065, 2603, 2747, 2917, 3060, 3491, 3815, 3973, 4131, 4528, 5043, 5269, 5364, 5804, 6146, 6337, 6432, 6899, 7480, 7576, 7847]",13984,12570,11577,8941,7847,42,106,129,105,26,"[0, 242, 837, 1221, 1576, 1758, 2333, 2912, 3352, 3756, 4166, 4587, 5505, 6271, 6543, 7125, 7751, 8321, 9195, 10268, 11230, 12409, 13088, 14104, 16336, 17264, 18380, 18513, 18801, 19409]","[0, 252, 575, 860, 1206, 1574, 1918, 2225, 2662, 3002, 3335, 3944, 4385, 5337, 5978, 6865, 7781, 8307, 9194, 9816, 10687, 11336, 11975, 12918, 13518, 14368, 15721, 16984, 17827, 18514]","[0, 238, 470, 765, 1044, 1451, 1903, 2278, 2902, 3282, 3860, 4573, 5118, 5702, 6514, 6784, 7221, 7628, 7992, 8482, 8892, 9662, 10343, 10803, 11258, 11860, 12743, 13449, 14183, 15163]","[0, 169, 369, 506, 596, 686, 825, 1270, 1360, 1691, 2166, 2658, 3107, 3777, 4006, 4393, 4488, 4839, 5107, 5689, 6262, 6727, 6939, 7517, 8077, 8732, 9061, 9557, 9763, 10344]","[0, 169, 259, 349, 439, 565, 703, 1189, 1426, 1516, 1921, 2428, 2696, 3175, 3360, 4133, 4566, 4990, 5718, 5902, 6265, 6797, 6963, 7163, 7472, 8118, 8581, 8782, 9199, 9576]",19409,18514,15163,10344,9576,-5425,-5944,-3586,-1403,-1729,-18087,30,dire
7619331703,10,74,137,121,3,"[0, 201, 362, 646, 830, 1246, 1385, 1760, 2121, 2592, 2860, 3174, 3513, 3951, 4507, 4898, 5292, 5969, 6520, 7232, 7852, 8682, 9521, 10307, 11171, 11700, 11859, 12778, 13452, 13949]","[0, 219, 456, 782, 1159, 1515, 1919, 2337, 2883, 3393, 3646, 3881, 4266, 4782, 5697, 5932, 6121, 6963, 7192, 7537, 7954, 9013, 9562, 9871, 10384, 10715, 10810, 11850, 12711, 12807]","[0, 164, 359, 543, 780, 953, 1259, 1560, 1843, 2128, 2344, 2506, 3097, 3497, 4556, 5019, 5113, 5696, 6015, 6134, 6478, 7318, 7925, 8427, 8870, 9217, 9376, 9797, 10295, 10391]","[0, 130, 220, 310, 408, 498, 725, 905, 995, 1135, 1225, 1315, 1491, 1668, 2377, 2677, 2783, 3327, 3422, 3516, 3655, 4449, 4691, 4907, 5077, 5247, 5417, 5866, 6208, 6379]","[0, 130, 220, 358, 448, 869, 959, 1139, 1229, 1369, 1459, 1640, 1730, 2091, 2523, 2618, 2712, 2897, 3004, 3134, 3229, 3938, 4105, 4199, 4326, 4457, 4552, 4646, 4943, 5039]",13949,12807,10391,6379,5039,89,14,2,65,105,"[0, 249, 475, 755, 958, 1562, 1943, 2518, 3048, 3493, 4060, 4520, 5046, 5840, 6611, 7194, 8170, 8858, 9927, 10796, 11675, 12596, 13971, 15000, 15884, 17011, 17919, 18778, 19471, 20707]","[0, 329, 572, 949, 1112, 1493, 1710, 1985, 2285, 2524, 2950, 3181, 3441, 3741, 3836, 4581, 5070, 5165, 5664, 5916, 6142, 6504, 6710, 7260, 7559, 8107, 8843, 9339, 9570, 11035]","[0, 210, 429, 700, 1577, 1777, 2156, 2509, 2767, 3022, 3237, 3361, 3627, 3842, 3975, 4326, 5071, 5667, 6271, 6884, 7286, 7526, 7996, 8456, 9034, 9306, 9951, 10414, 10749, 11645]","[0, 210, 334, 424, 681, 876, 1027, 1250, 1359, 1561, 1943, 2401, 2554, 2928, 3144, 3600, 4173, 4521, 5069, 5394, 5808, 6065, 6405, 6816, 7581, 8124, 8540, 8775, 9006, 9406]","[0, 210, 300, 475, 565, 655, 826, 961, 1083, 1173, 1481, 1620, 1747, 1962, 2057, 2310, 2884, 2979, 3431, 3756, 4157, 4342, 4610, 5064, 5373, 5766, 6927, 7206, 7778, 8326]",20707,11035,11645,9406,8326,-6758,1772,-1254,-3027,-3287,-12554,30,dire
7619338103,44,106,43,19,79,"[0, 248, 502, 1153, 1278, 1594, 1957, 2414, 2971, 3230, 3600, 4109, 4749, 5045, 5573, 6210, 6510, 7380, 8380, 8514, 9328, 10207, 10737, 11460, 11834, 12609, 13227, 14260, 14671, 15943]","[0, 205, 443, 572, 662, 842, 976, 1250, 1627, 1979, 2267, 2499, 3093, 3479, 4004, 4528, 5201, 6114, 6681, 7197, 7660, 8599, 8984, 9286, 10185, 10405, 10966, 11796, 11977, 12703]","[0, 285, 562, 723, 1034, 1271, 1839, 2000, 2488, 2623, 2913, 3885, 5113, 5430, 6463, 6865, 7635, 8707, 9144, 9642, 10301, 10875, 11498, 12037, 12696, 13011, 13187, 13590, 13957, 14217]","[0, 130, 271, 396, 680, 770, 950, 1040, 1363, 1490, 1580, 1986, 2507, 2698, 3078, 3511, 3809, 4580, 5329, 5525, 5736, 6197, 6398, 6700, 7459, 7553, 7875, 8311, 8443, 9124]","[0, 130, 575, 749, 883, 1038, 1128, 1236, 1411, 1501, 1638, 2044, 2273, 2368, 2633, 2885, 3307, 3615, 4095, 4291, 4511, 4786, 4880, 4975, 5127, 5221, 5397, 5717, 6021, 6172]",15943,12703,14217,9124,6172,35,123,114,21,71,"[0, 276, 526, 814, 1066, 1388, 1586, 2336, 2851, 3588, 4064, 4357, 4607, 5738, 6130, 6581, 7687, 8119, 8581, 9299, 10230, 11297, 12028, 13599, 14067, 14521, 15110, 15707, 16753, 17548]","[0, 242, 502, 761, 1044, 1349, 1815, 2187, 2550, 3211, 3489, 4074, 4453, 5088, 5699, 6228, 6818, 7597, 8200, 8683, 9240, 9775, 10493, 10910, 11716, 12266, 13036, 13626, 14818, 15076]","[0, 277, 796, 1108, 1820, 2272, 2999, 3814, 4266, 5183, 5702, 6367, 6457, 7049, 8076, 8818, 9576, 9773, 9925, 10490, 11083, 11590, 12268, 12568, 13408, 14408, 14922, 15501, 16110, 16828]","[0, 170, 512, 649, 739, 874, 1060, 1255, 1410, 1636, 1986, 2241, 2493, 2696, 3077, 3417, 3686, 3781, 4186, 4923, 5434, 5987, 6892, 7780, 7875, 8041, 8725, 9532, 10330, 10973]","[0, 170, 260, 350, 503, 671, 914, 1176, 1419, 1725, 1901, 2221, 2311, 2867, 3229, 3486, 3859, 4273, 4385, 4637, 5314, 5549, 5817, 6457, 7287, 8133, 8338, 8926, 9315, 9746]",17548,15076,16828,10973,9746,-1605,-2373,-2611,-1849,-3574,-12012,30,dire
7619709106,10,107,97,105,103,"[0, 222, 621, 952, 1405, 1615, 2136, 2544, 3021, 3334, 3783, 4374, 4906, 5496, 6131, 6662, 7375, 7575, 8105, 8958, 9052, 9147, 10210, 10782, 11001, 11947, 13061, 13873, 15578, 16623]","[0, 256, 567, 932, 1062, 1237, 1560, 1988, 2208, 2298, 2475, 2735, 3063, 3670, 4030, 4373, 4614, 5406, 6090, 6921, 7217, 7487, 8383, 8795, 9368, 9995, 10595, 11656, 13048, 14025]","[0, 245, 567, 906, 1211, 1470, 1639, 2090, 2350, 2739, 3264, 3613, 4322, 4623, 4819, 5161, 5318, 5894, 6152, 6713, 6828, 7017, 7808, 8439, 9338, 9724, 10617, 10712, 11796, 12741]","[0, 170, 306, 396, 572, 662, 1149, 1239, 1374, 1464, 1554, 1814, 2071, 2434, 2529, 2843, 3000, 3437, 4666, 5228, 5344, 5514, 5846, 6219, 6929, 7397, 7781, 7951, 9000, 9494]","[0, 170, 260, 394, 558, 648, 820, 910, 1045, 1416, 1713, 1973, 2537, 2734, 2829, 3082, 3239, 3334, 3914, 4471, 4565, 4660, 4917, 5012, 5106, 5273, 5548, 5947, 6841, 7281]",16623,14025,12741,9494,7281,41,49,35,86,110,"[0, 170, 419, 633, 1003, 1481, 1759, 2256, 2626, 3081, 3815, 4253, 4895, 5597, 6373, 6968, 7706, 8519, 9136, 9746, 10396, 11070, 11829, 12561, 13512, 14040, 14964, 16370, 16502, 17202]","[0, 209, 535, 823, 1280, 1480, 1818, 2134, 2558, 3249, 4003, 4518, 5258, 5803, 6102, 6570, 7007, 7883, 8721, 9523, 10514, 11384, 12194, 12901, 13513, 14060, 14830, 15730, 16224, 16938]","[0, 244, 553, 997, 1300, 2099, 2468, 2798, 3247, 3899, 4607, 5698, 6242, 6821, 7415, 8314, 8684, 9350, 9761, 10276, 11294, 11656, 12427, 12814, 13494, 13589, 14475, 14888, 15237, 15724]","[0, 221, 311, 440, 619, 760, 1057, 1182, 1403, 1726, 2154, 2374, 2606, 2818, 3481, 4062, 4667, 5170, 5453, 5758, 6332, 6603, 7461, 7658, 8170, 8265, 8564, 8864, 9005, 9211]","[0, 270, 360, 450, 596, 999, 1089, 1214, 1304, 1616, 1979, 2269, 2521, 2819, 3404, 3807, 4094, 4361, 4580, 4746, 5200, 5842, 6422, 6592, 6974, 7144, 7477, 7979, 8279, 8488]",17202,16938,15724,9211,8488,-579,-2913,-2983,283,-1207,-7399,30,dire
7619822517,72,23,43,136,5,"[145, 347, 545, 784, 1073, 1513, 1979, 2363, 2885, 3410, 4093, 4701, 5049, 5256, 6221, 7154, 7969, 8885, 9458, 9903, 10702, 11287, 11958, 12612, 13352, 14956, 16162, 18193, 19107, 19203]","[278, 554, 908, 1408, 1764, 2147, 2758, 3263, 3758, 4230, 4783, 5320, 5744, 6207, 6825, 7303, 8084, 8764, 9364, 9839, 10553, 11161, 11809, 12554, 13357, 13733, 14231, 15194, 15572, 16343]","[145, 362, 597, 827, 1104, 1509, 1807, 2200, 2420, 2791, 3337, 3788, 4192, 4585, 5223, 5584, 6079, 6369, 7077, 7695, 8077, 8499, 9034, 9623, 10151, 10873, 11227, 11961, 12524, 13289]","[145, 275, 365, 455, 631, 783, 873, 1346, 1475, 1695, 2194, 2425, 2571, 2797, 3475, 3732, 4283, 4562, 4968, 5676, 6110, 6427, 6903, 7382, 8160, 8484, 8999, 10011, 10187, 10449]","[278, 457, 597, 739, 887, 1037, 1127, 1217, 1680, 1969, 2317, 2930, 3061, 3343, 3750, 4263, 4618, 4890, 5111, 5451, 5687, 6381, 6717, 6858, 7136, 7412, 7717, 8609, 8996, 9092]",19203,16343,13289,10449,9092,109,22,98,9,26,"[513, 723, 1149, 1492, 2023, 2383, 3179, 3497, 4114, 4857, 5172, 5785, 6469, 6943, 7547, 7746, 8522, 8832, 9764, 10764, 11314, 12281, 13035, 14008, 14859, 15978, 16857, 17635, 18876, 19816]","[120, 365, 770, 1091, 1381, 1748, 1958, 2417, 2926, 3600, 4147, 4479, 4695, 5325, 6021, 6381, 6684, 7466, 7875, 8200, 8878, 9832, 10588, 11431, 12149, 12739, 13450, 13692, 14534, 15353]","[388, 598, 954, 1389, 1554, 1871, 2306, 2518, 2874, 3290, 4028, 4616, 5359, 6069, 6420, 6793, 7059, 7925, 8957, 9193, 9736, 10373, 10971, 12034, 12397, 12597, 13637, 13898, 15138, 16202]","[247, 508, 705, 893, 1157, 1264, 1976, 2200, 2417, 2776, 3010, 3619, 3932, 4480, 4915, 5098, 5193, 5371, 5577, 5844, 6132, 6429, 6767, 7301, 7435, 7601, 7992, 8197, 8953, 9385]","[380, 590, 680, 770, 935, 1025, 1115, 1274, 1430, 1608, 1949, 2196, 2421, 2792, 2950, 3045, 3140, 3234, 3531, 3626, 3832, 4016, 4183, 4368, 4463, 4629, 5098, 5303, 5835, 6204]",19816,15353,16202,9385,6204,-613,990,-2913,1064,2888,1416,30,dire
7619853714,18,90,138,106,121,"[0, 206, 707, 997, 1393, 1917, 2263, 2455, 3005, 3626, 4100, 5029, 5635, 6454, 6973, 8168, 8974, 10045, 11264, 12141, 13081, 13332, 14619, 15134, 16208, 17193, 17888, 18946, 19469, 20577]","[0, 209, 543, 915, 1354, 1800, 2401, 2839, 3882, 4464, 4698, 5234, 5723, 6801, 7458, 8380, 8939, 9395, 10163, 10812, 11437, 12377, 13383, 14176, 14470, 15094, 15342, 15914, 16299, 16977]","[0, 129, 219, 309, 475, 565, 910, 1154, 1380, 1705, 1885, 2052, 2233, 2647, 2757, 3293, 3497, 3878, 4534, 5180, 5747, 6033, 7125, 7345, 7568, 8071, 8346, 8441, 9311, 9407]","[0, 207, 532, 897, 1319, 1650, 2124, 2689, 3207, 3453, 3781, 4357, 4638, 5033, 5567, 5752, 6323, 6823, 7105, 7432, 8092, 8501, 9224, 9623, 9997, 10373, 10713, 11050, 11544, 12008]","[0, 129, 300, 434, 573, 740, 882, 972, 1230, 1513, 1693, 1921, 2129, 2385, 2525, 2934, 3092, 3658, 4084, 4370, 4575, 5023, 5882, 5977, 6172, 6425, 6602, 6804, 7060, 7454]",20577,16977,9407,12008,7454,70,129,43,19,52,"[0, 294, 491, 843, 1249, 1593, 1885, 2530, 2848, 3164, 3732, 4206, 4737, 5427, 6118, 6903, 8006, 8817, 9748, 10528, 11314, 11884, 11978, 13168, 14003, 15059, 16716, 17714, 18972, 19068]","[0, 243, 854, 1224, 1548, 2186, 2687, 3016, 3292, 3705, 4163, 4465, 4790, 5149, 5537, 5968, 6736, 6975, 7279, 7665, 8072, 8322, 8519, 9456, 10039, 10357, 11125, 11854, 12607, 12703]","[0, 299, 628, 963, 1270, 1674, 2037, 2414, 2710, 3366, 4359, 4612, 5371, 5889, 6504, 6773, 7326, 7856, 8635, 8990, 9460, 9774, 9868, 10699, 11157, 11598, 12411, 12864, 13441, 13655]","[100, 309, 563, 653, 743, 910, 1045, 1273, 1412, 1712, 2030, 2120, 2338, 2631, 2846, 2941, 3173, 3268, 3955, 4113, 4208, 4719, 4813, 5320, 5605, 5772, 6535, 6630, 7358, 7577]","[0, 209, 299, 406, 565, 704, 842, 1022, 1198, 1500, 1829, 1929, 2146, 2538, 3155, 3426, 3779, 4220, 4432, 4590, 4685, 5035, 5255, 5823, 5990, 6504, 7030, 7125, 7302, 7432]",19068,12703,13655,7577,7432,1509,4274,-4248,4431,22,5988,30,dire
7620049317,95,13,129,86,110,"[0, 600, 882, 1262, 1683, 2346, 2608, 2981, 3490, 3961, 4437, 5052, 5730, 6406, 7371, 8361, 9115, 9476, 10675, 11880, 12761, 13354, 14515, 15774, 17626, 18675, 20093, 21295, 21391, 21833]","[0, 258, 540, 909, 1247, 1676, 1918, 2360, 2696, 3390, 4050, 4521, 4687, 5466, 6035, 6480, 7311, 7617, 8006, 8515, 9220, 9688, 10494, 11633, 12437, 13160, 14721, 15516, 16662, 17443]","[0, 246, 536, 961, 1462, 1851, 2265, 2703, 3529, 3710, 4154, 4531, 4697, 5049, 5824, 6468, 6874, 7208, 7699, 9024, 9689, 10234, 10719, 11169, 11736, 12485, 13193, 13692, 14310, 14974]","[0, 130, 220, 515, 690, 973, 1063, 1596, 1950, 2499, 2680, 2814, 3319, 3631, 4140, 4917, 5467, 5982, 6836, 7500, 8230, 8750, 9179, 9630, 10185, 10582, 11258, 11978, 12434, 12695]","[0, 209, 299, 513, 824, 999, 1266, 1533, 2241, 2659, 2920, 3088, 3229, 3674, 4162, 4449, 4777, 5341, 5662, 6451, 6671, 6941, 7538, 7931, 8500, 8994, 9656, 10214, 10310, 10496]",21833,17443,14974,12695,10496,54,96,49,19,5,"[0, 248, 487, 845, 1301, 1718, 2156, 2595, 3050, 3422, 3981, 4416, 5318, 5920, 6154, 6900, 7739, 9122, 9774, 10515, 11180, 11888, 12978, 13335, 13581, 14127, 14533, 15249, 16250, 16346]","[0, 279, 512, 636, 881, 1160, 1668, 2355, 2651, 2874, 3376, 3810, 4490, 4997, 5440, 5687, 6616, 7038, 7628, 8051, 8808, 9321, 10045, 10807, 11040, 11135, 11230, 11615, 12693, 13050]","[0, 329, 659, 884, 1298, 1578, 2124, 2762, 3159, 3420, 3900, 4487, 5120, 5739, 6253, 6348, 6837, 7602, 8471, 8777, 8911, 9146, 9395, 9769, 10021, 10240, 10335, 10890, 12570, 12920]","[0, 210, 300, 426, 516, 606, 908, 1482, 1848, 1938, 2091, 2181, 2578, 2820, 2915, 3304, 3909, 4383, 4785, 4928, 5201, 5415, 6066, 6351, 6445, 6789, 6884, 6978, 7930, 8026]","[0, 210, 300, 390, 528, 647, 892, 1129, 1452, 1874, 2127, 2274, 2541, 2782, 2877, 2972, 3423, 3845, 4094, 4427, 4521, 4735, 4902, 5304, 5435, 5530, 5697, 5838, 6896, 6992]",16346,13050,12920,8026,6992,5487,4393,2054,4669,3504,20107,30,radiant
7620690105,44,23,43,109,19,"[0, 238, 484, 930, 1295, 1720, 2012, 2254, 2507, 2721, 3386, 3975, 4196, 4753, 5201, 5697, 6414, 6733, 7369, 7639, 8348, 8959, 9227, 9904, 10456, 11376, 11749, 12275, 13074, 13563]","[0, 345, 626, 845, 1043, 1454, 1791, 1953, 2368, 2799, 3701, 4024, 4348, 4777, 5618, 6183, 6488, 6583, 7145, 7402, 8063, 8614, 9251, 9646, 9936, 10526, 10982, 11324, 12068, 12894]","[0, 275, 553, 839, 1173, 1383, 1634, 1914, 2330, 2974, 3589, 4386, 4584, 5119, 5782, 6044, 6309, 6430, 7112, 7441, 7984, 8151, 8389, 8667, 8818, 9221, 9443, 9680, 10163, 10527]","[0, 232, 322, 458, 548, 683, 773, 1370, 1589, 1762, 2335, 2560, 2650, 2792, 3125, 3235, 3442, 3597, 4044, 4418, 4513, 4961, 5271, 5419, 5649, 5980, 6274, 6521, 6711, 6953]","[0, 194, 284, 374, 464, 554, 644, 927, 1017, 1190, 1582, 1807, 2096, 2191, 2524, 2619, 2777, 2946, 3482, 3685, 3896, 4709, 4962, 5091, 5186, 5483, 6035, 6408, 6504, 6600]",13563,12894,10527,6953,6600,38,49,25,5,79,"[0, 539, 825, 1221, 1467, 1740, 2205, 2569, 3051, 3704, 4176, 4528, 5694, 6516, 7215, 7725, 8634, 9201, 9941, 10757, 11303, 12225, 13096, 13954, 15352, 15646, 16472, 16688, 17179, 17689]","[0, 274, 450, 695, 1186, 1523, 1842, 2328, 2603, 3192, 3462, 4155, 4729, 5456, 5953, 6377, 7227, 7727, 9059, 9514, 10259, 10877, 11376, 12267, 13678, 14001, 14627, 15264, 15680, 16348]","[0, 286, 614, 872, 1154, 1364, 1893, 2279, 2612, 2963, 3525, 4165, 4597, 5197, 5603, 6343, 7390, 7992, 8341, 8836, 9249, 10229, 10867, 11397, 13127, 13513, 14047, 14380, 15246, 16073]","[0, 234, 370, 460, 655, 745, 1015, 1383, 1557, 1819, 2023, 2158, 2866, 3380, 3702, 3872, 4427, 5159, 5915, 6284, 6514, 6941, 7626, 8000, 9088, 9501, 9676, 9830, 9926, 10196]","[0, 234, 324, 462, 604, 990, 1143, 1278, 1747, 2044, 2260, 2450, 2791, 3184, 3427, 3778, 3897, 4629, 5265, 5735, 6051, 6640, 6981, 7356, 8426, 8638, 9137, 9307, 9478, 9730]",17689,16348,16073,10196,9730,-4126,-3454,-5546,-3243,-3130,-19499,30,dire
7621065719,109,23,69,85,105,"[0, 209, 493, 942, 1318, 1671, 2174, 2715, 3266, 3769, 4579, 4947, 5562, 6318, 7017, 7493, 8375, 9240, 9562, 10278, 11357, 11795, 12813, 13406, 14291, 15444, 16359, 17543, 18560, 19169]","[0, 330, 779, 1035, 1478, 1847, 2290, 2810, 3392, 4104, 4771, 5384, 5954, 6523, 7186, 7688, 8509, 9148, 9678, 10498, 11421, 11600, 12515, 13187, 13641, 14391, 14941, 15292, 16184, 16861]","[0, 330, 492, 909, 1243, 1784, 2094, 2844, 3216, 3573, 4473, 5206, 5785, 6314, 7020, 7910, 8891, 9492, 9962, 10299, 11639, 12005, 13032, 13582, 14034, 14748, 15154, 15551, 16291, 16592]","[0, 170, 260, 350, 526, 616, 829, 1077, 1281, 1565, 1918, 2256, 2484, 2926, 3256, 3360, 3815, 4020, 4177, 4428, 4743, 4849, 5078, 5292, 5393, 5834, 6205, 6375, 6769, 7033]","[0, 170, 260, 350, 480, 617, 707, 892, 1249, 1604, 1937, 2138, 2301, 2491, 2809, 2989, 3274, 3691, 4078, 4316, 4940, 5041, 5314, 5658, 5753, 6119, 6213, 6308, 6627, 6933]",19169,16861,16592,7033,6933,12,13,129,9,114,"[0, 207, 550, 904, 1151, 1260, 1521, 1740, 2011, 2334, 2810, 2924, 3533, 3907, 4341, 4904, 5426, 5817, 6436, 6962, 7358, 8170, 9298, 9606, 10118, 10602, 11463, 12305, 13196, 13581]","[0, 206, 479, 860, 1184, 1437, 1807, 2140, 2414, 3064, 3662, 3930, 4336, 4995, 5415, 5841, 6666, 7536, 8341, 8803, 9288, 9826, 10640, 11276, 11564, 12355, 12837, 13734, 14243, 14587]","[0, 170, 445, 571, 815, 1299, 1434, 1721, 1932, 2348, 2847, 3205, 3696, 4217, 4473, 5024, 5641, 6434, 6852, 7639, 8137, 8640, 9338, 10009, 10309, 10758, 11174, 11855, 12491, 12879]","[0, 170, 336, 549, 719, 809, 1014, 1529, 1789, 1897, 2183, 2426, 2717, 3025, 3119, 3431, 3813, 4115, 4674, 5263, 5691, 5970, 6358, 6645, 6841, 6936, 7098, 7645, 7995, 8328]","[0, 170, 285, 375, 545, 683, 818, 1000, 1234, 1629, 1809, 1987, 2118, 2268, 2425, 2574, 2732, 2958, 3558, 3891, 4061, 4228, 4518, 4802, 4945, 5040, 5134, 5385, 5652, 6412]",13581,14587,12879,8328,6412,5588,2274,3713,-1295,521,10801,30,radiant
7621528409,41,97,49,64,112,"[0, 281, 668, 1067, 1529, 1907, 2360, 2826, 3279, 3966, 4292, 4880, 5484, 6394, 7283, 7825, 8634, 9022, 9205, 10423, 11003, 11551, 12086, 12953, 14232, 15441, 16000, 17750, 19009, 20613]","[0, 267, 598, 997, 1398, 1727, 2130, 2825, 3365, 3834, 4447, 5008, 5906, 6666, 7148, 7434, 7529, 7985, 8080, 8480, 8982, 9256, 9606, 10132, 10816, 12245, 13191, 13884, 13980, 14835]","[0, 271, 557, 870, 1028, 1540, 1897, 2479, 2654, 3074, 3370, 3578, 4022, 4750, 5189, 5666, 5934, 6417, 6601, 7468, 8052, 8147, 8610, 9599, 10425, 11965, 12803, 13494, 13704, 14528]","[0, 195, 330, 489, 628, 786, 922, 1109, 1245, 1463, 1921, 2355, 2540, 3511, 3916, 4122, 4304, 4650, 4855, 5690, 5785, 6097, 6491, 7145, 7774, 8689, 8968, 10863, 11499, 12486]","[0, 195, 285, 405, 704, 843, 981, 1229, 1319, 1733, 1868, 1958, 2282, 2741, 2944, 3574, 3707, 4235, 4498, 4995, 5418, 5675, 5827, 6353, 6927, 8230, 8982, 9475, 9611, 9788]",20613,14835,14528,12486,9788,93,23,129,31,45,"[0, 252, 754, 960, 1413, 1682, 1975, 2395, 2726, 3438, 3954, 4707, 5162, 5623, 6899, 7607, 8387, 9368, 9821, 10696, 11325, 12550, 13371, 13595, 13762, 13857, 14180, 15364, 15460, 16072]","[0, 242, 530, 900, 1058, 1370, 1754, 1994, 2502, 3011, 3530, 4071, 4631, 5754, 6228, 6880, 7768, 8817, 9239, 10017, 10331, 11148, 11785, 12312, 12759, 13011, 13405, 14145, 14241, 14932]","[0, 170, 479, 818, 1159, 1618, 2036, 2290, 2669, 2808, 3116, 3488, 3949, 4507, 4830, 5267, 5935, 6267, 6853, 7687, 8502, 8957, 9348, 9546, 9935, 10575, 10750, 11364, 11460, 12343]","[0, 170, 470, 560, 738, 872, 1011, 1180, 1425, 1654, 2010, 2292, 2432, 3119, 3304, 4184, 4810, 5142, 5620, 6221, 6477, 7119, 7582, 7806, 7973, 8220, 8395, 9137, 9285, 9648]","[0, 170, 260, 350, 440, 565, 747, 882, 1051, 1314, 1505, 1678, 1818, 2323, 2671, 3106, 3543, 4245, 4682, 5091, 5312, 6176, 6499, 6723, 6890, 7303, 7478, 8295, 8538, 9012]",16072,14932,12343,9648,9012,4541,-97,2185,2838,776,10243,30,radiant
7621666802,138,96,17,9,65,"[0, 290, 540, 959, 1606, 1984, 2403, 2788, 3269, 3807, 4320, 4591, 5405, 5970, 6651, 7228, 8337, 8834, 9392, 9839, 10901, 11463, 12681, 13388, 14403, 15173, 16429, 17258, 18234, 18983]","[0, 255, 585, 865, 1414, 1650, 2000, 2418, 2922, 3307, 4214, 4510, 4939, 5205, 5466, 5659, 6359, 7034, 7638, 7796, 8313, 8479, 9364, 10013, 10877, 11493, 12335, 13191, 14186, 14887]","[0, 278, 567, 933, 1154, 1493, 1896, 2094, 2333, 2679, 3212, 3322, 3780, 3984, 4443, 4628, 5422, 6175, 6396, 6683, 6816, 7261, 7863, 8220, 8493, 9073, 9249, 9344, 9521, 10047]","[0, 174, 304, 437, 722, 872, 1275, 1468, 1558, 1895, 2238, 2647, 3285, 3393, 3970, 4296, 5494, 5965, 6109, 6267, 6539, 6818, 7612, 7707, 8092, 8534, 8778, 9166, 9512, 9789]","[0, 170, 333, 423, 621, 711, 801, 942, 1294, 1429, 1619, 1910, 2259, 2565, 3234, 3397, 3918, 4551, 4646, 4804, 5073, 5283, 5540, 5635, 6289, 6639, 6815, 7275, 7865, 8258]",18983,14887,10047,9789,8258,73,70,13,121,79,"[0, 313, 481, 690, 1113, 1731, 2062, 2894, 3281, 4047, 4444, 5470, 6402, 7377, 8243, 9083, 10360, 11267, 12010, 12705, 14298, 15191, 16390, 18003, 18222, 19098, 19950, 20263, 20611, 21194]","[0, 302, 556, 813, 1101, 1615, 1990, 2388, 2914, 3258, 3738, 4165, 4868, 5634, 6235, 7047, 7578, 8077, 8975, 9895, 10522, 11325, 12765, 13710, 14302, 15372, 16157, 16872, 18052, 18836]","[0, 195, 627, 872, 1217, 1679, 2088, 2602, 3107, 3438, 3768, 4428, 5331, 5635, 6251, 6683, 6911, 7650, 7886, 8677, 9485, 9931, 10656, 11703, 12342, 12778, 13335, 13689, 14600, 15315]","[0, 195, 328, 418, 812, 1068, 1158, 1467, 1686, 1821, 2180, 2521, 3235, 3733, 4215, 4310, 4538, 4829, 4957, 5685, 6511, 6680, 7045, 7512, 7681, 8152, 8752, 9144, 9530, 9812]","[0, 242, 332, 470, 843, 933, 1331, 1987, 2271, 2656, 2833, 3227, 3460, 3764, 4130, 4410, 4642, 5297, 5396, 5858, 6383, 6478, 7016, 7483, 7902, 8429, 8758, 9026, 9580, 10077]",21194,18836,15315,9812,10077,-2211,-3949,-5268,-23,-1819,-13270,30,dire
7622335611,41,120,23,27,85,"[0, 330, 592, 822, 1120, 1403, 1863, 2229, 2591, 3396, 3870, 4161, 4464, 5232, 5660, 5888, 6693, 6956, 7576, 8299, 8553, 9246, 9903, 10402, 11422, 12065, 12868, 13509, 14055, 15325]","[0, 379, 700, 1028, 1472, 1962, 2350, 2960, 3662, 4378, 4513, 5336, 5927, 6339, 7016, 7506, 8044, 8925, 9528, 9755, 10876, 11569, 12418, 12758, 13103, 13306, 13570, 13882, 14590, 15445]","[0, 247, 549, 886, 1206, 1524, 1660, 1786, 2480, 2928, 3100, 3349, 3804, 4357, 5081, 5632, 6332, 6911, 7481, 8009, 8524, 8679, 9291, 9433, 9600, 9895, 10328, 10983, 11344, 12774]","[0, 256, 422, 512, 864, 989, 1079, 1492, 1627, 1958, 2093, 2412, 2546, 2748, 3155, 3634, 3995, 4127, 4222, 4912, 5298, 5392, 6001, 6142, 6691, 6785, 6929, 7095, 7317, 7555]","[0, 210, 380, 591, 820, 945, 1080, 1174, 1314, 1588, 1895, 2106, 2307, 2555, 2813, 3163, 3502, 3643, 3790, 4068, 4675, 4769, 5133, 5331, 5587, 5717, 6066, 6197, 6423, 7125]",15325,15445,12774,7555,7125,48,17,96,123,86,"[0, 130, 435, 680, 1041, 1564, 2062, 2516, 2902, 3444, 4010, 4723, 5326, 5903, 6895, 7355, 8376, 9318, 9898, 10749, 11662, 12109, 12948, 13546, 14468, 15242, 16314, 17024, 17997, 18733]","[0, 324, 735, 1102, 1675, 2098, 2512, 3004, 3651, 3824, 4852, 5258, 6001, 6522, 6935, 7414, 8684, 9290, 10080, 10791, 11326, 11922, 12396, 12649, 13109, 13625, 14660, 15659, 16467, 16563]","[0, 130, 438, 716, 1099, 1391, 1900, 2269, 2763, 3195, 3571, 4038, 4572, 5060, 5758, 6098, 6581, 6988, 7186, 7883, 8554, 9344, 9756, 9851, 10441, 10925, 11265, 11706, 11964, 12371]","[0, 130, 272, 737, 916, 1041, 1180, 1315, 1450, 1913, 2308, 2518, 2888, 3131, 3470, 3588, 4046, 4407, 4548, 4983, 5509, 6139, 6769, 7072, 7484, 8071, 8536, 8918, 9387, 9483]","[0, 130, 321, 499, 673, 798, 888, 1068, 1221, 1391, 1916, 2270, 2432, 2663, 3057, 3152, 3537, 4105, 4411, 4847, 5370, 5621, 5810, 5971, 6176, 6497, 7039, 7215, 7473, 7569]",18733,16563,12371,9483,7569,-3408,-1118,403,-1928,-444,-6495,30,dire
7622509408,109,98,96,105,20,"[0, 207, 453, 762, 1057, 1420, 1813, 2361, 2691, 3099, 3639, 4293, 4791, 5470, 6109, 6969, 7725, 8415, 9065, 9564, 10403, 11267, 12025, 12486, 13055, 13481, 14171, 14775, 15952, 17065]","[0, 322, 680, 1179, 1433, 2011, 2434, 3105, 3472, 3941, 4568, 4716, 5806, 6371, 7052, 7897, 8822, 9443, 9568, 10076, 10715, 11290, 11821, 11975, 12476, 13241, 13479, 14137, 15180, 15575]","[0, 294, 508, 822, 1485, 1773, 2176, 2741, 3406, 4006, 4466, 4971, 5246, 5826, 6436, 6915, 7529, 8082, 8367, 9391, 9812, 10054, 11028, 11294, 11836, 11931, 12154, 12444, 13205, 13614]","[0, 170, 260, 380, 804, 899, 1260, 1531, 1621, 1918, 2141, 2289, 2789, 3095, 3492, 3801, 4051, 4459, 4681, 5236, 5554, 5695, 5862, 6400, 6598, 6890, 7344, 7751, 9009, 9309]","[0, 175, 265, 488, 616, 801, 891, 1092, 1440, 1620, 2010, 2153, 2243, 2482, 2696, 2974, 3223, 3381, 3746, 4030, 4399, 4546, 4713, 4808, 4904, 5023, 5118, 5213, 5390, 5700]",17065,15575,13614,9309,5700,12,13,129,26,51,"[0, 170, 345, 585, 712, 917, 1092, 1317, 1545, 1962, 2276, 2723, 3374, 3882, 4582, 5173, 5720, 6672, 7397, 8395, 9210, 9521, 9915, 10457, 11869, 12602, 13616, 14992, 15120, 16034]","[0, 288, 541, 824, 1153, 1409, 1783, 2036, 2576, 2913, 3357, 4176, 4524, 4849, 5225, 5548, 6069, 6997, 8182, 8690, 9738, 10175, 10433, 11069, 12375, 13116, 14631, 15723, 16221, 17173]","[0, 170, 545, 803, 1088, 1529, 1936, 2365, 2779, 3096, 3665, 4557, 4955, 5475, 5998, 6178, 6470, 7183, 8027, 8224, 8963, 9965, 10412, 11033, 11710, 12170, 13439, 14562, 14801, 15387]","[0, 170, 260, 350, 440, 601, 943, 1063, 1496, 1586, 1765, 2116, 2206, 2399, 2717, 2864, 2987, 3281, 3693, 3902, 4221, 4481, 4707, 5139, 6123, 6309, 7049, 7484, 7736, 8064]","[0, 170, 600, 729, 1057, 1205, 1426, 1516, 1675, 1789, 1924, 2291, 2397, 2597, 2795, 3040, 3134, 3339, 3893, 4090, 4332, 4473, 5056, 5415, 6192, 6536, 7599, 8078, 8174, 8537]",16034,17173,15387,8064,8537,1031,-1598,-1773,1245,-2837,-3932,30,dire
7622513213,78,32,53,120,85,"[0, 208, 483, 762, 1163, 1413, 1735, 2182, 2632, 3120, 3457, 3977, 4332, 4775, 5115, 5609, 6713, 7646, 8513, 9314, 9868, 11184, 12115, 12723, 13389, 14280, 14998, 15634, 16440, 17684]","[0, 326, 628, 953, 1673, 1959, 2417, 2795, 3283, 3882, 4341, 4915, 5212, 5610, 5864, 6399, 7746, 8410, 9300, 10015, 10109, 10608, 11220, 11863, 12383, 13199, 13363, 14123, 15805, 16632]","[0, 170, 332, 471, 636, 909, 999, 1089, 1301, 1742, 2022, 2557, 2694, 3090, 3433, 3782, 4689, 5436, 5966, 6668, 6922, 7437, 8028, 8522, 9056, 9358, 9998, 11291, 12421, 13399]","[0, 207, 564, 776, 1061, 1773, 2085, 2420, 2918, 3453, 4111, 4781, 5367, 5856, 6142, 6750, 7449, 7631, 8253, 8738, 9130, 9461, 9973, 10349, 10670, 11148, 11876, 12321, 12734, 13859]","[0, 170, 260, 350, 562, 709, 802, 892, 1093, 1437, 1558, 1801, 2083, 2318, 2633, 2730, 3505, 3687, 4048, 4377, 4471, 4999, 5166, 5261, 5355, 5933, 6287, 6702, 7262, 7963]",17684,16632,13399,13859,7963,7,93,129,86,5,"[0, 294, 630, 1022, 1330, 1610, 2025, 2473, 2890, 3268, 4152, 4730, 5018, 5426, 5841, 6242, 6610, 7526, 7927, 8488, 9251, 9595, 10198, 10621, 11120, 11651, 12094, 12517, 12848, 13892]","[0, 208, 520, 901, 1250, 1662, 1911, 2163, 2619, 3000, 3438, 3914, 4567, 5083, 5515, 6040, 6511, 6856, 7515, 7610, 8213, 9293, 9802, 10345, 10697, 11296, 12578, 12944, 13261, 13879]","[0, 240, 532, 898, 1261, 1622, 1824, 2348, 2627, 2791, 3341, 3768, 4197, 5055, 5588, 5851, 6803, 7254, 7547, 8044, 8737, 9506, 9863, 10134, 10909, 11204, 11823, 12088, 12687, 13059]","[0, 170, 305, 441, 530, 707, 797, 932, 1246, 1348, 1676, 1962, 2088, 2327, 2484, 2907, 3621, 4169, 4264, 4359, 5060, 5389, 5556, 5892, 6081, 6377, 6668, 6896, 7488, 7883]","[0, 221, 380, 470, 559, 775, 865, 1000, 1157, 1421, 1890, 2256, 2346, 2737, 3158, 3290, 3501, 3596, 3691, 3786, 4826, 4921, 5639, 5841, 6216, 6471, 6810, 6904, 7415, 7749]",13892,13879,13059,7883,7749,3792,2753,340,5976,214,13075,30,radiant
7622983019,106,46,98,53,86,"[0, 325, 654, 1068, 1477, 1845, 2252, 2736, 3150, 3821, 4448, 5144, 5658, 6665, 6887, 7401, 7777, 8639, 9538, 9860, 10233, 10769, 11861, 12357, 13452, 14890, 16229, 16984, 17833, 19365]","[0, 246, 419, 583, 922, 1251, 1541, 1775, 2195, 2477, 3639, 4103, 4569, 5130, 5751, 6498, 7204, 7481, 8260, 9100, 10298, 11201, 12317, 13191, 13364, 13458, 14473, 15595, 15822, 16544]","[331, 622, 1056, 1501, 1747, 2270, 2607, 3075, 3208, 3370, 3926, 4305, 4923, 5545, 5868, 6280, 6946, 7386, 8012, 8602, 8998, 9503, 10491, 11136, 11930, 12024, 12751, 13727, 14594, 15135]","[63, 233, 323, 462, 552, 642, 778, 1064, 1524, 2041, 2274, 2691, 3008, 4119, 4442, 4889, 5398, 5721, 6060, 6255, 6568, 6849, 7728, 8301, 8909, 9730, 10380, 10821, 11460, 12661]","[63, 233, 323, 448, 538, 674, 764, 854, 988, 1391, 1526, 1832, 1971, 2623, 2832, 3334, 3540, 4136, 4503, 4850, 4995, 5355, 6295, 6800, 7835, 8142, 8694, 9196, 9629, 10339]",19365,16544,15135,12661,10339,39,70,96,119,5,"[0, 286, 690, 1140, 1559, 2129, 2337, 2728, 3129, 3810, 4244, 4678, 5169, 5567, 6240, 6961, 7556, 8934, 9252, 9777, 10198, 10856, 11531, 11830, 13478, 13752, 14292, 15081, 15233, 15762]","[0, 206, 572, 887, 1373, 1734, 2474, 3121, 3620, 4142, 4524, 5137, 5486, 5758, 6567, 7375, 8176, 8985, 9162, 9424, 10247, 10821, 11309, 11818, 12650, 13025, 13200, 13873, 14150, 14301]","[0, 245, 445, 708, 1065, 1276, 1450, 1729, 2130, 2702, 3166, 3635, 4154, 4664, 5192, 5608, 6636, 6892, 6986, 8215, 8635, 9277, 9531, 9934, 10623, 10717, 11008, 11749, 12157, 12540]","[0, 170, 260, 613, 743, 1020, 1187, 1277, 1497, 1602, 1910, 2075, 2212, 2490, 2842, 3077, 3432, 3562, 3656, 4032, 4262, 4614, 4882, 4977, 5926, 6020, 6278, 6790, 7097, 7193]","[0, 170, 260, 350, 529, 701, 1182, 1472, 1693, 1898, 2273, 2408, 2498, 3031, 3125, 3322, 3676, 3771, 3865, 4093, 4387, 4845, 5097, 5278, 6238, 6412, 6507, 6602, 6773, 6869]",15762,14301,12540,7193,6869,3603,2243,2595,5468,3470,17379,30,radiant
7623082102,129,9,72,68,51,"[327, 657, 1101, 1479, 1962, 2334, 2785, 3161, 3765, 3980, 4664, 5151, 5611, 6222, 6759, 7310, 7828, 8731, 9518, 10375, 11017, 11807, 12661, 13603, 14411, 15312, 16334, 17855, 18225, 18975]","[59, 349, 608, 948, 1567, 1893, 2614, 3143, 3798, 4251, 5029, 5237, 5693, 6208, 6626, 7494, 8092, 9216, 9560, 9952, 10533, 12470, 13200, 14161, 14513, 14857, 15033, 15783, 15879, 17381]","[0, 306, 682, 977, 1186, 1812, 2225, 2499, 3002, 3391, 3873, 4462, 4943, 5529, 6272, 6979, 7601, 8446, 9077, 9588, 10930, 11691, 12769, 13088, 13816, 13959, 15349, 15808, 16158, 17747]","[0, 402, 492, 582, 703, 940, 1030, 1246, 1429, 1538, 2048, 2338, 2554, 2703, 3170, 3449, 3544, 3905, 4037, 4551, 4930, 5631, 6264, 7218, 7604, 8175, 8683, 9397, 9568, 11047]","[59, 269, 359, 495, 630, 760, 894, 1029, 1212, 1389, 1704, 1933, 2070, 2219, 2313, 2582, 2915, 3156, 3499, 3788, 4067, 4655, 4894, 5413, 5770, 5900, 6484, 6986, 7146, 7630]",18975,17381,17747,11047,7630,49,19,21,86,20,"[0, 256, 646, 1094, 1501, 1852, 2401, 2934, 3648, 4340, 5085, 5700, 6430, 7142, 7967, 8867, 9840, 10735, 11676, 12615, 13589, 14669, 15369, 16413, 17083, 17976, 18685, 20441, 21425, 22642]","[0, 268, 543, 885, 1126, 1337, 1626, 1914, 2082, 2419, 2543, 3569, 3950, 4530, 4950, 6119, 6963, 7347, 8349, 9100, 9974, 10283, 11369, 12395, 13758, 14758, 15808, 16482, 16688, 17364]","[0, 130, 334, 615, 788, 1001, 1320, 1957, 2343, 2698, 3310, 3745, 4526, 4994, 5176, 5603, 6105, 6372, 6765, 7453, 7781, 8214, 8477, 9163, 9666, 10564, 11454, 12071, 12407, 13617]","[0, 130, 265, 398, 498, 657, 792, 1044, 1355, 1491, 2018, 2162, 2522, 2671, 2833, 3310, 3706, 4121, 4272, 4520, 4929, 5113, 5419, 5943, 6355, 6736, 7357, 8195, 8401, 9077]","[0, 130, 255, 407, 497, 606, 740, 886, 1036, 1250, 1422, 1637, 2049, 2198, 2356, 2750, 2953, 3180, 3275, 3523, 3752, 3936, 4095, 4461, 4873, 5168, 5658, 6768, 6974, 7449]",22642,17364,13617,9077,7449,-3667,17,4130,1970,181,2631,30,dire
7623291018,95,129,35,86,29,"[0, 327, 621, 1040, 1238, 1820, 1982, 2465, 2684, 3874, 4010, 4617, 5320, 5979, 6716, 7437, 8368, 9041, 10201, 10910, 11592, 12484, 12578, 14014, 14109, 14810, 15447, 15929, 16524, 17310]","[0, 215, 570, 936, 1228, 1709, 2213, 2761, 3256, 3774, 4032, 4495, 4958, 5676, 6635, 7187, 8076, 8763, 9529, 10173, 10792, 11233, 12087, 13048, 13405, 14287, 14536, 15071, 15389, 16406]","[0, 329, 680, 1089, 1468, 1923, 2838, 3348, 3820, 4325, 5186, 5774, 6417, 7398, 8460, 8896, 10011, 10457, 10946, 11436, 12406, 13244, 14110, 14859, 15321, 15488, 15754, 16078, 16396, 17522]","[0, 129, 219, 406, 540, 670, 850, 1076, 1166, 1306, 1396, 1532, 1977, 2481, 2755, 2896, 3494, 3637, 3924, 4019, 4285, 4451, 5266, 5508, 5678, 5920, 6145, 6557, 7117, 8000]","[0, 558, 648, 820, 910, 1172, 1262, 1567, 1752, 1949, 2091, 2200, 2361, 2600, 3248, 3355, 4334, 4429, 4523, 4618, 4713, 4808, 5540, 5875, 6201, 6368, 6617, 6769, 6999, 7933]",17310,16406,17522,8000,7933,44,97,14,52,84,"[0, 289, 695, 1062, 1601, 1964, 2369, 2653, 3220, 3526, 4163, 4701, 5395, 5669, 6661, 7230, 8190, 8756, 9562, 10743, 11453, 12306, 13479, 14350, 15889, 17341, 18812, 20279, 21573, 23094]","[0, 544, 882, 1528, 1749, 2153, 2903, 3247, 3853, 4392, 4615, 4962, 5353, 5980, 6779, 7148, 7834, 8210, 9043, 10183, 11070, 11968, 13021, 13116, 13648, 14728, 15434, 15989, 16380, 17615]","[0, 451, 826, 1336, 1853, 2324, 2877, 3370, 3937, 4452, 5277, 5569, 6279, 6966, 7390, 7644, 8225, 8611, 9031, 10259, 10955, 11475, 11641, 11906, 13164, 13949, 14483, 15603, 16311, 16961]","[0, 276, 439, 766, 926, 1138, 1460, 1595, 2298, 2479, 2788, 3416, 3590, 3842, 4255, 4597, 4820, 5092, 5622, 6118, 6416, 7006, 7395, 7490, 8318, 9074, 9673, 10357, 10748, 11576]","[0, 209, 299, 389, 554, 771, 910, 1045, 1179, 1269, 1424, 1576, 1666, 2339, 2631, 2870, 3055, 3150, 3399, 4132, 4273, 4595, 4984, 5079, 5689, 6298, 6800, 7176, 7938, 8294]",23094,17615,16961,11576,8294,-5784,-1209,561,-3576,-361,-10369,30,dire
7623382418,18,77,23,65,9,"[0, 207, 517, 801, 1120, 1532, 1860, 2328, 2997, 3689, 4208, 4769, 5509, 6153, 6797, 7404, 8061, 8949, 9391, 9839, 10617, 10973, 11418, 12542, 13571, 14453, 15112, 15686, 16233, 16498]","[0, 208, 488, 800, 1285, 1655, 1900, 2417, 2968, 3596, 4207, 4592, 5078, 5562, 5946, 6552, 7198, 8273, 8574, 8913, 9885, 9979, 10896, 11612, 12065, 12469, 13458, 13892, 14295, 14501]","[0, 321, 628, 994, 1436, 1722, 2170, 2861, 3420, 4158, 4798, 5085, 5738, 6447, 6843, 7230, 7831, 8395, 8637, 9339, 9731, 10123, 10891, 11377, 11917, 12425, 12823, 13549, 13835, 14170]","[0, 170, 260, 410, 715, 805, 895, 1030, 1196, 1456, 1737, 1827, 2252, 2592, 2736, 3077, 3844, 4274, 4577, 4807, 5227, 5355, 5819, 5989, 6429, 6875, 7400, 7990, 8249, 8571]","[0, 213, 416, 553, 806, 1041, 1216, 1466, 1604, 1838, 2111, 2201, 2705, 3084, 3514, 3705, 4017, 4483, 4578, 4936, 5597, 5691, 5888, 6089, 6309, 6678, 6957, 7254, 7376, 7472]",16498,14501,14170,8571,7472,54,52,129,121,26,"[0, 207, 439, 708, 1088, 1367, 1639, 2088, 2597, 2853, 3171, 3619, 4219, 4791, 5380, 5914, 7047, 7756, 8397, 9066, 9583, 10465, 11322, 12518, 13213, 13908, 14581, 15441, 16313, 16746]","[0, 243, 532, 859, 1348, 1763, 2049, 2375, 2947, 3394, 4329, 4714, 5553, 6065, 6627, 7021, 7620, 8186, 8783, 9431, 10101, 10994, 11922, 12564, 13693, 14390, 15074, 15169, 16300, 16680]","[0, 170, 553, 940, 1350, 1567, 2085, 2503, 2865, 3414, 4014, 4594, 5142, 5680, 6052, 6587, 7432, 7872, 8446, 9200, 9969, 10608, 11503, 12017, 12359, 13186, 13876, 13971, 14562, 14765]","[0, 170, 294, 471, 688, 898, 1033, 1123, 1300, 1525, 1868, 1958, 2138, 2335, 2532, 2784, 3032, 3237, 3332, 3599, 3757, 4018, 4264, 4359, 4525, 4983, 5159, 5254, 5687, 5997]","[0, 170, 274, 364, 494, 624, 777, 867, 1044, 1134, 1316, 1546, 1863, 2093, 2242, 2337, 2729, 2886, 2981, 3630, 3788, 3882, 3977, 4252, 4592, 4759, 4935, 5030, 5252, 5348]",16746,16680,14765,5997,5348,-248,-2179,-595,2574,2124,1676,30,dire
7623497900,82,96,17,90,5,"[0, 210, 441, 698, 1019, 1360, 1916, 2350, 2887, 3542, 4010, 4673, 5257, 5997, 6571, 7636, 8349, 8640, 9126, 9221, 9826, 10768, 11405, 11861, 12325, 12906, 13809, 14435, 15231, 16392]","[0, 210, 518, 803, 1103, 1503, 2019, 2345, 2954, 3313, 3771, 3955, 4413, 4991, 5383, 6044, 6493, 6588, 7136, 7231, 7674, 7961, 8384, 9293, 10097, 10574, 11062, 11548, 11906, 12109]","[0, 362, 647, 1015, 1357, 1654, 2223, 2497, 3109, 3552, 4152, 4825, 5302, 5899, 6425, 6786, 7282, 7377, 7746, 8023, 8479, 8642, 9282, 9809, 10126, 10742, 11014, 11403, 11776, 11947]","[0, 249, 430, 568, 704, 838, 1153, 1287, 1377, 1600, 1753, 2023, 2236, 2535, 2630, 2909, 3066, 3161, 3434, 3621, 3864, 4146, 4811, 5125, 5294, 5792, 6144, 6580, 7218, 7389]","[0, 253, 390, 480, 688, 802, 1043, 1133, 1373, 1496, 1648, 1832, 1922, 2272, 2395, 2580, 2899, 2994, 3136, 3231, 3474, 3569, 4152, 4320, 4503, 5011, 5255, 5504, 6416, 6658]",16392,12109,11947,7389,6658,54,13,137,19,110,"[0, 155, 537, 928, 1335, 1580, 2134, 2381, 2848, 3252, 3709, 4215, 4527, 5184, 5749, 6119, 6794, 8051, 8514, 9428, 10251, 11294, 12155, 12928, 13546, 13848, 14971, 16005, 17192, 19043]","[0, 312, 590, 835, 1278, 1658, 2193, 2851, 3248, 3811, 4230, 4755, 5092, 5791, 6374, 6662, 7260, 8365, 8830, 10057, 10496, 11073, 11816, 12546, 13157, 13678, 14609, 14904, 15850, 16832]","[0, 155, 462, 749, 1088, 1347, 1474, 1772, 2306, 2718, 3312, 3851, 4402, 4686, 5084, 5274, 6268, 7778, 8396, 9276, 9772, 9939, 11153, 11872, 12252, 13332, 13537, 14285, 15274, 16439]","[0, 155, 245, 335, 580, 1052, 1142, 1363, 1718, 1808, 1999, 2361, 2728, 3035, 3507, 3651, 4077, 4916, 5011, 5930, 6203, 6465, 6789, 7074, 7373, 8626, 8831, 9226, 9692, 10874]","[0, 205, 295, 385, 562, 652, 835, 970, 1597, 1842, 2125, 2451, 2586, 2952, 3278, 3460, 3907, 4634, 4874, 5955, 6428, 6777, 7378, 7787, 8271, 8702, 9108, 9294, 9809, 10434]",19043,16832,16439,10874,10434,-2651,-4723,-4492,-3485,-3776,-19127,30,dire
7623846810,48,49,23,79,5,"[0, 170, 579, 904, 1193, 1521, 1979, 2278, 2828, 3180, 3582, 4261, 4867, 5605, 6261, 6948, 7579, 8657, 9349, 10443, 11449, 12585, 13239, 14338, 15937, 16615, 17968, 18708, 19658, 20528]","[0, 238, 565, 1010, 1466, 1854, 2276, 2699, 3079, 3649, 4259, 4891, 5308, 5847, 6541, 6997, 7419, 8068, 8309, 8921, 9274, 10010, 10567, 11260, 12164, 12563, 13511, 14136, 14965, 15769]","[0, 260, 543, 830, 1237, 1442, 1781, 1916, 2299, 2861, 3082, 3538, 4490, 5274, 5976, 6448, 6890, 7993, 8399, 8754, 9162, 9452, 9936, 10477, 10801, 11098, 11563, 11974, 12634, 13376]","[0, 170, 260, 384, 519, 649, 789, 924, 1014, 1280, 1893, 1983, 2302, 2635, 2880, 3023, 3298, 3935, 4172, 4534, 4901, 5167, 5525, 6001, 6383, 6684, 7086, 7403, 7763, 8087]","[0, 215, 305, 413, 634, 764, 937, 1072, 1201, 1335, 1779, 2050, 2254, 2636, 2934, 3294, 3536, 3976, 4189, 4567, 4661, 4872, 5466, 5830, 6105, 6396, 6882, 7267, 7569, 8025]",20528,15769,13376,8087,8025,10,98,17,19,110,"[0, 258, 545, 859, 1213, 1700, 2148, 2529, 2914, 3473, 4106, 4824, 5347, 5873, 6575, 7151, 7903, 8331, 9182, 9775, 10558, 11457, 12417, 13363, 14512, 15367, 16153, 16406, 17295, 18334]","[0, 206, 512, 720, 1008, 1253, 1459, 2230, 2805, 3258, 3818, 4170, 4651, 5096, 5630, 6489, 7118, 7729, 8689, 8784, 9865, 10725, 10892, 11366, 12185, 12980, 13739, 14173, 14468, 14666]","[0, 321, 608, 1020, 1303, 1576, 1764, 2077, 2646, 2850, 3537, 4011, 4525, 5200, 5730, 6320, 6853, 7429, 7891, 8095, 8496, 9263, 9910, 10546, 11151, 11487, 11687, 12557, 13161, 13637]","[0, 216, 341, 431, 605, 733, 823, 1048, 1261, 1484, 1761, 1851, 2032, 2257, 2725, 2920, 3189, 3744, 3940, 4040, 4237, 4404, 5015, 5544, 5844, 6180, 6633, 7064, 7252, 7597]","[0, 172, 266, 376, 551, 641, 731, 866, 1190, 1280, 1566, 1656, 1891, 2120, 2484, 2942, 3165, 3385, 3800, 4100, 4299, 4645, 4812, 5106, 5308, 5761, 5937, 6077, 6520, 6616]",18334,14666,13637,7597,6616,2194,1103,-261,490,1409,4935,30,radiant
7623881615,36,4,129,86,123,"[0, 235, 596, 1020, 1494, 1993, 2324, 3035, 3421, 3869, 4712, 5185, 5572, 6225, 6812, 7446, 8353, 8728, 8823, 9072, 9502, 9954, 10796, 12027, 12748, 13526, 14360, 16203, 16875, 17479]","[0, 192, 424, 625, 784, 874, 1203, 1625, 2023, 2296, 2978, 3400, 4114, 4352, 4780, 5290, 5831, 6467, 6916, 7507, 8181, 8636, 8731, 9201, 9874, 10994, 12039, 13489, 14154, 14839]","[0, 263, 693, 976, 1286, 1454, 1913, 2083, 2372, 2822, 3215, 3391, 3840, 4348, 4742, 5207, 5730, 6233, 6365, 6581, 6739, 7044, 7510, 8070, 8376, 9006, 9245, 9656, 10386, 10705]","[0, 154, 854, 944, 1184, 1528, 2024, 2431, 2783, 3111, 3389, 3564, 3849, 4210, 4445, 4583, 4880, 4975, 5104, 5198, 5452, 5721, 6347, 7944, 8039, 8746, 9082, 9899, 10212, 10308]","[0, 154, 244, 350, 483, 573, 934, 1146, 1381, 1580, 1882, 1972, 2145, 2402, 2637, 2731, 3035, 3130, 3411, 3593, 3751, 4287, 4430, 4900, 5209, 6129, 6419, 7132, 7519, 7717]",17479,14839,10705,10308,7717,106,98,93,19,112,"[0, 390, 753, 1042, 1239, 1586, 1833, 2182, 2548, 2819, 3542, 3838, 4419, 4899, 5461, 5727, 6173, 6763, 8117, 9196, 10161, 11268, 12438, 12974, 13196, 13812, 13907, 14524, 15137, 16201]","[0, 234, 563, 851, 1027, 1191, 1690, 2096, 2223, 2712, 2997, 3314, 3404, 4451, 5168, 5641, 5886, 6741, 7272, 7649, 8860, 9568, 10118, 10774, 11246, 11638, 12421, 12515, 13454, 14285]","[0, 341, 539, 1043, 1438, 1665, 1834, 2475, 2885, 3309, 3731, 4057, 4646, 4976, 5713, 6288, 6547, 7264, 7899, 8466, 9224, 9732, 10478, 10820, 11481, 11714, 12276, 12488, 13402, 13938]","[0, 234, 324, 449, 539, 754, 1173, 1468, 1558, 1933, 2113, 2203, 2438, 3149, 3442, 3832, 4017, 4661, 5053, 5604, 6142, 6659, 7401, 7828, 8225, 8825, 8920, 9498, 9960, 10286]","[100, 378, 468, 640, 809, 1142, 1277, 1502, 1592, 1794, 2020, 2231, 2367, 2462, 2755, 3129, 3287, 3799, 4422, 5014, 5457, 6632, 7127, 7320, 7597, 7967, 8461, 9078, 9643, 9996]",16201,14285,13938,10286,9996,1278,554,-3233,22,-2279,-3658,30,dire
7623943100,48,22,23,21,62,"[0, 227, 600, 889, 1328, 1496, 1726, 2153, 2641, 3126, 3791, 4343, 4941, 5639, 6060, 6382, 7362, 7945, 8798, 9631, 11413, 12027, 12761, 13719, 14295, 15367, 17065, 17639, 17906, 18389]","[0, 337, 838, 1234, 1579, 2063, 2449, 2839, 3328, 3866, 4346, 5004, 5734, 6121, 6524, 7133, 7716, 8420, 8979, 9222, 9897, 10224, 10318, 10564, 11280, 11978, 12458, 13470, 14411, 15483]","[0, 227, 465, 837, 1239, 1365, 2109, 2654, 3232, 3719, 4297, 5039, 5257, 5913, 6448, 7060, 7937, 8399, 9239, 9482, 10198, 10702, 10971, 11301, 12334, 12803, 13913, 14471, 14913, 15492]","[0, 495, 585, 768, 1119, 1301, 1627, 1807, 1946, 2141, 2371, 2730, 3004, 3153, 3501, 3760, 4303, 5347, 6106, 6621, 7652, 8180, 8386, 8481, 8612, 9252, 10225, 10555, 11175, 11642]","[12, 263, 353, 443, 621, 790, 1013, 1251, 1365, 1522, 1672, 1762, 2040, 2201, 2539, 2746, 3002, 3121, 3517, 3902, 4744, 4929, 5112, 5207, 5593, 6503, 7243, 7609, 7876, 7972]",18389,15483,15492,11642,7972,95,112,43,88,5,"[0, 292, 535, 779, 1331, 1616, 1912, 2444, 2940, 3497, 4043, 4502, 5012, 5544, 6055, 6763, 7332, 8366, 9436, 10469, 10740, 11076, 11975, 13007, 13789, 14747, 15114, 15792, 16979, 17838]","[0, 321, 601, 892, 1360, 1450, 2023, 2402, 2819, 3425, 3726, 4354, 5058, 5354, 5725, 6375, 6888, 7529, 8084, 9223, 9642, 10539, 11162, 12096, 12547, 12994, 13216, 13840, 15006, 15820]","[0, 250, 608, 921, 1168, 1624, 2084, 2750, 3156, 3780, 4200, 4722, 5172, 5523, 6350, 6836, 7181, 7765, 8214, 8724, 8921, 9481, 10117, 10853, 10970, 11260, 11355, 12469, 13858, 14135]","[0, 170, 260, 394, 524, 782, 872, 1052, 1272, 1543, 1903, 2485, 2924, 3569, 3809, 4012, 4475, 5192, 5541, 5896, 6486, 6822, 7503, 8063, 8646, 9028, 9879, 10276, 10987, 11325]","[0, 170, 260, 350, 544, 634, 810, 990, 1080, 1508, 1893, 2173, 2380, 2664, 2995, 3198, 3341, 3887, 4465, 4567, 4669, 4836, 5074, 5726, 5992, 6230, 6762, 7252, 7860, 8143]",17838,15820,14135,11325,8143,551,-337,1357,317,-171,1717,30,dire
7624146019,109,13,96,65,79,"[0, 555, 930, 1289, 1637, 1924, 2484, 2871, 3324, 4041, 4684, 5360, 6236, 6840, 7756, 8689, 9551, 10054, 11334, 11748, 12680, 13695, 14931, 15968, 17049, 17216, 18427, 20157, 20692, 21313]","[0, 208, 469, 596, 977, 1320, 1701, 2149, 2564, 3339, 3920, 4278, 4566, 5351, 6049, 6658, 7306, 8049, 8450, 8834, 9646, 10162, 10355, 10758, 11215, 12101, 12675, 13591, 14175, 14440]","[0, 170, 521, 852, 1217, 1393, 1717, 2312, 2722, 3207, 3504, 4011, 4630, 5026, 5584, 6186, 6892, 7581, 7990, 8307, 9081, 9838, 10562, 10743, 11604, 12327, 13054, 13676, 13772, 13868]","[0, 239, 684, 822, 1005, 1502, 1682, 1846, 2030, 2327, 2800, 2944, 3180, 3274, 3669, 4124, 4623, 4983, 5119, 5320, 5732, 5928, 6095, 6608, 6955, 7820, 8169, 8686, 9033, 9129]","[0, 170, 290, 428, 558, 648, 828, 963, 1106, 1374, 1667, 1857, 2094, 2372, 2998, 3355, 3924, 4081, 4267, 4468, 4626, 4817, 4984, 5192, 5693, 5860, 5989, 6506, 6676, 6772]",21313,14440,13868,9129,6772,18,23,126,5,86,"[0, 202, 499, 754, 1176, 1544, 1911, 2340, 2961, 3586, 4596, 5013, 5524, 6863, 7612, 8394, 8845, 9679, 10397, 12076, 12980, 14232, 15348, 16659, 18076, 18542, 20046, 21416, 22404, 23575]","[0, 178, 769, 1098, 1478, 1803, 2036, 2414, 2969, 3238, 3746, 4397, 4883, 5468, 5718, 6242, 7715, 8344, 9038, 9973, 10507, 11170, 11586, 12182, 12848, 13229, 13820, 14184, 14617, 15240]","[0, 287, 573, 956, 1322, 1708, 2128, 2829, 3159, 3286, 3672, 4382, 5108, 5960, 6244, 6707, 7267, 7704, 8214, 8877, 9634, 10188, 10734, 11187, 12267, 12794, 13353, 14102, 14767, 15117]","[0, 130, 220, 407, 543, 680, 770, 982, 1133, 1301, 1860, 2060, 2540, 2885, 3241, 3438, 4147, 4513, 5026, 5676, 5866, 6171, 6785, 7399, 8268, 8956, 9236, 9770, 10235, 10549]","[0, 130, 311, 401, 540, 793, 883, 1018, 1108, 1198, 1435, 1721, 1899, 2437, 2677, 3153, 3925, 4130, 4385, 5144, 5434, 5823, 6301, 6680, 7566, 7767, 7972, 8431, 9036, 9511]",23575,15240,15117,10549,9511,-2262,-800,-1249,-1420,-2739,-8470,30,dire
7624389211,41,120,98,47,105,"[0, 285, 713, 961, 1303, 1522, 1987, 2333, 3038, 3418, 3918, 4298, 4739, 5398, 5699, 6520, 7163, 7774, 8375, 8766, 9041, 10636, 11903, 12554, 13437, 13922, 15306, 16367, 17095, 17525]","[0, 297, 620, 931, 1393, 1606, 2025, 2653, 3258, 3854, 4929, 5271, 6304, 7043, 7138, 7943, 8703, 9409, 10270, 10716, 11015, 12241, 12970, 13064, 13489, 14074, 15025, 15936, 16645, 17105]","[0, 247, 564, 796, 1519, 1865, 2231, 2656, 3053, 3290, 3659, 4248, 4755, 5669, 6146, 7410, 8131, 8919, 9178, 9713, 10018, 10857, 11708, 12053, 12460, 12555, 13294, 14584, 15293, 15727]","[0, 210, 300, 471, 758, 848, 1504, 1684, 2000, 2090, 2727, 3050, 3604, 3933, 4393, 4725, 5410, 6108, 6529, 6874, 7354, 8193, 8790, 9027, 9301, 9396, 9914, 10464, 10789, 11056]","[0, 210, 300, 406, 654, 744, 1321, 1501, 1926, 2270, 2581, 2725, 3196, 3525, 4174, 4776, 5266, 5424, 5684, 6024, 6445, 6878, 7308, 7601, 7828, 7954, 8660, 9400, 9577, 9808]",17525,17105,15727,11056,9808,10,76,96,52,5,"[60, 229, 656, 880, 1087, 1339, 1851, 2251, 2714, 3059, 3605, 4048, 4694, 5816, 6568, 7030, 7449, 8202, 9061, 10109, 11244, 11647, 12429, 12858, 13965, 15557, 15958, 16052, 16229, 16450]","[60, 315, 717, 1171, 1455, 1902, 2427, 2754, 3089, 3269, 3683, 4067, 4720, 5055, 5610, 6166, 6568, 7172, 7828, 8406, 8741, 8836, 9247, 9882, 10486, 10821, 11323, 12066, 12492, 12707]","[328, 693, 898, 1287, 1754, 2306, 2586, 3042, 3358, 3794, 4154, 4770, 4979, 5462, 5839, 6279, 6481, 6895, 7455, 8259, 8847, 9017, 9508, 9854, 10564, 11378, 11864, 12033, 12433, 12650]","[60, 255, 388, 552, 814, 1108, 1508, 1989, 2116, 2637, 3337, 3748, 4003, 5346, 5456, 5830, 5925, 6281, 6820, 7272, 7617, 7712, 7999, 8600, 9178, 9799, 10156, 10285, 10719, 11239]","[160, 355, 445, 552, 642, 751, 1085, 1423, 1513, 1790, 2547, 2667, 2957, 3642, 3807, 4085, 4180, 4324, 4673, 5207, 5758, 5853, 6234, 6505, 7048, 8037, 8371, 8673, 8894, 9119]",16450,12707,12650,11239,9119,1075,4398,3077,-183,689,9056,30,radiant
7624424306,95,19,28,66,9,"[0, 179, 470, 723, 1089, 1296, 1765, 2187, 2525, 2931, 3152, 3622, 4093, 4683, 5308, 5933, 6440, 7092, 7625, 7846, 8640, 9123, 10119, 10358, 11523, 12219, 13042, 14247, 14950, 15567]","[0, 169, 442, 772, 1210, 1385, 1681, 2228, 2568, 3289, 3465, 3814, 4265, 4650, 5227, 5656, 6026, 6670, 7012, 7564, 8210, 8550, 9372, 10009, 10201, 11162, 11605, 11835, 12229, 12437]","[0, 256, 576, 868, 1164, 1607, 2106, 2705, 3341, 3870, 4439, 4932, 5336, 5431, 5935, 6365, 6685, 7678, 8016, 8708, 9182, 9277, 9749, 10739, 11019, 11390, 12261, 12906, 13116, 13293]","[0, 130, 254, 392, 598, 688, 896, 1401, 1604, 1729, 2125, 2449, 2677, 2813, 3022, 3462, 3658, 3947, 4468, 4913, 5546, 5716, 6047, 6632, 7186, 7413, 7947, 8655, 9332, 10285]","[0, 130, 220, 310, 528, 1064, 1203, 1537, 1627, 1780, 1915, 2085, 2254, 2632, 2816, 3353, 3475, 4379, 4853, 5497, 5797, 5971, 6688, 7307, 7484, 8234, 8736, 9018, 9114, 9544]",15567,12437,13293,10285,9544,18,15,77,65,5,"[0, 210, 595, 799, 1166, 1525, 1773, 2054, 2350, 2736, 3408, 4040, 4774, 6239, 6985, 7475, 8323, 9031, 9672, 10068, 10791, 11320, 12197, 12644, 13402, 14288, 15643, 16342, 16710, 17829]","[0, 245, 479, 714, 1076, 1544, 1942, 2569, 2784, 3129, 3965, 4817, 5477, 6163, 6718, 7044, 7471, 8090, 8194, 8996, 10266, 10961, 12505, 12780, 13331, 13766, 14450, 14806, 15283, 16058]","[0, 298, 555, 935, 1151, 1482, 1956, 2325, 2780, 3090, 3583, 3941, 4707, 5205, 5578, 6197, 6892, 7388, 7890, 8747, 9829, 10881, 11696, 12260, 12536, 12882, 13609, 14195, 14503, 15064]","[0, 210, 338, 428, 518, 905, 995, 1326, 1451, 1681, 2554, 2856, 3163, 3709, 4132, 4809, 5363, 5872, 5966, 6743, 7215, 7431, 8197, 8680, 8974, 9312, 9654, 9911, 10007, 11072]","[0, 210, 300, 416, 554, 644, 734, 952, 1171, 1580, 1801, 2219, 2417, 2820, 3082, 3188, 3782, 4148, 4274, 4623, 5003, 5219, 5879, 5974, 6371, 6614, 7072, 7257, 7353, 7970]",17829,16058,15064,11072,7970,-2262,-3621,-1771,-787,1574,-6867,30,radiant
7624657601,13,21,1,19,102,"[0, 279, 651, 1128, 1541, 1964, 2348, 2786, 3699, 4140, 4664, 5111, 5545, 6570, 7607, 8353, 9630, 11252, 12017, 12309, 12646, 13775, 14701, 16047, 16759, 17024, 17709, 17804, 18813, 20050]","[0, 243, 607, 1073, 1474, 1835, 2321, 2901, 2991, 3443, 3891, 4315, 5088, 5925, 6787, 7274, 8772, 9478, 9677, 10329, 10727, 11383, 12589, 13401, 14069, 14903, 15412, 16092, 17060, 18350]","[0, 242, 442, 720, 1001, 1234, 1583, 1955, 2254, 2795, 3278, 4325, 4630, 5146, 5534, 6002, 6686, 7349, 8442, 9013, 10138, 10996, 12466, 13695, 14732, 15403, 16303, 16866, 17124, 17641]","[100, 319, 409, 529, 714, 864, 999, 1134, 1368, 1631, 1768, 2115, 2333, 2876, 3393, 3666, 4217, 5060, 5205, 5300, 5394, 6411, 6785, 7341, 7545, 8031, 8126, 8221, 8762, 9431]","[0, 170, 260, 380, 595, 685, 775, 957, 1085, 1268, 1392, 1718, 1808, 2094, 2525, 2820, 3418, 3974, 4069, 4443, 4672, 5343, 5920, 6476, 6735, 7000, 7095, 7190, 7448, 7946]",20050,18350,17641,9431,7946,10,123,71,39,101,"[0, 247, 589, 870, 1322, 1723, 2105, 2663, 3316, 3761, 4337, 4901, 5570, 6085, 6977, 7574, 7936, 8362, 9457, 10115, 10568, 10663, 10958, 11270, 11892, 13304, 14582, 15545, 16068, 16296]","[0, 366, 913, 1298, 1700, 2120, 2659, 3199, 3636, 4250, 4677, 5397, 5972, 6547, 7315, 7606, 7700, 8560, 8918, 9509, 10202, 10297, 11060, 11724, 12184, 13051, 13620, 14344, 14602, 14996]","[0, 294, 717, 1055, 1544, 2218, 2630, 3224, 3559, 3880, 4334, 4633, 5022, 5669, 6178, 6495, 6636, 7103, 7778, 8383, 8874, 8969, 9154, 9988, 11088, 11942, 12674, 13332, 13561, 13789]","[0, 170, 285, 375, 511, 754, 924, 1014, 1151, 1241, 1449, 1825, 1915, 2064, 2419, 2806, 3183, 3968, 4322, 4652, 5135, 5230, 5415, 5768, 6295, 6462, 7136, 7449, 7953, 8453]","[0, 170, 285, 375, 519, 720, 810, 947, 1325, 1464, 1723, 1867, 2075, 2208, 2593, 2688, 2782, 3192, 3489, 3647, 3788, 3883, 4068, 4163, 4547, 5035, 5359, 5710, 5806, 6034]",16296,14996,13789,8453,6034,3754,3354,3852,978,1912,13850,30,radiant
7624763717,10,15,137,86,103,"[0, 276, 634, 984, 1327, 1705, 1987, 2469, 2919, 3138, 3489, 3994, 4424, 5186, 5783, 6345, 7154, 7820, 8508, 9042, 9711, 10343, 11506, 12012, 12995, 13263, 14060, 14575, 15091, 15355]","[0, 264, 437, 773, 1332, 1793, 2164, 2509, 2933, 3219, 3887, 4611, 4879, 5126, 5829, 6196, 6815, 7366, 7949, 8267, 8601, 8933, 9900, 10338, 10528, 11329, 11965, 12502, 12884, 12980]","[0, 194, 501, 779, 1217, 1458, 1958, 2464, 3041, 3167, 4029, 4222, 4678, 5141, 5577, 5920, 6353, 6985, 7245, 7708, 8395, 8734, 9187, 9481, 10046, 10533, 11100, 11463, 11988, 12240]","[0, 248, 390, 518, 750, 840, 1151, 1412, 1533, 1933, 2305, 2771, 3226, 3487, 4014, 4227, 4442, 4745, 4980, 5380, 5775, 5901, 6147, 6505, 6859, 6954, 7154, 7432, 7528, 7682]","[0, 194, 284, 374, 522, 616, 706, 888, 978, 1230, 1607, 1996, 2086, 2347, 2693, 2787, 3059, 3217, 3359, 3571, 3800, 3895, 4295, 4389, 5147, 5242, 5538, 5633, 5776, 5920]",15355,12980,12240,7682,5920,54,120,69,33,105,"[0, 207, 560, 1040, 1370, 1821, 2232, 2854, 3382, 3930, 4482, 5154, 5867, 6446, 7028, 7812, 8673, 9405, 10146, 11086, 12049, 12857, 13588, 14310, 15417, 16220, 17192, 18204, 18850, 19841]","[0, 216, 381, 828, 1165, 1585, 1867, 2200, 2762, 3362, 3885, 4420, 5290, 5938, 6651, 7336, 7787, 8528, 8623, 9077, 9949, 10695, 11013, 11804, 12490, 13665, 14431, 15233, 15870, 16634]","[0, 292, 616, 909, 1223, 1556, 2023, 2442, 2887, 3350, 3836, 4443, 4901, 5550, 5858, 6533, 7284, 7719, 8204, 8931, 9593, 9864, 10945, 11566, 12191, 12771, 13330, 14687, 14831, 15603]","[0, 219, 309, 480, 673, 937, 1061, 1262, 1580, 1752, 2014, 2290, 2455, 3096, 3329, 3772, 4409, 4708, 4878, 5245, 5490, 5839, 6201, 6677, 6900, 7274, 8149, 8589, 8946, 9430]","[0, 169, 259, 719, 857, 947, 1135, 1317, 1456, 1958, 2375, 2734, 2999, 3302, 3477, 3804, 4058, 4265, 4460, 4630, 4875, 5045, 5263, 5624, 6051, 6715, 7017, 7435, 7857, 8219]",19841,16634,15603,9430,8219,-4486,-3654,-3363,-1748,-2299,-15550,30,dire
7624827905,38,20,53,107,51,"[0, 317, 720, 1039, 1579, 1866, 2501, 2743, 3552, 3812, 4311, 4841, 5404, 6008, 6985, 7173, 8255, 9370, 10085, 10840, 11261, 12198, 12330, 12863, 13778, 14432, 15552, 15832, 15928, 17077]","[0, 324, 488, 860, 1238, 1462, 1670, 1917, 2375, 2593, 3298, 3769, 4536, 5090, 5386, 5935, 6506, 7072, 7544, 8244, 8574, 8668, 8763, 9193, 9736, 10461, 12144, 12276, 12372, 12710]","[0, 195, 285, 375, 771, 861, 1094, 1259, 1559, 1729, 2043, 2322, 2614, 2939, 3324, 3779, 4293, 4786, 5109, 5802, 6295, 6498, 7127, 7517, 8269, 8824, 10003, 10713, 11007, 11960]","[0, 355, 574, 899, 1273, 1406, 1594, 1991, 2242, 2751, 3357, 3447, 3831, 4257, 5007, 5102, 5474, 5725, 6177, 6700, 7344, 7692, 7877, 8432, 9090, 9600, 10237, 10332, 10428, 10855]","[0, 295, 420, 510, 790, 880, 970, 1293, 1865, 2240, 2572, 2816, 3118, 3551, 4020, 4115, 4324, 4575, 4670, 5033, 5609, 5859, 6535, 6737, 6904, 7227, 7654, 7749, 7845, 8150]",17077,12710,11960,10855,8150,120,41,96,123,112,"[0, 332, 754, 1110, 1443, 1901, 2506, 2795, 3094, 3885, 4065, 4603, 5435, 6126, 7275, 7613, 8429, 9492, 10267, 11731, 12383, 13358, 13937, 14750, 15569, 16253, 17020, 18098, 18987, 19778]","[0, 207, 445, 745, 1111, 1482, 1823, 2206, 2386, 3140, 3368, 3985, 4416, 5003, 6011, 6550, 7159, 8060, 9155, 9606, 10132, 11007, 11926, 12823, 13568, 14508, 14770, 15546, 17731, 18302]","[0, 170, 1024, 1148, 1783, 1910, 2361, 3417, 3920, 4200, 4490, 5329, 5675, 6316, 6519, 6991, 7550, 7751, 8484, 8890, 9610, 10273, 10787, 11357, 12065, 12564, 13017, 13698, 14901, 15435]","[0, 170, 415, 505, 805, 895, 1210, 1401, 1787, 2007, 2306, 2543, 2971, 3455, 3774, 4179, 4706, 5210, 5669, 6686, 7148, 7809, 8672, 9014, 9675, 10204, 10578, 11190, 12398, 12888]","[0, 170, 260, 350, 488, 622, 761, 952, 1132, 1389, 1479, 1677, 1940, 2125, 2859, 3307, 3562, 3666, 4045, 4828, 5152, 5658, 6485, 6652, 7005, 7350, 7833, 8434, 9187, 9489]",19778,18302,15435,12888,9489,-2701,-5592,-3475,-2033,-1339,-15140,30,dire
7624854612,18,59,69,5,26,"[0, 294, 534, 982, 1352, 1793, 2284, 2724, 3471, 4094, 4641, 5397, 6282, 6620, 7068, 7707, 8229, 9265, 9840, 10706, 11872, 12328, 13325, 13700, 14714, 15329, 15994, 16866, 18430, 19454]","[0, 279, 654, 1076, 1370, 1753, 2452, 2908, 3455, 3786, 3876, 4424, 4961, 5427, 6057, 6643, 7307, 7814, 8386, 8833, 9194, 9568, 10315, 10715, 11229, 11651, 12393, 12841, 13678, 14396]","[0, 331, 582, 924, 1623, 1882, 2051, 2376, 2730, 3011, 3771, 3957, 4408, 4944, 5603, 5818, 6430, 7052, 7648, 8160, 8711, 9778, 10573, 11078, 11282, 11671, 11848, 12039, 13114, 13471]","[0, 170, 341, 466, 601, 735, 1150, 1269, 1418, 1591, 1681, 1938, 2417, 2512, 2660, 3015, 3366, 3572, 3870, 4448, 4847, 4953, 5434, 5719, 6048, 6441, 6535, 6704, 7314, 7564]","[0, 170, 340, 430, 634, 852, 991, 1205, 1340, 1430, 1780, 1870, 2348, 2443, 2638, 2733, 2883, 3254, 3396, 3554, 3739, 4078, 4289, 4601, 4850, 5035, 5129, 5224, 6103, 6289]",19454,14396,13471,7564,6289,54,120,129,100,110,"[0, 170, 545, 970, 1302, 2102, 2658, 3285, 3846, 4328, 5080, 5533, 6066, 6518, 7088, 7675, 8547, 9348, 10192, 10959, 11656, 12534, 13263, 14057, 15233, 15757, 16736, 17516, 17856, 18621]","[0, 289, 479, 724, 1022, 1200, 1598, 2166, 2608, 3180, 3702, 4063, 4777, 5513, 6298, 6695, 7213, 7686, 8343, 8693, 9131, 9403, 9867, 10353, 11144, 11777, 12118, 12663, 13491, 14389]","[0, 170, 593, 867, 1313, 1627, 2033, 2557, 3042, 3511, 4343, 4708, 5271, 5852, 6181, 6515, 7301, 7648, 8263, 8823, 9549, 9644, 10319, 11199, 11678, 11939, 12265, 12771, 13058, 13429]","[0, 170, 285, 375, 589, 679, 1053, 1301, 1436, 1665, 2007, 2097, 2346, 2549, 2890, 3191, 3554, 3672, 4059, 4473, 4766, 4936, 5240, 5670, 5950, 6303, 6472, 6818, 7664, 8241]","[0, 170, 285, 427, 597, 782, 1234, 1447, 1582, 2004, 2497, 2712, 3083, 3368, 3740, 4309, 4851, 5055, 5544, 5884, 6173, 6268, 6497, 6664, 6895, 7551, 7795, 8104, 8391, 8649]",18621,14389,13429,8241,8649,833,7,42,-677,-2360,-2155,30,dire
7624880815,15,96,112,100,88,"[78, 465, 778, 1041, 1404, 1777, 2102, 2421, 3097, 3489, 3820, 4333, 4517, 5043, 5535, 6129, 7054, 8142, 8840, 9647, 9955, 10891, 12001, 12206, 12983, 13632, 14241, 15098, 15496, 16997]","[78, 565, 877, 1194, 1556, 2089, 2563, 2845, 3181, 3509, 3826, 4387, 4925, 5387, 6045, 6815, 7977, 8482, 10085, 10243, 10338, 11030, 11759, 12306, 13680, 14314, 14927, 15660, 16291, 17375]","[211, 706, 1147, 1544, 1949, 2524, 2767, 3096, 3643, 3895, 4452, 4770, 5221, 5782, 6690, 7457, 9109, 9914, 10135, 10641, 10736, 11328, 12441, 13980, 14433, 15102, 15732, 15935, 16512, 16874]","[78, 360, 501, 817, 907, 1206, 1296, 1719, 1938, 2160, 2334, 2617, 2936, 3064, 3280, 3465, 4513, 4964, 5321, 5581, 5676, 6112, 6599, 6743, 7055, 7844, 8341, 8536, 8860, 10127]","[78, 289, 409, 548, 638, 1038, 1128, 1300, 1676, 1899, 2034, 2124, 2675, 2769, 3621, 3974, 4310, 4969, 5719, 6293, 6441, 6881, 7450, 7813, 8545, 9268, 9520, 9715, 10039, 10135]",16997,17375,16874,10127,10135,69,63,53,13,65,"[323, 853, 1131, 1537, 1934, 2269, 2711, 3086, 3709, 4090, 4988, 5461, 6033, 6669, 7313, 7898, 8500, 8777, 9707, 10266, 11225, 11471, 11934, 12555, 12761, 13130, 13684, 14702, 15579, 16037]","[55, 426, 670, 884, 1329, 1858, 2206, 2836, 3136, 3603, 4058, 4534, 5236, 5892, 6179, 6626, 7062, 7244, 7670, 8607, 9539, 10059, 10275, 11171, 12017, 12456, 13162, 13437, 14911, 15502]","[55, 559, 649, 788, 947, 1267, 1357, 1583, 2068, 2263, 2774, 3172, 3514, 3662, 4062, 4581, 5120, 5418, 6675, 7015, 7855, 8588, 9057, 10743, 11287, 11711, 12069, 13004, 13912, 14199]","[55, 597, 1002, 1282, 1652, 2030, 2282, 2614, 2831, 3355, 3867, 4453, 4771, 5218, 5741, 6240, 6755, 6920, 7914, 8447, 9111, 10077, 10390, 10784, 11341, 11716, 12594, 12995, 14031, 14318]","[55, 559, 649, 739, 962, 1289, 1379, 1767, 1902, 2384, 2618, 2930, 3364, 3765, 4160, 4315, 4665, 5044, 5826, 6189, 6378, 7077, 7300, 8596, 8903, 9259, 9832, 10470, 10922, 11018]",16037,15502,14199,14318,11018,960,1873,2675,-4191,-883,434,30,radiant
7625161613,15,10,96,123,86,"[0, 285, 722, 1053, 1470, 1937, 2447, 3215, 3570, 4080, 4512, 4970, 5569, 6230, 6648, 7181, 7484, 7792, 8678, 9217, 10186, 10435, 11024, 11571, 11944, 12644, 13419, 13514, 14126, 14878]","[0, 214, 373, 703, 1028, 1314, 1549, 1814, 2205, 2600, 2886, 3268, 3712, 4601, 5052, 5401, 5619, 6084, 6454, 7141, 8016, 8315, 8595, 9048, 9720, 10047, 11262, 11835, 12811, 13590]","[0, 314, 634, 871, 1246, 1443, 1926, 2323, 2499, 3059, 3465, 3817, 4212, 4567, 5099, 5406, 5741, 6283, 6776, 7038, 7390, 7485, 8336, 8516, 9154, 9378, 9937, 10395, 11006, 11102]","[0, 501, 591, 838, 1017, 1107, 1385, 1752, 1842, 1980, 2114, 2577, 2744, 3370, 3637, 3815, 3909, 4232, 4502, 4696, 5011, 5106, 5365, 5797, 6021, 6245, 6581, 6767, 7027, 7192]","[0, 233, 368, 635, 864, 1073, 1391, 1778, 2112, 2393, 2529, 3016, 3224, 3654, 4096, 4442, 4536, 4656, 4934, 5130, 5564, 5659, 5812, 6253, 6383, 6478, 6785, 7210, 7759, 7904]",14878,13590,11102,7192,7904,54,90,19,9,5,"[0, 280, 442, 794, 1004, 1362, 1700, 2006, 2471, 2928, 3417, 3582, 4189, 4848, 5520, 6303, 6945, 7679, 8321, 8831, 9698, 10839, 11423, 11891, 12609, 13618, 14889, 15847, 17559, 18413]","[0, 293, 645, 934, 1502, 1951, 2790, 3154, 3421, 3970, 4276, 4447, 4993, 5334, 5577, 6084, 6816, 7677, 7772, 8096, 8749, 9500, 10439, 10829, 11401, 12134, 13045, 14000, 14763, 14950]","[0, 209, 447, 916, 1162, 1890, 2182, 2547, 2939, 3267, 3827, 4042, 4469, 4601, 4957, 5392, 6013, 6562, 6657, 7221, 7665, 8110, 8826, 9495, 10117, 10578, 10967, 11472, 12070, 12533]","[0, 219, 355, 571, 661, 938, 1090, 1769, 2160, 2634, 2831, 2957, 3047, 3187, 4138, 4353, 4761, 5266, 5517, 5892, 6282, 7159, 7981, 8546, 8841, 9357, 9746, 10325, 11654, 12202]","[0, 170, 260, 492, 582, 748, 1016, 1106, 1196, 1416, 1733, 1861, 2182, 2276, 2635, 3039, 3895, 4271, 4408, 4992, 5230, 5996, 6351, 6581, 6675, 6880, 7085, 7669, 8117, 8320]",18413,14950,12533,12202,8320,-3535,-1360,-1431,-5010,-416,-11752,30,dire
7625218507,61,20,36,33,58,"[0, 169, 443, 674, 801, 1020, 1504, 1960, 2050, 2565, 2877, 3206, 4027, 4825, 5466, 5912, 6130, 6542, 7546, 8007, 8347, 9253, 9798, 10494, 11348, 12338, 13084, 15057, 15819, 16405]","[0, 328, 647, 1051, 1340, 1876, 2082, 2218, 2513, 3460, 4087, 4708, 5361, 5634, 5974, 6438, 6680, 7188, 7520, 8918, 9548, 10319, 11036, 11475, 12218, 12913, 13232, 14252, 14973, 15752]","[0, 290, 649, 897, 1033, 1245, 1612, 1953, 2418, 3007, 3743, 4605, 5339, 6124, 6901, 7295, 7592, 8378, 8979, 9231, 9942, 11052, 11607, 12355, 13063, 13965, 14060, 14749, 15193, 15329]","[0, 169, 259, 369, 478, 624, 925, 1102, 1324, 2335, 2673, 3249, 4115, 4319, 4556, 4672, 5135, 5505, 6211, 6704, 7010, 7979, 8400, 8845, 9303, 9942, 10112, 10905, 11375, 11678]","[0, 169, 259, 365, 494, 641, 854, 1039, 1129, 1417, 1767, 2089, 2811, 3210, 3477, 3573, 3791, 3969, 4159, 4411, 4721, 5288, 5814, 6314, 6978, 7388, 7936, 8422, 9311, 9690]",16405,15752,15329,11678,9690,10,126,49,71,79,"[0, 586, 983, 1236, 1555, 1979, 2491, 2617, 3072, 3541, 4055, 4539, 5330, 5913, 7090, 7631, 8645, 9296, 10164, 11072, 11959, 12376, 13748, 14477, 15197, 17136, 17977, 19192, 19288, 19921]","[0, 272, 467, 622, 1035, 1322, 1679, 2052, 2398, 2899, 3346, 3805, 4108, 4345, 4723, 5834, 7235, 8211, 8851, 9162, 9483, 9708, 10521, 10729, 11570, 12148, 13222, 14688, 15226, 15591]","[0, 169, 502, 910, 1106, 1442, 1765, 1963, 2674, 3315, 3868, 3958, 4557, 5188, 5446, 5924, 6989, 7374, 7787, 8524, 8619, 9006, 9339, 9783, 10254, 11154, 12199, 12929, 13025, 13284]","[0, 235, 377, 515, 605, 784, 1037, 1369, 1631, 2233, 2485, 2666, 2915, 3013, 3365, 3846, 4757, 5487, 5582, 6716, 7155, 7749, 8465, 8734, 9131, 9768, 10184, 10936, 11032, 11185]","[0, 169, 279, 399, 528, 790, 1131, 1710, 1935, 2467, 2602, 2728, 2818, 2971, 3260, 3949, 4771, 5290, 5433, 6273, 6591, 7226, 7646, 7788, 8007, 8529, 8898, 9783, 10002, 10402]",19921,15591,13284,11185,10402,-3516,161,2045,493,-712,-1529,30,dire
7625316506,73,10,37,104,112,"[0, 508, 1167, 1530, 2013, 2426, 3130, 3494, 4197, 4547, 5334, 6112, 6643, 7907, 8572, 9285, 10475, 12036, 12423, 12851, 13975, 15605, 16336, 17134, 17813, 18270, 19193, 20305, 21156, 22013]","[0, 312, 621, 942, 1254, 1740, 1987, 2296, 2422, 2761, 3140, 3543, 4064, 4471, 4821, 5166, 5665, 6344, 7130, 7823, 8623, 8982, 10072, 10307, 10596, 11306, 11920, 12829, 13265, 13524]","[0, 195, 285, 537, 707, 893, 983, 1140, 1397, 1684, 2215, 2428, 2622, 2860, 3554, 3794, 4530, 5204, 5970, 6288, 6695, 7813, 8240, 9664, 9878, 10293, 10388, 11713, 12042, 12462]","[0, 273, 864, 1241, 1879, 2169, 2572, 3165, 3788, 4381, 5115, 5556, 6468, 6768, 7013, 7586, 8120, 8956, 9933, 10173, 10534, 11134, 11594, 11689, 12021, 12726, 13300, 13711, 13806, 14930]","[0, 195, 353, 443, 1089, 1365, 1455, 1641, 2048, 2372, 2642, 2907, 3150, 3399, 3605, 3800, 4512, 5268, 5822, 6066, 6456, 6815, 7370, 7465, 7719, 7814, 8068, 8628, 8954, 9288]",22013,13524,12462,14930,9288,1,106,29,123,71,"[64, 317, 598, 961, 1186, 1683, 1968, 2292, 2956, 3321, 3707, 4197, 4944, 5604, 6924, 7550, 8385, 9250, 9345, 10163, 11454, 12626, 13428, 14487, 14653, 15974, 16518, 17832, 18471, 19491]","[64, 349, 670, 1158, 1482, 1810, 2270, 2699, 3264, 3619, 4189, 4452, 5063, 5425, 5786, 6231, 6782, 7120, 8024, 8636, 9268, 9508, 9840, 11300, 11501, 12365, 12948, 14007, 14524, 15021]","[64, 234, 545, 1099, 1504, 1801, 2287, 3044, 3810, 4423, 4820, 5541, 5974, 6453, 7061, 7637, 8057, 8542, 9196, 9833, 10571, 10811, 11150, 12555, 13475, 14065, 14343, 14934, 15139, 15809]","[332, 505, 625, 915, 1005, 1219, 1527, 1907, 2204, 2548, 2907, 3193, 3501, 3997, 4716, 4962, 5230, 5519, 6231, 6764, 7471, 7808, 8135, 9085, 9526, 10044, 10274, 11117, 11558, 11816]","[64, 234, 354, 479, 569, 1009, 1406, 1852, 2055, 2240, 2330, 2420, 2929, 3221, 4182, 4816, 5036, 5276, 5500, 5834, 6319, 6736, 6831, 7876, 8458, 8809, 9039, 9677, 10016, 10419]",19491,15021,15809,11816,10419,2522,-1497,-3347,3114,-1131,-339,30,radiant
7625543012,13,78,32,19,65,"[0, 212, 528, 929, 1210, 1664, 1996, 2443, 3001, 3343, 3973, 4696, 5213, 5558, 6206, 6499, 7012, 7867, 8641, 9741, 10245, 10841, 11954, 12349, 12813, 13557, 14360, 15161, 15657, 16342]","[0, 241, 401, 650, 774, 1137, 1379, 1881, 2435, 2779, 3246, 3978, 4431, 4979, 5548, 5893, 6628, 6991, 7918, 9423, 10017, 11124, 11659, 12210, 12973, 13477, 14211, 15596, 16158, 16735]","[0, 253, 554, 922, 1210, 1537, 1863, 2170, 2438, 2683, 3350, 3609, 3757, 4492, 5282, 5555, 5891, 6501, 6843, 7351, 7818, 8451, 9020, 9187, 9384, 10150, 10819, 11470, 12374, 12795]","[0, 215, 330, 420, 510, 679, 821, 1392, 1945, 2122, 2324, 2743, 2881, 3118, 3521, 3910, 4178, 4542, 4817, 5405, 5940, 6596, 7140, 7514, 7736, 8189, 8482, 8577, 9049, 9650]","[0, 270, 385, 519, 609, 844, 1052, 1363, 1785, 2010, 2228, 2812, 2902, 3087, 3591, 3813, 4046, 4371, 4559, 5237, 5605, 6203, 6616, 6895, 7231, 7689, 8086, 8995, 9172, 9343]",16342,16735,12795,9650,9343,48,23,60,79,5,"[0, 243, 475, 719, 1425, 1745, 2067, 2387, 2601, 3128, 3704, 3839, 4400, 4991, 5777, 6519, 7480, 8350, 9056, 9716, 10856, 11560, 12348, 13466, 14222, 15006, 15863, 16481, 18062, 19168]","[0, 243, 654, 1107, 1559, 1979, 2559, 3313, 4364, 4795, 5198, 5543, 6338, 6765, 7087, 7182, 8111, 8718, 9160, 9564, 10006, 10778, 10969, 11735, 12191, 12427, 12711, 12806, 13655, 13991]","[0, 292, 543, 702, 918, 1215, 1747, 2143, 2625, 2864, 3544, 4016, 4270, 4555, 4900, 5179, 5550, 6151, 6409, 7277, 7617, 8110, 8813, 9386, 9750, 10084, 10711, 11380, 11942, 12334]","[0, 169, 259, 349, 439, 564, 768, 948, 1128, 1264, 1737, 2201, 2610, 3021, 3419, 3514, 3970, 4450, 4583, 4778, 4873, 5135, 5229, 5510, 5814, 6195, 6613, 7269, 8174, 8380]","[0, 169, 355, 445, 651, 758, 848, 1111, 1336, 1463, 1688, 1823, 2146, 2377, 2623, 2718, 2985, 3268, 3456, 3960, 4233, 4431, 4712, 5135, 5283, 5378, 5593, 5893, 6151, 6620]",19168,13991,12334,8380,6620,-2826,2744,461,1270,2723,4372,30,radiant
7625796211,44,126,97,9,85,"[0, 336, 610, 1009, 1172, 1750, 2201, 2503, 3003, 3506, 3998, 4481, 4935, 5375, 6095, 6926, 7664, 8532, 9159, 9698, 10250, 11238, 12049, 12870, 13262, 14433, 15284, 15886, 16125, 17308]","[0, 249, 454, 629, 854, 1140, 1386, 1607, 1901, 2250, 2800, 3331, 3896, 4298, 4615, 5165, 5800, 6076, 6711, 7160, 7573, 8486, 9023, 9818, 10261, 10394, 10992, 11087, 11576, 12437]","[0, 327, 492, 790, 998, 1160, 1296, 1592, 1765, 2039, 2383, 2929, 3413, 4358, 5140, 5534, 6021, 6666, 7051, 7248, 7747, 7842, 8832, 9751, 9846, 10299, 10822, 11023, 11291, 11722]","[0, 301, 443, 533, 713, 803, 1305, 1405, 1544, 1709, 2015, 2151, 2407, 2648, 2802, 3135, 3425, 3617, 4219, 4651, 4976, 5579, 5788, 6569, 6664, 6759, 6883, 6978, 7074, 7388]","[0, 249, 391, 564, 654, 993, 1083, 1173, 1263, 1414, 1603, 1738, 2091, 2583, 2822, 2945, 3320, 3561, 3736, 4039, 4225, 4320, 4621, 5187, 5282, 5496, 5620, 5715, 5880, 6130]",17308,12437,11722,7388,6130,109,35,104,110,86,"[0, 138, 495, 912, 1201, 1483, 1928, 2499, 2885, 3488, 4117, 4553, 5170, 5806, 6316, 7004, 7464, 8120, 8891, 9618, 10694, 11034, 11438, 12600, 14013, 14768, 15832, 16813, 17832, 18550]","[0, 127, 376, 734, 1110, 1274, 1626, 2234, 2630, 3077, 3856, 4362, 5128, 5672, 6424, 7043, 7733, 8306, 8851, 9352, 9841, 10898, 11582, 12305, 12926, 13633, 14170, 14424, 14756, 15346]","[0, 210, 389, 735, 987, 1279, 1992, 2466, 2748, 3240, 3523, 3965, 4440, 4909, 5476, 5807, 6205, 6500, 7261, 7356, 8176, 8499, 9280, 9690, 10766, 11437, 11793, 11950, 12342, 12780]","[0, 89, 229, 367, 497, 587, 1041, 1224, 1367, 1482, 1738, 2198, 2727, 3084, 3277, 3781, 4144, 4486, 4856, 4951, 5311, 5704, 6153, 7010, 7469, 8073, 8540, 8750, 9120, 9372]","[0, 89, 312, 402, 604, 783, 967, 1102, 1370, 1575, 2016, 2296, 2682, 3085, 3606, 3905, 4427, 4757, 4935, 5178, 5383, 5726, 6005, 6502, 6732, 7159, 7468, 7616, 7906, 8083]",18550,15346,12780,9372,8083,-1242,-2909,-1058,-1984,-1953,-9146,30,dire
7626063506,73,97,13,21,5,"[0, 327, 775, 1083, 1562, 1945, 2363, 2563, 3513, 4008, 4685, 5303, 5727, 6379, 6774, 7562, 9099, 9998, 10804, 11861, 12828, 13294, 14597, 15413, 15508, 16654, 17528, 17623, 17756, 18341]","[0, 326, 536, 869, 1260, 1511, 1958, 2494, 2952, 3529, 4011, 4539, 5038, 5833, 6531, 7194, 7532, 8494, 9279, 10594, 11192, 12214, 13008, 13692, 14354, 14466, 14825, 15583, 16777, 17712]","[0, 367, 731, 1098, 1526, 1906, 2502, 2923, 3508, 3850, 4521, 4895, 5515, 6126, 6871, 7268, 8419, 8733, 9284, 10037, 10496, 11331, 11647, 12383, 12730, 12922, 13225, 13798, 14262, 14933]","[0, 170, 351, 657, 821, 962, 1161, 1407, 1602, 1906, 2292, 3032, 3338, 3487, 3582, 3811, 4322, 4647, 5133, 5749, 5844, 6186, 6499, 7061, 7412, 8304, 8587, 9300, 9893, 10204]","[0, 170, 602, 692, 856, 946, 1036, 1129, 1255, 1390, 1575, 1925, 2031, 2180, 2461, 2591, 3041, 3136, 3280, 3818, 3988, 4158, 4375, 5150, 5320, 5583, 5886, 6289, 6460, 6903]",18341,17712,14933,10204,6903,48,25,120,68,64,"[0, 244, 409, 743, 1249, 1776, 2278, 2730, 3315, 3847, 4415, 5233, 5762, 6452, 7259, 8044, 9661, 10930, 11625, 12623, 13627, 14536, 15793, 17077, 18138, 19165, 19632, 20496, 21709, 22739]","[0, 279, 616, 1034, 1359, 1693, 2034, 2545, 3021, 3812, 4800, 5278, 5747, 6176, 6520, 7030, 8437, 9091, 9829, 10954, 11665, 12668, 13345, 14412, 15820, 16490, 17218, 18276, 18965, 19291]","[0, 242, 532, 1019, 1588, 2004, 2582, 2965, 3569, 4079, 4577, 4787, 5300, 5862, 6321, 6898, 7904, 8334, 9173, 9534, 10184, 11129, 11868, 12135, 13404, 14036, 14971, 15963, 16593, 17146]","[0, 170, 260, 350, 533, 668, 877, 1029, 1227, 1363, 1583, 2059, 2149, 2389, 3023, 3295, 4070, 4255, 4906, 5501, 5999, 6272, 7012, 7355, 7655, 8123, 8632, 9373, 9610, 10146]","[0, 170, 260, 508, 668, 758, 938, 1074, 1298, 1485, 1682, 1957, 2047, 2142, 2568, 2818, 3003, 3299, 3554, 3711, 3882, 4222, 4656, 5138, 5835, 6168, 6455, 7253, 7671, 8024]",22739,19291,17146,10146,8024,-4398,-1579,-2213,58,-1121,-9253,30,dire
7626216408,85,10,23,71,72,"[0, 285, 654, 977, 1878, 2228, 2844, 3339, 3976, 4705, 5429, 6115, 6695, 7021, 7724, 8372, 9680, 10563, 10963, 11673, 12303, 13968, 14226, 14712, 15322, 15922, 16214, 17058, 18406, 18658]","[0, 324, 689, 1035, 1334, 1708, 2150, 2780, 3475, 3786, 4341, 4938, 5335, 5980, 6212, 6838, 7736, 8781, 9057, 10183, 10844, 11761, 12211, 12556, 13315, 13599, 14325, 14501, 16413, 16966]","[0, 329, 773, 1115, 1484, 1974, 2335, 2832, 3661, 4214, 4840, 5302, 6012, 6475, 7101, 7843, 8765, 9317, 10179, 10687, 11442, 12001, 12403, 12498, 13069, 14174, 14268, 14838, 16019, 16393]","[0, 169, 259, 349, 439, 726, 1005, 1233, 1579, 1793, 2093, 2330, 2420, 2608, 3104, 3600, 4202, 4923, 5190, 5529, 6052, 6860, 7376, 7602, 8302, 8748, 8842, 9018, 10010, 10408]","[0, 169, 259, 349, 642, 750, 1155, 1335, 1770, 2172, 2676, 3038, 3280, 3429, 3675, 4026, 4372, 4924, 5326, 5635, 5955, 6651, 7026, 7215, 7310, 7839, 8445, 8822, 9838, 10218]",18658,16966,16393,10408,10218,11,84,70,39,5,"[0, 318, 643, 1063, 1486, 1907, 2388, 3102, 3660, 4103, 4486, 4958, 5930, 6458, 7002, 7824, 8521, 10219, 10511, 11161, 12032, 12254, 12916, 14061, 15336, 16608, 17155, 18131, 18713, 18809]","[0, 278, 733, 1137, 1559, 1960, 2258, 2707, 2997, 3413, 4354, 4481, 6066, 6847, 7876, 9099, 9382, 9760, 10444, 11076, 11473, 12086, 12645, 13894, 15148, 15939, 16639, 17416, 18120, 18216]","[0, 246, 485, 1037, 1201, 1438, 1647, 1847, 2169, 2394, 2802, 3129, 3858, 4467, 5133, 5455, 5859, 6689, 7569, 7906, 8001, 8291, 8809, 9114, 10492, 11355, 12029, 13021, 13775, 14535]","[0, 169, 358, 584, 814, 1072, 1843, 2013, 2186, 2461, 2718, 3057, 3790, 4409, 4504, 5414, 5936, 6442, 6963, 7275, 7717, 7812, 8251, 9468, 10153, 10826, 11231, 11567, 11784, 12069]","[0, 169, 259, 402, 492, 706, 878, 1048, 1144, 1234, 1430, 1536, 1722, 2271, 2366, 2622, 3055, 3198, 3326, 3507, 3695, 3790, 4075, 4634, 5095, 5539, 5894, 6137, 6314, 6751]",18809,18216,14535,12069,6751,-151,-1250,1858,-1661,3467,2263,30,dire
7627919905,48,106,60,26,45,"[0, 282, 483, 682, 1078, 1260, 1774, 2301, 2755, 3124, 3666, 4228, 4953, 5767, 6616, 7375, 8253, 9002, 10017, 10111, 11148, 11846, 12681, 13300, 13988, 15122, 15217, 16240, 17523, 18273]","[0, 251, 651, 1046, 1487, 1857, 2235, 2992, 3458, 3983, 4814, 5036, 5790, 6381, 6861, 6956, 7124, 7463, 8233, 8366, 8867, 9309, 10160, 10541, 10786, 11911, 12006, 13320, 13930, 14326]","[0, 170, 407, 614, 900, 1041, 1296, 1470, 1665, 2137, 2938, 3385, 3728, 4276, 4531, 5000, 5295, 5781, 6140, 6495, 6956, 7332, 7814, 8506, 9091, 9296, 9551, 10747, 11374, 11714]","[0, 170, 260, 395, 485, 575, 791, 1052, 1330, 1548, 1978, 2521, 2695, 2924, 3019, 3268, 3362, 3578, 3782, 3876, 4156, 4326, 4496, 4687, 4952, 5727, 5897, 6611, 6809, 7171]","[0, 170, 260, 350, 488, 616, 909, 1147, 1493, 1664, 2056, 2218, 2568, 2859, 3010, 3105, 3290, 3478, 4043, 4137, 4386, 4608, 4738, 4993, 5352, 5596, 5743, 6975, 7146, 7546]",18273,14326,11714,7171,7546,35,120,96,86,5,"[326, 568, 882, 1167, 1459, 2331, 2715, 3238, 3797, 4275, 4732, 4945, 5609, 6453, 7254, 7886, 9103, 9798, 11075, 11872, 12584, 13115, 14123, 14874, 15635, 17202, 18231, 18325, 18422, 19951]","[58, 304, 625, 914, 1292, 1708, 2379, 2634, 3357, 3905, 4664, 5219, 5872, 6653, 7397, 8254, 8954, 9150, 10150, 10499, 11008, 11608, 12180, 12440, 13258, 14661, 15473, 16073, 16827, 17855]","[58, 228, 556, 999, 1512, 1877, 2043, 2263, 2841, 3456, 4274, 5221, 5631, 6139, 6878, 7563, 8286, 8628, 9623, 10022, 10670, 10981, 11512, 11957, 12340, 12978, 13918, 14222, 14640, 15026]","[58, 228, 318, 666, 1026, 1304, 1480, 1721, 1811, 2057, 2327, 2471, 2561, 2885, 3497, 3646, 3973, 4428, 5399, 5666, 5949, 6749, 7469, 7563, 7782, 8619, 9232, 9326, 9557, 10831]","[58, 228, 318, 671, 846, 1107, 1246, 1457, 1547, 1727, 1997, 2210, 2446, 2826, 3089, 3402, 3836, 3970, 4269, 4992, 5330, 5825, 6301, 6663, 6957, 7532, 8216, 8385, 8557, 9465]",19951,17855,15026,10831,9465,-1678,-3529,-3312,-3660,-1919,-14098,30,dire
7628030316,95,98,106,53,86,"[0, 194, 469, 825, 1227, 1391, 1652, 2069, 2496, 2947, 3302, 3683, 4348, 5168, 5635, 6178, 6894, 7955, 8982, 9684, 10677, 12019, 12431, 13786, 14790, 15660, 16556, 17274, 18932, 20395]","[0, 265, 473, 1030, 1353, 1992, 2396, 2900, 3432, 3853, 4204, 4953, 5455, 6085, 6883, 7296, 8083, 8399, 9098, 9987, 10767, 11853, 12782, 13340, 14125, 14586, 15305, 15955, 16947, 17919]","[0, 271, 526, 776, 1234, 1644, 2099, 2585, 3036, 3776, 4075, 4330, 4826, 5489, 5940, 6153, 7090, 7551, 8464, 8980, 9075, 9588, 10041, 10495, 11207, 11864, 12849, 13573, 15559, 16312]","[0, 194, 284, 418, 508, 641, 731, 953, 1043, 1433, 1534, 1668, 2073, 2337, 2531, 2729, 3108, 3417, 4317, 4616, 4872, 5648, 5889, 6467, 6956, 7432, 8102, 8353, 9662, 10846]","[0, 242, 332, 455, 639, 904, 994, 1216, 1306, 1396, 1544, 1704, 1848, 2195, 2388, 2634, 2839, 3111, 3623, 3878, 4184, 4760, 4926, 5184, 5504, 5709, 6463, 6677, 7584, 8079]",20395,17919,16312,10846,8079,54,129,47,123,105,"[0, 169, 671, 922, 1286, 1450, 1904, 2240, 2577, 3137, 3663, 4259, 4769, 5624, 6007, 6489, 7079, 7693, 8466, 9179, 9808, 10666, 11567, 12114, 12281, 13477, 14490, 15385, 15648, 15744]","[0, 250, 584, 887, 1329, 1624, 1871, 2345, 2711, 2972, 3377, 3729, 4187, 4455, 4780, 5540, 5987, 7072, 7557, 8033, 8826, 9945, 10345, 11544, 12172, 12778, 13443, 13835, 13931, 15000]","[0, 249, 412, 643, 1135, 1532, 1817, 2202, 2565, 2950, 3123, 3881, 4292, 4724, 5070, 5351, 5509, 6181, 6483, 6852, 7294, 7831, 8302, 8678, 9286, 9898, 10189, 10558, 10834, 11230]","[0, 169, 309, 480, 650, 1005, 1095, 1568, 1702, 2197, 2332, 2553, 2757, 3071, 3348, 3965, 4281, 4821, 4953, 5277, 5796, 6002, 6323, 6746, 7215, 7434, 7724, 8217, 8792, 9319]","[0, 169, 330, 499, 728, 818, 991, 1291, 1381, 1775, 2037, 2316, 2797, 3368, 3549, 3862, 4509, 5275, 5539, 5760, 6458, 7377, 7754, 8441, 8877, 9119, 9484, 9827, 10383, 10554]",15744,15000,11230,9319,10554,4651,2919,5082,1527,-2475,11704,30,radiant
7628117703,48,22,129,45,79,"[0, 300, 545, 859, 1181, 1522, 1898, 2107, 2302, 2649, 2999, 3641, 4143, 4776, 5337, 5840, 6436, 7075, 7597, 7850, 8823, 9391, 10226, 11148, 12236, 13220, 13629, 13949, 14679, 15434]","[0, 573, 911, 1281, 1601, 1926, 2618, 3205, 3587, 3973, 4106, 4534, 5054, 5666, 5887, 6548, 6895, 6990, 7179, 7472, 7846, 8440, 8914, 9588, 10311, 10797, 11122, 11495, 11822, 12826]","[0, 226, 462, 874, 1170, 1451, 1659, 1868, 2452, 2790, 3126, 3471, 3561, 3957, 4103, 4576, 4912, 5251, 6046, 6318, 6744, 7221, 7956, 8604, 9292, 9387, 9482, 9702, 10326, 10672]","[0, 190, 280, 445, 582, 690, 869, 1107, 1197, 1373, 1463, 1610, 1898, 2648, 2743, 3250, 3344, 3605, 4148, 4242, 4530, 4683, 4826, 5324, 5810, 6012, 6309, 6403, 6543, 6688]","[0, 190, 280, 446, 552, 688, 908, 1043, 1180, 1362, 1719, 2136, 2357, 2452, 2547, 2802, 2950, 3045, 3140, 3234, 3364, 3459, 3554, 3858, 4129, 4429, 4744, 5016, 5187, 5358]",15434,12826,10672,6688,5358,54,96,107,138,9,"[0, 247, 597, 1048, 1370, 1788, 2168, 2648, 2924, 3367, 4278, 4826, 5367, 6237, 6848, 7856, 8777, 9401, 9994, 10793, 11595, 12422, 12715, 13764, 14700, 15564, 16609, 17310, 18080, 19329]","[0, 210, 478, 752, 1206, 1871, 2238, 2738, 3570, 4032, 4439, 4796, 5626, 6260, 6565, 6940, 7362, 7748, 8299, 8728, 9251, 9879, 10247, 11147, 11390, 11780, 12206, 12338, 12675, 13769]","[0, 249, 535, 846, 1137, 1507, 1962, 2492, 2949, 3679, 4204, 4818, 5289, 5894, 6152, 6485, 7291, 7523, 8038, 8739, 9310, 9561, 9728, 10315, 10971, 11398, 11829, 12320, 12663, 13319]","[0, 212, 352, 442, 646, 1045, 1214, 1574, 1972, 2407, 2878, 3541, 3862, 4595, 5218, 5996, 6655, 7120, 7840, 8766, 9451, 9565, 9869, 10393, 10891, 11236, 11861, 12104, 12624, 13704]","[0, 212, 302, 652, 806, 957, 1047, 1519, 1746, 2042, 2459, 2747, 3156, 4194, 4442, 4942, 5643, 6196, 6581, 7012, 7599, 7950, 8117, 8531, 8783, 9108, 9518, 9927, 10186, 11208]",19329,13769,13319,13704,11208,-3895,-943,-2647,-7016,-5850,-20351,30,dire
7629210704,123,12,100,47,121,"[0, 235, 524, 878, 1048, 1392, 1741, 2157, 2596, 2936, 3506, 4116, 4555, 4863, 5596, 6306, 7219, 7924, 8753, 9808, 10594, 11027, 11691, 12509, 13437, 14429, 15333, 15746, 16841, 17145]","[0, 167, 419, 803, 1478, 1765, 2228, 2777, 3162, 3721, 4468, 4945, 5519, 6197, 7179, 7650, 8354, 9197, 9595, 10560, 11478, 12187, 13208, 13783, 14404, 14956, 15936, 17398, 17979, 18075]","[0, 200, 290, 492, 582, 936, 1026, 1244, 1750, 2418, 2972, 3554, 3766, 4331, 4664, 5147, 5660, 6256, 6502, 7834, 8106, 8290, 8495, 9434, 10567, 11416, 11822, 12296, 12948, 13292]","[0, 200, 399, 707, 995, 1843, 2088, 2619, 2852, 3179, 3619, 3972, 4569, 5138, 5476, 5742, 6453, 6821, 7658, 8382, 8580, 9195, 9744, 10238, 11343, 11718, 12024, 12364, 12995, 13195]","[0, 468, 645, 800, 1336, 1426, 2007, 2181, 2321, 2775, 3345, 3610, 3968, 4117, 4452, 4683, 5020, 5631, 5825, 6794, 7205, 7346, 7484, 7803, 8988, 9155, 9724, 9819, 10386, 10482]",17145,18075,13292,13195,10482,129,49,13,58,109,"[0, 444, 875, 1273, 1756, 1966, 2415, 2874, 3546, 3877, 4687, 5162, 5342, 6183, 6781, 7295, 7619, 7939, 8873, 9371, 9629, 10235, 11004, 11378, 12498, 12921, 13369, 14385, 15261, 16192]","[0, 209, 550, 862, 1157, 1617, 2145, 2647, 3007, 3378, 4001, 4127, 4906, 5395, 5746, 6233, 6955, 7055, 7745, 8375, 8882, 9276, 9842, 10445, 10813, 11820, 12408, 13089, 13681, 15446]","[0, 319, 712, 1056, 1594, 2048, 2416, 2749, 3377, 4033, 4357, 4845, 5270, 5664, 6171, 6911, 7263, 7732, 8698, 9098, 9577, 10049, 11011, 11277, 11919, 12336, 12594, 12689, 13796, 14222]","[100, 414, 539, 629, 823, 957, 1093, 1284, 1628, 1962, 2169, 2583, 3084, 3365, 3545, 3957, 4346, 4551, 4928, 5201, 5296, 5475, 6159, 6669, 7032, 7422, 7685, 7780, 8084, 9705]","[0, 276, 401, 696, 873, 1037, 1229, 1329, 1797, 1931, 2101, 2323, 2623, 3433, 3639, 3949, 4263, 4756, 5143, 5301, 5468, 5704, 5870, 5965, 6180, 6755, 7369, 7523, 7656, 9325]",16192,15446,14222,9705,9325,953,2629,-930,3490,1157,7299,30,dire
7629309712,18,65,47,79,19,"[0, 275, 645, 780, 1025, 1309, 1803, 2140, 2593, 3308, 3797, 4508, 5191, 5804, 6996, 7952, 8943, 10297, 10878, 11885, 12515, 13906, 14866, 15252, 15853, 16521, 18115, 19420, 20257, 21445]","[0, 275, 546, 883, 1164, 1492, 2044, 2441, 3122, 3787, 4259, 4713, 5144, 5563, 6123, 6533, 7309, 8101, 8773, 9635, 9999, 10982, 11758, 12198, 12428, 13221, 13906, 14643, 15665, 16436]","[0, 170, 397, 691, 922, 1202, 1666, 2053, 2247, 2827, 3210, 3671, 3977, 4363, 4971, 5499, 5928, 6393, 6963, 7391, 7674, 8156, 8858, 9629, 10186, 10669, 10979, 11416, 11807, 13010]","[0, 170, 325, 454, 562, 699, 836, 971, 1061, 1358, 1724, 1869, 2292, 2694, 3483, 3773, 4103, 4535, 4802, 5103, 5802, 6357, 6755, 7043, 7418, 7724, 8084, 8596, 8940, 10230]","[0, 170, 285, 421, 556, 706, 796, 1017, 1107, 1619, 1754, 2057, 2147, 2385, 2719, 3044, 3395, 3762, 3920, 4265, 4734, 5401, 5715, 6051, 6356, 6598, 7104, 7885, 8439, 8871]",21445,16436,13010,10230,8871,95,25,23,9,105,"[0, 619, 929, 1255, 1525, 1936, 2217, 2538, 3062, 3445, 4007, 4483, 4976, 5808, 6265, 7183, 7635, 8387, 9036, 9549, 9936, 10275, 11059, 12296, 13284, 14003, 14846, 15338, 15867, 17357]","[0, 320, 563, 857, 1096, 1716, 2133, 2681, 3277, 3449, 3959, 4515, 5217, 5767, 6489, 7001, 7608, 8540, 8899, 9634, 10453, 11177, 11856, 11950, 12453, 13222, 13801, 14274, 15094, 15686]","[0, 170, 323, 572, 815, 1169, 1469, 1840, 2368, 2477, 2861, 3281, 4005, 4382, 4774, 5121, 5499, 5855, 6146, 6754, 7435, 7933, 8220, 8314, 8940, 9475, 9570, 9917, 10059, 10661]","[0, 235, 421, 511, 644, 883, 1095, 1251, 1769, 1955, 2077, 2221, 2482, 3089, 3526, 3884, 4134, 4437, 4580, 4980, 5438, 5533, 6022, 6515, 7055, 7439, 7633, 7844, 8194, 8733]","[0, 235, 325, 676, 766, 942, 1032, 1122, 1379, 1868, 2085, 2229, 2354, 2753, 2923, 3166, 3260, 3618, 3805, 3962, 4152, 4247, 4342, 4494, 4816, 4983, 5509, 5765, 5906, 6690]",17357,15686,10661,8733,6690,4088,750,2349,1497,2181,10865,30,radiant
7629815312,46,96,126,110,105,"[0, 299, 667, 1076, 1406, 1801, 2239, 2764, 3197, 3637, 4327, 4946, 5638, 6280, 6887, 7919, 8886, 9733, 10753, 11155, 11250, 11753, 12624, 13295, 14086, 14754, 15133, 16120, 16815, 17820]","[0, 372, 643, 1337, 1610, 2168, 2646, 2813, 3276, 3647, 4103, 4545, 5504, 5915, 6497, 7066, 7541, 7962, 8688, 8997, 9565, 9951, 10655, 11386, 11571, 11834, 11928, 12808, 13472, 14086]","[0, 400, 866, 1241, 1582, 1945, 2373, 2665, 3231, 3746, 4281, 4453, 4939, 5426, 5863, 6336, 6703, 7196, 7754, 8226, 8321, 8662, 9091, 9288, 9616, 9711, 9805, 10649, 10745, 11156]","[0, 250, 340, 512, 855, 945, 1240, 1330, 1420, 1709, 1940, 2157, 2617, 2883, 3470, 3824, 4156, 4451, 4717, 5285, 5601, 5991, 6315, 6759, 6854, 6949, 7043, 7377, 7473, 7569]","[0, 250, 340, 506, 616, 771, 861, 1240, 1426, 1669, 1901, 1991, 2253, 2516, 2744, 3166, 3324, 3839, 4018, 4280, 4699, 4892, 5022, 5117, 5212, 5432, 5746, 5879, 6107, 6480]",17820,14086,11156,7569,6480,10,135,13,58,79,"[0, 127, 413, 736, 1246, 1725, 2054, 2731, 3126, 3636, 4343, 5050, 6373, 7177, 7918, 8911, 9854, 10576, 11429, 12074, 12992, 13736, 14688, 15759, 16425, 18005, 19173, 20319, 21452, 22611]","[0, 176, 510, 800, 1176, 1679, 1978, 2738, 3042, 3610, 3984, 4699, 5557, 6031, 7042, 7729, 8462, 8932, 9699, 11038, 12468, 13148, 14353, 15181, 15534, 16107, 17204, 18076, 18774, 19519]","[0, 251, 491, 962, 1335, 1655, 2284, 2672, 3178, 3356, 3674, 4186, 4552, 5288, 6254, 6870, 7219, 7737, 8163, 8494, 9278, 9902, 10394, 11404, 11653, 12532, 13274, 14149, 14961, 15333]","[0, 90, 180, 274, 404, 534, 780, 1294, 1389, 1816, 2083, 2629, 3116, 3419, 3829, 4014, 4432, 4750, 4974, 5749, 6373, 6549, 6753, 7132, 7252, 7702, 8424, 8682, 9438, 9712]","[0, 90, 180, 270, 400, 742, 832, 1221, 1311, 1451, 1646, 2088, 2813, 3052, 3363, 3772, 4155, 4250, 4462, 5084, 5628, 5941, 6247, 6675, 6770, 7324, 7610, 7744, 7966, 8214]",22611,19519,15333,9712,8214,-4791,-5433,-4177,-2143,-1734,-18278,30,dire
7629875506,76,78,41,65,20,"[0, 287, 503, 667, 976, 1378, 1865, 2339, 2821, 3271, 3651, 3741, 4120, 4469, 4942, 5669, 6319, 6533, 6924, 7233, 7808, 8613, 9450, 10061, 10786, 11784, 12321, 13249, 14020, 15021]","[0, 251, 886, 1120, 1410, 1611, 2088, 2212, 2862, 3375, 3947, 4412, 4858, 5257, 5817, 6115, 6637, 7001, 7877, 8222, 8852, 9445, 10077, 10639, 11336, 12004, 13425, 13724, 14358, 14930]","[0, 283, 449, 725, 1000, 1280, 1527, 1732, 1971, 2442, 2714, 2899, 3480, 3821, 4254, 4697, 5074, 5670, 6061, 6699, 7310, 7979, 8459, 9578, 10188, 10629, 11682, 12094, 13152, 13754]","[0, 170, 333, 423, 559, 660, 1355, 1445, 1794, 2114, 2305, 2576, 2845, 3435, 3886, 4256, 4759, 4853, 5033, 5705, 5868, 6483, 7351, 7509, 7886, 8453, 9084, 9417, 9594, 9690]","[0, 170, 304, 515, 605, 695, 913, 1244, 1334, 1529, 1665, 1886, 2248, 2928, 3057, 3423, 3827, 3951, 4342, 4756, 5032, 5894, 6323, 7021, 7169, 7589, 8283, 8644, 9446, 9920]",15021,14930,13754,9690,9920,48,22,98,5,21,"[0, 170, 473, 706, 866, 1302, 1774, 2086, 2389, 2891, 3199, 3742, 4356, 4698, 5368, 6152, 6788, 7560, 7894, 8692, 9795, 10558, 11478, 12470, 13324, 13847, 16156, 17069, 17895, 19027]","[0, 322, 650, 897, 1360, 1904, 2283, 2696, 3663, 4233, 4794, 5865, 6463, 7328, 7936, 8426, 8953, 10460, 11321, 12166, 13062, 13370, 13992, 14741, 15466, 16040, 16630, 17555, 18652, 19144]","[0, 208, 537, 904, 1308, 1743, 2167, 2494, 2858, 3479, 4068, 4590, 5078, 5927, 6562, 7018, 7999, 8545, 9487, 10390, 11398, 11839, 12516, 13463, 14026, 14968, 15612, 16214, 17055, 17968]","[0, 170, 310, 619, 886, 1024, 1286, 1530, 1736, 1951, 2086, 2739, 3032, 3630, 3879, 4069, 4381, 4833, 5167, 5640, 5937, 6155, 6436, 6639, 7032, 7175, 7854, 8367, 8798, 9188]","[0, 170, 260, 398, 609, 843, 1080, 1170, 1387, 1566, 1777, 2279, 2523, 2725, 2938, 3310, 3733, 4123, 4574, 5329, 5603, 5773, 5981, 6259, 6682, 6952, 7449, 8288, 8794, 9262]",19027,19144,17968,9188,9262,-4006,-4214,-4214,502,658,-11274,30,dire
7630006507,54,69,106,79,5,"[0, 205, 717, 1082, 1557, 1789, 2338, 3048, 3440, 3885, 4288, 4950, 5750, 6418, 6814, 7288, 7726, 8717, 9285, 10194, 10481, 10743, 11897, 13011, 13584, 14058, 14605, 15359, 15937, 17965]","[0, 275, 597, 842, 1561, 1852, 2468, 2835, 3249, 3795, 4383, 4980, 5660, 6243, 6905, 7287, 8095, 8922, 9761, 10410, 11015, 11312, 11672, 12329, 13055, 13310, 14106, 15013, 15269, 16544]","[0, 295, 661, 1000, 1326, 1735, 2268, 2557, 3056, 3146, 3685, 3946, 4210, 4698, 4792, 5270, 5797, 6562, 7007, 7831, 8295, 8709, 9223, 9467, 9752, 9891, 10480, 10756, 10896, 11660]","[0, 213, 527, 617, 854, 944, 1386, 1476, 1809, 1899, 1989, 2219, 2527, 2704, 3141, 3259, 3380, 3917, 4130, 4272, 4485, 4580, 4746, 4939, 5167, 5341, 5435, 5881, 6025, 7456]","[0, 169, 382, 472, 647, 737, 930, 1133, 1223, 1362, 1452, 1633, 1960, 2231, 2487, 2582, 2677, 3080, 3293, 3542, 3637, 3783, 3949, 4044, 4139, 4234, 4421, 4942, 5113, 5982]",17965,16544,11660,7456,5982,113,13,23,62,21,"[0, 207, 513, 865, 1225, 1518, 1906, 2451, 2763, 3399, 4001, 4352, 4876, 5415, 6168, 7108, 7782, 8740, 9415, 10502, 11409, 12614, 13998, 14617, 15648, 18123, 19326, 20604, 22922, 24686]","[0, 257, 513, 880, 1293, 1713, 2063, 2558, 3163, 3873, 4391, 4815, 5426, 5830, 6482, 7115, 7706, 8013, 8504, 8662, 10099, 10845, 11802, 12499, 13162, 14309, 15699, 16739, 17830, 18076]","[0, 169, 549, 888, 1337, 1873, 2081, 2393, 2847, 3022, 3338, 4002, 4615, 5043, 5683, 6818, 7771, 7910, 8643, 9246, 10040, 10395, 10996, 11181, 11690, 12953, 13242, 13915, 14428, 15159]","[0, 169, 660, 792, 1228, 1758, 1905, 2090, 2225, 2496, 2676, 2766, 3047, 3188, 3640, 3805, 4026, 4133, 4227, 4385, 4741, 5226, 5392, 5487, 5784, 6868, 7349, 7908, 8511, 9472]","[0, 169, 360, 693, 943, 1033, 1482, 1827, 1962, 2374, 2652, 2776, 3029, 3234, 3860, 4279, 4671, 4814, 5133, 5649, 6119, 6452, 6618, 6913, 7143, 7864, 8297, 8779, 9147, 9964]",24686,18076,15159,9472,9964,-6721,-1532,-3499,-2016,-3982,-17750,30,dire
7630218506,18,74,61,52,91,"[0, 256, 629, 929, 1295, 1585, 1986, 2392, 2873, 3179, 3954, 4424, 4909, 5662, 6407, 6756, 8014, 8802, 9512, 10085, 10791, 11419, 12214, 13055, 13912, 14731, 14964, 15244, 16110, 16286]","[0, 209, 569, 901, 1180, 1396, 1679, 2058, 2573, 3208, 3691, 4073, 4389, 4839, 5078, 5251, 5678, 6295, 6825, 7179, 7274, 8191, 9013, 9790, 10401, 11052, 11768, 12828, 13567, 13663]","[0, 245, 511, 674, 1070, 1424, 1682, 2164, 2336, 2655, 3162, 4164, 4689, 5266, 5991, 6582, 7316, 7551, 8145, 8384, 8968, 9433, 10718, 11120, 11840, 12402, 12722, 13169, 14120, 14561]","[0, 170, 260, 350, 460, 595, 705, 1041, 1300, 1390, 1695, 2023, 2728, 3171, 3371, 3677, 3835, 4295, 4605, 4919, 5194, 5658, 6075, 6336, 6577, 6913, 7132, 7702, 8522, 9011]","[0, 170, 260, 350, 574, 746, 910, 1246, 1422, 1759, 1983, 2196, 2522, 2815, 3142, 3272, 3475, 3570, 3711, 3805, 4465, 4676, 5173, 5313, 5456, 5578, 5673, 5857, 6162, 6258]",16286,13663,14561,9011,6258,21,2,56,79,100,"[0, 332, 691, 1146, 1564, 1935, 2256, 2692, 2991, 3576, 4004, 4671, 4928, 5415, 5977, 6672, 7240, 7728, 8244, 9009, 9970, 10364, 10651, 10999, 11951, 12367, 13556, 14337, 14904, 15532]","[0, 240, 624, 934, 1274, 1527, 1730, 2481, 3134, 3586, 4292, 4852, 5520, 5877, 6188, 7163, 7493, 8184, 9197, 10375, 10688, 11209, 11558, 12745, 13373, 13946, 15748, 16251, 16529, 16909]","[0, 170, 404, 656, 873, 1605, 1817, 2252, 2540, 3068, 3659, 3803, 4245, 4700, 5111, 5374, 5648, 5953, 6290, 7137, 7364, 8149, 8542, 9155, 9588, 10071, 11209, 11897, 12451, 12703]","[0, 170, 336, 426, 565, 720, 847, 1135, 1353, 1845, 2070, 2523, 2757, 3135, 3343, 3548, 3881, 4242, 4851, 5513, 6168, 6679, 7139, 7357, 7701, 8388, 9334, 9832, 10084, 10255]","[0, 170, 298, 435, 525, 685, 832, 1060, 1198, 1473, 1828, 1981, 2161, 2291, 2499, 2923, 3239, 3578, 3789, 4212, 4525, 4620, 5081, 5487, 5784, 5879, 6588, 6907, 7378, 7474]",15532,16909,12703,10255,7474,754,-3246,1858,-1244,-1216,-3094,30,dire
7630340902,113,109,49,84,57,"[0, 205, 605, 936, 1234, 1460, 1630, 1833, 2109, 2688, 3137, 3227, 3912, 4427, 4536, 6020, 6644, 7433, 7676, 8297, 8494, 9016, 9355, 10927, 11022, 11282, 11536, 12506, 13025, 13121]","[0, 249, 522, 648, 934, 1101, 1344, 1788, 1976, 2501, 2963, 3303, 4153, 4560, 4708, 5078, 5707, 6208, 6778, 7296, 7773, 7976, 8504, 9361, 9979, 11165, 11550, 12176, 12630, 12726]","[0, 202, 465, 745, 1108, 1362, 1782, 1947, 2227, 2528, 2703, 3125, 3455, 3604, 3699, 4052, 4492, 4669, 4856, 5227, 5508, 5875, 6156, 6449, 6713, 7977, 8071, 8373, 8665, 8761]","[0, 129, 258, 396, 532, 622, 843, 1016, 1154, 1380, 1470, 1560, 1650, 1889, 1984, 2078, 2413, 2554, 2648, 3257, 3907, 4002, 4096, 4518, 4773, 5815, 6229, 6369, 6862, 7015]","[0, 129, 325, 430, 565, 655, 833, 923, 1013, 1344, 1434, 1573, 1800, 1949, 2078, 2685, 2843, 2972, 3279, 3548, 3895, 3990, 4084, 4419, 4872, 5057, 5151, 5435, 5866, 5962]",13121,12726,8761,7015,5962,41,74,81,26,20,"[0, 245, 483, 681, 1042, 1416, 1580, 1982, 2343, 2884, 3422, 3993, 4406, 4963, 5292, 6333, 6969, 7918, 8718, 9543, 10296, 11423, 12594, 13422, 14114, 15727, 16514, 16870, 17586, 18764]","[331, 663, 944, 1312, 1537, 1834, 2182, 2652, 3056, 3448, 4063, 4806, 5220, 5869, 6425, 6735, 7442, 8052, 8891, 9219, 10708, 11411, 12430, 12789, 13284, 14281, 14683, 15650, 16157, 17891]","[63, 307, 508, 949, 1079, 1670, 2080, 2329, 2627, 2796, 3421, 4248, 4625, 4720, 5360, 5911, 6612, 7065, 7547, 7948, 8489, 9153, 10289, 10621, 10969, 11673, 12501, 13112, 13715, 14879]","[63, 375, 465, 599, 695, 879, 1013, 1103, 1193, 1362, 1728, 2026, 2245, 2568, 2834, 3296, 3916, 4186, 4755, 5011, 5939, 6340, 7144, 7532, 7865, 8597, 8884, 9434, 9870, 11415]","[63, 272, 362, 452, 542, 891, 981, 1140, 1275, 1492, 1771, 2074, 2182, 2614, 2830, 3308, 3608, 3766, 4102, 4398, 4994, 5227, 5673, 6081, 6445, 6899, 7128, 7484, 7850, 9098]",18764,17891,14879,11415,9098,-5643,-5165,-6118,-4400,-3136,-24462,30,dire
7630469716,18,13,31,96,26,"[0, 584, 817, 1308, 1509, 1836, 2374, 2770, 3059, 3840, 4527, 5100, 6056, 6764, 7479, 8027, 9242, 9982, 11745, 12557, 12919, 13759, 14678, 15536, 16170, 16719, 17283, 17631, 17737, 18203]","[0, 287, 567, 823, 965, 1370, 1684, 2013, 2435, 3145, 3723, 3948, 4740, 5349, 6495, 6842, 7508, 8193, 9201, 9590, 10182, 10680, 11236, 11577, 12095, 12432, 12607, 13978, 14074, 15228]","[0, 234, 324, 414, 550, 658, 831, 1061, 1391, 1740, 1972, 2584, 2835, 3187, 3541, 3697, 4406, 4501, 5270, 5546, 5910, 6153, 6449, 6935, 7346, 7629, 7870, 8321, 8487, 8922]","[0, 346, 484, 689, 1190, 1350, 1640, 2184, 2508, 2750, 3248, 3510, 3808, 4075, 4506, 4861, 5467, 5982, 6346, 6834, 7122, 7603, 7844, 8122, 8470, 8700, 8875, 9201, 9297, 9758]","[0, 234, 324, 626, 831, 970, 1105, 1240, 1330, 1677, 1856, 2081, 2368, 2808, 3206, 3568, 4313, 4408, 5320, 5541, 5686, 6000, 6238, 6443, 7193, 7423, 7598, 7814, 7910, 8126]",18203,15228,8922,9758,8126,52,44,137,121,20,"[0, 209, 582, 767, 1139, 1433, 1969, 2402, 3014, 3318, 3614, 4100, 4357, 4613, 4949, 5257, 6559, 7108, 7208, 7871, 8898, 9546, 10075, 10438, 10925, 11479, 12520, 13021, 14485, 15007]","[0, 170, 481, 1218, 1508, 1818, 2152, 2433, 2963, 3391, 3837, 4465, 4811, 5729, 6167, 6803, 7948, 8637, 9524, 10405, 11518, 12446, 13229, 14144, 15000, 15926, 16382, 16751, 19030, 19763]","[0, 206, 405, 572, 815, 941, 1215, 1563, 2069, 2192, 2370, 2551, 3083, 3225, 3854, 4113, 5038, 5493, 5587, 6419, 6698, 7226, 7863, 8271, 8924, 9224, 9867, 10520, 11664, 12286]","[0, 270, 360, 560, 650, 740, 830, 1010, 1406, 1496, 1679, 1833, 2063, 2292, 2386, 2795, 2953, 3215, 3309, 3467, 3562, 3657, 3751, 3846, 4031, 4258, 4573, 4869, 5619, 5796]","[0, 170, 260, 518, 608, 709, 799, 993, 1228, 1414, 1525, 1654, 2064, 2159, 2253, 2348, 2781, 2907, 3001, 3325, 3792, 3947, 4226, 4321, 4506, 4601, 4866, 5073, 5899, 6175]",15007,19763,12286,5796,6175,3196,-4535,-3364,3962,1951,1210,30,dire
7630544602,56,29,126,37,123,"[0, 240, 852, 1184, 1458, 1818, 2047, 2421, 2585, 3064, 3665, 4204, 4410, 5307, 5823, 7062, 7854, 8515, 8771, 9353, 9508, 9603, 10938, 11750, 12802, 14198, 15351, 16546, 16642, 18277]","[0, 246, 565, 797, 1006, 1578, 1973, 2345, 2737, 3305, 3902, 4578, 5037, 5552, 6043, 6751, 7302, 7874, 8217, 8860, 9293, 10265, 11062, 11679, 12316, 13319, 14585, 15257, 15353, 16535]","[0, 257, 527, 865, 1325, 1771, 2233, 2670, 3035, 3290, 3784, 4744, 5138, 5820, 6383, 6655, 7298, 7660, 7924, 8504, 9452, 10288, 11130, 11624, 12520, 13132, 13317, 14215, 14311, 15504]","[0, 169, 406, 521, 646, 871, 1036, 1259, 1349, 1544, 1797, 2516, 2739, 3362, 3766, 4101, 5007, 5397, 5492, 5673, 6021, 6727, 7368, 8165, 9331, 10032, 11127, 12081, 12361, 13587]","[0, 221, 311, 448, 573, 727, 945, 1170, 1305, 1819, 2032, 2612, 2834, 3291, 3431, 3669, 4348, 4527, 4982, 5139, 5508, 6042, 6675, 7164, 7671, 8095, 8438, 8959, 9512, 11194]",18277,16535,15504,13587,11194,44,69,22,19,109,"[0, 208, 535, 697, 1306, 1622, 1932, 2396, 2960, 3145, 3616, 3792, 4389, 4759, 5238, 5879, 6255, 6983, 7490, 8308, 8929, 9682, 10282, 11276, 11589, 12077, 12524, 14095, 14191, 15042]","[0, 207, 481, 811, 1111, 1353, 1518, 1897, 2564, 2974, 3384, 3597, 4051, 4416, 4944, 5561, 6375, 6630, 7316, 8142, 8813, 9092, 9213, 9627, 10465, 11679, 12484, 13693, 14238, 14916]","[0, 257, 575, 987, 1326, 1753, 2049, 2895, 3333, 4040, 4830, 5178, 5529, 6043, 6791, 7208, 7495, 8148, 8528, 9108, 9502, 10354, 10555, 10975, 11175, 11784, 12393, 13427, 13985, 14394]","[0, 169, 262, 372, 462, 659, 783, 1170, 1364, 1684, 1990, 2358, 2592, 2871, 3179, 3407, 3709, 4198, 4468, 4694, 4954, 5124, 5542, 5711, 5881, 6820, 7321, 9495, 9736, 10135]","[0, 169, 259, 437, 613, 743, 1132, 1387, 1709, 1921, 2270, 2728, 2957, 3236, 3774, 3963, 4058, 4153, 4579, 5170, 5674, 6126, 6221, 6315, 6600, 6986, 7131, 7895, 7991, 8611]",15042,14916,14394,10135,8611,3235,1619,1110,3452,2583,11999,30,radiant
7630871702,41,97,13,9,79,"[0, 287, 533, 975, 1232, 1430, 1848, 2129, 2527, 2827, 3374, 3718, 4194, 4656, 4784, 5418, 6056, 6604, 7544, 8243, 8927, 9369, 10257, 10850, 11700, 12625, 12990, 13918, 14529, 15987]","[0, 198, 480, 738, 1109, 1436, 1919, 2363, 2863, 3454, 4069, 4551, 5344, 5684, 6075, 6741, 7679, 8531, 9069, 9670, 10140, 10802, 11177, 11968, 12597, 13601, 13696, 14361, 14766, 16105]","[0, 216, 378, 704, 1069, 1360, 1640, 1915, 2207, 2724, 3104, 3551, 3743, 4362, 4745, 5149, 5800, 6257, 6953, 7343, 7859, 8428, 9234, 9957, 10189, 10994, 11613, 11958, 12635, 12731]","[0, 130, 255, 345, 687, 827, 961, 1338, 1428, 1650, 1828, 1985, 2120, 2534, 2923, 3370, 3591, 4033, 4281, 4635, 4884, 5296, 5557, 5905, 6239, 6609, 6704, 7108, 7661, 8446]","[0, 130, 220, 398, 573, 782, 1005, 1095, 1315, 1513, 1691, 1872, 2187, 2436, 2530, 2812, 3033, 3682, 3825, 3967, 4062, 4468, 4890, 5199, 5366, 5811, 5906, 6094, 6449, 6750]",15987,16105,12731,8446,6750,1,52,135,45,138,"[0, 277, 597, 925, 1405, 1650, 1929, 2634, 2964, 3425, 4171, 4614, 5133, 5699, 6457, 7291, 8012, 8778, 9476, 10569, 11750, 12753, 12937, 13888, 14776, 15868, 17844, 18942, 20267, 21389]","[0, 397, 764, 1127, 1576, 1794, 2298, 2938, 3457, 3668, 4341, 5082, 5721, 6166, 6889, 7378, 8084, 8711, 9217, 9798, 10464, 11062, 12887, 13280, 13658, 14672, 15563, 16178, 16653, 17254]","[0, 277, 442, 696, 990, 1363, 1488, 1989, 2398, 2763, 3598, 4014, 4734, 5047, 5416, 5848, 6375, 6973, 7611, 8557, 9043, 9138, 9948, 10649, 11275, 11830, 12311, 12715, 13061, 13563]","[0, 545, 635, 725, 855, 945, 1035, 1260, 1350, 1440, 1737, 2002, 2549, 2644, 2922, 3017, 3454, 3596, 3904, 4217, 4468, 4638, 5284, 5503, 5808, 6303, 6940, 7293, 7589, 7984]","[0, 277, 367, 595, 770, 860, 950, 1470, 1560, 1662, 2236, 2425, 2650, 2923, 3193, 3318, 3526, 3660, 3754, 4199, 4375, 4470, 5529, 5697, 5974, 6435, 6632, 6837, 7071, 7391]",21389,17254,13563,7984,7391,-5402,-1149,-832,462,-641,-7562,30,dire
7631360009,25,96,126,5,72,"[0, 313, 767, 1020, 1547, 2036, 2596, 2875, 3087, 3340, 3945, 4991, 6205, 7060, 8469, 9161, 10267, 11040, 11829, 13083, 14155, 15046, 16176, 17123, 17715, 19134, 20436, 22074, 23358, 24865]","[0, 215, 538, 901, 1439, 1808, 2363, 2832, 3350, 3881, 4360, 4829, 5442, 6102, 6475, 7186, 8087, 8344, 8794, 9142, 10124, 10379, 11142, 11936, 12351, 13121, 13717, 14191, 15113, 16129]","[0, 357, 573, 949, 1389, 2019, 2590, 2970, 3842, 4634, 5212, 5696, 6289, 7039, 7705, 8368, 9098, 9691, 10326, 10545, 11045, 11421, 11805, 12504, 13099, 13681, 14492, 15112, 15929, 16512]","[0, 235, 393, 522, 739, 869, 999, 1227, 1602, 1766, 2076, 2211, 2684, 3049, 3689, 3910, 4387, 4659, 4900, 5105, 5579, 5858, 6100, 6808, 7419, 7901, 8181, 8557, 9832, 10371]","[0, 503, 608, 715, 873, 1082, 1453, 1775, 1997, 2366, 2786, 3012, 3589, 4220, 4510, 4692, 5034, 5342, 5500, 5705, 6108, 6357, 6524, 6979, 7125, 7913, 8218, 8827, 10118, 10559]",24865,16129,16512,10371,10559,10,98,90,86,83,"[0, 204, 469, 673, 976, 1298, 1630, 2039, 2411, 2777, 3073, 3653, 4374, 4771, 5334, 5913, 6780, 7385, 8115, 8537, 9348, 10185, 10812, 11494, 12283, 12832, 13318, 13700, 14438, 14957]","[0, 241, 515, 832, 1084, 1309, 1486, 2160, 2738, 3347, 3824, 4433, 5575, 6026, 6597, 7113, 7828, 8435, 8872, 9267, 10065, 10592, 10997, 11581, 12065, 12732, 13524, 14196, 14292, 14553]","[0, 282, 604, 953, 1121, 1432, 1753, 2075, 2165, 2873, 3473, 3914, 4538, 4850, 5351, 5939, 6457, 6807, 7261, 7628, 8558, 9343, 10086, 10523, 11192, 11460, 11555, 12006, 12317, 12973]","[0, 170, 260, 510, 874, 1071, 1397, 1701, 1916, 2256, 2391, 2865, 3096, 3642, 3772, 3921, 4079, 4332, 4467, 4673, 4921, 5369, 5779, 6017, 6442, 6541, 6680, 6865, 7340, 7436]","[0, 170, 275, 446, 619, 840, 930, 1399, 1614, 1793, 1928, 2215, 2457, 2605, 2737, 2998, 3201, 3358, 3506, 3666, 3914, 4134, 4332, 4433, 4577, 4678, 4869, 5062, 5479, 5655]",14957,14553,12973,7436,5655,9908,1576,3539,2935,4904,22862,30,radiant
7631440012,53,23,38,65,9,"[0, 257, 516, 898, 1336, 1568, 2014, 2432, 2603, 3163, 3437, 4086, 4561, 5391, 6479, 6891, 7690, 7961, 8383, 8889, 9583, 9919, 10014, 10694, 12039, 12510, 13382, 14391, 14866, 15775]","[0, 333, 643, 967, 1459, 1870, 2287, 2470, 2771, 3411, 3826, 4150, 4955, 5434, 5957, 6525, 7260, 7841, 8334, 9030, 9524, 10126, 10548, 11070, 11805, 12491, 12848, 12942, 13249, 13586]","[0, 296, 445, 750, 1211, 1576, 1858, 2228, 2480, 3004, 3427, 3988, 4412, 5072, 5506, 5903, 6289, 6560, 6996, 7283, 7485, 7963, 8996, 9507, 9836, 10503, 10881, 11096, 11455, 11767]","[0, 553, 668, 758, 940, 1049, 1264, 1399, 1489, 1817, 2159, 2285, 2772, 2942, 3315, 3546, 3812, 4093, 4227, 4410, 4696, 4890, 5391, 5782, 6271, 6717, 7081, 7345, 7642, 8383]","[0, 285, 459, 637, 874, 1226, 1568, 2013, 2103, 2273, 2515, 2605, 2889, 3104, 3368, 3737, 4054, 4404, 4499, 4594, 4944, 5220, 5423, 5700, 6098, 6481, 6576, 7086, 7679, 8302]",15775,13586,11767,8383,8302,18,15,137,19,121,"[0, 205, 697, 863, 1151, 1661, 2172, 2664, 3394, 3737, 4510, 5189, 6013, 7579, 8232, 8860, 9587, 11432, 12268, 13675, 14890, 16331, 17198, 18497, 19274, 20335, 21460, 22307, 23596, 24393]","[0, 209, 530, 792, 956, 1540, 2027, 2282, 2823, 3305, 3749, 3962, 4539, 4891, 5300, 5744, 6560, 7234, 8116, 8546, 9284, 9583, 10239, 11200, 11629, 12137, 12702, 13110, 13585, 14063]","[0, 298, 733, 990, 1365, 1650, 2307, 2823, 3550, 3865, 4414, 5353, 5908, 6325, 6854, 7530, 7918, 8362, 9091, 9520, 10311, 10516, 11005, 11352, 11742, 12378, 12997, 13526, 13931, 14694]","[0, 170, 306, 396, 519, 751, 1063, 1198, 1943, 2033, 2537, 2855, 2945, 3715, 4176, 4606, 5061, 5953, 6212, 6779, 7481, 7911, 8559, 9469, 9843, 10302, 10676, 11230, 11661, 12199]","[0, 170, 421, 562, 680, 810, 1063, 1486, 1722, 1857, 2158, 2570, 3090, 3768, 3958, 4353, 4734, 5602, 6131, 6349, 6862, 7112, 7494, 8052, 8338, 8826, 9309, 9515, 10174, 10841]",24393,14063,14694,12199,10841,-8618,-477,-2927,-3816,-2539,-18377,30,dire
7631686902,35,2,41,86,111,"[0, 288, 562, 975, 1391, 1776, 1911, 2298, 2425, 2764, 3187, 3790, 4638, 5555, 6006, 7120, 7597, 7957, 8681, 9549, 10383, 11294, 12490, 13732, 14856, 15284, 16505, 17287, 17879, 18346]","[0, 246, 528, 855, 1137, 1766, 2035, 2510, 2901, 3249, 3806, 4271, 4942, 5437, 5854, 6794, 7339, 7769, 9072, 9904, 11183, 11609, 12269, 12887, 13746, 14269, 14894, 15620, 15931, 16268]","[0, 317, 478, 804, 968, 1296, 1657, 1827, 1962, 2180, 2677, 3391, 3638, 4159, 4679, 5200, 5376, 5792, 6266, 7280, 8221, 8615, 9624, 10817, 11110, 12001, 12765, 13347, 14187, 14799]","[0, 210, 300, 486, 622, 760, 913, 1179, 1269, 2091, 2455, 2748, 3293, 3540, 4037, 4923, 5105, 5320, 6095, 6882, 7667, 8377, 9001, 9509, 10082, 10369, 11336, 11601, 12045, 12493]","[0, 210, 300, 438, 528, 726, 861, 1078, 1445, 1959, 2133, 2267, 2712, 2908, 3291, 3585, 3680, 3898, 4554, 5386, 5812, 6389, 7060, 7326, 7965, 8131, 8712, 8950, 9260, 9585]",18346,16268,14799,12493,9585,46,25,43,71,50,"[0, 249, 563, 1019, 1233, 1614, 2000, 2414, 2953, 3599, 4431, 5046, 5536, 6479, 7165, 7298, 8746, 9695, 10575, 11468, 12269, 12363, 12725, 13561, 14623, 15006, 16097, 17380, 18258, 19107]","[0, 253, 553, 1002, 1457, 1726, 2156, 2698, 3023, 3607, 3965, 4736, 5300, 6256, 6956, 7692, 8458, 9402, 9660, 9906, 10101, 10779, 11578, 11745, 12182, 13167, 13739, 14105, 14936, 15754]","[0, 215, 579, 866, 1316, 1769, 2184, 2585, 2961, 3498, 4571, 5064, 5664, 5978, 6504, 7077, 7842, 8434, 8900, 9256, 9745, 9839, 10256, 10865, 12951, 13706, 14130, 14488, 15022, 15376]","[0, 130, 220, 345, 435, 525, 874, 1035, 1207, 1548, 1992, 2089, 2179, 2631, 2779, 2975, 3633, 3891, 4117, 4275, 4427, 4721, 4949, 5206, 5472, 6020, 6424, 6624, 6966, 7264]","[0, 130, 571, 665, 755, 892, 1065, 1202, 1339, 1519, 1789, 1977, 2067, 2298, 2446, 2541, 3027, 3247, 3342, 3524, 3859, 4028, 4198, 4440, 5048, 5314, 5484, 5759, 6101, 6487]",19107,15754,15376,7264,6487,-761,514,-577,5229,3098,7503,30,radiant
7632105811,126,15,43,21,100,"[0, 289, 523, 745, 1145, 1402, 1769, 2245, 2943, 3344, 3653, 4050, 4537, 5519, 6194, 6920, 7527, 7901, 8745, 9058, 9876, 10499, 11203, 11997, 12698, 13117, 13400, 14063, 14240, 14879]","[0, 208, 473, 816, 1446, 2016, 2572, 3208, 3584, 4227, 4809, 5286, 5857, 6242, 7125, 7823, 8452, 9065, 9611, 10375, 11204, 11845, 12539, 13292, 13780, 14546, 14747, 15371, 16025, 16662]","[0, 416, 751, 1257, 1434, 1921, 2353, 2863, 3373, 3906, 4426, 4806, 5662, 6164, 6815, 7384, 8169, 8479, 8927, 9084, 9649, 9957, 10744, 11180, 11633, 12499, 12693, 13123, 13656, 14288]","[0, 244, 334, 505, 595, 732, 1097, 1425, 1641, 1788, 2143, 2561, 2771, 3437, 3803, 4082, 5033, 5684, 6234, 6736, 7089, 7437, 8130, 8872, 9114, 9393, 9577, 10256, 10529, 10625]","[100, 270, 395, 529, 691, 901, 1071, 1347, 1481, 1652, 1845, 2196, 2502, 2910, 3193, 3426, 3835, 4005, 4493, 5074, 5307, 5477, 5790, 6118, 6288, 6529, 6699, 7224, 7476, 7861]",14879,16662,14288,10625,7861,25,52,96,90,5,"[62, 388, 542, 869, 1130, 1258, 1504, 2179, 2651, 3075, 3661, 4245, 4588, 5131, 5686, 6366, 7117, 8500, 9360, 11129, 12008, 13056, 14094, 14948, 15736, 16208, 16805, 17756, 18784, 19781]","[330, 623, 978, 1272, 1644, 2053, 2505, 2640, 3191, 3519, 4117, 5287, 5743, 6240, 6849, 7217, 7657, 8652, 9004, 10469, 10855, 11715, 12304, 13202, 13919, 14559, 15262, 15673, 16951, 17961]","[62, 232, 622, 855, 1450, 1586, 1710, 1845, 2157, 2445, 2625, 2760, 3328, 3681, 3922, 4246, 4424, 4685, 4779, 5236, 5798, 6532, 7007, 7268, 7961, 8602, 8874, 9149, 9666, 10098]","[162, 332, 447, 584, 847, 937, 1108, 1243, 1333, 1423, 1656, 1887, 2138, 2527, 2806, 3092, 3390, 3933, 4229, 4831, 4970, 5576, 6218, 6533, 6981, 7337, 7636, 7911, 8777, 9402]","[62, 232, 347, 482, 572, 662, 786, 1145, 1235, 1325, 1544, 1756, 2007, 2323, 2554, 2649, 2955, 3329, 3423, 4025, 4257, 4735, 4968, 5153, 5655, 6017, 6222, 6317, 6413, 6775]",19781,17961,10098,9402,6775,-4902,-1299,4190,1223,1086,298,30,dire
7632217207,73,97,77,86,121,"[0, 395, 735, 1165, 1548, 1845, 2062, 2423, 2991, 3684, 4655, 5235, 5599, 6027, 6507, 7401, 8785, 9250, 10463, 11399, 12893, 13701, 14318, 14481, 15345, 16352, 17379, 18029, 18986, 19365]","[0, 359, 609, 1152, 1721, 2121, 3040, 3578, 4339, 4851, 5198, 5878, 6563, 7056, 7735, 7951, 8234, 8586, 9394, 10010, 11257, 12455, 12550, 13471, 13801, 13930, 14411, 14622, 15347, 15868]","[0, 205, 478, 757, 927, 1326, 1766, 2044, 2327, 2971, 3388, 3543, 4167, 5013, 5449, 5852, 6120, 6215, 6642, 7000, 7544, 8073, 8459, 8742, 9327, 9502, 9955, 10412, 10997, 11494]","[0, 504, 809, 1022, 1192, 1357, 1955, 2090, 2228, 2508, 2771, 3024, 3366, 3552, 3824, 4394, 4770, 5111, 5632, 6061, 6749, 7066, 7340, 7801, 8131, 8360, 8813, 9326, 9789, 10039]","[0, 236, 393, 793, 963, 1128, 1365, 1865, 1955, 2135, 2270, 2562, 2697, 2846, 3026, 3121, 3357, 3452, 3779, 4622, 5433, 5824, 5919, 6366, 6933, 7028, 7481, 7610, 7912, 8008]",19365,15868,11494,10039,8008,38,76,129,21,103,"[0, 282, 521, 723, 968, 1343, 1625, 2155, 2559, 3618, 4024, 5010, 5862, 6495, 7263, 8019, 8792, 10108, 10539, 11204, 11447, 12016, 14474, 15137, 15419, 17233, 17738, 18648, 18944, 20794]","[0, 268, 583, 874, 1327, 1734, 1892, 2250, 2672, 3017, 3390, 3958, 4390, 4798, 5409, 6122, 6719, 7888, 8704, 8938, 9320, 9695, 11103, 12733, 13124, 14471, 15105, 15927, 16460, 17704]","[0, 205, 411, 748, 1100, 1463, 1690, 1780, 1965, 2502, 2905, 3278, 3486, 4241, 4580, 4921, 5150, 5388, 5845, 6210, 6907, 7627, 8704, 9465, 9806, 10416, 12208, 13163, 13551, 15003]","[21, 190, 575, 710, 866, 1035, 1167, 1257, 1347, 1561, 1744, 2452, 2993, 3547, 3935, 4286, 4909, 5239, 5517, 6051, 6281, 6376, 7724, 8491, 9113, 9280, 10601, 11046, 11413, 12132]","[0, 190, 492, 582, 795, 890, 990, 1106, 1240, 1538, 1673, 1818, 2062, 2296, 2778, 3218, 3312, 3742, 3875, 4526, 4620, 4853, 5890, 6284, 6707, 7204, 8014, 8108, 8583, 8842]",20794,17704,15003,12132,8842,-1429,-1836,-3509,-2093,-834,-9701,30,dire
7632230602,73,98,60,79,119,"[0, 250, 662, 987, 1210, 1494, 2024, 2609, 3138, 3433, 4146, 4895, 5399, 6136, 6736, 7303, 8355, 9768, 11028, 12222, 13691, 14950, 16321, 17354, 18507, 19515, 20790, 22524, 23443, 24521]","[0, 281, 567, 726, 1090, 1314, 1492, 2108, 2512, 2926, 3559, 4531, 5122, 5430, 5524, 6327, 6632, 7133, 7383, 7851, 8937, 9762, 9936, 10658, 11658, 12248, 12612, 14303, 14931, 15470]","[0, 281, 530, 735, 1145, 1344, 2063, 2187, 2505, 2863, 3743, 4156, 4246, 4564, 4960, 5175, 5550, 5714, 5964, 6369, 7039, 7519, 8329, 8561, 8701, 9075, 9680, 10377, 10884, 10980]","[0, 170, 260, 399, 489, 614, 740, 1004, 1109, 1727, 2362, 2452, 2664, 3033, 3248, 3695, 3952, 4500, 4750, 4952, 5469, 5866, 6728, 7012, 7428, 7917, 8057, 8754, 8976, 9072]","[0, 170, 260, 350, 485, 616, 844, 968, 1338, 1542, 2216, 2306, 2631, 3233, 3448, 3543, 3764, 3928, 4178, 4372, 5270, 5599, 6084, 6360, 6851, 7092, 7310, 8082, 8621, 8792]",24521,15470,10980,9072,8792,114,49,21,75,136,"[0, 209, 490, 871, 1231, 1559, 1935, 2445, 2893, 3521, 3901, 4262, 5001, 5485, 6175, 6900, 7746, 8116, 8820, 9428, 10044, 10513, 11367, 11781, 12700, 13466, 14142, 14275, 14697, 15702]","[0, 291, 527, 742, 1065, 1411, 1842, 2356, 3038, 3411, 3956, 4160, 4835, 5412, 6031, 6698, 7489, 8457, 9060, 9517, 9762, 10267, 10555, 10894, 11719, 12165, 13040, 13135, 13543, 14310]","[0, 170, 309, 399, 978, 1068, 1421, 1601, 1802, 2217, 2352, 2746, 3049, 3873, 4303, 4836, 5542, 5846, 6208, 6641, 7147, 7493, 8186, 8749, 9469, 10316, 10709, 11234, 11611, 11986]","[0, 205, 370, 774, 1310, 1753, 1879, 2752, 3025, 3260, 3473, 3804, 4274, 4644, 5025, 5945, 6773, 7039, 7933, 8451, 8712, 9319, 10129, 10778, 11470, 11891, 12615, 12710, 12936, 13360]","[0, 170, 260, 385, 589, 723, 813, 1209, 1299, 1389, 1524, 1614, 1905, 2161, 2334, 2685, 3433, 3870, 4421, 4579, 4674, 4768, 5201, 5402, 5928, 6534, 6934, 7029, 7254, 7741]",15702,14310,11986,13360,7741,8819,1160,-1006,-4288,1051,5736,30,radiant
7632248708,120,54,123,129,9,"[0, 254, 620, 862, 1226, 1560, 1846, 2136, 2360, 2987, 3605, 3927, 4158, 4686, 5230, 5578, 6134, 6591, 6896, 7700, 8498, 9225, 9928, 10649, 10999, 11309, 12240, 12628, 12724, 13289]","[0, 205, 353, 630, 882, 972, 1097, 1337, 1598, 1923, 2530, 2935, 3492, 3815, 4541, 5084, 5772, 6325, 6420, 7106, 7646, 8471, 9150, 9663, 10144, 10834, 11245, 12019, 12691, 12864]","[0, 170, 260, 728, 934, 1143, 1336, 1471, 1561, 1721, 1905, 2032, 2215, 2443, 2612, 2801, 3052, 3147, 3242, 3560, 4056, 4668, 5314, 5819, 6222, 7174, 7456, 7729, 7927, 8023]","[0, 290, 698, 1090, 1347, 1609, 2076, 2751, 3213, 3713, 4508, 5069, 5531, 6088, 6527, 6675, 7522, 7867, 7986, 8509, 9127, 9710, 10256, 10643, 10738, 11051, 11516, 12278, 12374, 12470]","[0, 272, 435, 577, 730, 893, 1304, 1629, 1719, 2076, 2509, 2912, 3121, 3317, 3664, 4082, 4478, 4661, 5063, 5445, 5749, 6225, 6698, 6954, 7211, 7878, 8048, 8344, 8726, 8897]",13289,12864,8023,12470,8897,94,137,28,119,5,"[0, 218, 416, 659, 1130, 1371, 1792, 2046, 2540, 3056, 3518, 3961, 4614, 5225, 5926, 6554, 7596, 8308, 9596, 10372, 11080, 11378, 12005, 13041, 13540, 14737, 15729, 16074, 16963, 18097]","[0, 281, 564, 859, 1194, 1630, 2139, 2348, 2783, 3080, 3170, 3582, 4063, 4338, 5293, 5602, 6456, 6890, 7864, 8221, 9148, 9614, 10283, 11412, 12676, 13222, 13317, 13924, 14653, 15866]","[0, 170, 410, 680, 970, 1593, 1810, 2234, 2730, 3388, 3905, 4473, 4692, 5169, 5636, 5969, 6704, 7136, 8151, 8502, 9044, 9582, 9884, 10424, 11064, 11630, 11750, 11878, 12630, 13408]","[0, 170, 310, 443, 533, 934, 1118, 1253, 1392, 1531, 1621, 1909, 2256, 2405, 2872, 3282, 3685, 3866, 4653, 4890, 5073, 5243, 5732, 5916, 6591, 6873, 7370, 8000, 8621, 8925]","[0, 204, 294, 384, 490, 600, 820, 1081, 1286, 1376, 1481, 1692, 2161, 2455, 2878, 3037, 3381, 3744, 4375, 5038, 5178, 5358, 5870, 6229, 6719, 7542, 7703, 7797, 8350, 8705]",18097,15866,13408,8925,8705,-4808,-3002,-5385,3545,192,-9458,30,dire
7632386819,48,106,60,65,66,"[0, 320, 525, 750, 1233, 1571, 2107, 2529, 2921, 3367, 4063, 4702, 5096, 5731, 6225, 6996, 7693, 8409, 9711, 10935, 11740, 12687, 13931, 15095, 16037, 17387, 18031, 18529, 19508, 20257]","[0, 282, 615, 1000, 1412, 1761, 2167, 2580, 3076, 3579, 4022, 4621, 5091, 5330, 6113, 7271, 7712, 8337, 8890, 9530, 10373, 10930, 12526, 13449, 14257, 14424, 15194, 15661, 16499, 17003]","[0, 241, 550, 893, 1135, 1647, 2158, 2537, 3059, 3507, 3849, 4544, 5010, 5654, 6011, 6511, 6886, 7782, 8586, 9157, 9556, 9838, 10999, 11540, 12296, 13229, 14043, 14967, 15823, 16952]","[0, 194, 284, 439, 1238, 1373, 1954, 2044, 2334, 3147, 3285, 3763, 4238, 4698, 5234, 6076, 6764, 7481, 7953, 8471, 9349, 9861, 10767, 11352, 12368, 13551, 14048, 14486, 15023, 15280]","[0, 194, 284, 472, 648, 1015, 1448, 1759, 1950, 2658, 2989, 3373, 3654, 4100, 4710, 5189, 5527, 5680, 6331, 7301, 7954, 8320, 8752, 9665, 10008, 10653, 11090, 11552, 11883, 12548]",20257,17003,16952,15280,12548,90,18,108,5,112,"[0, 326, 615, 1023, 1354, 1827, 2310, 2647, 3010, 3491, 3806, 4317, 4598, 4901, 5500, 5605, 6171, 6877, 8283, 9161, 9692, 10307, 10401, 10496, 11261, 12779, 13497, 14279, 15002, 15355]","[0, 252, 606, 840, 1031, 1325, 1731, 2266, 2710, 3274, 3835, 4160, 4673, 4999, 5744, 6419, 7148, 7929, 8691, 9295, 9551, 10437, 10531, 10855, 11045, 11865, 12003, 12733, 13530, 13774]","[0, 239, 509, 707, 918, 1357, 1624, 1962, 2618, 3215, 3498, 4380, 4799, 4979, 5495, 5589, 5949, 6360, 6934, 7547, 7702, 7997, 8091, 8486, 9071, 9620, 9887, 10332, 10883, 11437]","[0, 169, 259, 406, 746, 881, 1011, 1192, 1402, 1698, 1881, 2422, 2987, 3295, 3588, 3784, 3879, 4540, 4879, 5366, 5461, 5783, 5965, 6252, 6600, 7232, 7407, 7832, 8453, 8549]","[0, 169, 259, 349, 486, 622, 923, 1107, 1295, 1509, 1652, 2012, 2254, 2394, 2664, 2758, 3073, 3234, 3614, 4017, 4157, 4561, 4655, 4919, 5014, 5591, 5746, 6171, 6396, 6492]",15355,13774,11437,8549,6492,4902,3229,5515,6731,6056,26433,30,radiant
7632470313,90,14,15,86,51,"[0, 259, 549, 910, 1323, 1610, 2066, 2529, 3009, 3577, 4032, 4391, 5133, 5686, 6170, 6792, 7058, 7821, 8314, 8861, 9166, 10144, 10494, 10751, 10846, 14143, 14654, 15203, 16175, 17583]","[0, 243, 595, 905, 1144, 1393, 1703, 1958, 2368, 2872, 3381, 3749, 4038, 4479, 4676, 5581, 5847, 6408, 7221, 8010, 8646, 9214, 9800, 10140, 11364, 12638, 13379, 14691, 15385, 16451]","[0, 256, 578, 870, 1074, 1376, 1684, 1934, 2320, 3047, 3572, 4212, 4683, 5168, 5359, 5804, 6154, 6911, 7538, 8366, 8700, 9390, 9619, 10152, 10307, 11173, 12197, 13097, 14163, 15585]","[0, 170, 325, 499, 855, 1026, 1414, 1504, 1594, 1684, 2064, 2952, 3042, 3136, 3646, 3892, 4347, 4531, 4941, 5201, 5379, 6624, 6719, 7428, 7523, 7751, 8095, 8811, 10125, 11863]","[0, 170, 260, 385, 495, 845, 1171, 1312, 1504, 1726, 1861, 2113, 2203, 2341, 2486, 2867, 3022, 3206, 3654, 3860, 3990, 4532, 4627, 4846, 4941, 5768, 6146, 7374, 8630, 9027]",17583,16451,15585,11863,9027,48,21,49,79,83,"[0, 208, 332, 630, 969, 1288, 1527, 2145, 2741, 3302, 3918, 4363, 4915, 5650, 6327, 7466, 8629, 9758, 10825, 11962, 13013, 14912, 15668, 16406, 17669, 18334, 19178, 19520, 19921, 20193]","[0, 323, 725, 1023, 1400, 1817, 2257, 2536, 2960, 3630, 4133, 4711, 5286, 5745, 6173, 7383, 8159, 8897, 9170, 10480, 11032, 11597, 12476, 13087, 14234, 15112, 15846, 15941, 16037, 16427]","[0, 214, 522, 808, 1215, 1472, 1934, 2340, 2699, 2984, 3328, 4072, 4391, 5037, 5553, 5995, 6686, 7355, 8066, 8690, 9370, 9733, 10051, 10825, 11634, 11992, 12464, 13083, 13216, 13891]","[0, 170, 260, 350, 485, 823, 1211, 1472, 1701, 1974, 2456, 2769, 2859, 3287, 3822, 4161, 4709, 4943, 5323, 5922, 6242, 7027, 7430, 7956, 9357, 9984, 10266, 10844, 10988, 11380]","[0, 170, 260, 694, 784, 874, 964, 1160, 1369, 1592, 1953, 2133, 2223, 2485, 2634, 3047, 3399, 3556, 3768, 4221, 4471, 5384, 5597, 5974, 6464, 7058, 7319, 7681, 7777, 8278]",20193,16427,13891,11380,8278,-2610,24,1694,483,749,340,30,radiant
7632526519,25,18,96,123,5,"[0, 630, 914, 1199, 1656, 1984, 2385, 3030, 3471, 3947, 4489, 4618, 5087, 5236, 5946, 6367, 7110, 8042, 8532, 9212, 9939, 10528, 11356, 12056, 13038, 13581, 14367, 15266, 15826, 16658]","[0, 272, 509, 797, 1003, 1291, 1728, 2264, 2534, 2986, 3445, 4131, 4992, 5483, 5945, 6762, 7498, 7786, 8420, 9372, 10028, 10598, 11102, 11673, 12559, 13912, 14807, 15471, 16200, 17160]","[0, 164, 485, 649, 1106, 1304, 1657, 2377, 2708, 3470, 3605, 4061, 4521, 4869, 5127, 5490, 5957, 6809, 7050, 7457, 7726, 7925, 8334, 9175, 9791, 11374, 11468, 11563, 12416, 13042]","[0, 129, 219, 309, 530, 733, 868, 1066, 1156, 1392, 1735, 1950, 2229, 2707, 2899, 3184, 3425, 3986, 4264, 4781, 5208, 5774, 6497, 6894, 7578, 8593, 9263, 10091, 10775, 11153]","[0, 252, 386, 476, 601, 973, 1271, 1406, 1496, 1586, 1735, 1949, 2039, 2357, 2454, 2603, 2698, 2919, 3263, 3706, 3968, 4277, 4776, 5036, 6255, 7143, 7422, 7763, 8307, 8606]",16658,17160,13042,11153,8606,10,52,23,79,85,"[0, 209, 334, 673, 871, 1247, 1656, 2102, 2556, 2718, 3466, 3868, 4530, 5322, 5962, 6527, 7281, 8169, 8859, 9487, 10565, 11199, 11479, 12197, 12899, 13382, 14684, 15356, 16012, 16553]","[0, 330, 683, 1029, 1244, 1492, 1927, 2435, 3155, 3564, 4399, 4828, 5600, 6441, 7032, 7578, 8386, 9511, 10174, 10616, 11409, 11925, 12577, 13152, 14426, 14645, 15698, 16384, 16688, 17787]","[0, 248, 518, 791, 1253, 1850, 2065, 2483, 2850, 3581, 4308, 4855, 5361, 5859, 6395, 6633, 7005, 7961, 8332, 8840, 9415, 9648, 9934, 10668, 11449, 11544, 11960, 12384, 12721, 12952]","[0, 209, 335, 638, 1038, 1267, 1582, 1717, 1937, 2274, 2586, 2958, 3531, 3732, 4138, 4485, 4690, 4928, 5128, 5391, 5643, 5874, 6232, 6545, 6972, 7067, 7388, 7655, 7832, 8059]","[0, 209, 299, 435, 525, 664, 845, 980, 1070, 1160, 1385, 1831, 2128, 2362, 2536, 2630, 2884, 3342, 3577, 4032, 4285, 4547, 4777, 4943, 5416, 5511, 5755, 6155, 6332, 6622]",16553,17787,12952,8059,6622,105,-627,90,3094,1984,4646,30,radiant
7632649002,41,19,137,121,110,"[0, 242, 541, 753, 1131, 1401, 1741, 2066, 2469, 2822, 3439, 3718, 3808, 4098, 4560, 4938, 5478, 5960, 6461, 6942, 7485, 7865, 8786, 9681, 11172, 12197, 12921, 14127, 14824, 15978]","[0, 329, 665, 1003, 1429, 1808, 2272, 2581, 3004, 3561, 4063, 4694, 4836, 5138, 5754, 6009, 6653, 7256, 7887, 8296, 8738, 9872, 10389, 11273, 11768, 12658, 13065, 14039, 14826, 16243]","[0, 250, 607, 977, 1266, 1469, 1760, 2409, 3041, 3390, 3969, 4511, 4601, 4895, 5929, 6155, 7069, 7857, 8618, 8898, 9914, 10294, 11090, 11657, 12615, 13255, 13677, 14439, 14919, 15719]","[0, 170, 260, 368, 498, 637, 771, 1139, 1322, 1506, 1839, 2172, 2262, 2474, 3213, 3376, 3783, 4045, 4154, 4362, 4908, 5003, 5185, 5661, 6247, 6700, 6795, 7125, 7348, 8370]","[0, 170, 694, 829, 959, 1049, 1215, 1311, 1447, 1659, 2142, 2442, 2532, 2855, 3275, 3370, 3729, 4289, 4652, 5205, 6000, 6445, 6725, 7292, 8156, 8581, 8862, 9282, 9558, 10564]",15978,16243,15719,8370,10564,70,129,13,9,79,"[0, 240, 515, 924, 1233, 1623, 2173, 2605, 2825, 3060, 3408, 3949, 4825, 5216, 5906, 6172, 7237, 8124, 8948, 9328, 10155, 10982, 11905, 12848, 13805, 14378, 15500, 16074, 17052, 18175]","[0, 207, 592, 943, 1275, 1787, 2078, 2336, 2795, 3297, 3721, 4268, 4923, 5155, 5655, 5750, 6073, 7066, 7316, 7840, 8503, 8976, 9907, 10437, 10986, 11414, 11622, 11869, 12775, 13684]","[0, 170, 437, 809, 1102, 1442, 1683, 2181, 2664, 3250, 3717, 4022, 4534, 4952, 5325, 5998, 6649, 7307, 7744, 8342, 8948, 9789, 10653, 11001, 11346, 11722, 12260, 12796, 13214, 14112]","[0, 170, 260, 615, 745, 996, 1166, 1301, 1436, 1806, 2046, 2136, 3096, 3327, 3755, 3850, 4038, 4556, 4813, 5057, 5866, 5961, 6455, 6951, 7308, 7729, 8185, 8467, 8943, 9542]","[0, 170, 260, 352, 538, 773, 1010, 1425, 1565, 1763, 1961, 2234, 2999, 3094, 3296, 3439, 3741, 4002, 4096, 4294, 5103, 5198, 5482, 5885, 6422, 6627, 6951, 7046, 7223, 7624]",18175,13684,14112,9542,7624,-2197,2559,1607,-1172,2940,3737,30,radiant
7632714910,52,54,96,79,105,"[0, 288, 562, 989, 1321, 1641, 2052, 2599, 3189, 3654, 4091, 4573, 5326, 6268, 6768, 7724, 8337, 8557, 9375, 10293, 11797, 12601, 13232, 14165, 14838, 15396, 16603, 17197, 18749, 20631]","[0, 293, 516, 869, 1268, 1794, 2208, 2740, 3150, 3677, 4077, 4574, 5224, 5846, 6512, 7546, 8281, 9160, 9774, 10839, 11588, 12350, 12821, 13680, 14313, 15317, 15801, 16639, 18319, 19484]","[0, 242, 484, 863, 1588, 1838, 2213, 2492, 2966, 3365, 4005, 4768, 5356, 5988, 6137, 7425, 8457, 9069, 9574, 9871, 10741, 11089, 11184, 11789, 12185, 13080, 13414, 13983, 14878, 16454]","[0, 170, 592, 798, 954, 1303, 1442, 1667, 2011, 2468, 2647, 2872, 3161, 3459, 3726, 4307, 4788, 5170, 5316, 5597, 6742, 7155, 7676, 8119, 8367, 8601, 9251, 9862, 10562, 11688]","[0, 170, 260, 429, 750, 880, 1059, 1333, 1611, 1748, 2087, 2177, 2408, 2777, 2932, 3842, 4335, 4645, 4803, 5250, 5952, 6206, 6504, 6869, 7267, 7472, 7639, 7939, 8595, 9665]",20631,19484,16454,11688,9665,46,120,129,45,138,"[0, 209, 528, 725, 1061, 1532, 1883, 2425, 2822, 3759, 4258, 4882, 5862, 6598, 7322, 7730, 8339, 9445, 10530, 11193, 11332, 12944, 13615, 14631, 15924, 16442, 17478, 18007, 18486, 18753]","[0, 327, 726, 1078, 1411, 1710, 2118, 2730, 3267, 3767, 4378, 4892, 5395, 5995, 6790, 7057, 7611, 8002, 8577, 9080, 9404, 9916, 10153, 10894, 11237, 12534, 13060, 13499, 13728, 14033]","[0, 172, 424, 869, 1032, 1262, 1637, 1924, 2295, 2419, 2676, 3187, 3649, 4031, 4616, 5052, 5466, 5999, 6360, 7555, 7792, 8085, 8828, 9344, 10101, 11369, 11792, 12126, 12368, 12505]","[0, 170, 305, 604, 745, 882, 1133, 1298, 1388, 1623, 1840, 2236, 2509, 2845, 3226, 3429, 3686, 4176, 4387, 4758, 4897, 5190, 5716, 6187, 6366, 6738, 6914, 7304, 7546, 7642]","[0, 170, 483, 729, 819, 1018, 1108, 1239, 1420, 1609, 1790, 2012, 2315, 2463, 2741, 2944, 3242, 3521, 3695, 4003, 4142, 4488, 4673, 5187, 5423, 5800, 6319, 6553, 6882, 7034]",18753,14033,12505,7642,7034,1878,5451,3949,4046,2631,17955,30,radiant
7632820016,18,25,137,121,19,"[0, 284, 616, 936, 1297, 1932, 2332, 2751, 3498, 4051, 4834, 5534, 6281, 7001, 7653, 8499, 9629, 10451, 11596, 12192, 13750, 14590, 15653, 17038, 18515, 19527, 20913, 21498, 22758, 23273]","[0, 282, 593, 997, 1278, 1756, 1976, 2753, 3216, 3634, 4377, 4675, 5392, 5622, 6556, 7370, 7985, 9022, 9974, 10765, 11271, 11912, 12403, 13408, 14468, 15629, 16460, 16942, 18134, 18716]","[0, 210, 408, 706, 831, 1090, 1376, 1972, 2533, 2921, 3493, 3922, 4669, 5399, 5761, 6064, 6584, 7431, 8249, 8860, 9789, 10147, 10923, 12092, 12502, 13256, 14101, 14570, 15695, 16148]","[0, 210, 300, 561, 696, 934, 1081, 1284, 1546, 1770, 2170, 2400, 2629, 2855, 3244, 3576, 3734, 4190, 4690, 5067, 5272, 5443, 6334, 6826, 7167, 7560, 7786, 7881, 8465, 9457]","[0, 253, 343, 599, 689, 859, 949, 1039, 1129, 1219, 1784, 2080, 2402, 2676, 3165, 3408, 3856, 4359, 4691, 4786, 5195, 5620, 6131, 6420, 6878, 7371, 7672, 7835, 8587, 9097]",23273,18716,16148,9457,9097,109,13,129,65,85,"[0, 213, 526, 770, 1195, 1689, 2016, 2415, 2797, 3196, 3487, 3913, 4266, 4630, 5358, 6049, 6739, 7006, 7941, 8856, 9255, 10124, 11241, 11430, 11525, 11629, 12094, 12710, 13663, 14540]","[0, 252, 495, 747, 1080, 1442, 1680, 2403, 2860, 3339, 3654, 3994, 4447, 5031, 5694, 6329, 6821, 7354, 7724, 9134, 9229, 9826, 10365, 10764, 11070, 11531, 12284, 13009, 13713, 13899]","[0, 254, 538, 800, 1130, 1533, 1897, 2462, 3181, 3391, 4107, 4418, 5042, 5936, 6529, 7141, 7602, 8023, 8427, 9053, 9399, 9989, 10845, 10950, 11045, 11802, 12493, 12837, 13230, 13504]","[0, 130, 240, 330, 464, 650, 740, 1016, 1333, 1578, 2137, 2372, 2730, 3210, 3359, 3728, 3963, 4412, 4507, 4824, 5097, 5289, 6019, 6376, 6686, 6946, 7135, 7743, 8406, 8941]","[0, 130, 220, 367, 457, 672, 762, 1030, 1287, 1559, 2162, 2352, 2555, 3033, 3275, 3674, 4121, 4359, 4649, 5185, 5534, 5628, 6221, 6505, 6600, 6755, 7029, 7124, 7612, 8100]",14540,13899,13504,8941,8100,8733,4817,2644,516,997,17707,30,radiant
7632828213,21,78,23,5,86,"[0, 260, 588, 920, 1243, 1613, 2039, 2516, 2952, 3637, 4218, 4844, 5336, 5974, 6808, 7321, 8179, 8971, 10300, 10778, 11278, 12443, 13347, 14128, 15351, 16225, 16677, 17899, 19155, 20161]","[0, 174, 493, 762, 1110, 1418, 1757, 2152, 2671, 2989, 3430, 3901, 4316, 4683, 5045, 5179, 5738, 6292, 7236, 7746, 8384, 9309, 10409, 10796, 12001, 12710, 13569, 14255, 15877, 16535]","[0, 292, 623, 993, 1328, 1785, 2176, 2997, 3881, 4799, 5502, 6210, 6756, 7497, 7901, 8257, 9344, 9959, 10562, 10922, 11202, 12300, 12795, 13071, 14211, 14930, 15829, 16922, 17470, 18290]","[0, 170, 476, 611, 830, 1024, 1114, 1339, 1499, 1683, 1920, 2214, 2539, 3105, 3586, 3681, 4176, 4449, 4844, 4939, 5133, 6441, 6918, 7271, 7946, 8241, 8521, 9111, 9805, 10373]","[0, 218, 308, 398, 539, 692, 782, 1127, 1287, 1455, 1771, 2000, 2582, 2834, 3054, 3236, 3698, 3864, 5047, 5270, 5452, 6586, 7049, 7327, 7877, 8043, 8248, 8642, 8919, 9365]",20161,16535,18290,10373,9365,89,52,97,119,51,"[0, 224, 587, 948, 1241, 1520, 1833, 2352, 2767, 3150, 3658, 4295, 4844, 5446, 6172, 7060, 8052, 9068, 9896, 10693, 11376, 11470, 11826, 12905, 14038, 15197, 16282, 17213, 18026, 18122]","[0, 262, 595, 1032, 1297, 1640, 2016, 2491, 3043, 3506, 3952, 4217, 4868, 5489, 6086, 6908, 7984, 8292, 8869, 9348, 9750, 9844, 10739, 11522, 11707, 12441, 13050, 13734, 14080, 14472]","[0, 287, 534, 934, 1259, 1472, 1788, 2148, 2514, 2962, 3350, 3693, 4458, 4811, 5313, 5956, 6328, 6935, 7980, 8389, 9152, 9246, 9580, 10545, 11083, 11600, 12040, 12484, 12743, 13106]","[0, 420, 510, 814, 991, 1081, 1171, 1261, 1540, 1824, 2197, 2287, 2574, 2815, 3098, 3470, 4096, 4368, 4863, 5070, 5228, 5322, 5667, 5942, 6275, 6795, 7217, 7456, 7552, 7648]","[0, 492, 582, 737, 867, 1070, 1160, 1566, 1912, 2002, 2265, 2390, 2844, 3140, 3453, 3895, 4204, 4626, 4992, 5458, 5616, 5710, 6159, 6301, 6486, 6887, 7076, 7315, 7579, 7815]",18122,14472,13106,7648,7815,2039,2063,5184,2725,1550,13561,30,radiant
7632939802,41,120,137,9,66,"[0, 292, 574, 929, 1256, 1571, 1894, 2410, 2611, 2929, 3338, 3884, 4486, 4836, 5590, 6049, 6678, 6903, 8369, 9187, 9447, 10362, 11210, 11922, 12390, 13004, 14136, 14585, 15196, 16430]","[0, 330, 639, 1097, 1499, 1824, 2331, 2926, 3492, 4037, 4309, 5136, 5451, 6054, 7039, 7224, 8255, 8769, 9100, 10019, 10165, 10661, 11270, 11999, 12923, 13435, 14395, 14490, 15086, 15654]","[0, 206, 470, 860, 1136, 1498, 1744, 2299, 2654, 3520, 4029, 4577, 5206, 5775, 6461, 7195, 8219, 8613, 9570, 10106, 10611, 11319, 12224, 12675, 12999, 13972, 14548, 14839, 14935, 15964]","[0, 221, 337, 472, 602, 903, 1094, 1184, 1274, 1511, 1732, 1876, 2056, 2252, 2720, 3045, 3426, 3569, 4306, 4640, 4889, 5081, 5600, 6501, 6948, 7277, 7371, 7580, 7806, 8197]","[0, 204, 312, 494, 682, 873, 1040, 1265, 1546, 1887, 2116, 2366, 2672, 2913, 3514, 3915, 4326, 4533, 4986, 5598, 5937, 6103, 6411, 6891, 7143, 7541, 7635, 7730, 7860, 8275]",16430,15654,15964,8197,8275,13,18,19,37,20,"[0, 296, 468, 803, 1093, 1453, 1734, 2203, 3052, 3850, 4524, 5095, 5515, 6142, 6584, 7445, 8074, 8885, 9377, 10088, 10905, 11815, 12601, 13545, 13901, 14527, 15274, 16871, 17854, 18097]","[0, 204, 378, 761, 958, 1444, 1804, 2426, 2850, 3322, 3628, 4484, 5159, 5794, 5978, 7244, 8196, 9166, 9799, 10646, 11782, 12233, 13112, 13888, 14814, 15079, 15976, 17210, 17836, 18367]","[0, 242, 562, 788, 1118, 1521, 1864, 2521, 2927, 3263, 3718, 4305, 4685, 5054, 5361, 5688, 6150, 6643, 6757, 7156, 7559, 7796, 8172, 8777, 8873, 9129, 9571, 10833, 11511, 11941]","[0, 169, 259, 349, 439, 625, 729, 954, 1044, 1467, 1651, 1959, 2099, 2349, 2968, 3226, 3447, 3768, 4202, 4532, 4981, 5242, 5515, 6030, 6134, 6305, 6399, 7045, 7553, 7866]","[0, 169, 259, 349, 563, 698, 834, 1059, 1305, 1562, 2041, 2532, 2806, 3321, 3590, 3685, 4204, 4900, 5123, 5802, 6087, 6202, 6864, 7350, 7445, 7615, 7779, 8318, 8576, 8785]",18097,18367,11941,7866,8785,-1667,-2713,4023,331,-510,-536,30,radiant
7633038512,109,7,76,50,121,"[0, 286, 604, 962, 1363, 1682, 1991, 2321, 2824, 3107, 3744, 4168, 4942, 5633, 6076, 6590, 7282, 8033, 8691, 9102, 9758, 10911, 12032, 12638, 13218, 13607, 13862, 14902, 16075, 16171]","[0, 236, 603, 1050, 1465, 1847, 2189, 2525, 3361, 3677, 4387, 4769, 5207, 5485, 6054, 6159, 7407, 7858, 8430, 8956, 9500, 10326, 11032, 11967, 12512, 12607, 12702, 12996, 13261, 13357]","[0, 205, 531, 900, 1158, 1399, 1658, 2046, 2304, 2727, 3191, 3527, 3956, 4288, 4683, 4895, 5124, 5488, 6502, 7025, 8167, 8864, 9506, 9918, 10379, 10513, 10645, 10894, 11393, 11489]","[0, 130, 220, 354, 492, 582, 893, 983, 1073, 1199, 1506, 1692, 1782, 2096, 2333, 2504, 3184, 3676, 4370, 4794, 5154, 5654, 5839, 5934, 6028, 6123, 6368, 6612, 7103, 7368]","[0, 173, 263, 435, 545, 635, 725, 862, 952, 1042, 1312, 1491, 1581, 1729, 2036, 2186, 2482, 2938, 3396, 3828, 4373, 4871, 5212, 5548, 5717, 5887, 6057, 6307, 6539, 6710]",16171,13357,11489,7368,6710,120,59,70,86,5,"[0, 363, 809, 1140, 1560, 2052, 2674, 3328, 3963, 4420, 5173, 6014, 6660, 6909, 7497, 8429, 8965, 9666, 10522, 11158, 11890, 12447, 13415, 14359, 14889, 15842, 16280, 16746, 17913, 18773]","[0, 299, 668, 1087, 1295, 2093, 2472, 3081, 3505, 4211, 4994, 5510, 6005, 6505, 7363, 8051, 8781, 9288, 10152, 11040, 11605, 11770, 12179, 12984, 13270, 14710, 15194, 15610, 16239, 17275]","[0, 283, 621, 941, 1287, 1643, 2108, 2409, 2840, 3040, 3435, 3823, 4395, 4954, 5436, 5984, 6770, 7308, 7976, 9127, 9868, 10675, 11532, 11866, 12558, 13909, 14728, 15856, 16676, 16772]","[0, 210, 300, 436, 880, 1095, 1288, 1498, 1718, 1946, 2160, 2380, 2550, 2856, 3167, 4187, 4715, 4959, 5563, 5874, 6292, 6832, 7156, 7251, 7396, 8479, 8954, 9536, 10128, 11541]","[0, 210, 326, 526, 616, 751, 912, 1092, 1485, 1585, 2107, 2197, 2287, 2381, 2616, 2794, 2951, 3140, 4288, 4747, 4867, 5032, 5318, 5413, 5699, 6511, 6716, 7086, 7634, 8292]",18773,17275,16772,11541,8292,-2602,-3918,-5283,-4173,-1582,-17558,30,dire
7633207514,73,22,15,112,65,"[0, 365, 672, 980, 1348, 1726, 2223, 2737, 3466, 4390, 5072, 5874, 6249, 7010, 8533, 9531, 10427, 10920, 11928, 13543, 14500, 15294, 16715, 17395, 17969, 19126, 19890, 20632, 21986, 23099]","[0, 444, 774, 1018, 1427, 1752, 2045, 2772, 3307, 3959, 4522, 5036, 5303, 6266, 6899, 7560, 8279, 8596, 8851, 10019, 10531, 11054, 11689, 11866, 11995, 12679, 12995, 13224, 14203, 14851]","[0, 573, 825, 1086, 1423, 1703, 2218, 2516, 2820, 3148, 3530, 4111, 4449, 4992, 5624, 6209, 7001, 7455, 7925, 8858, 9302, 10040, 10534, 10898, 10993, 12158, 12498, 13048, 13769, 14262]","[0, 209, 299, 389, 528, 618, 870, 960, 1050, 1337, 1594, 1860, 2110, 2509, 2748, 3165, 3782, 4135, 4424, 5468, 6030, 6125, 6757, 7111, 7206, 8008, 8442, 8671, 10076, 10809]","[0, 266, 356, 490, 702, 1000, 1540, 1691, 1839, 2326, 2804, 3117, 3299, 4001, 4345, 4836, 5278, 5843, 6295, 6993, 7676, 7803, 8094, 8347, 8442, 9401, 9846, 10075, 10878, 11165]",23099,14851,14262,10809,11165,10,137,79,54,83,"[0, 230, 444, 813, 1062, 1285, 1418, 1821, 2239, 2689, 3058, 3491, 3947, 4081, 4895, 5338, 6161, 7095, 7715, 8654, 9199, 10462, 11243, 11844, 13784, 15042, 16573, 17514, 18078, 18174]","[0, 206, 366, 737, 999, 1520, 1936, 2198, 2757, 3028, 3423, 4148, 4869, 5448, 6079, 6466, 7396, 7963, 8436, 8916, 9215, 10217, 10688, 10872, 12074, 12359, 12454, 13477, 13948, 14154]","[0, 154, 244, 421, 511, 781, 871, 1028, 1229, 1484, 1877, 2263, 2353, 2617, 2983, 3428, 3776, 4275, 4743, 5272, 5394, 6690, 7184, 7532, 8468, 8815, 9622, 10180, 10485, 11129]","[0, 239, 561, 809, 1102, 1430, 1805, 2292, 2711, 3089, 3448, 3668, 4146, 4410, 4688, 5135, 5499, 5874, 6413, 6723, 7102, 7543, 7961, 8145, 9588, 9852, 10122, 10382, 10686, 11113]","[0, 154, 244, 382, 472, 562, 652, 925, 1015, 1411, 1546, 1776, 1866, 1961, 3043, 3318, 4073, 4495, 4864, 5441, 5535, 6398, 6757, 7469, 8649, 8816, 9298, 9799, 10367, 10765]",18174,14154,11129,11113,10765,4925,697,3133,-304,400,8851,30,dire
7633305505,13,10,137,110,31,"[1, 276, 610, 1177, 1697, 2109, 2542, 3064, 3661, 4186, 4663, 5476, 5780, 6134, 6916, 7682, 8013, 8812, 9426, 10088, 10687, 11613, 12257, 13282, 14061, 14799, 15557, 16111, 16207, 17047]","[1, 282, 574, 878, 1169, 1553, 2243, 2614, 2779, 3141, 3666, 4130, 4668, 5130, 5637, 6347, 6930, 7782, 8327, 9006, 9680, 10145, 10906, 11858, 12658, 13198, 13803, 14480, 14787, 16298]","[1, 233, 524, 984, 1284, 1666, 2075, 2762, 3196, 3612, 3803, 4665, 5067, 5831, 6182, 7127, 7429, 7524, 7640, 7992, 8365, 8561, 8728, 8939, 9284, 9898, 10095, 10334, 10696, 11838]","[1, 196, 286, 445, 570, 660, 1107, 1571, 1661, 1917, 2007, 2268, 2530, 2818, 2993, 3359, 3677, 3948, 4204, 4746, 4971, 5520, 6010, 6185, 6552, 7106, 7201, 7862, 8051, 8356]","[1, 196, 286, 445, 535, 661, 851, 1187, 1277, 1367, 1502, 1682, 1910, 2059, 2521, 2616, 2773, 3025, 3189, 3437, 3699, 3995, 4162, 4337, 4771, 5039, 5134, 5496, 5592, 6458]",17047,16298,11838,8356,6458,48,90,15,66,19,"[1, 206, 490, 931, 1296, 1627, 1944, 2190, 2447, 3055, 3626, 4256, 5099, 5815, 6460, 7266, 8047, 8927, 9722, 10370, 11539, 12308, 13252, 14128, 15211, 16214, 16983, 17270, 18277, 19602]","[1, 375, 766, 1162, 1546, 1887, 2269, 2946, 3496, 3997, 4523, 5079, 5665, 6212, 6516, 6987, 7606, 8169, 8672, 9730, 10252, 11087, 11672, 12182, 12637, 13287, 14041, 14272, 14721, 15506]","[1, 207, 417, 705, 1365, 1680, 1960, 2219, 2382, 2776, 3166, 3598, 4365, 4883, 5526, 6013, 6689, 7378, 8092, 8631, 9203, 9461, 9666, 10011, 10222, 11003, 11707, 11945, 12551, 13179]","[1, 171, 261, 429, 640, 765, 970, 1472, 1635, 2022, 2380, 2783, 3241, 3585, 3870, 4197, 4847, 5453, 5706, 6114, 6425, 6770, 7072, 7386, 7563, 7817, 8351, 8506, 9204, 9801]","[1, 171, 345, 523, 816, 986, 1285, 1478, 1928, 2232, 2551, 2785, 3081, 3255, 3350, 3445, 4266, 4508, 4809, 5156, 5648, 5874, 6400, 6911, 7162, 7367, 7543, 7638, 7901, 8213]",19602,15506,13179,9801,8213,-2555,792,-1341,-1445,-1755,-6304,30,dire
7633391901,72,126,38,5,9,"[0, 283, 520, 890, 1141, 1623, 2085, 2400, 2918, 3428, 4224, 4314, 4810, 5502, 5878, 6367, 7207, 7790, 8478, 9386, 10092, 11115, 12111, 12908, 13347, 14095, 14552, 15120, 15865, 16168]","[0, 329, 736, 990, 1324, 1663, 2127, 2413, 2978, 3259, 3653, 4237, 4327, 5145, 5670, 5765, 6080, 6832, 7310, 7747, 8167, 8886, 9491, 10551, 10989, 11624, 11802, 12341, 14010, 14274]","[0, 206, 477, 678, 768, 1110, 1354, 1444, 1757, 1931, 2250, 2626, 2897, 3301, 3859, 4215, 4691, 5210, 5392, 5550, 6210, 6563, 6989, 7466, 7695, 8146, 8555, 8892, 9509, 9848]","[0, 170, 367, 457, 673, 1074, 1164, 1254, 1530, 1803, 2455, 2724, 3450, 3730, 3879, 3974, 4276, 4710, 4856, 5584, 5795, 6338, 6532, 6902, 7131, 7343, 7640, 7735, 7990, 8254]","[0, 170, 354, 535, 668, 867, 957, 1091, 1360, 1450, 1825, 2045, 2726, 2929, 3159, 3442, 3607, 3875, 4037, 4428, 4678, 4836, 5127, 5412, 5829, 6231, 6326, 6972, 7169, 7313]",16168,14274,9848,8254,7313,95,13,96,114,3,"[0, 255, 638, 1189, 1694, 2070, 2577, 3218, 3423, 4064, 4653, 5347, 6040, 6697, 7345, 8159, 8792, 10094, 10890, 11767, 12795, 13729, 15383, 16716, 18207, 18970, 19877, 21630, 22825, 24474]","[0, 324, 783, 1204, 1719, 2178, 2756, 3236, 3903, 4344, 4851, 5714, 6157, 6783, 7392, 8164, 9176, 9665, 10309, 11193, 12086, 12791, 13509, 14917, 16363, 17583, 18712, 20040, 21383, 21930]","[0, 170, 384, 625, 1063, 1487, 1936, 2505, 2758, 3234, 3941, 4503, 4867, 5494, 6183, 6703, 7045, 7610, 8302, 8648, 9006, 10019, 10505, 11354, 11792, 12120, 13047, 14606, 16043, 16916]","[0, 170, 320, 810, 1142, 1392, 1702, 1932, 2102, 2460, 2640, 2983, 3200, 3348, 3685, 3835, 4062, 4156, 4341, 4525, 4683, 4815, 5263, 5776, 6160, 6574, 7341, 8092, 8538, 9439]","[0, 196, 346, 471, 654, 936, 1514, 1744, 1914, 2092, 2278, 2590, 2807, 3286, 3471, 3792, 4181, 4275, 4506, 5133, 5291, 5541, 5811, 6557, 6762, 6928, 7618, 8299, 8988, 9581]",24474,21930,16916,9439,9581,-8306,-7656,-7068,-1185,-2268,-26483,30,dire
7633546718,10,43,2,27,85,"[0, 292, 644, 963, 1275, 1776, 2068, 2440, 2920, 3351, 3573, 4041, 4613, 5257, 5684, 6036, 6996, 7482, 8389, 9069, 10001, 10900, 11560, 12451, 13313, 13921, 14675, 15351, 15641, 15837]","[0, 255, 611, 900, 1157, 1572, 2023, 2720, 2935, 3347, 3859, 4121, 4528, 5104, 5487, 5619, 6486, 6863, 7483, 8216, 8482, 8669, 9240, 9857, 10400, 10761, 11418, 11846, 12252, 12692]","[0, 247, 493, 1148, 1433, 1934, 2316, 2760, 3232, 4010, 4856, 5266, 5562, 6259, 6551, 6863, 7919, 8376, 8907, 9738, 9972, 10207, 10665, 10965, 11802, 12270, 13245, 13409, 13553, 13999]","[0, 170, 280, 521, 739, 1079, 1214, 1881, 2016, 2149, 2393, 2483, 2711, 3110, 3350, 3444, 4219, 4646, 4890, 5183, 5443, 5667, 6019, 6370, 6611, 7151, 7656, 7908, 8127, 8650]","[0, 170, 260, 350, 650, 899, 1034, 1322, 1457, 1600, 1961, 2051, 2224, 2496, 2708, 3006, 3164, 3325, 3691, 4009, 4251, 4410, 4873, 5587, 5729, 6119, 6779, 7240, 7458, 8035]",15837,12692,13999,8650,8035,72,137,69,19,121,"[0, 245, 539, 1174, 1535, 2378, 2755, 3243, 3824, 4353, 4751, 5465, 6171, 6786, 7396, 8131, 8815, 9301, 9814, 10409, 10979, 11787, 12590, 13291, 13837, 14669, 15147, 15559, 15717, 16936]","[0, 294, 528, 773, 1085, 1383, 1720, 2138, 2589, 2952, 3492, 4346, 4542, 5122, 6019, 6686, 7267, 7816, 8118, 8751, 9346, 9700, 10214, 11105, 11288, 11579, 12278, 12620, 12844, 13836]","[0, 170, 399, 637, 916, 1294, 1866, 2335, 2907, 3344, 4012, 4621, 5344, 6127, 6746, 7141, 7579, 8410, 9178, 9578, 9896, 10049, 10571, 10929, 11060, 11431, 11991, 12085, 12341, 14245]","[0, 208, 346, 436, 526, 697, 863, 1079, 1214, 1849, 2361, 2545, 2635, 2784, 3102, 3576, 4057, 4152, 4247, 4475, 4790, 4956, 5373, 5618, 5713, 6062, 6335, 6429, 6593, 6689]","[0, 215, 305, 530, 729, 1043, 1393, 1618, 1802, 2019, 2350, 2534, 2672, 2857, 3163, 3565, 3751, 3846, 4032, 4224, 4468, 4745, 4912, 5006, 5101, 5286, 5462, 5556, 5652, 6492]",16936,13836,14245,6689,6492,-1099,-1144,-246,1961,1543,1015,30,dire
7633731105,43,123,28,51,37,"[0, 279, 443, 604, 981, 1177, 1522, 1984, 2314, 2721, 3370, 3724, 4422, 5193, 5427, 6608, 7294, 7976, 8502, 9134, 9536, 10354, 11157, 12456, 14065, 15739, 16833, 17851, 18764, 19413]","[0, 316, 563, 941, 1583, 2189, 2593, 3321, 4063, 4901, 5424, 5904, 6965, 7510, 8010, 8171, 8743, 9670, 10683, 11039, 11583, 12314, 13330, 14299, 15122, 15342, 16211, 17102, 17702, 18041]","[0, 321, 593, 874, 1268, 1756, 1882, 2516, 2703, 3241, 4027, 4546, 5262, 6048, 6591, 7208, 7802, 8545, 8985, 9568, 9663, 10572, 11136, 11719, 11954, 12918, 13849, 15146, 15669, 16138]","[0, 209, 346, 509, 643, 852, 1265, 1490, 1580, 1917, 2258, 2776, 3215, 3579, 3674, 4343, 4907, 5427, 5995, 6251, 6423, 6896, 7474, 7822, 8385, 9151, 9491, 10004, 10321, 10767]","[0, 259, 387, 477, 567, 701, 791, 1059, 1149, 1329, 1727, 2045, 2539, 3097, 3403, 3804, 4147, 4445, 5238, 5472, 5887, 6067, 6520, 6955, 7835, 9183, 9650, 10068, 10345, 10551]",19413,18041,16138,10767,10551,52,74,14,90,26,"[0, 163, 392, 920, 1134, 1424, 1952, 2343, 2629, 3007, 3327, 3968, 4554, 5578, 6028, 6376, 7226, 7691, 8287, 8670, 9938, 10780, 11493, 11662, 13327, 14083, 14465, 15058, 15674, 16386]","[0, 256, 488, 868, 1115, 1205, 1345, 1685, 1813, 2004, 2242, 2396, 2486, 3847, 4199, 4373, 4868, 5637, 5732, 6052, 7093, 7260, 7852, 8644, 9235, 9481, 9914, 10437, 10953, 11862]","[0, 89, 430, 689, 1103, 1381, 2063, 2350, 2710, 2946, 3209, 3299, 3764, 4114, 4409, 5345, 5713, 6280, 6378, 6592, 8059, 8423, 8742, 9227, 9740, 9986, 10283, 10553, 11049, 11445]","[0, 191, 349, 549, 684, 794, 947, 1127, 1217, 1307, 1397, 1504, 1628, 2176, 2271, 2453, 3039, 3134, 3229, 3346, 4123, 4652, 4974, 5259, 6320, 6673, 6768, 6943, 7257, 7549]","[0, 95, 213, 337, 489, 633, 1081, 1261, 1351, 1441, 1567, 1660, 1835, 2352, 2447, 3323, 3466, 3741, 4063, 4157, 4807, 4974, 5533, 5627, 6107, 6401, 6633, 6808, 6985, 7371]",16386,11862,11445,7549,7371,3027,6179,4693,3218,3180,20297,30,radiant
7633732214,48,114,86,29,109,"[0, 279, 544, 958, 1205, 1697, 1982, 2532, 3278, 3897, 4583, 5130, 6075, 7008, 7869, 9055, 10100, 11249, 11713, 12742, 13899, 15484, 15964, 16636, 17489, 18523, 18958, 19241, 19818, 20116]","[0, 353, 734, 998, 1412, 1746, 2444, 2934, 3604, 4020, 4581, 5033, 5714, 6015, 6381, 6802, 7021, 7241, 7445, 8196, 8813, 9296, 9837, 10496, 11087, 11415, 11726, 12119, 12896, 13097]","[0, 290, 380, 550, 750, 1204, 1789, 1981, 2385, 2607, 2898, 3057, 3660, 4063, 4195, 5025, 5339, 5830, 6015, 6676, 7142, 7495, 7876, 8680, 9077, 9447, 9542, 9695, 10569, 10985]","[0, 327, 527, 927, 1358, 1483, 1922, 2345, 2607, 3243, 3842, 4146, 4731, 5371, 5849, 6498, 7001, 7513, 7915, 8448, 9099, 9461, 9740, 10218, 10752, 11337, 11512, 11785, 11881, 12282]","[0, 244, 334, 454, 591, 681, 771, 995, 1375, 1779, 2157, 2616, 2928, 3299, 3716, 4327, 4577, 4889, 5248, 5650, 6343, 6605, 7070, 7556, 8126, 8716, 8868, 9016, 9112, 9635]",20116,13097,10985,12282,9635,10,69,106,19,9,"[0, 205, 438, 727, 974, 1395, 1726, 1888, 2486, 2971, 3290, 3909, 4625, 5117, 5641, 6325, 7146, 7700, 8207, 8926, 9399, 9693, 10632, 11227, 11761, 12462, 13525, 14115, 16391, 17594]","[0, 243, 457, 734, 1139, 1556, 2293, 2734, 3322, 3751, 4139, 4660, 5282, 5687, 6251, 6923, 7922, 8555, 9313, 10679, 11356, 11623, 12724, 13531, 13831, 14277, 15969, 16517, 17915, 18092]","[0, 323, 483, 680, 975, 1256, 1391, 1602, 1813, 2148, 2664, 2958, 3060, 3671, 3976, 4302, 5226, 5514, 5987, 6641, 6854, 7528, 8744, 9354, 9565, 9942, 11176, 11686, 12984, 13817]","[0, 169, 306, 426, 650, 839, 1103, 1193, 1677, 1924, 2345, 2541, 2665, 3253, 3557, 3651, 4425, 4713, 4808, 5158, 5259, 5785, 6875, 7123, 7218, 7710, 8396, 8691, 10144, 10472]","[0, 220, 358, 478, 703, 809, 944, 1130, 1622, 1987, 2122, 2344, 2434, 2816, 2990, 3175, 3931, 4219, 4423, 4847, 4962, 5272, 5748, 5987, 6336, 6648, 7451, 7803, 8574, 9028]",17594,18092,13817,10472,9028,2522,-4995,-2832,1810,607,-2888,30,dire
7633793219,48,35,129,85,86,"[0, 246, 491, 893, 1141, 1572, 1908, 2550, 2979, 3357, 3757, 4255, 4435, 5126, 5762, 6498, 7313, 8222, 9014, 9853, 10554, 10808, 10902, 11950, 12761, 13914, 14708, 15282, 15590, 15933]","[0, 200, 533, 935, 1341, 1787, 2351, 3132, 3475, 4146, 4891, 5240, 6024, 6486, 7048, 7672, 8255, 9168, 9795, 10247, 10780, 11342, 11570, 12385, 12765, 13197, 13291, 14056, 14152, 14950]","[0, 216, 419, 809, 979, 1590, 1719, 1979, 2285, 2588, 3031, 3942, 4208, 4590, 5086, 5530, 6157, 6794, 7483, 8008, 8765, 9240, 9334, 9942, 10163, 10617, 11094, 11310, 11411, 11998]","[0, 129, 219, 339, 429, 977, 1280, 1939, 2146, 2410, 2777, 3363, 3794, 4159, 4459, 4600, 4804, 5390, 5533, 5811, 6084, 6293, 6521, 6760, 6928, 7158, 7469, 7645, 7741, 7987]","[0, 167, 304, 468, 603, 733, 857, 1364, 1534, 1664, 2057, 2147, 2373, 2724, 2819, 3047, 3388, 3996, 4395, 4728, 4895, 5104, 5620, 5934, 6313, 6528, 6697, 6948, 7124, 7659]",15933,14950,11998,7987,7659,54,13,55,64,19,"[0, 253, 629, 900, 1285, 1574, 2015, 2576, 2951, 3398, 3998, 4613, 5484, 6321, 6923, 7508, 7850, 8035, 9020, 10511, 11348, 12025, 13809, 14645, 15666, 16230, 17583, 17987, 19499, 20951]","[0, 327, 454, 799, 1018, 1195, 1501, 1909, 2248, 2913, 3497, 4141, 4369, 5103, 5949, 6674, 6989, 7499, 7845, 8893, 9793, 11171, 12240, 12919, 13635, 14070, 15625, 16693, 17752, 18842]","[0, 281, 478, 673, 1023, 1421, 1819, 2265, 2515, 2985, 3511, 3896, 4155, 5037, 5601, 6213, 6767, 6952, 7282, 7911, 8274, 8629, 9199, 9553, 10373, 11045, 12278, 12821, 13589, 14276]","[0, 209, 299, 389, 578, 668, 804, 1479, 1606, 1696, 2040, 2214, 2304, 2806, 3276, 3577, 3882, 4108, 4493, 4853, 5441, 6188, 6731, 7057, 7611, 8129, 9619, 9957, 10560, 11303]","[0, 209, 299, 389, 526, 616, 706, 914, 1004, 1201, 1395, 1519, 2096, 2562, 2775, 2919, 3077, 3368, 3722, 4370, 4696, 5057, 5734, 5950, 6686, 7194, 8136, 8231, 9152, 9985]",20951,18842,14276,11303,9985,-5018,-3892,-2278,-3316,-2326,-16830,30,dire
7633814106,18,137,98,5,27,"[61, 338, 802, 1218, 1763, 2129, 2297, 2693, 3138, 3782, 4344, 4981, 5675, 6468, 7221, 7871, 9677, 10776, 11215, 12049, 13197, 14040, 15202, 15901, 16389, 17461, 18053, 19009, 19765, 22188]","[61, 342, 727, 1127, 1374, 1816, 2144, 2491, 2702, 3260, 3810, 4213, 5032, 5628, 6252, 6685, 7612, 8555, 9229, 10264, 10805, 11092, 12252, 13183, 13430, 14598, 15013, 15818, 16357, 17516]","[61, 343, 616, 846, 1212, 1536, 1790, 2148, 2540, 2973, 3880, 4494, 5137, 5634, 6159, 6710, 7387, 7943, 8644, 9485, 10117, 10722, 12082, 12891, 13093, 13457, 14080, 14174, 15244, 16091]","[329, 538, 752, 926, 1117, 1252, 1342, 1480, 1570, 2059, 2620, 2754, 2944, 3270, 3541, 3682, 3941, 4356, 4479, 4804, 5062, 5232, 6113, 6797, 7126, 7447, 7617, 7833, 8085, 8732]","[61, 270, 360, 495, 660, 750, 840, 964, 1054, 1262, 1650, 1740, 2061, 2347, 2615, 2710, 3391, 3764, 4004, 4513, 4697, 4830, 5526, 5692, 5787, 6347, 6468, 6562, 7052, 7603]",22188,17516,16091,8732,7603,94,82,23,72,65,"[0, 129, 429, 806, 1163, 1609, 2168, 2540, 3140, 3556, 4170, 4926, 5604, 6515, 7219, 7937, 8692, 9440, 10180, 11310, 12187, 13447, 14258, 15435, 16656, 18144, 18836, 20052, 20716, 21196]","[0, 324, 569, 984, 1476, 1856, 2473, 3234, 3706, 4278, 4793, 4992, 5970, 7483, 8423, 9063, 9220, 10140, 11109, 11876, 12687, 13496, 14329, 14522, 15528, 16364, 16459, 17101, 17987, 18653]","[0, 163, 348, 828, 1033, 1337, 1810, 1945, 2850, 3106, 3657, 4089, 4729, 5417, 6033, 6765, 7603, 8062, 8752, 9380, 10090, 10369, 10795, 11128, 11531, 12251, 12923, 13497, 13929, 14153]","[0, 129, 219, 358, 502, 637, 1180, 1315, 1569, 1659, 1794, 2103, 2462, 3054, 3196, 3536, 3717, 4054, 4268, 4787, 5128, 5317, 5599, 5693, 6298, 6725, 7456, 7783, 8254, 8395]","[0, 129, 219, 309, 439, 619, 1058, 1286, 1495, 1842, 2295, 2639, 2950, 3384, 3610, 4158, 4504, 4739, 5215, 5887, 6071, 6382, 6664, 6869, 7464, 7994, 8299, 8714, 8945, 9041]",21196,18653,14153,8395,9041,992,-1137,1938,337,-1438,692,30,radiant
7634024715,94,17,29,27,66,"[0, 243, 539, 889, 1138, 1579, 2192, 2523, 2936, 3379, 4414, 4805, 5374, 5832, 6347, 6858, 7539, 8550, 9389, 10410, 10726, 11697, 12687, 13419, 15293, 16697, 17582, 18214, 18993, 20079]","[0, 375, 745, 909, 1238, 1583, 1824, 2368, 2900, 3499, 4182, 5008, 5364, 5806, 6327, 7151, 7795, 8204, 9087, 9409, 9786, 10767, 11247, 11511, 13192, 13910, 14513, 15417, 16567, 17188]","[0, 295, 579, 784, 1149, 1470, 1747, 1949, 2280, 2779, 3408, 4077, 4167, 4507, 5070, 5667, 6498, 7270, 7834, 8185, 8373, 8850, 9421, 10251, 11796, 12610, 12910, 13174, 13435, 13996]","[0, 170, 260, 350, 489, 628, 752, 842, 978, 1113, 1485, 1828, 2188, 2283, 2669, 3316, 3447, 3668, 4184, 4398, 4974, 5408, 5719, 5889, 6921, 7709, 7878, 8214, 8466, 9068]","[0, 170, 278, 368, 495, 629, 798, 1073, 1308, 1518, 1871, 2211, 2358, 2685, 2982, 3264, 3571, 4070, 4453, 4841, 4994, 5317, 5615, 5819, 6386, 6955, 7235, 7429, 8003, 8699]",20079,17188,13996,9068,8699,18,137,69,65,62,"[0, 245, 492, 807, 1174, 1456, 2155, 2514, 3142, 3705, 4238, 4785, 5640, 6397, 7398, 8451, 9222, 10212, 11334, 12232, 12752, 13920, 15405, 16106, 16976, 17143, 18221, 18802, 19763, 20506]","[0, 250, 612, 1277, 1689, 2056, 2628, 2969, 3318, 3683, 4225, 4621, 5299, 6069, 6939, 7368, 8077, 8652, 9161, 9933, 10773, 11252, 12417, 12809, 13014, 13734, 14468, 15214, 16002, 16426]","[0, 208, 602, 806, 989, 1448, 1598, 1868, 2276, 2639, 3405, 3896, 4555, 5226, 5973, 6534, 7136, 7490, 8023, 8511, 9384, 10083, 11050, 12042, 12424, 12973, 13684, 14372, 15409, 15842]","[0, 170, 308, 518, 693, 823, 1069, 1159, 1375, 1465, 1770, 2145, 2279, 2892, 3175, 3922, 4162, 4657, 5106, 5516, 6369, 7012, 7400, 7931, 8136, 9142, 9431, 10429, 10754, 11181]","[0, 170, 260, 475, 666, 796, 1157, 1535, 1743, 1938, 2416, 2705, 3040, 3461, 3841, 4446, 4541, 4903, 5221, 5672, 6356, 6577, 7758, 7972, 8067, 8301, 8442, 9092, 9318, 9925]",20506,16426,15842,11181,9925,-427,762,-1846,-2113,-1226,-4850,30,radiant
7634079912,94,38,74,105,5,"[0, 242, 479, 727, 1053, 1346, 1833, 2214, 2674, 3140, 3469, 3893, 4411, 5196, 5793, 6192, 7387, 7924, 8812, 9593, 10836, 11741, 12185, 12685, 13753, 14604, 15399, 16176, 16697, 17986]","[0, 191, 519, 814, 1158, 1748, 2095, 2541, 2789, 3283, 3625, 4144, 5065, 5443, 6505, 6965, 7898, 9274, 10216, 11189, 12201, 12863, 13241, 13902, 14553, 15139, 15889, 16584, 16969, 17273]","[0, 276, 482, 743, 1157, 1502, 1838, 2299, 2838, 3637, 3888, 4137, 4590, 5090, 5614, 5709, 5932, 6820, 7270, 7406, 7905, 8341, 8885, 9532, 10097, 10630, 11138, 11730, 12166, 13228]","[0, 154, 244, 334, 469, 672, 808, 988, 1078, 1266, 1687, 1890, 2292, 2545, 2693, 2793, 2936, 3383, 3567, 4166, 4626, 5003, 5125, 5626, 6038, 6298, 6577, 6950, 7121, 8145]","[0, 154, 244, 383, 519, 703, 793, 973, 1237, 1642, 1751, 2070, 2244, 2497, 2645, 2740, 2835, 3611, 3861, 4381, 4798, 5031, 5433, 5663, 5912, 6097, 6348, 6524, 6868, 7572]",17986,17273,13228,8145,7572,10,98,55,19,45,"[0, 245, 553, 935, 1262, 1593, 2021, 2489, 2954, 3367, 3835, 4475, 5288, 6248, 6787, 7491, 8423, 8959, 9875, 10341, 11081, 11816, 12884, 13909, 14864, 15372, 16204, 17195, 17985, 18626]","[0, 332, 654, 1046, 1536, 1828, 2285, 3071, 3593, 4135, 4718, 5474, 5806, 6245, 6774, 7259, 8228, 8761, 9390, 10272, 10885, 11248, 12214, 12694, 13276, 13916, 14499, 15417, 15998, 16998]","[0, 209, 445, 744, 1168, 1593, 1953, 2531, 2754, 3280, 3952, 4497, 5168, 6048, 6495, 7275, 7922, 8654, 9274, 9750, 10427, 10970, 11636, 11900, 12414, 12971, 13348, 13663, 14177, 14994]","[0, 312, 402, 604, 770, 1163, 1298, 1668, 1843, 2196, 2430, 2785, 3214, 3781, 3923, 4235, 4629, 5067, 5335, 5667, 6287, 6382, 6976, 7352, 7693, 8260, 8600, 8959, 9490, 9930]","[0, 209, 299, 469, 589, 789, 971, 1186, 1392, 1747, 1966, 2274, 2513, 3012, 3110, 3708, 4216, 4382, 4650, 5067, 5431, 5775, 6013, 6157, 6279, 6527, 6728, 7148, 7495, 7935]",18626,16998,14994,9930,7935,-640,275,-1766,-1785,-363,-4279,30,dire
