match_id,rad_pos1,rad_pos2,rad_pos3,rad_pos4,rad_pos5,rad_pos1_gold,rad_pos2_gold,rad_pos3_gold,rad_pos4_gold,rad_pos5_gold,rad_pos1_last_gold,rad_pos2_last_gold,rad_pos3_last_gold,rad_pos4_last_gold,rad_pos5_last_gold,dire_pos1,dire_pos2,dire_pos3,dire_pos4,dire_pos5,dire_pos1_gold,dire_pos2_gold,dire_pos3_gold,dire_pos4_gold,dire_pos5_gold,dire_pos1_last_gold,dire_pos2_last_gold,dire_pos3_last_gold,dire_pos4_last_gold,dire_pos5_last_gold,pos1_diff,pos2_diff,pos3_diff,pos4_diff,pos5_diff,team_diff,minute,winner
7517376613,25,8,84,26,5,"[0, 357, 715, 1130, 1578, 1968, 2261, 2861, 3399, 4064, 4468, 4937, 5415, 6018, 6399]","[0, 246, 591, 895, 1255, 1499, 1823, 2117, 2411, 2876, 3486, 3784, 4322, 4773, 5383]","[0, 247, 580, 826, 1235, 1481, 1876, 2279, 2656, 2944, 3407, 4263, 4601, 5348, 5885]","[0, 170, 260, 350, 440, 827, 1051, 1141, 1278, 1368, 1593, 2076, 2166, 2261, 2609]","[0, 170, 281, 395, 559, 699, 821, 937, 1148, 1390, 1719, 1809, 1899, 2053, 2237]",6399,5383,5885,2609,2237,77,54,23,68,86,"[0, 206, 526, 1001, 1374, 1820, 2030, 2674, 3072, 3451, 4215, 4906, 5199, 5495, 5954]","[0, 243, 639, 1406, 1775, 2054, 2395, 2844, 3405, 3797, 4308, 4613, 5439, 5890, 6445]","[0, 280, 664, 857, 1274, 1724, 2283, 2807, 3266, 3614, 4215, 4747, 5246, 5751, 6200]","[0, 170, 285, 444, 578, 668, 806, 1000, 1180, 1283, 1538, 1718, 2017, 2458, 2816]","[0, 170, 285, 375, 511, 650, 740, 875, 1055, 1194, 1457, 1637, 1870, 2085, 2692]",5954,6445,6200,2816,2692,445,-1062,-315,-207,-455,-1594,15,dire
7517420109,80,70,23,63,100,"[0, 245, 482, 901, 1226, 1720, 2196, 2613, 3126, 3656, 4014, 4528, 4977, 5336, 5917]","[0, 243, 397, 859, 1111, 1554, 2117, 2596, 3049, 3540, 4104, 4610, 5209, 5650, 6235]","[0, 244, 633, 916, 1375, 1957, 2416, 2835, 3416, 3789, 4416, 4825, 5508, 6145, 6524]","[0, 216, 331, 513, 649, 779, 914, 1004, 1219, 1309, 1756, 2115, 2559, 2654, 2798]","[0, 170, 331, 421, 511, 885, 1020, 1110, 1408, 1498, 1643, 1842, 2223, 2488, 2628]",5917,6235,6524,2798,2628,2,25,17,45,110,"[0, 209, 581, 1066, 1871, 2316, 3128, 3595, 4274, 4660, 5366, 6146, 6956, 8281, 9055]","[0, 170, 410, 740, 1025, 1332, 1593, 1938, 2183, 2739, 3308, 3845, 4458, 5380, 6276]","[0, 313, 606, 767, 1056, 1285, 1531, 1977, 2372, 2805, 3283, 3798, 4333, 4945, 5429]","[0, 170, 260, 350, 549, 639, 774, 1002, 1223, 1387, 1738, 2038, 2151, 2682, 2866]","[0, 270, 411, 501, 591, 681, 816, 996, 1086, 1424, 1728, 2084, 2222, 2614, 2798]",9055,6276,5429,2866,2798,-3138,-41,1095,-68,-170,-2322,15,radiant
7517437309,10,104,19,45,64,"[0, 197, 439, 738, 1066, 1445, 2121, 2750, 3379, 3855, 4435, 4961, 5608, 6047, 6944]","[0, 290, 549, 944, 1402, 1785, 2309, 2676, 3152, 3554, 4027, 4319, 4878, 5442, 5849]","[0, 256, 589, 718, 1033, 1536, 1798, 2094, 2630, 2720, 3508, 4073, 4657, 5176, 5584]","[0, 173, 263, 742, 832, 969, 1207, 1400, 1688, 1830, 2022, 2345, 2698, 2984, 3521]","[0, 129, 219, 357, 496, 631, 721, 855, 990, 1080, 1358, 1448, 1701, 1962, 2260]",6944,5849,5584,3521,2260,7,67,53,71,102,"[0, 356, 826, 1268, 1545, 2033, 2482, 2857, 3265, 3841, 4145, 4632, 5162, 6245, 6690]","[0, 282, 483, 803, 1085, 1413, 1801, 2196, 2865, 3306, 4158, 4378, 4743, 5136, 5570]","[0, 246, 523, 1224, 1556, 1724, 1853, 2033, 2369, 2722, 3084, 3298, 3470, 4161, 4643]","[0, 209, 299, 684, 818, 948, 1038, 1218, 1353, 1543, 1925, 2015, 2226, 2457, 2700]","[0, 209, 299, 435, 606, 815, 1015, 1243, 1458, 1606, 1943, 2033, 2413, 2803, 3026]",6690,5570,4643,2700,3026,254,279,941,821,-766,1529,15,dire
7517480603,1,33,11,100,30,"[0, 242, 587, 827, 1334, 1784, 2217, 3051, 3456, 3867, 4618, 5183, 5810, 6431, 7209]","[0, 244, 898, 1268, 1718, 2173, 2632, 3024, 3418, 4234, 4879, 5331, 5828, 6160, 6843]","[0, 289, 454, 837, 1306, 1601, 1904, 2157, 2694, 3889, 4419, 4813, 5453, 5963, 6734]","[0, 169, 325, 415, 535, 670, 805, 895, 985, 1325, 1588, 1754, 1998, 2093, 2371]","[0, 169, 259, 349, 518, 652, 834, 1089, 1179, 1314, 1854, 2238, 2433, 2566, 2771]",7209,6843,6734,2371,2771,44,19,57,21,5,"[0, 242, 515, 1000, 1337, 1662, 2086, 2452, 2711, 3036, 3574, 4068, 4617, 5042, 5637]","[0, 278, 550, 1004, 1410, 1826, 2182, 2642, 2732, 2945, 3557, 3979, 4783, 5253, 5659]","[0, 204, 490, 765, 1059, 1351, 1713, 1803, 2490, 2866, 3172, 3426, 3859, 4598, 5180]","[0, 169, 398, 488, 625, 759, 945, 1035, 1125, 1476, 1746, 1836, 2072, 2644, 3095]","[0, 169, 259, 395, 533, 623, 773, 923, 1049, 1139, 1409, 1499, 1700, 2073, 2296]",5637,5659,5180,3095,2296,1572,1184,1554,-724,475,4061,15,radiant
7517522012,69,10,76,83,86,"[155, 492, 863, 1265, 1666, 2338, 2971, 3440, 4158, 4702, 5463, 5935, 6700, 7907, 8298]","[0, 261, 673, 1043, 1391, 1893, 2311, 2839, 3198, 3749, 4277, 4949, 5585, 6600, 7366]","[155, 562, 775, 1065, 1468, 1948, 2310, 2798, 3082, 3504, 4202, 4610, 5115, 5872, 6309]","[89, 414, 504, 689, 861, 999, 1138, 1488, 1654, 1843, 2768, 2858, 3355, 3866, 4413]","[0, 155, 466, 634, 1019, 1180, 1270, 1360, 1450, 1675, 1841, 2018, 2401, 3198, 3383]",8298,7366,6309,4413,3383,12,129,28,26,87,"[110, 613, 814, 1144, 1473, 1730, 1911, 2465, 2885, 3478, 3749, 4415, 4946, 6258, 6805]","[243, 478, 678, 1001, 1413, 1815, 2127, 2341, 3273, 3626, 4620, 4948, 5399, 6217, 6503]","[378, 767, 1038, 1323, 1713, 2047, 2454, 2877, 3662, 3788, 4395, 4857, 5251, 5790, 6036]","[110, 408, 498, 636, 813, 990, 1160, 1390, 1700, 1919, 2369, 2785, 3060, 3317, 3808]","[210, 508, 598, 688, 822, 952, 1290, 1425, 1748, 1967, 2189, 2414, 2504, 2761, 2856]",6805,6503,6036,3808,2856,1493,863,273,605,527,3761,15,dire
7517581617,43,21,129,110,26,"[0, 325, 759, 1200, 1646, 2285, 3006, 3262, 3763, 4159, 4856, 5426, 5891, 6516, 6851]","[201, 524, 784, 1205, 1711, 2152, 2683, 3050, 3508, 3922, 4482, 5168, 6030, 6815, 7361]","[68, 367, 786, 1126, 1532, 1870, 2415, 2662, 3121, 3809, 4268, 4905, 5272, 5523, 6118]","[68, 278, 405, 570, 700, 790, 925, 1253, 1386, 1700, 2160, 2568, 3224, 3513, 3719]","[68, 278, 368, 505, 687, 877, 1190, 1297, 1468, 1640, 1978, 2688, 3080, 3331, 3549]",6851,7361,6118,3719,3549,14,120,102,68,86,"[181, 395, 629, 1163, 1661, 2119, 2332, 2991, 3358, 3845, 4361, 5146, 5758, 6276, 6633]","[449, 896, 1307, 1608, 1911, 2159, 2655, 3041, 3420, 4061, 4497, 4763, 5121, 5776, 6524]","[314, 567, 728, 1252, 1611, 1934, 2178, 2617, 3191, 3671, 4030, 4488, 4789, 5370, 5961]","[314, 509, 599, 759, 954, 1110, 1200, 1380, 1580, 1715, 2008, 2212, 2302, 2581, 3393]","[181, 311, 444, 534, 664, 842, 932, 1238, 1373, 1987, 2122, 2299, 2480, 2665, 3022]",6633,6524,5961,3393,3022,218,837,157,326,527,2065,15,dire
7517586007,46,42,97,50,86,"[0, 205, 463, 746, 1132, 1436, 2130, 2573, 2948, 3718, 4211, 4888, 5658, 5752, 6468]","[0, 223, 526, 1060, 1398, 1820, 2422, 2597, 2906, 3324, 4037, 4355, 4829, 5488, 5912]","[0, 173, 500, 818, 981, 1405, 2047, 2400, 3229, 3728, 4450, 5242, 5604, 6033, 6536]","[0, 356, 689, 992, 1130, 1548, 2128, 2339, 2584, 2825, 3064, 3265, 3628, 3722, 3871]","[0, 169, 259, 395, 564, 762, 947, 1134, 1378, 1859, 2279, 2417, 2653, 2803, 3133]",6468,5912,6536,3871,3133,22,29,71,14,26,"[0, 405, 687, 1095, 1538, 1792, 2021, 2651, 3174, 3539, 4088, 4354, 4744, 5525, 5875]","[0, 616, 865, 1199, 1661, 1957, 2278, 3006, 3441, 3621, 4143, 4233, 5369, 6024, 6695]","[0, 210, 348, 487, 912, 1193, 1328, 1756, 2342, 2564, 3228, 3370, 4225, 5159, 5732]","[0, 328, 526, 798, 1306, 1670, 1985, 2415, 2915, 3466, 3978, 4317, 5107, 6027, 6306]","[0, 268, 358, 587, 762, 852, 1072, 1388, 1478, 1568, 1703, 1793, 2059, 2606, 2701]",5875,6695,5732,6306,2701,593,-783,804,-2435,432,-1389,15,radiant
7517639708,48,51,61,5,26,"[0, 291, 659, 1030, 1472, 1870, 2430, 2817, 3265, 3758, 4864, 5440, 6388, 6942, 7557]","[0, 205, 495, 822, 1182, 1503, 1712, 2142, 2412, 2830, 3117, 3523, 4322, 4955, 5517]","[0, 242, 456, 741, 997, 1310, 1602, 2027, 2543, 2911, 3253, 4113, 4414, 4965, 5404]","[0, 170, 260, 350, 440, 530, 668, 797, 1233, 1323, 1568, 1898, 2395, 2653, 2748]","[0, 170, 298, 485, 657, 794, 884, 1010, 1281, 1418, 1869, 2125, 2462, 2556, 2973]",7557,5517,5404,2748,2973,69,6,39,114,84,"[0, 335, 711, 1158, 1586, 1903, 2774, 3156, 3565, 4358, 4812, 5248, 6318, 6891, 7885]","[0, 282, 599, 848, 1092, 1363, 1793, 1992, 2100, 2371, 2811, 3058, 3598, 4277, 5068]","[0, 251, 550, 952, 1246, 1664, 2118, 2478, 2808, 3234, 3625, 4254, 4556, 5143, 5472]","[0, 170, 298, 435, 525, 660, 750, 840, 930, 1020, 1286, 1469, 1803, 2266, 2937]","[0, 170, 260, 350, 440, 530, 705, 836, 926, 1016, 1126, 1360, 1612, 1920, 2454]",7885,5068,5472,2937,2454,-328,449,-68,-189,519,383,15,dire
7519064617,6,25,129,7,84,"[0, 216, 378, 775, 1220, 1590, 2038, 2676, 3186, 3650, 4107, 4562, 5056, 5555, 6296]","[0, 367, 644, 1020, 1309, 1627, 2120, 2645, 3162, 3532, 3777, 4143, 4698, 5175, 5892]","[0, 251, 503, 790, 1040, 1377, 1818, 2468, 2914, 3751, 4216, 4592, 5160, 5370, 5750]","[0, 169, 259, 349, 439, 529, 663, 978, 1117, 1289, 1574, 1709, 2241, 2584, 2787]","[0, 169, 259, 446, 536, 672, 811, 1125, 1215, 1305, 1444, 1583, 1673, 1768, 1971]",6296,5892,5750,2787,1971,104,101,44,53,85,"[0, 368, 728, 1261, 1672, 2021, 2465, 2816, 3352, 3908, 4347, 4904, 5479, 6088, 6571]","[0, 316, 708, 1074, 1488, 1926, 2416, 2794, 3213, 3716, 4510, 5001, 5469, 5879, 6419]","[0, 354, 679, 1008, 1347, 1694, 1858, 2105, 2485, 3055, 3397, 3890, 4364, 4890, 5272]","[0, 244, 334, 424, 560, 650, 740, 902, 1090, 1364, 1630, 1950, 2429, 2759, 3085]","[0, 244, 334, 471, 599, 689, 826, 983, 1084, 1196, 1296, 1697, 1787, 1996, 2091]",6571,6419,5272,3085,2091,-275,-527,478,-298,-120,-742,15,radiant
7519118314,53,10,20,136,51,"[0, 250, 378, 653, 1061, 1371, 1809, 2009, 2504, 2909, 3633, 4609, 4871, 5506, 5910]","[0, 291, 568, 865, 1278, 1721, 2135, 2419, 3015, 3438, 4120, 4761, 5247, 5897, 6445]","[0, 239, 368, 723, 1136, 1958, 2287, 2538, 3248, 3515, 3823, 4397, 4870, 5478, 5961]","[0, 230, 320, 410, 592, 859, 1012, 1102, 1603, 1783, 2109, 2537, 2786, 3051, 3146]","[0, 429, 519, 624, 762, 892, 982, 1072, 1236, 1656, 1881, 2214, 2304, 2681, 2776]",5910,6445,5961,3146,2776,48,80,23,112,83,"[0, 209, 450, 657, 851, 1013, 1223, 1708, 1934, 2239, 2655, 2993, 3380, 3974, 4735]","[0, 283, 519, 754, 1151, 1543, 1895, 2243, 2471, 2818, 3231, 3726, 4054, 4594, 5065]","[0, 243, 515, 768, 1050, 1339, 1854, 2438, 2895, 3453, 4263, 4923, 5538, 6159, 6548]","[0, 209, 299, 471, 611, 763, 932, 1022, 1418, 1508, 1839, 2087, 2177, 2794, 2969]","[0, 209, 299, 441, 561, 688, 813, 1142, 1232, 1358, 1794, 2004, 2094, 2382, 2571]",4735,5065,6548,2969,2571,1175,1380,-587,177,205,2350,15,dire
7519162603,61,102,96,64,45,"[0, 291, 612, 1035, 1508, 1882, 2354, 2896, 3649, 4201, 5082, 5915, 6556, 7469, 8175]","[0, 205, 533, 949, 1268, 1677, 2166, 2609, 3399, 3781, 4075, 4351, 4841, 5474, 6358]","[0, 298, 524, 798, 1133, 1612, 1908, 2229, 2712, 3450, 4105, 4705, 5174, 5746, 6182]","[100, 270, 378, 512, 996, 1101, 1878, 2222, 2532, 2812, 3396, 3719, 4241, 4915, 5256]","[0, 170, 260, 350, 490, 672, 844, 1042, 1222, 1629, 1854, 1988, 2324, 2556, 3379]",8175,6358,6182,5256,3379,10,28,120,121,20,"[0, 204, 473, 627, 816, 1014, 1355, 1646, 1885, 2274, 3020, 3550, 4005, 4610, 5222]","[0, 242, 530, 796, 1032, 1380, 1553, 1972, 2217, 2993, 3664, 4142, 4563, 4684, 5237]","[0, 241, 485, 840, 1258, 1790, 1925, 2270, 2700, 3274, 3908, 4170, 4734, 4988, 5426]","[0, 170, 383, 498, 588, 989, 1124, 1311, 1401, 1724, 2049, 2199, 2411, 2554, 2837]","[0, 170, 310, 522, 626, 768, 907, 1042, 1182, 1272, 1644, 1793, 2007, 2102, 2384]",5222,5237,5426,2837,2384,2953,1121,756,2419,995,8244,15,radiant
7519175015,54,14,96,5,79,"[0, 217, 612, 1047, 1568, 2083, 2758, 3014, 3646, 4211, 4809, 5524, 6269, 7004, 7759]","[0, 250, 871, 1656, 2116, 2874, 3311, 3943, 4470, 5191, 5690, 6320, 7167, 7826, 8472]","[0, 243, 543, 985, 1347, 1747, 2148, 2559, 3069, 3460, 4198, 4764, 5069, 5256, 5771]","[0, 130, 316, 454, 897, 1087, 1328, 1621, 1813, 2139, 2394, 2720, 2989, 3250, 3536]","[0, 130, 220, 358, 544, 682, 772, 907, 1086, 1220, 1310, 1503, 2006, 2318, 2413]",7759,8472,5771,3536,2413,10,17,2,88,20,"[0, 326, 618, 962, 1215, 1725, 2141, 2648, 3175, 3749, 4481, 4873, 5498, 6434, 7018]","[0, 327, 600, 690, 1110, 1485, 1956, 2820, 3368, 3885, 4277, 4704, 5253, 5818, 6349]","[0, 249, 423, 751, 1074, 1330, 1637, 1823, 2323, 2720, 3315, 3885, 4529, 5146, 5834]","[0, 259, 349, 473, 645, 735, 954, 1411, 1699, 2042, 2271, 2653, 3048, 3427, 3607]","[0, 210, 300, 390, 480, 713, 848, 938, 1104, 1259, 1597, 1687, 1982, 2280, 2375]",7018,6349,5834,3607,2375,741,2123,-63,-71,38,2768,15,radiant
7519190619,65,113,47,136,66,"[0, 367, 695, 1355, 1741, 2154, 3095, 3759, 4336, 4917, 5553, 5973, 7249, 7556, 7968]","[0, 257, 541, 791, 1054, 1182, 1545, 2124, 2725, 2992, 3558, 3796, 4198, 4834, 5496]","[0, 205, 366, 647, 948, 1287, 1615, 2027, 2209, 2570, 3050, 3459, 3929, 4644, 5062]","[0, 170, 260, 578, 668, 805, 940, 1286, 1527, 1769, 1938, 2112, 2413, 2810, 3396]","[0, 170, 260, 370, 512, 693, 1174, 1497, 1682, 1968, 2240, 2458, 2724, 3386, 3834]",7968,5496,5062,3396,3834,109,93,96,5,85,"[0, 469, 711, 1275, 1481, 1923, 2123, 2462, 2891, 3159, 3483, 4039, 4646, 5022, 5497]","[0, 609, 1014, 1215, 1632, 1990, 2300, 2845, 3345, 3861, 4237, 4810, 5302, 6828, 7575]","[0, 307, 468, 876, 1052, 1582, 1792, 2065, 2529, 2917, 3119, 3439, 4085, 4584, 5104]","[0, 299, 435, 634, 724, 921, 1100, 1253, 1588, 1678, 1860, 2003, 2349, 2978, 3127]","[0, 299, 389, 885, 1011, 1187, 1326, 1507, 1695, 1913, 2003, 2201, 2474, 2900, 3135]",5497,7575,5104,3127,3135,2471,-2079,-42,269,699,1318,15,radiant
7519467519,21,25,14,121,51,"[0, 301, 705, 916, 1252, 1578, 2003, 2335, 2977, 3493, 3838, 4013, 4879, 5524, 6118]","[0, 298, 493, 827, 1281, 1661, 2384, 2567, 3026, 3377, 4206, 4296, 5116, 5564, 6051]","[0, 337, 780, 952, 1288, 1680, 2225, 2803, 3279, 3575, 4197, 4301, 4769, 5223, 5575]","[0, 210, 578, 929, 1063, 1318, 1474, 1732, 1867, 2146, 2715, 2805, 3130, 3403, 3634]","[0, 210, 300, 390, 480, 570, 705, 840, 982, 1072, 1481, 1692, 1920, 2205, 2390]",6118,6051,5575,3634,2390,94,69,80,66,5,"[0, 285, 605, 1052, 1246, 1693, 2027, 2352, 2780, 3079, 3369, 3959, 4339, 5244, 5777]","[0, 239, 453, 1023, 1553, 2039, 2275, 2597, 3300, 3805, 4350, 5233, 6016, 6578, 7138]","[0, 234, 488, 690, 900, 1274, 1664, 2319, 2692, 3074, 3164, 3891, 4179, 4739, 5496]","[0, 199, 289, 443, 552, 751, 958, 1143, 1381, 1624, 1844, 2163, 2481, 2913, 3478]","[0, 467, 601, 850, 1076, 1335, 1480, 1697, 2107, 2234, 2756, 3376, 3476, 4103, 4450]",5777,7138,5496,3478,4450,341,-1087,79,156,-2060,-2571,15,radiant
7519553415,59,76,23,112,20,"[0, 290, 470, 689, 1074, 1586, 2107, 2402, 2791, 3365, 3926, 4456, 4991, 6026, 6844]","[0, 209, 467, 841, 1322, 1611, 1967, 2348, 2607, 3097, 3600, 4240, 4749, 5115, 5882]","[0, 335, 534, 926, 1211, 1374, 2168, 2378, 3006, 3281, 3605, 4027, 4369, 4865, 5374]","[0, 170, 260, 398, 488, 773, 1001, 1164, 1374, 1630, 1950, 2511, 2713, 2979, 3130]","[0, 170, 260, 350, 456, 634, 797, 920, 1169, 1779, 1914, 2182, 2272, 2598, 2891]",6844,5882,5374,3130,2891,53,106,96,51,5,"[0, 219, 500, 1047, 1425, 1829, 2159, 2350, 2630, 3380, 3821, 4146, 5262, 6071, 6729]","[0, 204, 567, 812, 1022, 1301, 1609, 1750, 2673, 2975, 3194, 3581, 3773, 4259, 4649]","[0, 206, 529, 978, 1299, 1874, 2217, 2354, 2813, 3155, 3596, 4300, 4970, 5332, 5579]","[0, 270, 360, 461, 708, 798, 933, 1200, 1416, 1701, 1879, 2075, 2317, 2504, 2835]","[0, 170, 260, 423, 559, 1015, 1443, 1533, 1917, 2142, 2277, 2453, 2543, 2692, 2822]",6729,4649,5579,2835,2822,115,1233,-205,295,69,1507,15,dire
7519656307,61,1,23,121,45,"[0, 326, 660, 906, 1396, 1647, 1900, 2163, 2692, 3185, 3560, 4088, 4887, 5314, 5716]","[0, 281, 519, 771, 1045, 1331, 1500, 1714, 2329, 2662, 2928, 3172, 3454, 4056, 4426]","[0, 242, 410, 785, 1073, 1243, 1419, 1665, 1977, 2105, 2348, 2862, 3041, 3438, 3713]","[0, 371, 481, 651, 877, 967, 1338, 1477, 1758, 1848, 1938, 2064, 2208, 2453, 2596]","[0, 203, 293, 429, 606, 752, 842, 932, 1112, 1202, 1292, 1431, 1575, 1801, 2114]",5716,4426,3713,2596,2114,113,98,20,100,26,"[0, 410, 814, 1051, 1535, 2029, 2282, 2868, 3760, 4196, 5217, 5711, 6300, 6616, 7309]","[0, 387, 748, 1112, 1351, 1794, 2007, 2450, 2850, 3398, 4252, 5060, 5704, 6220, 7251]","[0, 303, 835, 1091, 1469, 1810, 2271, 2942, 3070, 3613, 4476, 4734, 5212, 5639, 6128]","[0, 536, 694, 819, 958, 1094, 1280, 1524, 1744, 2125, 2813, 3074, 3164, 3617, 3900]","[0, 413, 503, 593, 840, 998, 1134, 1338, 1568, 1658, 2353, 2624, 3059, 3491, 3909]",7309,7251,6128,3900,3909,-1593,-2825,-2415,-1304,-1795,-9932,15,dire
7519735705,10,39,129,79,83,"[0, 288, 573, 892, 1347, 1620, 2031, 2445, 2706, 3241, 3697, 4533, 4659, 5096, 5433]","[0, 290, 543, 797, 1243, 1586, 1919, 2595, 3248, 3692, 4439, 5001, 5091, 5615, 5823]","[0, 258, 642, 923, 1335, 1683, 1975, 2391, 2791, 3201, 3558, 4108, 4375, 4739, 4884]","[0, 170, 260, 398, 534, 624, 714, 976, 1131, 1269, 1775, 1952, 2277, 2846, 3740]","[0, 272, 362, 452, 542, 749, 927, 1151, 1275, 1365, 1455, 1678, 1768, 1907, 2084]",5433,5823,4884,3740,2084,113,22,104,86,102,"[0, 260, 505, 883, 1292, 1416, 1883, 2294, 2674, 3092, 3345, 3806, 4842, 5510, 6546]","[0, 295, 700, 1023, 1324, 1707, 2149, 2413, 2753, 3045, 3620, 4325, 5623, 6062, 7154]","[0, 208, 455, 703, 1033, 1370, 1747, 2063, 2476, 2669, 3145, 3421, 3980, 4798, 5356]","[0, 170, 309, 399, 600, 739, 913, 1094, 1231, 1391, 1481, 1822, 2174, 2485, 3002]","[0, 170, 262, 398, 576, 701, 1149, 1239, 1329, 1453, 1543, 1633, 2142, 2465, 3137]",6546,7154,5356,3002,3137,-1113,-1331,-472,738,-1053,-3231,15,radiant
7519862310,61,19,23,58,92,"[0, 214, 498, 941, 1101, 1274, 1603, 2130, 2732, 3036, 3884, 4046, 4768, 5629, 6722]","[0, 527, 938, 1393, 1656, 2118, 2418, 2891, 3641, 4058, 4526, 5341, 6117, 6367, 7151]","[0, 240, 602, 1044, 1339, 1879, 2134, 2557, 3020, 3408, 3573, 4184, 4670, 5360, 5980]","[0, 455, 614, 864, 954, 1282, 1386, 1533, 2260, 2701, 3292, 3538, 3682, 4195, 5142]","[0, 379, 469, 753, 843, 1082, 1220, 1384, 1844, 2024, 2224, 2314, 2641, 2901, 3813]",6722,7151,5980,5142,3813,4,25,21,20,31,"[0, 429, 828, 1235, 1603, 2054, 2643, 3202, 3467, 3830, 4233, 4742, 5312, 5778, 6080]","[0, 463, 823, 1139, 1471, 1763, 2080, 2399, 2660, 2927, 3078, 3571, 3937, 4357, 4746]","[0, 130, 305, 593, 929, 1495, 1689, 1873, 2100, 2533, 3279, 3369, 4078, 4263, 5000]","[0, 529, 659, 796, 949, 1167, 1321, 1487, 1611, 2301, 2545, 2635, 3018, 3293, 4208]","[0, 312, 442, 532, 718, 911, 1090, 1365, 1455, 1904, 2039, 2129, 2330, 2594, 3159]",6080,4746,5000,4208,3159,642,2405,980,934,654,5615,15,radiant
7520266915,109,114,84,123,30,"[0, 323, 521, 965, 1379, 1828, 2299, 2808, 3491, 3871, 4538, 5258, 6098, 6623, 7254]","[0, 358, 717, 1151, 1589, 2056, 2604, 3142, 3796, 4402, 4896, 5588, 6235, 6676, 7160]","[0, 291, 571, 926, 1346, 1753, 2115, 2601, 3285, 3772, 4615, 5249, 5888, 6227, 6677]","[0, 169, 275, 395, 531, 1106, 1245, 1555, 1720, 2017, 2387, 2793, 3296, 3987, 4235]","[0, 169, 259, 534, 690, 827, 966, 1056, 1404, 1683, 1865, 2099, 2356, 2638, 2871]",7254,7160,6677,4235,2871,17,10,21,97,5,"[0, 331, 701, 1240, 1687, 2194, 2744, 3255, 3771, 3861, 4425, 4893, 5594, 6307, 7032]","[0, 205, 444, 819, 1029, 1325, 1814, 2084, 2386, 2704, 3040, 3480, 3919, 4439, 5281]","[0, 206, 419, 662, 1003, 1170, 1390, 1738, 2133, 2395, 2753, 2843, 3056, 3522, 4276]","[0, 205, 344, 482, 612, 778, 955, 1294, 1478, 1744, 2166, 2315, 2787, 3040, 3502]","[0, 169, 300, 416, 546, 692, 868, 1092, 1285, 1544, 1679, 1807, 2033, 2128, 2590]",7032,5281,4276,3502,2590,222,1879,2401,733,281,5516,15,radiant
7520505806,10,120,78,51,26,"[0, 248, 375, 738, 942, 1352, 1647, 2032, 2227, 2944, 3458, 3985, 4924, 5332, 5806]","[0, 282, 677, 999, 1374, 2096, 2344, 2577, 3225, 3747, 4608, 4942, 5860, 5991, 6784]","[0, 318, 593, 910, 1221, 1555, 1933, 2435, 2952, 3398, 4018, 4519, 4910, 5213, 5990]","[0, 210, 348, 484, 574, 774, 864, 1099, 1334, 1606, 2163, 2541, 2922, 3017, 3522]","[0, 210, 350, 488, 651, 839, 1022, 1451, 1671, 1943, 2078, 2172, 2424, 2721, 3103]",5806,6784,5990,3522,3103,13,41,71,20,68,"[0, 239, 558, 932, 1354, 1630, 2079, 2930, 3395, 3706, 4048, 4497, 5023, 6242, 6408]","[0, 164, 444, 684, 853, 1213, 1444, 1900, 2189, 2608, 3177, 4023, 4548, 4923, 5572]","[0, 164, 397, 595, 1083, 1250, 1830, 2274, 2613, 2779, 2956, 3385, 3693, 4152, 4617]","[0, 130, 402, 492, 746, 870, 1008, 1439, 1750, 1840, 2017, 2161, 2299, 3013, 3526]","[0, 130, 220, 310, 445, 535, 640, 805, 985, 1075, 1252, 1576, 1846, 2198, 2458]",6408,5572,4617,3526,2458,-602,1212,1373,-4,645,2624,15,dire
7520536407,93,7,104,45,100,"[0, 658, 1232, 1607, 1977, 2268, 2862, 3196, 3842, 4337, 5121, 5742, 6098, 6689, 7229]","[0, 281, 565, 887, 1166, 1849, 2219, 2566, 2977, 3192, 3533, 4073, 4543, 5141, 5330]","[0, 256, 537, 834, 1056, 1431, 1853, 2308, 2698, 3041, 3588, 4195, 4463, 5078, 5438]","[0, 169, 294, 444, 534, 638, 805, 1034, 1141, 1324, 1460, 1820, 2103, 2448, 2635]","[0, 234, 388, 523, 658, 865, 1077, 1212, 1388, 1543, 1673, 1954, 2044, 2275, 2370]",7229,5330,5438,2635,2370,53,18,84,52,88,"[0, 169, 259, 401, 805, 944, 1508, 1728, 1863, 2346, 2894, 3207, 3992, 4792, 5396]","[0, 215, 625, 992, 1249, 1658, 1919, 2243, 2760, 3273, 3725, 4167, 4653, 5236, 5842]","[0, 169, 368, 647, 1138, 1266, 1727, 2164, 2467, 2703, 2838, 3529, 4194, 4526, 5096]","[0, 288, 589, 953, 1245, 1669, 2304, 2780, 3218, 3918, 4189, 4830, 5087, 5702, 6338]","[0, 169, 259, 349, 607, 697, 787, 1105, 1240, 1375, 1759, 1935, 2025, 2506, 2806]",5396,5842,5096,6338,2806,1833,-512,342,-3703,-436,-2476,15,dire
7520564105,19,63,71,45,78,"[0, 292, 581, 863, 1236, 1666, 2164, 2539, 3591, 4110, 4643, 5055, 5627, 6029, 6408]","[0, 322, 632, 969, 1135, 1414, 1669, 2112, 2202, 2701, 3162, 3655, 4005, 4537, 5366]","[0, 170, 260, 396, 549, 639, 852, 1508, 1913, 2126, 2710, 3365, 3949, 4359, 5127]","[100, 270, 695, 785, 1139, 1373, 1791, 2054, 2295, 2561, 3046, 3277, 3613, 3906, 4293]","[0, 277, 508, 820, 1259, 1420, 1920, 2152, 2397, 2861, 3201, 3569, 3800, 4203, 4405]",6408,5366,5127,4293,4405,48,7,128,20,51,"[0, 205, 561, 1068, 1349, 1921, 2372, 3043, 3665, 4061, 4630, 5383, 6552, 7286, 8075]","[0, 295, 610, 950, 1286, 1648, 1857, 2041, 2262, 2684, 3056, 3493, 3712, 4390, 4682]","[0, 208, 485, 747, 1111, 1531, 1942, 2342, 2834, 3276, 3818, 4376, 4795, 5300, 5728]","[0, 170, 260, 574, 664, 881, 1064, 1256, 1748, 1891, 2060, 2397, 2822, 3485, 3971]","[0, 170, 260, 350, 484, 693, 875, 1617, 1852, 2162, 2345, 2767, 3145, 3700, 4132]",8075,4682,5728,3971,4132,-1667,684,-601,322,273,-989,15,dire
7520586007,109,106,2,45,26,"[0, 166, 408, 817, 1056, 1360, 1797, 2191, 2410, 2617, 2966, 3362, 3607, 4015, 4143]","[0, 289, 687, 1050, 1370, 1619, 1824, 2288, 2465, 2555, 2770, 2974, 3157, 3412, 3541]","[0, 164, 336, 635, 857, 986, 1605, 1773, 1879, 2128, 2318, 2504, 2915, 3010, 3434]","[0, 130, 220, 356, 446, 583, 794, 900, 1149, 1328, 1724, 2148, 2293, 2388, 2483]","[0, 130, 258, 348, 521, 611, 1099, 1189, 1279, 1369, 1585, 1815, 1960, 2055, 2150]",4143,3541,3434,2483,2150,6,120,129,86,51,"[63, 363, 791, 1121, 1406, 1853, 2274, 3355, 3653, 4240, 4938, 5939, 6576, 7628, 8704]","[63, 312, 680, 1134, 1457, 1863, 2371, 2618, 2928, 3674, 4335, 5215, 5924, 6317, 7294]","[63, 362, 659, 1138, 1512, 2094, 2589, 3294, 3927, 4521, 5045, 5496, 5834, 6287, 6539]","[63, 273, 454, 593, 972, 1245, 1632, 2039, 2246, 2485, 3064, 3735, 3884, 4550, 4801]","[331, 541, 927, 1213, 1518, 1659, 1839, 2199, 2340, 2832, 3075, 3480, 3629, 4063, 4474]",8704,7294,6539,4801,4474,-4561,-3753,-3105,-2318,-2324,-16061,15,dire
7520687701,89,69,65,106,72,"[623, 859, 1026, 1230, 1415, 1699, 2108, 2338, 2768, 3269, 3912, 4548, 5278, 5760, 6392]","[449, 662, 792, 1120, 1406, 1573, 2037, 2204, 2417, 2965, 3268, 3665, 3945, 4646, 5328]","[250, 448, 578, 668, 1044, 1444, 1722, 1849, 1975, 2255, 2394, 2562, 2944, 3316, 4306]","[488, 816, 1228, 1508, 1839, 2256, 2433, 2616, 2706, 3092, 3337, 3565, 3660, 3860, 4191]","[437, 527, 657, 747, 1123, 1421, 1878, 2004, 2094, 2238, 2379, 2536, 2631, 3065, 3311]",6392,5328,4306,4191,3311,98,7,21,66,100,"[606, 934, 1466, 1768, 2238, 2881, 3478, 4263, 4668, 5188, 5706, 6718, 7265, 8131, 9112]","[606, 938, 1351, 1786, 2187, 2899, 3251, 3949, 4809, 5223, 5927, 6301, 7190, 7443, 8552]","[610, 1016, 1659, 2142, 2569, 3079, 3323, 4048, 4656, 5205, 5799, 6391, 7069, 7550, 8426]","[724, 927, 1152, 1308, 1623, 2627, 2831, 3516, 3859, 4202, 4893, 5485, 5928, 6483, 7041]","[386, 476, 641, 743, 958, 1308, 1478, 2269, 2505, 2685, 3036, 3410, 3669, 3809, 4621]",9112,8552,8426,7041,4621,-2720,-3224,-4120,-2850,-1310,-14224,15,dire
7520694012,81,52,135,20,75,"[0, 328, 652, 1122, 1471, 2040, 2542, 2867, 3411, 3865, 4310, 4715, 5108, 5669, 6187]","[0, 331, 718, 1117, 1497, 1815, 2278, 2847, 3517, 4059, 4784, 5120, 5956, 6383, 6774]","[0, 292, 495, 789, 1283, 1576, 2238, 2647, 2981, 3621, 4172, 4634, 4949, 5343, 5638]","[0, 170, 364, 532, 670, 936, 1300, 1613, 2050, 2287, 2754, 2933, 3509, 3642, 4280]","[0, 170, 297, 387, 523, 706, 1040, 1175, 1400, 1619, 1913, 2003, 2676, 3007, 3274]",6187,6774,5638,4280,3274,18,42,97,9,101,"[0, 252, 1000, 1394, 1774, 2141, 2423, 2921, 3232, 3776, 4227, 4792, 5522, 6277, 6889]","[0, 205, 476, 636, 998, 1207, 1583, 1800, 1924, 2014, 2493, 2915, 3278, 3823, 4307]","[0, 279, 442, 721, 1092, 1409, 1851, 2106, 2420, 2944, 3196, 4051, 4452, 5369, 5841]","[0, 170, 395, 566, 924, 1379, 1558, 1817, 1971, 2425, 2578, 2858, 3139, 3347, 3610]","[0, 170, 364, 454, 814, 904, 1034, 1124, 1752, 2061, 2299, 2479, 2623, 2916, 3367]",6889,4307,5841,3610,3367,-702,2467,-203,670,-93,2139,15,dire
7520723202,76,28,71,58,40,"[0, 169, 560, 877, 1075, 1486, 1824, 2340, 2805, 3206, 3808, 4311, 4809, 5331, 5689]","[0, 215, 574, 947, 1164, 1652, 2014, 2378, 2739, 3517, 4119, 4508, 5488, 6413, 6834]","[100, 299, 603, 864, 1144, 1369, 1672, 2012, 2363, 2920, 3558, 4197, 5027, 5759, 6052]","[78, 207, 297, 400, 501, 666, 813, 1409, 1577, 1667, 1941, 2646, 3171, 3851, 4253]","[211, 340, 430, 566, 656, 910, 1102, 1272, 1491, 1834, 2358, 2768, 3063, 3726, 4062]",5689,6834,6052,4253,4062,10,98,61,79,136,"[62, 271, 509, 819, 1159, 1646, 2238, 2697, 3196, 3536, 3795, 4075, 4514, 5185, 6106]","[330, 695, 982, 1393, 1719, 1929, 2436, 2896, 3320, 4060, 4655, 5410, 6237, 6600, 7252]","[62, 271, 622, 910, 1228, 1380, 1673, 1838, 2038, 2202, 2414, 2758, 3119, 3451, 4012]","[162, 416, 506, 677, 767, 897, 1049, 1236, 1407, 1785, 1905, 2103, 2694, 2989, 3119]","[62, 271, 361, 500, 594, 795, 978, 1068, 1158, 1248, 1592, 1812, 2095, 2513, 2784]",6106,7252,4012,3119,2784,-417,-418,2040,1134,1278,3617,15,dire
7520754303,90,93,69,5,26,"[324, 748, 1043, 1426, 1868, 2332, 3081, 3735, 4678, 5108, 5662, 6422, 6990, 7800, 8513]","[277, 474, 814, 1093, 1366, 2124, 2705, 2925, 3320, 4044, 4743, 5310, 5860, 6331, 6823]","[240, 522, 1172, 1487, 1772, 1983, 2399, 3083, 3751, 4178, 4939, 5811, 6200, 6524, 7372]","[219, 393, 581, 758, 897, 1453, 1591, 1699, 1991, 2408, 2864, 3046, 3514, 4249, 4565]","[207, 331, 598, 688, 859, 1072, 1213, 1444, 1789, 1915, 2327, 2569, 2754, 2939, 3033]",8513,6823,7372,4565,3033,1,106,102,110,138,"[239, 509, 835, 1195, 1484, 2128, 2566, 2745, 3160, 3499, 3751, 4051, 4765, 5139, 5505]","[287, 602, 980, 1375, 1885, 2311, 2813, 3218, 3528, 4071, 4259, 4519, 5239, 5510, 5913]","[204, 431, 632, 874, 1068, 1203, 1428, 1749, 1964, 2099, 2547, 2820, 3054, 3149, 3374]","[169, 278, 467, 606, 796, 963, 1188, 1514, 1759, 2028, 2253, 2347, 3138, 3917, 4066]","[169, 305, 475, 609, 783, 918, 1143, 1285, 1568, 2084, 2263, 2638, 3039, 3255, 3477]",5505,5913,3374,4066,3477,3008,910,3998,499,-444,7971,15,radiant
7520855809,98,21,96,121,112,"[0, 331, 648, 1142, 1475, 1776, 2314, 2722, 3284, 3586, 4122, 4623, 5076, 5378, 5685]","[0, 257, 593, 878, 1228, 1811, 2184, 2606, 2909, 3499, 3751, 4383, 4851, 5061, 5782]","[0, 205, 333, 622, 1103, 1324, 1414, 1825, 2145, 2482, 3105, 3406, 3619, 3887, 4421]","[0, 218, 308, 398, 567, 703, 835, 925, 1015, 1239, 1491, 1873, 1963, 2093, 2260]","[0, 169, 259, 349, 519, 649, 775, 984, 1074, 1164, 1416, 1588, 1810, 1932, 2536]",5685,5782,4421,2260,2536,47,61,129,91,26,"[0, 297, 531, 914, 1373, 2018, 2591, 3113, 3702, 4114, 5165, 5584, 6330, 7637, 8241]","[0, 169, 414, 816, 1036, 1455, 1747, 2299, 2838, 3384, 3865, 4430, 4861, 5614, 6254]","[0, 169, 499, 756, 1343, 1516, 1848, 2052, 2577, 2956, 3436, 3853, 4019, 4878, 5271]","[0, 169, 259, 396, 612, 799, 951, 1180, 1363, 1557, 1943, 2131, 2480, 3248, 3404]","[0, 169, 277, 415, 576, 666, 764, 944, 1153, 1243, 1489, 1677, 1767, 2281, 2505]",8241,6254,5271,3404,2505,-2556,-472,-850,-1144,31,-4991,15,dire
7520918903,90,14,96,92,31,"[0, 207, 531, 985, 1510, 2187, 2677, 3559, 3988, 4847, 5961, 6606, 7461, 8195, 8822]","[0, 292, 656, 921, 1449, 1709, 2161, 2708, 3117, 3497, 3861, 4307, 5173, 5710, 6214]","[0, 556, 1028, 1276, 1688, 2063, 2419, 2794, 3548, 4077, 4556, 5073, 5593, 6057, 6228]","[0, 240, 401, 539, 884, 1018, 1108, 1226, 1618, 1936, 2247, 2391, 2917, 3429, 3618]","[0, 169, 462, 552, 789, 900, 1092, 1246, 1423, 1693, 2107, 2322, 2603, 3156, 3336]",8822,6214,6228,3618,3336,126,73,60,20,87,"[0, 213, 600, 971, 1396, 1851, 2216, 3047, 3934, 4196, 4978, 5743, 6302, 6665, 8098]","[0, 249, 594, 684, 949, 1191, 1524, 2114, 2349, 2753, 3029, 3360, 3766, 4413, 4973]","[0, 206, 608, 1010, 1253, 1882, 2164, 2340, 2684, 3146, 3462, 3736, 4204, 4592, 5202]","[0, 169, 284, 374, 464, 776, 945, 1175, 1564, 1789, 2105, 2423, 2513, 2662, 3532]","[0, 169, 371, 506, 596, 686, 902, 992, 1082, 1307, 1489, 1579, 1794, 1967, 2618]",8098,4973,5202,3532,2618,724,1241,1026,86,718,3795,15,radiant
7521011714,10,102,59,112,66,"[0, 242, 531, 864, 1188, 1516, 1887, 2300, 2724, 3094, 3641, 4185, 4716, 5603, 6421]","[0, 254, 522, 1001, 1351, 1479, 1940, 2262, 2648, 2809, 3334, 3730, 4308, 4728, 5442]","[0, 313, 566, 859, 1376, 1836, 2334, 2945, 3246, 3711, 3963, 4635, 5243, 5576, 5848]","[0, 207, 297, 818, 1026, 1116, 1297, 1432, 1699, 1835, 2269, 2749, 3062, 3450, 3729]","[0, 272, 362, 499, 633, 821, 942, 1178, 1473, 1640, 1974, 2425, 2899, 3071, 3447]",6421,5442,5848,3729,3447,44,17,43,71,5,"[0, 205, 630, 921, 1201, 1414, 1577, 1913, 2336, 2865, 3343, 3784, 4330, 4808, 5195]","[0, 327, 534, 965, 1215, 1398, 1738, 2000, 2878, 3053, 3538, 4129, 4673, 4994, 5570]","[0, 208, 543, 866, 1161, 1439, 1775, 2138, 2818, 3294, 4162, 4676, 5384, 5976, 6682]","[0, 170, 365, 542, 769, 859, 962, 1100, 1508, 1873, 2243, 2382, 2582, 2903, 3185]","[0, 170, 260, 574, 704, 840, 992, 1131, 1266, 1458, 1835, 1925, 2149, 2930, 3078]",5195,5570,6682,3185,3078,1226,-128,-834,544,369,1177,15,radiant
7521225303,46,49,76,58,26,"[368, 681, 858, 1228, 1579, 1976, 2422, 2675, 3301, 3852, 4455, 5006, 5747, 6165, 6953]","[283, 620, 863, 1278, 1488, 1689, 1906, 2355, 2795, 3223, 3899, 4198, 4619, 5196, 5291]","[288, 580, 995, 1374, 1730, 2292, 2865, 3138, 3568, 3795, 4149, 4593, 5076, 5332, 5828]","[210, 300, 508, 659, 836, 943, 1237, 1468, 1595, 2014, 2228, 2428, 2614, 2725, 2930]","[254, 344, 451, 631, 721, 811, 991, 1402, 1536, 1626, 1960, 2280, 2492, 2987, 3290]",6953,5291,5828,2930,3290,82,14,69,63,123,"[274, 562, 809, 1103, 1578, 2235, 2540, 3309, 3822, 4471, 5134, 5624, 6209, 7343, 8294]","[130, 544, 862, 1095, 1462, 1807, 2462, 2841, 3608, 4177, 4725, 5283, 5824, 6290, 6748]","[202, 530, 903, 1131, 1782, 2003, 2663, 3298, 3588, 4350, 4845, 5891, 6481, 7264, 7867]","[166, 256, 879, 969, 1186, 1276, 1448, 1647, 1821, 2204, 2316, 2406, 2677, 3205, 3567]","[181, 271, 413, 599, 867, 1225, 1360, 1614, 1788, 2035, 2125, 2394, 2794, 3148, 3412]",8294,6748,7867,3567,3412,-1341,-1457,-2039,-637,-122,-5596,15,dire
7521480417,12,107,21,85,138,"[0, 281, 630, 988, 1483, 1718, 1981, 2071, 2224, 2581, 2769, 3497, 4065, 4595, 5251]","[0, 319, 602, 1087, 1448, 1720, 2083, 2483, 2861, 3150, 3361, 3800, 4104, 4532, 5545]","[0, 282, 615, 1019, 1485, 1781, 2206, 2964, 3455, 4059, 4488, 5235, 5764, 6372, 7425]","[0, 170, 260, 397, 532, 628, 763, 952, 1170, 1471, 1787, 2209, 2299, 2533, 2903]","[0, 170, 304, 439, 575, 665, 800, 890, 1141, 1346, 1531, 1999, 2089, 2284, 2941]",5251,5545,7425,2903,2941,10,129,137,26,100,"[0, 285, 589, 871, 1395, 1609, 2078, 2609, 2952, 3503, 4137, 4505, 5043, 5563, 6187]","[0, 240, 562, 824, 1144, 1468, 1938, 2369, 2622, 3151, 3703, 4308, 4864, 5257, 5538]","[0, 170, 420, 741, 996, 1408, 1858, 2717, 3361, 3629, 4248, 4338, 4967, 5489, 6273]","[0, 170, 619, 709, 858, 992, 1082, 1513, 1675, 1765, 2023, 2113, 2220, 2413, 2692]","[0, 170, 260, 350, 572, 676, 766, 946, 1104, 1251, 1431, 1728, 1818, 2217, 2447]",6187,5538,6273,2692,2447,-936,7,1152,211,494,928,15,dire
7522240610,102,98,97,56,112,"[0, 244, 585, 935, 1180, 1379, 1656, 2114, 2418, 2791, 3447, 3993, 4636, 5061, 5455]","[0, 279, 596, 878, 1243, 1609, 1974, 2292, 2733, 3037, 3665, 4148, 4414, 4961, 5794]","[0, 209, 409, 734, 894, 1225, 1524, 1922, 2404, 2646, 2977, 3480, 3720, 3944, 4386]","[0, 209, 324, 745, 835, 1055, 1189, 1411, 1536, 1750, 2024, 2207, 2377, 2612, 2892]","[0, 255, 421, 587, 715, 805, 911, 1046, 1239, 1374, 1718, 1928, 2279, 2462, 2770]",5455,5794,4386,2892,2770,38,21,22,19,58,"[0, 129, 390, 756, 1317, 1566, 2099, 2531, 2807, 3135, 3270, 3517, 4144, 4502, 5173]","[0, 281, 505, 925, 1292, 1505, 1790, 2155, 2596, 2855, 3191, 3748, 4244, 4944, 5259]","[0, 284, 550, 966, 1247, 1530, 1994, 2491, 2831, 3356, 3857, 4220, 4721, 5165, 5475]","[0, 129, 244, 334, 587, 677, 901, 991, 1081, 1381, 1764, 1955, 2164, 2469, 2965]","[0, 474, 589, 679, 875, 985, 1120, 1274, 1666, 1931, 2066, 2176, 2422, 3224, 3370]",5173,5259,5475,2965,3370,282,535,-1089,-73,-600,-945,15,dire
7522292402,1,35,14,22,64,"[0, 286, 662, 1088, 1419, 1782, 2178, 2672, 3693, 4237, 4688, 5139, 5611, 6536, 7296]","[0, 360, 770, 1170, 1570, 2010, 2478, 2990, 3470, 4110, 4633, 5258, 5725, 6471, 7252]","[0, 331, 638, 967, 1413, 1835, 2257, 2620, 2981, 3548, 4024, 4187, 4703, 5467, 6091]","[0, 210, 330, 475, 748, 949, 1086, 1242, 1528, 1752, 1971, 2477, 2629, 3112, 3387]","[0, 210, 300, 492, 601, 754, 864, 954, 1044, 1273, 1497, 1622, 1712, 1997, 2200]",7296,7252,6091,3387,2200,44,11,129,84,86,"[0, 167, 535, 862, 1190, 1486, 1950, 2325, 2747, 3027, 3439, 4058, 4715, 5362, 5908]","[0, 286, 617, 1062, 1452, 1951, 2521, 3074, 3877, 4620, 5175, 5727, 6455, 7273, 7948]","[0, 203, 444, 802, 1178, 1622, 1903, 2547, 2916, 3237, 3604, 4137, 4761, 5217, 5690]","[0, 130, 220, 366, 502, 592, 729, 897, 1032, 1122, 1212, 1348, 1600, 1694, 1872]","[0, 130, 220, 310, 400, 490, 580, 764, 928, 1103, 1275, 1742, 1994, 2170, 2265]",5908,7948,5690,1872,2265,1388,-696,401,1515,-65,2543,15,radiant
7522384400,95,137,110,97,101,"[0, 262, 575, 803, 1278, 1877, 2253, 2433, 2907, 3359, 3874, 4400, 4978, 5459, 5858]","[0, 158, 317, 558, 801, 1069, 1438, 1892, 2661, 2838, 3312, 3501, 3591, 4391, 5209]","[0, 434, 524, 614, 783, 1179, 1364, 1746, 1836, 2051, 2322, 2558, 2806, 3301, 3666]","[0, 169, 520, 819, 1477, 1768, 2135, 2453, 2852, 3219, 3473, 3775, 4091, 4807, 5258]","[0, 311, 401, 491, 850, 1168, 1393, 1573, 1849, 2074, 2345, 2789, 2924, 3317, 3446]",5858,5209,3666,5258,3446,25,28,135,86,26,"[381, 673, 968, 1446, 1728, 2117, 2523, 3134, 3503, 4097, 4389, 4867, 5373, 5678, 6271]","[246, 565, 850, 1227, 1471, 1969, 2365, 2924, 3419, 3972, 4692, 5245, 5937, 6415, 7266]","[113, 356, 609, 847, 1025, 1199, 1475, 1982, 2397, 3013, 3442, 3962, 4664, 5199, 5627]","[113, 322, 412, 589, 679, 851, 976, 1503, 2322, 2535, 2888, 3126, 3306, 3800, 4168]","[113, 322, 412, 635, 770, 860, 950, 1220, 1518, 1733, 1978, 2305, 2541, 2744, 3250]",6271,7266,5627,4168,3250,-413,-2057,-1961,1090,196,-3145,15,radiant
7522545002,93,47,110,20,14,"[0, 243, 708, 1421, 1631, 2209, 2632, 2874, 3125, 3502, 3997, 5016, 5342, 6086, 6824]","[0, 583, 819, 1080, 1411, 1647, 1811, 2015, 2563, 2927, 3354, 3698, 4228, 4688, 5081]","[0, 170, 369, 459, 549, 639, 831, 921, 1101, 1514, 2538, 2899, 3034, 3335, 3883]","[0, 277, 690, 1059, 1257, 1458, 1548, 1757, 2143, 2347, 2714, 2980, 3382, 3796, 3977]","[0, 239, 532, 874, 1035, 1222, 1395, 1485, 1795, 1984, 2361, 2541, 3148, 3351, 3646]",6824,5081,3883,3977,3646,25,29,70,27,121,"[0, 222, 592, 924, 1316, 1813, 2531, 3073, 3755, 4175, 4419, 4763, 5279, 5664, 6673]","[0, 241, 478, 1014, 1311, 1514, 1812, 2490, 3043, 3714, 4319, 4556, 4923, 5495, 5886]","[0, 244, 668, 871, 1281, 1516, 1985, 2253, 2795, 2968, 3218, 3523, 4220, 4809, 5432]","[0, 272, 379, 560, 690, 780, 915, 1054, 1198, 1329, 1554, 1644, 1778, 2016, 2692]","[0, 170, 462, 768, 943, 1072, 1345, 1505, 1731, 1857, 2082, 2172, 2409, 2656, 3108]",6673,5886,5432,2692,3108,151,-805,-1549,1285,538,-380,15,dire
7522558918,39,21,15,100,20,"[330, 578, 827, 1078, 1586, 2128, 2703, 3475, 4134, 4722, 5958, 6448, 7200, 7999, 8698]","[62, 389, 938, 1234, 1805, 2182, 2506, 3101, 3841, 4517, 5242, 5884, 6064, 7163, 8056]","[62, 392, 775, 984, 1510, 1854, 2119, 2598, 3015, 3745, 4238, 5597, 6010, 6896, 7270]","[62, 272, 423, 513, 681, 851, 941, 1381, 1597, 1745, 2174, 2354, 2534, 3160, 3507]","[62, 272, 362, 486, 647, 1020, 1110, 1270, 1415, 1641, 1876, 2121, 2446, 3026, 3337]",8698,8056,7270,3507,3337,90,102,29,112,121,"[0, 312, 596, 855, 1028, 1290, 1747, 2088, 2419, 2672, 2925, 3015, 3789, 4084, 4464]","[0, 193, 513, 972, 1311, 1593, 1844, 2204, 2342, 2611, 3139, 3575, 4242, 4951, 5142]","[0, 155, 436, 732, 1012, 1272, 1362, 1542, 1677, 1767, 2140, 2419, 2806, 3163, 3386]","[0, 155, 245, 335, 425, 515, 605, 785, 875, 965, 1182, 1571, 1661, 1966, 2061]","[0, 155, 291, 451, 649, 874, 1013, 1278, 1554, 1726, 2116, 2378, 2821, 2996, 3146]",4464,5142,3386,2061,3146,4234,2914,3884,1446,191,12669,15,radiant
7522585414,65,48,23,58,112,"[0, 295, 466, 957, 1255, 1782, 2334, 2918, 3661, 4163, 4726, 5616, 6331, 6688, 7566]","[0, 322, 566, 817, 1210, 1385, 1674, 1800, 2036, 2308, 2890, 3386, 4076, 4605, 5356]","[0, 254, 447, 696, 977, 1477, 2034, 2218, 2845, 3157, 3429, 3846, 4282, 4559, 5211]","[0, 169, 363, 536, 889, 1026, 1436, 1777, 1903, 1993, 2253, 2347, 2840, 2935, 3097]","[0, 169, 294, 384, 518, 741, 1003, 1187, 1389, 1838, 2235, 2502, 2706, 2801, 3160]",7566,5356,5211,3097,3160,54,21,20,136,45,"[0, 251, 566, 911, 1186, 1585, 2022, 2530, 3008, 3431, 3925, 4346, 4778, 5047, 5863]","[0, 303, 702, 1026, 1358, 1814, 2360, 2766, 3353, 4114, 4672, 5256, 5756, 6184, 7049]","[0, 542, 791, 1313, 1713, 2108, 2522, 3206, 3931, 4681, 5175, 5524, 5823, 6215, 6666]","[0, 238, 328, 519, 1195, 1367, 2048, 2235, 2588, 2901, 3219, 3367, 4023, 4234, 4472]","[0, 169, 309, 429, 519, 653, 872, 996, 1131, 1303, 1647, 1945, 2295, 2768, 3006]",5863,7049,6666,4472,3006,1703,-1693,-1455,-1375,154,-2666,15,dire
7522659008,25,74,23,102,45,"[0, 284, 679, 1093, 1541, 2179, 2470, 2946, 3516, 3944, 5308, 5961, 6622, 7458, 8703]","[0, 169, 366, 728, 1002, 1457, 1781, 2225, 2641, 3007, 3695, 4319, 4914, 5286, 5886]","[0, 244, 585, 1148, 1276, 1705, 1839, 2043, 2391, 2597, 2948, 3338, 3517, 4105, 4729]","[0, 169, 284, 422, 530, 926, 1071, 1249, 1347, 1519, 2147, 2417, 2575, 2775, 3245]","[0, 219, 334, 569, 721, 873, 963, 1444, 1534, 1671, 2187, 2608, 2794, 2889, 3391]",8703,5886,4729,3245,3391,52,76,14,71,79,"[58, 349, 725, 1098, 1467, 1882, 2228, 2781, 3214, 3422, 3588, 4348, 4609, 5717, 6397]","[326, 533, 893, 1179, 1481, 1853, 2172, 2699, 3154, 3833, 4067, 4365, 4833, 5232, 6000]","[58, 227, 395, 707, 1158, 1322, 1537, 2317, 2653, 2861, 3196, 3750, 4219, 4562, 4949]","[58, 227, 317, 407, 581, 711, 849, 1087, 1286, 1483, 1814, 2112, 2448, 2723, 2818]","[58, 227, 317, 407, 584, 714, 823, 1148, 1283, 1373, 1463, 1679, 2016, 2586, 2964]",6397,6000,4949,2818,2964,2306,-114,-220,427,427,2826,15,radiant
7522961618,25,95,104,128,51,"[0, 204, 539, 783, 1242, 1610, 1936, 2581, 2882, 3342, 4334, 4652, 5043, 5902, 6823]","[0, 285, 488, 816, 1187, 1518, 2078, 2474, 2932, 3480, 3660, 4132, 4641, 5026, 5671]","[0, 295, 424, 879, 1155, 1281, 1571, 1698, 1833, 2213, 2491, 2791, 3174, 3555, 3918]","[0, 169, 276, 366, 536, 715, 850, 940, 1075, 1630, 2009, 2201, 2291, 2657, 3169]","[0, 169, 259, 349, 538, 719, 898, 988, 1123, 1561, 1741, 2064, 2154, 2458, 3149]",6823,5671,3918,3169,3149,10,74,129,85,121,"[0, 253, 690, 1216, 1806, 2644, 3167, 3734, 4436, 4720, 5396, 6009, 6547, 6921, 7499]","[0, 240, 376, 703, 993, 1289, 1611, 1953, 2494, 2906, 3295, 3842, 4409, 4953, 5260]","[0, 203, 516, 759, 1094, 1307, 1681, 1987, 2411, 2890, 3769, 4277, 4747, 5274, 5631]","[0, 169, 259, 422, 681, 980, 1074, 1276, 1456, 1657, 2022, 2285, 2528, 2773, 2922]","[0, 169, 259, 349, 487, 577, 667, 864, 1044, 1201, 1626, 1855, 2053, 2495, 2819]",7499,5260,5631,2922,2819,-676,411,-1713,247,330,-1401,15,dire
7523301704,21,106,77,53,100,"[0, 271, 719, 1176, 1496, 2013, 2392, 2976, 3891, 4963, 5532, 6139, 6795, 7401, 8528]","[0, 538, 749, 1071, 1448, 1710, 2126, 2821, 3202, 3989, 4398, 5454, 5851, 6287, 7208]","[0, 295, 585, 872, 1343, 1874, 2288, 2792, 3302, 3749, 4339, 5301, 5568, 6286, 7303]","[0, 236, 326, 416, 617, 1003, 1138, 1649, 1803, 2135, 2313, 2910, 3187, 3923, 4362]","[0, 236, 391, 621, 711, 882, 1185, 1402, 1698, 2345, 2623, 3277, 3566, 3946, 4467]",8528,7208,7303,4362,4467,25,84,96,71,86,"[0, 207, 386, 596, 802, 1185, 1647, 2255, 2587, 3110, 3594, 4338, 4969, 5618, 5983]","[0, 369, 811, 1187, 1516, 1738, 1982, 2496, 2944, 3079, 3424, 3903, 4625, 5395, 5584]","[0, 170, 443, 698, 1078, 1291, 1865, 2326, 2536, 2792, 3123, 4194, 4615, 4865, 5176]","[0, 170, 260, 350, 527, 680, 770, 1183, 1538, 1742, 1832, 2069, 2366, 2755, 2938]","[0, 170, 260, 552, 688, 1132, 1316, 1616, 1944, 2124, 2214, 2767, 3026, 3239, 3571]",5983,5584,5176,2938,3571,2545,1624,2127,1424,896,8616,15,radiant
7523505303,41,104,23,86,5,"[0, 294, 619, 816, 1274, 1557, 1935, 2587, 2924, 3309, 3618, 4483, 4951, 5743, 6429]","[0, 295, 638, 934, 1312, 1717, 2374, 2711, 3162, 3871, 4691, 5564, 5733, 6700, 7186]","[0, 368, 596, 883, 1175, 1614, 1938, 2177, 2371, 2461, 2770, 2978, 3373, 3851, 4511]","[0, 209, 368, 590, 730, 942, 1337, 1782, 1872, 1962, 2576, 3016, 3225, 4006, 4688]","[0, 209, 324, 414, 794, 932, 1185, 1442, 1578, 1824, 2290, 2580, 2914, 3414, 3735]",6429,7186,4511,4688,3735,84,114,1,100,68,"[0, 282, 651, 1003, 1487, 1887, 2183, 2632, 2922, 3305, 3903, 4193, 4930, 5651, 6193]","[0, 257, 657, 1112, 1521, 2048, 2602, 2968, 3387, 4230, 4826, 5714, 6358, 6453, 7045]","[0, 163, 478, 762, 959, 1135, 1450, 1981, 2301, 2774, 3065, 3424, 3891, 4200, 4698]","[0, 129, 219, 696, 861, 1171, 1307, 1397, 1618, 1758, 2073, 2522, 2884, 2979, 3074]","[0, 129, 219, 322, 412, 502, 592, 726, 816, 956, 1046, 1289, 1518, 1731, 1826]",6193,7045,4698,3074,1826,236,141,-187,1614,1909,3713,15,radiant
7523717218,48,74,129,96,26,"[0, 252, 566, 880, 1161, 1521, 2010, 2518, 2987, 3526, 4069, 4698, 5344, 6018, 6815]","[0, 245, 536, 898, 1629, 2009, 2726, 3271, 3415, 3695, 4125, 4314, 4737, 5235, 5527]","[0, 285, 592, 831, 1254, 1434, 1673, 2131, 2447, 2905, 3190, 3705, 4118, 4649, 4919]","[0, 170, 260, 395, 525, 664, 992, 1417, 1507, 1597, 1918, 2342, 2559, 2980, 3413]","[0, 170, 260, 350, 528, 618, 754, 1071, 1330, 1549, 1684, 1873, 2139, 2317, 2507]",6815,5527,4919,3413,2507,46,17,69,20,45,"[0, 256, 525, 936, 1266, 1663, 2064, 2414, 2940, 3520, 4225, 4824, 5244, 6138, 6875]","[0, 355, 559, 848, 1081, 1304, 1745, 1997, 2468, 3057, 3412, 3930, 4286, 4848, 5706]","[0, 170, 402, 529, 973, 1295, 1618, 1960, 2095, 2377, 2759, 3195, 3550, 4133, 4572]","[0, 170, 260, 471, 787, 927, 1027, 1248, 1657, 2015, 2251, 2462, 3056, 3361, 3745]","[0, 259, 400, 577, 770, 956, 1046, 1136, 1348, 1571, 1708, 2043, 2312, 2661, 2939]",6875,5706,4572,3745,2939,-60,-179,347,-332,-432,-656,15,radiant
7523787713,78,41,76,105,110,"[229, 566, 805, 1289, 1604, 1778, 2081, 2334, 2598, 2932, 3398, 3901, 4355, 4449, 4715]","[168, 576, 824, 1310, 1552, 2062, 2616, 3070, 3593, 3909, 4188, 4619, 4942, 5236, 5616]","[300, 461, 840, 1156, 1448, 2000, 2259, 2682, 3091, 3510, 3978, 4305, 4740, 5139, 5566]","[193, 283, 420, 796, 886, 1072, 1532, 1693, 1938, 2028, 2212, 2302, 2450, 2556, 2675]","[461, 551, 641, 820, 910, 1000, 1348, 1748, 1838, 1984, 2210, 2554, 2974, 3323, 3589]",4715,5616,5566,2675,3589,10,120,129,128,51,"[245, 556, 1046, 1565, 1959, 2460, 2977, 3559, 4032, 4579, 5262, 5832, 6561, 7257, 7778]","[291, 580, 929, 1252, 1574, 1827, 2136, 2620, 3096, 3662, 4313, 4706, 5314, 6155, 6818]","[248, 549, 812, 1049, 1338, 1647, 1943, 2340, 2559, 2990, 3295, 3851, 4239, 4768, 5580]","[210, 325, 450, 580, 736, 874, 1058, 1193, 1283, 1556, 1695, 2075, 2387, 2717, 3203]","[210, 325, 415, 591, 711, 817, 1174, 1309, 1399, 1740, 1874, 2284, 2615, 3034, 3399]",7778,6818,5580,3203,3399,-3063,-1202,-14,-528,190,-4617,15,dire
7523882604,48,98,129,53,26,"[0, 242, 597, 907, 1441, 1814, 2006, 2484, 3004, 3722, 4428, 5117, 5739, 6266, 7194]","[0, 208, 872, 1184, 1672, 2110, 2703, 3494, 3928, 4829, 5579, 6419, 7144, 7589, 8181]","[0, 255, 614, 1063, 1405, 1874, 2398, 2897, 3194, 3942, 4566, 5240, 5662, 6604, 6969]","[0, 211, 301, 608, 1002, 1333, 1486, 1666, 2068, 2446, 3151, 3536, 4028, 4556, 4906]","[0, 170, 528, 674, 827, 962, 1160, 1508, 1705, 2041, 2457, 2926, 3107, 3579, 4098]",7194,8181,6969,4906,4098,73,17,97,79,5,"[0, 328, 459, 588, 908, 1272, 1684, 2263, 2753, 3200, 3437, 4432, 5277, 5996, 6449]","[0, 242, 528, 768, 1122, 1517, 1842, 2389, 2744, 3266, 3671, 4050, 4500, 4783, 6090]","[0, 245, 558, 844, 1184, 1470, 1883, 2437, 2826, 3028, 3444, 3703, 4415, 4828, 5322]","[0, 170, 260, 350, 618, 748, 1149, 1239, 1329, 2102, 2192, 2410, 2796, 3260, 3775]","[0, 270, 681, 771, 905, 1035, 1166, 1326, 1452, 1654, 1842, 1982, 2211, 2494, 2906]",6449,6090,5322,3775,2906,745,2091,1647,1131,1192,6806,15,radiant
7524037914,46,14,92,5,51,"[0, 206, 655, 1007, 1422, 1923, 2351, 2812, 3369, 3772, 4385, 4975, 5155, 5614, 6003]","[0, 218, 466, 678, 1140, 1676, 1964, 2217, 2656, 3121, 3304, 4429, 4940, 5589, 6420]","[0, 169, 464, 677, 1224, 1348, 1628, 1885, 2045, 2542, 2863, 3339, 3519, 4073, 4549]","[0, 130, 597, 743, 911, 1531, 1634, 1859, 2059, 2327, 2519, 3288, 3647, 3795, 4247]","[0, 130, 245, 412, 660, 750, 840, 1166, 1256, 1435, 1580, 1760, 1940, 2223, 2667]",6003,6420,4549,4247,2667,10,74,96,86,45,"[0, 210, 421, 775, 997, 1697, 1976, 2345, 2818, 3327, 3747, 3996, 4729, 5649, 6608]","[0, 210, 461, 791, 1122, 1338, 1667, 2080, 2456, 2920, 3350, 3695, 4303, 4791, 5624]","[0, 333, 574, 907, 1405, 1833, 2314, 2828, 3334, 3668, 4365, 4515, 4988, 5669, 6648]","[0, 210, 300, 450, 606, 831, 921, 1168, 1303, 1626, 1908, 1998, 2579, 3101, 3997]","[0, 210, 362, 709, 940, 1110, 1262, 1557, 1692, 1858, 2197, 2287, 2608, 3011, 3960]",6608,5624,6648,3997,3960,-605,796,-2099,250,-1293,-2951,15,dire
7524134519,109,74,14,121,26,"[0, 324, 536, 1179, 1496, 1622, 2111, 2406, 2766, 3503, 3862, 4546, 5435, 6089, 6481]","[0, 279, 450, 743, 1204, 1571, 1820, 2288, 3169, 3556, 4048, 4636, 5327, 6097, 6453]","[0, 222, 790, 1115, 1376, 1738, 2099, 2486, 2929, 3535, 3985, 4483, 5423, 5951, 6293]","[100, 270, 360, 736, 908, 1043, 1404, 1670, 2319, 2491, 2581, 2846, 3183, 3475, 3643]","[0, 170, 562, 652, 873, 963, 1053, 1280, 1714, 2266, 2356, 2446, 2988, 3191, 3375]",6481,6453,6293,3643,3375,70,23,112,53,20,"[0, 437, 680, 840, 1202, 1409, 1687, 2173, 2513, 2914, 3373, 3750, 4306, 4798, 5270]","[0, 389, 707, 1084, 1535, 1971, 2523, 2613, 2938, 3203, 3401, 4119, 4313, 4723, 5420]","[0, 274, 488, 740, 1062, 1460, 1686, 1934, 2110, 2310, 2600, 2690, 3370, 3552, 4405]","[0, 504, 594, 684, 859, 1231, 1331, 1421, 1511, 1601, 1833, 1923, 2013, 2304, 2912]","[0, 304, 394, 484, 634, 742, 832, 1088, 1224, 1460, 1642, 1753, 1853, 1948, 2330]",5270,5420,4405,2912,2330,1211,1033,1888,731,1045,5908,15,radiant
7524401509,13,10,138,30,100,"[0, 239, 415, 728, 818, 1088, 1300, 1644, 2175, 2557, 3052, 3738, 4271, 4786, 5548]","[0, 234, 523, 613, 1017, 1282, 1728, 2019, 2530, 2916, 3399, 3890, 4556, 5102, 5438]","[0, 338, 428, 565, 702, 837, 976, 1439, 1619, 1877, 2217, 3122, 3277, 3472, 3615]","[0, 205, 295, 385, 520, 728, 862, 952, 1181, 1330, 1500, 1798, 1979, 2176, 2319]","[0, 359, 567, 796, 1080, 1384, 1667, 2032, 2318, 2690, 3041, 3509, 4001, 4150, 4612]",5548,5438,3615,2319,4612,1,25,21,112,20,"[60, 308, 617, 973, 1441, 1682, 1932, 2216, 2564, 3253, 3725, 4428, 4983, 5690, 6254]","[328, 857, 1185, 1514, 1960, 2460, 3157, 3612, 3937, 4598, 5103, 5433, 6110, 6702, 7348]","[60, 306, 592, 1235, 1637, 1897, 2379, 2905, 3275, 3655, 3985, 4174, 5046, 5428, 5707]","[60, 269, 359, 449, 873, 963, 1102, 1240, 1449, 1687, 1860, 1987, 2410, 2622, 3171]","[0, 255, 345, 435, 606, 793, 983, 1481, 1571, 1735, 1871, 1961, 2337, 2477, 2626]",6254,7348,5707,3171,2626,-706,-1910,-2092,-852,1986,-3574,15,radiant
7525107118,41,100,74,56,20,"[0, 258, 541, 819, 1100, 1415, 1586, 1841, 2230, 2786, 3252, 4005, 4483, 5047, 5501]","[0, 521, 974, 1184, 1466, 1744, 2379, 2794, 3700, 4249, 4605, 5227, 5775, 6124, 6604]","[0, 295, 541, 839, 1229, 1550, 1812, 2130, 2509, 2694, 3059, 3197, 3782, 4135, 4340]","[0, 207, 740, 945, 1141, 1245, 1497, 1930, 2248, 2537, 3079, 3285, 3535, 3946, 4376]","[0, 130, 268, 358, 497, 721, 856, 988, 1283, 1468, 1848, 2149, 2322, 2861, 3077]",5501,6604,4340,4376,3077,48,61,21,88,66,"[0, 291, 470, 867, 1129, 1405, 1698, 2071, 2431, 2943, 3731, 4616, 5248, 5961, 6751]","[0, 316, 680, 1044, 1465, 1943, 2395, 2833, 3339, 3987, 4518, 5001, 5320, 5915, 6346]","[0, 245, 507, 832, 1491, 1897, 2307, 2695, 3223, 3523, 3821, 4465, 4889, 5439, 5625]","[0, 210, 334, 424, 605, 763, 1100, 1280, 1460, 1598, 2173, 2801, 3053, 3246, 3386]","[0, 210, 335, 472, 648, 771, 1017, 1235, 1499, 1666, 2091, 2419, 2599, 2748, 2981]",6751,6346,5625,3386,2981,-1250,258,-1285,990,96,-1191,15,dire
7525812113,35,22,69,83,26,"[0, 208, 388, 858, 1260, 1546, 2180, 2386, 2739, 3098, 3792, 4121, 4492, 4729, 5484]","[0, 326, 679, 1083, 1538, 2046, 2544, 2911, 3389, 3980, 4616, 4876, 5365, 5863, 6438]","[0, 274, 712, 1208, 1407, 1810, 2057, 2541, 3142, 3704, 4458, 4765, 5312, 5987, 6602]","[0, 170, 260, 396, 507, 641, 853, 989, 1513, 1980, 2160, 2250, 2340, 2990, 3198]","[0, 170, 351, 529, 619, 803, 1013, 1103, 1332, 1634, 1814, 1904, 2023, 2342, 2624]",5484,6438,6602,3198,2624,6,90,135,136,20,"[330, 577, 894, 1123, 1528, 1728, 2308, 2597, 2915, 3309, 3811, 4502, 5106, 5677, 6245]","[0, 290, 607, 1023, 1383, 1979, 2507, 3123, 3213, 3664, 4259, 4933, 5608, 6004, 6383]","[62, 343, 699, 898, 1185, 1517, 1855, 2670, 3117, 3455, 3688, 4544, 5009, 5769, 6426]","[62, 232, 533, 658, 748, 838, 1019, 1146, 1526, 1741, 2011, 2308, 2466, 3099, 3481]","[62, 276, 576, 666, 820, 957, 1141, 1608, 1742, 1922, 2204, 2534, 2624, 3071, 3195]",6245,6383,6426,3481,3195,-761,55,176,-283,-571,-1384,15,dire
7525933503,109,65,137,121,26,"[334, 1033, 1391, 1824, 2211, 2689, 2964, 3317, 3676, 3925, 4922, 5089, 5829, 6394, 7270]","[258, 466, 771, 1021, 1233, 1719, 2014, 2596, 3110, 3468, 3958, 4465, 5636, 6260, 6632]","[170, 478, 709, 1051, 1228, 1690, 1780, 2371, 2778, 3301, 3775, 4368, 4670, 5443, 5869]","[213, 350, 651, 837, 927, 1141, 1231, 1519, 1609, 1893, 2303, 2393, 2629, 2862, 3053]","[170, 342, 583, 738, 866, 956, 1285, 1568, 1658, 1748, 2032, 2122, 2217, 2539, 2730]",7270,6632,5869,3053,2730,39,21,69,20,119,"[287, 609, 991, 1443, 2231, 2675, 3316, 3738, 4037, 4693, 5168, 5488, 6074, 6815, 7427]","[257, 620, 1291, 1658, 2097, 2378, 2880, 3166, 3663, 4354, 5316, 5876, 6609, 7124, 7723]","[280, 523, 850, 1291, 1572, 1837, 2430, 3101, 3595, 4317, 4723, 5224, 5932, 6597, 7519]","[170, 260, 427, 576, 905, 1234, 1589, 1811, 1981, 2336, 2906, 3584, 3823, 3983, 4354]","[170, 299, 389, 531, 821, 931, 1159, 1294, 1458, 2053, 2382, 2608, 2852, 3116, 3426]",7427,7723,7519,4354,3426,-157,-1091,-1650,-1301,-696,-4895,15,dire
7526011301,25,41,129,66,26,"[287, 710, 995, 1404, 1774, 2106, 2763, 3753, 4153, 4711, 5207, 5740, 6527, 7710, 8359]","[208, 461, 749, 1036, 1423, 1825, 2214, 2636, 2990, 3517, 3851, 4580, 5079, 5496, 6201]","[206, 474, 756, 1169, 1457, 1980, 2386, 2831, 3192, 3460, 3920, 4310, 4952, 5368, 5814]","[170, 260, 350, 524, 782, 936, 1142, 1404, 1698, 2109, 2278, 2760, 3028, 3222, 3609]","[170, 260, 433, 569, 659, 749, 931, 1181, 1370, 1619, 1709, 2208, 2416, 2511, 2744]",8359,6201,5814,3609,2744,120,54,61,90,63,"[323, 523, 897, 1150, 1488, 1882, 2276, 2396, 3048, 3702, 4217, 5202, 5624, 6128, 7135]","[206, 447, 733, 1143, 1458, 1866, 2077, 2361, 2605, 3074, 3393, 4089, 4542, 5050, 5550]","[248, 411, 800, 1204, 1505, 1997, 2379, 2944, 3315, 3885, 4237, 4886, 5385, 5755, 6302]","[215, 342, 479, 655, 843, 995, 1355, 1567, 1750, 2205, 2433, 2755, 3135, 3284, 3415]","[170, 260, 350, 547, 727, 857, 1011, 1197, 1495, 1630, 1770, 2092, 2505, 2781, 3085]",7135,5550,6302,3415,3085,1224,651,-488,194,-341,1240,15,radiant
7526050917,46,98,120,79,83,"[0, 170, 364, 454, 820, 1141, 1388, 1716, 2046, 2479, 2932, 3287, 3876, 4381, 5219]","[0, 170, 449, 693, 817, 1316, 1753, 2121, 2484, 3106, 3861, 4257, 4621, 5222, 6277]","[0, 298, 628, 1043, 1443, 1985, 2351, 2736, 3143, 3938, 4909, 5171, 5814, 6368, 6722]","[0, 170, 260, 397, 487, 577, 940, 1030, 1120, 1532, 2017, 2391, 2685, 2928, 3413]","[0, 170, 310, 434, 524, 659, 749, 887, 1154, 1289, 1698, 1827, 1917, 2016, 2288]",5219,6277,6722,3413,2288,48,21,96,65,85,"[0, 254, 598, 899, 1562, 1806, 2053, 2347, 2660, 3074, 3326, 3971, 4581, 5372, 6264]","[0, 204, 557, 844, 1259, 1621, 2072, 2493, 2989, 3161, 3827, 4715, 5254, 5949, 6765]","[0, 289, 559, 826, 1240, 1413, 2003, 2567, 3088, 3658, 3998, 4709, 5287, 6066, 6329]","[0, 170, 285, 802, 1062, 1222, 1434, 1758, 1992, 2439, 2745, 3280, 3723, 3979, 4467]","[0, 170, 285, 375, 553, 643, 885, 1199, 1334, 1481, 1918, 2413, 2604, 2907, 3417]",6264,6765,6329,4467,3417,-1045,-488,393,-1054,-1129,-3323,15,dire
7526071203,54,74,96,101,83,"[0, 205, 492, 979, 1393, 1620, 2442, 2809, 3107, 3294, 3879, 4549, 5160, 5757, 6076]","[0, 175, 495, 788, 1164, 1415, 1865, 2320, 2899, 3206, 3699, 4092, 4533, 4926, 5403]","[0, 166, 349, 599, 847, 1060, 1333, 1606, 1696, 1951, 2311, 2578, 2865, 3307, 3800]","[0, 130, 220, 549, 639, 749, 1099, 1189, 1323, 1458, 1698, 2264, 2354, 2502, 2806]","[0, 164, 254, 393, 483, 619, 977, 1111, 1201, 1384, 1568, 1850, 1940, 2088, 2273]",6076,5403,3800,2806,2273,107,102,14,105,27,"[0, 293, 493, 834, 1330, 1689, 2339, 2858, 3538, 3928, 4393, 4939, 5416, 5698, 6406]","[0, 291, 614, 866, 1288, 1573, 1958, 2574, 3024, 3404, 3856, 4279, 4751, 5337, 5954]","[0, 210, 451, 616, 937, 1253, 1580, 1844, 2233, 2585, 2853, 3293, 3744, 4330, 4841]","[100, 310, 739, 829, 1002, 1254, 1402, 1582, 1909, 2126, 2419, 2604, 2804, 3044, 3335]","[0, 210, 404, 538, 668, 856, 1188, 1495, 1679, 1902, 2130, 2315, 2452, 2649, 3025]",6406,5954,4841,3335,3025,-330,-551,-1041,-529,-752,-3203,15,dire
7526158006,38,41,17,121,19,"[327, 542, 851, 1217, 1381, 1713, 1839, 2226, 2491, 2956, 3304, 4038, 4779, 5159, 6034]","[204, 514, 801, 1011, 1394, 1520, 1862, 2166, 2445, 2721, 3008, 3384, 3711, 4290, 4829]","[276, 688, 930, 1307, 1589, 2125, 2544, 3359, 3486, 4077, 4393, 4710, 5023, 5499, 6021]","[206, 340, 564, 654, 818, 1064, 1198, 1333, 1939, 2122, 2259, 2704, 2834, 3106, 3350]","[169, 259, 394, 547, 726, 816, 906, 1077, 1401, 1536, 1683, 1929, 2059, 2192, 2729]",6034,4829,6021,3350,2729,94,129,29,53,20,"[244, 555, 951, 1270, 1772, 2186, 2767, 3685, 4154, 4742, 5535, 6592, 7187, 8182, 9196]","[204, 381, 672, 1092, 1449, 1878, 3027, 3323, 3964, 4352, 5188, 6344, 6865, 7490, 7979]","[208, 581, 965, 1672, 1929, 2515, 2835, 3198, 3621, 4255, 4773, 5020, 5217, 5974, 6485]","[169, 259, 349, 547, 637, 727, 924, 1082, 1313, 1632, 2310, 2737, 3271, 3683, 4038]","[169, 311, 493, 692, 953, 1092, 1433, 1635, 2286, 2680, 2959, 3258, 3407, 3801, 3949]",9196,7979,6485,4038,3949,-3162,-3150,-464,-688,-1220,-8684,15,dire
7526305209,89,96,76,105,68,"[0, 204, 438, 756, 1089, 1559, 1923, 2254, 2719, 3326, 3853, 4252, 5169, 5822, 6517]","[0, 335, 554, 907, 1285, 1572, 2007, 2337, 2924, 3481, 3680, 4179, 4597, 5212, 5532]","[0, 242, 534, 831, 1175, 1494, 1711, 1919, 2339, 2846, 3215, 3711, 3853, 4507, 5004]","[0, 170, 260, 691, 826, 963, 1101, 1428, 1636, 1816, 1906, 2050, 2222, 2416, 2513]","[0, 170, 260, 399, 489, 656, 934, 1215, 1350, 1530, 1649, 1895, 2114, 2312, 2407]",6517,5532,5004,2513,2407,41,43,106,26,110,"[0, 170, 384, 667, 961, 1361, 1779, 2141, 2404, 2591, 3103, 3589, 4051, 4488, 5142]","[0, 242, 578, 895, 1224, 1557, 1870, 2402, 2819, 3228, 3780, 4546, 4989, 5613, 6202]","[0, 325, 636, 886, 1221, 1625, 1940, 2509, 2806, 3271, 3536, 3979, 4945, 5313, 5831]","[0, 174, 266, 360, 542, 638, 996, 1243, 1345, 1575, 1710, 2140, 2498, 2701, 2982]","[0, 170, 260, 350, 498, 607, 955, 1351, 1441, 1579, 1763, 2167, 2442, 2842, 3444]",5142,6202,5831,2982,3444,1375,-670,-827,-469,-1037,-1628,15,radiant
7526520514,25,106,129,100,119,"[0, 323, 1069, 1391, 2040, 2854, 3788, 4365, 5049, 5742, 6736, 7605, 8667, 9303, 10286]","[0, 241, 590, 965, 1347, 1437, 1905, 2354, 2825, 3626, 4355, 4775, 5399, 5814, 6542]","[0, 208, 412, 589, 767, 997, 1335, 1632, 1957, 2365, 2831, 3228, 3452, 3788, 4448]","[0, 169, 438, 575, 864, 1163, 1460, 1596, 2089, 2593, 2949, 3557, 3890, 4375, 4662]","[100, 269, 359, 449, 621, 711, 847, 937, 1128, 1755, 2028, 2306, 2804, 3095, 3347]",10286,6542,4448,4662,3347,82,80,2,85,20,"[0, 207, 655, 1064, 1431, 1878, 2173, 2663, 3315, 3652, 4110, 4612, 5201, 5931, 6466]","[0, 215, 414, 796, 1242, 1648, 2026, 2409, 2696, 2906, 3169, 3622, 3869, 4162, 4257]","[0, 207, 544, 813, 1185, 1434, 1562, 1784, 2139, 2510, 2645, 2827, 2930, 3345, 3747]","[0, 169, 259, 397, 612, 729, 819, 909, 1293, 1475, 1647, 2191, 2294, 2544, 2685]","[0, 169, 259, 349, 837, 927, 1062, 1238, 1588, 1723, 1858, 2145, 2235, 2336, 2439]",6466,4257,3747,2685,2439,3820,2285,701,1977,908,9691,15,radiant
7526538514,82,56,14,119,110,"[0, 280, 524, 840, 1408, 1763, 2456, 3161, 3643, 4149, 4805, 5415, 6125, 6765, 7991]","[0, 289, 612, 992, 1274, 1804, 2175, 2594, 3112, 3560, 3929, 4251, 4981, 5350, 5753]","[0, 821, 1072, 1489, 1805, 2368, 2975, 3319, 3830, 4055, 4682, 5268, 6233, 6751, 7257]","[0, 298, 437, 802, 967, 1469, 1685, 1866, 2040, 2209, 2585, 2756, 3222, 3441, 4344]","[0, 170, 260, 350, 570, 799, 991, 1081, 1171, 1306, 1667, 2105, 2538, 2896, 3457]",7991,5753,7257,4344,3457,34,38,21,27,45,"[0, 238, 517, 1057, 1433, 1887, 2253, 2343, 3379, 3868, 4656, 5212, 5685, 6514, 7005]","[0, 285, 520, 941, 1383, 1744, 2077, 2315, 2962, 3394, 3757, 4219, 4971, 5709, 6091]","[0, 238, 519, 764, 1599, 1761, 2089, 2629, 3315, 3810, 4242, 5006, 5397, 5746, 5969]","[0, 170, 310, 437, 788, 968, 1058, 1292, 1749, 1884, 2217, 2454, 2634, 2902, 3034]","[0, 170, 260, 416, 629, 719, 809, 899, 1246, 1401, 1577, 1762, 2123, 2442, 2665]",7005,6091,5969,3034,2665,986,-338,1288,1310,792,4038,15,radiant
7526873007,89,106,129,121,26,"[0, 170, 589, 908, 1297, 1676, 2211, 2665, 2994, 3561, 4031, 4733, 5424, 5816, 6204]","[0, 243, 698, 995, 1362, 1700, 2112, 2718, 3011, 3184, 3573, 3983, 4224, 4498, 4886]","[0, 257, 699, 938, 1199, 1476, 1724, 2011, 2260, 2846, 3239, 3364, 3792, 4155, 4445]","[0, 219, 309, 493, 925, 1015, 1500, 1653, 1816, 1906, 2134, 2315, 2405, 2625, 2764]","[0, 170, 260, 440, 580, 717, 852, 987, 1100, 1190, 1315, 1405, 1500, 2002, 2169]",6204,4886,4445,2764,2169,41,15,120,58,7,"[0, 170, 490, 701, 983, 1278, 1756, 2212, 2665, 3354, 3900, 4587, 4956, 5789, 6430]","[0, 207, 505, 715, 999, 1608, 1901, 2413, 2898, 3307, 3820, 4364, 5212, 5946, 6313]","[0, 336, 649, 1099, 1557, 1861, 2197, 2486, 2962, 3414, 3853, 4528, 5001, 5377, 5722]","[0, 170, 294, 432, 562, 687, 1057, 1187, 1344, 1835, 1970, 2470, 2614, 3262, 3694]","[0, 170, 260, 398, 528, 653, 743, 960, 1095, 1229, 1364, 1790, 1980, 2503, 2598]",6430,6313,5722,3694,2598,-226,-1427,-1277,-930,-429,-4289,15,dire
7526888103,8,106,137,26,20,"[218, 581, 1168, 1351, 1836, 2129, 2536, 2913, 3486, 4129, 4608, 5224, 5726, 6708, 7726]","[284, 685, 936, 1134, 1443, 1775, 2131, 2603, 3285, 3561, 3851, 4273, 4710, 5059, 5446]","[170, 406, 725, 1088, 1676, 2289, 2678, 3135, 3486, 4120, 4781, 5235, 5789, 6388, 6587]","[219, 332, 467, 653, 1145, 1372, 1496, 1638, 1935, 2197, 2311, 2984, 3431, 3670, 4029]","[170, 260, 455, 593, 723, 904, 1043, 1177, 1339, 1495, 1585, 1813, 2042, 2226, 2644]",7726,5446,6587,4029,2644,95,97,23,110,86,"[247, 538, 865, 1217, 1706, 1979, 2200, 2468, 2799, 3530, 3906, 4518, 5090, 5690, 6625]","[207, 514, 685, 1112, 1370, 1719, 2024, 2250, 2539, 2973, 3460, 3814, 4098, 4696, 5211]","[255, 621, 993, 1233, 1887, 2535, 3167, 3813, 4166, 4958, 5283, 5648, 5936, 6231, 6640]","[170, 277, 412, 548, 678, 813, 1305, 1395, 1485, 1620, 2046, 2309, 2404, 2725, 3003]","[170, 260, 350, 578, 970, 1105, 1285, 1435, 1563, 2129, 2470, 2677, 2926, 3043, 3295]",6625,5211,6640,3003,3295,1101,235,-53,1026,-651,1658,15,radiant
7527329500,46,102,21,26,14,"[599, 1041, 1555, 2028, 2547, 2926, 3661, 4162, 4874, 5229, 6112, 6854, 7128, 8038, 8809]","[484, 776, 1057, 1338, 1780, 2347, 2603, 3033, 3922, 4501, 4902, 5508, 5803, 6647, 7251]","[760, 1041, 1305, 1991, 2437, 2942, 3393, 3925, 4563, 4751, 5345, 6114, 6679, 7393, 8150]","[307, 397, 613, 783, 1094, 1229, 1337, 1496, 1631, 1921, 2510, 2860, 2955, 3310, 3730]","[1111, 1311, 1401, 1616, 1770, 1905, 2011, 2364, 2590, 2815, 3145, 3397, 3540, 3991, 4447]",8809,7251,8150,3730,4447,95,13,97,20,86,"[628, 873, 1263, 1626, 1966, 2232, 2653, 3124, 3736, 4041, 4638, 5252, 5721, 6193, 6860]","[588, 959, 1335, 1743, 1923, 2337, 2632, 2886, 3654, 4148, 4793, 5317, 5698, 5834, 6370]","[539, 740, 1148, 1332, 1741, 1927, 2098, 2390, 3074, 3250, 3621, 4122, 4391, 4650, 5409]","[470, 605, 735, 957, 1187, 1370, 1560, 1734, 2182, 2272, 2647, 2836, 2931, 3108, 3265]","[567, 657, 994, 1372, 1509, 1599, 1689, 1824, 2040, 2410, 2698, 2847, 2965, 3292, 3518]",6860,6370,5409,3265,3518,1949,881,2741,465,929,6965,15,radiant
7527512604,10,84,17,27,5,"[0, 282, 657, 897, 1095, 1344, 1645, 1888, 2305, 3172, 3570, 4413, 4643, 5489, 6087]","[0, 280, 642, 1051, 1460, 1825, 2057, 2377, 2626, 3230, 3939, 4735, 5305, 6120, 6869]","[0, 315, 574, 1075, 1769, 2051, 2315, 2665, 3195, 3719, 4177, 4627, 4995, 5699, 6424]","[0, 218, 308, 444, 724, 854, 1101, 1408, 1873, 2501, 2681, 3159, 3249, 3479, 3829]","[0, 170, 260, 366, 496, 626, 764, 963, 1053, 1491, 1715, 2008, 2187, 2378, 2673]",6087,6869,6424,3829,2673,38,1,106,37,30,"[0, 323, 721, 1059, 1351, 1598, 1914, 2656, 3023, 3184, 3602, 3994, 4578, 5015, 5400]","[0, 329, 601, 925, 1212, 1509, 1933, 2265, 2552, 2959, 3450, 3693, 4037, 4338, 4904]","[0, 318, 725, 928, 1370, 1648, 2099, 2434, 2882, 2972, 3193, 4055, 4570, 4925, 5142]","[0, 170, 260, 350, 440, 620, 759, 894, 1032, 1171, 1307, 2009, 2406, 3057, 3233]","[0, 170, 634, 724, 814, 951, 1086, 1323, 1458, 1596, 1732, 1822, 2256, 2400, 2495]",5400,4904,5142,3233,2495,687,1965,1282,596,178,4708,15,dire
7527537810,53,49,23,79,136,"[239, 671, 1124, 1355, 1481, 2019, 2455, 3009, 3310, 3728, 4021, 4389, 5309, 5926, 6396]","[244, 527, 858, 1259, 1516, 2085, 2762, 3408, 3834, 4459, 4935, 5275, 5755, 6013, 6627]","[291, 961, 1241, 1540, 1877, 2409, 2825, 3276, 3733, 4546, 5080, 5701, 6315, 7146, 7597]","[170, 327, 434, 764, 854, 1070, 1303, 1528, 1698, 2013, 2103, 2473, 3083, 3884, 4150]","[170, 326, 465, 623, 796, 1043, 1168, 1546, 1862, 2125, 2439, 2642, 2862, 3234, 3585]",6396,6627,7597,4150,3585,25,106,129,21,102,"[204, 447, 666, 1012, 1291, 1663, 1982, 2490, 2665, 3201, 3850, 4261, 4759, 5551, 6183]","[242, 478, 814, 1063, 1349, 1633, 2142, 2627, 3200, 3510, 3980, 4662, 4986, 5339, 5860]","[253, 497, 757, 1326, 1600, 2095, 2519, 2792, 3501, 4093, 4545, 5005, 5398, 5631, 5993]","[170, 260, 350, 484, 889, 1108, 1292, 1715, 2288, 2561, 2800, 3007, 3340, 3542, 3658]","[170, 260, 405, 509, 686, 821, 956, 1176, 1268, 1487, 1679, 2004, 2099, 2248, 2349]",6183,5860,5993,3658,2349,213,767,1604,492,1236,4312,15,radiant
7527552717,73,11,71,27,84,"[0, 324, 500, 892, 1238, 1840, 2254, 2625, 3059, 3506, 5076, 5495, 6478, 8010, 9274]","[0, 207, 534, 842, 969, 1257, 1487, 1719, 1894, 2142, 2681, 2771, 3261, 3381, 3898]","[0, 206, 479, 753, 963, 1172, 1583, 1712, 2182, 2521, 3092, 3565, 3728, 4417, 4929]","[0, 218, 351, 872, 1007, 1097, 1267, 1394, 1607, 1697, 1958, 2286, 2376, 2592, 2786]","[0, 222, 351, 508, 642, 781, 919, 1009, 1186, 1326, 1755, 1845, 2175, 2458, 2739]",9274,3898,4929,2786,2739,46,74,96,20,26,"[0, 256, 666, 962, 1615, 2340, 2725, 3448, 4155, 4897, 5565, 6132, 7201, 8063, 8774]","[0, 252, 584, 951, 1316, 1681, 2023, 2405, 2860, 3192, 3696, 4249, 4645, 5200, 5607]","[0, 245, 608, 982, 1519, 1971, 2356, 2732, 3381, 3796, 4133, 4802, 5224, 5527, 5835]","[0, 170, 260, 398, 622, 1047, 1222, 1389, 1557, 1998, 2452, 3096, 3353, 3538, 4111]","[0, 170, 260, 350, 530, 708, 845, 983, 1572, 1707, 1887, 2085, 2219, 2534, 2665]",8774,5607,5835,4111,2665,500,-1709,-906,-1325,74,-3366,15,dire
7527668710,46,39,17,51,88,"[0, 165, 566, 844, 1184, 1598, 2076, 2469, 3128, 3785, 4592, 5469, 6215, 7174, 7793]","[0, 257, 488, 702, 1332, 1711, 2077, 2448, 2786, 3205, 3720, 4431, 4910, 5622, 6578]","[0, 291, 613, 1105, 1511, 1998, 2402, 2851, 3391, 3670, 4238, 4810, 5392, 6187, 6447]","[0, 130, 255, 345, 483, 692, 829, 964, 1216, 1322, 1672, 2038, 2463, 2797, 3363]","[0, 355, 445, 535, 788, 878, 1012, 1102, 1282, 1418, 1628, 1975, 2392, 2762, 3288]",7793,6578,6447,3363,3288,18,107,71,68,101,"[0, 655, 1127, 1528, 1720, 1929, 2371, 3222, 3833, 4260, 4963, 6001, 6898, 7839, 9118]","[0, 388, 637, 1078, 1527, 1868, 2414, 3242, 3660, 4248, 4542, 5031, 5541, 6120, 6996]","[0, 205, 482, 861, 1026, 1580, 2050, 2402, 2696, 2980, 3321, 3942, 4301, 4624, 5349]","[0, 229, 384, 563, 859, 963, 1100, 1413, 1784, 1957, 2349, 2625, 2944, 3128, 3704]","[0, 170, 260, 487, 616, 775, 948, 1173, 1342, 1757, 1847, 2131, 2463, 2647, 3137]",9118,6996,5349,3704,3137,-1325,-418,1098,-341,151,-835,15,dire
7527699910,102,20,112,51,9,"[0, 169, 515, 918, 1171, 1499, 1919, 2211, 2661, 3004, 3812, 4333, 4889, 5603, 6156]","[0, 289, 557, 1171, 1680, 2091, 2671, 3086, 3555, 3957, 4486, 5017, 5588, 6123, 7055]","[0, 324, 492, 867, 1191, 1565, 1971, 2583, 2916, 3248, 3605, 4155, 4728, 5228, 5805]","[0, 169, 259, 771, 907, 1160, 1363, 1498, 1633, 1723, 2205, 2473, 2774, 3115, 3591]","[0, 169, 259, 429, 564, 706, 881, 1016, 1169, 1540, 1765, 2149, 2374, 2620, 2998]",6156,7055,5805,3591,2998,106,14,71,5,86,"[0, 292, 733, 1092, 1600, 1908, 2366, 2812, 3219, 3517, 3960, 4394, 4898, 5556, 5903]","[0, 206, 582, 862, 1187, 1421, 1834, 2228, 2548, 2725, 3390, 3749, 4235, 4776, 5293]","[0, 204, 469, 757, 1046, 1171, 1684, 1774, 2235, 2773, 3099, 3268, 3623, 4329, 4603]","[0, 169, 289, 461, 597, 687, 867, 1017, 1248, 1424, 1982, 2170, 2260, 2640, 2825]","[0, 169, 289, 379, 518, 724, 859, 965, 1214, 1468, 1847, 2060, 2235, 2537, 2632]",5903,5293,4603,2825,2632,253,1762,1202,766,366,4349,15,radiant
7528042208,28,71,38,47,121,"[0, 279, 563, 880, 1201, 1494, 1903, 2434, 2886, 3355, 3907, 4239, 4957, 5810, 6234]","[0, 251, 606, 867, 1066, 1316, 1911, 2136, 2550, 3030, 3432, 3961, 4398, 5008, 5411]","[0, 334, 606, 894, 1442, 2016, 2230, 2641, 2852, 3469, 4266, 4786, 5049, 5395, 5758]","[0, 517, 654, 784, 1027, 1163, 1298, 1951, 2322, 2640, 2865, 3509, 3652, 4124, 5158]","[0, 251, 341, 471, 624, 748, 1008, 1381, 1510, 1780, 2041, 2665, 2837, 3123, 3446]",6234,5411,5758,5158,3446,59,74,62,23,119,"[0, 481, 687, 1029, 1395, 1559, 1717, 1922, 2373, 2848, 3426, 3848, 4631, 5178, 5629]","[0, 747, 982, 1398, 1722, 2007, 2462, 2892, 3281, 3551, 4116, 4288, 5213, 5540, 5732]","[100, 710, 812, 1047, 1304, 1414, 1523, 1733, 2028, 2477, 2911, 3102, 3461, 3753, 4322]","[0, 566, 816, 1482, 1728, 1903, 2310, 2831, 3405, 3811, 4560, 4781, 5243, 5824, 6153]","[0, 334, 424, 677, 767, 879, 1267, 1357, 1529, 1719, 2124, 2297, 2948, 3337, 3766]",5629,5732,4322,6153,3766,605,-321,1436,-995,-320,405,15,dire
7528123004,25,90,23,79,45,"[0, 291, 417, 746, 1076, 1432, 1800, 2497, 2773, 3255, 3538, 3808, 5506, 6139, 7039]","[0, 326, 854, 1142, 1523, 2027, 2511, 3009, 3431, 4188, 4541, 4810, 5731, 6439, 7236]","[0, 285, 596, 958, 1334, 1578, 2011, 2216, 2624, 2888, 3557, 3827, 4358, 4762, 5574]","[0, 169, 307, 483, 618, 759, 895, 1153, 1248, 1490, 1880, 2155, 2502, 3140, 3461]","[0, 169, 259, 462, 601, 726, 1355, 1535, 1677, 1928, 2280, 2532, 3033, 3342, 3936]",7039,7236,5574,3461,3936,48,13,96,91,58,"[0, 285, 603, 774, 1070, 1438, 1679, 1969, 2461, 2770, 3268, 3821, 4206, 5133, 5745]","[0, 238, 543, 910, 1319, 1692, 2288, 2701, 3336, 4097, 4811, 5113, 5322, 6166, 6807]","[0, 207, 573, 815, 1109, 1400, 1620, 1843, 2226, 2608, 2925, 3346, 3736, 3989, 4284]","[0, 169, 645, 735, 873, 1020, 1198, 1624, 1714, 2166, 2594, 3131, 3359, 3635, 3906]","[0, 169, 289, 379, 469, 608, 821, 991, 1128, 1387, 1682, 1848, 1958, 2338, 2596]",5745,6807,4284,3906,2596,1294,429,1290,-445,1340,3908,15,dire
7528383718,46,32,98,45,20,"[0, 313, 608, 859, 1165, 1567, 1856, 2155, 2542, 2808, 3265, 3783, 4422, 5390, 6041]","[0, 645, 938, 1229, 1559, 1891, 2504, 3057, 3791, 4092, 4638, 4854, 5117, 5821, 6323]","[0, 244, 597, 1062, 1330, 1801, 2089, 2434, 2866, 3072, 3902, 4542, 4722, 5407, 6033]","[0, 772, 923, 1061, 1151, 1281, 1371, 1586, 1765, 1855, 2310, 2454, 2834, 3357, 3685]","[0, 302, 392, 539, 712, 893, 1113, 1203, 1642, 1814, 1949, 2262, 2442, 2735, 2958]",6041,6323,6033,3685,2958,25,13,60,53,87,"[0, 437, 798, 1158, 1572, 1942, 2361, 2875, 3180, 3922, 4445, 4835, 5627, 5935, 6598]","[0, 249, 457, 948, 1316, 1569, 2203, 2840, 3390, 3892, 4203, 4540, 5376, 5762, 6480]","[0, 392, 553, 975, 1365, 1613, 1903, 2729, 3229, 3913, 4532, 4902, 5617, 6206, 6509]","[0, 321, 514, 867, 957, 1082, 1295, 1871, 2006, 2704, 3540, 4194, 5140, 5235, 5445]","[0, 454, 544, 784, 874, 1003, 1216, 1487, 1622, 1965, 2189, 2366, 2868, 2963, 3058]",6598,6480,6509,5445,3058,-557,-157,-476,-1760,-100,-3050,15,dire
7528465311,71,104,91,20,86,"[0, 264, 505, 631, 914, 1264, 1510, 1813, 2733, 2929, 3675, 4248, 4995, 5668, 6169]","[0, 300, 612, 1037, 1410, 1953, 2534, 3041, 3482, 4043, 4562, 5125, 6275, 6845, 7320]","[0, 229, 404, 532, 736, 1182, 1317, 1771, 2152, 2408, 2759, 3330, 3698, 4241, 4778]","[0, 316, 724, 1096, 1507, 1833, 2165, 2504, 2953, 3394, 3904, 4473, 4792, 5223, 6039]","[0, 569, 694, 931, 1069, 1286, 1644, 2295, 2385, 2573, 3190, 3442, 4148, 4646, 4831]",6169,7320,4778,6039,4831,18,106,96,101,121,"[0, 231, 620, 919, 1173, 1824, 1914, 2506, 3087, 3618, 4403, 4884, 5652, 5747, 6169]","[0, 356, 570, 867, 1240, 1557, 1877, 2275, 2565, 2830, 3249, 3541, 3849, 4224, 4716]","[0, 230, 438, 956, 1413, 1616, 1939, 2436, 2889, 2979, 3069, 3594, 4013, 4322, 4881]","[0, 272, 362, 604, 795, 885, 975, 1200, 1449, 1584, 1674, 1819, 2041, 2173, 2422]","[0, 405, 495, 585, 675, 902, 992, 1126, 1261, 1351, 1441, 1721, 1943, 2098, 2259]",6169,4716,4881,2422,2259,0,2604,-103,3617,2572,8690,15,dire
7528473819,46,52,97,86,110,"[0, 309, 649, 832, 1079, 1301, 1731, 2090, 2359, 2752, 3215, 3838, 4483, 5095, 6280]","[0, 256, 463, 839, 1080, 1208, 1664, 2211, 2702, 3102, 3710, 4099, 4577, 5080, 5553]","[0, 205, 416, 810, 1335, 2022, 2282, 2771, 3112, 3775, 4561, 5000, 5489, 5788, 6072]","[0, 502, 592, 838, 1131, 1454, 1589, 1814, 1904, 2248, 2883, 3335, 3536, 3765, 4263]","[0, 234, 364, 492, 582, 672, 807, 1073, 1383, 1516, 2123, 2213, 2734, 2920, 3204]",6280,5553,6072,4263,3204,72,43,59,26,102,"[0, 282, 883, 1307, 1624, 1955, 2318, 2897, 3443, 4086, 4795, 5181, 6468, 7364, 8223]","[0, 169, 493, 732, 1190, 1450, 1727, 2466, 2803, 3343, 4037, 4483, 5347, 5571, 6082]","[0, 380, 668, 1037, 1447, 1918, 2328, 2796, 3155, 3706, 4450, 4876, 5054, 5203, 5689]","[0, 206, 296, 386, 589, 713, 803, 1142, 1232, 1394, 2012, 2102, 2506, 2993, 3287]","[0, 169, 335, 489, 624, 861, 994, 1208, 1360, 1687, 2142, 2355, 2785, 3053, 3283]",8223,6082,5689,3287,3283,-1943,-529,383,976,-79,-1192,15,dire
7528616403,38,104,114,63,100,"[0, 278, 521, 686, 860, 1305, 1971, 2851, 3365, 3997, 4450, 5193, 6071, 6933, 7774]","[0, 210, 545, 882, 1144, 1307, 1860, 2242, 2565, 2811, 3313, 3955, 4416, 4898, 5311]","[0, 416, 775, 1160, 1528, 1911, 2366, 2879, 3543, 4354, 4824, 5741, 6498, 6946, 7691]","[0, 254, 738, 1101, 1535, 1669, 1803, 1893, 2028, 2235, 2418, 2785, 3138, 3385, 3655]","[0, 210, 320, 410, 500, 590, 933, 1237, 1494, 1640, 1897, 2290, 2748, 3180, 3480]",7774,5311,7691,3655,3480,35,81,28,86,26,"[0, 291, 582, 843, 1243, 1692, 2344, 2738, 3241, 3877, 4419, 4966, 5554, 6321, 7127]","[0, 214, 458, 658, 942, 1106, 1309, 1537, 1957, 2242, 2728, 3136, 3522, 4007, 4626]","[0, 130, 387, 776, 1028, 1435, 1761, 2179, 2584, 3298, 3559, 3964, 4440, 4907, 5374]","[0, 168, 542, 978, 1306, 1573, 1697, 1958, 2142, 2669, 2891, 3123, 3888, 4160, 4386]","[0, 167, 265, 403, 540, 630, 1102, 1282, 1417, 1557, 1647, 2006, 2274, 2423, 2671]",7127,4626,5374,4386,2671,647,685,2317,-731,809,3727,15,dire
7528971815,1,49,74,86,84,"[0, 370, 730, 1129, 1462, 1879, 2280, 2753, 3221, 3666, 4088, 4809, 5407, 6212, 6709]","[0, 284, 552, 1082, 1505, 1967, 2317, 2980, 3502, 3710, 4159, 4680, 5496, 6037, 6341]","[0, 333, 574, 910, 1244, 1368, 1920, 2368, 2749, 3218, 3473, 3671, 4297, 4810, 5497]","[0, 290, 519, 661, 798, 933, 1116, 1280, 1389, 1661, 1917, 2160, 2468, 2664, 2943]","[0, 210, 300, 457, 547, 681, 835, 925, 1064, 1203, 1364, 1615, 1923, 2141, 2236]",6709,6341,5497,2943,2236,48,65,21,7,119,"[0, 217, 435, 930, 1414, 1810, 2352, 2881, 3393, 3974, 4571, 5112, 5962, 6727, 7511]","[0, 254, 627, 1040, 1381, 2096, 2607, 2905, 3575, 3838, 4541, 5381, 6378, 7206, 7756]","[0, 243, 440, 776, 1310, 1685, 2132, 2586, 2945, 3435, 3895, 4368, 4787, 5247, 5702]","[0, 130, 220, 310, 489, 623, 806, 941, 1118, 1255, 1527, 1709, 2673, 3232, 3547]","[0, 130, 220, 357, 487, 593, 775, 955, 1091, 1181, 1567, 1802, 2178, 2327, 2422]",7511,7756,5702,3547,2422,-802,-1415,-205,-604,-186,-3212,15,dire
7529139904,114,80,129,128,64,"[0, 245, 590, 870, 1155, 1744, 2240, 2702, 3175, 3391, 3757, 4434, 5186, 5551, 6257]","[2, 320, 733, 1139, 1585, 2137, 2784, 3594, 4031, 4403, 4974, 5368, 5709, 6564, 7428]","[0, 245, 567, 829, 1011, 1383, 1994, 2506, 3061, 3441, 3952, 4865, 5329, 6027, 6627]","[0, 247, 374, 472, 648, 1006, 1134, 1642, 1744, 2035, 2499, 2892, 3439, 3795, 4142]","[0, 245, 335, 425, 556, 694, 861, 1161, 1293, 1383, 1891, 2554, 2829, 3215, 3488]",6257,7428,6627,4142,3488,89,13,29,72,62,"[0, 170, 547, 795, 1438, 1930, 2229, 2634, 3047, 3308, 4125, 5138, 5643, 6375, 6829]","[0, 170, 443, 638, 851, 1021, 1272, 1528, 1900, 2351, 2610, 2750, 3451, 3802, 3993]","[0, 253, 378, 746, 963, 1180, 1270, 1654, 2041, 2587, 3229, 3899, 4457, 5109, 5543]","[0, 170, 260, 350, 480, 570, 660, 795, 1097, 1277, 1502, 1642, 1931, 2073, 2253]","[0, 170, 312, 430, 1011, 1236, 1326, 1473, 1802, 1982, 2265, 2405, 2495, 2602, 2934]",6829,3993,5543,2253,2934,-572,3435,1084,1889,554,6390,15,radiant
7529155513,10,106,96,105,64,"[3773, 4233, 4854, 5687, 6273, 6924, 7738, 8428, 9914, 10802, 11917, 12290, 13241, 14588, 15552]","[3517, 4075, 4466, 4761, 5176, 5392, 5867, 6446, 7897, 8732, 8965, 10055, 11111, 12632, 13174]","[3670, 3772, 4264, 4833, 5361, 5916, 6499, 7123, 8490, 8893, 9624, 10125, 10917, 11774, 12666]","[2477, 2777, 3012, 3569, 3915, 4252, 4598, 4793, 5087, 5605, 5942, 6669, 7270, 7821, 8026]","[2387, 2854, 2944, 3249, 3344, 3991, 4219, 4484, 5188, 5565, 5841, 6035, 6666, 7698, 7903]",15552,13174,12666,8026,7903,8,129,74,123,121,"[4209, 4662, 5146, 5806, 6594, 7056, 7791, 8323, 8704, 9101, 9920, 10504, 11063, 11349, 11751]","[4169, 4413, 4837, 5363, 5505, 6043, 6387, 6482, 7012, 7460, 8235, 8628, 9048, 9722, 10150]","[3642, 3980, 4129, 4545, 4899, 5451, 5984, 6372, 6591, 7060, 7625, 8297, 8676, 8915, 9010]","[2437, 2667, 2877, 3026, 3297, 3525, 4057, 4532, 5208, 5366, 5935, 6203, 6702, 7327, 7422]","[1678, 1785, 1924, 2161, 2301, 2493, 2697, 2792, 3117, 3275, 3682, 3894, 4155, 4626, 4796]",11751,10150,9010,7422,4796,3801,3024,3656,604,3107,14192,15,radiant
7529241517,89,49,43,110,100,"[521, 871, 1276, 1751, 2167, 2517, 3020, 3681, 4289, 5019, 5845, 6770, 7526, 8136, 8784]","[703, 957, 1490, 1902, 2362, 2918, 3568, 4061, 4837, 5128, 5835, 6406, 6604, 7293, 8119]","[520, 721, 966, 1425, 1975, 2462, 3119, 3649, 4095, 4801, 5321, 5829, 6244, 6666, 7519]","[289, 727, 884, 1309, 1443, 1578, 1758, 1985, 2475, 2761, 2952, 3287, 3614, 3891, 4384]","[353, 443, 570, 720, 883, 1018, 1214, 1394, 1740, 1999, 2243, 2446, 2541, 2636, 3038]",8784,8119,7519,4384,3038,109,106,28,105,68,"[531, 779, 1202, 1329, 1627, 2081, 2377, 2648, 3330, 3673, 4355, 4947, 5411, 6037, 6739]","[476, 690, 1087, 1380, 1627, 2095, 2453, 2837, 3577, 3836, 4322, 4794, 5771, 5866, 6680]","[491, 786, 1072, 1326, 1789, 2194, 2458, 3089, 3564, 4195, 4720, 5241, 5628, 6463, 6710]","[286, 412, 560, 689, 824, 1270, 1417, 1553, 1735, 2097, 2261, 2729, 3226, 3321, 4064]","[259, 395, 571, 706, 841, 1106, 1447, 1588, 1901, 2025, 2439, 2817, 3431, 3802, 4114]",6739,6680,6710,4064,4114,2045,1439,809,320,-1076,3537,15,dire
7529317317,25,13,28,65,26,"[1285, 1612, 2342, 2759, 3328, 3850, 4207, 4744, 5887, 6753, 8036, 8608, 9543, 10142, 10928]","[1648, 2167, 2582, 3046, 3719, 4301, 4461, 5181, 5617, 6297, 6765, 7645, 8207, 9136, 9527]","[1194, 1755, 2097, 2580, 3532, 3993, 4333, 4858, 5602, 6460, 7027, 7721, 8299, 8664, 9008]","[1091, 1429, 1773, 2135, 2440, 2837, 3571, 3706, 4427, 5220, 5627, 6004, 6747, 7183, 7911]","[967, 1104, 1510, 1692, 2185, 2361, 2670, 2896, 3565, 4143, 4630, 4858, 5001, 5847, 5942]",10928,9527,9008,7911,5942,73,97,129,79,5,"[1076, 1297, 1602, 2001, 2302, 2786, 3570, 4129, 5126, 5516, 6305, 6880, 7412, 8999, 9220]","[917, 1007, 1344, 1483, 1786, 2031, 3062, 3491, 3852, 4038, 4757, 4981, 5479, 5574, 5972]","[631, 828, 1034, 1326, 1544, 1781, 2369, 2859, 2949, 3074, 3219, 3607, 3967, 4348, 4890]","[385, 475, 565, 655, 790, 880, 1184, 1309, 1606, 1696, 1791, 1885, 2021, 2515, 2875]","[423, 513, 695, 785, 920, 1047, 1495, 1585, 1675, 1765, 1896, 1990, 2136, 2231, 2554]",9220,5972,4890,2875,2554,1708,3555,4118,5036,3388,17805,15,radiant
7529378713,76,53,43,85,19,"[0, 546, 794, 1324, 1862, 2355, 3005, 3385, 4131, 4686, 5365, 6208, 6874, 7433, 7736]","[0, 267, 466, 848, 1223, 1431, 1823, 2347, 2506, 3282, 3834, 4477, 4695, 4976, 5562]","[0, 210, 426, 553, 844, 1007, 1505, 1789, 2391, 3005, 3444, 3920, 4234, 4638, 5162]","[0, 195, 285, 538, 814, 950, 1182, 1678, 1946, 2236, 2627, 2918, 3098, 3646, 3798]","[0, 195, 285, 375, 465, 555, 955, 1115, 1274, 1510, 1906, 2122, 2302, 2538, 2633]",7736,5562,5162,3798,2633,80,23,112,31,26,"[0, 322, 627, 915, 1005, 1305, 1441, 2108, 2915, 3063, 3275, 4015, 4331, 4822, 5493]","[0, 248, 520, 647, 857, 1082, 1299, 1529, 1829, 2288, 2459, 2624, 2920, 3537, 3898]","[0, 400, 572, 1018, 1399, 1730, 2214, 2596, 3181, 3446, 3721, 3940, 4629, 5413, 5834]","[0, 311, 401, 491, 619, 709, 1098, 1278, 1458, 1548, 1939, 2356, 2446, 2714, 2982]","[0, 210, 345, 435, 567, 657, 747, 927, 1107, 1197, 1552, 1957, 2189, 2386, 2806]",5493,3898,5834,2982,2806,2243,1664,-672,816,-173,3878,15,dire
7529403415,25,95,69,5,20,"[0, 370, 694, 958, 1216, 1507, 1975, 2421, 3165, 3781, 4406, 4632, 5160, 5697, 6257]","[0, 239, 527, 909, 1243, 1442, 1963, 2416, 2924, 3224, 3682, 3848, 4540, 5370, 5773]","[0, 333, 611, 972, 1427, 1737, 2013, 2500, 2747, 3027, 3399, 3985, 4625, 5118, 5639]","[0, 170, 260, 394, 550, 640, 744, 1132, 1270, 1424, 2039, 2129, 2500, 3065, 3249]","[0, 170, 260, 409, 568, 706, 836, 981, 1071, 1161, 1542, 1681, 2335, 2753, 3046]",6257,5773,5639,3249,3046,32,55,74,121,71,"[0, 170, 693, 838, 1199, 1567, 2384, 2513, 2944, 3420, 4027, 4535, 4834, 5204, 5605]","[0, 207, 568, 803, 1089, 1558, 1813, 1903, 2196, 2511, 2935, 3602, 4239, 5286, 5662]","[0, 206, 422, 512, 882, 1125, 1626, 1856, 2116, 2242, 2801, 3238, 3603, 4044, 4525]","[0, 170, 337, 427, 578, 734, 1032, 1316, 1503, 1747, 2130, 2539, 2674, 3266, 3777]","[0, 219, 347, 437, 527, 773, 953, 1080, 1170, 1427, 1607, 2317, 2407, 2991, 3340]",5605,5662,4525,3777,3340,652,111,1114,-528,-294,1055,15,dire
7529493512,32,82,78,71,58,"[0, 285, 492, 973, 1330, 1459, 1798, 2127, 2445, 2831, 3367, 3794, 4420, 5010, 5105]","[0, 245, 485, 768, 1054, 1370, 1734, 2270, 2688, 3035, 3413, 3728, 4000, 4874, 5818]","[0, 279, 538, 890, 1275, 1495, 1829, 1953, 2264, 2848, 3623, 3838, 4149, 4533, 4873]","[0, 170, 260, 396, 486, 820, 943, 1071, 1290, 1641, 2048, 2263, 2398, 2666, 3094]","[0, 272, 362, 501, 658, 748, 877, 967, 1086, 1221, 1612, 1827, 2039, 2447, 2790]",5105,5818,4873,3094,2790,17,14,21,51,20,"[57, 379, 746, 1119, 1612, 1894, 2358, 2968, 3447, 3752, 4415, 5140, 5777, 6308, 6995]","[57, 266, 557, 754, 1290, 1590, 2038, 2651, 3115, 3360, 3808, 4118, 4742, 5256, 5712]","[57, 266, 1048, 1295, 1579, 1979, 2321, 2886, 3268, 3686, 4531, 5263, 5852, 6298, 6890]","[57, 227, 443, 581, 804, 1160, 1295, 1474, 1738, 2455, 2806, 3093, 3312, 3521, 3956]","[325, 495, 585, 692, 833, 1000, 1169, 1645, 1870, 2183, 2807, 2966, 3393, 3696, 3888]",6995,5712,6890,3956,3888,-1890,106,-2017,-862,-1098,-5761,15,dire
7529535219,59,41,57,105,110,"[522, 901, 1604, 2063, 2674, 3064, 3472, 4011, 4457, 4948, 5720, 6374, 6911, 7172, 7517]","[498, 916, 1207, 1668, 1953, 2382, 2890, 3316, 3783, 4260, 4960, 5454, 5882, 6230, 6761]","[563, 884, 1287, 1552, 1727, 2301, 2538, 3043, 3663, 4269, 4735, 5155, 5572, 5748, 6443]","[260, 350, 440, 570, 921, 1093, 1228, 1415, 1505, 1857, 2351, 2649, 3235, 3412, 4098]","[358, 448, 584, 808, 1021, 1202, 1460, 1600, 1830, 2042, 2324, 2762, 3036, 3381, 3743]",7517,6761,6443,4098,3743,95,97,106,101,58,"[501, 874, 1261, 1557, 2057, 2242, 2857, 3230, 3802, 4177, 4958, 5368, 6860, 7614, 8416]","[554, 913, 1374, 1605, 1937, 2498, 2940, 3346, 3939, 4420, 5035, 5716, 6577, 7544, 8480]","[805, 982, 1155, 1399, 1584, 1974, 2368, 2814, 3290, 3772, 4083, 4483, 5320, 5754, 6304]","[639, 775, 905, 995, 1085, 1355, 1445, 1535, 1819, 1958, 2141, 2344, 3106, 3291, 3620]","[323, 616, 746, 882, 1071, 1246, 1494, 1737, 1978, 2197, 2370, 2657, 3383, 3655, 4102]",8416,8480,6304,3620,4102,-899,-1719,139,478,-359,-2360,15,dire
7529570918,25,98,114,112,86,"[615, 1015, 1475, 2087, 2518, 2732, 3391, 3988, 4513, 5090, 5459, 6109, 6648, 7383, 8035]","[606, 938, 1256, 2001, 2412, 2921, 3605, 4217, 4384, 5205, 5785, 6162, 6558, 7223, 7849]","[766, 1061, 1595, 1832, 2355, 2779, 2920, 3447, 3652, 4111, 4601, 5007, 5377, 5604, 6198]","[629, 742, 880, 970, 1118, 1208, 1298, 1552, 1687, 2053, 2143, 2408, 2804, 3438, 3686]","[332, 506, 616, 927, 1017, 1107, 1242, 1545, 2002, 2342, 2432, 2694, 3181, 3523, 4121]",8035,7849,6198,3686,4121,56,43,60,26,83,"[525, 736, 1151, 1453, 1704, 2133, 2876, 3256, 4200, 4744, 5200, 5651, 6100, 6560, 7236]","[614, 790, 1244, 1901, 2277, 3244, 3787, 4385, 5096, 5604, 6113, 6356, 6863, 7516, 8272]","[456, 830, 1043, 1508, 1681, 2089, 2521, 2938, 3858, 4235, 4647, 5182, 5738, 6293, 6870]","[260, 350, 440, 625, 760, 1530, 2017, 2269, 2404, 2548, 2815, 2972, 3117, 3387, 3675]","[260, 350, 440, 530, 665, 885, 1244, 1334, 1712, 1856, 2068, 2385, 2491, 2763, 2984]",7236,8272,6870,3675,2984,799,-423,-672,11,1137,852,15,radiant
7529595404,10,25,96,51,79,"[647, 869, 1231, 1644, 2134, 2595, 3112, 3864, 4343, 4739, 5792, 6841, 7581, 8633, 9535]","[615, 1015, 1267, 1647, 1850, 2456, 2946, 3391, 3612, 4166, 4823, 5571, 6296, 7004, 7853]","[983, 1325, 1537, 1792, 2177, 2528, 2941, 3281, 3645, 4249, 5217, 5402, 6060, 6610, 7124]","[340, 430, 567, 1130, 1220, 1736, 2186, 2453, 2657, 2793, 3290, 3790, 4584, 4900, 5353]","[475, 871, 961, 1051, 1430, 1730, 1927, 2295, 2540, 2756, 3393, 3689, 3898, 4083, 4373]",9535,7853,7124,5353,4373,59,71,19,45,83,"[543, 816, 1165, 1827, 1964, 2417, 2761, 3209, 3540, 3965, 4302, 4605, 4829, 5257, 5708]","[530, 737, 1024, 1191, 1482, 1660, 2070, 2246, 2612, 2872, 3095, 3925, 4176, 4541, 4907]","[451, 624, 863, 1025, 1275, 1453, 1735, 2026, 2607, 2986, 3334, 3483, 4010, 4392, 4921]","[312, 494, 664, 789, 879, 1074, 1184, 1274, 1914, 2167, 2512, 2877, 3101, 3435, 3715]","[264, 392, 888, 1121, 1219, 1614, 1835, 1925, 2507, 2642, 2770, 3137, 3361, 3493, 3849]",5708,4907,4921,3715,3849,3827,2946,2203,1638,524,11138,15,radiant
7529597611,48,17,137,105,45,"[0, 293, 540, 1019, 1472, 1834, 2462, 3030, 3522, 4168, 4846, 5464, 6195, 7085, 7752]","[0, 420, 762, 1211, 1544, 1856, 2137, 2834, 3314, 4005, 4850, 5986, 6736, 7496, 8550]","[0, 249, 662, 1042, 1547, 2043, 2550, 3231, 3736, 4441, 5048, 5328, 5871, 6286, 6945]","[0, 210, 629, 719, 849, 1212, 1797, 2245, 2380, 2907, 3423, 4058, 4243, 4476, 4827]","[0, 210, 348, 780, 910, 1052, 1234, 1718, 2006, 2720, 3270, 4034, 4296, 4484, 4682]",7752,8550,6945,4827,4682,43,18,76,71,20,"[0, 246, 524, 854, 964, 1198, 1569, 1859, 2289, 2708, 3178, 3428, 3726, 3820, 3915]","[0, 164, 304, 443, 533, 674, 764, 925, 1244, 1580, 1769, 1950, 2715, 3211, 3473]","[0, 273, 589, 973, 1378, 1611, 2066, 2478, 2781, 2951, 3288, 3442, 3651, 3859, 4044]","[0, 130, 220, 310, 400, 538, 628, 718, 938, 1028, 1118, 1208, 1298, 1392, 1487]","[0, 130, 220, 310, 436, 526, 616, 706, 1286, 1511, 1601, 1691, 1781, 1875, 1970]",3915,3473,4044,1487,1970,3837,5077,2901,3340,2712,17867,15,radiant
7529603109,48,74,96,110,86,"[329, 605, 929, 1296, 1540, 1951, 2507, 2921, 3379, 4003, 4638, 5445, 6150, 6825, 7755]","[296, 694, 1059, 1540, 1968, 2476, 2950, 3554, 4008, 4813, 5340, 6354, 6449, 6943, 7588]","[306, 702, 1140, 1390, 1626, 2042, 2337, 2726, 3118, 3614, 3917, 4220, 4703, 5408, 5836]","[489, 579, 699, 1105, 1326, 1717, 1852, 1942, 2156, 2519, 2823, 3319, 3494, 3995, 4587]","[221, 525, 747, 975, 1154, 1483, 1618, 1754, 2145, 2473, 2563, 2941, 3205, 3739, 4065]",7755,7588,5836,4587,4065,43,46,15,135,26,"[450, 691, 926, 1129, 1425, 1855, 2230, 2794, 3491, 3891, 4437, 5222, 6272, 6561, 7206]","[362, 638, 1042, 1329, 1605, 1849, 2240, 2595, 3042, 3567, 3977, 4436, 5082, 5656, 6214]","[292, 617, 949, 1190, 1522, 1732, 1987, 2236, 2893, 3217, 3545, 3944, 4454, 4726, 5041]","[245, 374, 513, 603, 759, 893, 983, 1122, 1642, 1732, 1876, 2178, 2499, 2594, 2944]","[245, 335, 463, 553, 740, 936, 1026, 1162, 1775, 1962, 2106, 2363, 2774, 2919, 3050]",7206,6214,5041,2944,3050,549,1374,795,1643,1015,5376,15,radiant
7529606900,106,41,137,66,101,"[899, 1365, 1885, 2327, 2965, 3428, 3833, 4489, 4870, 5503, 6003, 6492, 7705, 8365, 9345]","[1020, 1438, 1798, 2128, 2690, 2780, 3335, 3847, 4260, 5018, 5651, 6348, 6840, 7381, 7981]","[1009, 1408, 1614, 2218, 2702, 3413, 3935, 4194, 4706, 5394, 5753, 6784, 7089, 7841, 8075]","[485, 640, 997, 1380, 1641, 1827, 2171, 2536, 2887, 3523, 3795, 4290, 4460, 4791, 5074]","[478, 818, 1184, 1614, 1785, 2022, 2424, 2928, 3184, 3726, 3971, 4210, 4476, 4570, 4728]",9345,7981,8075,5074,4728,46,29,74,128,30,"[850, 1190, 1636, 1993, 2702, 2937, 3320, 3925, 4452, 5095, 5973, 6484, 6798, 7475, 8476]","[880, 1167, 1342, 1828, 2078, 2608, 2852, 3238, 3544, 3812, 4357, 4511, 4916, 5309, 6210]","[694, 988, 1078, 1327, 1592, 2130, 2258, 2931, 3676, 3864, 4348, 4529, 4952, 5640, 6509]","[670, 807, 1099, 1452, 1678, 1768, 2049, 2497, 2967, 3573, 3768, 3916, 4138, 4406, 5205]","[430, 569, 706, 1124, 1673, 1809, 2059, 2149, 2401, 2858, 3102, 3233, 3328, 3709, 4147]",8476,6210,6509,5205,4147,869,1771,1566,-131,581,4656,15,radiant
7529661409,12,129,74,105,53,"[543, 877, 1249, 1623, 1909, 2322, 2624, 2997, 3526, 4048, 4479, 5569, 6010, 6408, 6998]","[630, 1000, 1635, 1877, 2492, 2814, 3099, 3645, 4063, 4863, 5772, 6931, 7099, 7749, 8108]","[558, 886, 1166, 1515, 1845, 2179, 2645, 3062, 3442, 3555, 3927, 4513, 4898, 5194, 5289]","[358, 552, 741, 871, 1046, 1261, 1351, 1669, 1850, 2226, 2714, 3480, 3677, 4072, 4484]","[337, 490, 613, 775, 966, 1140, 1490, 1733, 1965, 2055, 2418, 3169, 3310, 3730, 4212]",6998,8108,5289,4484,4212,21,10,96,110,79,"[503, 867, 1241, 1524, 1800, 2167, 2423, 2850, 3374, 3950, 4431, 5260, 5697, 6063, 6858]","[462, 866, 1040, 1513, 1842, 2461, 2907, 3244, 3825, 4278, 4693, 5198, 5603, 6223, 6751]","[653, 938, 1244, 1465, 2012, 2436, 2864, 3105, 3572, 3769, 4426, 4931, 5026, 5592, 6282]","[220, 357, 520, 613, 703, 951, 1103, 1193, 1382, 1785, 1929, 2362, 2652, 2953, 3282]","[300, 478, 568, 658, 795, 1209, 1429, 1529, 1706, 2008, 2316, 2685, 2827, 3051, 3236]",6858,6751,6282,3282,3236,140,1357,-993,1202,976,2682,15,radiant
7529662500,12,106,96,86,45,"[1420, 1622, 1950, 2223, 2681, 2942, 3614, 3999, 4742, 5234, 6398, 7235, 7653, 8355, 9717]","[1493, 1935, 2189, 2431, 2588, 2852, 3185, 3649, 4076, 4419, 4902, 6007, 6284, 7203, 8139]","[1535, 1742, 2148, 2684, 3083, 3471, 4014, 4408, 4800, 4993, 5404, 5866, 6170, 6620, 7385]","[715, 1077, 1212, 1387, 1654, 1744, 2024, 2149, 2288, 2646, 3090, 3317, 3768, 4211, 4413]","[765, 963, 1098, 1318, 1467, 1557, 1737, 1827, 1922, 2251, 2667, 2960, 3129, 3679, 3973]",9717,8139,7385,4413,3973,41,47,33,19,26,"[1323, 1581, 1840, 1970, 2493, 3054, 3236, 3952, 4407, 4844, 5238, 5779, 6366, 7067, 7696]","[1576, 1889, 2726, 3206, 4015, 4449, 4947, 5383, 6079, 6398, 6628, 7072, 7672, 8289, 8457]","[1988, 2493, 2783, 3191, 3434, 4480, 4668, 5576, 6102, 6692, 6984, 7351, 7821, 8508, 8758]","[803, 1057, 1237, 1373, 1463, 1815, 1905, 2426, 2608, 2743, 3008, 3292, 3671, 4019, 4177]","[829, 1188, 1368, 1458, 1682, 2034, 2124, 2507, 2656, 2923, 3265, 3549, 3689, 3835, 4023]",7696,8457,8758,4177,4023,2021,-318,-1373,236,-50,516,15,radiant
7529668400,15,21,59,19,91,"[0, 205, 452, 746, 1088, 1288, 1629, 1997, 2087, 2448, 2880, 3385, 4182, 4812, 5327]","[0, 170, 607, 930, 1452, 1750, 1879, 2304, 2710, 3178, 3714, 3889, 4446, 5265, 5624]","[0, 258, 633, 980, 1270, 1725, 2378, 2714, 3160, 3681, 4769, 5336, 6187, 6949, 7514]","[0, 270, 432, 552, 745, 993, 1163, 1336, 1594, 1761, 2362, 2665, 3043, 3594, 3894]","[0, 170, 260, 380, 604, 779, 891, 1088, 1227, 1394, 1697, 1835, 2252, 2491, 2640]",5327,5624,7514,3894,2640,1,43,74,51,45,"[0, 582, 1009, 1238, 1528, 2106, 2524, 3039, 3393, 3636, 4085, 4438, 4615, 5284, 5808]","[0, 256, 634, 848, 1141, 1541, 2089, 2282, 2634, 3441, 3913, 4686, 5123, 5933, 6386]","[0, 256, 463, 674, 764, 961, 1097, 1392, 1738, 2064, 2315, 2664, 3081, 3753, 4136]","[0, 170, 285, 375, 510, 630, 1111, 1201, 1438, 1733, 1963, 2268, 2428, 2755, 3002]","[0, 239, 354, 444, 621, 859, 993, 1083, 1320, 1483, 1620, 1909, 2048, 2331, 2470]",5808,6386,4136,3002,2470,-481,-762,3378,892,170,3197,15,dire
7529670117,41,13,69,86,3,"[446, 648, 975, 1247, 1898, 2297, 2721, 2977, 3625, 4122, 4493, 5013, 5437, 6193, 6936]","[657, 1027, 1478, 1892, 2376, 3172, 3262, 3519, 3991, 4290, 5016, 5165, 5683, 6231, 6561]","[628, 957, 1367, 1659, 1914, 2288, 2634, 2803, 3238, 3563, 4267, 4932, 5442, 5794, 6422]","[334, 441, 575, 749, 919, 1227, 1317, 1444, 1579, 2213, 2303, 2452, 2945, 3544, 4256]","[260, 456, 563, 720, 941, 1256, 1346, 1680, 2052, 2222, 2312, 2507, 2843, 3073, 3459]",6936,6561,6422,4256,3459,114,90,129,20,26,"[524, 853, 1027, 1455, 1867, 2293, 2593, 3133, 3729, 4383, 4939, 5642, 6384, 7137, 7340]","[625, 951, 1408, 1864, 2484, 3020, 3661, 4379, 5020, 5538, 6048, 6866, 7235, 7542, 8161]","[472, 790, 952, 1371, 1658, 2118, 2288, 2923, 3170, 3695, 4232, 5050, 5515, 5914, 6425]","[375, 596, 760, 944, 1116, 1302, 1514, 1910, 2045, 2567, 2808, 3278, 3526, 3979, 4429]","[260, 350, 440, 929, 1066, 1156, 1246, 1548, 1792, 1929, 2263, 2881, 3177, 3302, 3705]",7340,8161,6425,4429,3705,-404,-1600,-3,-173,-246,-2426,15,radiant
7529800410,94,19,92,72,5,"[0, 286, 568, 883, 1244, 1704, 2119, 2771, 3113, 3579, 4216, 4929, 5507, 6437, 7695]","[0, 286, 533, 783, 1088, 1417, 1699, 2149, 2692, 3232, 3823, 4231, 4592, 4935, 5754]","[0, 208, 459, 811, 1201, 1432, 1832, 2463, 2742, 3196, 3802, 4160, 4813, 5354, 5947]","[0, 167, 339, 815, 905, 1046, 1477, 1910, 2243, 2768, 3305, 3525, 3615, 4207, 4913]","[0, 130, 234, 372, 462, 652, 761, 1006, 1174, 1661, 2051, 2141, 2378, 2638, 3076]",7695,5754,5947,4913,3076,41,69,106,75,86,"[0, 366, 668, 869, 1131, 1492, 1813, 2135, 2455, 2662, 2961, 3707, 4200, 4950, 5398]","[0, 245, 441, 925, 1221, 1384, 1642, 2083, 2526, 2978, 3407, 4209, 4611, 5093, 5584]","[0, 244, 528, 923, 1133, 1381, 1795, 2402, 3021, 3273, 3737, 4138, 4581, 4842, 5128]","[0, 210, 300, 390, 544, 765, 1069, 1159, 1761, 1851, 1986, 2327, 2784, 3082, 3176]","[0, 258, 348, 487, 577, 796, 1062, 1152, 1461, 1551, 1770, 2130, 2302, 2534, 2784]",5398,5584,5128,3176,2784,2297,170,819,1737,292,5315,15,radiant
7529950215,95,137,92,136,112,"[256, 381, 722, 978, 1277, 1638, 2069, 2399, 2974, 3418, 3940, 4534, 5608, 6316, 6877]","[391, 631, 917, 1285, 1739, 2090, 2397, 2808, 3312, 3910, 4722, 5176, 6208, 6589, 7223]","[123, 515, 799, 1400, 1925, 2238, 2528, 2777, 3625, 4064, 4510, 4726, 5271, 5898, 6402]","[123, 310, 400, 631, 856, 1058, 1148, 1238, 1515, 1774, 1913, 2333, 2781, 3324, 4310]","[223, 313, 403, 511, 645, 869, 996, 1086, 1306, 1792, 2108, 2382, 2683, 3169, 3796]",6877,7223,6402,4310,3796,21,135,67,123,100,"[205, 736, 1067, 1395, 1753, 2054, 2673, 3143, 3979, 4230, 4900, 5603, 6375, 6794, 7073]","[0, 548, 799, 1169, 1457, 2154, 2542, 2997, 3373, 3894, 4270, 4450, 5005, 5692, 5964]","[72, 449, 854, 980, 1149, 1482, 2348, 2605, 2823, 3079, 3596, 3945, 4166, 4486, 4954]","[72, 582, 672, 762, 852, 1257, 1675, 1810, 1946, 2089, 2269, 2579, 2991, 3153, 3255]","[72, 488, 626, 716, 856, 998, 1414, 1549, 1639, 1729, 2091, 2382, 2557, 2826, 2942]",7073,5964,4954,3255,2942,-196,1259,1448,1055,854,4420,15,radiant
7530075714,62,18,102,107,26,"[0, 257, 559, 1160, 1530, 1798, 2138, 3073, 3463, 4302, 5089, 5493, 7319, 8128, 8759]","[0, 163, 287, 703, 1152, 1646, 1976, 2413, 3049, 3353, 3968, 4876, 5328, 6261, 6696]","[0, 129, 342, 663, 851, 1666, 1939, 2261, 2804, 3141, 3833, 4389, 4918, 5527, 5780]","[0, 167, 257, 396, 708, 1113, 1250, 2084, 2264, 2667, 3253, 3722, 4312, 4604, 4757]","[0, 129, 266, 400, 534, 704, 858, 997, 1239, 1377, 1731, 2235, 2564, 3077, 3404]",8759,6696,5780,4757,3404,25,71,12,30,84,"[0, 362, 618, 1052, 1501, 1980, 2317, 2718, 3172, 3515, 3818, 4028, 4371, 4783, 5476]","[0, 244, 875, 1084, 1383, 1977, 2224, 2599, 2971, 3395, 3565, 3948, 4088, 4652, 5534]","[0, 320, 564, 763, 979, 1143, 1440, 1863, 2243, 2613, 2984, 3241, 3476, 3799, 4261]","[0, 209, 336, 447, 557, 647, 784, 973, 1153, 1243, 1378, 1507, 1597, 1746, 1985]","[0, 209, 364, 454, 562, 726, 863, 1087, 1267, 1357, 1492, 1775, 1940, 2089, 2349]",5476,5534,4261,1985,2349,3283,1162,1519,2772,1055,9791,15,radiant
7530076119,69,109,120,66,26,"[0, 593, 838, 1249, 1704, 2051, 2830, 3147, 3827, 4516, 5120, 5809, 6717, 7726, 8220]","[0, 257, 855, 1267, 1635, 2269, 2645, 3193, 3592, 4070, 4841, 5383, 6133, 7093, 7914]","[0, 277, 524, 907, 1214, 1505, 1746, 2236, 2628, 3154, 3808, 4233, 5063, 5556, 6068]","[0, 169, 319, 453, 575, 785, 1042, 1316, 1670, 2198, 2579, 2858, 3275, 3665, 4046]","[0, 238, 328, 467, 557, 647, 1059, 1194, 1338, 1496, 1885, 2065, 2300, 2499, 3005]",8220,7914,6068,4046,3005,46,44,97,86,100,"[0, 362, 562, 1004, 1376, 1709, 2123, 2629, 2934, 3182, 3615, 3805, 4211, 4486, 5187]","[0, 239, 519, 814, 1246, 1482, 1590, 1971, 2342, 2517, 2840, 3194, 3674, 4046, 4984]","[0, 237, 398, 746, 879, 1005, 1386, 1985, 2197, 2564, 2976, 3358, 3913, 4757, 5099]","[0, 169, 298, 418, 543, 633, 762, 942, 1142, 1286, 1613, 1770, 1900, 2148, 2459]","[0, 217, 322, 470, 608, 735, 825, 1040, 1162, 1387, 1522, 1659, 1749, 1846, 2203]",5187,4984,5099,2459,2203,3033,2930,969,1587,802,9321,15,radiant
7530084716,97,28,16,30,128,"[0, 130, 363, 536, 716, 954, 1133, 1455, 1614, 1738, 2068, 2481, 2936, 3209, 3358]","[0, 164, 387, 710, 835, 1217, 1441, 1531, 1795, 2044, 2801, 3252, 3905, 4159, 4308]","[0, 166, 481, 726, 1245, 1433, 1792, 2085, 2588, 2923, 3374, 3643, 3812, 4311, 4636]","[0, 130, 220, 310, 400, 539, 629, 719, 809, 899, 1353, 1443, 1615, 1860, 2009]","[0, 130, 318, 408, 723, 1087, 1297, 1387, 1477, 1688, 1969, 2108, 2198, 2318, 2505]",3358,4308,4636,2009,2505,13,46,43,100,20,"[518, 900, 1209, 1513, 2013, 2500, 2877, 3323, 3785, 4799, 5704, 6428, 7162, 7824, 8811]","[117, 323, 511, 792, 1120, 1260, 1570, 2271, 2991, 3790, 4827, 5789, 6527, 7368, 8250]","[117, 362, 639, 1126, 1726, 2109, 2610, 2955, 3671, 4340, 5182, 5796, 6255, 6871, 7494]","[117, 287, 402, 759, 945, 1239, 1396, 1683, 1908, 2226, 2800, 3073, 3299, 3504, 4077]","[62, 232, 347, 522, 849, 939, 1073, 1574, 1866, 2245, 2820, 3136, 3417, 3756, 4003]",8811,8250,7494,4077,4003,-5453,-3942,-2858,-2068,-1498,-15819,15,dire
7530098507,48,106,65,58,136,"[0, 253, 536, 781, 1249, 1574, 2104, 2479, 3161, 3656, 4270, 4798, 5321, 6166, 7054]","[0, 354, 614, 976, 1352, 1612, 1869, 2300, 2754, 3400, 3826, 4460, 4846, 5288, 5868]","[0, 205, 530, 899, 1461, 1649, 2336, 2833, 3206, 3919, 4210, 4651, 5151, 5652, 6533]","[0, 170, 260, 389, 519, 639, 759, 894, 1076, 1543, 1767, 2029, 2326, 2615, 2896]","[0, 170, 294, 431, 629, 958, 1166, 1426, 1621, 2006, 2141, 2366, 2661, 2909, 3093]",7054,5868,6533,2896,3093,10,96,17,66,86,"[0, 255, 494, 792, 1172, 1527, 2068, 2483, 2931, 3251, 3907, 4496, 4826, 5430, 6216]","[0, 245, 482, 705, 1109, 1473, 1671, 2170, 2630, 3060, 3605, 4156, 4758, 5199, 5707]","[0, 222, 568, 778, 1158, 1248, 1682, 1998, 2296, 2386, 2825, 3513, 4121, 4590, 5199]","[0, 204, 294, 428, 615, 750, 858, 1018, 1241, 1359, 1799, 2167, 2467, 2881, 2976]","[0, 170, 305, 412, 772, 956, 1132, 1222, 1571, 1862, 2192, 2537, 2734, 3139, 3426]",6216,5707,5199,2976,3426,838,161,1334,-80,-333,1920,15,dire
7530110416,25,28,21,110,100,"[297, 582, 983, 1425, 1827, 2191, 2624, 3072, 3544, 3681, 4146, 4663, 5077, 5377, 6537]","[332, 654, 964, 1381, 1909, 2243, 2587, 3228, 3955, 4541, 4806, 5196, 5344, 5565, 6386]","[248, 514, 805, 1214, 1582, 1861, 2558, 2858, 3322, 3939, 4067, 4866, 5581, 5837, 6944]","[170, 290, 380, 470, 648, 738, 1024, 1114, 1388, 1617, 1828, 2008, 2214, 2772, 2867]","[170, 290, 380, 737, 1127, 1217, 1477, 1567, 1798, 2127, 2217, 2397, 2545, 2766, 3251]",6537,6386,6944,2867,3251,48,22,104,83,86,"[318, 655, 1033, 1251, 1744, 2087, 2390, 2805, 3205, 3885, 4579, 5118, 5952, 6692, 7266]","[318, 639, 912, 1234, 1617, 2333, 2792, 3462, 4081, 4396, 4842, 5288, 6242, 6881, 6976]","[269, 432, 677, 968, 1181, 1336, 1738, 2078, 2741, 3290, 4418, 4722, 5160, 6028, 6197]","[195, 615, 811, 901, 1076, 1283, 1538, 1686, 2095, 2230, 2884, 2974, 3512, 4267, 4436]","[195, 330, 471, 561, 691, 885, 1020, 1191, 1402, 1659, 2211, 2349, 2615, 3274, 3624]",7266,6976,6197,4436,3624,-729,-590,747,-1569,-373,-2514,15,dire
7530159016,41,53,129,97,105,"[326, 530, 728, 1040, 1304, 1818, 2098, 2233, 2532, 3121, 3569, 4017, 4737, 5068, 5710]","[251, 341, 431, 818, 993, 1739, 1950, 2108, 2485, 3121, 3542, 4156, 4641, 4813, 5847]","[511, 762, 1079, 1361, 1562, 1757, 2228, 2515, 3302, 3823, 4251, 4689, 5627, 5829, 6063]","[242, 419, 675, 924, 1415, 2106, 2233, 2695, 3000, 3448, 3963, 4380, 5014, 5146, 5802]","[169, 259, 366, 500, 753, 1147, 1711, 1846, 2329, 2721, 2857, 2996, 3372, 3467, 4121]",5710,5847,6063,5802,4121,25,36,96,100,20,"[264, 652, 1165, 1427, 1811, 2361, 3418, 4010, 4312, 5098, 5439, 6270, 6896, 7946, 8876]","[571, 934, 1275, 1652, 2019, 2477, 2853, 3481, 3938, 4758, 5362, 5982, 6617, 7798, 8168]","[304, 554, 918, 1184, 1669, 1840, 2113, 2772, 3076, 3613, 3823, 4236, 4890, 5342, 5700]","[229, 423, 592, 1015, 1190, 1699, 2135, 2834, 3015, 3335, 3426, 3561, 3826, 4132, 4689]","[229, 319, 457, 593, 777, 867, 957, 1195, 1358, 1956, 2159, 2310, 2597, 2798, 3021]",8876,8168,5700,4689,3021,-3166,-2321,363,1113,1100,-2911,15,dire
7530428617,69,1,53,19,5,"[0, 250, 608, 771, 1286, 1554, 2271, 2834, 3445, 3718, 4088, 4795, 5473, 6241, 6627]","[0, 252, 696, 941, 1103, 1426, 1851, 2419, 2833, 3233, 3671, 4184, 4679, 5313, 5800]","[0, 170, 260, 350, 516, 606, 835, 1182, 1272, 1924, 2193, 2387, 2531, 2962, 3434]","[0, 280, 599, 854, 1234, 1596, 2045, 2542, 2950, 3285, 3753, 4112, 4372, 5175, 5841]","[0, 170, 284, 374, 469, 598, 782, 996, 1175, 1400, 1584, 1976, 2139, 2278, 2570]",6627,5800,3434,5841,2570,109,25,78,68,21,"[0, 255, 591, 1178, 1623, 2095, 2454, 2852, 3533, 3949, 4698, 5250, 5996, 7157, 7597]","[0, 218, 618, 948, 1197, 1481, 1897, 2348, 2673, 2982, 3512, 3949, 4621, 5355, 6062]","[0, 242, 591, 886, 1208, 1615, 1816, 2048, 2317, 2487, 2967, 3393, 3882, 4554, 5192]","[0, 170, 276, 453, 621, 853, 943, 1200, 1335, 1472, 1856, 2149, 2831, 3197, 3597]","[0, 214, 304, 394, 484, 709, 850, 985, 1233, 1408, 1627, 1928, 2226, 2664, 3001]",7597,6062,5192,3597,3001,-970,-262,-1758,2244,-431,-1177,15,dire
7530463515,114,74,104,84,7,"[0, 253, 417, 837, 1175, 1626, 1955, 2529, 2765, 3298, 3834, 4307, 4861, 5449, 5918]","[0, 239, 513, 835, 1164, 1501, 1664, 2075, 2563, 3178, 3858, 4882, 5358, 6076, 6935]","[0, 330, 492, 760, 1262, 1729, 1979, 2112, 2883, 3170, 3552, 3984, 4506, 5399, 5693]","[0, 208, 385, 521, 660, 798, 936, 1070, 1256, 1395, 1563, 1761, 1895, 2147, 2522]","[0, 169, 259, 349, 484, 619, 709, 799, 1027, 1162, 1371, 1613, 1747, 2012, 2324]",5918,6935,5693,2522,2324,1,19,53,96,5,"[0, 207, 640, 1050, 1497, 1987, 2416, 2872, 3208, 3756, 4030, 4377, 4856, 5326, 5819]","[0, 335, 627, 955, 1327, 1677, 2355, 2704, 3050, 3563, 4202, 4292, 4883, 5453, 5796]","[0, 219, 309, 443, 633, 780, 1007, 1097, 1232, 1412, 1749, 2154, 2588, 3125, 3625]","[0, 241, 483, 925, 1194, 1440, 1907, 2110, 2660, 3152, 3653, 3898, 4522, 4793, 5225]","[0, 169, 285, 461, 551, 687, 866, 1056, 1267, 1447, 1582, 1719, 1986, 2155, 2250]",5819,5796,3625,5225,2250,99,1139,2068,-2703,74,677,15,dire
7530531515,11,106,7,105,37,"[0, 384, 741, 1027, 1385, 1678, 2224, 2651, 3280, 3739, 4322, 5267, 6091, 6969, 7443]","[0, 298, 660, 939, 1378, 1615, 1907, 2278, 2663, 3002, 3471, 4002, 4681, 5365, 5946]","[0, 261, 629, 846, 1201, 1387, 1667, 1868, 2068, 3066, 3237, 3748, 4162, 4830, 5156]","[0, 539, 629, 749, 967, 1102, 1321, 1411, 1581, 2250, 2771, 3165, 3590, 3685, 3780]","[0, 271, 361, 607, 776, 910, 1362, 1536, 1658, 1998, 2675, 3126, 3513, 4013, 4147]",7443,5946,5156,3780,4147,91,74,97,53,84,"[0, 202, 456, 859, 1273, 1595, 1935, 2328, 2744, 3059, 3346, 3552, 4135, 5104, 5427]","[0, 281, 568, 994, 1462, 1740, 2104, 2412, 2813, 3080, 3606, 3916, 4292, 5118, 5383]","[0, 169, 381, 933, 1358, 1532, 2091, 2322, 2460, 2661, 3086, 3342, 3925, 4532, 5121]","[0, 130, 223, 439, 591, 768, 1234, 1414, 1740, 1967, 2148, 2238, 2503, 2892, 3295]","[0, 130, 220, 393, 571, 705, 841, 1305, 1566, 1656, 2071, 2197, 2403, 2590, 2917]",5427,5383,5121,3295,2917,2016,563,35,485,1230,4329,15,dire
7530650619,120,41,78,68,123,"[0, 350, 640, 891, 1222, 1501, 1753, 2257, 2887, 3257, 3975, 4841, 5670, 6447, 7570]","[0, 350, 549, 797, 1106, 1514, 1821, 2204, 2576, 2892, 3230, 3740, 4327, 5039, 5582]","[0, 232, 510, 745, 983, 1371, 1703, 2103, 2481, 2983, 3204, 3736, 4264, 4764, 5370]","[0, 195, 285, 375, 549, 684, 819, 1190, 1390, 1652, 1885, 2203, 2546, 2875, 3236]","[0, 195, 285, 499, 731, 966, 1101, 1613, 2116, 2246, 2475, 2747, 3042, 3387, 3821]",7570,5582,5370,3236,3821,25,18,29,66,20,"[61, 308, 640, 1095, 1426, 1820, 2146, 2541, 2958, 3318, 3807, 4386, 4998, 5599, 6038]","[329, 535, 853, 1256, 1631, 1959, 2499, 2913, 3466, 3920, 4507, 5466, 6185, 6788, 7147]","[61, 459, 706, 1162, 1430, 1928, 2289, 2699, 3252, 3534, 4300, 4957, 5311, 5755, 6277]","[61, 290, 380, 564, 654, 857, 1099, 1632, 2192, 2342, 2637, 3007, 3172, 3431, 4048]","[61, 290, 380, 470, 560, 666, 756, 923, 1221, 1311, 1446, 1774, 2105, 2411, 2506]",6038,7147,6277,4048,2506,1532,-1565,-907,-812,1315,-437,15,dire
7530728311,48,39,96,79,26,"[0, 245, 442, 929, 1259, 1582, 2034, 2633, 3089, 3490, 3937, 4704, 5377, 5943, 6720]","[0, 244, 468, 783, 1061, 1375, 1906, 2041, 2564, 2914, 3499, 3932, 4442, 4681, 5175]","[0, 163, 443, 852, 1364, 1690, 2070, 2318, 2934, 3402, 4002, 4533, 5018, 5540, 5727]","[0, 129, 219, 346, 537, 627, 855, 983, 1118, 1263, 1398, 1673, 1801, 2075, 2456]","[0, 129, 219, 433, 572, 696, 921, 1288, 1519, 1664, 1799, 1916, 2373, 2507, 2846]",6720,5175,5727,2456,2846,8,17,98,121,45,"[0, 281, 518, 756, 1165, 1486, 1935, 2406, 2776, 3214, 3990, 4382, 4836, 5463, 6036]","[0, 325, 548, 913, 1087, 1254, 1555, 2016, 2582, 2772, 3373, 3885, 4446, 4862, 5290]","[0, 248, 573, 882, 1264, 1462, 1720, 1985, 2336, 2710, 3117, 3689, 3860, 4365, 4741]","[0, 209, 421, 553, 727, 908, 998, 1542, 1838, 2051, 2445, 2814, 3176, 3501, 3695]","[0, 209, 379, 856, 1141, 1283, 1373, 1594, 1767, 2021, 2427, 2521, 3012, 3590, 3760]",6036,5290,4741,3695,3760,684,-115,986,-1239,-914,-598,15,dire
7530771503,38,61,129,90,65,"[1805, 2075, 2680, 3134, 3998, 4309, 5008, 5616, 6158, 6533, 7643, 8297, 8946, 9107, 9633]","[1022, 1417, 1666, 1974, 2314, 2953, 3704, 4132, 4887, 5565, 6345, 7147, 8428, 9041, 9862]","[1559, 2104, 2378, 2811, 3529, 3707, 4646, 5229, 5745, 6315, 6743, 7192, 7776, 8250, 8753]","[797, 905, 1211, 1436, 1743, 2013, 2302, 2392, 2700, 3189, 3524, 3830, 4455, 4614, 5208]","[541, 717, 1039, 1174, 1395, 1485, 1832, 2004, 2518, 2827, 3379, 3784, 4148, 4249, 4617]",9633,9862,8753,5208,4617,48,22,78,119,66,"[1530, 1820, 2395, 2835, 3292, 3819, 4269, 5002, 5607, 6032, 6641, 7314, 7967, 8761, 9541]","[1603, 1935, 2517, 3050, 3721, 4165, 4851, 5432, 5868, 6284, 6802, 7204, 8079, 9086, 9861]","[1153, 1385, 1676, 2099, 2254, 2671, 3327, 3748, 4367, 4676, 5164, 6007, 6408, 7232, 7895]","[502, 774, 904, 1040, 1181, 1278, 1529, 1999, 2285, 2490, 3155, 3379, 3556, 4073, 4231]","[753, 942, 1183, 1315, 1686, 2025, 2422, 2760, 2985, 3313, 3537, 4093, 4560, 4871, 5345]",9541,9861,7895,4231,5345,92,1,858,977,-728,1200,15,radiant
7531040410,73,106,33,86,19,"[413, 839, 1110, 1671, 1885, 2457, 3252, 4049, 4580, 5259, 6157, 6788, 7445, 7957, 8805]","[284, 697, 1061, 1468, 1949, 2252, 2844, 3380, 4060, 4311, 4491, 4657, 5294, 5868, 6498]","[285, 673, 1019, 1335, 1656, 2159, 2605, 2933, 3308, 3899, 4953, 5274, 5923, 6259, 6651]","[209, 299, 433, 612, 726, 863, 1124, 1214, 1405, 1495, 1796, 2202, 2504, 2668, 2949]","[209, 299, 437, 618, 812, 1176, 1356, 1446, 1593, 1683, 1999, 2354, 2812, 3314, 3744]",8805,6498,6651,2949,3744,89,23,21,26,68,"[164, 483, 759, 961, 1129, 1536, 1797, 2192, 2582, 3106, 3552, 4149, 4953, 5552, 6214]","[179, 469, 770, 980, 1177, 1482, 2156, 2537, 3077, 3964, 4484, 5034, 5419, 5817, 6508]","[314, 583, 832, 1300, 1465, 1867, 2290, 2663, 3192, 4097, 5022, 5480, 6005, 6475, 7065]","[129, 219, 676, 1001, 1103, 1193, 1404, 1539, 1731, 2219, 2470, 3004, 3506, 3615, 3811]","[129, 219, 374, 464, 554, 704, 828, 1012, 1138, 1407, 1497, 1858, 2054, 2384, 2539]",6214,6508,7065,3811,2539,2591,-10,-414,-862,1205,2510,15,radiant
7531077704,95,106,98,121,103,"[236, 563, 1000, 1368, 1728, 2302, 2665, 3236, 3864, 4624, 5065, 5847, 6420, 7380, 8044]","[281, 629, 1085, 1247, 1417, 1705, 1892, 2250, 2746, 3455, 4038, 4551, 5098, 5659, 5985]","[278, 565, 1060, 1361, 1718, 1965, 2349, 2742, 3306, 4330, 4857, 5390, 5930, 6220, 6640]","[504, 594, 804, 1016, 1180, 1355, 1664, 2012, 2157, 2808, 3018, 3198, 3626, 3872, 4089]","[236, 329, 433, 539, 629, 719, 854, 1035, 1307, 1901, 2143, 2372, 2643, 2796, 2972]",8044,5985,6640,4089,2972,114,53,62,129,45,"[170, 507, 828, 1205, 1578, 2113, 2367, 2806, 3014, 3339, 4019, 4414, 4952, 5303, 6222]","[286, 419, 549, 724, 863, 1063, 1364, 1680, 1891, 2427, 2650, 2854, 3456, 3722, 4172]","[302, 745, 1214, 1722, 2121, 2724, 3250, 3430, 3710, 4466, 4768, 5033, 5230, 5521, 5830]","[170, 523, 827, 1084, 1284, 1904, 2240, 2651, 2891, 3130, 3220, 3630, 3976, 4361, 4813]","[208, 298, 388, 581, 719, 1263, 1443, 1533, 1682, 2091, 2181, 2488, 2583, 2677, 2772]",6222,4172,5830,4813,2772,1822,1813,810,-724,200,3921,15,radiant
7531158313,46,10,23,26,112,"[326, 543, 857, 1192, 1616, 1940, 2308, 2641, 2998, 3284, 3759, 4169, 4877, 5140, 6304]","[58, 188, 467, 782, 941, 1153, 1340, 1468, 1887, 2301, 2613, 2963, 3493, 3753, 4667]","[58, 188, 383, 781, 1062, 1315, 1613, 2300, 2635, 2881, 3372, 3879, 4115, 4210, 4834]","[58, 231, 404, 561, 732, 969, 1176, 1445, 1627, 1717, 1831, 1973, 2063, 2240, 3177]","[58, 288, 378, 560, 685, 849, 991, 1081, 1425, 1592, 1682, 1772, 1862, 2184, 2662]",6304,4667,4834,3177,2662,70,66,129,86,105,"[330, 540, 738, 1045, 1410, 1939, 2279, 2758, 3127, 3579, 4129, 4666, 5342, 5956, 6616]","[197, 407, 570, 825, 1004, 1375, 1533, 1948, 2182, 2781, 3138, 3663, 4093, 5081, 5671]","[133, 424, 709, 1022, 1517, 1950, 2565, 3033, 3526, 4041, 4924, 5430, 5940, 6528, 6758]","[330, 658, 1001, 1325, 1733, 2175, 2623, 3187, 3635, 4339, 4902, 5288, 5676, 6254, 6807]","[330, 540, 630, 768, 858, 1049, 1228, 1746, 1836, 2132, 2357, 2703, 2975, 3303, 3707]",6616,5671,6758,6807,3707,-312,-1004,-1924,-3630,-1045,-7915,15,dire
7531360714,10,17,43,101,96,"[0, 130, 442, 1159, 1478, 1956, 2197, 2664, 3149, 3515, 4171, 4659, 5756, 6588, 7532]","[0, 239, 473, 759, 1263, 1516, 1895, 2435, 2935, 3590, 4299, 4647, 5330, 5984, 6494]","[0, 206, 405, 572, 752, 1052, 1671, 1846, 2628, 3051, 3351, 3523, 3838, 4077, 4870]","[0, 130, 262, 352, 442, 543, 1039, 1881, 2178, 2348, 2573, 2663, 3417, 3638, 4304]","[0, 130, 220, 385, 475, 601, 691, 829, 1015, 1105, 1376, 1466, 1963, 2186, 2470]",7532,6494,4870,4304,2470,135,6,98,20,85,"[0, 253, 501, 1022, 1324, 1859, 2313, 2649, 2982, 3373, 3765, 4480, 4771, 5053, 5456]","[0, 249, 530, 772, 1138, 1521, 1954, 2247, 2685, 2911, 3495, 4093, 4605, 5844, 6256]","[0, 282, 510, 820, 1237, 1529, 1952, 2338, 2795, 3734, 3905, 4570, 4660, 5108, 5798]","[0, 210, 300, 468, 558, 1135, 1778, 2358, 2666, 2982, 3117, 3296, 3386, 3806, 3978]","[0, 210, 315, 405, 539, 636, 1077, 1294, 1727, 1898, 2067, 2514, 2730, 3382, 3554]",5456,6256,5798,3978,3554,2076,238,-928,326,-1084,628,15,radiant
7531469911,76,21,28,91,83,"[0, 291, 509, 802, 1208, 1455, 1791, 2156, 2575, 3011, 3339, 4135, 4726, 5351, 5948]","[0, 285, 519, 859, 1060, 1547, 1940, 2576, 2925, 3500, 3961, 4496, 5062, 6184, 6896]","[0, 207, 379, 591, 1049, 1367, 1698, 2263, 2849, 3764, 4134, 4669, 5140, 5713, 6295]","[0, 170, 260, 350, 544, 718, 860, 1007, 1246, 1707, 1844, 1934, 2311, 2925, 3200]","[0, 170, 365, 501, 591, 1072, 1262, 1469, 1840, 2089, 2179, 2507, 3008, 3434, 4050]",5948,6896,6295,3200,4050,113,109,96,100,68,"[0, 313, 565, 851, 1311, 1604, 2000, 2333, 2904, 3605, 4259, 5164, 5677, 6221, 7067]","[0, 272, 868, 1260, 1574, 1966, 2414, 3030, 3203, 3436, 4442, 5042, 5694, 6076, 6336]","[0, 205, 520, 846, 1247, 1374, 1722, 1965, 2219, 2602, 3133, 3776, 4183, 4706, 4952]","[0, 505, 870, 976, 1066, 1205, 1385, 1551, 1686, 1815, 2168, 2420, 2511, 2660, 3087]","[0, 237, 327, 464, 639, 767, 892, 1025, 1196, 1286, 1636, 1888, 1987, 2136, 2285]",7067,6336,4952,3087,2285,-1119,560,1343,113,1765,2662,15,radiant
7531515518,4,102,19,105,45,"[275, 627, 871, 1416, 1726, 2252, 2757, 3151, 3637, 4146, 4789, 5554, 6367, 6932, 7626]","[355, 711, 836, 1198, 1518, 1794, 2215, 2772, 3293, 3778, 4546, 5121, 5669, 6198, 6950]","[345, 677, 1015, 1315, 1615, 1943, 2423, 2660, 3031, 3317, 3734, 4220, 4577, 5038, 5420]","[195, 285, 375, 531, 946, 1088, 1702, 1866, 2234, 2416, 3132, 3436, 3855, 4127, 4225]","[195, 285, 375, 510, 632, 767, 1301, 1391, 1644, 1994, 2505, 2799, 2995, 3347, 3724]",7626,6950,5420,4225,3724,73,21,13,65,100,"[430, 724, 966, 1302, 1786, 2280, 2504, 3042, 3447, 4021, 4781, 5780, 6551, 7524, 8325]","[170, 530, 943, 1361, 1723, 2202, 2579, 2875, 3038, 3885, 4290, 4798, 5514, 6077, 6483]","[289, 517, 829, 1112, 1482, 1743, 2270, 2525, 2912, 3262, 3769, 4025, 4405, 4729, 5212]","[170, 285, 490, 658, 1205, 1295, 1471, 1576, 1693, 1936, 2413, 2768, 2971, 3448, 3542]","[170, 285, 405, 621, 751, 841, 978, 1113, 1203, 1429, 1631, 2034, 2403, 2766, 3131]",8325,6483,5212,3542,3131,-699,467,208,683,593,1252,15,radiant
7531643102,41,114,128,5,100,"[0, 208, 409, 703, 1257, 1593, 1861, 2483, 3039, 3443, 3940, 4345, 4708, 5169, 5795]","[0, 325, 667, 1073, 1358, 1659, 2238, 2922, 3350, 3817, 4285, 4465, 5051, 5348, 5788]","[0, 294, 959, 1201, 1481, 1984, 2515, 2650, 3126, 3564, 3745, 3835, 4140, 4587, 4871]","[0, 169, 352, 493, 724, 858, 1270, 1489, 1805, 1985, 2395, 2495, 2715, 3103, 3397]","[0, 169, 325, 415, 505, 735, 935, 1199, 1429, 1899, 2080, 2170, 2260, 2514, 2799]",5795,5788,4871,3397,2799,70,69,106,72,121,"[0, 284, 488, 1031, 1478, 2021, 2433, 3230, 3572, 3832, 4959, 5450, 6050, 6731, 6826]","[0, 273, 552, 698, 1279, 1643, 2014, 2376, 2749, 3257, 3809, 4382, 5103, 5621, 6336]","[0, 207, 419, 795, 1113, 1376, 1718, 1847, 1989, 2574, 3486, 3730, 4206, 4832, 5171]","[0, 215, 350, 476, 650, 784, 1249, 1455, 1834, 2230, 2757, 2847, 2937, 3573, 3668]","[0, 169, 305, 521, 763, 1145, 1572, 1946, 2167, 2361, 2541, 2631, 2762, 3241, 3336]",6826,6336,5171,3668,3336,-1031,-548,-300,-271,-537,-2687,15,dire
7531673702,95,69,106,121,79,"[0, 343, 708, 959, 1286, 1570, 2027, 2521, 3121, 3784, 4280, 4767, 5642, 6301, 6845]","[0, 328, 704, 987, 1393, 1750, 2456, 2705, 3369, 3966, 4498, 5056, 5796, 6135, 6792]","[0, 205, 600, 852, 1251, 1628, 1835, 2497, 2998, 3178, 3925, 4277, 4811, 5277, 5567]","[0, 170, 360, 450, 587, 778, 1029, 1274, 1858, 2200, 3094, 3544, 3724, 3873, 4412]","[0, 505, 662, 833, 977, 1088, 1407, 1846, 2169, 2383, 3263, 3481, 3752, 3948, 4344]",6845,6792,5567,4412,4344,25,67,104,26,83,"[0, 328, 558, 803, 1234, 1665, 2034, 2532, 2965, 3876, 3976, 4544, 5103, 5566, 5957]","[0, 240, 567, 894, 1144, 1557, 1897, 2280, 2534, 3064, 3202, 3421, 4058, 4153, 5694]","[0, 170, 481, 698, 1003, 1294, 1655, 2005, 2219, 2610, 2773, 3368, 3745, 4432, 5510]","[0, 170, 728, 856, 946, 1076, 1166, 1344, 1488, 1840, 1930, 2199, 2397, 2629, 3476]","[0, 170, 260, 407, 497, 760, 898, 1027, 1117, 1454, 1544, 1814, 2095, 2190, 3107]",5957,5694,5510,3476,3107,888,1098,57,936,1237,4216,15,radiant
7531796410,54,25,55,21,5,"[0, 293, 698, 1108, 1433, 1831, 2213, 2746, 3284, 3912, 4494, 4960, 5614, 6261, 6823]","[0, 204, 372, 802, 1162, 1462, 1950, 2498, 2799, 3525, 4308, 4942, 5742, 6369, 6896]","[0, 240, 665, 1160, 1603, 2040, 2428, 3072, 3699, 4316, 5087, 5731, 6465, 6770, 7250]","[0, 170, 272, 407, 545, 696, 786, 923, 1013, 1193, 1333, 1469, 1667, 1896, 2272]","[0, 170, 268, 404, 511, 601, 764, 854, 1024, 1204, 1398, 1488, 1721, 1916, 2058]",6823,6896,7250,2272,2058,8,2,13,114,84,"[0, 253, 624, 989, 1509, 2085, 2664, 3342, 3933, 4665, 5335, 6127, 6702, 7451, 8248]","[0, 200, 407, 861, 1280, 1525, 2325, 2798, 3302, 3911, 4536, 5170, 5816, 6612, 7208]","[0, 240, 603, 895, 1260, 1660, 2171, 2824, 3367, 3837, 4431, 4951, 5345, 5950, 6540]","[0, 179, 273, 409, 550, 695, 895, 1246, 1336, 1672, 2016, 2177, 2402, 2954, 3258]","[0, 130, 220, 310, 447, 583, 801, 1114, 1248, 1387, 1563, 1653, 1743, 1938, 2032]",8248,7208,6540,3258,2032,-1425,-312,710,-986,26,-1987,15,dire
7531926406,46,13,121,71,5,"[0, 325, 650, 1073, 1355, 1783, 2182, 2864, 3280, 3940, 4798, 5248, 5875, 6566, 7369]","[0, 328, 698, 1147, 1517, 1892, 2562, 3076, 3721, 4269, 4760, 5174, 5889, 6107, 6691]","[0, 169, 259, 779, 943, 1152, 1298, 1434, 1669, 2061, 2151, 2343, 2687, 2782, 3047]","[0, 278, 513, 940, 1127, 1693, 1978, 2197, 3018, 3561, 3889, 4153, 4794, 5052, 5238]","[0, 169, 293, 435, 525, 646, 741, 831, 941, 1072, 1206, 1385, 2091, 2226, 2442]",7369,6691,3047,5238,2442,4,106,55,86,83,"[0, 296, 649, 1098, 1746, 2066, 2563, 3566, 4046, 4364, 5257, 6243, 6805, 7447, 7988]","[0, 326, 776, 1119, 1581, 1990, 2479, 3311, 3827, 4297, 4937, 5338, 5855, 6412, 7195]","[0, 245, 476, 681, 1160, 1487, 1733, 2118, 2422, 2512, 2852, 3114, 3489, 3798, 4603]","[0, 169, 307, 444, 625, 822, 912, 1344, 1434, 1681, 1975, 2323, 2577, 2901, 3070]","[0, 169, 259, 349, 577, 667, 757, 1309, 1518, 1608, 1925, 2198, 2288, 2484, 2602]",7988,7195,4603,3070,2602,-619,-504,-1556,2168,-160,-671,15,dire
7531967418,22,54,47,100,5,"[242, 522, 934, 1220, 1475, 1798, 1923, 2473, 2713, 3226, 3416, 4306, 4793, 5097, 5272]","[547, 750, 1115, 1283, 1490, 1707, 1923, 2275, 2633, 2952, 3173, 3710, 4233, 4702, 5356]","[170, 260, 551, 641, 904, 1173, 1792, 2153, 2456, 2788, 3114, 3662, 4040, 4240, 4387]","[240, 330, 499, 589, 679, 1131, 1337, 1538, 1628, 1911, 2001, 2339, 2565, 2900, 2995]","[240, 330, 420, 510, 600, 851, 1073, 1332, 1422, 1546, 1636, 1726, 1821, 1967, 2062]",5272,5356,4387,2995,2062,25,33,19,105,96,"[409, 880, 1153, 1936, 2186, 2534, 2891, 3337, 3889, 4614, 5170, 5819, 6762, 7524, 8666]","[170, 441, 843, 1170, 1736, 2067, 2851, 3493, 4503, 4865, 5472, 6118, 6689, 7272, 7721]","[330, 712, 1005, 1330, 2077, 2498, 2998, 3561, 4315, 4769, 4946, 5267, 5893, 6099, 6808]","[240, 524, 614, 951, 1268, 1459, 1687, 1777, 1949, 2129, 2501, 2757, 3501, 4141, 5039]","[240, 391, 481, 778, 954, 1373, 1553, 1643, 1853, 2077, 2463, 2950, 3735, 4026, 4543]",8666,7721,6808,5039,4543,-3394,-2365,-2421,-2044,-2481,-12705,15,dire
7532057903,54,11,104,19,84,"[0, 244, 611, 1018, 1382, 1908, 2320, 2587, 3232, 3762, 4315, 4801, 5126, 5785, 6354]","[0, 252, 619, 863, 1231, 1487, 1822, 2068, 2520, 2955, 3297, 3839, 3953, 4518, 4960]","[0, 336, 700, 1014, 1389, 1668, 1908, 2260, 2732, 3274, 3618, 3973, 4253, 4870, 5136]","[0, 209, 299, 457, 589, 679, 769, 859, 949, 1129, 1256, 1346, 1651, 1848, 2063]","[0, 209, 299, 457, 563, 1083, 1221, 1311, 1401, 1654, 1761, 1944, 2034, 2363, 2458]",6354,4960,5136,2063,2458,48,22,14,114,20,"[0, 310, 593, 984, 1294, 1845, 2433, 3047, 3526, 4176, 5107, 5698, 6499, 7246, 8012]","[0, 275, 691, 1070, 1516, 1898, 2272, 2911, 3554, 4300, 4992, 5337, 5717, 6536, 7352]","[0, 229, 594, 927, 1378, 1659, 1942, 2218, 2663, 2982, 3305, 3816, 4185, 4908, 5431]","[0, 154, 244, 334, 627, 765, 900, 1035, 1125, 1320, 1663, 1753, 1843, 2100, 2195]","[0, 154, 294, 431, 561, 746, 885, 1020, 1110, 1244, 1592, 1825, 1959, 2216, 2311]",8012,7352,5431,2195,2311,-1658,-2392,-295,-132,147,-4330,15,dire
7532058012,48,106,14,86,31,"[177, 379, 702, 875, 1210, 1543, 1829, 1955, 2178, 2477, 2692, 3375, 3505, 3803, 3897]","[204, 414, 674, 970, 1288, 1530, 1719, 2305, 2511, 2890, 2980, 3353, 3632, 4130, 4462]","[129, 363, 602, 1010, 1340, 1551, 1845, 2087, 2270, 2669, 2759, 2910, 3202, 3297, 3649]","[174, 264, 400, 582, 690, 780, 1076, 1319, 2148, 2283, 2513, 2603, 2976, 3071, 3608]","[129, 219, 354, 520, 706, 845, 935, 1025, 1115, 1250, 1340, 1430, 1564, 1746, 2098]",3897,4462,3649,3608,2098,10,19,97,105,65,"[264, 623, 1026, 1241, 1626, 2332, 2851, 3290, 3984, 4722, 5615, 6695, 7230, 7924, 9284]","[243, 624, 947, 1393, 1753, 2366, 2823, 3417, 3875, 4222, 4869, 5347, 5887, 6720, 7183]","[222, 807, 1048, 1406, 2085, 2754, 3167, 3799, 4302, 4918, 5316, 5627, 6358, 6846, 7293]","[455, 628, 758, 894, 1114, 1454, 1544, 1972, 2344, 2584, 3347, 3623, 4122, 4520, 5107]","[187, 302, 478, 568, 757, 982, 1088, 1288, 1724, 1904, 2435, 2819, 3052, 3269, 4242]",9284,7183,7293,5107,4242,-5387,-2721,-3644,-1499,-2144,-15395,15,dire
7532211815,11,17,60,19,102,"[0, 256, 622, 840, 1190, 1461, 1771, 1990, 2355, 2760, 3023, 3543, 3980, 4581, 5283]","[0, 290, 666, 956, 1349, 1773, 2077, 2431, 2934, 3670, 4176, 4653, 4856, 5464, 6090]","[0, 244, 384, 680, 933, 1100, 1344, 1672, 1874, 2211, 2375, 3245, 3736, 4081, 4383]","[0, 170, 298, 418, 548, 678, 768, 1093, 1183, 1468, 1558, 1981, 2071, 2265, 2364]","[0, 170, 260, 380, 549, 679, 791, 881, 991, 1276, 1366, 1720, 1962, 2156, 2416]",5283,6090,4383,2364,2416,76,21,23,79,58,"[60, 303, 521, 882, 1222, 1483, 1857, 2273, 2841, 3214, 4268, 4556, 5180, 5782, 6447]","[328, 569, 850, 1190, 1595, 2049, 2401, 2866, 3394, 3529, 4255, 5186, 5990, 6730, 7218]","[60, 267, 553, 1019, 1318, 1591, 2017, 2369, 2782, 3228, 3756, 4336, 4910, 5847, 6472]","[60, 230, 320, 457, 577, 1104, 1414, 1549, 1729, 1999, 2089, 2377, 2718, 2921, 3316]","[60, 230, 320, 455, 575, 665, 873, 1008, 1143, 1278, 1532, 1858, 2077, 2427, 2770]",6447,7218,6472,3316,2770,-1164,-1128,-2089,-952,-354,-5687,15,radiant
7532381012,113,120,97,128,45,"[0, 291, 797, 926, 1335, 1676, 2008, 2213, 2468, 2634, 2899, 3194, 3936, 4110, 4700]","[0, 222, 434, 801, 1185, 1444, 1688, 2045, 2495, 3139, 3229, 3627, 4254, 4550, 4726]","[0, 243, 449, 809, 1042, 1530, 1928, 2224, 2433, 2756, 3157, 3473, 4098, 4755, 4984]","[0, 170, 335, 459, 764, 873, 1044, 1219, 1344, 1565, 1655, 1745, 2344, 2779, 2874]","[0, 170, 304, 693, 783, 943, 1053, 1143, 1320, 1665, 1920, 2059, 2413, 2579, 2791]",4700,4726,4984,2874,2791,106,69,93,66,110,"[0, 254, 764, 988, 1402, 1821, 2343, 2725, 3210, 3546, 3960, 4373, 5263, 5636, 6076]","[0, 170, 755, 953, 1390, 1759, 2226, 2782, 3353, 3963, 4853, 5129, 5698, 6243, 6915]","[0, 242, 494, 694, 902, 1145, 1636, 1973, 2575, 3003, 3516, 4008, 4367, 5189, 5639]","[0, 170, 294, 384, 585, 742, 944, 1227, 1510, 1798, 2042, 2528, 2789, 3107, 3519]","[0, 170, 340, 430, 608, 738, 828, 963, 1191, 1351, 1908, 2033, 2251, 2658, 2902]",6076,6915,5639,3519,2902,-1376,-2189,-655,-645,-111,-4976,15,dire
7532385315,70,112,102,31,105,"[0, 237, 473, 614, 1041, 1279, 1844, 2038, 2508, 2669, 2870, 3386, 3780, 4198, 4540]","[0, 129, 377, 755, 1135, 1356, 1730, 2077, 2402, 2606, 2696, 3074, 3838, 4256, 4906]","[0, 204, 596, 921, 1207, 1569, 1924, 2050, 2387, 2741, 2831, 3085, 3298, 3581, 4154]","[0, 129, 219, 309, 444, 574, 834, 924, 1166, 1256, 1381, 1525, 1615, 1917, 2012]","[0, 129, 566, 656, 746, 957, 1047, 1137, 1227, 1317, 1539, 1771, 1861, 2046, 2141]",4540,4906,4154,2012,2141,48,128,29,53,26,"[0, 258, 455, 857, 1182, 1595, 1846, 2284, 2648, 3062, 3867, 4392, 5016, 5731, 6487]","[0, 287, 850, 1143, 1472, 2034, 2530, 2910, 3903, 4401, 5242, 5681, 5887, 6371, 6973]","[0, 283, 551, 885, 1356, 1766, 2309, 2769, 3236, 3431, 4115, 4421, 5129, 5653, 6480]","[0, 209, 299, 438, 548, 917, 1007, 1206, 1587, 1791, 2679, 2769, 3068, 3388, 4161]","[0, 209, 299, 389, 528, 961, 1158, 1516, 1833, 2165, 2713, 2803, 3541, 3752, 4201]",6487,6973,6480,4161,4201,-1947,-2067,-2326,-2149,-2060,-10549,15,dire
7532407808,1,69,112,19,26,"[240, 593, 952, 1271, 1652, 1742, 2214, 2426, 2660, 3195, 3955, 4084, 4673, 4958, 5505]","[276, 437, 900, 1345, 2071, 2459, 2785, 3286, 3791, 4132, 4957, 5399, 5841, 6016, 6478]","[283, 570, 862, 1242, 1454, 1663, 2193, 2683, 2981, 3355, 3701, 4094, 4375, 4713, 4967]","[170, 322, 447, 582, 1201, 1291, 1471, 1606, 1821, 2159, 2553, 2716, 3250, 3345, 3610]","[170, 260, 452, 588, 757, 847, 1235, 1370, 1622, 1889, 1979, 2069, 2298, 2393, 2658]",5505,6478,4967,3610,2658,25,98,74,123,20,"[206, 489, 841, 1167, 1574, 2057, 2652, 3283, 3843, 4196, 4617, 5188, 6229, 7265, 7670]","[289, 567, 890, 1067, 1505, 2201, 2776, 3586, 4372, 5015, 5753, 6437, 6672, 7440, 7722]","[240, 538, 746, 1030, 1319, 1773, 2202, 2924, 3167, 3783, 4302, 4651, 5210, 5820, 6265]","[170, 260, 436, 612, 750, 1091, 1602, 2011, 2239, 2438, 2984, 3646, 4194, 4501, 5002]","[221, 311, 450, 584, 720, 1019, 1546, 1862, 2215, 2414, 2703, 2864, 3285, 3594, 3688]",7670,7722,6265,5002,3688,-2165,-1244,-1298,-1392,-1030,-7129,15,dire
7532416205,48,15,17,114,110,"[683, 1051, 1227, 1728, 2187, 2672, 2995, 3445, 3976, 4703, 5300, 6030, 6409, 7161, 8359]","[513, 802, 1142, 1516, 2193, 2522, 3086, 3505, 4038, 4821, 5170, 5782, 6573, 7249, 7947]","[730, 900, 1215, 1460, 1945, 2384, 2756, 3316, 3699, 4251, 4341, 4624, 5497, 5987, 6393]","[597, 687, 1007, 1210, 1634, 1770, 2059, 2149, 2845, 3119, 3209, 3441, 3819, 4280, 4573]","[310, 446, 536, 711, 1095, 1185, 1535, 1625, 1821, 2397, 2688, 3001, 3241, 3598, 3845]",8359,7947,6393,4573,3845,73,19,112,105,136,"[726, 1076, 1477, 1987, 2171, 2704, 3071, 3799, 4323, 4994, 5502, 6133, 7132, 8196, 9156]","[676, 923, 1219, 1594, 1962, 2572, 3052, 3355, 3858, 3948, 4418, 5015, 5218, 5748, 5916]","[449, 758, 1314, 1444, 1649, 2001, 2279, 2523, 3163, 3270, 3636, 4280, 4924, 5264, 5358]","[404, 494, 816, 966, 1056, 1236, 1370, 1946, 2081, 2226, 2543, 2913, 3215, 3310, 3539]","[290, 424, 813, 943, 1033, 1213, 1448, 1680, 1982, 2194, 2546, 2840, 3043, 3138, 3232]",9156,5916,5358,3539,3232,-797,2031,1035,1034,613,3916,15,radiant
7532489102,10,59,129,53,91,"[625, 837, 1278, 1802, 2359, 3129, 3444, 4141, 4563, 5206, 5838, 6456, 6927, 7561, 8415]","[1027, 1686, 1917, 2724, 3574, 4310, 4779, 5774, 6055, 6708, 7440, 7883, 8517, 9464, 10433]","[1009, 1337, 1576, 2085, 2569, 3228, 3474, 3828, 4695, 5092, 5548, 6097, 6350, 7110, 7524]","[350, 474, 641, 916, 1258, 1545, 1635, 2117, 2315, 2501, 2731, 3292, 3624, 3829, 4545]","[438, 601, 813, 1060, 1330, 1580, 1670, 2031, 2121, 2211, 2441, 2657, 3188, 3625, 3940]",8415,10433,7524,4545,3940,1,106,14,119,30,"[734, 1220, 1491, 1704, 2050, 2217, 2658, 3040, 3296, 3732, 4666, 5215, 5309, 5774, 6247]","[498, 588, 851, 941, 1159, 1757, 2387, 2918, 3279, 3587, 3835, 4045, 4692, 5181, 5608]","[1187, 1617, 1932, 2175, 2576, 2915, 3374, 3501, 4003, 4093, 4497, 4934, 5362, 6142, 6684]","[422, 784, 1188, 1278, 1495, 1585, 1768, 1944, 2122, 2212, 2699, 2970, 3162, 3778, 3965]","[384, 567, 657, 747, 927, 1017, 1346, 1436, 1580, 1822, 2126, 2221, 2802, 3378, 3473]",6247,5608,6684,3965,3473,2168,4825,840,580,467,8880,15,radiant
7532553807,10,126,98,86,72,"[0, 205, 523, 731, 1136, 1295, 1706, 1948, 2316, 2665, 3202, 3776, 4430, 4822, 5398]","[0, 280, 497, 823, 1237, 1652, 1941, 2578, 3289, 3663, 4235, 4909, 5544, 6153, 6803]","[0, 167, 569, 1093, 1414, 1592, 1995, 2338, 2863, 3273, 3663, 4016, 4645, 4949, 5854]","[0, 130, 270, 439, 613, 703, 793, 921, 1011, 1231, 1502, 1787, 2044, 2609, 3075]","[0, 130, 220, 330, 509, 636, 726, 912, 1180, 1315, 1786, 1930, 2512, 2812, 3722]",5398,6803,5854,3075,3722,4,13,112,19,26,"[0, 244, 485, 728, 1173, 1591, 2021, 2396, 2676, 3069, 3464, 3997, 4483, 5040, 5399]","[0, 289, 644, 1032, 1274, 1693, 2095, 2384, 2671, 3047, 3485, 3753, 4159, 4834, 4928]","[0, 210, 498, 770, 1061, 1416, 1791, 2155, 2646, 2974, 3354, 3444, 3627, 4075, 4611]","[0, 210, 300, 390, 607, 932, 1067, 1202, 1571, 1915, 2333, 2506, 2632, 3335, 3466]","[100, 310, 442, 583, 708, 1105, 1244, 1430, 1619, 1781, 2144, 2488, 2578, 2781, 3172]",5399,4928,4611,3466,3172,-1,1875,1243,-391,550,3276,15,radiant
7532722008,63,114,96,110,26,"[674, 1124, 1604, 1943, 2350, 2871, 3477, 3727, 4649, 4977, 5157, 5443, 6303, 6956, 7624]","[730, 1032, 1445, 1778, 2623, 3144, 3620, 3887, 4239, 4803, 5251, 5551, 5979, 6701, 6967]","[709, 942, 1261, 1544, 2013, 2525, 2952, 3388, 3931, 4440, 5060, 5498, 5764, 6353, 6800]","[324, 482, 833, 972, 1107, 1356, 1526, 1661, 1987, 2077, 2556, 2835, 2990, 3481, 3710]","[530, 681, 815, 905, 1181, 1552, 1709, 1967, 2195, 2523, 2703, 2843, 2937, 3542, 3818]",7624,6967,6800,3710,3818,106,54,69,86,58,"[915, 1085, 1329, 1732, 2029, 2516, 2860, 3364, 3781, 4362, 4680, 5544, 6200, 6506, 7385]","[559, 996, 1402, 1806, 2214, 2567, 3379, 3844, 4461, 5174, 5625, 6736, 7320, 7884, 8290]","[508, 598, 926, 1122, 1488, 2083, 2487, 2975, 3301, 3834, 4304, 4827, 5764, 6211, 6821]","[336, 537, 742, 916, 1128, 1313, 1529, 1759, 1992, 2178, 2745, 3136, 3452, 3636, 4084]","[350, 458, 629, 768, 858, 1061, 1280, 1509, 1724, 1947, 2392, 3047, 3318, 3696, 4018]",7385,8290,6821,4084,4018,239,-1323,-21,-374,-200,-1679,15,radiant
7532751106,10,97,106,58,65,"[0, 215, 497, 910, 1506, 2086, 2479, 3096, 3457, 3980, 4795, 5330, 6054, 7150, 7965]","[0, 215, 605, 1008, 1386, 1790, 2197, 2809, 3115, 3726, 4533, 5185, 5658, 6524, 7343]","[0, 353, 584, 788, 996, 1493, 1665, 1934, 2129, 2435, 3112, 3655, 4151, 4963, 6066]","[0, 498, 588, 724, 945, 1430, 1634, 1814, 2008, 2318, 2588, 3020, 3535, 4174, 4619]","[0, 230, 320, 454, 544, 845, 985, 1544, 1867, 2161, 3072, 3176, 3593, 4154, 5168]",7965,7343,6066,4619,5168,59,41,28,86,20,"[0, 170, 547, 1015, 1308, 1565, 2275, 2753, 3208, 3773, 4061, 4705, 5072, 5451, 5592]","[0, 251, 490, 740, 1018, 1466, 1789, 2042, 2372, 2546, 3052, 3520, 4170, 4645, 5012]","[0, 242, 405, 681, 1078, 1168, 1331, 1507, 1679, 1919, 2272, 2690, 3378, 3575, 4342]","[0, 170, 348, 535, 822, 1013, 1137, 1293, 1814, 2037, 2459, 2974, 3219, 3313, 3795]","[0, 170, 312, 486, 647, 871, 961, 1051, 1629, 1765, 2084, 2174, 2786, 2917, 3012]",5592,5012,4342,3795,3012,2373,2331,1724,824,2156,9408,15,radiant
7532848119,14,74,15,5,100,"[62, 267, 549, 836, 1252, 1732, 2253, 2807, 3152, 3622, 4104, 4641, 5244, 5501, 5768]","[62, 264, 471, 838, 1177, 1551, 2036, 2463, 2942, 3330, 3604, 4041, 4737, 4832, 5062]","[62, 191, 426, 705, 1163, 1322, 1571, 1774, 2260, 2783, 3159, 3706, 4248, 4796, 5052]","[430, 604, 714, 804, 980, 1156, 1347, 1654, 2029, 2119, 2209, 2346, 2608, 2796, 3199]","[62, 243, 333, 423, 650, 740, 875, 1010, 1332, 1422, 1512, 1744, 1926, 2021, 2236]",5768,5062,5052,3199,2236,120,41,137,64,26,"[0, 291, 622, 1001, 1486, 1906, 2393, 2788, 3320, 3718, 4618, 5204, 5792, 6752, 7108]","[0, 254, 485, 729, 1044, 1320, 1609, 2018, 2622, 3119, 3781, 4335, 4859, 6024, 6119]","[0, 243, 454, 725, 1009, 1294, 1498, 1830, 2170, 2956, 3562, 3962, 4230, 4687, 4890]","[0, 209, 338, 465, 595, 746, 962, 1097, 1417, 1586, 2131, 2620, 2744, 3180, 3721]","[100, 309, 435, 759, 889, 979, 1195, 1330, 1802, 2262, 2617, 2901, 3103, 3624, 3758]",7108,6119,4890,3721,3758,-1340,-1057,162,-522,-1522,-4279,15,dire
7532956917,8,120,43,65,88,"[287, 571, 977, 1538, 1916, 2636, 3200, 3828, 4457, 4863, 5404, 5712, 6812, 7422, 7851]","[317, 534, 905, 1649, 2064, 2738, 2883, 3493, 4301, 4858, 5537, 6039, 7088, 7274, 7834]","[206, 455, 841, 1124, 1353, 1733, 2108, 2873, 3571, 3872, 4547, 5002, 5664, 6215, 6556]","[170, 260, 350, 504, 716, 950, 1282, 1553, 1790, 2092, 2710, 2908, 3622, 3841, 3936]","[170, 293, 722, 861, 951, 1170, 1397, 1689, 1914, 2049, 2408, 2755, 3473, 3968, 4063]",7851,7834,6556,3936,4063,18,100,23,50,20,"[216, 536, 934, 1060, 1198, 1562, 1652, 2048, 2390, 2672, 3104, 3591, 3978, 4755, 5290]","[170, 411, 752, 842, 1164, 1423, 1793, 2069, 2291, 2637, 2800, 4004, 4551, 5144, 5574]","[170, 374, 508, 753, 843, 1072, 1395, 1606, 1993, 2347, 2437, 3072, 3539, 4093, 4334]","[170, 260, 350, 440, 530, 783, 1068, 1205, 1295, 1809, 1949, 2327, 2836, 3177, 3576]","[170, 260, 350, 440, 579, 669, 805, 895, 1117, 1390, 1510, 2024, 2265, 2759, 2857]",5290,5574,4334,3576,2857,2561,2260,2222,360,1206,8609,15,radiant
7532959808,69,19,53,101,100,"[789, 1184, 1791, 2330, 2796, 3174, 3720, 4661, 5210, 6061, 6839, 7811, 8389, 8875, 9967]","[877, 1206, 1693, 2196, 2692, 3170, 3943, 4443, 4973, 6309, 6915, 7533, 8120, 8475, 9319]","[648, 954, 1541, 1886, 2464, 2751, 3642, 4195, 4926, 5376, 5973, 6837, 7502, 8129, 9102]","[394, 544, 954, 1044, 1310, 1699, 2037, 2541, 3097, 3228, 3480, 3955, 4325, 4510, 5187]","[332, 493, 1003, 1093, 1237, 1393, 1649, 1884, 2234, 2639, 2976, 3284, 3804, 4095, 4575]",9967,9319,9102,5187,4575,18,98,13,105,87,"[558, 826, 1109, 1275, 1452, 1662, 2146, 2522, 2836, 3139, 3313, 3633, 4072, 4480, 5045]","[794, 1099, 1529, 1729, 2062, 2638, 2952, 3042, 3351, 3877, 4173, 4434, 4789, 4883, 4978]","[571, 879, 1082, 1253, 1479, 1943, 2199, 2289, 2459, 2656, 2934, 3202, 3466, 3875, 4025]","[380, 642, 782, 872, 962, 1142, 1402, 1492, 1582, 1835, 1925, 2074, 2322, 2454, 2583]","[513, 695, 785, 875, 983, 1238, 1328, 1418, 1595, 1848, 1938, 2033, 2128, 2222, 2317]",5045,4978,4025,2583,2317,4922,4341,5077,2604,2258,19202,15,radiant
7532959919,48,120,60,26,91,"[0, 174, 424, 757, 1040, 1555, 1766, 2741, 3284, 3704, 4193, 4894, 5501, 6127, 6336]","[0, 200, 489, 823, 1223, 1399, 1602, 2205, 2597, 3213, 3753, 4034, 4825, 5149, 5244]","[0, 166, 444, 702, 878, 1124, 1408, 2046, 2328, 2662, 3148, 3431, 3932, 4279, 4456]","[0, 130, 566, 852, 942, 1032, 1122, 1675, 1765, 1940, 2154, 2244, 2616, 2809, 2904]","[0, 130, 220, 310, 400, 535, 625, 1352, 1571, 1706, 2038, 2128, 2680, 2873, 2968]",6336,5244,4456,2904,2968,72,74,55,112,19,"[0, 334, 948, 1226, 1596, 1892, 2451, 2588, 3043, 3558, 4120, 4883, 5302, 5902, 7222]","[0, 328, 687, 970, 1377, 1706, 1987, 2077, 2375, 2465, 2635, 2939, 3188, 3486, 4306]","[0, 244, 497, 822, 1044, 1259, 1487, 1777, 2042, 2435, 3011, 3357, 3898, 4353, 5323]","[0, 210, 369, 666, 756, 894, 1194, 1284, 1541, 1762, 1932, 2116, 2406, 2747, 3840]","[0, 210, 300, 435, 525, 698, 849, 939, 1029, 1200, 1456, 1546, 1690, 1937, 2489]",7222,4306,5323,3840,2489,-886,938,-867,-936,479,-1272,15,dire
7532977810,18,102,19,26,65,"[1008, 1438, 1803, 2437, 3148, 3767, 4384, 5169, 6151, 6887, 7775, 8414, 9523, 10260, 11110]","[1578, 1916, 2421, 2749, 3548, 4188, 4696, 5544, 6202, 6856, 7294, 8058, 8673, 9342, 10017]","[1144, 1526, 1816, 2225, 2558, 3138, 3566, 4395, 4999, 5531, 5779, 6379, 7051, 8148, 8999]","[927, 1069, 1382, 1706, 1926, 2214, 2438, 3046, 3499, 3783, 3976, 4797, 5297, 5668, 6321]","[729, 1050, 1140, 1364, 1540, 1849, 1939, 2506, 2751, 3031, 3170, 3445, 3803, 4234, 4690]",11110,10017,8999,6321,4690,35,60,67,68,27,"[708, 958, 1252, 1544, 1888, 2149, 2406, 2541, 2724, 2967, 3219, 3534, 3680, 4102, 4393]","[381, 544, 880, 1051, 1385, 1548, 1881, 2225, 2425, 2716, 2974, 3192, 3545, 3709, 4079]","[386, 592, 682, 817, 980, 1123, 1386, 1570, 1709, 1835, 2059, 2154, 2300, 2602, 3011]","[310, 435, 656, 791, 1134, 1309, 1399, 1534, 1624, 1714, 1902, 1997, 2128, 2288, 2382]","[349, 521, 643, 778, 868, 958, 1048, 1183, 1273, 1363, 1457, 1591, 1969, 2064, 2158]",4393,4079,3011,2382,2158,6717,5938,5988,3939,2532,25114,15,radiant
7532985414,10,25,137,100,26,"[285, 575, 883, 1134, 1340, 1694, 2194, 2612, 3220, 3551, 4067, 4505, 4845, 5061, 5412]","[152, 565, 861, 1321, 1960, 2646, 3166, 3974, 4239, 4417, 5512, 5868, 5958, 6481, 7161]","[285, 563, 800, 967, 1446, 1844, 2246, 2618, 3045, 3423, 3608, 4377, 4774, 5213, 5654]","[106, 316, 450, 540, 753, 892, 1022, 1173, 1358, 1448, 1858, 2037, 2447, 2590, 2685]","[420, 630, 816, 906, 1054, 1192, 1564, 1715, 2062, 2152, 2562, 2875, 2965, 3060, 3332]",5412,7161,5654,2685,3332,96,54,19,65,5,"[0, 282, 590, 876, 1540, 1982, 2337, 2743, 3082, 3996, 4588, 5129, 6140, 6868, 7537]","[0, 314, 517, 772, 1072, 1400, 1689, 2049, 2504, 3153, 3744, 4107, 4671, 5305, 6113]","[0, 155, 403, 844, 1094, 1305, 1605, 1909, 2488, 2960, 3371, 3774, 4356, 5629, 5959]","[0, 155, 245, 384, 831, 1088, 1178, 1303, 1924, 2753, 3334, 3789, 4174, 4712, 5259]","[0, 155, 288, 484, 661, 786, 1262, 1352, 1654, 2357, 2651, 2741, 3107, 3876, 4327]",7537,6113,5959,5259,4327,-2125,1048,-305,-2574,-995,-4951,15,radiant
7532992309,18,23,98,72,121,"[290, 525, 765, 1269, 1519, 2290, 2580, 3404, 4037, 4903, 5753, 6458, 7431, 8623, 9558]","[256, 663, 1484, 1896, 2301, 2633, 3137, 3810, 4639, 5024, 5761, 6344, 6793, 7590, 8330]","[292, 663, 1065, 1399, 1971, 2434, 3066, 3924, 4384, 5025, 6083, 6708, 7677, 8449, 8943]","[169, 293, 435, 603, 796, 1098, 1233, 1509, 2000, 2338, 2807, 3459, 4049, 4323, 4878]","[169, 308, 481, 618, 708, 974, 1130, 1537, 1766, 2088, 2322, 3001, 3574, 3861, 4101]",9558,8330,8943,4878,4101,48,28,13,30,105,"[207, 443, 651, 898, 1192, 1443, 1739, 2138, 2710, 3202, 3398, 3905, 4667, 5161, 5680]","[251, 569, 1063, 1351, 1810, 2185, 2583, 2981, 3355, 3695, 4032, 4122, 4388, 4705, 4961]","[214, 432, 652, 1060, 1284, 1570, 1781, 1946, 2334, 2707, 2810, 2900, 3165, 3270, 3522]","[169, 259, 349, 479, 589, 679, 837, 927, 1295, 1422, 1512, 1639, 1734, 1829, 2041]","[169, 259, 445, 575, 749, 930, 1065, 1165, 1393, 1675, 1858, 1948, 2043, 2138, 2313]",5680,4961,3522,2041,2313,3878,3369,5421,2837,1788,17293,15,radiant
7532994407,38,21,10,26,51,"[836, 1748, 2120, 2597, 3354, 3979, 4443, 5067, 5902, 7158, 8029, 8870, 9657, 11016, 12111]","[1015, 1619, 2028, 2550, 3026, 3709, 4431, 4755, 5531, 5917, 6345, 7124, 7874, 8877, 9833]","[813, 1318, 1724, 2238, 2644, 3065, 3552, 3907, 4500, 5196, 5651, 6258, 7291, 8191, 9262]","[441, 631, 807, 897, 1090, 1290, 1380, 1812, 2112, 2423, 2543, 2854, 3354, 3821, 4252]","[473, 662, 840, 999, 1149, 1349, 1587, 1892, 2094, 2307, 2796, 3273, 3559, 4226, 4862]",12111,9833,9262,4252,4862,48,90,129,65,86,"[849, 1122, 1495, 1780, 2061, 2333, 2589, 3026, 3757, 4511, 5156, 5598, 6248, 7280, 8558]","[704, 944, 1206, 1717, 2205, 2485, 2850, 3223, 3360, 3960, 4541, 4925, 5177, 5532, 5860]","[566, 932, 1143, 1268, 1651, 2048, 2509, 3090, 3180, 3486, 3846, 4233, 4457, 4721, 4972]","[394, 534, 711, 836, 1515, 1755, 2011, 2146, 2399, 2756, 3003, 3185, 3462, 3832, 3989]","[418, 639, 729, 854, 1392, 1517, 1607, 1697, 2132, 2333, 2697, 2814, 3019, 3177, 3505]",8558,5860,4972,3989,3505,3553,3973,4290,263,1357,13436,15,radiant
7532995214,63,21,65,72,51,"[556, 892, 1263, 1596, 2098, 2622, 2896, 3647, 4532, 5091, 5715, 6411, 7247, 7875, 9032]","[699, 1034, 1530, 1875, 2420, 2977, 3480, 4247, 5119, 5406, 5757, 6283, 6882, 7547, 8339]","[485, 850, 1102, 1710, 2175, 2737, 3418, 4044, 4796, 5495, 6052, 7154, 8027, 8532, 9455]","[300, 497, 633, 1174, 1325, 1835, 1961, 2269, 2706, 3082, 3840, 4398, 4636, 4770, 5285]","[300, 428, 553, 787, 922, 1378, 1747, 2021, 2246, 2384, 2844, 3108, 3404, 3761, 4473]",9032,8339,9455,5285,4473,54,47,43,75,100,"[580, 742, 1207, 1423, 1769, 2324, 2576, 2831, 2966, 3389, 3963, 4231, 4727, 5297, 5503]","[468, 643, 920, 1295, 1614, 2027, 2333, 2783, 3277, 3535, 3900, 4344, 4562, 4694, 4788]","[418, 547, 752, 975, 1260, 1590, 2039, 2983, 3323, 3729, 4025, 4300, 4441, 4869, 4995]","[220, 328, 458, 548, 720, 921, 1011, 1523, 1658, 1748, 1838, 2348, 2443, 2538, 2632]","[220, 310, 440, 632, 802, 1081, 1171, 1752, 2023, 2113, 2203, 2544, 2639, 2734, 2828]",5503,4788,4995,2632,2828,3529,3551,4460,2653,1645,15838,15,radiant
7533042916,10,74,47,96,20,"[0, 249, 494, 1105, 1502, 2176, 2846, 3442, 4117, 4820, 5316, 6080, 6900, 7384, 8199]","[0, 258, 635, 885, 1307, 1397, 1888, 2177, 2517, 2933, 3334, 3772, 4233, 4482, 4721]","[0, 286, 451, 857, 1225, 2021, 2520, 2966, 3378, 3681, 4029, 4512, 5127, 5465, 6058]","[0, 205, 340, 478, 568, 842, 1011, 1101, 1238, 1534, 1738, 2185, 2486, 2581, 2865]","[0, 169, 259, 424, 558, 831, 1008, 1194, 1435, 1802, 2427, 2672, 3075, 3334, 3620]",8199,4721,6058,2865,3620,46,22,69,72,121,"[0, 169, 333, 594, 918, 1008, 1607, 2013, 2405, 2866, 3265, 3682, 4438, 5572, 6459]","[0, 291, 593, 874, 1166, 1646, 2126, 2975, 3225, 3518, 4271, 4620, 5142, 6144, 6239]","[0, 206, 480, 793, 963, 1480, 1599, 1779, 2292, 2543, 2721, 3065, 4048, 4723, 5150]","[0, 169, 346, 436, 606, 969, 1500, 1789, 1951, 2041, 2247, 2542, 3011, 3519, 3813]","[0, 215, 348, 654, 869, 1089, 1179, 1359, 1521, 1764, 2081, 2256, 2396, 3186, 3375]",6459,6239,5150,3813,3375,1740,-1518,908,-948,245,427,15,radiant
7533154518,73,120,78,69,72,"[0, 712, 1045, 1268, 1741, 2110, 2332, 2957, 3506, 4216, 4753, 5421, 6092, 7140, 8272]","[0, 291, 584, 927, 1340, 1637, 1999, 2230, 2489, 3075, 3357, 3774, 4480, 4710, 5222]","[0, 170, 335, 539, 791, 1180, 1598, 1733, 2086, 2788, 3290, 3914, 4264, 4981, 5612]","[0, 170, 260, 375, 621, 1011, 1195, 1330, 1459, 1639, 2231, 2589, 3154, 3283, 3412]","[0, 236, 326, 452, 542, 678, 814, 960, 1050, 1273, 1492, 1740, 2263, 2357, 2595]",8272,5222,5612,3412,2595,109,39,112,26,19,"[0, 663, 878, 1198, 1477, 1876, 2242, 2528, 3032, 3259, 3619, 3959, 4931, 5401, 6113]","[0, 324, 558, 930, 1380, 1673, 2040, 2454, 3167, 3630, 4104, 4538, 5119, 5304, 6132]","[0, 221, 382, 725, 888, 1192, 1917, 2131, 2690, 3089, 3672, 4699, 5178, 6309, 6770]","[0, 326, 454, 703, 793, 1016, 1151, 1324, 1504, 1674, 1924, 2081, 2261, 2998, 3501]","[0, 170, 260, 400, 527, 651, 1130, 1460, 1640, 1902, 2306, 2476, 2755, 2849, 3434]",6113,6132,6770,3501,3434,2159,-910,-1158,-89,-839,-837,15,dire
7533231811,10,96,11,136,26,"[1, 130, 554, 846, 1368, 1813, 2150, 2843, 3319, 3885, 4333, 4817, 5526, 6130, 6643]","[1, 180, 604, 918, 1589, 2068, 2421, 3239, 3932, 4357, 5013, 5518, 6393, 6716, 7104]","[1, 247, 582, 784, 1065, 1773, 1988, 2236, 2819, 3573, 3993, 4606, 5134, 5332, 5856]","[1, 130, 560, 686, 1077, 1494, 1684, 1855, 2032, 2122, 2395, 2531, 2711, 2806, 2954]","[1, 130, 265, 373, 669, 848, 1188, 1415, 1734, 1908, 2078, 2218, 2997, 3313, 3498]",6643,7104,5856,2954,3498,106,41,19,90,86,"[1, 377, 575, 1180, 1566, 1948, 2545, 2789, 3174, 3388, 3779, 4129, 4521, 5201, 5706]","[1, 210, 458, 783, 1123, 1676, 1838, 2413, 2614, 2986, 3316, 3883, 4088, 4614, 5333]","[1, 244, 485, 655, 988, 1214, 1782, 1989, 2238, 2373, 2542, 2753, 3084, 3558, 3972]","[1, 210, 300, 390, 480, 760, 1014, 1149, 1367, 1715, 1901, 2744, 3422, 3867, 4177]","[1, 249, 383, 518, 682, 1074, 1732, 1954, 2044, 2170, 2552, 2642, 2886, 3071, 3464]",5706,5333,3972,4177,3464,937,1771,1884,-1223,34,3403,15,radiant
7533363704,95,43,22,71,103,"[0, 256, 574, 880, 1304, 1704, 2186, 2781, 3252, 3761, 4205, 4784, 5232, 5813, 6654]","[0, 203, 537, 739, 829, 1213, 1417, 1740, 2264, 2519, 3155, 3657, 4118, 4526, 5633]","[0, 284, 609, 937, 1412, 1859, 2265, 2755, 3479, 3898, 4192, 4775, 5261, 5861, 6573]","[0, 130, 220, 347, 519, 658, 1120, 1291, 1429, 1698, 1917, 2061, 2299, 2898, 3246]","[0, 130, 220, 310, 435, 572, 710, 845, 984, 1153, 1410, 1554, 1881, 2228, 3001]",6654,5633,6573,3246,3001,6,128,28,21,88,"[0, 210, 498, 769, 1689, 2115, 2516, 2881, 3248, 4048, 4499, 4879, 5242, 5975, 6568]","[0, 330, 612, 1022, 1424, 1833, 2479, 2916, 3369, 3873, 4587, 5005, 5671, 6209, 6695]","[0, 246, 443, 730, 1048, 1306, 1806, 2333, 2627, 3046, 3515, 4282, 4882, 5501, 6024]","[0, 210, 347, 437, 925, 1063, 1199, 1334, 1740, 2348, 2723, 2931, 3145, 3594, 3778]","[0, 210, 300, 438, 568, 658, 834, 924, 1110, 1469, 1694, 1902, 2287, 2629, 2813]",6568,6695,6024,3778,2813,86,-1062,549,-532,188,-771,15,radiant
7533366805,13,60,41,121,102,"[0, 170, 523, 765, 1473, 1869, 2229, 2850, 3390, 3733, 4272, 4603, 5133, 5647, 6440]","[0, 170, 494, 747, 1187, 1485, 1868, 2316, 2931, 3227, 4064, 4513, 5234, 5745, 6436]","[0, 251, 486, 738, 1062, 1361, 1566, 1813, 1991, 2155, 2411, 2716, 3363, 3835, 4386]","[0, 170, 260, 404, 611, 741, 849, 1024, 1202, 1292, 1382, 1472, 1794, 1949, 2278]","[0, 170, 260, 461, 591, 721, 811, 1151, 1371, 1554, 1912, 2017, 2331, 2425, 2617]",6440,6436,4386,2278,2617,48,106,23,79,40,"[0, 170, 614, 1026, 1306, 1796, 2208, 2655, 3025, 3316, 3733, 4335, 4931, 5798, 6987]","[0, 243, 532, 910, 1243, 1557, 1728, 2074, 2354, 2679, 3171, 3719, 4221, 4895, 5247]","[0, 330, 706, 1457, 1755, 2107, 2569, 2850, 3533, 4219, 5110, 5621, 6188, 6663, 7019]","[0, 170, 260, 417, 507, 677, 894, 1065, 1251, 1416, 1777, 1975, 2149, 2381, 3113]","[0, 170, 260, 400, 490, 627, 811, 967, 1344, 1513, 1908, 2106, 2364, 2623, 3058]",6987,5247,7019,3113,3058,-547,1189,-2633,-835,-441,-3267,15,dire
7533396906,48,98,74,96,26,"[165, 450, 931, 1187, 1758, 2261, 2800, 3413, 3797, 4278, 5206, 5768, 6337, 7060, 8482]","[165, 499, 776, 1080, 1307, 1730, 2175, 2670, 3105, 3809, 4489, 6041, 6614, 7168, 8263]","[699, 990, 1260, 1703, 2214, 2588, 3113, 4024, 4630, 4931, 5358, 5448, 5598, 5912, 6719]","[165, 374, 521, 809, 1011, 1288, 1737, 2081, 2600, 3088, 3377, 3709, 4322, 4520, 5049]","[165, 374, 464, 697, 787, 957, 1168, 1445, 1775, 1865, 2138, 2609, 2759, 2958, 3466]",8482,8263,6719,5049,3466,25,43,20,105,14,"[0, 203, 490, 919, 1259, 1551, 1844, 2207, 2524, 2733, 3310, 4370, 4810, 5243, 5918]","[0, 163, 517, 722, 1052, 1181, 1525, 1809, 2325, 2648, 2935, 3686, 4463, 4674, 5162]","[0, 242, 485, 966, 1224, 1569, 1814, 2146, 2429, 2847, 3735, 4306, 4919, 5288, 5521]","[0, 129, 219, 309, 458, 548, 742, 1016, 1150, 1240, 1701, 2080, 2308, 2671, 3075]","[0, 129, 502, 592, 682, 772, 1107, 1298, 1388, 1478, 1968, 2378, 2662, 2970, 3272]",5918,5162,5521,3075,3272,2564,3101,1198,1974,194,9031,15,radiant
7533433505,48,43,23,96,119,"[78, 372, 730, 1007, 1486, 1787, 2080, 2547, 2936, 3640, 4003, 4508, 5114, 5708, 5920]","[78, 372, 759, 1105, 1345, 1637, 1990, 2252, 2680, 3175, 3737, 4114, 4623, 5176, 5524]","[211, 450, 681, 1051, 1355, 1565, 2156, 2583, 3268, 3699, 4302, 5277, 5535, 6025, 6445]","[78, 248, 363, 453, 543, 673, 809, 994, 1238, 1645, 2247, 2617, 2707, 3162, 3390]","[78, 348, 463, 598, 704, 834, 942, 1129, 1606, 1900, 2156, 2423, 2513, 3046, 3735]",5920,5524,6445,3390,3735,25,21,129,26,136,"[308, 515, 760, 1030, 1281, 1657, 2126, 2413, 2967, 3428, 3730, 4242, 5189, 5820, 6953]","[308, 566, 763, 1331, 1624, 1943, 2394, 2941, 3150, 3675, 4226, 4536, 5104, 5696, 6469]","[116, 397, 557, 967, 1247, 1584, 2217, 2723, 3479, 3871, 4494, 5050, 5459, 5554, 5923]","[443, 613, 754, 1131, 1221, 1396, 1608, 1760, 1959, 2505, 2761, 2906, 3121, 3263, 3877]","[175, 345, 435, 525, 615, 705, 906, 1058, 1192, 1365, 1500, 1590, 1956, 2145, 2491]",6953,6469,5923,3877,2491,-1033,-945,522,-487,1244,-699,15,radiant
7533447006,19,11,2,22,84,"[0, 365, 817, 1219, 1712, 2127, 2680, 3087, 3653, 4107, 4616, 5671, 6098, 6900, 7760]","[0, 287, 648, 1364, 1944, 2506, 2864, 3132, 3481, 3681, 4032, 4694, 5061, 5568, 6544]","[0, 327, 732, 1214, 1625, 2220, 2399, 3048, 3691, 4460, 5029, 5879, 6401, 6946, 7514]","[0, 170, 260, 666, 756, 1106, 1563, 1805, 1967, 2610, 2951, 3533, 3623, 3862, 4421]","[0, 170, 260, 471, 634, 931, 1291, 1433, 1523, 1736, 2029, 2676, 3021, 3346, 3650]",7760,6544,7514,4421,3650,53,8,71,88,87,"[0, 288, 607, 977, 1381, 1678, 2096, 2471, 2895, 3618, 4077, 4576, 5621, 6293, 7101]","[0, 285, 639, 1053, 1501, 1957, 2516, 2958, 3500, 3812, 4159, 4933, 5538, 5863, 6482]","[0, 329, 614, 756, 1041, 1265, 1532, 1744, 2216, 2726, 3008, 3259, 3801, 4394, 4821]","[0, 170, 260, 350, 485, 738, 1172, 1311, 1401, 1624, 1833, 2084, 2466, 2615, 2799]","[0, 170, 309, 399, 536, 626, 939, 1029, 1199, 1289, 1408, 1498, 1588, 1737, 1921]",7101,6482,4821,2799,1921,659,62,2693,1622,1729,6765,15,radiant
7533451006,10,35,96,79,58,"[0, 257, 507, 948, 1368, 1718, 2163, 2646, 3235, 3736, 4237, 4834, 5581, 6278, 6974]","[0, 277, 593, 1084, 1456, 2116, 2682, 3056, 3603, 3979, 4449, 5050, 5490, 6048, 6752]","[0, 293, 558, 877, 1360, 1684, 2182, 2555, 2982, 3481, 4030, 4507, 5281, 5657, 6480]","[0, 170, 260, 350, 525, 662, 800, 934, 1204, 1464, 1860, 2169, 2507, 2973, 3500]","[0, 170, 260, 397, 540, 665, 801, 937, 1207, 1382, 1727, 1939, 2360, 2710, 3163]",6974,6752,6480,3500,3163,13,93,129,110,121,"[0, 222, 480, 732, 936, 1076, 1234, 1643, 1810, 2324, 2907, 3232, 3569, 3869, 4179]","[0, 170, 374, 536, 897, 1226, 1592, 1857, 2184, 2372, 2600, 3006, 3490, 4088, 4402]","[0, 170, 447, 605, 1022, 1219, 1521, 1790, 1986, 2165, 2481, 2906, 3123, 3319, 3449]","[0, 170, 260, 350, 543, 676, 824, 1049, 1192, 1436, 1911, 2055, 2236, 2404, 2498]","[0, 170, 352, 523, 704, 794, 1112, 1341, 1469, 1594, 1769, 1960, 2107, 2202, 2397]",4179,4402,3449,2498,2397,2795,2350,3031,1002,766,9944,15,radiant
7533473607,67,21,69,26,102,"[0, 280, 515, 716, 1058, 1417, 1839, 2242, 2657, 3105, 3624, 3877, 4422, 5216, 6374]","[0, 363, 716, 969, 1312, 1670, 2411, 2873, 3258, 4094, 4560, 5095, 5488, 6470, 7086]","[0, 317, 750, 912, 1282, 1486, 1830, 2113, 2581, 3093, 3354, 3852, 4553, 5505, 6435]","[0, 254, 430, 557, 693, 823, 1294, 1455, 1675, 2394, 2942, 3140, 3504, 4146, 4699]","[0, 247, 337, 427, 517, 647, 902, 992, 1128, 1353, 1922, 2203, 2762, 3325, 4037]",6374,7086,6435,4699,4037,138,53,64,74,105,"[0, 205, 626, 1003, 1421, 1696, 2421, 3032, 3403, 4195, 4847, 5217, 5773, 6330, 6988]","[0, 457, 838, 1263, 1597, 1888, 2299, 2505, 2768, 2982, 3257, 4071, 4194, 4617, 4851]","[0, 299, 560, 843, 1174, 1506, 1804, 2088, 2864, 2999, 3183, 3631, 3897, 4215, 4638]","[0, 189, 350, 485, 614, 965, 1135, 1327, 1538, 1999, 2134, 2982, 3072, 3752, 3846]","[0, 189, 279, 413, 549, 639, 729, 999, 1089, 1511, 1681, 2145, 2235, 2504, 2598]",6988,4851,4638,3846,2598,-614,2235,1797,853,1439,5710,15,radiant
7533473919,35,76,23,19,20,"[0, 354, 632, 1068, 1385, 1638, 2092, 2621, 2940, 3296, 3436, 4247, 4537, 4984, 5382]","[0, 350, 632, 810, 1265, 1589, 1811, 2033, 2410, 3169, 3633, 4158, 4596, 5021, 5471]","[0, 285, 522, 955, 1321, 1615, 1898, 2216, 2870, 3389, 3586, 4216, 4804, 5241, 5513]","[100, 509, 599, 689, 874, 1013, 1148, 1306, 1539, 1853, 2011, 2332, 3027, 3397, 3491]","[0, 276, 366, 500, 651, 824, 914, 1004, 1094, 1360, 1450, 1726, 2010, 2276, 2419]",5382,5471,5513,3491,2419,8,69,47,112,83,"[0, 723, 957, 1203, 1544, 1952, 2557, 2823, 3241, 3844, 4284, 4614, 5213, 5995, 6577]","[0, 381, 677, 1042, 1407, 1718, 2017, 2728, 3103, 3667, 4166, 4625, 5355, 6110, 6827]","[0, 423, 676, 1120, 1330, 1605, 1920, 2051, 2401, 2511, 3170, 3999, 4863, 5498, 5962]","[0, 270, 398, 533, 706, 796, 936, 1152, 1287, 1545, 1635, 1844, 2358, 2586, 2900]","[0, 198, 288, 378, 534, 677, 945, 1053, 1188, 1314, 1708, 1871, 2377, 2653, 2837]",6577,6827,5962,2900,2837,-1195,-1356,-449,591,-418,-2827,15,dire
7533480104,61,98,41,40,86,"[0, 321, 595, 954, 1238, 1497, 2018, 2735, 3518, 4062, 4813, 5788, 6725, 7884, 8811]","[0, 249, 525, 942, 1051, 1566, 1929, 2450, 3097, 3572, 4475, 4992, 5667, 6719, 7462]","[0, 375, 601, 1086, 1504, 2106, 2503, 3091, 3503, 3930, 4404, 4824, 5210, 5682, 6114]","[0, 210, 499, 699, 789, 951, 1117, 1207, 1745, 1968, 2268, 2733, 3039, 3685, 3932]","[0, 246, 594, 745, 888, 1090, 1265, 1479, 1794, 1957, 2182, 2653, 2921, 3187, 3657]",8811,7462,6114,3932,3657,18,17,21,31,121,"[0, 515, 754, 953, 1185, 1434, 1866, 2142, 2565, 3031, 3566, 4424, 5063, 5557, 5853]","[0, 251, 588, 965, 1366, 2010, 2350, 2512, 3254, 3501, 4051, 4525, 4735, 5160, 5899]","[0, 166, 407, 574, 829, 1112, 1679, 1890, 2198, 2619, 3073, 3405, 3824, 4174, 4555]","[0, 209, 299, 436, 526, 656, 878, 1012, 1194, 1365, 1502, 1927, 2135, 2316, 2458]","[0, 130, 220, 310, 418, 660, 916, 1054, 1393, 1492, 1678, 1925, 2015, 2281, 2376]",5853,5899,4555,2458,2376,2958,1563,1559,1474,1281,8835,15,radiant
7533525210,8,23,90,112,66,"[0, 250, 456, 616, 846, 1043, 1422, 1913, 2319, 2790, 3192, 3785, 4151, 4672, 4928]","[0, 203, 403, 748, 1076, 1450, 1613, 1877, 2334, 2781, 3193, 3283, 3572, 4295, 4720]","[0, 216, 388, 698, 989, 1360, 1709, 1889, 2317, 2491, 2982, 3162, 3506, 4110, 4525]","[0, 129, 219, 357, 477, 615, 705, 885, 975, 1065, 1229, 1407, 1727, 1970, 2358]","[0, 129, 219, 414, 573, 714, 924, 1285, 1446, 1612, 1833, 2098, 2654, 2850, 3123]",4928,4720,4525,2358,3123,21,59,60,111,20,"[0, 296, 665, 1047, 1525, 1868, 2246, 2811, 3249, 3960, 4867, 5128, 6172, 6639, 6931]","[0, 299, 651, 999, 1179, 1468, 2062, 2600, 2999, 3524, 4229, 4689, 4857, 5060, 5750]","[0, 245, 484, 823, 1035, 1335, 1678, 2174, 2614, 3250, 3882, 4308, 4960, 5299, 5734]","[0, 209, 632, 805, 895, 1029, 1190, 1486, 1625, 1853, 2115, 2205, 2610, 2961, 3393]","[0, 209, 351, 489, 579, 719, 809, 1158, 1248, 1576, 1832, 2035, 2474, 2768, 3073]",6931,5750,5734,3393,3073,-2003,-1030,-1209,-1035,50,-5227,15,dire
7533601912,53,61,23,112,5,"[0, 298, 561, 756, 1079, 1500, 1751, 2143, 2443, 2952, 3313, 4103, 4851, 5712, 6113]","[0, 209, 561, 974, 1262, 1559, 1881, 2522, 2950, 3218, 3635, 4757, 5624, 6207, 6965]","[0, 293, 599, 860, 1134, 1457, 2069, 2558, 3076, 3755, 4034, 4586, 5724, 6067, 6815]","[0, 209, 699, 856, 946, 1149, 1406, 1586, 1826, 2041, 2265, 2827, 3194, 3289, 3776]","[0, 209, 376, 466, 556, 651, 741, 921, 1124, 1429, 1794, 2046, 2418, 2513, 2669]",6113,6965,6815,3776,2669,41,49,76,91,83,"[0, 227, 508, 790, 1027, 1435, 1816, 2218, 2704, 3075, 3451, 3785, 4260, 5314, 5980]","[0, 271, 552, 918, 1415, 1791, 2229, 2826, 3275, 3689, 4077, 4361, 4820, 5201, 5646]","[0, 190, 400, 772, 951, 1372, 1648, 1878, 2338, 2665, 2870, 3144, 3394, 3838, 4089]","[0, 154, 244, 382, 533, 827, 1223, 1403, 1615, 1742, 2076, 2289, 2759, 3346, 3453]","[0, 154, 244, 334, 424, 561, 700, 880, 1166, 1256, 1391, 1623, 1713, 2160, 2298]",5980,5646,4089,3453,2298,133,1319,2726,323,371,4872,15,radiant
7533788004,41,126,40,92,86,"[0, 245, 444, 993, 1415, 2011, 2613, 3200, 3594, 4131, 4555, 5013, 5742, 6011, 6590]","[0, 320, 532, 900, 1267, 1516, 1835, 2354, 3027, 3628, 3938, 4470, 5197, 5491, 6206]","[0, 170, 260, 473, 652, 873, 1210, 1435, 1864, 2189, 2510, 2757, 3190, 3437, 3864]","[0, 204, 539, 706, 1204, 1378, 1672, 1897, 2059, 2410, 2935, 3025, 3387, 3482, 3922]","[0, 170, 299, 389, 635, 725, 815, 1268, 2065, 2721, 2856, 3118, 3298, 3593, 4136]",6590,6206,3864,3922,4136,93,53,34,23,27,"[0, 325, 522, 964, 1344, 1743, 2268, 2892, 3264, 3552, 3930, 4694, 5457, 6312, 6869]","[0, 170, 303, 774, 1097, 1481, 1646, 1997, 2169, 2391, 2571, 2794, 3233, 3800, 4441]","[0, 325, 587, 879, 1210, 1748, 2080, 2486, 2576, 2750, 3138, 3397, 3821, 4413, 4627]","[0, 279, 514, 719, 878, 1195, 1285, 1697, 1986, 2239, 2646, 2957, 3234, 3967, 4647]","[0, 170, 260, 418, 641, 882, 1047, 1396, 1486, 1621, 1756, 1986, 2392, 3055, 3149]",6869,4441,4627,4647,3149,-279,1765,-763,-725,987,985,15,dire
7534160206,4,96,74,85,112,"[0, 205, 506, 785, 1067, 1434, 1766, 1961, 2417, 2980, 3559, 4243, 5271, 5983, 6308]","[0, 169, 487, 890, 1354, 1517, 1771, 2102, 2513, 2688, 3224, 3529, 4030, 4555, 5280]","[0, 220, 471, 725, 1065, 1523, 1896, 2022, 2444, 3028, 3369, 3778, 4742, 5019, 5725]","[0, 270, 360, 495, 585, 743, 878, 1341, 1477, 1789, 2044, 2227, 2804, 3377, 3847]","[0, 169, 259, 349, 439, 529, 668, 810, 947, 1072, 1448, 1582, 1762, 2120, 2295]",6308,5280,5725,3847,2295,1,17,21,20,19,"[0, 289, 495, 685, 1075, 1495, 2035, 2457, 2748, 2959, 3308, 3540, 3946, 4505, 5097]","[0, 329, 644, 896, 1290, 1572, 2042, 3130, 3686, 3776, 4257, 4595, 5082, 5338, 5700]","[0, 292, 542, 991, 1357, 1569, 1929, 2139, 2729, 3108, 3531, 3898, 4224, 4371, 4705]","[0, 169, 302, 733, 1075, 1165, 1427, 1813, 1948, 2077, 2724, 2814, 3179, 3274, 3501]","[0, 169, 294, 384, 637, 771, 995, 1130, 1300, 1390, 1627, 1717, 1872, 2006, 2770]",5097,5700,4705,3501,2770,1211,-420,1020,346,-475,1682,15,radiant
7534334312,70,39,97,51,5,"[0, 286, 536, 744, 1400, 2153, 2402, 3083, 3458, 3968, 4430, 5065, 5540, 6090, 7470]","[0, 361, 648, 991, 1448, 1725, 2213, 2935, 3270, 3509, 4025, 4343, 4663, 5236, 6154]","[0, 291, 574, 807, 1152, 1392, 1482, 1823, 2193, 2732, 2950, 3410, 3979, 4385, 4948]","[0, 210, 300, 602, 772, 862, 952, 1303, 1443, 1697, 2021, 2111, 2255, 2404, 3061]","[0, 210, 300, 390, 701, 887, 1016, 1230, 1370, 1731, 1867, 2077, 2221, 2411, 2796]",7470,6154,4948,3061,2796,10,137,92,110,65,"[0, 174, 504, 817, 1273, 1554, 2084, 2578, 3034, 3650, 4286, 4695, 5347, 5904, 6706]","[0, 293, 589, 883, 1047, 1386, 1756, 2558, 2848, 3215, 3420, 3830, 4535, 5206, 5653]","[0, 504, 832, 1153, 1534, 1770, 1980, 2260, 2667, 2757, 3103, 3547, 4213, 4732, 5095]","[0, 230, 366, 456, 635, 760, 850, 1420, 1544, 1722, 1879, 2049, 2298, 2494, 2729]","[0, 200, 290, 380, 704, 829, 1091, 1410, 1579, 1835, 2313, 2648, 2847, 3545, 3992]",6706,5653,5095,2729,3992,764,501,-147,332,-1196,254,15,radiant
7534419016,10,14,98,31,121,"[0, 170, 520, 863, 1224, 1392, 1861, 2261, 2616, 3085, 3781, 4431, 4897, 5644, 6512]","[0, 551, 925, 1351, 1913, 2121, 2443, 2986, 3434, 3897, 4717, 5500, 5808, 6258, 6761]","[0, 318, 649, 1135, 1423, 1850, 2106, 2553, 3266, 3433, 4277, 4796, 5435, 5881, 6314]","[0, 246, 387, 497, 700, 1023, 1113, 1203, 1328, 1508, 1817, 2084, 2879, 3098, 3689]","[0, 170, 260, 394, 567, 657, 894, 984, 1340, 1464, 1994, 2434, 2636, 2993, 3389]",6512,6761,6314,3689,3389,13,56,77,112,19,"[0, 278, 585, 914, 1081, 1382, 2050, 2576, 3553, 4230, 4540, 5133, 5223, 5852, 6222]","[0, 205, 450, 731, 937, 1520, 1727, 2524, 2884, 3226, 3633, 4057, 4682, 5056, 5435]","[0, 246, 411, 696, 1085, 1610, 1846, 2426, 2717, 3061, 3232, 3765, 4050, 4626, 4937]","[0, 170, 260, 350, 535, 674, 876, 1193, 1494, 1761, 1906, 2191, 2327, 2575, 2971]","[0, 254, 380, 517, 612, 1027, 1158, 1551, 1829, 1999, 2180, 2389, 2479, 2574, 2899]",6222,5435,4937,2971,2899,290,1326,1377,718,490,4201,15,radiant
7535023015,82,13,69,53,26,"[0, 295, 491, 770, 1181, 1437, 1685, 2093, 2571, 3153, 3821, 4110, 4441, 5008, 5691]","[0, 369, 656, 1039, 1443, 1927, 2367, 2870, 3538, 3833, 4541, 4823, 5343, 6183, 6834]","[0, 369, 691, 856, 1352, 1937, 2536, 3348, 3686, 4128, 4656, 5184, 5683, 6260, 6782]","[0, 209, 299, 389, 528, 739, 935, 1137, 1248, 1357, 1686, 1886, 2317, 2891, 3176]","[0, 209, 314, 404, 575, 749, 908, 1268, 1358, 1448, 1803, 1991, 2745, 3590, 3794]",5691,6834,6782,3176,3794,10,96,23,86,83,"[0, 89, 367, 655, 1028, 1226, 1467, 1656, 2383, 2746, 3052, 3642, 4192, 4852, 5158]","[0, 165, 504, 831, 1473, 1853, 2186, 2733, 3288, 3771, 4417, 4760, 5537, 6212, 6598]","[0, 280, 720, 944, 1490, 1850, 2393, 2823, 3471, 3889, 4290, 4792, 5260, 5889, 6661]","[0, 89, 179, 289, 493, 633, 723, 849, 939, 1226, 1716, 1992, 2271, 2719, 2943]","[0, 89, 179, 331, 481, 635, 725, 894, 1110, 1520, 1837, 1962, 2285, 2488, 2712]",5158,6598,6661,2943,2712,533,236,121,233,1082,2205,15,radiant
7535030019,53,106,61,123,100,"[0, 253, 533, 976, 1162, 1382, 1666, 2111, 2596, 3101, 3841, 4382, 5048, 5561, 6230]","[0, 245, 539, 992, 1368, 1771, 2046, 2554, 2991, 3332, 4314, 4829, 5171, 5680, 6133]","[0, 204, 364, 591, 1045, 1367, 1649, 1868, 2296, 2920, 3943, 4770, 5281, 6026, 6373]","[0, 170, 304, 394, 573, 703, 793, 996, 1216, 1306, 1646, 2147, 2333, 2542, 2689]","[0, 170, 260, 610, 735, 990, 1096, 1299, 1517, 1607, 2014, 2391, 2571, 3056, 3165]",6230,6133,6373,2689,3165,41,69,74,128,65,"[0, 208, 745, 1070, 1198, 1605, 1959, 2328, 2772, 2996, 3238, 3510, 3783, 4251, 4802]","[0, 214, 459, 795, 1153, 1613, 1897, 2445, 3141, 3470, 3987, 4408, 4943, 5299, 6095]","[0, 242, 450, 694, 1073, 1455, 1817, 2215, 2504, 2749, 2971, 3189, 3633, 4030, 4348]","[0, 170, 297, 454, 588, 1001, 1091, 1301, 1503, 1593, 1813, 2177, 2366, 2562, 3063]","[0, 170, 336, 442, 558, 769, 859, 1226, 1381, 1537, 1766, 2024, 2293, 2489, 2948]",4802,6095,4348,3063,2948,1428,38,2025,-374,217,3334,15,dire
7535110205,70,49,96,128,65,"[0, 352, 653, 1104, 1484, 1969, 2177, 2566, 3024, 3495, 4070, 4606, 5256, 5860, 6391]","[0, 271, 633, 884, 1294, 1623, 1867, 2584, 3177, 3519, 3836, 4431, 5065, 5634, 5922]","[0, 234, 506, 706, 1071, 1391, 2210, 2387, 3049, 3543, 4189, 4479, 4699, 5073, 5563]","[0, 195, 378, 564, 738, 951, 1236, 1407, 1667, 2127, 2262, 2396, 2873, 3177, 3472]","[0, 195, 285, 658, 794, 1069, 1237, 1373, 1553, 1992, 2265, 2529, 2923, 3310, 3405]",6391,5922,5563,3472,3405,25,29,23,100,20,"[0, 213, 475, 710, 954, 1298, 1465, 2045, 2173, 2362, 3211, 3909, 4480, 5717, 6480]","[0, 330, 610, 971, 1260, 1620, 1851, 2491, 3143, 3663, 4004, 4450, 4626, 5481, 5965]","[0, 206, 440, 767, 1013, 1354, 1559, 1775, 2198, 2724, 3399, 3922, 4805, 5149, 5807]","[0, 170, 260, 393, 483, 818, 908, 1136, 1226, 1539, 2040, 2278, 2635, 3087, 3365]","[0, 170, 260, 441, 531, 699, 789, 1016, 1325, 1509, 1683, 1872, 2200, 2652, 2930]",6480,5965,5807,3365,2930,-89,-43,-244,107,475,206,15,dire
7535205409,60,17,123,20,19,"[0, 206, 524, 854, 1215, 1700, 2218, 2915, 3455, 3878, 4348, 5004, 5680, 6224, 6872]","[0, 316, 687, 1020, 1344, 1512, 2086, 2486, 2833, 3629, 4174, 4806, 5149, 5614, 5903]","[0, 246, 502, 898, 988, 1394, 1706, 2085, 2729, 2819, 3197, 3646, 4267, 4682, 4814]","[0, 169, 259, 756, 976, 1268, 1412, 1737, 2047, 2276, 2482, 2647, 3078, 3281, 3376]","[0, 169, 259, 396, 486, 624, 759, 985, 1194, 1421, 1627, 1901, 2512, 2837, 2932]",6872,5903,4814,3376,2932,46,21,78,100,121,"[0, 241, 511, 842, 1260, 1956, 2247, 2663, 3225, 3488, 4241, 5286, 6328, 6772, 7763]","[0, 250, 567, 733, 995, 1453, 1864, 2211, 2675, 3310, 3823, 4432, 4522, 4873, 5477]","[0, 291, 566, 841, 1078, 1504, 1955, 2097, 2404, 2692, 3246, 3611, 3776, 4396, 5249]","[0, 169, 259, 349, 439, 797, 931, 1021, 1111, 1376, 1595, 1868, 2200, 2607, 3000]","[0, 169, 259, 397, 487, 808, 979, 1140, 1230, 1404, 1494, 1858, 2251, 2525, 2914]",7763,5477,5249,3000,2914,-891,426,-435,376,18,-506,15,dire
7535209904,25,22,23,112,83,"[0, 387, 722, 1300, 1584, 2167, 2968, 3270, 3641, 3930, 4208, 4724, 5657, 6228, 6634]","[0, 281, 608, 952, 1194, 1524, 2025, 2354, 2495, 2806, 3236, 3652, 4065, 5215, 5680]","[0, 265, 546, 845, 1148, 1521, 1821, 2195, 2614, 3094, 3692, 4241, 5114, 5618, 6035]","[0, 265, 355, 445, 535, 714, 889, 979, 1231, 1577, 1759, 2223, 2812, 3503, 3866]","[0, 499, 603, 805, 895, 1069, 1591, 1730, 1925, 2056, 2146, 2282, 2372, 3018, 3149]",6634,5680,6035,3866,3149,46,14,98,121,3,"[0, 324, 702, 1063, 1513, 1793, 2471, 3000, 3547, 4307, 5279, 6076, 6729, 6986, 7437]","[0, 204, 481, 716, 1116, 1253, 1569, 2118, 2504, 3150, 3688, 4139, 4806, 5336, 5917]","[0, 279, 656, 922, 1414, 1713, 2077, 2250, 2537, 2816, 3107, 3742, 4067, 4680, 5398]","[0, 169, 259, 349, 439, 529, 723, 958, 1097, 1395, 2100, 2394, 2624, 2791, 3016]","[0, 169, 259, 349, 751, 868, 1318, 1536, 1626, 1828, 2044, 2185, 2473, 2640, 3118]",7437,5917,5398,3016,3118,-803,-237,637,850,31,478,15,dire
7535324203,89,13,80,5,100,"[0, 244, 480, 779, 1115, 1413, 2100, 2528, 2694, 3254, 3678, 4402, 5030, 5804, 6334]","[0, 283, 600, 952, 1351, 1735, 1977, 2359, 2651, 3146, 4042, 4456, 4842, 5750, 6183]","[0, 362, 532, 1082, 1488, 1836, 2436, 2830, 3377, 3808, 4096, 4322, 4845, 5845, 6547]","[0, 254, 344, 434, 797, 932, 1137, 1498, 1698, 1915, 2315, 2459, 2634, 2873, 2996]","[0, 210, 339, 497, 635, 725, 1125, 1310, 1475, 1692, 1896, 2040, 2215, 2643, 2738]",6334,6183,6547,2996,2738,56,28,60,26,64,"[58, 282, 538, 891, 1223, 1491, 1654, 2317, 2855, 3265, 3773, 4816, 5352, 6134, 6631]","[58, 265, 589, 879, 1210, 1701, 2319, 3000, 3782, 4077, 4375, 5156, 5453, 5913, 6245]","[326, 783, 1023, 1260, 1476, 1809, 2201, 2695, 3304, 3813, 4123, 4686, 4978, 5368, 5662]","[58, 217, 311, 440, 570, 757, 847, 1138, 1645, 1793, 1928, 2225, 2411, 2650, 2870]","[58, 213, 303, 393, 570, 660, 750, 979, 1168, 1307, 1489, 1965, 2494, 2817, 2912]",6631,6245,5662,2870,2912,-297,-62,885,126,-174,478,15,dire
7535326407,1,113,102,105,20,"[0, 249, 571, 1046, 1691, 2008, 2461, 2940, 3354, 3744, 4576, 5021, 5573, 6159, 6405]","[0, 373, 672, 1085, 1640, 2108, 2756, 3464, 4053, 4492, 4907, 5110, 5660, 6221, 6866]","[0, 255, 453, 808, 1047, 1469, 1767, 2181, 2392, 2872, 3339, 3929, 4359, 4876, 5667]","[0, 169, 259, 349, 479, 650, 740, 1042, 1623, 1802, 2076, 2166, 2346, 2572, 2818]","[0, 169, 259, 349, 858, 1006, 1214, 1551, 1845, 2112, 2386, 2476, 2986, 3135, 3535]",6405,6866,5667,2818,3535,10,78,71,110,26,"[0, 169, 408, 546, 1057, 1345, 1915, 2351, 2814, 3200, 3631, 4257, 4672, 5170, 5765]","[0, 254, 605, 919, 1481, 1869, 2557, 3006, 3249, 3570, 3953, 4587, 4981, 5432, 6087]","[0, 252, 526, 893, 1292, 1577, 1801, 1891, 2302, 3140, 3308, 3649, 4031, 4685, 5145]","[0, 169, 259, 349, 487, 577, 762, 898, 1097, 1418, 1563, 1800, 1983, 2272, 2896]","[0, 169, 259, 394, 666, 836, 1013, 1147, 1282, 1544, 1634, 1871, 2054, 2508, 2930]",5765,6087,5145,2896,2930,640,779,522,-78,605,2468,15,radiant
7535558607,1,120,50,7,100,"[533, 738, 1216, 1610, 1948, 2425, 2829, 3172, 3668, 4235, 4732, 5369, 6021, 6736, 7271]","[338, 662, 1112, 1483, 1828, 2267, 2445, 2732, 3239, 3718, 4479, 4887, 5309, 5514, 5819]","[348, 606, 807, 1225, 1590, 1952, 2431, 2692, 3099, 3545, 4035, 4212, 4698, 5324, 5851]","[169, 304, 394, 621, 711, 801, 936, 1074, 1214, 1393, 1483, 1845, 2149, 2329, 3055]","[231, 321, 459, 638, 728, 866, 1058, 1325, 1415, 1550, 1719, 1989, 2144, 2288, 2774]",7271,5819,5851,3055,2774,21,15,106,65,19,"[203, 600, 897, 1113, 1433, 1750, 2018, 2342, 2801, 3130, 3642, 4254, 4738, 5278, 5476]","[276, 646, 855, 1085, 1397, 1644, 2023, 2588, 2884, 3585, 4055, 4430, 4958, 5362, 5726]","[458, 825, 1195, 1609, 2103, 2340, 2746, 3105, 3445, 3927, 4526, 4996, 5681, 6320, 6626]","[239, 329, 419, 509, 674, 811, 1043, 1133, 1409, 1544, 2002, 2195, 2622, 2953, 3047]","[275, 365, 455, 545, 710, 800, 890, 980, 1161, 1498, 1693, 1783, 2018, 2245, 2339]",5476,5726,6626,3047,2339,1795,93,-775,8,435,1556,15,radiant
7535614616,6,49,29,100,31,"[0, 663, 1026, 1573, 1844, 2405, 2615, 2967, 3392, 3544, 4025, 4420, 4896, 5348, 5733]","[0, 315, 789, 1123, 1558, 1933, 2417, 2870, 3410, 4167, 4685, 5092, 5439, 5825, 6288]","[0, 235, 452, 742, 914, 1285, 1733, 1913, 2682, 3051, 3452, 3889, 4601, 5189, 5513]","[0, 235, 390, 579, 699, 950, 1074, 1254, 1567, 2095, 2376, 2529, 3083, 3658, 4088]","[0, 235, 325, 431, 551, 641, 814, 994, 1275, 1500, 1963, 2053, 2316, 2702, 3011]",5733,6288,5513,4088,3011,113,63,22,2,102,"[0, 326, 526, 817, 1382, 1582, 2099, 2472, 2800, 3427, 4198, 4558, 5439, 5805, 6697]","[0, 170, 382, 607, 842, 1754, 2063, 2153, 2288, 2690, 3100, 3290, 3435, 3584, 3872]","[0, 284, 576, 913, 1252, 1705, 2024, 2598, 3082, 3566, 3964, 4268, 4549, 4734, 5113]","[0, 207, 297, 461, 733, 1065, 1569, 1897, 2426, 2754, 3172, 3495, 3822, 4058, 4380]","[0, 170, 260, 350, 567, 657, 841, 1064, 1199, 1470, 1832, 1922, 2058, 2395, 2590]",6697,3872,5113,4380,2590,-964,2416,400,-292,421,1981,15,dire
7535638906,49,80,55,5,83,"[0, 335, 639, 1028, 1413, 1681, 2156, 3210, 3660, 4268, 4759, 5816, 6165, 6859, 7604]","[0, 243, 530, 945, 1360, 1603, 1971, 2542, 2817, 3233, 3559, 3966, 4347, 5122, 5376]","[0, 221, 385, 620, 1097, 1340, 1718, 2079, 2411, 2851, 3218, 3775, 4360, 5098, 5829]","[100, 270, 452, 576, 815, 952, 1090, 1348, 1521, 1843, 2229, 2551, 2902, 3348, 3723]","[0, 270, 360, 450, 630, 720, 863, 1043, 1133, 1591, 1990, 2226, 2394, 2689, 3007]",7604,5376,5829,3723,3007,95,39,112,138,26,"[0, 329, 692, 1023, 1307, 1717, 2053, 2568, 2906, 3300, 3652, 4172, 4728, 5124, 5798]","[0, 279, 514, 710, 1119, 1282, 1468, 1558, 2016, 2603, 3193, 3804, 4149, 4648, 4919]","[0, 204, 497, 709, 833, 1000, 1174, 1664, 2073, 2687, 2859, 3203, 3732, 3827, 4170]","[0, 170, 260, 455, 591, 726, 930, 1114, 1222, 1466, 1693, 1989, 2226, 2321, 2416]","[0, 170, 260, 399, 652, 775, 958, 1088, 1178, 1358, 1604, 1748, 2037, 2178, 2497]",5798,4919,4170,2416,2497,1806,457,1659,1307,510,5739,15,radiant
7535724706,70,86,97,138,110,"[249, 522, 882, 1171, 1572, 1808, 2212, 2302, 2648, 3090, 3408, 3791, 4439, 5386, 6057]","[328, 573, 896, 1295, 1753, 2162, 2500, 2926, 3220, 3710, 4358, 4538, 4803, 5328, 5866]","[169, 440, 696, 1195, 1670, 2162, 2762, 3369, 3929, 4480, 5108, 5698, 6562, 7040, 7777]","[169, 302, 392, 575, 768, 1111, 1436, 1657, 1747, 1972, 2126, 2306, 2510, 2687, 3008]","[169, 259, 431, 521, 747, 1034, 1460, 1550, 1680, 1952, 2270, 2678, 3034, 3153, 3533]",6057,5866,7777,3008,3533,113,56,98,105,100,"[296, 586, 955, 1321, 1720, 2019, 2280, 2605, 3019, 3222, 4025, 4827, 5258, 5632, 5917]","[169, 373, 623, 914, 1337, 1523, 1973, 2377, 2664, 3032, 3577, 4500, 4997, 5588, 5953]","[207, 495, 779, 1049, 1249, 1661, 1857, 2487, 2629, 2998, 3707, 4359, 5070, 5294, 6082]","[169, 259, 431, 591, 681, 771, 906, 1317, 1568, 1834, 2077, 2626, 2874, 3047, 3180]","[169, 259, 394, 591, 681, 832, 967, 1158, 1417, 1507, 1697, 2173, 2345, 2440, 2535]",5917,5953,6082,3180,2535,140,-87,1695,-172,998,2574,15,radiant
7535725505,41,82,49,58,26,"[0, 239, 487, 929, 1099, 1430, 1597, 2203, 2564, 2776, 3038, 3459, 4103, 4867, 5376]","[0, 273, 434, 731, 1013, 1402, 1617, 2057, 2442, 2723, 3603, 3787, 4701, 5214, 6059]","[0, 130, 398, 670, 891, 1292, 1937, 2310, 2517, 2971, 3413, 3659, 3964, 4503, 5034]","[0, 130, 220, 350, 486, 610, 735, 1041, 1453, 1543, 1823, 1913, 2214, 2345, 2560]","[0, 130, 220, 350, 547, 686, 939, 1119, 1334, 1424, 1700, 1790, 2361, 2672, 2998]",5376,6059,5034,2560,2998,53,98,113,96,9,"[100, 604, 694, 1010, 1347, 1652, 1829, 2031, 2348, 2809, 3495, 4050, 4791, 5117, 5542]","[0, 218, 501, 897, 1263, 1679, 2197, 2684, 3102, 3657, 4352, 4889, 5322, 5834, 6253]","[0, 310, 607, 903, 1385, 1541, 1791, 2297, 3129, 3505, 4058, 4725, 5592, 5914, 6450]","[0, 204, 420, 836, 983, 1704, 2149, 2606, 3096, 3313, 4074, 4578, 4885, 5217, 5787]","[0, 170, 260, 380, 527, 815, 905, 1100, 1754, 2096, 2380, 2976, 3400, 3653, 3848]",5542,6253,6450,5787,3848,-166,-194,-1416,-3227,-850,-5853,15,dire
7535755508,6,59,96,5,58,"[0, 290, 782, 1063, 1455, 1865, 2420, 2852, 3283, 3636, 3897, 4240, 4665, 5086, 5745]","[0, 283, 598, 968, 1270, 1588, 2098, 2276, 2577, 3055, 3631, 4252, 4807, 5800, 6300]","[0, 321, 677, 806, 1204, 1713, 2045, 2290, 2579, 2873, 3249, 3592, 4012, 4366, 4608]","[0, 169, 520, 651, 741, 871, 1412, 1502, 1592, 1729, 2025, 2303, 2593, 2742, 3004]","[0, 169, 341, 478, 623, 770, 1424, 1528, 1674, 1817, 2012, 2244, 2943, 3276, 3539]",5745,6300,4608,3004,3539,10,106,86,97,119,"[0, 204, 446, 621, 1035, 1280, 1577, 2083, 2476, 2769, 3259, 3842, 4360, 5066, 5947]","[0, 243, 495, 672, 796, 1450, 1575, 1789, 2279, 2536, 2912, 3297, 3552, 4052, 4553]","[0, 344, 632, 786, 924, 1446, 1634, 1769, 2001, 2180, 2621, 2928, 3422, 3625, 4208]","[0, 509, 758, 1040, 1375, 1615, 1744, 2122, 2301, 2775, 3576, 3922, 4302, 4630, 5111]","[0, 169, 323, 413, 570, 962, 1299, 1468, 1558, 1740, 2099, 2258, 2716, 3026, 3200]",5947,4553,4208,5111,3200,-202,1747,400,-2107,339,177,15,radiant
7535757511,95,2,19,14,31,"[0, 208, 495, 804, 1278, 1603, 1764, 2027, 2884, 3301, 3738, 3908, 4375, 4860, 5159]","[0, 281, 615, 911, 1250, 1525, 1888, 2023, 2458, 2862, 3395, 3519, 3812, 4500, 5138]","[0, 398, 647, 958, 1408, 1809, 2370, 2701, 3297, 3978, 4579, 4849, 5038, 5553, 6291]","[0, 242, 332, 504, 803, 933, 1098, 1327, 1526, 1752, 2016, 2243, 2636, 2926, 3671]","[100, 475, 803, 931, 1061, 1191, 1552, 2011, 2146, 2326, 2634, 2724, 2814, 3058, 3569]",5159,5138,6291,3671,3569,10,63,96,114,20,"[0, 296, 872, 1131, 1526, 1966, 2344, 2905, 3406, 3860, 4243, 4834, 5362, 5889, 6626]","[0, 296, 466, 648, 774, 864, 1066, 1205, 1295, 1385, 1759, 2245, 2384, 2741, 3129]","[0, 368, 606, 1013, 1190, 1476, 1871, 2508, 2764, 3213, 3565, 3968, 4381, 4957, 5750]","[0, 762, 1016, 1320, 1668, 2127, 2534, 2997, 3365, 3613, 3978, 4297, 4827, 5378, 5824]","[0, 429, 588, 796, 886, 1025, 1203, 1337, 1461, 1599, 1792, 2284, 2421, 2653, 2986]",6626,3129,5750,5824,2986,-1467,2009,541,-2153,583,-487,15,dire
7535897712,89,106,96,72,58,"[0, 279, 841, 1052, 1312, 1646, 2149, 2637, 3050, 3779, 4523, 5288, 5748, 6629, 7473]","[0, 331, 697, 1065, 1426, 1798, 2358, 2448, 2944, 3388, 4177, 4658, 5192, 5935, 6604]","[0, 337, 567, 815, 1135, 1512, 1941, 2286, 3010, 3830, 4592, 5059, 5500, 5778, 6098]","[0, 170, 260, 476, 660, 886, 1176, 1266, 1487, 1863, 2088, 2222, 2366, 3058, 3288]","[0, 170, 337, 482, 572, 822, 957, 1091, 1502, 2006, 2266, 2487, 2670, 3183, 3439]",7473,6604,6098,3288,3439,70,69,23,65,20,"[0, 295, 562, 766, 1049, 1259, 1516, 1779, 1987, 2150, 2489, 2910, 3487, 4042, 4632]","[4, 282, 588, 844, 1333, 1748, 2014, 2622, 3033, 3500, 4192, 4526, 5352, 5751, 6314]","[0, 296, 570, 1026, 1187, 1571, 1781, 2244, 2665, 2814, 3431, 3776, 4221, 4713, 6045]","[2, 172, 287, 377, 514, 604, 694, 874, 1133, 1271, 1571, 1779, 2094, 2694, 3429]","[0, 170, 333, 423, 557, 862, 952, 1132, 1305, 1565, 1736, 1826, 1962, 2279, 2649]",4632,6314,6045,3429,2649,2841,290,53,-141,790,3833,15,radiant
7535992313,95,21,98,75,83,"[64, 442, 605, 1007, 1329, 1670, 2058, 2265, 2676, 3056, 3603, 4195, 4616, 4764, 5595]","[332, 999, 1209, 1571, 1866, 2280, 2612, 3366, 3591, 3860, 4462, 4872, 5621, 6060, 6844]","[64, 315, 586, 818, 1286, 1831, 2136, 2731, 3058, 3708, 4300, 4954, 5342, 5526, 6474]","[64, 315, 423, 513, 712, 818, 1830, 2003, 2140, 2522, 2857, 3229, 3468, 3663, 3917]","[64, 315, 405, 495, 702, 1373, 1508, 1643, 1861, 2281, 2582, 2945, 3184, 3332, 3693]",5595,6844,6474,3917,3693,41,59,96,111,20,"[0, 204, 449, 611, 739, 926, 1332, 1725, 1984, 2397, 2663, 3102, 3472, 4563, 4852]","[0, 278, 489, 750, 1040, 1204, 1543, 1813, 2215, 2536, 2839, 3263, 3896, 4815, 5140]","[0, 254, 582, 1161, 1471, 1644, 2091, 2965, 3306, 3561, 3964, 4345, 4792, 5337, 5540]","[0, 170, 356, 446, 536, 626, 1121, 1325, 1462, 1607, 1966, 2197, 2373, 2919, 3363]","[0, 387, 477, 699, 835, 925, 1182, 1452, 1673, 1808, 2140, 2230, 2320, 2684, 2779]",4852,5140,5540,3363,2779,743,1704,934,554,914,4849,15,radiant
7535996813,21,80,137,105,26,"[298, 574, 831, 1314, 1694, 2216, 2520, 3312, 3763, 4427, 5185, 5451, 5931, 6479, 7079]","[334, 582, 856, 1259, 1662, 1786, 2318, 2889, 3387, 4157, 4918, 5520, 6142, 6589, 7159]","[371, 660, 997, 1337, 1862, 2025, 2151, 2616, 3028, 3545, 4252, 4815, 5322, 5727, 6090]","[210, 300, 390, 520, 694, 784, 874, 1224, 1362, 1923, 2454, 2563, 3056, 3405, 3744]","[210, 382, 472, 648, 738, 1160, 1524, 1707, 1846, 2150, 2593, 2813, 3301, 3487, 3665]",7079,7159,6090,3744,3665,41,19,38,53,20,"[511, 760, 1403, 1711, 2167, 2746, 3005, 3445, 3699, 3965, 4368, 4732, 5206, 5539, 5997]","[204, 506, 932, 1310, 1653, 2101, 2458, 2871, 3172, 3564, 3906, 4473, 5070, 5410, 6168]","[204, 480, 693, 941, 1071, 1161, 1587, 1847, 2096, 2977, 3617, 3996, 4443, 5347, 6094]","[204, 332, 503, 638, 1041, 1292, 1500, 1873, 2002, 2226, 2417, 2723, 3032, 3455, 3932]","[204, 346, 605, 780, 1148, 1384, 1592, 1806, 1896, 2075, 2436, 2628, 2826, 3090, 3762]",5997,6168,6094,3932,3762,1082,991,-4,-188,-97,1784,15,dire
7536248504,102,96,25,105,83,"[242, 614, 993, 1377, 1833, 2158, 2436, 2872, 3279, 3697, 4092, 4515, 4972, 5317, 5871]","[203, 427, 656, 980, 1227, 1561, 1827, 2199, 2605, 2876, 3172, 3719, 4016, 4317, 4772]","[129, 302, 648, 1064, 1426, 1725, 1986, 2182, 2326, 2699, 2807, 3070, 3362, 3635, 4082]","[129, 219, 325, 464, 679, 769, 859, 1030, 1120, 1310, 1400, 1572, 1818, 1913, 2192]","[129, 219, 400, 604, 782, 1017, 1141, 1280, 1370, 1480, 1570, 1852, 1947, 2042, 2184]",5871,4772,4082,2192,2184,41,17,97,72,58,"[370, 689, 1105, 1347, 1743, 2286, 2682, 3112, 3622, 4252, 4703, 5564, 6080, 7173, 7884]","[280, 610, 1014, 1293, 1583, 1988, 2301, 2964, 3629, 4209, 4741, 5277, 5805, 6485, 7039]","[281, 554, 758, 1132, 1412, 1650, 2320, 2525, 3008, 3734, 4068, 5041, 5805, 6494, 7002]","[248, 425, 566, 656, 835, 1300, 1471, 1905, 2308, 2488, 3303, 3651, 3800, 4331, 4425]","[209, 337, 450, 540, 1044, 1369, 1459, 1742, 2096, 2575, 3076, 3406, 3555, 3913, 4245]",7884,7039,7002,4425,4245,-2013,-2267,-2920,-2233,-2061,-11494,15,dire
7536321303,95,13,97,72,110,"[209, 601, 885, 1370, 1826, 2238, 3026, 3853, 4251, 4971, 5351, 6050, 7098, 7918, 8527]","[246, 484, 725, 1389, 1823, 2391, 2798, 3234, 3739, 4212, 4522, 5399, 6325, 6878, 7769]","[244, 508, 836, 1196, 1682, 2007, 2420, 2937, 3241, 3590, 4146, 5024, 6020, 6665, 7655]","[208, 336, 511, 694, 899, 1115, 1355, 1740, 2060, 2322, 2444, 2735, 3499, 3718, 4339]","[170, 260, 405, 578, 757, 847, 1084, 1422, 1671, 1830, 1988, 2279, 2747, 3017, 3375]",8527,7769,7655,4339,3375,10,19,129,66,86,"[285, 652, 869, 1043, 1373, 1911, 2189, 2611, 3125, 3701, 4349, 4900, 5449, 5846, 6423]","[243, 543, 831, 1095, 1462, 1723, 2030, 2353, 2687, 3054, 3474, 3928, 4174, 4449, 4544]","[170, 496, 750, 986, 1366, 1456, 1712, 1920, 2059, 2313, 2742, 3216, 3872, 4102, 4197]","[206, 296, 421, 537, 659, 858, 1011, 1163, 1411, 1701, 2128, 2409, 2793, 3002, 3216]","[170, 260, 388, 558, 648, 738, 873, 963, 1139, 1378, 1557, 1828, 2008, 2304, 2691]",6423,4544,4197,3216,2691,2104,3225,3458,1123,684,10594,15,radiant
7536605016,25,102,28,56,20,"[0, 284, 584, 827, 1081, 1373, 1903, 2288, 2733, 3110, 3890, 4440, 4804, 5572, 6152]","[0, 257, 430, 708, 1040, 1418, 1777, 2501, 2963, 3361, 4045, 4681, 5260, 6099, 6248]","[0, 283, 566, 917, 1289, 1860, 2278, 2962, 3355, 3863, 4472, 4938, 5346, 6350, 6926]","[0, 170, 260, 389, 546, 732, 931, 1141, 1500, 2026, 2475, 3041, 3295, 3840, 4040]","[0, 170, 311, 535, 751, 971, 1149, 1436, 2328, 2549, 2762, 3015, 3170, 3928, 4077]",6152,6248,6926,4040,4077,95,74,129,58,105,"[0, 256, 666, 1114, 1350, 1918, 2404, 2753, 3091, 3810, 4362, 4887, 5549, 6094, 6905]","[0, 296, 543, 751, 968, 1293, 1998, 2334, 2664, 2994, 3622, 4033, 4864, 5245, 5963]","[0, 206, 450, 1006, 1627, 1911, 2725, 2926, 3557, 3960, 4371, 4653, 5561, 5948, 6837]","[0, 170, 260, 395, 485, 683, 793, 945, 1336, 1484, 2122, 2609, 2791, 3279, 4499]","[0, 170, 260, 432, 812, 982, 1285, 1684, 1898, 2095, 2276, 2856, 3167, 3310, 3710]",6905,5963,6837,4499,3710,-753,285,89,-459,367,-471,15,dire
7536605901,10,71,120,110,121,"[0, 130, 369, 816, 1226, 1585, 1920, 2362, 2746, 3295, 3715, 4334, 4700, 5292, 5769]","[0, 164, 516, 796, 1101, 1544, 1806, 2331, 3058, 3476, 3883, 4708, 5478, 6054, 6864]","[0, 296, 494, 940, 1336, 1741, 2011, 2500, 2986, 3558, 4051, 4424, 5233, 5896, 6322]","[0, 168, 258, 415, 641, 798, 888, 1205, 1339, 1474, 1702, 1868, 2396, 2725, 2846]","[0, 175, 602, 692, 937, 1122, 1388, 1556, 1869, 2032, 2200, 2466, 2667, 3089, 3259]",5769,6864,6322,2846,3259,89,106,97,105,75,"[0, 209, 566, 1050, 1386, 1748, 2039, 2538, 2791, 3087, 3762, 4244, 5024, 6073, 7018]","[0, 328, 681, 1007, 1368, 1723, 1930, 2668, 3058, 3830, 4396, 4732, 5311, 5758, 6395]","[0, 209, 556, 799, 1245, 1637, 2047, 2445, 2864, 3444, 3959, 4380, 4922, 5180, 6249]","[0, 170, 260, 416, 506, 661, 796, 961, 1096, 1596, 1776, 2293, 2548, 2762, 3173]","[0, 170, 305, 441, 629, 759, 951, 1244, 1397, 1646, 2028, 2278, 2491, 2705, 2911]",7018,6395,6249,3173,2911,-1249,469,73,-327,348,-686,15,dire
7536677705,113,22,96,65,105,"[73, 237, 645, 817, 1189, 1548, 1960, 2368, 2672, 3075, 3953, 4442, 4900, 5522, 6135]","[73, 326, 719, 1125, 1390, 1800, 2373, 2730, 3237, 3697, 4331, 4849, 5336, 6039, 6297]","[73, 285, 566, 1009, 1431, 1796, 2130, 2385, 2763, 3014, 3475, 3950, 4410, 5409, 5962]","[73, 203, 293, 531, 848, 958, 1369, 1836, 2249, 2546, 3061, 3800, 4340, 4903, 5217]","[206, 336, 441, 531, 666, 756, 1174, 2005, 2193, 2705, 3606, 3732, 4070, 4450, 4838]",6135,6297,5962,5217,4838,94,106,69,58,121,"[174, 420, 627, 966, 1287, 1735, 2096, 2474, 3039, 3507, 4174, 4545, 5188, 5790, 6421]","[307, 703, 951, 1246, 1646, 2059, 2592, 2917, 3091, 3447, 3582, 3965, 4636, 4839, 5525]","[174, 420, 774, 1168, 1581, 1973, 2430, 3191, 3576, 3992, 4204, 4843, 5252, 5785, 6170]","[442, 652, 742, 832, 1074, 1288, 1607, 1852, 2099, 2508, 2680, 3104, 3518, 3721, 3990]","[307, 517, 607, 745, 870, 1125, 1287, 1754, 2059, 2219, 2393, 2800, 2980, 3183, 3377]",6421,5525,6170,3990,3377,-286,772,-208,1227,1461,2966,15,radiant
7536836105,48,36,96,26,84,"[0, 213, 532, 951, 1460, 1821, 2467, 2977, 3424, 3955, 4497, 4916, 5627, 6283, 6880]","[0, 293, 625, 1031, 1239, 1535, 1732, 2139, 2469, 2966, 3489, 3969, 4380, 5107, 5683]","[0, 244, 371, 840, 1290, 1613, 2189, 2722, 3040, 3492, 4041, 4500, 4863, 5346, 5779]","[0, 220, 360, 494, 584, 774, 1036, 1171, 1261, 1351, 1486, 1680, 1811, 2004, 2144]","[0, 170, 314, 404, 539, 629, 803, 938, 1031, 1180, 1384, 1652, 1875, 2024, 2119]",6880,5683,5779,2144,2119,69,106,6,53,102,"[0, 330, 777, 1246, 1643, 2253, 2778, 3412, 4008, 4589, 5232, 6082, 6735, 7582, 8265]","[0, 325, 731, 1079, 1526, 2001, 2292, 2742, 3053, 3525, 4346, 5035, 5585, 6329, 6791]","[0, 170, 553, 827, 1304, 1754, 2252, 2657, 3114, 3613, 4012, 4348, 5118, 5622, 6076]","[0, 170, 260, 419, 626, 772, 908, 1059, 1238, 1441, 1731, 1916, 2331, 2652, 2856]","[0, 216, 306, 751, 881, 1006, 1096, 1230, 1320, 1427, 1831, 2134, 2545, 2831, 2998]",8265,6791,6076,2856,2998,-1385,-1108,-297,-712,-879,-4381,15,dire
7537185709,42,120,96,85,121,"[0, 285, 609, 1016, 1297, 1578, 1958, 2261, 2964, 3196, 3652, 4000, 4487, 5055, 5763]","[0, 240, 571, 902, 1123, 1486, 1699, 2087, 2488, 2676, 3246, 3389, 4193, 4632, 4965]","[0, 244, 489, 734, 939, 1262, 1637, 1930, 2456, 2813, 3190, 3280, 3661, 3810, 3951]","[100, 270, 360, 606, 791, 926, 1061, 1241, 1676, 1803, 2342, 2432, 2809, 2958, 3087]","[0, 170, 296, 386, 551, 701, 791, 971, 1328, 1713, 2244, 2334, 2469, 2618, 2713]",5763,4965,3951,3087,2713,113,78,48,30,26,"[0, 326, 568, 818, 1534, 1916, 2467, 3185, 3727, 4213, 4713, 5349, 6062, 7497, 8730]","[0, 207, 493, 697, 1046, 1248, 1583, 1829, 1919, 2449, 2932, 3769, 4476, 4827, 5539]","[0, 252, 415, 589, 893, 1017, 1323, 1695, 1823, 2243, 2423, 2777, 3125, 3544, 4267]","[0, 170, 260, 350, 486, 576, 774, 909, 1076, 1176, 1321, 1689, 1986, 2267, 2624]","[0, 170, 260, 350, 485, 575, 757, 847, 937, 1071, 1216, 1476, 1856, 2527, 2972]",8730,5539,4267,2624,2972,-2967,-574,-316,463,-259,-3653,15,dire
7537243502,95,112,29,65,86,"[494, 931, 1324, 1652, 2098, 2623, 3212, 3711, 4175, 4749, 5583, 6170, 6265, 6966, 7694]","[451, 692, 873, 1168, 1551, 2151, 2587, 3032, 3587, 4428, 4736, 5532, 5702, 6151, 6409]","[603, 730, 1100, 1681, 1890, 2188, 2583, 2969, 3230, 3777, 4014, 4569, 4664, 5091, 5424]","[297, 432, 562, 671, 1080, 1360, 1493, 1627, 2112, 2404, 2710, 2930, 3163, 3414, 3655]","[643, 733, 881, 1184, 1274, 1364, 1706, 1821, 2107, 2627, 2892, 3149, 3269, 3551, 3759]",7694,6409,5424,3655,3759,93,46,97,45,72,"[485, 1089, 1298, 1954, 2569, 3176, 3475, 4008, 4573, 4921, 5606, 6525, 8295, 9167, 10324]","[540, 853, 1307, 1602, 1850, 2207, 2680, 3108, 4204, 4597, 5125, 5676, 6375, 6913, 7610]","[408, 704, 1050, 1347, 1770, 2385, 2735, 3202, 3744, 4317, 4890, 5422, 6066, 6957, 7770]","[375, 465, 599, 771, 1014, 1317, 1407, 1630, 2191, 2281, 2371, 2908, 3670, 3928, 4436]","[260, 742, 849, 1307, 1443, 1716, 1872, 1962, 2373, 2463, 2722, 3038, 3713, 3955, 4567]",10324,7610,7770,4436,4567,-2630,-1201,-2346,-781,-808,-7766,15,dire
7537270116,46,47,102,79,26,"[0, 440, 715, 990, 1258, 1729, 2110, 2540, 2971, 3368, 3637, 4337, 5070, 5878, 6425]","[0, 395, 671, 919, 1511, 1998, 2210, 2655, 3105, 3537, 3949, 4648, 5197, 5629, 5822]","[0, 588, 823, 1172, 1585, 1796, 2116, 2257, 2494, 2790, 3160, 3561, 4249, 4616, 5040]","[0, 418, 508, 646, 1168, 1307, 1640, 1778, 1953, 2458, 2548, 2780, 3618, 3841, 3936]","[0, 478, 568, 658, 876, 1015, 1138, 1277, 1415, 1539, 1711, 1854, 2706, 2952, 3098]",6425,5822,5040,3936,3098,53,59,55,88,58,"[0, 478, 716, 957, 1328, 1535, 2150, 3113, 3910, 4350, 4815, 5577, 5897, 6678, 7037]","[0, 485, 800, 1126, 1545, 2074, 2369, 3195, 3647, 4283, 4997, 5551, 5726, 6377, 6597]","[0, 839, 1040, 1463, 1742, 1871, 2509, 2888, 3258, 3805, 4070, 4422, 4861, 5387, 5901]","[0, 303, 409, 574, 896, 986, 1292, 1517, 2066, 2506, 3308, 3846, 3936, 4276, 4971]","[0, 370, 460, 590, 860, 950, 1074, 1780, 1998, 2478, 2682, 3218, 3326, 3689, 3918]",7037,6597,5901,4971,3918,-612,-775,-861,-1035,-820,-4103,15,dire
7537298215,43,35,129,119,20,"[121, 367, 910, 1130, 1640, 2053, 2867, 3402, 4119, 5059, 5941, 6449, 7251, 7735, 8147]","[254, 583, 902, 1191, 1615, 2111, 2587, 3393, 3715, 4444, 5227, 5834, 6505, 7048, 7797]","[121, 413, 763, 1137, 1625, 2182, 2501, 2884, 3443, 4188, 4831, 5494, 5776, 6470, 7230]","[389, 599, 699, 847, 1024, 1355, 1666, 2295, 2430, 2837, 3317, 3831, 4310, 4973, 5391]","[121, 331, 421, 719, 849, 1037, 1274, 1532, 1927, 2313, 2628, 2840, 3048, 3297, 3585]",8147,7797,7230,5391,3585,7,73,29,121,14,"[0, 165, 292, 532, 657, 956, 1080, 1273, 1446, 1536, 1721, 2502, 2592, 2686, 2781]","[0, 251, 341, 510, 872, 1044, 1134, 1260, 1480, 1898, 2168, 2762, 3462, 3739, 3834]","[0, 202, 328, 456, 629, 719, 928, 1018, 1108, 1237, 1492, 1632, 1840, 2007, 2102]","[0, 130, 294, 496, 669, 879, 969, 1226, 1486, 1576, 1711, 1801, 1891, 1985, 2080]","[0, 130, 220, 310, 448, 538, 628, 763, 1032, 1170, 1305, 1494, 1584, 1678, 1773]",2781,3834,2102,2080,1773,5366,3963,5128,3311,1812,19580,15,radiant
7537736803,25,90,97,19,83,"[57, 262, 563, 934, 1268, 1520, 2012, 2405, 2495, 2860, 3303, 3909, 4586, 5131, 5633]","[57, 375, 722, 984, 1312, 1616, 2033, 2349, 2851, 3628, 4456, 4882, 5533, 6125, 6606]","[325, 532, 919, 1383, 1693, 1942, 2336, 2781, 3200, 3671, 4108, 4812, 5170, 5677, 6201]","[57, 227, 510, 648, 817, 1007, 1143, 1413, 1503, 2001, 2237, 2405, 2585, 2733, 3126]","[57, 227, 355, 490, 646, 736, 875, 1164, 1254, 1598, 1994, 2207, 2387, 2535, 2902]",5633,6606,6201,3126,2902,70,128,28,86,66,"[0, 219, 591, 841, 1289, 1510, 2052, 2576, 2945, 3368, 3796, 3997, 4740, 5306, 5627]","[0, 286, 651, 1070, 1391, 1814, 2231, 2398, 2949, 3390, 3785, 4214, 4791, 5141, 5492]","[0, 209, 405, 635, 996, 1131, 1454, 1862, 2107, 2248, 2717, 2935, 3530, 4061, 4567]","[0, 216, 394, 530, 669, 759, 1032, 1199, 1587, 1677, 1949, 2039, 2466, 2862, 3413]","[0, 209, 403, 599, 745, 888, 1054, 1370, 1625, 1755, 2033, 2197, 2594, 2911, 3228]",5627,5492,4567,3413,3228,6,1114,1634,-287,-326,2141,15,radiant
7537775002,41,39,97,123,20,"[326, 613, 928, 1248, 1470, 1882, 2043, 2507, 3040, 3662, 4018, 4648, 4929, 5257, 5772]","[58, 336, 744, 1038, 1524, 1778, 2190, 2679, 3054, 3533, 4003, 4687, 5126, 5740, 6257]","[58, 277, 514, 802, 1048, 1576, 1915, 2294, 2709, 3250, 3518, 4109, 4683, 5256, 5533]","[58, 188, 278, 398, 524, 742, 832, 1121, 1331, 1599, 1866, 2192, 2743, 3389, 3992]","[58, 188, 314, 473, 603, 893, 1018, 1223, 1470, 1871, 2213, 2612, 2792, 3293, 3473]",5772,6257,5533,3992,3473,82,74,129,65,105,"[0, 255, 662, 999, 1385, 1754, 2282, 2780, 3467, 4162, 4559, 4827, 5641, 5958, 6867]","[0, 256, 540, 875, 1142, 1559, 1972, 2410, 2904, 3391, 3721, 4080, 4465, 4941, 5679]","[0, 260, 532, 914, 1307, 1504, 2000, 2346, 2807, 2984, 3241, 3818, 4448, 4977, 5304]","[100, 310, 400, 490, 775, 985, 1075, 1367, 1654, 1744, 1995, 2304, 2520, 2836, 3124]","[0, 210, 300, 498, 618, 743, 927, 1093, 1276, 1568, 1865, 2096, 2560, 2747, 3246]",6867,5679,5304,3124,3246,-1095,578,229,868,227,807,15,radiant
7537910800,73,120,129,53,79,"[1, 388, 662, 1059, 1328, 1719, 2161, 2928, 3255, 4180, 4807, 5642, 6241, 7749, 8689]","[1, 242, 484, 650, 965, 1368, 1574, 2400, 2646, 3201, 3695, 4168, 4952, 5108, 5552]","[1, 258, 437, 918, 1391, 1809, 2425, 2841, 3292, 3613, 4098, 4250, 4874, 5500, 5801]","[1, 323, 413, 582, 672, 880, 1086, 1266, 1489, 1734, 2054, 2224, 2603, 2934, 3085]","[1, 491, 581, 701, 829, 1145, 1516, 1696, 1803, 2141, 2505, 2885, 3222, 3426, 3799]",8689,5552,5801,3085,3799,47,41,55,51,110,"[1, 256, 544, 804, 1161, 1554, 2242, 2413, 2897, 3529, 3928, 4235, 4837, 5290, 5689]","[1, 171, 387, 595, 978, 1189, 1524, 1820, 2188, 2406, 2918, 3417, 3962, 4391, 5125]","[1, 171, 368, 527, 1033, 1418, 1733, 2257, 2814, 3363, 3837, 4407, 4980, 5380, 6017]","[1, 216, 306, 396, 526, 633, 829, 1045, 1329, 1552, 1687, 2026, 2116, 2412, 2967]","[1, 171, 261, 399, 573, 663, 1026, 1161, 1268, 1366, 1501, 1711, 2014, 2254, 2698]",5689,5125,6017,2967,2698,3000,427,-216,118,1101,4430,15,radiant
7538114108,106,1,96,92,112,"[1027, 1478, 1805, 2132, 2673, 3084, 3579, 4090, 4550, 5119, 5757, 6857, 7603, 8274, 9248]","[1004, 1515, 1845, 2174, 2532, 2876, 3433, 3883, 4468, 5031, 5911, 6393, 6939, 7701, 8598]","[1258, 1592, 2182, 2884, 3367, 3821, 4581, 5010, 5370, 5915, 6301, 6888, 7285, 7797, 8569]","[961, 1051, 1222, 1467, 1660, 2036, 2276, 2366, 2748, 2928, 3187, 3549, 3794, 4348, 4965]","[531, 765, 867, 957, 1138, 1276, 1516, 1606, 1959, 2363, 2551, 2826, 3024, 3365, 3531]",9248,8598,8569,4965,3531,17,43,67,65,19,"[964, 1447, 1928, 2379, 2802, 3409, 4117, 4650, 4906, 5246, 6029, 6522, 6879, 7186, 7433]","[755, 1120, 1438, 2240, 2648, 3033, 3608, 3959, 4206, 4403, 5259, 5443, 5715, 6552, 6940]","[641, 1023, 1441, 1657, 1829, 2131, 2505, 2920, 3292, 3720, 4775, 5306, 5657, 6268, 6586]","[344, 654, 784, 1138, 1273, 1872, 2093, 2273, 2363, 2834, 3280, 3464, 3720, 3987, 4081]","[310, 440, 706, 836, 971, 1187, 1408, 1999, 2133, 2254, 2710, 2894, 2989, 3268, 3479]",7433,6940,6586,4081,3479,1815,1658,1983,884,52,6392,15,radiant
7538340310,7,55,41,51,20,"[0, 329, 760, 1177, 1707, 2109, 2526, 3355, 3899, 4433, 4970, 5404, 6044, 6756, 7383]","[0, 239, 572, 933, 1322, 2113, 2513, 3149, 3765, 4585, 5296, 5645, 6510, 7523, 8090]","[0, 254, 734, 1134, 1329, 1834, 2241, 2734, 3095, 3478, 3977, 4672, 5268, 5782, 6033]","[0, 208, 322, 461, 598, 853, 943, 1260, 1465, 1555, 1854, 2109, 2429, 2971, 3237]","[0, 170, 260, 481, 615, 822, 912, 1250, 1455, 1637, 1984, 2354, 2498, 3108, 3744]",7383,8090,6033,3237,3744,11,105,2,9,114,"[0, 290, 979, 1302, 1760, 2211, 2704, 3434, 3801, 4063, 4575, 5308, 5826, 6230, 6393]","[0, 338, 716, 1057, 1477, 1973, 2501, 2705, 3122, 3559, 4186, 4510, 4923, 5389, 6345]","[0, 281, 544, 944, 1270, 1699, 2252, 2777, 3334, 3864, 4397, 5026, 5433, 6124, 7514]","[0, 170, 349, 538, 754, 990, 1213, 1385, 1620, 1829, 2055, 2487, 2810, 3008, 3212]","[0, 170, 360, 499, 673, 763, 893, 1108, 1284, 1413, 1725, 1916, 2109, 2307, 2839]",6393,6345,7514,3212,2839,990,1745,-1481,25,905,2184,15,dire
7538469504,10,106,78,75,26,"[0, 167, 499, 917, 1286, 1568, 2081, 2542, 3020, 3445, 3877, 4586, 5247, 5735, 6468]","[0, 168, 451, 814, 983, 1149, 1351, 1656, 1908, 2282, 2631, 2911, 3603, 4041, 4423]","[0, 167, 576, 825, 1085, 1415, 1787, 2097, 2389, 2964, 3574, 3955, 4171, 4473, 4760]","[0, 129, 219, 309, 399, 489, 579, 821, 926, 1166, 1382, 1771, 2005, 2222, 2600]","[0, 129, 276, 366, 456, 546, 636, 861, 1046, 1320, 1620, 1800, 2271, 2779, 2955]",6468,4423,4760,2600,2955,41,49,102,58,110,"[0, 209, 372, 576, 851, 1474, 1794, 2102, 2622, 3257, 3571, 3938, 4343, 5040, 5582]","[0, 335, 664, 911, 1378, 1595, 2093, 2584, 2963, 3334, 3943, 4260, 4592, 5329, 6094]","[0, 295, 494, 656, 897, 1458, 1690, 2239, 2662, 3129, 3552, 4194, 4663, 5092, 5632]","[0, 209, 299, 407, 514, 664, 819, 1221, 1311, 1762, 2139, 2527, 2712, 3029, 3161]","[0, 258, 348, 438, 567, 742, 832, 1311, 1401, 1718, 1908, 2302, 2743, 3033, 3220]",5582,6094,5632,3161,3220,886,-1671,-872,-561,-265,-2483,15,dire
7538484012,46,35,71,84,86,"[0, 257, 596, 933, 1391, 1808, 2448, 2982, 3554, 4237, 5015, 5832, 6906, 7722, 9173]","[0, 284, 444, 722, 1216, 1377, 1781, 2488, 2756, 3322, 3831, 4845, 5502, 6135, 6761]","[0, 207, 372, 824, 1144, 1541, 1735, 1979, 2517, 2699, 3119, 3518, 3758, 4227, 4376]","[0, 170, 260, 409, 543, 725, 833, 1191, 1281, 1417, 1609, 2177, 2617, 2746, 2988]","[0, 222, 312, 402, 584, 996, 1130, 1373, 1508, 1845, 2170, 2368, 2662, 3001, 3477]",9173,6761,4376,2988,3477,76,59,33,14,5,"[0, 295, 576, 954, 1410, 1910, 2323, 2987, 3538, 4008, 4555, 5135, 6188, 6908, 7505]","[0, 214, 647, 999, 1514, 1858, 2421, 2933, 3686, 4285, 5110, 5855, 6200, 6775, 7390]","[0, 328, 963, 1353, 1835, 2574, 2958, 3942, 4532, 5004, 5529, 5619, 5948, 6755, 7184]","[0, 170, 332, 422, 640, 884, 1192, 1372, 1846, 1980, 2115, 2412, 2759, 3242, 3415]","[0, 170, 312, 402, 532, 695, 903, 1083, 1173, 1367, 1888, 2287, 2574, 2907, 3002]",7505,7390,7184,3415,3002,1668,-629,-2808,-427,475,-1721,15,dire
7538527908,89,46,23,26,105,"[0, 208, 660, 1101, 1419, 1837, 2266, 2737, 3189, 3769, 4193, 4373, 4962, 5666, 6079]","[0, 204, 406, 607, 731, 1003, 1364, 1794, 2008, 2471, 2976, 3542, 4063, 4824, 5571]","[0, 242, 653, 908, 1153, 1572, 1930, 2055, 2688, 2932, 3742, 4032, 4960, 5089, 5645]","[0, 169, 259, 396, 766, 926, 1155, 1371, 1507, 1861, 2053, 2195, 2453, 2548, 2643]","[0, 169, 259, 349, 439, 564, 793, 883, 1057, 1316, 1637, 1799, 2057, 2187, 2436]",6079,5571,5645,2643,2436,41,22,96,123,20,"[0, 171, 470, 748, 1248, 1628, 1879, 2290, 2724, 3411, 3885, 4417, 4849, 5481, 6292]","[2, 246, 615, 1379, 1667, 2084, 2441, 3041, 3730, 4342, 4955, 5414, 6075, 6263, 6873]","[0, 277, 554, 919, 1417, 1739, 2686, 3220, 3830, 4581, 4974, 5602, 6194, 6560, 6991]","[0, 169, 259, 396, 828, 918, 1384, 1655, 2125, 2583, 2743, 2921, 3234, 3533, 3968]","[2, 173, 297, 425, 585, 793, 1063, 1288, 1585, 2089, 2268, 2405, 2577, 2770, 2969]",6292,6873,6991,3968,2969,-213,-1302,-1346,-1325,-533,-4719,15,dire
7538558409,138,29,19,64,45,"[0, 361, 601, 889, 1271, 1676, 1940, 2185, 2312, 2882, 3203, 3402, 4167, 4719, 5148]","[0, 454, 793, 990, 1524, 2073, 2613, 3207, 3588, 4065, 4665, 5273, 5616, 6135, 6617]","[0, 328, 659, 858, 1149, 1520, 1854, 2231, 2676, 3120, 3739, 4537, 4872, 5110, 5851]","[0, 287, 380, 470, 845, 1059, 1280, 1460, 1801, 2286, 2511, 3446, 3580, 3969, 4538]","[0, 210, 316, 406, 594, 775, 865, 1045, 1221, 1603, 2179, 2619, 2821, 3001, 3406]",5148,6617,5851,4538,3406,74,129,6,53,103,"[0, 166, 408, 846, 1125, 1532, 1890, 2285, 2587, 2888, 3049, 3283, 3658, 4087, 4721]","[0, 470, 630, 1001, 1295, 1421, 2137, 2709, 3183, 3463, 3955, 4620, 5243, 5624, 6431]","[0, 323, 691, 884, 1166, 1319, 1721, 1919, 2158, 2248, 2502, 2646, 3025, 3368, 3805]","[0, 202, 311, 431, 617, 955, 1277, 1552, 1732, 1872, 2604, 3115, 3465, 3865, 4159]","[0, 202, 292, 459, 549, 639, 1110, 1293, 1512, 1685, 1976, 2362, 2542, 2750, 2969]",4721,6431,3805,4159,2969,427,186,2046,379,437,3475,15,dire
7538571609,25,90,105,137,121,"[656, 1108, 1482, 1814, 1939, 2309, 2660, 3102, 3443, 3635, 4197, 4623, 5165, 5937, 6366]","[611, 858, 1228, 1600, 1777, 2041, 2775, 3245, 3475, 3655, 3896, 4670, 5034, 5705, 5905]","[639, 912, 1047, 1338, 1597, 1836, 2253, 2428, 2731, 2821, 3412, 3620, 4363, 4641, 5437]","[651, 1203, 1642, 1919, 2486, 3318, 3599, 4310, 4713, 4905, 5520, 5615, 6025, 6629, 7217]","[421, 719, 934, 1602, 2007, 2589, 2679, 2987, 3217, 3590, 3734, 4093, 4378, 4608, 4703]",6366,5905,5437,7217,4703,113,69,114,112,5,"[691, 1034, 1438, 1977, 2617, 3010, 3355, 3844, 4606, 5478, 5813, 6725, 7558, 8143, 9148]","[564, 885, 1144, 1781, 2289, 2608, 3379, 3946, 4694, 5089, 5707, 6312, 6627, 6948, 7528]","[578, 1079, 1367, 1966, 2198, 2596, 2903, 3098, 3451, 3905, 4210, 4622, 5082, 5400, 5648]","[360, 499, 589, 865, 1098, 1645, 1861, 2080, 2690, 3118, 3376, 3753, 4025, 4270, 4637]","[259, 469, 783, 1013, 1236, 1558, 1812, 1992, 2646, 2894, 3183, 3436, 3718, 3812, 4469]",9148,7528,5648,4637,4469,-2782,-1623,-211,2580,234,-1802,15,dire
7538618712,41,120,55,26,7,"[479, 890, 1090, 1579, 1946, 2283, 2695, 3085, 3607, 4146, 4850, 5281, 6102, 6565, 7280]","[621, 963, 1300, 1703, 2289, 2706, 3083, 3606, 3870, 4514, 4902, 5186, 5543, 5819, 6202]","[511, 756, 1094, 1796, 2179, 2613, 2986, 3514, 4048, 4690, 5061, 5656, 6484, 6856, 7085]","[271, 361, 451, 759, 1190, 1443, 1614, 1794, 2111, 2201, 2534, 2856, 3194, 3332, 3490]","[271, 361, 787, 1251, 1515, 1605, 1740, 1920, 2098, 2308, 2488, 2876, 3376, 3717, 4098]",7280,6202,7085,3490,4098,48,97,106,58,86,"[528, 738, 1185, 1471, 1904, 2219, 2772, 3414, 4102, 4618, 5227, 6345, 7007, 7667, 8544]","[526, 1022, 1480, 1940, 2376, 2876, 3265, 3892, 4877, 5494, 6287, 6856, 7131, 7797, 8243]","[673, 1038, 1357, 1691, 2084, 2570, 2898, 3074, 3682, 3965, 4624, 5225, 5709, 5803, 6162]","[300, 440, 799, 929, 1099, 1363, 1453, 1722, 2399, 2703, 2900, 3249, 3344, 3511, 3826]","[395, 690, 869, 1036, 1452, 1764, 1898, 2229, 2682, 2932, 3252, 3614, 3761, 3855, 4013]",8544,8243,6162,3826,4013,-1264,-2041,923,-336,85,-2633,15,dire
7538627214,11,61,33,14,86,"[0, 250, 545, 915, 1265, 1598, 2085, 2539, 2976, 4035, 4528, 5267, 5898, 6504, 7018]","[0, 179, 603, 849, 1330, 1582, 1865, 2017, 2496, 2986, 3471, 4157, 4745, 5015, 5577]","[0, 201, 544, 820, 1293, 1737, 2001, 2415, 2834, 2924, 3519, 4190, 4691, 5198, 5549]","[0, 130, 544, 732, 1094, 1301, 1391, 1608, 2127, 2591, 3324, 3558, 3648, 3743, 3927]","[0, 130, 220, 358, 876, 1014, 1142, 1604, 2073, 2356, 2491, 2904, 2994, 3196, 3462]",7018,5577,5549,3927,3462,93,106,53,38,112,"[0, 249, 710, 902, 1261, 1423, 1756, 2171, 2861, 3247, 3803, 4255, 4969, 5868, 6758]","[0, 331, 533, 784, 1081, 1404, 1736, 2289, 2659, 3217, 3354, 3480, 4248, 4549, 5906]","[0, 210, 335, 425, 1051, 1262, 1722, 2162, 2624, 2837, 3054, 3144, 3510, 4019, 4941]","[0, 244, 574, 854, 1197, 1708, 2048, 2600, 2851, 3205, 3670, 4076, 4561, 5273, 6047]","[0, 210, 365, 472, 867, 957, 1214, 1323, 1548, 1961, 2519, 2693, 2987, 3377, 4056]",6758,5906,4941,6047,4056,260,-329,608,-2120,-594,-2175,15,dire
7538635507,25,120,69,84,5,"[0, 203, 441, 935, 1343, 1782, 2372, 2904, 3566, 3896, 4688, 5122, 5924, 6291, 6624]","[0, 328, 646, 1136, 1469, 1935, 2484, 2865, 3234, 3740, 4269, 4893, 5502, 5952, 6858]","[0, 204, 449, 727, 1031, 1256, 1858, 1984, 2246, 2761, 3371, 3769, 4565, 5394, 6335]","[0, 169, 259, 402, 577, 1062, 1227, 1386, 1523, 1658, 2008, 2098, 2376, 2741, 3417]","[0, 221, 350, 487, 617, 770, 905, 1107, 1197, 1371, 1652, 1779, 2195, 2533, 2923]",6624,6858,6335,3417,2923,54,21,55,88,66,"[0, 293, 596, 761, 1326, 1662, 2075, 2516, 3171, 3643, 3878, 4344, 4839, 5282, 5840]","[0, 291, 576, 891, 1349, 1700, 2020, 2581, 2996, 3530, 3826, 4043, 4297, 5295, 5864]","[0, 206, 334, 477, 694, 1019, 1229, 1507, 1832, 2129, 2484, 2731, 3087, 3512, 4247]","[0, 169, 259, 349, 489, 579, 717, 902, 1087, 1215, 1635, 1899, 2134, 2581, 2879]","[0, 169, 259, 365, 539, 653, 844, 1080, 1415, 1780, 2012, 2358, 2781, 3295, 3654]",5840,5864,4247,2879,3654,784,994,2088,538,-731,3673,15,dire
7538639606,41,15,23,19,65,"[874, 1306, 1651, 2127, 2529, 2814, 3213, 3570, 4058, 4549, 4875, 5372, 5953, 6548, 7108]","[711, 934, 1333, 1554, 1920, 2338, 2896, 3352, 3770, 4365, 5107, 5662, 6481, 7238, 7500]","[1049, 1382, 1743, 2463, 2708, 3317, 3722, 4086, 4781, 5296, 5689, 6134, 6530, 6980, 7565]","[455, 692, 828, 918, 1089, 1179, 1324, 1420, 1596, 1849, 2276, 2625, 2779, 2874, 2968]","[460, 683, 1086, 1205, 1593, 1683, 1896, 2385, 2606, 2973, 3258, 3645, 3807, 4182, 4511]",7108,7500,7565,2968,4511,109,53,129,74,20,"[1257, 1467, 1825, 2667, 3178, 3661, 4031, 4838, 5514, 6062, 7086, 7716, 8603, 9428, 9821]","[641, 766, 1135, 1626, 2040, 2328, 2477, 3117, 3655, 3889, 4673, 5135, 5971, 6573, 7330]","[741, 1072, 1434, 1844, 2338, 2740, 3283, 3835, 4250, 5029, 5633, 6352, 6528, 6997, 7999]","[864, 1159, 1489, 1828, 2039, 2410, 2864, 3328, 3628, 3817, 4358, 4797, 5097, 5647, 5899]","[543, 704, 794, 1133, 1344, 1434, 1524, 1819, 1909, 2408, 2821, 2978, 3223, 3707, 3801]",9821,7330,7999,5899,3801,-2713,170,-434,-2931,710,-5198,15,radiant
7538715719,48,106,55,100,20,"[1016, 1389, 1715, 2213, 2614, 3036, 3363, 3995, 4505, 4875, 5378, 6112, 6701, 7255, 8594]","[1069, 1445, 1779, 2187, 2841, 3312, 3845, 4501, 4903, 5409, 5894, 6369, 6717, 7131, 8078]","[983, 1736, 2233, 2598, 3310, 3962, 4677, 5412, 5827, 6362, 6963, 7481, 8145, 8466, 9173]","[387, 694, 854, 944, 1455, 1704, 2051, 2342, 2432, 2669, 2903, 3238, 3566, 3661, 4210]","[386, 616, 706, 1080, 1583, 1711, 2231, 2493, 2678, 2855, 3112, 3206, 3451, 3620, 4026]",8594,8078,9173,4210,4026,41,22,96,121,58,"[970, 1421, 1725, 2062, 2438, 2770, 3103, 3305, 3992, 4519, 4932, 5363, 5829, 6727, 6908]","[1091, 1491, 1805, 2179, 2805, 2965, 3505, 4072, 4685, 4963, 5520, 5876, 6555, 7008, 7103]","[640, 1048, 1424, 1552, 1928, 2320, 2806, 3295, 4035, 4839, 5555, 6132, 6391, 6830, 6925]","[640, 817, 1184, 1274, 1576, 1666, 1803, 1983, 2591, 2979, 3218, 3397, 3861, 4190, 4285]","[454, 584, 674, 764, 1256, 1346, 1455, 1640, 1956, 2129, 2402, 2545, 2858, 3126, 3221]",6908,7103,6925,4285,3221,1686,975,2248,-75,805,5639,15,radiant
7538821104,76,137,29,114,102,"[0, 298, 512, 762, 1173, 1583, 1940, 2550, 2927, 3438, 3837, 4126, 4501, 5044, 5305]","[0, 283, 696, 873, 1229, 1409, 1620, 2066, 2746, 3095, 3849, 4298, 4828, 5278, 5373]","[0, 205, 499, 784, 1281, 1511, 1793, 2248, 2806, 3103, 3556, 3821, 4362, 4480, 4670]","[0, 170, 471, 803, 981, 1196, 1286, 1625, 1850, 1985, 2180, 2270, 2414, 2588, 2810]","[0, 170, 260, 350, 480, 649, 776, 1011, 1282, 1554, 1889, 2229, 2448, 2543, 2725]",5305,5373,4670,2810,2725,56,98,15,68,112,"[0, 349, 676, 1116, 1524, 1979, 2297, 2784, 3138, 3877, 4187, 4634, 5201, 6286, 6954]","[0, 505, 753, 1276, 1732, 2093, 2761, 3168, 3914, 4342, 4432, 5110, 5721, 6661, 7881]","[0, 205, 446, 766, 1011, 1336, 1638, 1911, 2209, 2430, 2882, 3299, 3827, 4372, 4942]","[0, 170, 260, 380, 519, 609, 747, 874, 964, 1054, 1369, 1505, 1773, 2362, 2793]","[0, 311, 401, 521, 611, 878, 1047, 1137, 1423, 1513, 1603, 2107, 2336, 2735, 3175]",6954,7881,4942,2793,3175,-1649,-2508,-272,17,-450,-4862,15,dire
7538889304,98,21,46,53,110,"[0, 211, 533, 968, 1139, 1500, 1891, 2317, 2682, 3178, 3630, 4091, 4634, 5374, 5933]","[0, 329, 652, 972, 1316, 1749, 2206, 2674, 2936, 3546, 3927, 4406, 4999, 5684, 6074]","[0, 632, 950, 1373, 1829, 2196, 2743, 3243, 3765, 4311, 4943, 5033, 5866, 6595, 7181]","[0, 205, 347, 730, 854, 1081, 1264, 1562, 1922, 2081, 2171, 2671, 2874, 3350, 3651]","[0, 205, 295, 443, 669, 877, 1012, 1147, 1417, 1576, 1694, 1857, 2057, 2459, 2657]",5933,6074,7181,3651,2657,54,23,112,66,20,"[0, 284, 448, 721, 1037, 1366, 1765, 2295, 2699, 3105, 3614, 4360, 4837, 5401, 6114]","[0, 319, 671, 1002, 1217, 1580, 1973, 2452, 2889, 3388, 3925, 4548, 5105, 5724, 6147]","[0, 210, 444, 680, 971, 1184, 1486, 1656, 1988, 2795, 3299, 3389, 3856, 4408, 4915]","[0, 249, 367, 457, 547, 891, 1072, 1232, 1347, 1629, 2062, 2782, 3137, 3706, 4107]","[0, 210, 397, 487, 994, 1151, 1286, 1421, 1511, 1891, 2116, 2503, 2618, 2795, 3025]",6114,6147,4915,4107,3025,-181,-73,2266,-456,-368,1188,15,radiant
7538985616,43,10,33,65,19,"[307, 641, 846, 1454, 1786, 2427, 3036, 3770, 4238, 4633, 5176, 5813, 6481, 7327, 7957]","[170, 297, 587, 1269, 1707, 2034, 2267, 2774, 3274, 3905, 4553, 5242, 5748, 6335, 6963]","[304, 576, 949, 1155, 1608, 1927, 2144, 2559, 3054, 3543, 4090, 4939, 5334, 5861, 6235]","[601, 735, 871, 1105, 1235, 1669, 1759, 1894, 2052, 2364, 2952, 3276, 3851, 4062, 4748]","[233, 323, 470, 600, 730, 969, 1059, 1194, 1795, 1930, 2430, 2853, 3164, 3349, 3443]",7957,6963,6235,4748,3443,95,98,106,72,20,"[286, 690, 1073, 1488, 2136, 2880, 3193, 3610, 3938, 4463, 4891, 5329, 6151, 6875, 7620]","[274, 436, 927, 1061, 1425, 1753, 2103, 2328, 2703, 3382, 3875, 4297, 4482, 4771, 5671]","[251, 499, 790, 1077, 1363, 1614, 2162, 2554, 2905, 3275, 3380, 3688, 3925, 4269, 4991]","[170, 260, 396, 642, 767, 1194, 1284, 1419, 1549, 1739, 1949, 2194, 2397, 2694, 2942]","[188, 278, 368, 518, 706, 1020, 1110, 1245, 1375, 1854, 1968, 2058, 2478, 2573, 2821]",7620,5671,4991,2942,2821,337,1292,1244,1806,622,5301,15,radiant
7539188102,25,65,62,51,20,"[259, 496, 904, 1397, 1903, 2434, 2942, 3267, 3580, 3937, 4586, 5539, 6261, 6930, 7447]","[250, 483, 764, 932, 1314, 1728, 1863, 2438, 2746, 3609, 4267, 5084, 5695, 6210, 6903]","[249, 599, 897, 1344, 1688, 2134, 2410, 2954, 3445, 3778, 4292, 4928, 5289, 5780, 6165]","[170, 309, 748, 838, 992, 1204, 1387, 1560, 1770, 2118, 2362, 2615, 2854, 3021, 3370]","[170, 306, 449, 634, 771, 861, 996, 1144, 1281, 1524, 2006, 2366, 3083, 3461, 3758]",7447,6903,6165,3370,3758,67,98,106,79,72,"[241, 473, 769, 979, 1344, 1652, 2258, 2597, 3212, 3624, 4140, 4608, 4940, 5626, 6041]","[248, 452, 597, 1026, 1210, 1630, 2171, 2574, 2858, 3870, 4226, 4645, 5614, 6149, 6572]","[278, 565, 848, 1472, 1959, 2289, 2743, 3125, 4013, 4382, 4858, 5179, 5608, 5789, 6169]","[170, 260, 350, 440, 570, 660, 1123, 1231, 1391, 1661, 2312, 3003, 3250, 3621, 3994]","[170, 260, 397, 487, 695, 785, 1121, 1245, 1462, 1732, 1950, 2040, 2362, 2495, 2662]",6041,6572,6169,3994,2662,1406,331,-4,-624,1096,2205,15,dire
7539531110,25,15,28,20,100,"[0, 243, 651, 977, 1228, 1804, 2327, 2765, 3279, 3700, 4208, 4634, 5305, 5990, 6748]","[0, 211, 458, 704, 935, 1321, 1837, 2284, 3141, 3541, 4164, 4452, 5040, 5689, 6131]","[0, 277, 570, 936, 1352, 1870, 2122, 2822, 3057, 3756, 4360, 4700, 5234, 5704, 6147]","[0, 130, 676, 810, 900, 1254, 1455, 1545, 1707, 1918, 2098, 2188, 2393, 2890, 3148]","[0, 130, 220, 310, 400, 525, 749, 883, 1143, 1471, 1651, 1780, 2015, 2164, 2387]",6748,6131,6147,3148,2387,95,38,106,69,110,"[0, 290, 560, 950, 1079, 1277, 1599, 1959, 2049, 2586, 3087, 3774, 4402, 5052, 5616]","[0, 244, 410, 799, 1177, 1314, 1632, 2026, 2567, 2970, 3832, 4380, 4834, 5235, 5762]","[0, 286, 558, 994, 1317, 1514, 1919, 2337, 2972, 3062, 3678, 4140, 4382, 4751, 5212]","[100, 310, 450, 588, 678, 838, 991, 1197, 1337, 1473, 1884, 2129, 2418, 2624, 2782]","[0, 210, 336, 426, 562, 652, 823, 1003, 1183, 1273, 1850, 2042, 2539, 2738, 2833]",5616,5762,5212,2782,2833,1132,369,935,366,-446,2356,15,dire
7539558016,109,69,106,105,20,"[282, 605, 1152, 1450, 1865, 2364, 2730, 3244, 3633, 4113, 4703, 5246, 6083, 6857, 7332]","[241, 519, 728, 1039, 1242, 1672, 2197, 2776, 3217, 3679, 4215, 5004, 6003, 6428, 6924]","[248, 603, 970, 1292, 1544, 1933, 2280, 2731, 3185, 3607, 4072, 4566, 5126, 5722, 6427]","[207, 297, 387, 517, 607, 914, 1356, 1446, 1536, 1789, 1963, 2131, 2577, 2967, 3105]","[219, 309, 708, 910, 1046, 1276, 1415, 1522, 1612, 1918, 2149, 2482, 2848, 3029, 3268]",7332,6924,6427,3105,3268,94,120,28,65,110,"[219, 505, 916, 1318, 1684, 2062, 2705, 3266, 3910, 4400, 5296, 5944, 6620, 7446, 8000]","[219, 452, 785, 1166, 1422, 1828, 2364, 2702, 2965, 3333, 3691, 4174, 4323, 5239, 5914]","[281, 371, 721, 980, 1226, 1443, 1820, 2042, 2276, 2795, 3191, 3870, 4410, 5034, 5519]","[169, 259, 525, 690, 815, 949, 1084, 1421, 1511, 1601, 1896, 2203, 2451, 2712, 2883]","[169, 274, 444, 857, 991, 1081, 1459, 1594, 1684, 1823, 2117, 2347, 2888, 3197, 3410]",8000,5914,5519,2883,3410,-668,1010,908,222,-142,1330,15,radiant
7539608700,26,126,136,31,97,"[0, 363, 815, 1147, 1567, 2143, 2595, 3206, 3720, 4473, 4892, 5336, 5426, 5917, 6315]","[0, 241, 700, 980, 1384, 1719, 2256, 2671, 3080, 3714, 4171, 4421, 4732, 5228, 5583]","[0, 218, 456, 950, 1118, 1611, 1805, 1981, 2155, 2290, 2501, 2697, 3075, 3324, 3478]","[0, 170, 260, 396, 486, 663, 912, 1002, 1295, 1430, 1520, 1897, 1987, 2126, 2351]","[0, 170, 260, 350, 486, 616, 753, 843, 933, 1068, 1158, 1354, 1482, 1577, 1671]",6315,5583,3478,2351,1671,38,13,81,75,68,"[0, 329, 695, 1031, 1490, 1810, 2810, 3240, 4220, 4638, 5691, 6455, 7111, 7997, 8932]","[0, 324, 606, 1052, 1423, 1878, 2402, 2867, 3335, 3773, 4432, 5784, 6370, 7109, 7930]","[0, 290, 604, 937, 1357, 1814, 2231, 2793, 3227, 3672, 4231, 4851, 5540, 6267, 7407]","[0, 170, 260, 350, 535, 669, 903, 1037, 1598, 1732, 2042, 2399, 2777, 3235, 3645]","[0, 170, 260, 350, 440, 578, 746, 836, 1059, 1149, 1374, 1500, 1736, 2108, 2618]",8932,7930,7407,3645,2618,-2617,-2347,-3929,-1294,-947,-11134,15,dire
7539919209,61,20,80,73,45,"[0, 280, 568, 941, 1169, 1755, 2207, 2682, 3562, 4391, 5085, 5801, 6280, 7129, 8070]","[0, 621, 1075, 1536, 1965, 2281, 2945, 3555, 4131, 5133, 5768, 6333, 7347, 7908, 8668]","[0, 241, 502, 796, 969, 1414, 1826, 2462, 3091, 3626, 4290, 4693, 5158, 5751, 6241]","[0, 318, 470, 862, 998, 1285, 1906, 2335, 2820, 3468, 3845, 4272, 4969, 5573, 6099]","[0, 170, 260, 397, 599, 689, 985, 1165, 1525, 1881, 2455, 2914, 3215, 3749, 4163]",8070,8668,6241,6099,4163,53,46,96,101,51,"[0, 241, 485, 647, 1092, 1339, 1513, 1894, 2630, 2999, 3393, 3707, 4382, 4842, 5283]","[0, 264, 477, 765, 1224, 1514, 1792, 2173, 2496, 3062, 3660, 4143, 4233, 4617, 4786]","[0, 243, 445, 721, 968, 1273, 1928, 2265, 2515, 2679, 2814, 2942, 3502, 3896, 4582]","[0, 170, 260, 350, 489, 619, 757, 892, 982, 1188, 1323, 1533, 1706, 1880, 1975]","[0, 170, 260, 435, 525, 655, 745, 929, 1214, 1389, 1524, 1617, 1798, 2134, 2229]",5283,4786,4582,1975,2229,2787,3882,1659,4124,1934,14386,15,radiant
7540018616,10,120,60,21,102,"[526, 733, 1003, 1254, 1838, 2348, 2911, 3261, 3858, 4265, 4895, 5551, 5950, 6221, 6586]","[465, 769, 1015, 1518, 1679, 1990, 2434, 2726, 3391, 3747, 3977, 4545, 4640, 4992, 5649]","[408, 695, 785, 1084, 1595, 1964, 2737, 3020, 3619, 3923, 4172, 4715, 5161, 5386, 5618]","[262, 352, 442, 532, 972, 1107, 1304, 1464, 1835, 1925, 2223, 2561, 2656, 2804, 3087]","[323, 448, 577, 751, 841, 976, 1173, 1398, 1977, 2067, 2304, 2529, 2624, 2893, 2988]",6586,5649,5618,3087,2988,49,6,96,65,86,"[693, 1101, 1571, 1854, 2364, 3028, 3554, 3975, 4308, 4675, 5500, 6041, 6722, 6989, 8174]","[504, 628, 1288, 1871, 2189, 2435, 2762, 3243, 3885, 4462, 5289, 5811, 6554, 7127, 7925]","[553, 960, 1197, 1601, 1822, 2311, 2922, 3555, 3855, 4287, 4864, 5392, 5817, 6168, 7005]","[299, 433, 912, 1217, 1569, 1762, 1852, 2117, 2343, 2792, 3327, 3863, 4569, 5039, 5618]","[331, 467, 692, 871, 1006, 1264, 1354, 1604, 1992, 2281, 2659, 3321, 3963, 4322, 4765]",8174,7925,7005,5618,4765,-1588,-2276,-1387,-2531,-1777,-9559,15,dire
7540116814,70,21,96,53,26,"[624, 752, 1079, 1537, 1984, 2418, 3111, 3370, 3830, 4345, 4799, 5247, 5924, 6179, 6875]","[664, 911, 1245, 1696, 2194, 2701, 3378, 3468, 4140, 4959, 5274, 5907, 6293, 6719, 7477]","[839, 1072, 1432, 1813, 2239, 2704, 3048, 3309, 3812, 4467, 4937, 5534, 5928, 6360, 7159]","[387, 523, 673, 921, 1011, 1300, 1574, 1740, 2017, 2485, 2710, 2978, 3807, 4043, 4724]","[694, 927, 1017, 1196, 1286, 1636, 1909, 2171, 2655, 2858, 2948, 3144, 3569, 4012, 4387]",6875,7477,7159,4724,4387,41,120,14,119,20,"[577, 912, 1235, 1402, 1897, 2361, 2769, 3449, 3668, 4050, 4325, 4711, 5198, 5599, 5884]","[1093, 1344, 1754, 2081, 2398, 3059, 3536, 4254, 4849, 5521, 5718, 6210, 6736, 7270, 8066]","[474, 919, 1208, 1684, 1842, 2003, 2244, 2431, 2785, 3133, 3658, 3875, 4702, 5430, 6230]","[598, 766, 856, 946, 1036, 1248, 1699, 1871, 2184, 2477, 2686, 3007, 3773, 3921, 4252]","[465, 631, 982, 1105, 1195, 1484, 1771, 2002, 2230, 2477, 2663, 2913, 3277, 3471, 3765]",5884,8066,6230,4252,3765,991,-589,929,472,622,2425,15,dire
7540217919,95,49,97,21,20,"[719, 1187, 1536, 2200, 2498, 3091, 3653, 4078, 4731, 5463, 6239, 6791, 7477, 8281, 9479]","[659, 1043, 1184, 1788, 2198, 2706, 3303, 4185, 4604, 5384, 6029, 6643, 7518, 8473, 9325]","[1044, 1408, 1904, 2358, 3222, 3665, 4053, 4509, 5405, 6518, 6986, 7547, 8593, 9046, 9251]","[389, 525, 814, 1240, 1381, 1637, 2019, 2483, 2736, 2980, 3229, 3504, 3783, 4006, 4528]","[532, 622, 804, 969, 1127, 1531, 1988, 2126, 2492, 2970, 3170, 3319, 3611, 4153, 4494]",9479,9325,9251,4528,4494,41,28,86,53,106,"[420, 715, 990, 1317, 1714, 2027, 2351, 2754, 3125, 3513, 4168, 4703, 5111, 5880, 6508]","[295, 511, 937, 1148, 1449, 2240, 2491, 2912, 3414, 3976, 4415, 4713, 4959, 5361, 5634]","[296, 426, 638, 809, 939, 1257, 1347, 1568, 1939, 2392, 2505, 2654, 2760, 4126, 4284]","[280, 459, 589, 679, 1127, 1217, 1307, 1753, 2305, 2831, 2921, 3122, 3272, 3958, 4116]","[803, 933, 1218, 1463, 1628, 1718, 1842, 1932, 2492, 2765, 3031, 3397, 3619, 3713, 4068]",6508,5634,4284,4116,4068,2971,3691,4967,412,426,12467,15,radiant
7540243410,6,106,98,105,26,"[176, 653, 1025, 1429, 1841, 2471, 2937, 3298, 3813, 4267, 4455, 4886, 5753, 6397, 6793]","[253, 505, 794, 1018, 1346, 1636, 2183, 2513, 3060, 3535, 3908, 4439, 4862, 5206, 5656]","[130, 583, 1178, 1380, 1781, 2164, 2459, 2986, 3606, 4041, 4496, 5084, 5609, 5748, 6261]","[230, 320, 459, 639, 773, 1007, 1311, 1401, 1750, 1934, 2024, 2206, 2301, 2475, 2570]","[130, 220, 535, 675, 765, 939, 1199, 1289, 1609, 1744, 1834, 2014, 2180, 2319, 2414]",6793,5656,6261,2570,2414,49,10,55,90,51,"[280, 610, 1014, 1299, 1632, 2133, 2470, 2844, 3138, 3699, 4286, 5081, 5915, 6629, 7376]","[367, 702, 872, 1197, 1586, 1959, 2400, 2861, 3251, 3709, 4236, 4857, 5593, 6291, 6872]","[576, 855, 1227, 1685, 1912, 2229, 2609, 3252, 3559, 4235, 4771, 5719, 6219, 6731, 7395]","[316, 453, 637, 815, 1155, 1363, 1621, 1769, 2000, 2553, 3063, 3599, 4192, 4988, 5598]","[210, 300, 426, 601, 777, 867, 957, 1094, 1233, 1546, 1762, 1897, 2579, 3059, 3479]",7376,6872,7395,5598,3479,-583,-1216,-1134,-3028,-1065,-7026,15,dire
7540691210,73,61,23,112,65,"[0, 302, 841, 1107, 1453, 1792, 2302, 2870, 3006, 3154, 3630, 4319, 5064, 5993, 6877]","[0, 213, 362, 652, 742, 1056, 1363, 1934, 2489, 2919, 3527, 4373, 5154, 5897, 6236]","[0, 288, 669, 950, 1198, 1541, 1934, 2588, 2914, 3331, 3672, 4054, 4625, 5320, 6002]","[0, 129, 376, 702, 886, 1072, 1438, 1637, 1764, 2537, 2717, 3053, 3276, 3533, 3770]","[0, 129, 244, 378, 468, 654, 863, 1043, 1182, 1491, 1821, 2072, 2197, 2454, 2749]",6877,6236,6002,3770,2749,53,135,69,26,20,"[0, 291, 555, 965, 1448, 2207, 2603, 3048, 3907, 4396, 5135, 5528, 5939, 6535, 7099]","[0, 372, 688, 989, 1405, 1818, 2382, 2683, 3199, 3597, 4549, 5215, 5896, 6438, 6982]","[0, 314, 810, 1115, 1493, 2104, 2536, 2969, 3457, 3735, 4708, 5092, 5383, 5998, 6690]","[0, 209, 715, 892, 1056, 1267, 1402, 1538, 1858, 2012, 2580, 2670, 2760, 3054, 3207]","[0, 209, 324, 447, 665, 962, 1184, 1399, 1723, 1985, 2636, 2930, 3097, 3534, 3689]",7099,6982,6690,3207,3689,-222,-746,-688,563,-940,-2033,15,radiant
7540902013,72,108,106,20,26,"[0, 580, 908, 1309, 1725, 2168, 2796, 3207, 4013, 4515, 4991, 5982, 6454, 7199, 7968]","[0, 220, 537, 855, 1236, 1656, 1980, 2565, 3312, 3889, 4147, 4674, 4899, 5533, 6081]","[0, 241, 526, 973, 1262, 1607, 2160, 2639, 3144, 3496, 3881, 4398, 4692, 5325, 5884]","[0, 239, 346, 480, 618, 769, 925, 1098, 1445, 1660, 1800, 2355, 2867, 3090, 3559]","[0, 169, 356, 446, 581, 716, 1020, 1223, 1565, 1705, 1910, 2246, 2551, 2793, 3084]",7968,6081,5884,3559,3084,23,25,69,83,121,"[0, 290, 628, 1020, 1316, 1834, 2304, 2758, 3496, 3950, 4757, 5253, 6005, 6455, 7031]","[0, 217, 648, 776, 900, 1272, 1689, 1929, 2131, 2384, 2904, 3310, 3918, 4414, 5101]","[0, 169, 474, 845, 1025, 1233, 1363, 1662, 1880, 2669, 3224, 3493, 4019, 4355, 4980]","[0, 169, 289, 379, 488, 703, 793, 1100, 1488, 1775, 2269, 2413, 2963, 3260, 3570]","[0, 169, 289, 596, 738, 955, 1235, 1370, 1597, 1886, 2264, 2437, 2846, 3131, 3392]",7031,5101,4980,3570,3392,937,980,904,-11,-308,2502,15,dire
7540945015,46,32,129,20,21,"[286, 538, 839, 1264, 1655, 2031, 2241, 3223, 3752, 4452, 5047, 5787, 6824, 7491, 8019]","[332, 847, 1130, 1423, 1791, 2173, 2618, 2915, 3236, 3763, 4096, 4535, 4997, 5309, 5991]","[246, 455, 621, 783, 1075, 1476, 1861, 2182, 2462, 2972, 3457, 3916, 4588, 5300, 5395]","[310, 841, 993, 1169, 1295, 1433, 1603, 1870, 2148, 2411, 2663, 2790, 3159, 3539, 3790]","[260, 393, 535, 625, 762, 852, 988, 1170, 1296, 1386, 1853, 2067, 2448, 2722, 3307]",8019,5991,5395,3790,3307,10,23,112,58,100,"[285, 520, 849, 1376, 1718, 2134, 2532, 3076, 3738, 4373, 4779, 5218, 5930, 6462, 7470]","[168, 487, 812, 1246, 1537, 2007, 2439, 3025, 3470, 4161, 4750, 5355, 5546, 6383, 7343]","[201, 397, 666, 831, 1327, 1738, 1980, 2435, 2653, 3005, 3528, 3919, 4259, 4701, 5123]","[130, 268, 388, 612, 781, 883, 1106, 1353, 1570, 1965, 2315, 2607, 2716, 2869, 3224]","[130, 220, 443, 573, 703, 793, 1181, 1271, 1659, 2201, 2726, 2870, 3164, 3426, 3848]",7470,7343,5123,3224,3848,549,-1352,272,566,-541,-506,15,radiant
7541057003,73,19,129,123,105,"[60, 445, 821, 995, 1665, 2324, 3031, 3575, 4042, 4854, 5605, 6350, 7115, 8577, 9998]","[58, 304, 594, 1000, 1497, 1886, 2219, 2806, 3211, 3790, 4592, 5063, 5660, 6252, 6828]","[58, 301, 623, 938, 1186, 1484, 1862, 2118, 2779, 2988, 3385, 3908, 4072, 4468, 5048]","[58, 271, 552, 686, 829, 919, 1130, 1306, 1494, 1703, 2109, 2335, 2870, 3238, 3955]","[426, 596, 878, 1019, 1149, 1362, 1790, 2130, 2448, 2670, 2934, 3281, 3405, 3545, 4263]",9998,6828,5048,3955,4263,10,96,53,106,72,"[0, 208, 483, 801, 1115, 1397, 2062, 2509, 2834, 3152, 3844, 4252, 4776, 5693, 6688]","[0, 170, 369, 725, 1244, 1603, 1927, 2134, 2738, 3122, 3778, 4050, 4671, 5311, 5685]","[0, 170, 296, 672, 1076, 1447, 1537, 1939, 2313, 2458, 3052, 3188, 3973, 4754, 5163]","[0, 244, 494, 899, 1271, 1722, 2055, 2289, 2957, 3202, 3636, 4146, 4533, 5079, 5626]","[0, 213, 303, 526, 663, 786, 984, 1074, 1283, 1693, 2044, 2339, 2596, 2889, 3334]",6688,5685,5163,5626,3334,3310,1143,-115,-1671,929,3596,15,radiant
7541154713,10,21,22,58,100,"[0, 335, 745, 1062, 1537, 1972, 2450, 2983, 3644, 4137, 4788, 5208, 5983, 6471, 7067]","[0, 170, 298, 731, 1039, 1407, 1655, 2079, 2740, 3233, 3887, 4554, 5171, 5640, 6191]","[0, 323, 548, 1040, 1426, 1859, 2169, 2716, 3324, 3779, 4845, 5352, 5796, 6525, 6919]","[0, 232, 393, 543, 780, 937, 1076, 1237, 1401, 1855, 2213, 2434, 2778, 3182, 3469]","[0, 500, 590, 680, 827, 961, 1051, 1188, 1413, 1848, 2155, 2447, 2672, 3119, 3514]",7067,6191,6919,3469,3514,48,106,129,102,26,"[0, 327, 688, 974, 1578, 1832, 2380, 2799, 3090, 3460, 3902, 4392, 5019, 5839, 6603]","[0, 293, 609, 902, 1309, 1667, 2194, 2592, 3067, 3567, 3973, 4293, 4756, 5359, 6369]","[0, 244, 453, 654, 873, 1197, 1486, 1937, 2201, 2732, 3033, 3512, 4153, 4589, 5059]","[0, 170, 260, 350, 565, 709, 1090, 1227, 1450, 1589, 1764, 1908, 2136, 2404, 2738]","[0, 170, 260, 350, 440, 530, 664, 860, 1040, 1291, 1433, 1577, 1801, 1986, 2129]",6603,6369,5059,2738,2129,464,-178,1860,731,1385,4262,15,dire
7541159409,42,14,77,138,84,"[0, 322, 678, 890, 1170, 1588, 1872, 2291, 2753, 3160, 3714, 4453, 5097, 5822, 6272]","[0, 370, 620, 973, 1394, 1842, 2388, 3183, 3736, 4188, 4597, 5852, 6488, 7021, 7585]","[0, 239, 634, 989, 1285, 1636, 2132, 2505, 2972, 3395, 3969, 4621, 5037, 5669, 6048]","[0, 218, 308, 443, 533, 729, 863, 1106, 1300, 1456, 1624, 2064, 2351, 2663, 3124]","[0, 169, 259, 399, 572, 662, 752, 842, 1022, 1180, 1365, 1669, 1759, 1962, 2139]",6272,7585,6048,3124,2139,48,71,90,22,5,"[0, 205, 604, 1059, 1470, 1808, 2161, 2562, 3020, 3216, 3777, 4295, 4888, 5480, 6048]","[0, 253, 657, 986, 1315, 1482, 1894, 2056, 2982, 3376, 3752, 4717, 5141, 5776, 6254]","[0, 295, 723, 1112, 1505, 2155, 2674, 3217, 3686, 4270, 5019, 5722, 6316, 6808, 7288]","[0, 169, 259, 449, 539, 634, 769, 859, 1302, 1473, 1563, 1950, 2040, 2135, 2275]","[0, 169, 259, 349, 484, 600, 734, 869, 1011, 1246, 1352, 1604, 1709, 1804, 1899]",6048,6254,7288,2275,1899,224,1331,-1240,849,240,1404,15,radiant
7541201613,48,19,29,64,101,"[0, 318, 518, 898, 1090, 1490, 2014, 2612, 3150, 3547, 4230, 4738, 5705, 6679, 7791]","[0, 240, 558, 1016, 1418, 1719, 2119, 2569, 3080, 3568, 4119, 4547, 4989, 5837, 6860]","[0, 204, 493, 861, 1124, 1489, 1592, 1954, 2211, 2434, 3005, 3306, 3698, 3998, 4681]","[0, 170, 260, 395, 485, 621, 774, 1160, 1525, 1683, 2168, 2364, 2697, 3057, 3747]","[0, 170, 294, 654, 744, 834, 924, 1251, 1389, 1479, 1704, 1838, 2171, 2728, 3299]",7791,6860,4681,3747,3299,93,22,71,16,26,"[0, 281, 912, 1171, 1490, 1749, 2281, 2571, 2949, 3174, 3569, 3957, 4302, 5073, 5687]","[0, 310, 489, 786, 1245, 1652, 2178, 2635, 3189, 3664, 4042, 4659, 5038, 5516, 5877]","[0, 170, 375, 630, 816, 911, 1095, 1678, 1860, 2605, 2841, 3305, 3617, 4577, 4827]","[0, 170, 420, 547, 727, 1165, 1380, 1818, 1979, 2188, 2492, 3568, 3825, 4193, 4727]","[0, 170, 294, 384, 713, 1022, 1157, 1292, 1382, 1554, 1689, 2373, 2463, 2941, 3089]",5687,5877,4827,4727,3089,2104,983,-146,-980,210,2171,15,radiant
7541282317,38,63,28,3,121,"[0, 251, 818, 1089, 1332, 1682, 2115, 2875, 3501, 3714, 4109, 4598, 5049, 5457, 5930]","[0, 129, 386, 528, 813, 1056, 1314, 1561, 2202, 2541, 3097, 3544, 3738, 4922, 5132]","[0, 254, 623, 993, 1443, 1909, 2371, 3177, 3632, 3878, 4339, 4429, 4642, 5326, 5543]","[0, 129, 319, 447, 537, 687, 907, 1313, 1976, 2150, 2240, 2416, 2783, 3005, 3099]","[0, 129, 219, 376, 514, 711, 847, 982, 1322, 1652, 1896, 1986, 2197, 2292, 2556]",5930,5132,5543,3099,2556,69,14,106,123,33,"[0, 295, 1021, 1346, 1626, 2000, 2865, 3373, 3967, 4527, 5355, 5747, 6928, 7451, 7839]","[0, 247, 726, 1054, 1317, 1513, 2151, 2515, 2861, 3537, 4080, 4627, 5132, 5700, 6304]","[0, 326, 630, 905, 1114, 1482, 1732, 2026, 2357, 2606, 3117, 3712, 4101, 4380, 4796]","[0, 243, 508, 642, 992, 1215, 1463, 1693, 1888, 3000, 3207, 3550, 4186, 4335, 4575]","[0, 209, 324, 496, 805, 931, 1158, 1248, 1338, 1949, 2156, 2413, 2886, 3409, 3676]",7839,6304,4796,4575,3676,-1909,-1172,747,-1476,-1120,-4930,15,dire
7541303204,48,106,14,63,83,"[0, 287, 606, 769, 1015, 1355, 1805, 2326, 2833, 3301, 3810, 4444, 4993, 5534, 5744]","[0, 361, 642, 1133, 1549, 1917, 2296, 2527, 2999, 3369, 3896, 4289, 4779, 5155, 5594]","[0, 285, 557, 729, 932, 1469, 1941, 2358, 2804, 3131, 3605, 3749, 4037, 4560, 4946]","[0, 169, 302, 441, 594, 684, 774, 1117, 1207, 1674, 2071, 2517, 2824, 3145, 3387]","[0, 169, 311, 417, 760, 850, 1025, 1160, 1319, 1409, 1547, 1691, 1781, 1876, 2007]",5744,5594,4946,3387,2007,81,22,51,27,86,"[0, 203, 514, 839, 1279, 1657, 2010, 2506, 2961, 3352, 3925, 5055, 5494, 6144, 6828]","[0, 295, 751, 1079, 1529, 2047, 2490, 2934, 3539, 4170, 4795, 5364, 5928, 6422, 6986]","[0, 274, 519, 885, 1397, 1877, 2106, 2588, 3208, 3586, 4109, 4645, 5097, 5516, 6510]","[0, 213, 303, 496, 695, 825, 915, 1097, 1419, 1626, 1867, 2048, 2186, 2559, 3195]","[0, 169, 277, 367, 533, 663, 769, 903, 1212, 1378, 1619, 1709, 1799, 2107, 2424]",6828,6986,6510,3195,2424,-1084,-1392,-1564,192,-417,-4265,15,radiant
7541457507,48,23,96,45,91,"[593, 1011, 1256, 1579, 1861, 2067, 2618, 3195, 3647, 4727, 5246, 5840, 6635, 7590, 8668]","[981, 1393, 1884, 2446, 2845, 3475, 4056, 4518, 4906, 5570, 6050, 6638, 7096, 7539, 8339]","[608, 768, 1169, 1259, 1349, 1690, 2258, 2464, 3024, 3311, 3714, 4404, 4688, 4912, 5307]","[270, 398, 528, 657, 747, 837, 927, 1518, 1656, 2001, 2176, 2440, 2853, 3353, 3771]","[270, 630, 760, 884, 1037, 1127, 1217, 1307, 1500, 1783, 1936, 2031, 2345, 2439, 2769]",8668,8339,5307,3771,2769,73,114,120,58,123,"[1459, 1799, 2431, 3071, 3853, 4808, 5137, 6098, 6800, 7607, 8724, 9518, 10432, 11621, 12078]","[1019, 1381, 1595, 2106, 2681, 3253, 3573, 4111, 4333, 5012, 5580, 6254, 6901, 7346, 7914]","[1028, 1425, 1792, 2141, 2738, 3455, 3896, 4621, 5292, 5624, 6435, 7143, 7683, 8529, 9480]","[554, 722, 995, 1159, 1446, 1702, 2038, 2311, 2581, 3081, 3621, 3748, 3922, 4570, 5009]","[585, 788, 1247, 1337, 1602, 1835, 1986, 2289, 2452, 2838, 3390, 3663, 4137, 4516, 4889]",12078,7914,9480,5009,4889,-3410,425,-4173,-1238,-2120,-10516,15,dire
7541497612,48,120,15,100,26,"[1, 296, 533, 1069, 1659, 1907, 2405, 2918, 3350, 3921, 4555, 4940, 5828, 6561, 7331]","[1, 255, 544, 802, 1289, 1787, 2045, 2723, 3115, 3697, 4207, 4560, 5402, 5929, 6794]","[1, 290, 534, 973, 1450, 1697, 2384, 2869, 3438, 3712, 4615, 5005, 5390, 5801, 6412]","[1, 171, 261, 424, 648, 784, 1053, 1262, 1442, 1532, 1994, 2123, 2495, 2917, 3214]","[1, 171, 261, 644, 818, 908, 1090, 1452, 1542, 1709, 2013, 2268, 2571, 2737, 3240]",7331,6794,6412,3214,3240,95,106,20,86,40,"[1, 288, 529, 1031, 1403, 1613, 1943, 2278, 2640, 3307, 4017, 4669, 5889, 6457, 7326]","[1, 368, 704, 1073, 1478, 1860, 2381, 2806, 3138, 3440, 3919, 4404, 4938, 5477, 5785]","[1, 207, 443, 745, 1023, 1268, 1531, 1750, 2344, 2934, 3473, 3941, 4132, 4744, 5033]","[1, 171, 296, 823, 913, 1003, 1093, 1228, 1374, 1650, 2099, 2323, 2773, 3019, 3345]","[1, 171, 261, 506, 613, 703, 793, 1024, 1291, 1531, 1846, 2207, 2620, 2850, 3047]",7326,5785,5033,3345,3047,5,1009,1379,-131,193,2455,15,radiant
7541527708,48,28,135,110,20,"[0, 168, 616, 1012, 1347, 1675, 1915, 2399, 2663, 3082, 3381, 3819, 4524, 5101, 5724]","[0, 214, 498, 856, 1156, 1428, 1909, 2380, 2877, 3471, 4091, 4401, 4974, 5524, 5811]","[0, 208, 458, 735, 1027, 1237, 1364, 1870, 2068, 2745, 3205, 4055, 4696, 5315, 5619]","[0, 129, 219, 339, 526, 637, 817, 997, 1181, 1361, 1778, 2175, 2869, 3389, 3598]","[0, 175, 265, 418, 916, 1288, 1479, 1659, 1890, 2070, 2391, 2960, 3121, 3270, 3365]",5724,5811,5619,3598,3365,95,69,25,19,31,"[0, 255, 683, 944, 1176, 1615, 1892, 2291, 2652, 3032, 3670, 4077, 4507, 4889, 5393]","[0, 278, 625, 1082, 1406, 2260, 2628, 3126, 3769, 4459, 5024, 5659, 6172, 6940, 7539]","[0, 368, 714, 1119, 1487, 1857, 2378, 2924, 3424, 4047, 4547, 4956, 5659, 6085, 6929]","[0, 209, 299, 407, 591, 959, 1178, 1456, 1546, 1726, 1906, 2084, 2283, 2432, 2727]","[100, 309, 439, 529, 667, 860, 1187, 1429, 1638, 1894, 2093, 2255, 2639, 2881, 2976]",5393,7539,6929,2727,2976,331,-1728,-1310,871,389,-1447,15,dire
7541553404,109,126,97,45,86,"[1481, 1886, 2129, 2835, 3187, 3607, 4010, 4390, 4830, 5235, 5667, 5934, 6851, 7542, 8462]","[1210, 1546, 1888, 2435, 2760, 3220, 3624, 3988, 4443, 4751, 5151, 5367, 5817, 6786, 7344]","[572, 954, 1241, 1438, 1830, 2291, 2865, 3177, 3617, 4170, 5067, 5533, 5711, 6174, 6816]","[485, 620, 710, 845, 1265, 1514, 1873, 2346, 2645, 3112, 3437, 3531, 3908, 4343, 4556]","[569, 777, 945, 1080, 1292, 1472, 1948, 2187, 2412, 2626, 2815, 2960, 3118, 3505, 3752]",8462,7344,6816,4556,3752,6,13,29,20,112,"[1981, 2262, 2992, 3659, 3876, 4426, 4998, 5416, 5888, 6657, 7389, 8274, 8935, 9440, 10197]","[1345, 1869, 2326, 2733, 3359, 3830, 4420, 5240, 5666, 6635, 7141, 7763, 8390, 9176, 9722]","[1113, 1370, 1964, 2530, 3016, 3638, 4109, 4636, 5033, 5651, 6174, 7112, 7903, 8464, 8970]","[955, 1110, 1494, 1726, 1816, 2084, 2240, 2429, 2561, 2935, 3164, 3790, 4011, 4106, 4291]","[514, 669, 902, 1037, 1181, 1539, 1629, 1846, 2154, 2590, 2864, 3292, 3513, 3608, 3822]",10197,9722,8970,4291,3822,-1735,-2378,-2154,265,-70,-6072,15,dire
7541755512,95,25,96,112,100,"[0, 166, 414, 774, 1061, 1845, 2179, 2658, 3378, 3940, 4343, 5139, 5506, 5766, 6284]","[0, 237, 545, 785, 1076, 1497, 1890, 2383, 3127, 3691, 4031, 4255, 4794, 5148, 5890]","[0, 130, 405, 630, 1318, 1768, 1949, 2129, 2492, 2946, 3375, 3672, 4366, 4865, 5136]","[0, 230, 320, 428, 609, 792, 882, 1296, 1624, 1742, 2070, 2293, 2476, 2871, 3126]","[0, 130, 280, 387, 477, 728, 823, 1092, 1266, 1434, 1644, 1772, 1911, 2060, 2295]",6284,5890,5136,3126,2295,13,137,32,91,83,"[0, 292, 617, 814, 1148, 1552, 2034, 2368, 2810, 3455, 4415, 4969, 5589, 5949, 6805]","[0, 248, 494, 793, 1088, 1261, 1722, 1894, 2193, 2607, 2918, 3489, 4148, 5066, 5611]","[0, 257, 537, 752, 1056, 1420, 1760, 2105, 2389, 2641, 2896, 3655, 3949, 4676, 5341]","[0, 210, 338, 428, 566, 656, 803, 1181, 1347, 1582, 1815, 2433, 2553, 3127, 3308]","[0, 210, 300, 390, 480, 663, 987, 1077, 1167, 1476, 1829, 2200, 2290, 2669, 2823]",6805,5611,5341,3308,2823,-521,279,-205,-182,-528,-1157,15,dire
7541784709,38,21,137,65,83,"[0, 168, 471, 772, 1554, 1987, 2387, 2738, 3333, 3929, 4251, 4609, 4984, 5666, 6252]","[0, 243, 533, 750, 1096, 1335, 1785, 2126, 2783, 3331, 3674, 4207, 4599, 5326, 5727]","[0, 198, 518, 886, 1016, 1263, 1752, 1967, 2482, 2899, 3754, 4660, 5222, 5861, 6512]","[0, 130, 220, 310, 558, 648, 1087, 1310, 1706, 1870, 2314, 2667, 3127, 3626, 4199]","[0, 130, 220, 414, 544, 634, 807, 942, 1591, 1807, 2070, 2328, 2551, 2718, 3252]",6252,5727,6512,4199,3252,41,15,96,20,87,"[0, 245, 447, 766, 1016, 1258, 1616, 2017, 2262, 2631, 2990, 3382, 3748, 4178, 4789]","[0, 329, 641, 1003, 1425, 1882, 2184, 3083, 3501, 4149, 4325, 4572, 4833, 5595, 6019]","[0, 210, 406, 582, 906, 1193, 1602, 1985, 2208, 2647, 3063, 3607, 3913, 4392, 4953]","[0, 259, 435, 602, 822, 947, 1161, 1520, 1656, 1830, 2100, 2298, 2803, 3038, 3223]","[0, 247, 371, 461, 691, 816, 1068, 1434, 1568, 1742, 2071, 2546, 2636, 2903, 3297]",4789,6019,4953,3223,3297,1463,-292,1559,976,-45,3661,15,dire
7541933305,10,23,47,45,19,"[0, 252, 637, 1020, 1387, 1819, 2243, 2647, 3265, 3732, 4194, 5087, 5616, 6053, 6696]","[0, 288, 680, 1080, 1378, 1999, 2323, 2803, 3352, 4003, 4389, 4832, 5264, 5397, 5914]","[0, 429, 668, 955, 1121, 1583, 1960, 2087, 2321, 2710, 2963, 3274, 3449, 4026, 4245]","[100, 270, 385, 566, 885, 1103, 1193, 1407, 1542, 2035, 2170, 2451, 2587, 2693, 2834]","[0, 261, 415, 505, 812, 1236, 1462, 1552, 1774, 2151, 2286, 2666, 2860, 2960, 3100]",6696,5914,4245,2834,3100,12,74,96,65,20,"[60, 288, 776, 987, 1491, 1795, 2212, 2715, 3160, 3735, 4368, 4830, 5607, 6342, 7141]","[328, 593, 864, 1068, 1403, 1528, 1723, 1982, 2361, 2733, 3281, 3850, 4160, 4649, 5435]","[60, 420, 851, 1149, 1513, 1960, 2327, 2712, 2959, 3831, 4852, 5333, 6042, 6369, 6851]","[60, 345, 500, 590, 778, 933, 1368, 1629, 1875, 2061, 2451, 2641, 2949, 3533, 3959]","[60, 528, 721, 811, 1020, 1154, 1614, 1749, 1839, 1977, 2121, 2285, 2375, 2685, 2879]",7141,5435,6851,3959,2879,-445,479,-2606,-1125,221,-3476,15,dire
7542425418,94,96,90,20,121,"[603, 847, 1256, 1526, 1984, 2583, 3054, 3510, 3890, 4517, 5022, 5652, 6372, 7467, 8240]","[485, 757, 1084, 1492, 1998, 2261, 2569, 2929, 3266, 3521, 3733, 4430, 4748, 5589, 5819]","[594, 1003, 1334, 1903, 2670, 3276, 3512, 4173, 4610, 5241, 5774, 5869, 6402, 7452, 8014]","[430, 567, 657, 809, 1069, 1249, 1444, 1629, 1758, 2012, 2283, 2393, 2948, 3369, 3821]","[460, 594, 684, 821, 977, 1157, 1530, 1707, 1874, 2168, 2258, 2389, 3059, 3418, 3759]",8240,5819,8014,3821,3759,69,54,17,105,66,"[447, 684, 1204, 1489, 1887, 2131, 2663, 3232, 3813, 4532, 5153, 6005, 6928, 7520, 8406]","[464, 779, 1131, 1568, 1855, 2340, 2815, 3144, 3839, 4489, 4978, 5510, 6163, 6692, 7070]","[604, 971, 1428, 1949, 2412, 2753, 3273, 3621, 3977, 4278, 4662, 5329, 5827, 6504, 6819]","[535, 671, 1112, 1279, 1369, 1542, 2218, 2394, 2784, 2927, 3181, 3698, 4275, 4391, 4601]","[267, 375, 505, 765, 892, 1091, 1466, 1679, 2215, 2594, 3033, 3408, 3771, 3984, 4409]",8406,7070,6819,4601,4409,-166,-1251,1195,-780,-650,-1652,15,radiant
7542581116,48,25,96,75,84,"[0, 281, 568, 942, 1307, 1838, 2196, 2736, 3232, 3745, 4249, 5061, 5731, 6364, 6949]","[0, 296, 577, 931, 1413, 1836, 2003, 2485, 3144, 3767, 4580, 5190, 5774, 6510, 6994]","[0, 240, 590, 955, 1201, 1678, 1977, 2181, 2803, 3086, 3649, 4102, 4612, 5018, 5527]","[0, 212, 352, 442, 583, 719, 809, 899, 1034, 1124, 1379, 1976, 2453, 2801, 2941]","[0, 169, 259, 349, 439, 575, 712, 846, 981, 1071, 1161, 1490, 1580, 1953, 2048]",6949,6994,5527,2941,2048,53,49,54,40,5,"[0, 329, 810, 1227, 1761, 2146, 2769, 3335, 3752, 4257, 4972, 5454, 5892, 6555, 7221]","[0, 244, 611, 1050, 1506, 1917, 2292, 2751, 3069, 3538, 4365, 5079, 5597, 6291, 6974]","[0, 255, 608, 945, 1276, 1652, 1852, 2228, 2627, 3089, 3580, 3966, 4434, 4833, 5190]","[0, 169, 259, 349, 526, 664, 838, 1304, 1524, 1614, 1929, 2095, 2327, 2514, 2809]","[0, 169, 259, 349, 524, 663, 769, 906, 996, 1086, 1401, 1780, 1909, 2058, 2322]",7221,6974,5190,2809,2322,-272,20,337,132,-274,-57,15,radiant
7542628405,48,74,98,105,45,"[62, 502, 704, 1075, 1405, 1907, 2391, 2652, 2818, 3489, 3960, 4140, 4680, 5209, 5788]","[62, 445, 689, 1248, 1625, 2535, 2927, 3306, 3863, 4405, 4910, 5433, 5907, 6676, 6770]","[62, 407, 718, 922, 1012, 1409, 2048, 2429, 2840, 3382, 3911, 4091, 4508, 5187, 5376]","[330, 560, 859, 949, 1375, 1651, 2048, 2183, 2317, 2654, 3010, 3795, 4175, 4602, 4879]","[62, 292, 382, 616, 791, 995, 1407, 1658, 2106, 2373, 2508, 3006, 3190, 3484, 3631]",5788,6770,5376,4879,3631,53,33,11,66,20,"[0, 170, 556, 1119, 1368, 2053, 2312, 2940, 3606, 4117, 4532, 5403, 5857, 6682, 7735]","[0, 330, 656, 952, 1210, 1706, 1946, 2611, 3301, 4041, 4478, 5638, 5906, 6589, 7792]","[0, 209, 413, 583, 920, 1086, 1395, 2108, 2377, 2960, 3324, 4035, 4526, 4856, 5434]","[0, 219, 309, 530, 620, 953, 1099, 1500, 1855, 2103, 2403, 2766, 3156, 3585, 4097]","[0, 170, 260, 398, 571, 661, 851, 1297, 1652, 1996, 2253, 2523, 2613, 3031, 3485]",7735,7792,5434,4097,3485,-1947,-1022,-58,782,146,-2099,15,dire
7542660813,44,104,74,22,20,"[0, 333, 709, 962, 1353, 1756, 2217, 2535, 2929, 3427, 3876, 4430, 5470, 5757, 6490]","[0, 208, 646, 972, 1371, 1753, 2129, 2489, 2614, 3161, 3735, 4064, 4492, 4945, 5726]","[0, 169, 491, 826, 1136, 1808, 2077, 2291, 2515, 3182, 3832, 4156, 4890, 5125, 5819]","[0, 169, 305, 492, 722, 861, 1329, 1582, 1788, 1970, 2560, 3053, 3231, 3365, 3810]","[0, 169, 259, 419, 598, 766, 856, 990, 1211, 1643, 1856, 1992, 2082, 2186, 2814]",6490,5726,5819,3810,2814,106,48,14,114,84,"[0, 327, 694, 1052, 1546, 2084, 2490, 3146, 3692, 4172, 4899, 5527, 6029, 7190, 8075]","[0, 246, 441, 896, 1349, 1782, 2303, 3044, 3686, 4072, 4754, 5554, 6202, 6833, 7713]","[0, 251, 702, 982, 1469, 1959, 2421, 3064, 3777, 4187, 4467, 5104, 5608, 6294, 7155]","[0, 169, 259, 399, 590, 720, 1064, 1253, 1478, 1568, 1755, 1944, 2121, 2621, 2914]","[0, 169, 259, 394, 572, 748, 1139, 1381, 1575, 1739, 1974, 2209, 2299, 3010, 3303]",8075,7713,7155,2914,3303,-1585,-1987,-1336,896,-489,-4501,15,radiant
7542768300,6,106,28,45,20,"[0, 219, 584, 958, 1399, 1748, 2254, 2530, 3282, 3684, 4082, 4984, 5858, 6302, 6834]","[0, 345, 730, 1005, 1322, 1763, 2140, 2435, 2897, 3451, 3863, 4780, 5224, 5683, 6356]","[0, 346, 581, 897, 1104, 1352, 2217, 2555, 2770, 3577, 3801, 4204, 4992, 5460, 6246]","[0, 454, 590, 710, 817, 966, 1437, 1611, 1945, 2398, 2610, 2755, 3230, 3483, 3665]","[0, 186, 382, 551, 641, 817, 1043, 1143, 1440, 1801, 1909, 2335, 2665, 2777, 3125]",6834,6356,6246,3665,3125,36,49,69,121,51,"[0, 698, 968, 1294, 1729, 2372, 2627, 3211, 4198, 4419, 5056, 5671, 6143, 7309, 8047]","[0, 412, 655, 1019, 1341, 1804, 2134, 2750, 3533, 4124, 4672, 5491, 6161, 6523, 6831]","[0, 205, 425, 794, 1078, 1316, 1653, 1977, 2400, 2624, 3350, 3684, 4079, 4744, 5335]","[0, 698, 839, 981, 1368, 1480, 1615, 1977, 2157, 2412, 2756, 3089, 3179, 3693, 3841]","[0, 453, 543, 633, 769, 990, 1080, 1215, 1561, 1696, 1985, 2334, 2424, 2788, 2936]",8047,6831,5335,3841,2936,-1213,-475,911,-176,189,-764,15,dire
7542785507,11,22,28,121,3,"[0, 291, 493, 829, 1184, 1600, 2234, 2910, 3671, 4272, 4903, 5586, 5843, 6470, 6721]","[0, 279, 653, 942, 1232, 1557, 2281, 2885, 3774, 4252, 4716, 5680, 6092, 6736, 7259]","[0, 206, 443, 1115, 1319, 1576, 1950, 2865, 3197, 3564, 4137, 4907, 5619, 6054, 6602]","[0, 318, 408, 829, 1042, 1257, 1494, 1773, 1909, 2436, 2631, 3131, 3421, 4267, 4639]","[0, 169, 277, 412, 740, 898, 1284, 1848, 2089, 2256, 2451, 3203, 3429, 3684, 4571]",6721,7259,6602,4639,4571,128,23,95,20,101,"[0, 243, 456, 796, 955, 1207, 1377, 1633, 2066, 2393, 3286, 3897, 4651, 5496, 6156]","[0, 378, 784, 1189, 1563, 2001, 2495, 3271, 3903, 4458, 4593, 5101, 5225, 5634, 6278]","[0, 249, 543, 684, 1000, 1446, 1748, 1998, 2203, 3217, 4141, 4509, 4684, 4869, 5106]","[0, 169, 259, 499, 875, 1103, 1770, 1905, 1995, 2392, 3212, 3347, 3749, 4034, 4884]","[0, 169, 259, 349, 479, 660, 750, 885, 1085, 1416, 1805, 2020, 2552, 2825, 3477]",6156,6278,5106,4884,3477,565,981,1496,-245,1094,3891,15,radiant
7543000702,55,41,56,106,53,"[0, 246, 619, 1043, 1455, 1697, 2090, 2471, 2686, 3814, 3998, 4397, 5002, 5211, 5638]","[0, 201, 363, 525, 873, 1117, 1321, 1535, 1735, 2197, 2441, 2737, 3424, 3891, 4265]","[0, 129, 400, 611, 765, 890, 1245, 1422, 1626, 2442, 2659, 2960, 3361, 3850, 4193]","[0, 215, 618, 998, 1359, 1782, 1986, 2190, 2657, 3089, 3437, 3665, 4085, 4294, 4547]","[0, 129, 629, 888, 978, 1068, 1158, 1248, 1338, 1941, 2352, 2523, 2905, 3150, 3299]",5638,4265,4193,4547,3299,14,13,29,58,123,"[0, 248, 571, 1194, 1695, 2208, 2724, 3080, 3822, 4433, 5221, 6003, 6933, 7333, 7887]","[0, 296, 694, 1091, 1346, 1641, 2037, 2432, 2853, 3372, 3904, 4752, 5867, 6671, 7009]","[0, 247, 510, 782, 1383, 1593, 2113, 2564, 3228, 3977, 4396, 4934, 5446, 6124, 6475]","[100, 309, 399, 602, 970, 1124, 1321, 1731, 1910, 2244, 2553, 2853, 3452, 4139, 4678]","[0, 209, 323, 429, 673, 807, 1025, 1691, 1946, 2370, 2528, 2997, 3504, 3890, 4122]",7887,7009,6475,4678,4122,-2249,-2744,-2282,-131,-823,-8229,15,dire
7543217005,82,14,80,31,123,"[0, 214, 492, 873, 1273, 1605, 2039, 2501, 2914, 3531, 4295, 5110, 5722, 6737, 6940]","[0, 169, 772, 1197, 1679, 2015, 2824, 3182, 3830, 4432, 5241, 5817, 6342, 6616, 6711]","[0, 212, 520, 768, 1049, 1308, 1665, 2087, 2739, 2916, 3691, 3904, 4839, 5489, 6043]","[0, 176, 357, 493, 645, 738, 1168, 1454, 1791, 2121, 2501, 2678, 2858, 3227, 3322]","[0, 130, 220, 310, 400, 490, 806, 995, 1537, 1759, 2031, 2208, 2388, 2959, 3084]",6940,6711,6043,3322,3084,98,76,28,91,83,"[0, 278, 647, 890, 1491, 1857, 2373, 2698, 3231, 4650, 5554, 6238, 6757, 7170, 8390]","[0, 279, 577, 914, 1463, 1880, 2005, 2373, 2779, 3169, 3637, 4180, 4692, 5553, 6386]","[0, 283, 519, 818, 1155, 1499, 1835, 2085, 2419, 2732, 3141, 3623, 4391, 4904, 5606]","[0, 210, 351, 490, 669, 759, 929, 1019, 1289, 1749, 2117, 2491, 2719, 2946, 3193]","[0, 210, 300, 434, 634, 770, 899, 1402, 1574, 1761, 2337, 2646, 2972, 3173, 3894]",8390,6386,5606,3193,3894,-1450,325,437,129,-810,-1369,15,dire
7543287310,73,46,96,58,26,"[0, 250, 898, 1259, 1509, 2283, 2741, 3254, 4134, 4938, 5453, 6387, 7308, 8433, 9393]","[0, 206, 620, 886, 1275, 1667, 2124, 2530, 2910, 3505, 4445, 5460, 6130, 6878, 7614]","[0, 324, 567, 855, 1142, 1478, 1823, 2453, 3219, 3761, 4513, 5045, 5554, 6462, 6790]","[0, 170, 320, 410, 500, 753, 1161, 1267, 1463, 1676, 1937, 2554, 3056, 3626, 4088]","[0, 170, 260, 350, 577, 703, 861, 951, 1222, 1371, 2028, 2639, 3126, 3660, 3782]",9393,7614,6790,4088,3782,41,74,97,105,19,"[0, 235, 570, 903, 1422, 1794, 2172, 2485, 2768, 3234, 3764, 4244, 4358, 4770, 5076]","[0, 130, 304, 602, 890, 1269, 1671, 2045, 2343, 2706, 3400, 3823, 4242, 4566, 5149]","[0, 168, 505, 1003, 1292, 1657, 2140, 2308, 2597, 2870, 3941, 4574, 4716, 4920, 5208]","[0, 130, 220, 350, 703, 840, 930, 1020, 1302, 1440, 1815, 2089, 2179, 2294, 2893]","[0, 130, 220, 433, 539, 629, 807, 897, 1033, 1123, 1557, 1991, 2081, 2207, 2347]",5076,5149,5208,2893,2347,4317,2465,1582,1195,1435,10994,15,radiant
7544009609,98,46,25,110,20,"[0, 609, 979, 1735, 2044, 2550, 3257, 3587, 4085, 4447, 5456, 6387, 6909, 7523, 8096]","[0, 241, 449, 817, 1269, 1721, 2136, 2771, 3200, 3793, 4395, 5309, 5904, 6206, 6743]","[0, 255, 570, 861, 1174, 1626, 1956, 2085, 2801, 3082, 4098, 4423, 4795, 5212, 5533]","[0, 234, 324, 554, 693, 1071, 1516, 1676, 2050, 2296, 2727, 3481, 3958, 4147, 4740]","[0, 234, 369, 626, 820, 974, 1134, 1351, 1845, 2241, 2668, 2937, 3027, 3122, 3271]",8096,6743,5533,4740,3271,60,114,39,100,119,"[0, 129, 292, 603, 921, 1423, 1851, 2394, 2559, 3071, 3345, 4545, 5104, 5777, 6084]","[0, 201, 363, 566, 1089, 1305, 1561, 1865, 2125, 2487, 2577, 2781, 3353, 3879, 4279]","[0, 164, 398, 667, 952, 1356, 1595, 1941, 2719, 3066, 3289, 3894, 4217, 4758, 5276]","[0, 129, 219, 354, 490, 977, 1497, 1971, 2097, 2278, 2368, 2856, 3083, 3419, 3771]","[0, 129, 219, 309, 475, 682, 854, 989, 1079, 1223, 1349, 1439, 1700, 2036, 2131]",6084,4279,5276,3771,2131,2012,2464,257,969,1140,6842,15,radiant
7544097910,21,70,106,71,14,"[0, 173, 833, 974, 1408, 1694, 2237, 2527, 2785, 3197, 3525, 4047, 4804, 5391, 6841]","[0, 242, 544, 838, 1120, 1553, 1899, 2342, 3002, 3189, 3984, 4444, 5027, 5906, 6093]","[0, 203, 539, 837, 1225, 1735, 2156, 2750, 3332, 3630, 3895, 4614, 5683, 6116, 6764]","[0, 130, 220, 356, 499, 754, 887, 1083, 1218, 1413, 1726, 1919, 2276, 2558, 2929]","[0, 130, 288, 413, 752, 889, 1046, 1286, 1533, 1623, 1713, 1940, 2427, 2709, 3273]",6841,6093,6764,2929,3273,48,7,49,119,27,"[0, 244, 635, 1076, 1476, 1968, 2376, 2976, 3454, 4070, 5062, 5633, 6316, 6721, 7570]","[0, 337, 700, 1027, 1440, 1970, 2215, 2469, 2896, 3243, 3907, 4251, 4772, 5286, 5931]","[0, 245, 408, 806, 1156, 1395, 1774, 2037, 2747, 3003, 3348, 3597, 4136, 4531, 4952]","[0, 210, 300, 390, 566, 744, 874, 964, 1199, 1289, 1469, 2064, 2252, 2503, 3428]","[0, 210, 300, 437, 527, 674, 804, 940, 1078, 1168, 1548, 1759, 2069, 2254, 2503]",7570,5931,4952,3428,2503,-729,162,1812,-499,770,1516,15,radiant
7544133504,114,14,106,85,86,"[0, 170, 454, 875, 1111, 1402, 1756, 2504, 2691, 3214, 3768, 4204, 4487, 4905, 5491]","[0, 248, 489, 935, 1436, 1676, 2235, 2890, 3543, 3890, 4417, 5001, 5405, 5799, 6347]","[0, 287, 650, 995, 1232, 1513, 1726, 2104, 2829, 3213, 4065, 4486, 5107, 5641, 5947]","[0, 257, 717, 982, 1072, 1243, 1614, 1937, 2107, 2345, 2636, 3102, 3801, 4447, 4881]","[0, 468, 558, 748, 916, 1052, 1802, 2281, 2545, 2843, 3044, 3313, 3747, 4318, 4599]",5491,6347,5947,4881,4599,17,102,69,26,100,"[0, 242, 599, 1059, 1497, 1899, 2149, 2563, 2993, 3342, 3942, 4565, 5074, 5624, 6020]","[0, 206, 610, 931, 1333, 1749, 1985, 2313, 2727, 3318, 4117, 4670, 5525, 6137, 6774]","[0, 354, 614, 946, 1596, 2037, 3066, 3245, 3653, 4040, 5183, 5877, 6567, 7159, 7724]","[0, 230, 320, 458, 715, 925, 1281, 1407, 1542, 1677, 1971, 2234, 2848, 2943, 3038]","[0, 498, 588, 727, 873, 1016, 1447, 1537, 1673, 2050, 2356, 2446, 2761, 2856, 2951]",6020,6774,7724,3038,2951,-529,-427,-1777,1843,1648,758,15,dire
7544188709,97,67,98,105,136,"[206, 373, 831, 1426, 1685, 2079, 2465, 3087, 3608, 3810, 4281, 5021, 6046, 6535, 6657]","[206, 371, 941, 1337, 1848, 2104, 2420, 2782, 3177, 3481, 4162, 4402, 4832, 5482, 6192]","[330, 543, 929, 1222, 1486, 1734, 2194, 2551, 2719, 2809, 3281, 3676, 4616, 4997, 5691]","[170, 260, 551, 745, 1148, 1269, 1546, 1907, 2116, 2689, 3240, 3976, 4420, 5362, 5756]","[170, 298, 483, 871, 961, 1446, 1800, 1939, 2078, 2708, 3111, 3448, 3842, 4395, 4770]",6657,6192,5691,5756,4770,76,102,48,64,85,"[244, 858, 1096, 1451, 1941, 2491, 2626, 3265, 3680, 4360, 5467, 6202, 6706, 7327, 8488]","[289, 625, 1034, 1628, 2041, 2553, 2953, 4057, 4315, 4840, 5717, 6343, 6905, 7073, 7222]","[256, 771, 988, 1148, 1589, 1856, 2298, 2701, 3121, 3667, 4214, 5175, 6042, 6793, 7616]","[170, 260, 350, 522, 740, 899, 1051, 1434, 2127, 3075, 3952, 4422, 4922, 5100, 5350]","[170, 456, 585, 924, 1331, 1604, 1739, 2170, 2441, 2801, 3466, 3646, 4106, 4359, 4598]",8488,7222,7616,5350,4598,-1831,-1030,-1925,406,172,-4208,15,dire
7544192417,128,22,81,107,31,"[0, 240, 402, 1245, 1650, 2052, 2500, 2899, 3187, 3862, 4318, 4702, 5564, 6150, 6941]","[0, 402, 697, 1037, 1492, 1982, 2392, 3078, 3811, 4194, 4675, 5199, 5737, 6151, 6511]","[0, 293, 570, 1009, 1379, 1789, 2270, 2576, 2828, 3284, 3652, 4027, 4563, 4977, 5557]","[0, 169, 259, 467, 557, 734, 1148, 1330, 1420, 1869, 2531, 2621, 2820, 3160, 3492]","[0, 179, 279, 458, 605, 781, 960, 1160, 1326, 1509, 2367, 2544, 2769, 2995, 3285]",6941,6511,5557,3492,3285,106,4,64,97,121,"[0, 282, 594, 969, 1391, 1842, 2296, 2832, 3532, 4205, 4759, 4982, 5701, 6246, 6730]","[0, 245, 563, 816, 1229, 1493, 1993, 2355, 2891, 3154, 3394, 3809, 4227, 4673, 4868]","[0, 169, 302, 392, 531, 621, 814, 950, 1318, 1540, 1834, 2731, 3114, 3310, 3734]","[0, 205, 525, 767, 1178, 1508, 1877, 2040, 2492, 2901, 3153, 3454, 3906, 4390, 4716]","[0, 169, 259, 457, 821, 960, 1097, 1187, 1419, 1556, 1726, 2199, 2682, 2914, 3095]",6730,4868,3734,4716,3095,211,1643,1823,-1224,190,2643,15,radiant
7544499316,10,13,69,40,123,"[0, 170, 486, 1029, 1386, 1613, 2060, 2717, 3215, 3805, 4372, 4881, 5541, 5956, 6752]","[0, 253, 465, 860, 1175, 1529, 1906, 2346, 2680, 3141, 3407, 3987, 4415, 4510, 5203]","[0, 204, 592, 759, 1005, 1193, 1560, 1738, 1950, 2288, 2761, 3141, 3644, 4195, 5432]","[0, 514, 604, 694, 830, 929, 1126, 1342, 1432, 1522, 1657, 1747, 1947, 2042, 2196]","[100, 316, 625, 715, 854, 1022, 1312, 1402, 1492, 1705, 2050, 2474, 2654, 2749, 2938]",6752,5203,5432,2196,2938,42,20,53,32,21,"[0, 241, 486, 724, 1157, 1433, 1800, 2332, 2606, 2990, 3437, 3806, 4218, 4907, 5317]","[0, 250, 564, 951, 1235, 1690, 2138, 2592, 2930, 3164, 3697, 3948, 4151, 4661, 5317]","[0, 170, 260, 444, 1026, 1165, 1414, 1641, 1852, 2181, 2801, 3062, 3288, 3527, 3886]","[0, 257, 781, 1140, 1513, 1793, 2195, 2617, 3144, 3737, 4410, 4846, 5201, 5578, 5673]","[0, 170, 260, 350, 533, 756, 930, 1210, 1474, 1692, 2042, 2284, 2395, 2931, 3026]",5317,5317,3886,5673,3026,1435,-114,1546,-3477,-88,-698,15,dire
7545061403,61,93,112,64,100,"[0, 244, 523, 853, 1104, 1620, 2127, 2778, 3470, 3957, 4531, 5121, 5659, 5949, 7102]","[0, 219, 472, 720, 1092, 1303, 1836, 2429, 2807, 3219, 3829, 4219, 4641, 4922, 6547]","[0, 180, 451, 843, 987, 1402, 1679, 2027, 2324, 2612, 3095, 3509, 3839, 4142, 5169]","[0, 130, 468, 605, 743, 1099, 1334, 1604, 1694, 1917, 2128, 2343, 2520, 2649, 3874]","[0, 130, 220, 348, 438, 622, 1071, 1341, 1479, 1696, 1981, 2234, 2363, 2539, 2866]",7102,6547,5169,3874,2866,136,65,71,91,9,"[112, 407, 843, 1213, 1618, 1947, 2368, 2829, 3611, 4029, 5036, 6001, 6440, 7413, 7838]","[245, 524, 728, 1017, 1300, 1702, 1989, 2318, 2961, 3414, 3985, 4551, 5048, 5993, 6340]","[112, 322, 522, 853, 1050, 1337, 1464, 1778, 2147, 2360, 2739, 3292, 3756, 4643, 4979]","[380, 590, 680, 828, 1267, 1357, 1727, 1862, 2171, 2343, 2482, 3018, 3389, 3984, 4236]","[53, 263, 353, 443, 577, 711, 801, 1149, 1239, 1417, 1742, 2285, 2519, 3110, 3559]",7838,6340,4979,4236,3559,-736,207,190,-362,-693,-1394,15,radiant
7545071905,46,69,98,53,26,"[0, 295, 647, 1047, 1369, 1785, 2148, 2588, 3256, 3767, 4618, 5423, 6090, 6591, 6942]","[0, 288, 535, 1034, 1187, 1531, 1812, 2124, 2742, 3258, 3761, 4400, 4923, 5858, 6544]","[0, 333, 649, 1062, 1479, 1854, 2373, 2940, 3233, 4033, 4123, 4917, 5265, 5468, 5979]","[0, 170, 306, 613, 1010, 1220, 1439, 1626, 2114, 2643, 2992, 3348, 3487, 3690, 3784]","[0, 170, 260, 423, 513, 643, 1048, 1138, 1361, 1740, 2041, 2532, 2740, 3139, 3272]",6942,6544,5979,3784,3272,94,23,137,105,72,"[0, 257, 619, 748, 1273, 1917, 2260, 2657, 3011, 3241, 3730, 4606, 5232, 6166, 6953]","[0, 330, 563, 873, 1159, 1438, 1725, 2186, 2590, 3247, 3854, 4950, 5519, 6578, 7142]","[0, 170, 447, 813, 1077, 1543, 1982, 2442, 3234, 3409, 3866, 4365, 5149, 5602, 6105]","[0, 170, 260, 506, 875, 1173, 1551, 1731, 1933, 2437, 2825, 3450, 3706, 4597, 4769]","[0, 170, 600, 808, 1023, 1293, 1383, 1644, 1769, 2148, 2581, 3110, 3294, 4254, 4663]",6953,7142,6105,4769,4663,-11,-598,-126,-985,-1391,-3111,15,dire
7545119608,25,120,47,112,102,"[0, 243, 437, 1076, 1331, 1620, 2019, 2344, 2821, 3369, 3713, 4239, 4853, 5047, 5870]","[0, 282, 536, 833, 1204, 1666, 2120, 2331, 3011, 3298, 3938, 4478, 4750, 5046, 5623]","[0, 239, 441, 771, 1016, 1261, 1747, 1955, 2200, 2495, 2823, 3026, 3366, 3884, 4412]","[0, 471, 609, 747, 877, 1016, 1155, 1326, 1461, 1772, 1906, 2119, 2299, 2394, 2707]","[0, 129, 219, 391, 521, 619, 709, 799, 1356, 1446, 1627, 1717, 1943, 2318, 2680]",5870,5623,4412,2707,2680,15,69,74,86,91,"[0, 453, 702, 902, 1231, 1502, 1753, 2019, 2474, 3082, 3712, 4313, 4885, 5654, 6631]","[0, 281, 538, 773, 1193, 1482, 1678, 1907, 2358, 2769, 3438, 3722, 4617, 5171, 5845]","[0, 291, 527, 874, 1286, 1641, 1770, 2060, 2559, 3001, 3476, 3729, 4251, 4699, 5195]","[0, 209, 337, 638, 773, 941, 1031, 1167, 1412, 1679, 1914, 2098, 2486, 2752, 3086]","[0, 283, 373, 463, 600, 825, 964, 1364, 1467, 1646, 1904, 2070, 2295, 2531, 3009]",6631,5845,5195,3086,3009,-761,-222,-783,-379,-329,-2474,15,dire
7545334814,73,28,19,101,20,"[0, 295, 585, 949, 1242, 1849, 2263, 2913, 3348, 3489, 4272, 5326, 6842, 7831, 8887]","[0, 251, 570, 970, 1384, 1758, 2247, 2952, 3533, 3681, 4181, 4403, 5046, 5519, 6293]","[0, 281, 560, 791, 1185, 1611, 1957, 2290, 2701, 2994, 3174, 3489, 4173, 4784, 5128]","[0, 170, 260, 350, 440, 677, 996, 1131, 1460, 1837, 2275, 2744, 3495, 3902, 4443]","[0, 170, 260, 496, 621, 833, 1003, 1138, 1469, 1559, 1741, 2270, 2719, 2865, 3256]",8887,6293,5128,4443,3256,95,92,90,69,121,"[0, 278, 580, 938, 1238, 1485, 1975, 2573, 2783, 3094, 3658, 4246, 4789, 5315, 5839]","[0, 240, 594, 949, 1387, 1907, 2657, 2855, 3113, 3813, 4545, 5126, 5449, 5954, 6450]","[0, 245, 528, 866, 1124, 1551, 2065, 2472, 2779, 3216, 3612, 4564, 5075, 5640, 5949]","[0, 170, 368, 567, 839, 929, 1284, 1459, 1641, 2031, 2427, 2686, 2893, 3143, 3273]","[0, 553, 643, 1034, 1124, 1214, 1531, 1716, 2051, 2532, 2883, 3063, 3334, 3488, 3645]",5839,6450,5949,3273,3645,3048,-157,-821,1170,-389,2851,15,radiant
7545474417,13,93,80,62,31,"[0, 240, 561, 848, 1250, 1551, 1893, 2186, 2582, 3165, 3603, 4433, 4794, 5829, 5924]","[0, 291, 550, 1016, 1386, 1834, 2084, 2464, 2925, 3450, 3897, 4501, 4914, 5406, 5970]","[0, 296, 607, 955, 1151, 1426, 2272, 2454, 3469, 3888, 4164, 4979, 5800, 6291, 6589]","[100, 269, 384, 504, 664, 799, 934, 1140, 1673, 2002, 2287, 2734, 3343, 3998, 4093]","[0, 169, 284, 449, 654, 837, 1210, 1394, 2145, 2421, 2511, 3084, 3395, 3711, 3806]",5924,5970,6589,4093,3806,48,21,76,74,26,"[0, 208, 447, 741, 1224, 1751, 2605, 3211, 3545, 3732, 4246, 4762, 5474, 6170, 6854]","[0, 280, 594, 950, 1397, 1627, 2249, 2509, 2599, 3335, 3831, 4253, 4343, 5141, 5440]","[0, 203, 403, 731, 988, 1378, 1782, 2254, 2690, 2890, 3016, 3243, 3724, 4741, 5093]","[0, 169, 296, 386, 538, 958, 1251, 1402, 1826, 1992, 2277, 2470, 2599, 3730, 4102]","[0, 169, 601, 735, 912, 1135, 1364, 1499, 1589, 1975, 2358, 2732, 3069, 3540, 3635]",6854,5440,5093,4102,3635,-930,530,1496,-9,171,1258,15,dire
7545480413,42,41,29,71,20,"[0, 317, 676, 998, 1532, 2041, 2640, 3338, 3775, 4463, 5133, 5807, 6544, 7049, 8247]","[0, 325, 610, 859, 1311, 1630, 1933, 2234, 3108, 3535, 3705, 4076, 4379, 4982, 5286]","[0, 205, 368, 649, 983, 1304, 1434, 1813, 2174, 2313, 2599, 2743, 3003, 3413, 3950]","[0, 170, 276, 366, 585, 917, 1103, 1320, 1505, 1595, 1893, 2070, 2198, 2413, 2865]","[0, 170, 260, 396, 486, 576, 706, 886, 1091, 1204, 1339, 1572, 1662, 1856, 2490]",8247,5286,3950,2865,2490,14,54,96,65,45,"[0, 331, 592, 1005, 1388, 2003, 2623, 3163, 3618, 4218, 4769, 5363, 5978, 6637, 7323]","[0, 208, 681, 1298, 1388, 2032, 2460, 2844, 3171, 3594, 3994, 4800, 5382, 5885, 6499]","[0, 237, 533, 857, 1086, 1382, 1792, 2144, 2360, 2726, 3358, 3990, 4714, 5381, 5573]","[0, 170, 306, 505, 645, 1267, 1373, 1757, 1847, 2317, 2426, 2912, 3327, 3888, 4087]","[0, 505, 595, 936, 1225, 1391, 1557, 1951, 2172, 2348, 2521, 2664, 3002, 3589, 4284]",7323,6499,5573,4087,4284,924,-1213,-1623,-1222,-1794,-4928,15,dire
7545494518,39,69,12,19,30,"[1, 656, 1017, 1474, 1871, 2205, 2524, 2903, 3529, 3814, 4241, 4866, 5518, 6566, 7524]","[1, 309, 505, 816, 1534, 1770, 2376, 2970, 3341, 3560, 4024, 4834, 5239, 6306, 6951]","[1, 209, 501, 728, 852, 1148, 1483, 1811, 2044, 2253, 2738, 3413, 3775, 4641, 5227]","[1, 235, 325, 415, 766, 1024, 1220, 1355, 1519, 1621, 1979, 2417, 2583, 2980, 3204]","[1, 235, 359, 621, 711, 868, 1003, 1216, 1417, 1507, 1697, 1877, 1967, 2454, 2785]",7524,6951,5227,3204,2785,96,70,13,26,22,"[1, 249, 447, 985, 1668, 2131, 2497, 3020, 3462, 3950, 4415, 4828, 5299, 5786, 6362]","[1, 324, 655, 1096, 1336, 1986, 2110, 2440, 3144, 3390, 3708, 3980, 4619, 4965, 5405]","[1, 220, 467, 662, 1037, 1535, 1746, 1956, 2329, 2743, 3302, 3512, 3877, 4006, 4101]","[1, 170, 260, 631, 919, 1027, 1251, 1386, 1602, 1766, 1992, 2082, 2219, 2314, 2494]","[1, 170, 260, 379, 549, 674, 764, 979, 1069, 1159, 1378, 1526, 1690, 1835, 1930]",6362,5405,4101,2494,1930,1162,1546,1126,710,855,5399,15,radiant
7545503107,48,129,86,123,45,"[0, 204, 484, 748, 988, 1362, 1808, 2067, 2523, 2875, 3263, 3710, 4219, 4880, 5420]","[0, 201, 448, 1008, 1326, 1737, 2026, 2188, 2678, 2958, 3336, 3581, 3871, 4280, 4730]","[0, 322, 634, 964, 1460, 1956, 2387, 2601, 3088, 3592, 3983, 4121, 4420, 5112, 5341]","[0, 230, 320, 475, 565, 655, 1012, 1107, 1197, 1669, 2010, 2170, 2410, 2730, 2841]","[0, 130, 220, 581, 671, 807, 992, 1082, 1172, 1484, 1619, 1709, 1804, 2487, 2597]",5420,4730,5341,2841,2597,73,17,33,71,26,"[0, 330, 615, 896, 1153, 1650, 2207, 2818, 3430, 4133, 4818, 5482, 6065, 7247, 8278]","[0, 357, 809, 1187, 1615, 2139, 2521, 3260, 3802, 4515, 5093, 5867, 6685, 7196, 7691]","[0, 316, 495, 839, 1047, 1238, 1436, 1780, 2254, 2748, 3078, 3598, 4352, 4874, 5228]","[0, 210, 336, 426, 634, 802, 916, 1488, 1578, 1977, 2278, 2939, 3640, 4007, 4605]","[0, 210, 334, 444, 619, 798, 888, 1587, 1697, 1948, 2127, 2545, 2913, 3277, 3433]",8278,7691,5228,4605,3433,-2858,-2961,113,-1764,-836,-8306,15,dire
7545586112,43,11,102,86,121,"[0, 253, 572, 943, 1124, 2057, 2319, 2648, 3169, 3433, 3902, 4528, 5296, 6010, 7555]","[0, 399, 811, 1064, 1494, 1868, 2349, 2844, 3613, 4080, 4548, 5494, 6281, 7201, 7475]","[0, 336, 499, 776, 954, 1328, 1523, 1897, 2278, 2918, 3218, 3824, 4416, 4784, 5143]","[0, 210, 346, 436, 556, 848, 938, 1028, 1757, 2319, 2409, 3526, 3808, 4128, 4654]","[0, 210, 300, 439, 529, 701, 1019, 1265, 1586, 1970, 2108, 2576, 2876, 3150, 3607]",7555,7475,5143,4654,3607,21,82,114,30,100,"[0, 304, 774, 1152, 1630, 2172, 2551, 3269, 3862, 4359, 5330, 5817, 6102, 6538, 7870]","[0, 173, 423, 547, 681, 956, 1371, 1506, 1942, 2672, 3387, 3884, 4231, 4544, 5064]","[0, 205, 330, 716, 845, 1015, 1364, 1607, 2136, 2973, 3456, 3762, 3931, 4298, 4880]","[0, 466, 556, 726, 848, 1018, 1208, 1370, 1869, 2485, 2748, 2838, 2964, 3069, 3723]","[0, 198, 363, 453, 638, 808, 945, 1425, 1707, 1974, 2237, 2363, 2681, 2821, 2915]",7870,5064,4880,3723,2915,-315,2411,263,931,692,3982,15,radiant
7545622003,74,78,41,105,50,"[0, 386, 514, 1001, 1170, 1387, 1678, 2176, 2266, 2565, 3277, 3568, 3862, 4814, 5115]","[0, 309, 748, 1314, 1533, 1820, 2035, 2425, 2878, 3559, 3948, 4373, 4597, 5177, 5486]","[0, 229, 487, 772, 1026, 1116, 1343, 1574, 1664, 1912, 2342, 2645, 2904, 3167, 3416]","[0, 497, 661, 825, 915, 1005, 1095, 1272, 1362, 1542, 1778, 1868, 1981, 2228, 2514]","[0, 229, 353, 526, 633, 723, 813, 990, 1080, 1260, 1680, 1911, 2141, 2425, 2896]",5115,5486,3416,2514,2896,2,46,43,123,53,"[0, 243, 850, 1275, 1685, 2665, 3039, 3526, 4259, 4974, 5227, 5728, 6358, 7326, 8289]","[0, 205, 400, 694, 975, 1370, 1752, 2357, 2808, 3234, 4181, 4681, 5237, 5826, 6241]","[0, 241, 456, 761, 1136, 1702, 2065, 2553, 3504, 3975, 4411, 4916, 5046, 5307, 5899]","[100, 316, 627, 828, 1135, 1407, 1617, 1912, 2204, 2482, 2764, 2854, 2963, 3788, 4102]","[0, 208, 314, 420, 577, 753, 890, 1067, 1452, 1632, 1865, 2110, 2200, 2833, 3361]",8289,6241,5899,4102,3361,-3174,-755,-2483,-1588,-465,-8465,15,dire
7545626504,46,21,41,14,64,"[54, 275, 588, 1068, 1377, 1863, 2504, 3209, 4353, 5179, 5889, 6633, 7155, 7958, 9003]","[54, 450, 711, 1119, 1748, 2069, 2597, 2838, 3323, 3778, 4641, 5340, 5600, 6205, 6579]","[54, 297, 463, 870, 1194, 1444, 1779, 2003, 2721, 3234, 3656, 4082, 4524, 5186, 5618]","[54, 281, 405, 655, 858, 948, 1375, 1681, 2285, 2587, 3128, 3218, 3400, 3744, 3941]","[322, 491, 581, 820, 990, 1098, 1188, 1472, 1832, 2080, 2841, 3067, 3307, 4037, 4187]",9003,6579,5618,3941,4187,42,29,53,106,26,"[0, 242, 494, 793, 958, 1293, 1531, 2181, 2411, 2501, 2781, 3173, 3633, 3994, 4534]","[0, 243, 525, 778, 986, 1481, 1764, 2236, 2326, 2580, 3225, 3901, 4356, 4590, 5807]","[0, 213, 303, 672, 919, 1272, 1413, 1956, 2046, 2270, 2942, 3557, 4047, 4335, 4932]","[0, 279, 586, 758, 1032, 1352, 1550, 1899, 2028, 2380, 2737, 3204, 3373, 3767, 4191]","[0, 169, 259, 671, 786, 921, 1011, 1339, 1429, 1519, 1748, 2089, 2321, 2461, 2885]",4534,5807,4932,4191,2885,4469,772,686,-250,1302,6979,15,radiant
7545665209,138,60,74,85,51,"[119, 363, 671, 951, 1493, 1939, 2117, 2620, 3051, 3509, 3933, 4447, 4727, 5237, 6280]","[119, 369, 709, 1062, 1264, 1633, 1961, 2286, 2632, 2761, 3191, 3583, 3673, 3767, 4575]","[252, 461, 691, 854, 1175, 1776, 2088, 2764, 3120, 3294, 3435, 3878, 4372, 4599, 5347]","[387, 557, 782, 872, 1116, 1206, 1418, 1881, 2033, 2234, 2324, 2579, 2669, 2901, 3512]","[59, 229, 349, 486, 593, 749, 879, 1014, 1104, 1194, 1284, 1472, 1766, 1971, 2423]",6280,4575,5347,3512,2423,123,76,19,86,97,"[72, 240, 590, 909, 1199, 1409, 1823, 2907, 3519, 4102, 4922, 5327, 6016, 6762, 7015]","[72, 275, 631, 880, 1355, 1676, 2075, 2299, 2801, 3447, 4322, 4592, 5175, 5976, 6251]","[72, 202, 327, 462, 679, 809, 899, 989, 1213, 1474, 1875, 1965, 2609, 2971, 3269]","[205, 335, 460, 550, 720, 907, 1033, 1677, 1942, 2175, 2814, 2904, 3249, 4043, 4176]","[72, 236, 646, 812, 1119, 1249, 1571, 1735, 1870, 2026, 2465, 2876, 3225, 3834, 4016]",7015,6251,3269,4176,4016,-735,-1676,2078,-664,-1593,-2590,15,dire
7545688814,48,13,53,79,20,"[0, 323, 688, 975, 1248, 1540, 2265, 3029, 3580, 3707, 4379, 5037, 5626, 6609, 7058]","[0, 261, 500, 720, 1083, 1380, 1953, 2557, 2776, 3027, 3750, 4187, 4844, 5380, 5987]","[0, 333, 700, 1109, 1360, 1938, 2222, 2706, 2998, 3623, 4156, 4510, 5058, 5897, 6057]","[0, 311, 401, 491, 629, 767, 1066, 1301, 1700, 2022, 2332, 3156, 3274, 3821, 3916]","[0, 210, 317, 452, 542, 1024, 1236, 1677, 2038, 2208, 2344, 2831, 2921, 3282, 3377]",7058,5987,6057,3916,3377,44,17,14,128,37,"[0, 239, 525, 903, 1110, 1446, 1812, 1947, 2765, 2903, 3390, 3536, 3936, 4223, 4580]","[0, 213, 521, 707, 1155, 1525, 1756, 2266, 2951, 3133, 3718, 4072, 4464, 4891, 5299]","[0, 166, 488, 689, 896, 1409, 2056, 2477, 2901, 3669, 4070, 4421, 4766, 5536, 5939]","[0, 230, 320, 410, 547, 810, 900, 1157, 1410, 1755, 2330, 2521, 2657, 3279, 3459]","[0, 130, 220, 781, 871, 1041, 1131, 1266, 1814, 1942, 2463, 2639, 2819, 2958, 3227]",4580,5299,5939,3459,3227,2478,688,118,457,150,3891,15,radiant
7545749916,48,54,21,86,14,"[0, 243, 773, 1270, 1519, 1964, 2811, 2984, 3230, 3462, 3898, 4665, 5323, 5869, 6391]","[0, 170, 425, 707, 987, 1394, 1685, 2201, 2442, 2739, 3204, 3697, 4078, 4476, 5139]","[0, 251, 549, 973, 1296, 1700, 2196, 2771, 3110, 3759, 4756, 4926, 5673, 6116, 6897]","[0, 170, 260, 397, 696, 884, 974, 1242, 1387, 1562, 2204, 2958, 3378, 3806, 4367]","[0, 170, 328, 765, 855, 1050, 1433, 1662, 1925, 2157, 2544, 2714, 3261, 3673, 4177]",6391,5139,6897,4367,4177,120,25,98,103,26,"[0, 313, 513, 1003, 1333, 1655, 1994, 2354, 2787, 3459, 4369, 4858, 5364, 5899, 6644]","[0, 261, 464, 919, 1460, 1974, 2184, 2840, 3195, 4289, 4658, 5590, 6546, 6711, 7398]","[0, 170, 329, 678, 963, 1313, 1701, 2038, 2360, 2797, 3078, 3294, 3384, 3629, 4093]","[0, 170, 260, 394, 484, 649, 739, 1213, 1303, 1618, 1806, 2084, 2340, 2520, 2869]","[0, 170, 260, 350, 529, 742, 832, 1060, 1197, 1430, 1877, 2204, 2521, 2669, 2866]",6644,7398,4093,2869,2866,-253,-2259,2804,1498,1311,3101,15,radiant
7545759506,63,106,9,129,85,"[0, 246, 648, 946, 1156, 1700, 1911, 2241, 2709, 3108, 3517, 4092, 4246, 5021, 5346]","[0, 260, 468, 795, 1088, 1214, 1348, 1893, 2494, 3086, 3462, 4049, 4521, 4957, 5210]","[0, 210, 635, 825, 1118, 1263, 1400, 1796, 2290, 2929, 3233, 4041, 4267, 4695, 4950]","[0, 331, 740, 1023, 1260, 1388, 1699, 1859, 2039, 2168, 2766, 3100, 3458, 3800, 4230]","[0, 210, 300, 472, 562, 903, 1079, 1169, 1639, 1907, 2042, 2518, 2725, 2996, 3090]",5346,5210,4950,4230,3090,10,53,114,136,100,"[0, 155, 326, 582, 1055, 1548, 2118, 2574, 3329, 3720, 4256, 4606, 5256, 5778, 6594]","[0, 266, 437, 634, 1002, 1235, 1709, 2396, 2935, 3278, 3840, 4688, 5384, 6072, 6572]","[0, 244, 489, 883, 1226, 1554, 2053, 2393, 2691, 2781, 3148, 3238, 4171, 4449, 4768]","[0, 155, 245, 335, 425, 515, 1035, 1485, 1575, 1665, 1755, 1922, 2288, 2545, 2803]","[0, 155, 245, 335, 710, 833, 1067, 1242, 1458, 1548, 1638, 1805, 2075, 2332, 2678]",6594,6572,4768,2803,2678,-1248,-1362,182,1427,412,-589,15,radiant
7545796214,82,101,71,137,45,"[214, 489, 857, 1133, 1352, 1715, 2070, 3034, 3774, 4628, 5296, 5969, 6816, 7553, 8771]","[170, 490, 794, 1040, 1250, 1751, 2501, 2944, 3495, 3993, 4500, 5267, 5506, 6214, 6468]","[170, 374, 891, 1197, 1374, 1867, 2343, 3021, 3467, 3788, 4285, 4721, 5092, 5551, 5983]","[205, 437, 792, 993, 1356, 1613, 2149, 2473, 2791, 3348, 3722, 4070, 4727, 4999, 5238]","[170, 260, 399, 546, 636, 855, 1178, 1340, 2234, 2554, 2967, 3114, 3784, 3878, 4076]",8771,6468,5983,5238,4076,23,95,13,107,105,"[170, 405, 602, 1097, 1373, 1763, 2183, 2681, 3221, 3329, 3954, 4253, 4738, 5058, 5411]","[247, 534, 1048, 1427, 1702, 2102, 2506, 2825, 3138, 3432, 3622, 3867, 4127, 4515, 4774]","[289, 749, 992, 1364, 1612, 1877, 2056, 2355, 2731, 2857, 3545, 3635, 3967, 4086, 4401]","[220, 356, 490, 665, 755, 1068, 1158, 1293, 1574, 1954, 2339, 2549, 2968, 3271, 3454]","[170, 260, 424, 554, 644, 779, 1124, 1259, 1470, 1698, 1926, 2357, 2452, 2546, 2641]",5411,4774,4401,3454,2641,3360,1694,1582,1784,1435,9855,15,radiant
7545850405,69,14,22,123,20,"[215, 537, 627, 947, 1447, 1636, 2032, 2615, 2918, 3900, 4427, 5473, 6590, 7281, 8271]","[277, 581, 1012, 1413, 1925, 2448, 2985, 3602, 4233, 4860, 5523, 6197, 6836, 7492, 8033]","[348, 704, 994, 1383, 1775, 2222, 2576, 3239, 3763, 4095, 5011, 5480, 5677, 6511, 7048]","[348, 652, 742, 928, 1304, 1572, 1797, 2091, 2284, 2644, 2824, 3347, 4054, 4617, 4819]","[215, 785, 1095, 1276, 1515, 1693, 1899, 2059, 2194, 2329, 2674, 2898, 3275, 3598, 3800]",8271,8033,7048,4819,3800,109,106,97,19,26,"[186, 470, 1058, 1282, 2111, 2400, 2685, 2986, 3275, 3530, 3772, 4029, 4653, 5124, 5665]","[454, 767, 1051, 1375, 1626, 2265, 2587, 3257, 3840, 4145, 4617, 4941, 5641, 5860, 6240]","[250, 494, 777, 1013, 1312, 1479, 1894, 2066, 2506, 2842, 3259, 3688, 4191, 4660, 4873]","[319, 603, 693, 783, 873, 1003, 1236, 1371, 1573, 1663, 1753, 1887, 2270, 2644, 2857]","[186, 559, 733, 823, 1116, 1249, 1339, 1590, 1806, 1981, 2117, 2253, 2909, 3124, 3518]",5665,6240,4873,2857,3518,2606,1793,2175,1962,282,8818,15,radiant
7545918303,48,17,98,92,79,"[1852, 2106, 2534, 2856, 3307, 3716, 4073, 4500, 5225, 5355, 6015, 6477, 7094, 7860, 9273]","[2026, 2484, 2845, 3020, 3670, 3997, 4260, 5139, 5234, 5328, 5679, 6023, 6912, 7437, 8107]","[969, 1149, 1547, 1833, 2202, 2616, 3031, 3409, 3934, 4028, 4549, 4644, 4956, 5476, 6136]","[1558, 1797, 2469, 2639, 3336, 3640, 3765, 4222, 4390, 4484, 4609, 5253, 5529, 5721, 6234]","[1162, 1342, 1791, 2118, 2694, 2945, 3059, 3420, 3561, 3694, 3909, 4231, 4408, 4718, 5188]",9273,8107,6136,6234,5188,21,112,106,72,105,"[2412, 3015, 3386, 4359, 4951, 5441, 5997, 6307, 6989, 8171, 8898, 9905, 10645, 11504, 12224]","[1558, 2131, 2365, 2822, 3300, 3624, 4197, 4922, 5535, 6292, 6945, 7928, 9111, 9761, 10342]","[1369, 1664, 2435, 2970, 3625, 4090, 4692, 5269, 6354, 7000, 7710, 8066, 8427, 9013, 9410]","[865, 1020, 1203, 1698, 2436, 2571, 2661, 2862, 3363, 3759, 4067, 4655, 4750, 5017, 5969]","[826, 916, 1109, 1686, 1907, 2246, 2336, 2767, 3445, 3800, 4231, 4601, 4827, 5148, 5440]",12224,10342,9410,5969,5440,-2951,-2235,-3274,265,-252,-8447,15,dire
7546267004,74,38,70,21,26,"[0, 295, 577, 946, 1271, 1647, 1935, 2341, 2790, 3630, 3882, 4243, 4872, 5477, 6178]","[0, 283, 518, 879, 1187, 1553, 1853, 2020, 2195, 3011, 3443, 4052, 4453, 5412, 6108]","[0, 209, 523, 768, 1091, 1425, 1620, 2131, 2582, 3015, 3383, 3473, 3686, 4350, 4801]","[0, 209, 299, 483, 635, 802, 969, 1143, 1279, 1612, 1968, 2058, 2260, 2497, 2988]","[0, 209, 341, 431, 541, 675, 765, 855, 990, 1584, 1764, 1996, 2198, 2533, 2747]",6178,6108,4801,2988,2747,25,102,32,58,3,"[0, 234, 569, 952, 1283, 1606, 1978, 2470, 2900, 3128, 3595, 4186, 4779, 6388, 7149]","[0, 220, 485, 885, 1230, 1393, 1837, 2051, 2461, 2717, 3269, 3618, 4481, 4962, 5197]","[0, 168, 330, 457, 744, 962, 1496, 1670, 2197, 2373, 2542, 2893, 3218, 3865, 4047]","[0, 129, 219, 309, 399, 489, 734, 869, 1049, 1186, 1487, 1631, 1923, 2171, 2353]","[0, 129, 219, 354, 559, 649, 1196, 1368, 1458, 1548, 1956, 2100, 2667, 2835, 3017]",7149,5197,4047,2353,3017,-971,911,754,635,-270,1059,15,radiant
7546556801,98,43,109,83,112,"[0, 283, 840, 1087, 1629, 1940, 2105, 2595, 3009, 3669, 4224, 4850, 5667, 5851, 6379]","[0, 232, 442, 862, 1189, 1564, 1945, 2834, 3082, 3262, 3757, 4312, 4824, 5738, 6231]","[0, 209, 514, 796, 1371, 1671, 1798, 2428, 2819, 3419, 3893, 4471, 4850, 5144, 5609]","[0, 129, 219, 309, 470, 560, 650, 1098, 1188, 1501, 1684, 2023, 2191, 2883, 3023]","[0, 129, 314, 404, 583, 673, 763, 1089, 1226, 1406, 1718, 2200, 2290, 2580, 2720]",6379,6231,5609,3023,2720,72,60,36,91,121,"[0, 320, 758, 1048, 1380, 1669, 2140, 2737, 3005, 3694, 4087, 4868, 5543, 6727, 7316]","[0, 246, 564, 809, 984, 1357, 1812, 2243, 2741, 3403, 3857, 4086, 4803, 5361, 5957]","[0, 366, 723, 1103, 1398, 1488, 1700, 1912, 2549, 3088, 3583, 3980, 4335, 4967, 5520]","[0, 209, 533, 671, 801, 891, 1207, 1400, 1675, 2394, 2508, 2693, 2961, 3503, 3770]","[0, 209, 299, 426, 556, 693, 1088, 1253, 1520, 1841, 2015, 2105, 2323, 2585, 2888]",7316,5957,5520,3770,2888,-937,274,89,-747,-168,-1489,15,radiant
7546718402,89,102,137,26,45,"[0, 251, 418, 777, 1100, 1441, 1696, 2044, 2369, 2871, 3318, 3754, 4183, 5016, 5732]","[0, 212, 488, 903, 1359, 1814, 2413, 2858, 3308, 4075, 4531, 4984, 5623, 6244, 6721]","[0, 249, 611, 1023, 1404, 2006, 2454, 2856, 3285, 3636, 3981, 4564, 5214, 5720, 6387]","[0, 130, 432, 649, 779, 886, 1041, 1221, 1442, 1855, 1990, 2098, 2505, 2957, 3051]","[0, 130, 220, 401, 563, 698, 788, 1013, 1305, 1523, 1704, 2109, 2328, 2835, 3128]",5732,6721,6387,3051,3128,39,93,129,123,119,"[0, 305, 594, 1054, 1406, 1652, 2104, 2637, 3064, 3409, 3971, 4454, 5080, 5746, 6419]","[0, 280, 408, 698, 879, 1083, 1435, 1709, 1983, 2235, 2708, 3219, 3486, 4086, 4806]","[0, 569, 732, 1085, 1371, 1664, 2440, 2775, 3409, 3892, 4272, 4727, 5240, 5766, 6025]","[0, 265, 406, 496, 626, 716, 938, 1111, 1363, 1721, 2088, 2203, 2293, 2499, 2639]","[0, 265, 391, 562, 692, 782, 872, 996, 1086, 1285, 1475, 1650, 1871, 2014, 2261]",6419,4806,6025,2639,2261,-687,1915,362,412,867,2869,15,dire
7546861308,48,38,19,45,136,"[0, 239, 617, 1003, 1197, 1425, 1563, 1872, 2098, 2641, 3057, 3553, 4480, 5363, 5963]","[0, 204, 368, 647, 927, 1068, 1459, 1925, 2331, 3005, 3451, 3983, 4554, 5600, 6252]","[0, 330, 647, 1001, 1372, 1535, 1954, 2804, 3145, 4032, 4313, 4720, 5555, 6102, 6414]","[0, 219, 346, 480, 570, 660, 1092, 1478, 1873, 2089, 2570, 3269, 3993, 4354, 4599]","[0, 170, 481, 571, 661, 751, 973, 1263, 1611, 1835, 1970, 2241, 2878, 3330, 3424]",5963,6252,6414,4599,3424,109,96,13,100,26,"[0, 284, 821, 1250, 1582, 2151, 2666, 3199, 3449, 3679, 4178, 4785, 5251, 5976, 6601]","[0, 215, 487, 761, 1274, 2043, 2581, 2987, 3465, 4092, 4630, 4936, 5250, 5619, 5988]","[0, 282, 576, 785, 1162, 1448, 1890, 2316, 2524, 2886, 3245, 3335, 3680, 3835, 4068]","[0, 170, 328, 465, 639, 840, 978, 1147, 1237, 1372, 1716, 1806, 1911, 2006, 2154]","[0, 170, 471, 561, 725, 974, 1138, 1228, 1318, 1637, 1772, 1862, 1998, 2169, 2419]",6601,5988,4068,2154,2419,-638,264,2346,2445,1005,5422,15,radiant
7546973501,94,43,7,83,100,"[604, 816, 1397, 1840, 2344, 2683, 3277, 3753, 4231, 4823, 5427, 6173, 7307, 7845, 8888]","[619, 867, 1126, 1299, 1515, 1959, 2481, 2999, 3782, 4282, 4867, 5528, 6491, 6806, 7529]","[536, 842, 1173, 1512, 2052, 2552, 3120, 3690, 4330, 4916, 5416, 5872, 6231, 6620, 7339]","[285, 375, 545, 635, 770, 1183, 1870, 2036, 2306, 2741, 3104, 3253, 3685, 4174, 4888]","[321, 411, 515, 605, 895, 1243, 1464, 1871, 2189, 2822, 3068, 3217, 3565, 3732, 4078]",8888,7529,7339,4888,4078,48,13,102,20,103,"[589, 924, 1275, 1600, 2022, 2262, 2664, 2968, 3324, 3414, 3971, 4166, 4916, 5813, 6620]","[453, 664, 995, 1365, 1857, 2185, 2785, 3048, 3301, 3513, 3866, 4313, 5398, 6002, 6648]","[901, 1134, 1366, 1627, 1944, 2358, 2587, 3090, 3319, 3627, 4208, 4761, 5131, 5457, 5944]","[370, 685, 818, 908, 1143, 1356, 1880, 1970, 2060, 2150, 2303, 2398, 2783, 2917, 3429]","[322, 412, 522, 646, 1038, 1414, 1718, 1808, 1898, 1988, 2078, 2211, 2547, 2849, 3173]",6620,6648,5944,3429,3173,2268,881,1395,1459,905,6908,15,radiant
7547188716,61,41,14,47,31,"[403, 858, 1023, 1467, 1716, 2166, 2419, 2934, 3253, 3601, 3914, 4631, 5423, 6361, 7045]","[498, 817, 1322, 1887, 2233, 2608, 3214, 4032, 4616, 5273, 5808, 6162, 6435, 7039, 7648]","[360, 450, 581, 795, 1236, 1549, 1954, 2245, 2629, 3329, 3765, 4324, 5417, 5825, 6272]","[405, 654, 783, 1113, 1323, 1774, 1864, 2270, 2479, 2839, 3195, 3593, 4055, 4573, 4923]","[259, 349, 485, 648, 1073, 1293, 1460, 1790, 1969, 2357, 2588, 3061, 3246, 3448, 3734]",7045,7648,6272,4923,3734,10,23,99,30,105,"[613, 860, 1154, 1480, 1827, 2227, 2667, 2837, 3196, 3593, 3930, 4464, 5218, 5758, 6289]","[648, 863, 1160, 1523, 1822, 2337, 2754, 3254, 3825, 4292, 4613, 4956, 6282, 6376, 6945]","[538, 949, 1217, 1561, 2000, 2286, 2792, 3000, 3246, 3573, 3840, 4445, 4757, 5031, 5591]","[259, 349, 439, 573, 908, 998, 1265, 1355, 1535, 1662, 1770, 2120, 2963, 3057, 3314]","[259, 394, 531, 665, 803, 942, 1125, 1215, 1400, 1525, 1696, 2031, 2266, 2490, 2703]",6289,6945,5591,3314,2703,756,703,681,1609,1031,4780,15,radiant
7547237916,109,69,120,53,100,"[604, 999, 1863, 2190, 2452, 2848, 3046, 3649, 4291, 4729, 6122, 6638, 7237, 7816, 8546]","[418, 716, 1009, 1150, 1585, 2070, 2572, 3198, 3881, 4430, 4912, 6037, 6605, 7535, 8448]","[530, 907, 1348, 1795, 2485, 2942, 3568, 3912, 4648, 5199, 5671, 6439, 6794, 7704, 8008]","[318, 473, 934, 1024, 1257, 1748, 2031, 2364, 2949, 3228, 3370, 3696, 4175, 5027, 5438]","[300, 436, 614, 704, 1426, 1692, 1911, 2001, 2371, 2551, 2760, 3118, 3364, 4025, 4183]",8546,8448,8008,5438,4183,138,43,88,14,91,"[902, 1385, 1775, 2375, 2705, 3031, 3376, 3685, 4062, 4507, 4979, 5110, 5545, 5792, 6399]","[502, 715, 959, 1433, 2314, 2797, 3413, 3746, 4080, 4505, 5255, 5708, 6117, 6537, 6680]","[577, 886, 1220, 1397, 1902, 2416, 2623, 3149, 3828, 4253, 4437, 4950, 5195, 5745, 5840]","[397, 487, 577, 794, 1108, 1198, 1411, 1598, 1953, 2133, 2417, 2681, 2989, 3198, 3293]","[290, 442, 576, 1022, 1382, 1726, 1816, 2004, 2303, 2483, 2767, 3004, 3306, 3515, 3681]",6399,6680,5840,3293,3681,2147,1768,2168,2145,502,8730,15,radiant
7547312807,89,106,16,105,45,"[243, 530, 934, 1145, 1540, 1906, 2322, 2834, 3322, 3931, 4566, 5685, 6367, 6560, 7320]","[243, 412, 700, 1139, 1949, 2288, 2496, 2924, 3727, 4192, 4787, 5138, 5882, 6227, 6633]","[170, 442, 655, 866, 1080, 1334, 1579, 1706, 1983, 2238, 2328, 3010, 3697, 4099, 4616]","[170, 309, 399, 489, 690, 1161, 1508, 1719, 2206, 2876, 3147, 3746, 4241, 4336, 4542]","[170, 260, 350, 440, 882, 1018, 1150, 1261, 1583, 2133, 2556, 2849, 3501, 3748, 4100]",7320,6633,4616,4542,4100,102,11,80,88,64,"[389, 750, 984, 1550, 1831, 2527, 3077, 3454, 3907, 4388, 5220, 5496, 6249, 7259, 7952]","[464, 749, 998, 1505, 1843, 2470, 3394, 4036, 4304, 4894, 5330, 5887, 6144, 6994, 7667]","[208, 453, 701, 951, 1165, 1614, 1924, 2153, 2761, 3094, 3664, 4098, 4505, 5398, 5958]","[232, 322, 509, 685, 793, 928, 1572, 1771, 1906, 2068, 2248, 2422, 2625, 2973, 3067]","[500, 590, 717, 885, 975, 1234, 1459, 1664, 1754, 1939, 2164, 2335, 2691, 3034, 3128]",7952,7667,5958,3067,3128,-632,-1034,-1342,1475,972,-561,15,radiant
7547411814,73,120,96,66,123,"[287, 557, 854, 988, 1386, 1928, 2432, 2806, 3261, 4058, 4833, 5319, 6204, 7061, 8014]","[259, 510, 919, 1387, 1720, 2232, 2711, 3314, 3891, 4357, 4816, 4952, 5617, 6375, 6561]","[246, 738, 1084, 1463, 1844, 2395, 2961, 3416, 3705, 4358, 4787, 4877, 5206, 5301, 5797]","[169, 259, 454, 605, 757, 929, 1131, 1284, 1529, 1781, 2140, 2594, 3085, 3253, 3649]","[169, 334, 543, 668, 895, 1106, 1634, 1828, 1918, 2053, 2279, 2369, 2546, 2902, 3044]",8014,6561,5797,3649,3044,9,89,74,86,26,"[202, 445, 899, 1242, 1474, 2027, 2465, 2879, 3359, 3913, 4371, 5093, 5681, 6258, 6857]","[167, 655, 1413, 1643, 1815, 2158, 2591, 3143, 3769, 4391, 5011, 6091, 6567, 7078, 7785]","[211, 465, 780, 1143, 1511, 1795, 2043, 2603, 3030, 3719, 4164, 5360, 5653, 6224, 6994]","[129, 269, 465, 555, 738, 876, 1203, 1423, 1513, 1788, 1988, 2506, 2709, 3012, 3376]","[129, 424, 727, 864, 954, 1049, 1227, 1410, 1500, 1724, 1924, 2408, 2633, 2826, 2970]",6857,7785,6994,3376,2970,1157,-1224,-1197,273,74,-917,15,radiant
7547417213,10,106,69,86,121,"[260, 497, 820, 1139, 1501, 1805, 2120, 2426, 2696, 3240, 3689, 4253, 5118, 5720, 6548]","[293, 777, 1055, 1318, 1774, 2271, 2715, 3127, 3627, 4127, 4693, 4876, 6146, 6653, 7205]","[274, 580, 917, 1482, 1818, 2116, 2365, 2805, 3491, 4008, 4686, 4869, 5539, 5865, 6243]","[170, 642, 784, 988, 1118, 1358, 1618, 1708, 1962, 2127, 2299, 2671, 3381, 3524, 3882]","[170, 310, 400, 661, 1036, 1248, 1555, 1911, 2117, 2585, 2788, 2971, 3300, 3648, 3906]",6548,7205,6243,3882,3906,94,60,107,20,45,"[204, 506, 893, 1233, 1671, 2009, 2260, 2679, 3130, 3785, 4239, 4907, 5497, 6328, 6975]","[247, 621, 911, 1196, 1355, 1802, 2208, 2682, 3146, 3672, 4079, 5051, 5409, 5811, 6025]","[213, 461, 710, 1197, 1598, 1976, 2273, 2726, 3016, 3635, 3990, 4831, 5278, 5641, 6095]","[170, 260, 655, 785, 875, 1084, 1223, 1313, 1602, 2068, 2250, 3112, 3374, 3523, 3617]","[170, 260, 439, 613, 751, 905, 995, 1085, 1504, 1789, 1934, 2496, 2663, 2908, 3012]",6975,6025,6095,3617,3012,-427,1180,148,265,894,2060,15,radiant
7547476916,59,93,28,21,20,"[215, 534, 922, 1665, 2118, 2456, 3008, 3860, 4534, 5135, 6105, 6242, 6986, 7439, 8285]","[253, 491, 936, 1261, 1559, 1959, 2342, 2834, 3487, 4037, 4707, 5005, 5628, 6396, 7208]","[207, 575, 897, 1265, 1474, 1811, 2470, 2839, 3409, 3636, 4405, 5088, 5898, 6319, 7201]","[170, 346, 436, 619, 776, 911, 1079, 1382, 1802, 2010, 2190, 2516, 3214, 3393, 3722]","[272, 398, 537, 671, 761, 896, 1124, 1304, 1565, 1909, 2193, 2331, 2624, 2737, 2922]",8285,7208,7201,3722,2922,82,13,55,123,31,"[330, 498, 1091, 1325, 1657, 2295, 2753, 2843, 3239, 4080, 4565, 4935, 5766, 6609, 7328]","[296, 541, 705, 838, 1002, 1242, 1485, 1767, 2128, 2666, 2756, 3166, 3495, 3721, 4069]","[245, 387, 802, 1084, 1251, 1741, 2280, 2568, 2916, 3122, 3307, 4222, 4711, 5145, 5676]","[170, 260, 414, 549, 679, 769, 1182, 1318, 1408, 1767, 1857, 2158, 2439, 2706, 3162]","[170, 260, 473, 563, 708, 798, 933, 1023, 1113, 1248, 1338, 1639, 1788, 1921, 2107]",7328,4069,5676,3162,2107,957,3139,1525,560,815,6996,15,radiant
7547652005,41,129,34,123,20,"[0, 169, 424, 798, 1118, 1609, 1922, 2339, 2849, 3283, 3865, 4505, 4825, 5307, 5822]","[0, 284, 573, 850, 1102, 1756, 2347, 2719, 3131, 3937, 4171, 4369, 4708, 5689, 5969]","[0, 205, 534, 898, 1151, 1498, 1622, 1712, 2146, 2420, 2698, 2827, 2953, 3434, 3588]","[0, 169, 341, 483, 573, 1004, 1166, 1256, 1346, 1653, 2362, 2499, 2672, 3032, 3127]","[0, 169, 331, 655, 856, 1270, 1360, 1532, 1656, 1746, 2154, 2244, 2669, 3029, 3124]",5822,5969,3588,3127,3124,54,106,28,86,65,"[0, 335, 537, 902, 1108, 1354, 1712, 2071, 2470, 2765, 3553, 4166, 4774, 5484, 5919]","[0, 282, 653, 1017, 1388, 1909, 2621, 3254, 3877, 4640, 5238, 6053, 6428, 6830, 7087]","[0, 208, 823, 1026, 1263, 1552, 1945, 2454, 3100, 3694, 4107, 4617, 5104, 5798, 6324]","[0, 169, 259, 349, 539, 715, 840, 1047, 1448, 1734, 2000, 2358, 2538, 2984, 3619]","[0, 204, 362, 531, 661, 858, 983, 1300, 1605, 2050, 2383, 2675, 3088, 3479, 3718]",5919,7087,6324,3619,3718,-97,-1118,-2736,-492,-594,-5037,15,dire
7547673509,113,13,69,58,20,"[0, 167, 467, 913, 1170, 1534, 1943, 2549, 3036, 3794, 4335, 4955, 5531, 5843, 6224]","[0, 294, 693, 1116, 1364, 1701, 1901, 2123, 2612, 3088, 3618, 4067, 4483, 4780, 5182]","[0, 215, 384, 618, 1070, 1487, 1958, 2174, 2461, 3311, 3819, 4322, 5030, 5871, 6249]","[0, 130, 220, 592, 730, 860, 1146, 1290, 1700, 2028, 2208, 2506, 2717, 3251, 3412]","[0, 130, 220, 547, 637, 787, 926, 1373, 1536, 1712, 1892, 2146, 2236, 2706, 2801]",6224,5182,6249,3412,2801,10,74,104,86,100,"[0, 281, 540, 1114, 1402, 1821, 2608, 2851, 3434, 3558, 4295, 4725, 5198, 5631, 6475]","[0, 282, 603, 919, 1208, 1587, 1986, 2518, 2977, 3345, 3899, 4311, 4709, 5715, 6421]","[0, 285, 491, 1150, 1314, 1558, 1948, 2150, 2638, 2836, 3311, 3659, 4218, 4831, 5488]","[0, 210, 351, 789, 914, 1061, 1253, 1343, 1523, 1663, 1992, 2208, 2493, 2889, 3121]","[0, 210, 300, 498, 635, 797, 1028, 1164, 1344, 1516, 1715, 2045, 2180, 2463, 2815]",6475,6421,5488,3121,2815,-251,-1239,761,291,-14,-452,15,dire
7547992002,41,129,120,64,107,"[0, 330, 740, 1098, 1466, 1910, 2325, 2584, 3132, 3832, 4564, 4926, 5866, 6605, 7151]","[0, 204, 438, 713, 1452, 1770, 2022, 2375, 2708, 2946, 3502, 4019, 4385, 4951, 5342]","[0, 307, 510, 805, 1014, 1104, 1359, 1840, 2057, 2654, 3268, 4012, 4351, 5083, 5276]","[0, 170, 260, 505, 643, 782, 1178, 1313, 1542, 1808, 2168, 2422, 2637, 3088, 3237]","[0, 170, 260, 350, 641, 731, 866, 1004, 1139, 1643, 2052, 2243, 2423, 2780, 2929]",7151,5342,5276,3237,2929,36,6,99,86,20,"[0, 256, 525, 873, 1277, 1530, 2028, 2349, 2800, 3169, 3597, 3826, 4298, 5375, 5742]","[0, 222, 433, 667, 950, 1244, 1479, 1736, 2019, 2200, 2618, 2800, 3242, 3436, 3780]","[0, 170, 333, 593, 847, 937, 1162, 1289, 1424, 1584, 1674, 1937, 2063, 3070, 3243]","[0, 170, 260, 589, 679, 816, 1006, 1132, 1296, 1386, 1525, 1615, 1822, 2416, 2511]","[0, 170, 260, 350, 799, 936, 1077, 1198, 1306, 1479, 1656, 1746, 1881, 2176, 2271]",5742,3780,3243,2511,2271,1409,1562,2033,726,658,6388,15,radiant
7548001205,74,41,81,14,71,"[100, 381, 546, 871, 995, 1085, 1213, 1390, 1967, 2176, 2897, 3095, 3381, 3623, 4066]","[0, 337, 612, 806, 1271, 1404, 1698, 1914, 2180, 2307, 2831, 3020, 3220, 3735, 3979]","[0, 247, 412, 541, 665, 1175, 1340, 1580, 2043, 2133, 2447, 2591, 2681, 2974, 3312]","[0, 209, 299, 423, 513, 710, 800, 936, 1190, 1413, 1630, 1774, 1923, 2205, 2523]","[0, 209, 299, 424, 609, 699, 789, 879, 969, 1059, 1243, 1387, 1477, 1672, 1849]",4066,3979,3312,2523,1849,93,36,104,112,111,"[0, 129, 447, 859, 1544, 1970, 2436, 3201, 3663, 4098, 4672, 5448, 6226, 6853, 7528]","[0, 245, 656, 979, 1428, 1764, 2262, 2872, 3322, 4313, 4731, 5211, 5774, 6306, 6617]","[0, 240, 528, 937, 1133, 1989, 2410, 2923, 3504, 4200, 4419, 4765, 5065, 5476, 5965]","[0, 129, 219, 371, 461, 915, 1005, 1248, 1393, 1669, 1804, 1924, 2116, 2437, 3003]","[0, 129, 219, 358, 636, 785, 933, 1226, 1369, 1614, 1935, 2074, 2254, 2484, 2950]",7528,6617,5965,3003,2950,-3462,-2638,-2653,-480,-1101,-10334,15,dire
7548007315,21,54,64,104,84,"[0, 206, 447, 770, 1060, 1383, 1631, 1963, 2666, 2943, 3229, 3720, 3906, 4148, 4612]","[0, 163, 443, 693, 1064, 1347, 1509, 1891, 2272, 2618, 3076, 3473, 3701, 3883, 4381]","[0, 90, 180, 270, 360, 490, 580, 670, 794, 932, 1022, 1300, 1390, 1485, 1639]","[0, 124, 251, 341, 469, 672, 762, 887, 977, 1259, 1349, 1610, 1869, 1964, 2540]","[0, 90, 180, 318, 505, 635, 725, 1142, 1374, 1464, 1784, 1874, 1998, 2137, 2486]",4612,4381,1639,2540,2486,48,106,96,26,85,"[0, 649, 848, 1457, 2063, 2597, 3317, 3760, 4363, 5063, 5965, 6689, 7774, 8864, 10167]","[0, 384, 669, 913, 1248, 1500, 2133, 2612, 3074, 3216, 3594, 3900, 4754, 5104, 5801]","[0, 471, 682, 1039, 1441, 1936, 2412, 2754, 3088, 3538, 4063, 4360, 5176, 5475, 6233]","[0, 311, 414, 504, 722, 812, 1004, 1579, 1759, 1849, 2559, 2774, 3183, 3359, 3916]","[0, 311, 401, 545, 745, 891, 1026, 1355, 1660, 1951, 2367, 2569, 3048, 3253, 3442]",10167,5801,6233,3916,3442,-5555,-1420,-4594,-1376,-956,-13901,15,dire
7548094003,48,25,47,105,136,"[0, 284, 526, 954, 1284, 1667, 2078, 2478, 2986, 3416, 4000, 4751, 5355, 6147, 6912]","[0, 207, 547, 893, 1234, 1602, 2025, 2594, 3193, 3460, 4047, 4665, 5152, 5520, 5831]","[2, 206, 409, 663, 1004, 1129, 1483, 1702, 2040, 2400, 3104, 3609, 3908, 4103, 4323]","[0, 169, 295, 385, 700, 840, 1215, 1305, 1484, 1741, 2033, 2276, 2366, 2561, 2656]","[0, 169, 259, 527, 617, 862, 1045, 1163, 1345, 1449, 1690, 1933, 2067, 2282, 2377]",6912,5831,4323,2656,2377,114,106,123,96,79,"[60, 229, 790, 1113, 1399, 1827, 2332, 2947, 3289, 3759, 4304, 4923, 5545, 6208, 6542]","[328, 695, 1052, 1267, 1805, 2102, 2432, 3127, 3568, 4413, 5107, 5511, 6209, 7137, 7286]","[60, 229, 319, 644, 780, 1129, 1264, 1401, 1537, 2201, 2574, 2929, 3204, 3623, 4109]","[60, 302, 640, 1068, 1467, 1966, 2056, 2559, 3058, 3607, 4494, 4659, 5273, 5820, 6020]","[60, 229, 383, 526, 616, 805, 1015, 1298, 1447, 1964, 2559, 3010, 3190, 3439, 3639]",6542,7286,4109,6020,3639,370,-1455,214,-3364,-1262,-5497,15,dire
7548152615,7,6,74,33,30,"[207, 372, 462, 635, 931, 1021, 1366, 1495, 1585, 1755, 1845, 1989, 2245, 2440, 2822]","[74, 276, 478, 684, 893, 1112, 1320, 1536, 1698, 1863, 2067, 2211, 2384, 2786, 3043]","[74, 241, 527, 739, 868, 1125, 1458, 1596, 1756, 1895, 1985, 2282, 2418, 2513, 2607]","[74, 204, 340, 430, 637, 810, 918, 1053, 1164, 1294, 1384, 1711, 1871, 1983, 2077]","[74, 204, 294, 429, 567, 657, 792, 882, 972, 1110, 1200, 1344, 1434, 1529, 1623]",2822,3043,2607,2077,1623,42,129,76,101,121,"[324, 606, 941, 1483, 1776, 2580, 2833, 3193, 3999, 4253, 5115, 6250, 6552, 7336, 8149]","[56, 309, 683, 984, 1567, 2120, 2537, 2937, 3491, 4108, 4615, 5389, 6167, 6821, 7160]","[56, 411, 589, 868, 1116, 1393, 1723, 2054, 2557, 2973, 3480, 4172, 4519, 5146, 5602]","[56, 266, 356, 534, 675, 1066, 1156, 1294, 1627, 1858, 2132, 2402, 2893, 3343, 3519]","[56, 266, 356, 586, 782, 962, 1141, 1231, 1456, 2037, 2172, 2550, 3179, 3643, 3737]",8149,7160,5602,3519,3737,-5327,-4117,-2995,-1442,-2114,-15995,15,dire
7548241213,10,69,74,21,27,"[0, 248, 456, 829, 1157, 1490, 1987, 2159, 2507, 3115, 3558, 4236, 4740, 5374, 6221]","[0, 165, 422, 797, 1228, 1753, 2366, 2957, 3288, 3888, 4303, 5193, 5861, 6407, 6824]","[0, 165, 449, 693, 981, 1335, 1625, 2265, 2708, 3360, 3838, 4365, 4570, 5231, 5754]","[0, 178, 268, 767, 857, 992, 1367, 1774, 1864, 2174, 2309, 2614, 2741, 3031, 3522]","[0, 130, 220, 310, 400, 490, 629, 958, 1236, 1326, 1461, 1605, 1741, 1931, 2119]",6221,6824,5754,3522,2119,39,41,123,78,20,"[0, 367, 605, 929, 1209, 1444, 1777, 1995, 2457, 2898, 3319, 3599, 4370, 4915, 5232]","[0, 249, 514, 688, 1010, 1465, 1995, 2211, 2713, 3204, 3443, 3781, 4110, 4576, 4671]","[0, 210, 300, 553, 922, 1108, 1325, 1580, 2014, 2376, 2515, 2804, 3260, 3673, 3858]","[0, 210, 464, 910, 1228, 1388, 1838, 2215, 2461, 2626, 2865, 3195, 3441, 3818, 4039]","[0, 210, 300, 507, 731, 821, 1103, 1510, 1773, 2182, 2272, 2482, 2848, 3051, 3146]",5232,4671,3858,4039,3146,989,2153,1896,-517,-1027,3494,15,radiant
7548252414,67,22,2,40,20,"[0, 291, 700, 948, 1156, 1450, 1707, 2035, 2448, 2981, 3348, 3853, 4247, 4533, 4894]","[0, 219, 622, 1021, 1375, 1772, 2151, 3091, 3710, 4589, 5051, 6038, 6587, 7112, 7531]","[0, 205, 448, 831, 1235, 1491, 1780, 2272, 2657, 3677, 4111, 4647, 5279, 6037, 6949]","[0, 517, 632, 722, 904, 1004, 1141, 1415, 1505, 1845, 2067, 2389, 2908, 3034, 3444]","[0, 169, 284, 374, 464, 601, 691, 781, 919, 1309, 1444, 1604, 1920, 2191, 2338]",4894,7531,6949,3444,2338,8,97,43,27,121,"[0, 205, 472, 799, 1204, 1587, 1995, 2579, 3091, 3333, 3986, 4237, 4754, 5208, 5659]","[0, 216, 579, 938, 1354, 1928, 2276, 2569, 3113, 3619, 4346, 4686, 5284, 5962, 6471]","[0, 237, 486, 816, 1336, 1465, 1555, 1965, 2295, 2626, 3014, 3351, 3496, 3819, 4343]","[100, 269, 359, 449, 652, 817, 953, 1043, 1178, 1529, 1664, 1875, 2150, 2433, 2695]","[0, 169, 259, 397, 610, 775, 910, 1078, 1256, 1346, 1481, 1571, 1661, 2236, 2432]",5659,6471,4343,2695,2432,-765,1060,2606,749,-94,3556,15,radiant
7548322301,10,98,21,100,84,"[0, 294, 709, 883, 1220, 1904, 2224, 2778, 3197, 3928, 4485, 5025, 5411, 6269, 6886]","[0, 250, 625, 1110, 1407, 1845, 2387, 2931, 3265, 3831, 4339, 5051, 5838, 6438, 6950]","[0, 241, 487, 881, 1186, 1641, 1919, 2149, 2779, 3569, 4024, 4487, 4608, 5139, 5534]","[100, 270, 360, 796, 886, 1235, 1325, 1829, 2140, 2461, 2686, 3382, 3674, 3822, 3917]","[0, 170, 260, 350, 489, 709, 799, 1080, 1260, 1462, 1687, 1905, 1995, 2188, 2299]",6886,6950,5534,3917,2299,82,22,102,58,5,"[0, 207, 468, 804, 1048, 1355, 1946, 2507, 2841, 3159, 3659, 4380, 5227, 5774, 6412]","[0, 357, 763, 1126, 1662, 2036, 3343, 3800, 4134, 5087, 5666, 6060, 7014, 7405, 7657]","[0, 170, 517, 826, 1041, 1466, 1915, 2207, 2728, 3047, 3343, 3892, 4262, 4850, 5257]","[0, 170, 285, 405, 495, 794, 1134, 1356, 1558, 1908, 2486, 2874, 3271, 3706, 3999]","[0, 170, 334, 499, 589, 725, 1080, 1260, 1423, 1513, 1787, 1963, 2358, 2602, 2798]",6412,7657,5257,3999,2798,474,-707,277,-82,-499,-537,15,radiant
7548329914,73,51,14,86,26,"[330, 619, 988, 1314, 1746, 2217, 2539, 3086, 3612, 4373, 4982, 5602, 6786, 7967, 9035]","[60, 339, 574, 905, 1351, 1757, 2279, 2404, 2748, 3515, 4108, 4556, 5423, 6025, 6852]","[60, 402, 675, 1457, 1669, 2316, 2864, 3274, 3645, 4264, 4473, 5020, 6080, 6728, 7383]","[60, 275, 365, 455, 632, 946, 1183, 1273, 1411, 1667, 2049, 2381, 3209, 3984, 4345]","[60, 430, 767, 1034, 1164, 1444, 1625, 1725, 1945, 2286, 2376, 2820, 3700, 4016, 4230]",9035,6852,7383,4345,4230,94,69,76,100,121,"[0, 330, 506, 942, 1203, 1293, 1538, 2031, 2276, 2957, 3185, 3673, 4101, 4432, 4927]","[0, 207, 485, 727, 1064, 1459, 1773, 2300, 2564, 2806, 3421, 4025, 4494, 4941, 5142]","[0, 325, 620, 1024, 1308, 1708, 2114, 2642, 3000, 3090, 3700, 3898, 3988, 4327, 4983]","[0, 393, 483, 704, 794, 889, 996, 1284, 1376, 1618, 1708, 1906, 2086, 2365, 2460]","[0, 169, 259, 349, 524, 614, 827, 1373, 1629, 1945, 2035, 2233, 2323, 2418, 2665]",4927,5142,4983,2460,2665,4108,1710,2400,1885,1565,11668,15,radiant
7548406310,106,69,93,123,31,"[329, 609, 1048, 1456, 1948, 2281, 2731, 2985, 3232, 3887, 4344, 4931, 5673, 6365, 7032]","[61, 347, 514, 932, 1233, 1551, 2020, 2429, 2828, 3670, 3891, 4252, 4893, 5627, 6319]","[61, 267, 511, 793, 1190, 1434, 1782, 2176, 2567, 3022, 3577, 4157, 4696, 5163, 5885]","[61, 230, 320, 455, 593, 683, 818, 908, 998, 1379, 1707, 2023, 2260, 2605, 3267]","[61, 230, 320, 649, 739, 921, 1179, 1435, 1525, 1889, 2069, 2257, 2446, 2816, 3520]",7032,6319,5885,3267,3520,94,120,53,97,105,"[0, 207, 540, 874, 1041, 1426, 1795, 2200, 2542, 2914, 3442, 4148, 4630, 5368, 5973]","[0, 324, 643, 1017, 1308, 1633, 2030, 2624, 3364, 3792, 4175, 4544, 5244, 5728, 6471]","[0, 169, 259, 568, 771, 968, 1320, 1823, 2044, 2367, 2540, 2748, 3054, 3213, 3641]","[0, 207, 463, 888, 1167, 1529, 1895, 2507, 2957, 3409, 3832, 3973, 4763, 5198, 5410]","[0, 169, 259, 651, 995, 1167, 1325, 1833, 2134, 2358, 2635, 2951, 3351, 3512, 3933]",5973,6471,3641,5410,3933,1059,-152,2244,-2143,-413,595,15,radiant
7548623607,17,129,4,26,83,"[0, 166, 515, 817, 1014, 1493, 1797, 2152, 2725, 3124, 3538, 3868, 4331, 5459, 6097]","[0, 211, 598, 806, 1156, 1526, 2123, 2573, 3246, 3572, 4089, 4636, 4983, 5860, 6422]","[0, 205, 401, 671, 936, 1355, 1541, 1884, 2372, 2506, 2733, 3176, 3305, 3683, 4062]","[0, 130, 220, 310, 400, 490, 758, 848, 1299, 1389, 1528, 1618, 1708, 2296, 2551]","[0, 130, 677, 815, 905, 1235, 1370, 1460, 1675, 1787, 2013, 2103, 2230, 2635, 2781]",6097,6422,4062,2551,2781,90,61,60,21,51,"[0, 365, 537, 808, 1094, 1371, 1731, 2215, 2667, 3519, 4515, 5147, 5395, 5728, 6262]","[0, 210, 489, 944, 1244, 1522, 1943, 2497, 2804, 3361, 4030, 4623, 5363, 6125, 6871]","[0, 253, 564, 774, 1369, 1577, 2128, 2583, 2986, 3589, 4565, 4920, 5482, 5631, 6149]","[0, 210, 546, 636, 899, 989, 1079, 1650, 2073, 2329, 2758, 3389, 3881, 4030, 4284]","[0, 210, 300, 638, 773, 937, 1073, 1243, 1333, 1615, 2044, 2400, 2917, 3283, 3853]",6262,6871,6149,4284,3853,-165,-449,-2087,-1733,-1072,-5506,15,dire
7548715213,89,128,2,71,105,"[1, 242, 514, 1008, 1399, 1773, 1972, 2387, 2714, 3304, 3920, 4291, 5080, 5769, 6556]","[1, 291, 659, 1002, 1495, 2196, 2681, 3250, 3726, 4534, 5047, 5479, 5822, 6748, 7637]","[1, 247, 513, 753, 1036, 1345, 1975, 2120, 2827, 3525, 4228, 4751, 5153, 5569, 6569]","[1, 171, 261, 351, 487, 678, 808, 1025, 1160, 1365, 1590, 1887, 2142, 2625, 2774]","[1, 171, 261, 785, 923, 1076, 1206, 1389, 1534, 2006, 2231, 2953, 3475, 3839, 4610]",6556,7637,6569,2774,4610,14,69,53,135,121,"[1, 196, 663, 906, 1268, 1686, 2099, 2575, 2820, 3102, 3286, 3715, 4724, 4872, 5107]","[3, 357, 601, 933, 1315, 1525, 1934, 2104, 2433, 2603, 3198, 3496, 4619, 5193, 5716]","[1, 196, 286, 376, 554, 684, 1105, 1292, 1768, 1858, 2179, 2420, 3063, 3211, 3357]","[1, 231, 360, 687, 854, 1354, 1778, 2154, 2639, 3062, 3513, 3819, 4010, 4158, 4253]","[1, 196, 286, 601, 731, 1184, 1605, 1792, 2052, 2177, 2435, 2572, 3087, 3235, 3330]",5107,5716,3357,4253,3330,1449,1921,3212,-1479,1280,6383,15,radiant
7548737005,10,39,60,86,83,"[450, 700, 1185, 1573, 1785, 2417, 2673, 3498, 3829, 4782, 5899, 6475, 7008, 7574, 8117]","[749, 1132, 1543, 1972, 2285, 2582, 2967, 3542, 3913, 4790, 5267, 5415, 5783, 6149, 6591]","[560, 908, 1230, 1830, 2092, 2864, 3249, 3886, 4272, 4727, 5281, 5763, 6166, 6261, 6778]","[599, 739, 1008, 1185, 1327, 1676, 1766, 2035, 2170, 2673, 2990, 3138, 3371, 3639, 3979]","[261, 351, 536, 626, 716, 896, 1069, 1629, 1903, 2403, 2668, 3012, 3107, 3202, 3359]",8117,6591,6778,3979,3359,42,28,95,37,20,"[533, 928, 1295, 1697, 2113, 2928, 3303, 4068, 4511, 5142, 5621, 6484, 6835, 7624, 9028]","[695, 1317, 1568, 1941, 2297, 2387, 2642, 3445, 3923, 4175, 4812, 5656, 6388, 7023, 7501]","[575, 905, 1182, 1321, 1565, 1729, 1907, 2020, 2334, 2778, 2993, 3583, 3678, 4438, 5308]","[327, 969, 1152, 1472, 1713, 1803, 1941, 2569, 2801, 3102, 3192, 3796, 4111, 4444, 5233]","[327, 417, 547, 637, 825, 915, 1005, 1569, 1905, 2194, 2429, 2787, 3082, 3504, 3966]",9028,7501,5308,5233,3966,-911,-910,1470,-1254,-607,-2212,15,radiant
7548774319,39,93,78,58,26,"[557, 892, 1237, 1502, 1979, 2334, 2955, 3902, 4566, 5168, 5950, 6551, 7107, 7201, 7702]","[519, 1038, 1379, 1624, 2045, 2411, 2775, 3537, 4075, 4606, 5136, 5634, 6086, 6180, 6632]","[791, 1156, 1489, 1736, 2275, 2823, 3565, 4013, 4960, 5145, 5870, 6489, 7300, 7394, 8228]","[260, 350, 536, 647, 1212, 1380, 1636, 2053, 2430, 2772, 3368, 3695, 4037, 4308, 4767]","[421, 511, 641, 775, 1068, 1203, 1488, 1699, 2123, 2431, 2791, 3107, 3451, 3545, 3802]",7702,6632,8228,4767,3802,25,137,14,53,5,"[657, 903, 1357, 1719, 2091, 2524, 3063, 3549, 4141, 4231, 4471, 4566, 5017, 6074, 6696]","[488, 612, 900, 1045, 1385, 1544, 1819, 2107, 2425, 2940, 3213, 3428, 3964, 4554, 5117]","[741, 1060, 1337, 1720, 2029, 2406, 2579, 2992, 3370, 3460, 4086, 4892, 5072, 5672, 6122]","[344, 666, 796, 886, 1314, 1404, 1494, 1822, 2063, 2303, 2588, 3082, 3347, 3860, 4345]","[344, 701, 831, 970, 1153, 1287, 1377, 1553, 1766, 1919, 2181, 2314, 2409, 3393, 3523]",6696,5117,6122,4345,3523,1006,1515,2106,422,279,5328,15,radiant
7548914808,10,39,80,91,84,"[0, 324, 633, 1101, 1478, 1987, 2504, 3079, 3810, 4418, 5160, 5908, 6531, 7247, 8092]","[0, 370, 743, 1060, 1392, 1812, 2183, 2716, 3492, 3918, 4452, 5114, 5629, 6345, 6736]","[0, 324, 669, 1110, 1520, 1988, 2331, 2979, 3741, 4045, 4596, 5503, 6461, 7268, 7362]","[0, 170, 260, 425, 561, 698, 837, 976, 1293, 1396, 1620, 1919, 2139, 2342, 2436]","[0, 170, 260, 428, 518, 655, 789, 879, 1198, 1288, 1516, 1817, 1907, 2464, 2558]",8092,6736,7362,2436,2558,114,109,28,86,64,"[0, 320, 729, 1059, 1470, 1892, 2301, 2897, 3630, 4150, 4717, 5139, 5746, 6445, 7138]","[0, 277, 675, 1049, 1357, 1574, 1934, 2245, 2658, 3043, 3455, 3830, 4522, 4988, 5611]","[0, 244, 639, 1059, 1436, 2038, 2524, 3019, 3512, 3962, 4474, 5035, 5558, 5989, 6791]","[0, 221, 311, 401, 542, 681, 816, 906, 1131, 1603, 1996, 2442, 2863, 3590, 3908]","[0, 170, 260, 350, 507, 597, 687, 813, 903, 1041, 1131, 1275, 1414, 1509, 1603]",7138,5611,6791,3908,1603,954,1125,571,-1472,955,2133,15,radiant
7548949810,8,76,107,64,9,"[283, 572, 770, 1272, 1722, 2168, 2519, 2758, 3267, 3687, 4328, 4693, 5303, 5951, 6395]","[248, 496, 994, 1328, 1795, 2075, 2728, 3216, 3581, 3934, 4388, 5209, 5541, 6310, 6713]","[241, 825, 1153, 1488, 2018, 2226, 2396, 2725, 3019, 3390, 4036, 4356, 4884, 5424, 6042]","[170, 396, 486, 679, 850, 1029, 1119, 1964, 2104, 2306, 2533, 2770, 2911, 3262, 3564]","[170, 336, 426, 556, 646, 781, 1298, 1388, 1557, 1681, 1976, 2379, 2474, 2845, 2939]",6395,6713,6042,3564,2939,54,13,102,33,128,"[615, 811, 1059, 1470, 1671, 2221, 2646, 3142, 3587, 3808, 4149, 4780, 5305, 5554, 6272]","[284, 488, 737, 1053, 1255, 1710, 2006, 2490, 2789, 3191, 3700, 3950, 4516, 5151, 5419]","[247, 529, 809, 1164, 1402, 2029, 2594, 3206, 3503, 4152, 4774, 4864, 5391, 5910, 6471]","[170, 260, 350, 520, 610, 1054, 1234, 1723, 1896, 2330, 2743, 2833, 3190, 3560, 3811]","[283, 373, 545, 690, 784, 1117, 1297, 1477, 1651, 1949, 2439, 2613, 2809, 3083, 3241]",6272,5419,6471,3811,3241,123,1294,-429,-247,-302,439,15,radiant
7548999419,48,46,29,65,17,"[216, 462, 662, 959, 1244, 1544, 1976, 2431, 2892, 3612, 3993, 4719, 5503, 6357, 7127]","[296, 544, 841, 1257, 1641, 2055, 2517, 2907, 3542, 4356, 5057, 5926, 6373, 6878, 7480]","[222, 545, 710, 914, 1004, 1441, 1903, 2377, 2719, 3055, 3403, 3749, 4149, 4418, 4879]","[170, 260, 435, 525, 722, 846, 1197, 1332, 1468, 1897, 2247, 2523, 2771, 3112, 3282]","[170, 260, 350, 485, 575, 665, 857, 992, 1226, 1556, 1733, 2048, 2251, 2365, 2558]",7127,7480,4879,3282,2558,32,33,97,7,105,"[266, 571, 1050, 1363, 1728, 1890, 2233, 2737, 3078, 3812, 4022, 4735, 5296, 6262, 7076]","[265, 663, 1101, 1497, 1827, 2216, 2738, 3001, 3327, 3861, 4344, 5092, 5499, 6318, 7012]","[328, 582, 826, 1198, 1530, 1944, 2384, 2508, 2833, 2968, 3159, 3685, 4127, 4421, 4978]","[499, 589, 709, 879, 1171, 1323, 1534, 1624, 1714, 2020, 2312, 2492, 3047, 3539, 3633]","[231, 321, 523, 693, 1040, 1130, 1220, 1310, 1400, 1619, 1890, 2117, 2337, 3350, 3482]",7076,7012,4978,3633,3482,51,468,-99,-351,-924,-855,15,dire
7549153711,42,53,9,7,87,"[340, 631, 920, 1128, 1419, 1687, 2063, 2567, 3045, 3511, 4269, 4700, 5265, 6023, 6376]","[670, 1347, 1672, 2243, 2831, 3199, 3802, 4171, 4995, 5538, 6742, 7184, 7949, 8604, 9428]","[502, 654, 983, 1169, 1638, 1789, 1979, 2119, 2361, 2688, 3032, 3430, 3923, 4330, 4961]","[333, 460, 640, 863, 1296, 1506, 1599, 1689, 1896, 2416, 2637, 3077, 3564, 4098, 4543]","[578, 974, 1108, 1290, 1455, 1625, 2106, 2208, 2465, 2720, 3064, 3343, 4176, 4707, 5276]",6376,9428,4961,4543,5276,36,61,69,1,51,"[1026, 1431, 1816, 2114, 2362, 2967, 3410, 3713, 4281, 4963, 5623, 6057, 6444, 6539, 7241]","[702, 1030, 1328, 1768, 2208, 2779, 3165, 3740, 4709, 5559, 6454, 6933, 7088, 7434, 7977]","[490, 657, 933, 1063, 1605, 2452, 2772, 3217, 3856, 4427, 4805, 5526, 5760, 6339, 6972]","[322, 458, 806, 1027, 1199, 1425, 1515, 1962, 2394, 2874, 3184, 3390, 3485, 3618, 3776]","[260, 350, 488, 617, 792, 1082, 1218, 1398, 2137, 2526, 2796, 2982, 3077, 3172, 3503]",7241,7977,6972,3776,3503,-865,1451,-2011,767,1773,1115,15,dire
7549213314,48,14,105,33,84,"[0, 257, 588, 1193, 1606, 1933, 2367, 2780, 3138, 3524, 4252, 4919, 5396, 5987, 6338]","[0, 311, 641, 1033, 1320, 1704, 2185, 2518, 3009, 3516, 4270, 4414, 5266, 5802, 5897]","[0, 169, 303, 610, 700, 790, 880, 1014, 1271, 1361, 1749, 2026, 3112, 3398, 4330]","[0, 244, 540, 858, 1174, 1379, 1605, 2037, 2199, 2447, 2818, 3274, 3609, 4090, 4326]","[0, 169, 259, 496, 630, 766, 900, 1160, 1420, 1555, 1997, 2224, 2454, 2657, 2904]",6338,5897,4330,4326,2904,76,55,46,83,26,"[0, 364, 725, 1181, 1637, 2058, 2507, 3048, 3558, 4295, 4875, 5426, 5961, 6621, 7643]","[0, 329, 704, 1085, 1355, 1954, 2602, 3115, 3393, 3823, 4423, 4641, 5677, 6594, 7772]","[0, 280, 643, 1406, 1777, 2212, 2823, 3331, 4061, 4780, 5208, 5553, 5777, 6910, 7752]","[0, 169, 277, 487, 606, 947, 1130, 1238, 1461, 1747, 1853, 2072, 2474, 2761, 3281]","[0, 169, 259, 360, 450, 633, 835, 974, 1077, 1479, 1613, 1758, 2321, 2604, 2993]",7643,7772,7752,3281,2993,-1305,-1875,-3422,1045,-89,-5646,15,radiant
7549256701,36,120,28,83,121,"[0, 331, 658, 1074, 1415, 1660, 2150, 2493, 3183, 3397, 3952, 4394, 4745, 5230, 5775]","[0, 322, 730, 1097, 1437, 1685, 1894, 2265, 2614, 3435, 3840, 4412, 5009, 5742, 6277]","[0, 335, 499, 627, 952, 1261, 1691, 2059, 2451, 2721, 3201, 3877, 4342, 5105, 5527]","[0, 210, 405, 541, 631, 937, 1075, 1165, 1345, 1589, 2043, 2133, 2387, 2668, 2985]","[0, 210, 345, 435, 922, 1118, 1208, 1342, 1522, 1917, 2214, 2304, 2438, 2725, 3282]",5775,6277,5527,2985,3282,95,74,60,112,26,"[0, 255, 585, 913, 1305, 1694, 1979, 2573, 2927, 3262, 4012, 4433, 5117, 5855, 6449]","[0, 216, 458, 836, 1213, 1613, 2022, 2355, 2647, 2762, 3001, 3525, 4154, 4496, 5066]","[0, 178, 378, 662, 859, 1034, 1161, 1624, 2089, 2522, 3052, 3611, 3982, 4491, 4892]","[0, 130, 264, 354, 444, 534, 629, 854, 1006, 1096, 1556, 1734, 1978, 2127, 2435]","[0, 130, 220, 310, 400, 538, 628, 808, 898, 998, 1346, 1436, 1670, 1853, 2184]",6449,5066,4892,2435,2184,-674,1211,635,550,1098,2820,15,radiant
7549265807,28,92,21,51,5,"[0, 210, 668, 1005, 1326, 1719, 2032, 2615, 2982, 3523, 3854, 4212, 4933, 5534, 6102]","[0, 364, 682, 924, 1257, 1548, 1840, 2157, 2498, 3043, 3611, 4092, 4786, 5427, 5909]","[0, 360, 633, 912, 1134, 1632, 1968, 2459, 2986, 3307, 3877, 4385, 4815, 5611, 6033]","[0, 210, 300, 429, 519, 879, 1052, 1187, 1277, 1491, 1740, 1889, 2374, 2750, 3165]","[0, 210, 300, 454, 544, 674, 886, 1021, 1129, 1491, 1758, 2028, 2216, 2521, 2805]",6102,5909,6033,3165,2805,10,106,69,123,110,"[0, 169, 496, 817, 1133, 1378, 1867, 2391, 2833, 3299, 3820, 4314, 4894, 5386, 5886]","[0, 257, 559, 886, 1139, 1380, 1676, 1905, 2457, 2602, 2868, 3182, 3445, 3984, 4652]","[0, 205, 332, 529, 804, 1168, 1758, 2233, 2541, 2887, 3367, 3934, 4428, 4826, 5257]","[0, 178, 307, 469, 908, 1024, 1277, 1412, 1502, 1646, 1970, 2287, 2585, 2987, 3140]","[0, 174, 264, 414, 737, 870, 1101, 1308, 1482, 1621, 1796, 2180, 2402, 2741, 2957]",5886,4652,5257,3140,2957,216,1257,776,25,-152,2122,15,radiant
7549276403,8,128,96,123,58,"[516, 760, 1122, 1404, 1828, 2247, 2633, 3422, 3997, 4527, 5091, 5465, 5825, 6492, 7217]","[561, 984, 1281, 1692, 2400, 2643, 3024, 3599, 3864, 4135, 4469, 5046, 5229, 5451, 6442]","[615, 891, 1054, 1292, 1669, 2142, 2481, 2792, 3206, 3538, 4110, 4557, 4830, 5356, 5665]","[260, 350, 440, 684, 813, 1119, 1209, 1299, 1434, 1524, 1751, 2096, 2237, 2576, 2934]","[260, 350, 458, 562, 669, 765, 893, 1069, 1322, 1456, 1689, 1836, 1930, 2262, 2996]",7217,6442,5665,2934,2996,48,120,129,105,68,"[457, 907, 1639, 2060, 2490, 2698, 3105, 3821, 4432, 5047, 5888, 6934, 7687, 8932, 10010]","[625, 831, 1214, 1637, 2047, 2910, 3341, 4037, 4809, 5078, 5839, 6405, 7509, 8097, 8774]","[543, 903, 1397, 1841, 2187, 2478, 2865, 3367, 3750, 4155, 4739, 5575, 6295, 7104, 7917]","[260, 367, 586, 692, 816, 1088, 1284, 1595, 2070, 2300, 2664, 3261, 3574, 4074, 4700]","[260, 398, 850, 1023, 1210, 1678, 1833, 2068, 2275, 2418, 2882, 3234, 3850, 4361, 4680]",10010,8774,7917,4700,4680,-2793,-2332,-2252,-1766,-1684,-10827,15,dire
7549276501,90,114,84,71,26,"[0, 279, 576, 854, 1273, 1812, 2223, 2642, 3196, 3834, 4574, 5700, 6203, 6778, 7411]","[0, 320, 598, 975, 1417, 1791, 2048, 2174, 2813, 3199, 3730, 4038, 4856, 5350, 5903]","[0, 508, 598, 734, 871, 1212, 1302, 1392, 1626, 1761, 2108, 2198, 2559, 3152, 3358]","[0, 207, 512, 720, 886, 1179, 1563, 1688, 2203, 2356, 2485, 2820, 3121, 3438, 3863]","[0, 255, 607, 794, 955, 1093, 1183, 1273, 1593, 1683, 1773, 2100, 2426, 2799, 3158]",7411,5903,3358,3863,3158,13,54,40,83,86,"[0, 360, 689, 1147, 1605, 2133, 2623, 3317, 3972, 4570, 5210, 5871, 6505, 7214, 7436]","[0, 297, 566, 893, 1256, 1575, 1941, 2879, 3304, 3769, 4318, 4810, 5299, 6409, 7494]","[0, 280, 697, 1135, 1423, 1693, 2048, 2563, 3066, 3505, 3873, 4324, 4617, 5215, 5790]","[0, 170, 260, 387, 477, 567, 702, 1082, 1262, 1643, 1876, 1966, 2099, 2451, 2776]","[0, 170, 260, 399, 526, 918, 1008, 1478, 1960, 2129, 2318, 2408, 2498, 2854, 2949]",7436,7494,5790,2776,2949,-25,-1591,-2432,1087,209,-2752,15,dire
7549277311,46,19,69,102,121,"[0, 308, 609, 959, 1426, 1780, 2232, 2668, 3226, 3717, 4497, 4972, 5753, 6370, 7193]","[0, 154, 493, 1326, 1842, 2125, 2540, 3028, 3396, 3858, 4240, 4330, 5083, 5603, 6347]","[0, 154, 382, 809, 1139, 1423, 1533, 1834, 2333, 2648, 2988, 3987, 4606, 5268, 5909]","[0, 154, 292, 412, 619, 841, 931, 1111, 1295, 1385, 1555, 1768, 2321, 2587, 2971]","[0, 189, 279, 447, 703, 833, 923, 1227, 1361, 1451, 1541, 1902, 2447, 2643, 2936]",7193,6347,5909,2971,2936,82,13,129,90,20,"[0, 245, 599, 1151, 1415, 1766, 2203, 3183, 3757, 4531, 5190, 5721, 5811, 6235, 6833]","[0, 288, 550, 808, 1238, 1456, 1742, 2244, 2706, 3152, 3610, 4039, 4627, 5205, 5928]","[0, 243, 538, 829, 1107, 1561, 1821, 2352, 2724, 3141, 3597, 3966, 4226, 4823, 5378]","[0, 257, 407, 522, 612, 749, 892, 1027, 1117, 1232, 1546, 1934, 2246, 2789, 2884]","[0, 253, 368, 579, 669, 806, 927, 1171, 1403, 1493, 1967, 2295, 2385, 2625, 2877]",6833,5928,5378,2884,2877,360,419,531,87,59,1456,15,dire
7549304914,49,48,97,105,79,"[0, 283, 565, 935, 1197, 1533, 2012, 2422, 3091, 3459, 4162, 4689, 5509, 5945, 6960]","[0, 207, 486, 719, 1007, 1174, 1522, 1798, 2259, 2834, 3227, 3544, 3977, 4577, 5428]","[0, 286, 615, 885, 1161, 1825, 2160, 2511, 2962, 3596, 4043, 4474, 4942, 5281, 5634]","[0, 170, 260, 459, 549, 754, 888, 1023, 1203, 1500, 1836, 2392, 2720, 2930, 3351]","[0, 170, 304, 394, 484, 614, 791, 1009, 1140, 1339, 1592, 1860, 2246, 2747, 2957]",6960,5428,5634,3351,2957,46,39,102,65,20,"[0, 293, 640, 1056, 1426, 1714, 2130, 2532, 3187, 3900, 4297, 4754, 5475, 6537, 7277]","[0, 209, 481, 640, 923, 1013, 1227, 1690, 2012, 2566, 3117, 3808, 4540, 5108, 5317]","[0, 507, 774, 1056, 1599, 2215, 2563, 2844, 3134, 3471, 3879, 4220, 4611, 5400, 5668]","[0, 239, 331, 425, 560, 945, 1084, 1233, 1706, 2245, 2419, 2766, 3035, 3636, 3878]","[0, 239, 329, 469, 624, 848, 938, 1154, 1379, 1739, 1857, 2037, 2287, 2639, 2856]",7277,5317,5668,3878,2856,-317,111,-34,-527,101,-666,15,radiant
7549315015,48,53,25,42,85,"[0, 285, 648, 786, 1157, 1484, 1996, 2468, 3181, 3845, 4379, 4982, 5535, 6051, 7088]","[0, 164, 532, 670, 804, 939, 1148, 1537, 1826, 2393, 3645, 3904, 4981, 5722, 6868]","[0, 180, 468, 813, 1099, 1590, 2303, 2555, 3010, 3238, 4075, 4405, 5036, 5834, 6296]","[0, 129, 255, 510, 778, 1140, 1300, 1498, 1735, 2114, 2625, 3011, 3374, 3864, 4327]","[0, 129, 335, 463, 553, 692, 973, 1454, 1777, 1911, 2242, 2332, 2475, 3213, 3535]",7088,6868,6296,4327,3535,126,8,55,107,5,"[0, 297, 581, 1021, 1453, 1739, 2031, 2704, 3274, 3973, 4554, 5209, 5960, 6785, 7216]","[0, 315, 743, 1191, 1666, 2027, 2363, 3321, 3561, 4101, 4482, 5020, 5788, 6550, 6763]","[0, 285, 496, 1022, 1212, 1513, 1850, 2191, 2521, 2708, 3512, 3957, 4547, 4962, 5177]","[0, 169, 259, 597, 789, 879, 1289, 1611, 1941, 2163, 2498, 2633, 2894, 3220, 3315]","[0, 502, 612, 746, 919, 1047, 1137, 1644, 1734, 1958, 2093, 2569, 3003, 3298, 3487]",7216,6763,5177,3315,3487,-128,105,1119,1012,48,2156,15,dire
7549315406,78,74,67,58,20,"[81, 287, 569, 1014, 1485, 1919, 2261, 2859, 3350, 4048, 4555, 5236, 5538, 5930, 6635]","[81, 210, 509, 755, 1063, 1365, 1635, 1770, 2237, 2583, 3009, 3394, 3520, 3920, 4979]","[81, 171, 442, 571, 904, 1076, 1241, 1733, 2180, 2449, 2824, 3180, 3484, 4210, 4816]","[81, 171, 261, 396, 486, 879, 1015, 1166, 1627, 1938, 2028, 2487, 2642, 3021, 3494]","[81, 171, 261, 351, 441, 531, 621, 846, 1457, 2049, 2438, 2711, 2846, 3186, 3598]",6635,4979,4816,3494,3598,80,92,21,100,103,"[1, 171, 490, 1461, 1945, 2437, 2870, 3152, 3572, 3982, 4549, 5056, 5289, 6519, 6906]","[1, 243, 445, 815, 1137, 1379, 1781, 2143, 2702, 3257, 3840, 4521, 5099, 6018, 6633]","[1, 247, 462, 902, 1133, 1302, 1585, 1868, 2295, 2601, 3308, 3744, 4650, 5410, 5559]","[1, 222, 312, 618, 807, 998, 1322, 1412, 1547, 2405, 2631, 3066, 3233, 3597, 3855]","[1, 171, 297, 434, 564, 694, 784, 874, 1009, 1315, 1621, 1788, 1956, 2531, 2680]",6906,6633,5559,3855,2680,-271,-1654,-743,-361,918,-2111,15,radiant
7549328801,49,113,60,96,26,"[1879, 2395, 2874, 3376, 4067, 4744, 5555, 6070, 7033, 7405, 8100, 9248, 9875, 10399, 11204]","[1519, 1911, 2287, 2521, 2994, 3926, 4329, 5242, 5691, 6498, 6978, 7831, 8607, 9299, 10202]","[1755, 2400, 2835, 3374, 4148, 4437, 4966, 5292, 5669, 5841, 6389, 7199, 7729, 8306, 9358]","[842, 1336, 1517, 1697, 1877, 2067, 2425, 2678, 3216, 3772, 4168, 4771, 5096, 5255, 6105]","[936, 1237, 1489, 1707, 1953, 2133, 2672, 2902, 3203, 3333, 3462, 3760, 3918, 4183, 4853]",11204,10202,9358,6105,4853,12,69,106,119,86,"[1770, 1944, 2140, 2456, 2669, 3099, 3581, 4184, 4491, 5170, 5618, 6103, 6699, 7427, 7954]","[1426, 1707, 2511, 2826, 3485, 3880, 4640, 5201, 6154, 6457, 7124, 7597, 8091, 8435, 8689]","[1166, 1546, 1839, 2015, 2197, 2534, 2968, 3367, 3771, 4206, 4671, 5168, 5739, 6188, 6904]","[905, 1040, 1335, 1589, 1723, 2035, 2481, 2807, 3504, 3599, 3742, 4151, 4246, 4341, 4477]","[843, 978, 1233, 1360, 1468, 1872, 2053, 2340, 2848, 2943, 3165, 3385, 3527, 3712, 3806]",7954,8689,6904,4477,3806,3250,1513,2454,1628,1047,9892,15,radiant
7549368300,10,49,106,105,45,"[942, 1278, 1734, 1824, 2309, 2608, 3350, 3626, 4409, 5313, 6087, 6562, 7303, 7957, 8283]","[991, 1661, 1898, 2463, 3078, 3555, 4256, 4981, 5617, 6079, 6895, 7184, 7932, 8422, 9316]","[1326, 1744, 2154, 2620, 3251, 3746, 4413, 4968, 5336, 5882, 6352, 6619, 7226, 7693, 7928]","[664, 858, 948, 1310, 1734, 2116, 2354, 2673, 3064, 3244, 3646, 3933, 4332, 4683, 4918]","[453, 669, 778, 1239, 1490, 1614, 1885, 2065, 2226, 2406, 2655, 3021, 3221, 3688, 4140]",8283,9316,7928,4918,4140,78,90,67,58,100,"[874, 1295, 1620, 2181, 2606, 3106, 3685, 4400, 4664, 5460, 5773, 6266, 6767, 7061, 7279]","[871, 1268, 1549, 2132, 2403, 2745, 3224, 3783, 4131, 4422, 4833, 5085, 5647, 6082, 6524]","[667, 1032, 1304, 1478, 1903, 2196, 2485, 3022, 3358, 3838, 4247, 4656, 5068, 5474, 5926]","[426, 591, 694, 965, 1133, 1278, 1469, 1899, 2043, 2229, 2467, 2637, 2820, 3064, 3282]","[481, 694, 830, 958, 1093, 1183, 1408, 1844, 2033, 2219, 2528, 2623, 2718, 2942, 3160]",7279,6524,5926,3282,3160,1004,2792,2002,1636,980,8414,15,radiant
7549377918,73,35,129,105,112,"[403, 582, 910, 1269, 1573, 1984, 2326, 2977, 4010, 4862, 5848, 6767, 7764, 8934, 10050]","[337, 948, 1313, 1764, 2261, 2817, 3265, 3807, 4224, 4833, 5546, 5984, 6460, 7167, 7739]","[295, 697, 935, 1182, 1466, 1701, 2218, 2439, 2704, 3437, 4006, 4565, 5018, 5467, 5774]","[209, 299, 523, 613, 868, 958, 1048, 1310, 1818, 2260, 2759, 3358, 3768, 4209, 4831]","[209, 349, 517, 654, 791, 925, 1062, 1277, 1555, 1827, 2013, 2193, 2422, 2606, 2863]",10050,7739,5774,4831,2863,47,54,96,58,26,"[211, 459, 814, 1111, 1424, 1678, 2181, 2941, 3271, 3722, 4366, 4799, 5328, 5989, 6309]","[163, 473, 637, 1255, 1619, 1991, 2454, 2914, 3316, 3788, 4166, 4789, 5262, 5784, 6317]","[201, 440, 799, 1213, 1584, 1992, 2552, 2799, 3251, 3698, 4165, 4534, 4928, 5454, 5683]","[129, 219, 309, 499, 677, 809, 1051, 1315, 1452, 1587, 1727, 1943, 2332, 2689, 2990]","[180, 309, 399, 529, 697, 908, 1171, 1371, 1509, 1665, 1878, 2105, 2456, 2634, 2731]",6309,6317,5683,2990,2731,3741,1422,91,1841,132,7227,15,radiant
7549726004,17,102,96,110,26,"[1364, 1824, 2180, 2769, 3246, 4088, 4729, 5281, 6466, 7666, 8409, 9116, 9952, 10103, 10878]","[1396, 2064, 2351, 2824, 3151, 3457, 3948, 4128, 4891, 5433, 5723, 5998, 6803, 7250, 7789]","[1736, 2378, 2850, 3060, 3906, 4268, 4983, 5199, 5544, 5974, 6285, 6690, 7515, 7962, 8588]","[843, 1024, 1198, 1611, 2062, 2387, 2757, 2985, 3327, 3683, 3961, 4493, 5026, 5428, 6035]","[1185, 1526, 1710, 1883, 2170, 2365, 2549, 2729, 3154, 3425, 3743, 4113, 4556, 4761, 5301]",10878,7789,8588,6035,5301,128,137,41,40,105,"[1165, 1618, 1901, 2166, 2577, 2711, 3470, 3864, 4104, 4395, 5212, 5896, 6120, 7013, 7272]","[879, 1126, 1289, 1514, 1834, 2194, 2489, 2959, 3049, 3319, 3961, 4397, 4659, 5527, 5931]","[870, 980, 1304, 1624, 1786, 1986, 2220, 2835, 3084, 3486, 4271, 4724, 4977, 5341, 5616]","[512, 602, 737, 917, 1067, 1157, 1490, 2087, 2528, 2623, 3173, 3426, 3521, 4381, 4588]","[543, 726, 816, 996, 1136, 1226, 1411, 1669, 1909, 2004, 2959, 3212, 3307, 4105, 4199]",7272,5931,5616,4588,4199,3606,1858,2972,1447,1102,10985,15,radiant
7549735307,63,56,29,58,123,"[534, 931, 1290, 1994, 2682, 3109, 3592, 4217, 4598, 5161, 5741, 6244, 6769, 7440, 8094]","[323, 617, 1026, 1432, 1681, 2104, 2667, 3428, 3957, 4496, 5094, 5800, 6538, 7237, 7603]","[302, 540, 753, 1283, 1695, 2479, 2803, 3632, 4164, 5077, 5984, 6714, 7341, 8083, 8658]","[169, 462, 552, 947, 1371, 1788, 1944, 2330, 2785, 3176, 3369, 3649, 4132, 4696, 4903]","[282, 372, 462, 762, 899, 1328, 1739, 2366, 2583, 2911, 3196, 3311, 3744, 4101, 4308]",8094,7603,8658,4903,4308,46,14,49,45,20,"[322, 701, 1194, 1624, 1960, 2257, 2561, 3544, 4294, 4912, 5355, 5884, 6177, 6647, 6815]","[169, 521, 819, 1270, 1634, 1860, 2308, 2464, 2784, 3424, 3695, 3962, 4227, 4636, 4811]","[254, 537, 772, 895, 1021, 1314, 1645, 2127, 2627, 3111, 3393, 3483, 3672, 3979, 4383]","[169, 284, 420, 806, 1031, 1192, 1700, 1790, 2338, 2705, 2795, 2885, 2980, 3295, 3739]","[169, 284, 374, 464, 554, 644, 948, 1139, 1380, 1674, 1814, 2138, 2233, 2362, 2457]",6815,4811,4383,3739,2457,1279,2792,4275,1164,1851,11361,15,radiant
7549761004,10,106,96,123,20,"[1172, 1591, 2068, 2497, 2947, 3545, 4032, 4301, 4959, 5768, 6320, 7191, 8019, 9045, 10564]","[1281, 1692, 2136, 2369, 2949, 3253, 3793, 4375, 5032, 5917, 6634, 7345, 7978, 8399, 9028]","[1604, 2236, 2717, 3264, 3647, 3980, 4070, 4572, 4968, 6091, 6277, 6874, 7181, 7852, 8888]","[776, 990, 1157, 1247, 1519, 1654, 2065, 2155, 2736, 3173, 3306, 3657, 4403, 4636, 5306]","[706, 942, 1078, 1243, 1333, 1514, 1825, 1915, 2194, 2875, 3124, 3309, 3544, 3827, 4370]",10564,9028,8888,5306,4370,54,19,120,105,65,"[1147, 1297, 1465, 2074, 2517, 2942, 3211, 3506, 3957, 4098, 4797, 5273, 5783, 6418, 7326]","[1315, 1772, 2146, 2574, 2919, 3221, 3512, 3905, 4162, 4412, 4764, 5166, 6008, 6443, 6538]","[1099, 1350, 1707, 2162, 2509, 2820, 3095, 3437, 3751, 4117, 4281, 4640, 5172, 5356, 5554]","[525, 660, 1042, 1254, 1344, 1745, 2046, 2238, 2777, 2919, 3267, 3624, 4094, 4278, 4648]","[756, 895, 1289, 1501, 1721, 2105, 2240, 2384, 2565, 2659, 2932, 3149, 3359, 3544, 3639]",7326,6538,5554,4648,3639,3238,2490,3334,658,731,10451,15,radiant
7549801106,106,21,88,128,26,"[543, 920, 1241, 1568, 1968, 2458, 3042, 3643, 4307, 4737, 5213, 5933, 6645, 7051, 7790]","[654, 871, 1274, 1673, 2010, 2405, 2847, 3163, 3427, 3691, 3824, 4341, 4896, 5544, 6201]","[497, 1239, 1865, 2268, 2567, 2902, 3267, 3752, 4281, 4559, 4702, 5520, 6340, 6657, 7113]","[266, 420, 628, 850, 1030, 1212, 1302, 1551, 2016, 2311, 2491, 3639, 3920, 4140, 4389]","[240, 330, 487, 651, 886, 1021, 1111, 1371, 1576, 1683, 1822, 2441, 2536, 2720, 3012]",7790,6201,7113,4389,3012,41,77,74,119,110,"[487, 797, 965, 1292, 1825, 2224, 2518, 2999, 3330, 3797, 4416, 5021, 5605, 6122, 6951]","[603, 845, 1135, 1452, 1711, 2421, 2695, 3123, 3591, 3999, 4279, 4726, 5148, 6103, 6661]","[547, 926, 1243, 1579, 2024, 2317, 2577, 2667, 3228, 3592, 4046, 4141, 5002, 5671, 6156]","[299, 389, 479, 569, 659, 889, 979, 1622, 1712, 2151, 2295, 2426, 2643, 2999, 3220]","[299, 389, 479, 569, 708, 890, 997, 1319, 1474, 1652, 1940, 2220, 2528, 2712, 3096]",6951,6661,6156,3220,3096,839,-460,957,1169,-84,2421,15,dire
7549846718,19,93,69,45,121,"[0, 359, 700, 1097, 1508, 1795, 2223, 2921, 3339, 4016, 4344, 4586, 5409, 5905, 6077]","[0, 204, 560, 924, 1175, 1389, 1680, 1924, 2184, 2566, 3065, 3751, 4131, 5054, 5432]","[0, 208, 375, 684, 895, 1207, 1612, 1936, 2425, 2705, 3236, 3722, 4346, 5029, 5201]","[0, 269, 405, 540, 718, 808, 1249, 1386, 1601, 1844, 2135, 2426, 2844, 3482, 3982]","[0, 218, 355, 567, 657, 794, 976, 1277, 1367, 1536, 1992, 2136, 2531, 2871, 3090]",6077,5432,5201,3982,3090,25,22,49,123,30,"[0, 280, 997, 1306, 1648, 1979, 2398, 2953, 3253, 3727, 3969, 4491, 4914, 5451, 6441]","[0, 241, 578, 964, 1375, 1788, 2276, 2696, 3065, 3915, 4139, 4827, 5130, 5562, 6485]","[0, 239, 509, 825, 1141, 1685, 2066, 2560, 3129, 3755, 4096, 4384, 4712, 5109, 5576]","[0, 169, 259, 349, 553, 996, 1086, 1266, 1356, 1611, 1766, 2215, 2667, 2762, 3152]","[0, 169, 546, 636, 775, 905, 1041, 1221, 1311, 1566, 1701, 2009, 2144, 2287, 2594]",6441,6485,5576,3152,2594,-364,-1053,-375,830,496,-466,15,dire
7549855019,10,15,129,110,123,"[916, 1577, 1962, 2462, 2796, 3216, 3759, 4475, 4886, 5558, 6286, 7301, 8258, 9334, 10161]","[1473, 1958, 2451, 2875, 3368, 3757, 4092, 4404, 4905, 5344, 6045, 6716, 7475, 8198, 9532]","[990, 1452, 1992, 2818, 3063, 3704, 4167, 4711, 5816, 6479, 7068, 7484, 7971, 8599, 9164]","[486, 781, 911, 1201, 1337, 1558, 1693, 1873, 2388, 2779, 3183, 3715, 4021, 4393, 4905]","[567, 797, 1342, 1540, 1720, 1810, 1982, 2233, 3218, 3516, 4013, 4518, 4834, 5435, 5669]",10161,9532,9164,4905,5669,39,54,112,121,100,"[763, 1138, 1399, 1663, 2552, 2914, 3896, 4256, 4675, 5059, 5612, 6051, 6326, 6571, 6832]","[714, 933, 1177, 1455, 1958, 2393, 2934, 3135, 3457, 3710, 4206, 4833, 5155, 5250, 5788]","[769, 1261, 1511, 1734, 2086, 2360, 2794, 3214, 3518, 3855, 4235, 4588, 4847, 5252, 5817]","[432, 541, 678, 1147, 1508, 1724, 2303, 2555, 3043, 3133, 3878, 4152, 4247, 4640, 4795]","[384, 567, 657, 901, 1170, 1367, 1771, 1905, 2032, 2194, 3162, 3310, 3405, 3710, 3805]",6832,5788,5817,4795,3805,3329,3744,3347,110,1864,12394,15,radiant
7549866219,19,128,69,51,79,"[0, 203, 487, 749, 1082, 1333, 1724, 2226, 2635, 3375, 3738, 4806, 5342, 6128, 6683]","[0, 239, 520, 1076, 1367, 1590, 1862, 2392, 2775, 3321, 3752, 4421, 5060, 5495, 6462]","[0, 253, 774, 1206, 1647, 1988, 2664, 3410, 4188, 4698, 5476, 6319, 7143, 7750, 8256]","[0, 202, 310, 734, 938, 1028, 1192, 1484, 1907, 2267, 2562, 2973, 3293, 3874, 4403]","[0, 169, 617, 1095, 1185, 1552, 1716, 2346, 2819, 2983, 3211, 3757, 4121, 4469, 4716]",6683,6462,8256,4403,4716,12,25,45,38,121,"[0, 358, 817, 907, 1285, 1632, 2372, 2576, 3151, 3640, 3959, 4414, 4897, 5221, 5580]","[0, 349, 718, 1047, 1455, 1905, 2378, 2859, 3258, 3676, 4285, 5061, 5151, 5474, 5959]","[0, 422, 512, 715, 853, 986, 1215, 1579, 1769, 1960, 2233, 2436, 2526, 3067, 3626]","[0, 323, 522, 886, 1174, 1410, 1902, 2148, 2506, 2647, 3125, 3475, 3604, 4075, 4676]","[0, 553, 770, 910, 1092, 1202, 1443, 1773, 1908, 1998, 2191, 2394, 2652, 2837, 3086]",5580,5959,3626,4676,3086,1103,503,4630,-273,1630,7593,15,dire
7550262115,42,114,53,106,20,"[395, 710, 1023, 1252, 1927, 2205, 2890, 3467, 4291, 5102, 5908, 6715, 7352, 8173, 8726]","[958, 1480, 1803, 2418, 3053, 3497, 4249, 4811, 5375, 5806, 6613, 7007, 7464, 8014, 8340]","[521, 683, 842, 1191, 1451, 2202, 3030, 3594, 4129, 4418, 4980, 5891, 6366, 7001, 7454]","[683, 970, 1230, 1458, 2087, 2468, 2904, 3644, 4204, 4833, 5217, 5721, 6134, 6613, 7309]","[520, 659, 1010, 1214, 1499, 1736, 2135, 2489, 2898, 3423, 3647, 4150, 4369, 4695, 4984]",8726,8340,7454,7309,4984,17,38,1,101,121,"[884, 1248, 1660, 2245, 2450, 2634, 3162, 3550, 3986, 4081, 4404, 4809, 5038, 5605, 6069]","[871, 1142, 1300, 1610, 2276, 2654, 2867, 3339, 3780, 4229, 4562, 4981, 5284, 6121, 6568]","[419, 580, 819, 1311, 1471, 1798, 1961, 2306, 3005, 3172, 3580, 4154, 4585, 4787, 4882]","[360, 450, 540, 732, 1040, 1175, 1265, 1355, 2021, 2111, 2401, 2501, 2650, 3011, 3106]","[447, 537, 627, 966, 1143, 1362, 1537, 1627, 1892, 1982, 2247, 2480, 2629, 2724, 2819]",6069,6568,4882,3106,2819,2657,1772,2572,4203,2165,13369,15,radiant
7550266815,46,93,96,105,83,"[243, 606, 958, 1360, 1743, 2277, 2670, 3122, 3451, 4080, 4424, 5142, 6001, 6720, 7024]","[285, 589, 927, 1267, 1590, 2083, 2549, 2961, 3601, 4089, 4576, 5141, 6247, 6755, 6903]","[287, 495, 820, 1103, 1425, 2172, 2262, 2864, 3239, 3901, 4490, 5018, 5717, 6159, 6534]","[169, 259, 349, 483, 926, 1152, 1320, 1495, 1630, 2104, 2323, 2541, 2780, 2964, 3195]","[269, 359, 548, 674, 784, 919, 1009, 1401, 1581, 1884, 2064, 2154, 2497, 2708, 2904]",7024,6903,6534,3195,2904,15,41,13,53,19,"[203, 440, 756, 891, 1285, 1702, 2151, 2449, 2836, 3260, 3828, 4150, 4800, 5537, 6466]","[331, 533, 839, 1230, 1667, 1957, 2554, 2821, 3091, 3560, 4155, 4425, 4735, 5344, 6084]","[239, 488, 810, 1095, 1410, 1710, 2281, 2533, 2835, 3017, 3890, 4217, 4807, 5313, 6397]","[169, 259, 425, 562, 736, 965, 1322, 1412, 1541, 1795, 2191, 2499, 3084, 3445, 3985]","[169, 338, 543, 683, 920, 1055, 1280, 1459, 1549, 1664, 2060, 2150, 2476, 2877, 3348]",6466,6084,6397,3985,3348,558,819,137,-790,-444,280,15,radiant
7550292203,13,41,43,100,75,"[0, 243, 601, 1021, 1383, 1826, 2350, 3026, 3540, 3993, 4625, 5314, 5859, 6177, 6738]","[0, 251, 497, 929, 1293, 1859, 2221, 2489, 2649, 3083, 3621, 4239, 4836, 5484, 5930]","[4, 264, 475, 792, 1103, 1513, 1942, 2580, 3678, 4123, 4528, 5213, 5585, 6210, 6611]","[0, 172, 266, 356, 701, 831, 1513, 1648, 1971, 2061, 2287, 2601, 3186, 3598, 4121]","[0, 170, 260, 488, 622, 837, 1371, 1583, 1907, 2066, 2341, 2877, 3106, 3344, 3638]",6738,5930,6611,4121,3638,89,90,129,110,123,"[58, 263, 539, 824, 1015, 1414, 1879, 2314, 2678, 3057, 3599, 4101, 4832, 5225, 5487]","[58, 468, 632, 1005, 1355, 1823, 2661, 3109, 3537, 3943, 4537, 4934, 5123, 5706, 6268]","[58, 313, 802, 1242, 1499, 1957, 2348, 2714, 3317, 3652, 3968, 4321, 4990, 5496, 5885]","[326, 496, 586, 723, 847, 982, 1163, 1310, 1577, 1744, 1934, 2273, 2476, 2746, 2979]","[58, 228, 381, 535, 625, 715, 943, 1159, 1434, 1524, 1832, 1982, 2220, 2512, 2924]",5487,6268,5885,2979,2924,1251,-338,726,1142,714,3495,15,radiant
7550321213,18,80,23,123,20,"[1435, 1896, 2379, 3130, 3800, 4391, 5160, 5809, 7194, 8419, 9664, 11053, 11937, 12960, 14337]","[1157, 1568, 2076, 2807, 3302, 3871, 4606, 5361, 5841, 6613, 7270, 7801, 8488, 8908, 9743]","[1613, 1776, 2496, 3108, 3773, 4331, 5356, 6038, 6543, 6997, 7938, 8084, 8792, 9287, 9467]","[819, 1042, 1177, 1448, 1927, 2062, 2655, 2872, 3730, 4270, 4915, 5092, 5297, 5589, 5923]","[764, 1171, 1307, 1589, 1828, 1963, 2376, 2787, 3031, 3343, 3874, 4120, 4370, 4575, 5171]",14337,9743,9467,5923,5171,93,129,64,102,74,"[914, 1079, 1246, 1336, 1655, 1908, 2293, 2663, 2973, 3243, 3829, 4148, 4458, 4590, 5162]","[682, 897, 1282, 1504, 1718, 2321, 2988, 3078, 3254, 3517, 4045, 4139, 4297, 4774, 5147]","[647, 737, 827, 917, 1089, 1214, 1533, 1764, 1888, 2340, 3053, 3735, 3893, 4494, 5093]","[673, 763, 949, 1039, 1129, 1549, 1907, 1997, 2087, 2350, 3337, 3722, 3880, 4222, 4628]","[733, 942, 1082, 1243, 1433, 1724, 2043, 2318, 2444, 2707, 2886, 3016, 3213, 3516, 3852]",5162,5147,5093,4628,3852,9175,4596,4374,1295,1319,20759,15,radiant
7550369811,10,17,29,110,123,"[671, 1378, 1840, 2098, 2428, 2884, 3056, 3396, 3729, 4309, 4694, 5641, 6123, 6437, 6963]","[560, 945, 1324, 1731, 2094, 2569, 2973, 3514, 4253, 4596, 4704, 5623, 5972, 6450, 7418]","[473, 883, 1086, 1211, 1475, 1865, 2081, 2409, 2920, 3304, 3757, 4269, 4875, 5266, 5538]","[284, 478, 701, 896, 986, 1169, 1358, 1557, 1948, 2076, 2295, 2715, 2810, 3389, 3571]","[319, 663, 793, 883, 1093, 1679, 2062, 2152, 2609, 2699, 2789, 3529, 3811, 4234, 4588]",6963,7418,5538,3571,4588,25,78,19,128,20,"[577, 938, 1376, 1930, 2671, 3323, 3972, 4220, 4704, 5116, 5705, 5800, 6706, 8631, 9213]","[606, 883, 1242, 1590, 1960, 2229, 2728, 3281, 3636, 4089, 4252, 4761, 5514, 6344, 7150]","[564, 806, 1133, 1469, 1814, 2076, 2369, 2992, 3583, 3932, 4248, 4541, 5068, 6115, 6654]","[259, 401, 714, 850, 985, 1170, 1830, 2337, 2764, 3265, 3747, 3903, 4188, 4464, 4777]","[294, 384, 520, 768, 1068, 1203, 1487, 1665, 1901, 2110, 2270, 2365, 2699, 3107, 3498]",9213,7150,6654,4777,3498,-2250,268,-1116,-1206,1090,-3214,15,radiant
7550382805,48,106,80,123,20,"[869, 1203, 1697, 2055, 2444, 2803, 3217, 3385, 4166, 4759, 5598, 6305, 6818, 7684, 8366]","[922, 1264, 1508, 1891, 2432, 2890, 3224, 3650, 4197, 4402, 4892, 5324, 5650, 6279, 7065]","[888, 1178, 1505, 1628, 1991, 2655, 3032, 3603, 3842, 4282, 4776, 5005, 5379, 5667, 5913]","[479, 585, 803, 974, 1245, 1422, 1557, 1748, 1901, 2076, 2485, 2716, 2811, 3209, 3598]","[547, 779, 1033, 1162, 1252, 1462, 1597, 1954, 2044, 2187, 2585, 2963, 3086, 3333, 3458]",8366,7065,5913,3598,3458,46,63,33,136,83,"[800, 1127, 1464, 1986, 2473, 3102, 3775, 4386, 5212, 6033, 6769, 7763, 8279, 9216, 10344]","[799, 1253, 1468, 2101, 2489, 2891, 3295, 3556, 3831, 4812, 5330, 6401, 6859, 7544, 8091]","[1419, 1991, 2118, 2632, 3353, 3966, 4353, 5354, 5761, 6154, 6572, 6971, 7302, 7771, 8211]","[561, 768, 1105, 1265, 1538, 1832, 1994, 2216, 2351, 2692, 2919, 3405, 3605, 4159, 4517]","[443, 622, 801, 985, 1246, 1474, 1636, 1858, 2193, 2700, 3046, 3395, 3649, 4216, 4570]",10344,8091,8211,4517,4570,-1978,-1026,-2298,-919,-1112,-7333,15,radiant
7550385619,106,41,7,53,121,"[0, 539, 839, 1251, 1413, 1899, 2268, 2660, 3039, 3496, 3905, 4278, 4903, 5120, 5586]","[0, 278, 475, 726, 1008, 1291, 1604, 1894, 2234, 2399, 3166, 3588, 4161, 4660, 5205]","[0, 244, 474, 784, 1150, 1507, 1753, 2427, 2685, 3112, 3511, 4166, 4681, 5021, 5596]","[0, 271, 361, 734, 941, 1157, 1297, 1867, 2001, 2204, 2538, 2702, 3180, 3322, 3516]","[0, 315, 450, 773, 863, 1079, 1169, 1417, 1541, 2038, 2356, 2730, 3037, 3180, 3274]",5586,5205,5596,3516,3274,49,98,21,58,19,"[0, 202, 523, 837, 1244, 1608, 1909, 2409, 2942, 3236, 3508, 3901, 4565, 5284, 5874]","[0, 287, 531, 949, 1219, 1516, 1753, 1959, 2366, 2845, 3059, 3525, 4245, 4620, 4927]","[0, 248, 478, 725, 1234, 1438, 1775, 1981, 2770, 2958, 3338, 3866, 4152, 5046, 5493]","[0, 130, 263, 390, 525, 769, 859, 1004, 1215, 1420, 1591, 1718, 2344, 2786, 3080]","[0, 130, 269, 359, 604, 1011, 1220, 1402, 1664, 1876, 2252, 2352, 2532, 2825, 3205]",5874,4927,5493,3080,3205,-288,278,103,436,69,598,15,radiant
7550400712,138,137,101,29,31,"[205, 491, 889, 1186, 1407, 1910, 2105, 2594, 3163, 3505, 4443, 5033, 5466, 6047, 6463]","[424, 751, 1109, 1465, 1794, 2297, 2485, 2906, 3287, 3844, 4594, 4924, 5117, 5400, 6008]","[170, 594, 798, 972, 1062, 1484, 1981, 2237, 2363, 2989, 3154, 3968, 4366, 4746, 5332]","[290, 633, 801, 1155, 1531, 1827, 2088, 2484, 2822, 3527, 3838, 4256, 4734, 5181, 5734]","[170, 310, 446, 576, 666, 955, 1045, 1220, 1592, 1950, 2183, 2498, 2691, 2974, 3320]",6463,6008,5332,5734,3320,114,36,88,121,26,"[207, 409, 978, 1325, 1485, 2026, 2199, 2548, 2719, 2809, 3286, 3569, 4078, 4737, 5449]","[170, 445, 773, 1104, 1347, 1596, 1846, 2128, 2542, 2704, 3147, 3434, 3600, 3820, 4578]","[256, 589, 793, 1160, 1288, 1619, 1923, 2107, 2458, 2674, 3027, 3340, 4177, 4893, 5041]","[170, 260, 398, 533, 707, 933, 1023, 1477, 1733, 1823, 2278, 2368, 2463, 2682, 3079]","[170, 260, 528, 618, 708, 893, 1021, 1240, 1375, 1757, 2242, 2379, 2562, 2696, 3057]",5449,4578,5041,3079,3057,1014,1430,291,2655,263,5653,15,radiant
7550455815,113,120,14,26,2,"[543, 1273, 2064, 2748, 3374, 3909, 4543, 5173, 5677, 6393, 6961, 7878, 8583, 8904, 9438]","[663, 1031, 1375, 1615, 1905, 2428, 2691, 2960, 3671, 4150, 4510, 5419, 5513, 6165, 6993]","[260, 636, 934, 1149, 1521, 1611, 1874, 2061, 2394, 2718, 2859, 3164, 3258, 3862, 4109]","[260, 497, 587, 677, 1118, 1253, 1388, 1548, 1936, 2031, 2195, 2351, 2445, 2694, 3068]","[339, 705, 811, 901, 1156, 1246, 1393, 1798, 1948, 2068, 2380, 2774, 2961, 3372, 3467]",9438,6993,4109,3068,3467,13,40,38,21,105,"[978, 1311, 1745, 2027, 3228, 3614, 4406, 4904, 5376, 5897, 6709, 7312, 7923, 8793, 10149]","[656, 1042, 1513, 2120, 2368, 3051, 3586, 3939, 4856, 5081, 5641, 6447, 6745, 7260, 8186]","[409, 573, 788, 958, 1610, 2024, 2276, 2725, 3070, 3519, 4072, 4654, 5224, 5629, 6769]","[260, 549, 1085, 1481, 2020, 2202, 2525, 2705, 2795, 3316, 3720, 4029, 4657, 5018, 5556]","[323, 413, 503, 822, 982, 1117, 1207, 1564, 1654, 1926, 2099, 3014, 3191, 3376, 3710]",10149,8186,6769,5556,3710,-711,-1193,-2660,-2488,-243,-7295,15,dire
7550509001,8,17,20,126,5,"[0, 201, 661, 1006, 1214, 1835, 2284, 2766, 3183, 3606, 4432, 4975, 5467, 6359, 6591]","[0, 250, 558, 970, 1263, 1927, 2476, 2819, 3448, 4246, 5168, 5515, 5978, 6626, 7346]","[0, 471, 688, 1307, 1431, 1803, 2469, 2923, 3421, 3753, 4342, 4573, 5253, 5631, 6317]","[0, 203, 293, 785, 875, 1093, 1523, 1654, 1964, 2181, 2399, 2540, 2752, 3723, 3985]","[0, 203, 372, 510, 687, 916, 1132, 1849, 2029, 2312, 2596, 2873, 3010, 3118, 3378]",6591,7346,6317,3985,3378,43,82,45,102,84,"[0, 297, 637, 841, 1380, 1627, 1928, 2569, 3238, 3734, 4033, 4671, 5503, 5714, 6520]","[0, 375, 619, 989, 1257, 1396, 1839, 2086, 2489, 2813, 3443, 3848, 4626, 5206, 5721]","[0, 209, 500, 590, 767, 1071, 1408, 1498, 1871, 2253, 2784, 3102, 3659, 4194, 5371]","[0, 285, 539, 982, 1382, 1714, 1973, 2295, 2760, 3648, 4157, 4644, 5235, 5768, 6298]","[0, 418, 508, 692, 1095, 1247, 1427, 1675, 1810, 2238, 2533, 2672, 3050, 3145, 4330]",6520,5721,5371,6298,4330,71,1625,946,-2313,-952,-623,15,dire
7550636605,126,54,102,100,26,"[0, 294, 688, 1061, 1632, 2014, 2489, 2916, 3324, 3764, 4445, 4949, 5517, 5612, 6316]","[0, 244, 592, 982, 1375, 1877, 2314, 2756, 3267, 3759, 4260, 4824, 5280, 5849, 6343]","[0, 326, 619, 1500, 2000, 2690, 3175, 3630, 4220, 4708, 5662, 6068, 6603, 7088, 7641]","[0, 169, 259, 474, 690, 907, 1044, 1134, 1314, 1449, 1795, 1885, 1975, 2241, 2390]","[0, 169, 259, 364, 534, 789, 926, 1055, 1253, 1388, 1523, 1655, 1745, 1912, 2105]",6316,6343,7641,2390,2105,11,2,74,86,84,"[0, 292, 730, 982, 1446, 1625, 2066, 2436, 3152, 3625, 3953, 4119, 5031, 5644, 6202]","[0, 254, 491, 821, 1194, 1613, 2028, 2461, 3389, 4473, 4946, 5515, 6647, 7014, 7369]","[0, 257, 631, 757, 1434, 1860, 2058, 2447, 2798, 3368, 3707, 4140, 4746, 5147, 5705]","[0, 169, 311, 444, 534, 641, 776, 1166, 1511, 1786, 1921, 2184, 2681, 2944, 3318]","[0, 169, 259, 349, 484, 645, 735, 872, 1039, 1153, 1429, 1780, 1994, 2251, 2484]",6202,7369,5705,3318,2484,114,-1026,1936,-928,-379,-283,15,dire
7550680216,29,81,21,26,87,"[0, 239, 540, 839, 1243, 1488, 1866, 2208, 2691, 2820, 3549, 4047, 4756, 5458, 5857]","[0, 286, 415, 738, 1153, 1882, 2273, 2704, 3077, 3378, 4000, 4493, 5228, 5865, 6300]","[0, 243, 526, 873, 1203, 1535, 2017, 2485, 2815, 3271, 3676, 4038, 4674, 5169, 5706]","[0, 169, 259, 349, 488, 614, 807, 942, 1081, 1171, 1515, 1687, 1895, 2610, 2705]","[0, 169, 296, 433, 570, 790, 925, 1141, 1231, 1358, 1601, 1740, 2056, 2345, 2440]",5857,6300,5706,2705,2440,126,4,71,27,58,"[0, 252, 540, 912, 1411, 1712, 2080, 2465, 3065, 3706, 4089, 4527, 4975, 5918, 6411]","[0, 204, 434, 677, 1010, 1414, 1741, 2361, 2803, 3424, 3934, 4508, 4916, 5974, 6645]","[0, 169, 491, 820, 1176, 1458, 1776, 2232, 2643, 3030, 3502, 3906, 4458, 5022, 5171]","[0, 169, 259, 441, 571, 697, 836, 1016, 1228, 1363, 1498, 1716, 2354, 2602, 2964]","[0, 169, 259, 389, 556, 694, 931, 1352, 1502, 1891, 2097, 2386, 2590, 3146, 3594]",6411,6645,5171,2964,3594,-554,-345,535,-259,-1154,-1777,15,dire
7550704109,41,120,97,86,58,"[0, 279, 486, 843, 1131, 1369, 1698, 1959, 2431, 2904, 3331, 4145, 4620, 5365, 5981]","[0, 205, 499, 900, 1352, 1825, 2595, 2746, 3170, 3589, 4468, 4942, 5674, 6080, 6441]","[0, 285, 532, 1042, 1412, 1532, 2069, 2312, 2673, 3252, 3617, 4151, 4737, 5672, 6238]","[0, 170, 260, 432, 675, 765, 855, 1188, 1347, 1437, 1878, 2138, 2336, 2624, 3197]","[0, 170, 260, 463, 675, 841, 975, 1143, 1276, 1597, 1873, 2095, 2491, 2850, 2983]",5981,6441,6238,3197,2983,48,98,106,121,119,"[0, 206, 511, 844, 1212, 1513, 1891, 2147, 2697, 3198, 3709, 4318, 4919, 5593, 6240]","[0, 216, 455, 690, 937, 1298, 1707, 2122, 2593, 3128, 3714, 4173, 5061, 5497, 5967]","[0, 293, 627, 999, 1378, 1639, 1934, 2433, 2775, 3194, 3636, 4207, 4740, 5102, 5315]","[0, 170, 303, 393, 580, 670, 805, 941, 1089, 1333, 1502, 1804, 2300, 2536, 2631]","[0, 170, 260, 350, 440, 601, 736, 1031, 1166, 1390, 1559, 2020, 2399, 2700, 2901]",6240,5967,5315,2631,2901,-259,474,923,566,82,1786,15,radiant
7550728517,77,44,90,72,83,"[0, 289, 603, 880, 1253, 1785, 2209, 2732, 3155, 4325, 4874, 5614, 6533, 7176, 7561]","[0, 292, 728, 1157, 1484, 1899, 2359, 2865, 3322, 3850, 4265, 4928, 5464, 5869, 6532]","[0, 255, 541, 916, 1212, 1598, 1925, 2340, 2760, 3376, 4095, 4613, 5115, 5557, 6057]","[0, 170, 260, 425, 601, 1137, 1314, 1404, 1543, 1960, 2192, 2877, 3093, 3370, 3752]","[0, 170, 260, 398, 580, 719, 809, 946, 1083, 1403, 1575, 1969, 2130, 2366, 2461]",7561,6532,6057,3752,2461,48,14,43,45,5,"[0, 284, 557, 1020, 1485, 1909, 2448, 2958, 3607, 3832, 4317, 4930, 5434, 5830, 6737]","[0, 327, 660, 1073, 1493, 2044, 2873, 3326, 3999, 4443, 5140, 5650, 6123, 6640, 7156]","[0, 331, 656, 1019, 1399, 1761, 2361, 2939, 3573, 4654, 4998, 5552, 6043, 6615, 7114]","[0, 170, 260, 350, 484, 588, 678, 768, 993, 1308, 1398, 1629, 1756, 1850, 2035]","[0, 170, 260, 363, 498, 605, 695, 788, 1065, 1183, 1273, 1363, 1597, 1736, 1969]",6737,7156,7114,2035,1969,824,-624,-1057,1717,492,1352,15,dire
7550811717,48,11,71,86,84,"[1, 289, 699, 1086, 1472, 1929, 2500, 3096, 3601, 4195, 5134, 5691, 6242, 6845, 7575]","[1, 285, 652, 1064, 1557, 2089, 2718, 3864, 4323, 4984, 5556, 6586, 7398, 7910, 8809]","[1, 251, 576, 851, 1317, 1687, 1974, 2274, 2657, 2830, 3295, 3541, 4324, 4633, 4943]","[1, 171, 273, 431, 609, 747, 1037, 1314, 1483, 1573, 1812, 2138, 2579, 3023, 3460]","[1, 171, 261, 430, 564, 701, 837, 1063, 1201, 1361, 1724, 1975, 2527, 2675, 2891]",7575,8809,4943,3460,2891,18,14,97,30,5,"[1, 259, 572, 986, 1405, 1802, 2153, 2644, 3114, 3606, 4144, 4863, 5336, 6090, 6811]","[1, 324, 677, 1129, 1614, 1992, 2631, 3213, 3382, 3980, 4660, 5146, 5683, 6377, 6944]","[1, 335, 529, 814, 1300, 1755, 2198, 2800, 3270, 3705, 4050, 4353, 4860, 5220, 5754]","[1, 171, 261, 351, 441, 531, 621, 801, 1053, 1143, 1233, 1323, 1468, 1715, 2046]","[1, 171, 310, 432, 568, 735, 870, 1094, 1218, 1405, 1503, 1593, 1738, 1957, 2096]",6811,6944,5754,2046,2096,764,1865,-811,1414,795,4027,15,radiant
7550854213,25,109,53,86,5,"[0, 367, 723, 1081, 1534, 2264, 2766, 3395, 4219, 4787, 5539, 6274, 7275, 8002, 9077]","[0, 327, 642, 1015, 1467, 1870, 2445, 3079, 3453, 4027, 4377, 4810, 5272, 5760, 6464]","[0, 246, 494, 734, 1296, 1658, 2035, 2218, 2565, 2799, 3160, 3336, 3760, 4167, 4664]","[0, 213, 351, 464, 751, 890, 1072, 1255, 1465, 1629, 1897, 2308, 2718, 3165, 3774]","[0, 169, 612, 751, 890, 1030, 1247, 1430, 1568, 1830, 1954, 2230, 2374, 2603, 2745]",9077,6464,4664,3774,2745,74,48,81,27,83,"[0, 287, 658, 990, 1398, 1853, 2339, 2786, 3147, 3651, 4166, 4882, 5520, 5939, 6567]","[0, 169, 415, 774, 983, 1233, 1519, 1726, 2170, 2647, 3178, 3706, 4238, 4810, 5342]","[0, 282, 518, 887, 1295, 1624, 1966, 2350, 2648, 3110, 3596, 3741, 4467, 4959, 5885]","[0, 216, 342, 432, 585, 675, 914, 1076, 1544, 1867, 2442, 2662, 3173, 3331, 3539]","[0, 169, 259, 395, 597, 722, 851, 1027, 1117, 1223, 1313, 1504, 1642, 1836, 1968]",6567,5342,5885,3539,1968,2510,1122,-1221,235,777,3423,15,radiant
7550988313,4,126,21,31,112,"[0, 289, 945, 1190, 1470, 1733, 2288, 2920, 3312, 4249, 4808, 5065, 6161, 6412, 6737]","[0, 326, 539, 774, 1029, 1411, 1576, 2163, 2566, 2944, 3034, 3246, 3875, 4192, 4423]","[0, 170, 433, 749, 1061, 1224, 1710, 1890, 2331, 2759, 2849, 3014, 3338, 3966, 4358]","[0, 273, 427, 565, 655, 871, 1008, 1313, 1493, 1745, 1888, 2038, 2405, 2554, 2767]","[0, 170, 260, 388, 526, 616, 830, 1010, 1322, 1730, 1938, 2028, 2218, 2709, 2879]",6737,4423,4358,2767,2879,10,45,60,25,85,"[0, 244, 593, 882, 1247, 1654, 2169, 2653, 2995, 3320, 3809, 4193, 4301, 4846, 5383]","[0, 204, 883, 1214, 1722, 2005, 2534, 2945, 3483, 4270, 4488, 5360, 5742, 6296, 6745]","[0, 240, 469, 805, 1191, 1480, 1693, 2305, 2727, 3022, 3450, 3924, 4415, 4940, 5367]","[0, 170, 355, 494, 798, 1038, 1128, 1440, 1647, 2011, 2146, 2744, 2834, 3165, 3364]","[0, 271, 610, 745, 1131, 1266, 1576, 1851, 2031, 2388, 2709, 3049, 3254, 3386, 3606]",5383,6745,5367,3364,3606,1354,-2322,-1009,-597,-727,-3301,15,dire
7551597806,82,74,19,65,85,"[0, 289, 655, 1097, 1624, 1867, 2417, 3023, 3767, 4480, 5020, 5451, 6290, 7049, 7659]","[0, 209, 390, 680, 1135, 1445, 1746, 2205, 2601, 3045, 3616, 4254, 4788, 5085, 5598]","[0, 251, 538, 784, 1370, 1615, 1906, 2326, 2696, 3046, 3628, 4419, 4776, 5295, 5623]","[0, 170, 260, 387, 659, 749, 924, 1014, 1164, 1435, 1688, 2191, 2454, 2689, 3291]","[0, 170, 260, 350, 640, 730, 820, 910, 1045, 1309, 1532, 1915, 2005, 2253, 2506]",7659,5598,5623,3291,2506,94,129,103,83,119,"[0, 170, 586, 872, 1326, 1654, 1883, 2367, 2827, 3108, 3425, 3549, 3968, 4783, 5380]","[0, 329, 724, 1068, 1393, 1681, 2307, 2710, 3409, 3783, 4392, 4794, 5367, 5767, 5971]","[0, 244, 502, 740, 1043, 1447, 1812, 2315, 2786, 3089, 3898, 3996, 4404, 4634, 5131]","[0, 170, 285, 375, 514, 604, 768, 967, 1164, 1254, 1755, 1850, 2271, 2672, 3338]","[0, 213, 362, 452, 542, 897, 1394, 1529, 1619, 1709, 2112, 2205, 2496, 2748, 3243]",5380,5971,5131,3338,3243,2279,-373,492,-47,-737,1614,15,radiant
7551667014,48,21,106,86,105,"[849, 1093, 1304, 1662, 2060, 2311, 2948, 3123, 3747, 4364, 5166, 5683, 6330, 7048, 7697]","[957, 1448, 2150, 2509, 2857, 3152, 3411, 3870, 4251, 4519, 4968, 5458, 5820, 5981, 6482]","[1020, 1395, 1789, 1973, 2264, 2580, 3001, 3417, 3794, 4090, 4709, 5055, 5629, 5848, 6512]","[350, 480, 695, 1140, 1320, 1457, 1547, 1637, 1772, 2136, 2364, 2598, 2865, 3262, 3623]","[394, 524, 653, 1226, 1406, 1512, 1711, 1883, 2160, 2250, 2517, 2686, 2781, 2951, 3120]",7697,6482,6512,3623,3120,41,49,102,121,20,"[678, 954, 1253, 1549, 1810, 2266, 2701, 3159, 3809, 4440, 5058, 5777, 6518, 7062, 7994]","[882, 1337, 1711, 2212, 2814, 3193, 3705, 4142, 4892, 5417, 6188, 6907, 7396, 8085, 8794]","[760, 1053, 1709, 2115, 2452, 3055, 3606, 4167, 4949, 5242, 5927, 6508, 6945, 7581, 8078]","[398, 535, 802, 1036, 1126, 1345, 1435, 1832, 2101, 2447, 2817, 3359, 3681, 4032, 4178]","[436, 590, 720, 1065, 1155, 1419, 1509, 1776, 2081, 2294, 2773, 2925, 3366, 3833, 4129]",7994,8794,8078,4178,4129,-297,-2312,-1566,-555,-1009,-5739,15,dire
7551823505,10,135,53,14,105,"[279, 609, 933, 1381, 1800, 2570, 2789, 3207, 3751, 4104, 4762, 5102, 5860, 6265, 6717]","[654, 818, 1294, 1658, 1947, 2196, 2535, 3077, 3751, 4167, 4652, 5339, 6085, 6648, 7586]","[226, 354, 532, 821, 1094, 1645, 1828, 1989, 2468, 2848, 3040, 3462, 4246, 4341, 4846]","[226, 316, 455, 604, 739, 1353, 1659, 1864, 2109, 2279, 2432, 2738, 3281, 3496, 3702]","[170, 260, 350, 485, 623, 1046, 1226, 1359, 1543, 1681, 1873, 2053, 2423, 2543, 2780]",6717,7586,4846,3702,2780,18,123,31,71,26,"[731, 1107, 1340, 1655, 1983, 2361, 2785, 3584, 4173, 5009, 5571, 6149, 7014, 7577, 8274]","[354, 574, 793, 1177, 1267, 1496, 1926, 2186, 2412, 2714, 2888, 3348, 3860, 4253, 4873]","[315, 566, 762, 1047, 1288, 1712, 1964, 2257, 2483, 2826, 3310, 3521, 3821, 3916, 4252]","[311, 401, 698, 1075, 1165, 1519, 1944, 2397, 2532, 2950, 3117, 3207, 3356, 3732, 4153]","[513, 641, 824, 1060, 1150, 1240, 1403, 1694, 1864, 2145, 2511, 2705, 2854, 3249, 3584]",8274,4873,4252,4153,3584,-1557,2713,594,-451,-804,495,15,radiant
7552008919,6,126,38,119,21,"[0, 256, 911, 1251, 1603, 2171, 2345, 2986, 3700, 4227, 4764, 5793, 6161, 6979, 8117]","[0, 293, 581, 881, 1248, 1495, 1976, 2387, 3058, 3479, 4176, 4678, 5448, 6048, 6948]","[0, 244, 481, 736, 1187, 1606, 1992, 2462, 2848, 3541, 3813, 4459, 4936, 5433, 6050]","[0, 170, 327, 417, 593, 831, 1191, 1373, 1808, 2245, 2592, 2953, 3506, 3676, 4055]","[0, 170, 260, 350, 710, 906, 1261, 1459, 1594, 1771, 1945, 2164, 2488, 2768, 3330]",8117,6948,6050,4055,3330,95,84,23,123,26,"[0, 252, 623, 901, 1154, 1362, 1665, 1923, 2519, 2989, 3281, 3642, 4268, 4771, 5491]","[0, 318, 556, 975, 1304, 1656, 1947, 2433, 2841, 3418, 4099, 4529, 4656, 4958, 5053]","[0, 208, 471, 669, 920, 1433, 1873, 2140, 2544, 2893, 3209, 3374, 3816, 4341, 4559]","[0, 170, 260, 350, 440, 614, 1040, 1222, 1312, 1731, 2121, 2265, 2760, 3215, 3551]","[0, 170, 260, 350, 527, 657, 799, 889, 1180, 1674, 1991, 2199, 2452, 2654, 3051]",5491,5053,4559,3551,3051,2626,1895,1491,504,279,6795,15,radiant
7552020905,18,46,104,72,22,"[0, 244, 606, 1109, 1536, 1913, 2408, 2940, 3589, 4256, 5149, 5806, 6456, 7029, 7394]","[0, 407, 696, 1180, 1455, 1947, 2385, 2790, 3310, 4180, 5071, 5611, 6378, 6982, 7564]","[0, 279, 554, 989, 1350, 1750, 2107, 2435, 2838, 3052, 3519, 3840, 4330, 4785, 5396]","[0, 170, 308, 443, 613, 746, 884, 974, 1203, 1383, 1818, 1986, 2218, 2833, 3240]","[0, 170, 278, 429, 635, 1319, 1456, 1584, 1800, 1935, 2119, 2209, 2418, 2637, 2839]",7394,7564,5396,3240,2839,48,19,96,5,86,"[0, 279, 595, 1005, 1402, 2047, 2470, 3012, 3508, 4248, 4842, 5356, 6042, 6769, 7394]","[0, 324, 617, 1032, 1521, 1971, 2394, 3038, 3560, 4206, 4778, 5259, 5930, 6151, 7035]","[0, 283, 510, 904, 1235, 1478, 1896, 2329, 2697, 3072, 3572, 4033, 4489, 4844, 5454]","[0, 170, 260, 437, 567, 749, 886, 1113, 1307, 1534, 1722, 1937, 2027, 2122, 2671]","[0, 222, 312, 402, 532, 658, 748, 974, 1109, 1199, 1383, 1519, 1609, 1704, 2148]",7394,7035,5454,2671,2148,0,529,-58,569,691,1731,15,dire
7552046611,56,51,55,105,86,"[0, 314, 710, 963, 1301, 1622, 2201, 2565, 3076, 3586, 4249, 5281, 5697, 6271, 6613]","[0, 581, 919, 1368, 1861, 2186, 2468, 3051, 3352, 3759, 4293, 4679, 5014, 5352, 5630]","[0, 199, 444, 733, 1097, 1422, 1907, 2565, 2854, 3496, 4087, 4470, 4807, 5000, 5866]","[0, 281, 574, 664, 842, 972, 1358, 1696, 1786, 2065, 2368, 2690, 3104, 3253, 3450]","[0, 281, 371, 461, 591, 721, 846, 1149, 1290, 1463, 1780, 2101, 2437, 2707, 3120]",6613,5630,5866,3450,3120,48,126,69,21,27,"[0, 363, 651, 1111, 1546, 1880, 2295, 2662, 3201, 3759, 4420, 4791, 5612, 6180, 6927]","[0, 246, 480, 885, 1293, 1644, 2123, 2530, 3145, 3683, 4038, 4642, 5627, 6588, 7102]","[0, 574, 772, 1092, 1353, 1527, 1759, 2229, 2823, 3187, 3705, 4248, 4907, 5524, 6062]","[0, 272, 382, 492, 626, 763, 957, 1131, 1467, 1728, 2085, 2268, 2755, 3199, 3607]","[0, 272, 574, 682, 772, 1115, 1205, 1343, 1665, 1929, 2019, 2109, 2308, 2501, 2695]",6927,7102,6062,3607,2695,-314,-1472,-196,-157,425,-1714,15,dire
7552069010,126,109,21,86,20,"[0, 288, 527, 921, 1281, 1663, 2307, 2758, 3211, 3736, 4251, 4794, 5434, 6399, 6683]","[0, 275, 554, 955, 1362, 1773, 2507, 2958, 3614, 4127, 4664, 5191, 5740, 6483, 7138]","[0, 246, 579, 917, 1369, 1870, 2297, 2708, 3158, 3540, 4226, 4722, 5515, 6273, 6685]","[0, 170, 260, 395, 485, 622, 757, 892, 1031, 1121, 1335, 1560, 1910, 2321, 2583]","[0, 170, 304, 440, 681, 848, 1080, 1302, 1490, 1580, 1715, 2100, 2190, 2447, 2542]",6683,7138,6685,2583,2542,97,22,110,14,5,"[0, 291, 661, 956, 1355, 1901, 2394, 3085, 3687, 4247, 4728, 5245, 5503, 6010, 6452]","[0, 287, 651, 941, 1322, 1935, 2222, 2847, 3463, 4233, 4745, 5261, 6676, 7108, 7331]","[0, 217, 355, 445, 579, 685, 814, 904, 1170, 1429, 1739, 2128, 2479, 2683, 3303]","[0, 241, 528, 768, 1090, 1412, 1541, 1631, 1964, 2266, 2645, 3285, 3644, 4155, 4594]","[0, 170, 278, 368, 458, 592, 713, 852, 1130, 1426, 1741, 1876, 2066, 2281, 2753]",6452,7331,3303,4594,2753,231,-193,3382,-2011,-211,1198,15,radiant
7552077918,6,120,129,20,105,"[1140, 1803, 2481, 2699, 3078, 4052, 4642, 5277, 6372, 6974, 7881, 8921, 9516, 10294, 11943]","[809, 1301, 1863, 2311, 2619, 3127, 3510, 4052, 4666, 5174, 6027, 7100, 7710, 8545, 9701]","[990, 1305, 1780, 2075, 2548, 3011, 3548, 4169, 5194, 5867, 6115, 6910, 7437, 8015, 9344]","[885, 1177, 1584, 1674, 1764, 2041, 2269, 2495, 3034, 3298, 3666, 4150, 4536, 4864, 5725]","[660, 750, 945, 1035, 1257, 1495, 1585, 1972, 2368, 2604, 3049, 3723, 3944, 4477, 5626]",11943,9701,9344,5725,5626,59,28,41,123,110,"[877, 1336, 1684, 1983, 2823, 3641, 4122, 4576, 4666, 5236, 5331, 5849, 5943, 6038, 6170]","[707, 986, 1152, 1409, 1819, 1944, 2084, 2416, 2814, 3148, 3413, 3931, 4025, 4705, 4977]","[759, 962, 1196, 1372, 1676, 1889, 2092, 2440, 2716, 3353, 3547, 3834, 4118, 4289, 4707]","[461, 855, 1030, 1209, 1567, 1742, 2019, 2184, 2293, 2569, 2749, 3338, 3432, 3663, 3758]","[419, 509, 617, 753, 978, 1484, 1658, 1748, 1838, 2018, 2231, 2448, 2769, 2912, 3091]",6170,4977,4707,3758,3091,5773,4724,4637,1967,2535,19636,15,radiant
7552078015,48,13,20,26,102,"[698, 1093, 1517, 1961, 2459, 2981, 3391, 3848, 4836, 5433, 6252, 6890, 7661, 8661, 9947]","[865, 1101, 1503, 1843, 2024, 2349, 2824, 3558, 3873, 4354, 4937, 5545, 6043, 6303, 7123]","[860, 1361, 1714, 2164, 2445, 3147, 3696, 3806, 4142, 4716, 5506, 6053, 6377, 7073, 8025]","[489, 614, 744, 879, 969, 1104, 1375, 1727, 1894, 2082, 2290, 2620, 2715, 2872, 3472]","[346, 471, 619, 754, 860, 950, 1396, 1712, 2054, 2198, 2430, 2680, 2870, 3052, 3499]",9947,7123,8025,3472,3499,12,106,98,45,79,"[1140, 1465, 1853, 2270, 2745, 3058, 3445, 3866, 4157, 4522, 5383, 5716, 6262, 6819, 7648]","[1151, 1526, 1943, 2168, 2578, 2996, 3473, 3874, 4323, 4728, 5159, 5549, 5864, 7098, 7672]","[775, 1001, 1512, 1708, 2172, 2830, 3569, 4389, 4775, 5412, 6090, 6856, 7156, 8095, 8653]","[860, 954, 1092, 1182, 2060, 2235, 2661, 3059, 3268, 3678, 4203, 4442, 4687, 5067, 5454]","[421, 771, 861, 951, 1132, 1222, 1564, 1865, 2056, 2423, 2756, 2995, 3338, 3543, 4145]",7648,7672,8653,5454,4145,2299,-549,-628,-1982,-646,-1506,15,radiant
7552118903,82,98,74,83,26,"[962, 1178, 1342, 1791, 2250, 2794, 3381, 4033, 4915, 5773, 6541, 7693, 8700, 9744, 11365]","[869, 1246, 1815, 2277, 2772, 3255, 3705, 4394, 4784, 5169, 5787, 6924, 7393, 8372, 9746]","[866, 1270, 1758, 2333, 2849, 3602, 4006, 4526, 5168, 5622, 5974, 6793, 7301, 8052, 8872]","[471, 639, 807, 897, 1051, 1339, 1561, 1715, 1983, 2550, 2787, 3236, 3463, 3754, 4468]","[472, 655, 931, 1109, 1244, 1501, 1591, 1745, 2082, 2523, 3005, 3446, 3591, 3921, 4487]",11365,9746,8872,4468,4487,48,80,14,123,100,"[1103, 1512, 1931, 2270, 2509, 2938, 3397, 4021, 4603, 4989, 5417, 5671, 6111, 6798, 6982]","[843, 1507, 1719, 2161, 2539, 2867, 3349, 3864, 4354, 4609, 4979, 5073, 5168, 5671, 5766]","[800, 1026, 1308, 1476, 1868, 2281, 2501, 3206, 3414, 3698, 4014, 4108, 4502, 5170, 5384]","[435, 605, 781, 1019, 1109, 1199, 1401, 1747, 1921, 2057, 2180, 2274, 2499, 2657, 2752]","[414, 553, 643, 733, 823, 913, 1003, 1228, 1619, 1709, 1840, 1934, 2159, 2400, 2495]",6982,5766,5384,2752,2495,4383,3980,3488,1716,1992,15559,15,radiant
7552136213,48,49,129,105,119,"[0, 210, 486, 1022, 1210, 1425, 1804, 2372, 2536, 2987, 3367, 3862, 4444, 5359, 6417]","[0, 373, 610, 1029, 1404, 1755, 2401, 2990, 3398, 3817, 4249, 4879, 5327, 6167, 6870]","[0, 246, 651, 1005, 1249, 1666, 2037, 2542, 2915, 3490, 3941, 4496, 5103, 5492, 6130]","[0, 330, 420, 713, 803, 893, 1321, 1703, 1963, 2148, 2529, 2761, 2905, 3179, 3777]","[0, 210, 351, 485, 575, 1040, 1215, 1535, 1625, 1805, 1996, 2119, 2594, 2849, 3198]",6417,6870,6130,3777,3198,41,25,97,26,45,"[0, 205, 565, 936, 1258, 1653, 1974, 2289, 2557, 3093, 3344, 3828, 4236, 4817, 5453]","[0, 354, 662, 988, 1316, 1698, 2034, 2383, 2833, 3350, 3779, 4516, 5061, 5658, 6392]","[0, 536, 798, 1117, 1553, 1917, 2308, 2838, 3136, 3555, 4095, 5020, 5683, 6380, 6920]","[0, 193, 319, 409, 625, 761, 851, 941, 1146, 1427, 1644, 1892, 2081, 2828, 3013]","[0, 239, 329, 467, 689, 1159, 1249, 1383, 1603, 2049, 2367, 2547, 2883, 3445, 3546]",5453,6392,6920,3013,3546,964,478,-790,764,-348,1068,15,dire
7552151314,4,20,32,112,51,"[0, 315, 644, 897, 1501, 1907, 2424, 2792, 3240, 3639, 4087, 4647, 5268, 6079, 6633]","[0, 278, 629, 927, 1432, 1931, 2057, 2547, 3032, 3585, 4195, 4841, 5477, 6157, 7163]","[0, 322, 606, 915, 1198, 1511, 1821, 2187, 2322, 2509, 2801, 3284, 3689, 4006, 4612]","[0, 195, 302, 487, 711, 845, 1028, 1163, 1449, 1699, 2220, 2707, 3002, 3319, 3553]","[0, 195, 285, 470, 678, 812, 902, 1067, 1202, 1439, 1911, 2315, 2457, 3095, 3291]",6633,7163,4612,3553,3291,48,13,28,119,21,"[0, 213, 502, 790, 1101, 1394, 2057, 2450, 2813, 3129, 3629, 4165, 4293, 5118, 5807]","[0, 246, 540, 823, 1075, 1425, 1830, 2328, 2859, 3150, 3616, 3983, 4073, 5074, 5427]","[0, 290, 584, 819, 1314, 1556, 1719, 1893, 2463, 3045, 3357, 3447, 3960, 4584, 4973]","[0, 170, 260, 350, 650, 780, 1236, 1371, 1600, 2024, 2159, 2285, 2461, 2879, 3176]","[0, 170, 277, 367, 610, 740, 978, 1130, 1404, 1693, 2196, 2286, 2756, 3159, 3484]",5807,5427,4973,3176,3484,826,1736,-361,377,-193,2385,15,radiant
7552190011,73,98,39,5,45,"[0, 335, 644, 1182, 1578, 1897, 2110, 2561, 3094, 3747, 4510, 5315, 5806, 6877, 8030]","[0, 292, 618, 951, 1208, 1572, 2221, 2784, 3339, 3815, 4381, 4834, 5405, 6176, 6839]","[0, 289, 521, 888, 1104, 1378, 1722, 2219, 2676, 3038, 3466, 3879, 4178, 4608, 4755]","[0, 169, 307, 443, 599, 725, 859, 1169, 1493, 1843, 1978, 2068, 2258, 2692, 2871]","[0, 169, 259, 445, 583, 759, 934, 1163, 1471, 1640, 1896, 2034, 2181, 2735, 3273]",8030,6839,4755,2871,3273,48,43,33,58,19,"[0, 204, 408, 734, 1172, 1655, 1978, 2386, 2766, 3382, 3943, 4846, 5532, 6415, 7014]","[0, 294, 651, 955, 1239, 1560, 1883, 2471, 2873, 3244, 3952, 4506, 4813, 5052, 5747]","[0, 169, 410, 741, 994, 1323, 2226, 2656, 3116, 3404, 3991, 4500, 4977, 5733, 6192]","[0, 169, 259, 349, 596, 783, 1100, 1557, 1922, 2027, 2209, 2519, 2648, 3062, 3546]","[0, 169, 259, 349, 555, 691, 931, 1178, 1344, 1434, 1687, 1867, 1957, 2223, 2590]",7014,5747,6192,3546,2590,1016,1092,-1437,-675,683,679,15,dire
7552191700,15,106,97,110,51,"[253, 609, 906, 1072, 1366, 1661, 2165, 2549, 3034, 3626, 4297, 4870, 5555, 6524, 7003]","[331, 777, 953, 1334, 1568, 1974, 2398, 2648, 3065, 3544, 3883, 4220, 4467, 5153, 6134]","[205, 616, 796, 1162, 1581, 2154, 2621, 3206, 3745, 4312, 4534, 5149, 5873, 6278, 6712]","[176, 268, 380, 482, 703, 1262, 1442, 1599, 1823, 2080, 2246, 2440, 2905, 3397, 3752]","[515, 605, 741, 831, 921, 1011, 1191, 1301, 1499, 2002, 2496, 2729, 2824, 3424, 3616]",7003,6134,6712,3752,3616,89,17,137,86,65,"[204, 487, 727, 1121, 1332, 1648, 2127, 2570, 2988, 3398, 3934, 4462, 5275, 6290, 7041]","[326, 604, 1060, 1395, 1756, 1935, 2351, 2689, 3038, 3395, 3803, 4399, 5052, 5380, 5611]","[170, 489, 733, 1138, 1575, 1855, 2205, 2524, 2830, 3210, 3644, 4372, 5108, 5590, 6095]","[170, 308, 563, 951, 1206, 1341, 1494, 1661, 2096, 2225, 2520, 2749, 3459, 3644, 4184]","[170, 260, 350, 485, 605, 749, 886, 976, 1087, 1452, 1847, 2145, 2741, 2872, 3301]",7041,5611,6095,4184,3301,-38,523,617,-432,315,985,15,radiant
7552202519,8,102,84,21,26,"[0, 288, 522, 792, 1208, 1638, 1968, 2333, 2808, 3070, 3696, 4454, 5051, 5706, 6581]","[0, 219, 654, 1084, 1605, 2419, 2755, 3198, 4128, 4726, 5261, 5557, 5771, 6065, 6526]","[0, 209, 299, 389, 605, 790, 924, 1063, 1443, 1623, 2032, 2427, 2558, 3225, 3856]","[0, 328, 546, 931, 1299, 1827, 2247, 2491, 2581, 3237, 3693, 4138, 4622, 5107, 5742]","[0, 170, 476, 566, 993, 1366, 1456, 1595, 1924, 2272, 2805, 3038, 3128, 3635, 4010]",6581,6526,3856,5742,4010,25,81,129,87,39,"[0, 332, 630, 910, 1311, 1686, 2176, 2577, 3366, 3904, 4695, 5267, 5940, 7012, 7574]","[0, 256, 1016, 1422, 1731, 2079, 2409, 2724, 2951, 3446, 3931, 4352, 5045, 5779, 6459]","[0, 248, 524, 940, 1340, 1563, 2061, 2327, 2743, 3362, 3490, 4466, 4811, 5109, 5908]","[0, 170, 353, 489, 663, 997, 1176, 1313, 1536, 2049, 2283, 2885, 3120, 3972, 4210]","[0, 170, 285, 423, 578, 668, 901, 1066, 1322, 1833, 2067, 2690, 2957, 3154, 3392]",7574,6459,5908,4210,3392,-993,67,-2052,1532,618,-828,15,dire
7552287805,89,106,69,58,65,"[0, 208, 630, 923, 1533, 2247, 2656, 3426, 3815, 4551, 5409, 6242, 7098, 7842, 9119]","[0, 212, 580, 920, 1645, 1939, 2281, 2551, 3126, 3638, 4415, 5089, 5508, 5985, 6588]","[0, 180, 582, 1073, 1425, 1683, 1971, 2516, 2953, 3711, 4267, 4889, 5514, 5822, 6682]","[0, 129, 282, 372, 760, 1068, 1413, 1585, 1752, 1932, 2397, 2864, 3064, 3379, 3740]","[0, 129, 307, 441, 749, 839, 1088, 1178, 1550, 1912, 2173, 2466, 2646, 3736, 4357]",9119,6588,6682,3740,4357,41,2,74,56,31,"[0, 248, 580, 754, 1282, 1696, 2576, 2824, 3348, 3508, 4263, 4589, 4755, 5477, 5698]","[0, 245, 369, 660, 750, 937, 1465, 1690, 2113, 2284, 2455, 2999, 3813, 4383, 4806]","[0, 289, 613, 905, 1157, 1484, 1811, 2028, 2586, 2887, 3314, 3546, 3879, 4601, 5042]","[0, 209, 299, 389, 504, 683, 1069, 1258, 1348, 1657, 1941, 2194, 2284, 2595, 2908]","[0, 209, 637, 727, 1286, 1376, 1736, 1826, 2029, 2119, 2209, 2442, 2532, 2994, 3097]",5698,4806,5042,2908,3097,3421,1782,1640,832,1260,8935,15,radiant
7552353215,120,41,96,58,33,"[407, 617, 984, 1409, 1808, 1978, 2480, 3247, 3859, 4473, 4804, 5214, 6056, 6951, 7126]","[141, 351, 598, 930, 1055, 1473, 1599, 2305, 2867, 3203, 3791, 4217, 4769, 5080, 5417]","[141, 389, 729, 858, 1189, 1562, 1871, 2085, 2271, 2656, 2900, 2990, 3585, 3911, 4359]","[141, 351, 557, 647, 737, 907, 1030, 1506, 1596, 1804, 1943, 2175, 2501, 2848, 3183]","[141, 544, 678, 805, 926, 1155, 1288, 1925, 2173, 2596, 2804, 3042, 3813, 4078, 4247]",7126,5417,4359,3183,4247,137,21,92,14,71,"[122, 599, 935, 1263, 1682, 2478, 3104, 3736, 4154, 4482, 4893, 5643, 5733, 6392, 7534]","[122, 359, 644, 1039, 1424, 1802, 2162, 2521, 3459, 4025, 4557, 5176, 5645, 6165, 7138]","[523, 928, 1214, 1565, 1946, 2194, 2723, 3083, 3295, 3914, 4398, 5033, 5328, 5423, 5975]","[122, 292, 382, 687, 863, 1143, 1361, 1821, 2002, 2440, 2734, 2907, 2997, 3240, 3571]","[122, 403, 493, 583, 751, 986, 1116, 1333, 1753, 2065, 2870, 3097, 3344, 3581, 4245]",7534,7138,5975,3571,4245,-408,-1721,-1616,-388,2,-4131,15,radiant
7552492602,94,13,96,121,83,"[630, 834, 1167, 1480, 2064, 2561, 3324, 3715, 4238, 4790, 5374, 6332, 7077, 7826, 8770]","[765, 1017, 1381, 1682, 2058, 2392, 2837, 3189, 3733, 4390, 4604, 5045, 5447, 5720, 5975]","[439, 960, 1064, 1429, 1893, 2428, 2912, 3039, 3678, 4005, 4629, 5182, 5655, 5864, 6469]","[393, 567, 657, 907, 1289, 1443, 1934, 2278, 2533, 2713, 2824, 3147, 3280, 3584, 3759]","[627, 764, 903, 1243, 1479, 1636, 1924, 2014, 2304, 2484, 2720, 3043, 3353, 3553, 4012]",8770,5975,6469,3759,4012,7,41,69,72,64,"[615, 965, 1525, 1772, 2375, 2745, 3113, 3691, 4147, 4738, 5718, 6025, 6760, 7793, 9180]","[436, 562, 975, 1198, 1578, 1727, 2117, 2830, 3140, 3573, 3830, 4308, 5361, 5733, 6431]","[292, 508, 824, 1004, 1194, 1460, 1550, 1961, 2501, 2757, 3167, 3659, 4145, 4291, 4906]","[219, 309, 399, 489, 579, 669, 759, 1053, 1340, 1430, 1651, 2147, 2662, 2757, 3396]","[219, 309, 399, 533, 729, 819, 954, 1219, 1523, 1613, 1703, 2010, 2818, 3091, 3779]",9180,6431,4906,3396,3779,-410,-456,1563,363,233,1293,15,radiant
7552498805,129,13,21,65,5,"[1818, 2015, 2604, 3010, 3732, 3913, 4450, 5697, 5792, 6333, 6817, 7619, 8316, 9265, 9845]","[1884, 2197, 2612, 3024, 3333, 4101, 4684, 5316, 5687, 6106, 6727, 7865, 9024, 9606, 10107]","[1642, 1852, 2066, 2407, 2911, 3079, 3333, 3710, 4159, 4575, 4984, 5515, 6820, 7331, 7919]","[986, 1147, 1639, 1869, 2388, 2730, 2855, 3328, 3620, 4218, 4594, 5322, 5949, 6484, 6904]","[1094, 1255, 1562, 1712, 2153, 2426, 2584, 2912, 3213, 3427, 3522, 3750, 4636, 4809, 4904]",9845,10107,7919,6904,4904,90,14,112,20,100,"[1707, 2481, 2866, 3415, 4186, 4948, 5293, 5504, 5920, 6674, 6977, 7319, 7572, 8051, 8439]","[1831, 2105, 2609, 2950, 3468, 4039, 4585, 5199, 5920, 6560, 7069, 7584, 8180, 8764, 9274]","[1002, 1306, 1979, 2269, 2790, 3327, 3847, 4204, 4837, 5748, 6226, 6448, 6739, 7304, 7624]","[977, 1244, 1538, 1871, 2411, 2838, 3089, 3224, 3940, 4417, 4791, 5047, 5142, 5569, 6036]","[879, 1252, 1499, 1676, 2455, 2851, 3044, 3179, 3515, 3848, 4250, 4610, 4705, 4800, 5021]",8439,9274,7624,6036,5021,1406,833,295,868,-117,3285,15,radiant
7552518202,25,35,112,14,85,"[4680, 4680, 4680, 4680, 4680, 4680, 4680, 4680, 4680, 4680, 4680, 4680, 4680, 4680, 4680]","[4469, 4469, 4469, 4469, 4469, 4469, 4469, 4469, 4469, 4469, 4469, 4469, 4469, 4469, 4469]","[3693, 3693, 3693, 3693, 3693, 3693, 3693, 3693, 3693, 3693, 3693, 3693, 3693, 3693, 3693]","[3092, 3092, 3092, 3092, 3092, 3092, 3092, 3092, 3092, 3092, 3092, 3092, 3092, 3092, 3092]","[2196, 2196, 2196, 2196, 2196, 2196, 2196, 2196, 2196, 2196, 2196, 2196, 2196, 2196, 2196]",4680,4469,3693,3092,2196,41,30,50,2,74,"[1284, 1284, 1284, 1284, 1284, 1284, 1284, 1284, 1284, 1284, 1284, 1284, 1284, 1284, 1284]","[1102, 1102, 1102, 1102, 1102, 1102, 1102, 1102, 1102, 1102, 1102, 1102, 1102, 1102, 1102]","[1047, 1047, 1047, 1047, 1047, 1047, 1047, 1047, 1047, 1047, 1047, 1047, 1047, 1047, 1047]","[994, 994, 994, 994, 994, 994, 994, 994, 994, 994, 994, 994, 994, 994, 994]","[992, 992, 992, 992, 992, 992, 992, 992, 992, 992, 992, 992, 992, 992, 992]",1284,1102,1047,994,992,3396,3367,2646,2098,1204,12711,15,radiant
7552545518,106,67,98,9,20,"[0, 245, 589, 932, 1339, 1620, 2105, 2350, 2614, 3546, 4026, 4725, 5166, 5618, 6757]","[0, 202, 506, 872, 1224, 1477, 1739, 2071, 2435, 2772, 3239, 3697, 4176, 4801, 5335]","[0, 224, 416, 506, 665, 1283, 1558, 2210, 2926, 3958, 4564, 5424, 5891, 6481, 7058]","[0, 357, 523, 613, 755, 1106, 1196, 1420, 1510, 1907, 2087, 2403, 2637, 3171, 3866]","[0, 172, 287, 426, 750, 946, 1084, 1218, 1480, 2081, 2261, 2545, 2852, 3253, 3886]",6757,5335,7058,3866,3886,21,6,137,135,88,"[0, 306, 604, 1040, 1242, 1690, 2240, 2679, 3157, 3665, 4130, 4503, 4922, 5410, 5683]","[0, 416, 730, 996, 1378, 1592, 1825, 2072, 2418, 2852, 3135, 3713, 4069, 4638, 4912]","[0, 365, 709, 1040, 1289, 1572, 1923, 2224, 2658, 2926, 3297, 3723, 3903, 4625, 4931]","[0, 563, 653, 952, 1205, 1330, 1514, 1784, 2131, 2221, 2400, 2751, 2841, 3242, 3337]","[0, 234, 360, 494, 624, 762, 957, 1344, 1479, 1604, 1746, 2072, 2162, 2466, 2681]",5683,4912,4931,3337,2681,1074,423,2127,529,1205,5358,15,radiant
7552578103,95,25,112,86,19,"[252, 671, 1006, 1440, 1715, 2129, 2747, 3419, 3986, 4384, 4736, 5299, 6079, 6274, 7302]","[333, 777, 1142, 1538, 1964, 2411, 2757, 3220, 4038, 4615, 5348, 5900, 7302, 8106, 8688]","[205, 551, 826, 1235, 1596, 1995, 2456, 2911, 3284, 3752, 4285, 4591, 5188, 5569, 5924]","[170, 695, 889, 1019, 1230, 1567, 1906, 2042, 2349, 2524, 2614, 2788, 3527, 3729, 4107]","[170, 514, 604, 810, 900, 1113, 1307, 1514, 2047, 2182, 2272, 2554, 3113, 3589, 3927]",7302,8688,5924,4107,3927,49,1,105,14,20,"[325, 645, 1057, 1467, 1870, 2237, 2540, 3073, 3396, 4002, 4493, 4963, 5384, 5713, 6363]","[241, 434, 722, 955, 1232, 1474, 1653, 1743, 1939, 2347, 2728, 3123, 3747, 4289, 4869]","[170, 260, 397, 636, 1232, 1406, 1541, 1670, 1760, 2250, 2674, 2954, 3049, 3731, 4296]","[208, 498, 800, 1212, 1786, 2036, 2372, 2571, 2826, 3137, 3620, 4118, 4213, 4770, 5052]","[256, 346, 436, 561, 735, 950, 1090, 1180, 1270, 1815, 2047, 2270, 2400, 2697, 3117]",6363,4869,4296,5052,3117,939,3819,1628,-945,810,6251,15,radiant
7552578117,21,106,53,96,65,"[1919, 2620, 3386, 4036, 4639, 5294, 6329, 6892, 7465, 8330, 9041, 9813, 10457, 11746, 12601]","[1873, 2261, 2728, 2995, 3644, 4452, 4708, 5243, 5935, 6410, 6964, 8093, 8328, 9188, 11116]","[1210, 1699, 2075, 2741, 3140, 3712, 4181, 5043, 5662, 6249, 6838, 8364, 8459, 9473, 10029]","[2218, 2829, 3334, 3921, 4241, 5007, 5658, 6219, 7003, 7490, 7857, 8365, 8460, 8912, 9538]","[1486, 1882, 2279, 2459, 2683, 3294, 3733, 4227, 4847, 5616, 5997, 6710, 6891, 7507, 8366]",12601,11116,10029,9538,8366,123,59,22,28,121,"[1470, 1656, 1783, 2220, 2490, 2909, 3036, 3164, 3693, 4139, 4681, 5048, 5381, 5794, 7038]","[1456, 1719, 2011, 2401, 2529, 3137, 3227, 3317, 3742, 3837, 4379, 5045, 5470, 6004, 6098]","[954, 1221, 1311, 1938, 2067, 2593, 2844, 2934, 3679, 3774, 3990, 4241, 4439, 4534, 5709]","[831, 966, 1102, 1227, 1398, 1488, 1830, 2115, 2295, 2426, 2566, 3191, 3391, 3619, 5289]","[575, 710, 800, 924, 1053, 1143, 1233, 1371, 1466, 1598, 1736, 2323, 2418, 2513, 2651]",7038,6098,5709,5289,2651,5563,5018,4320,4249,5715,24865,15,radiant
7552578501,89,80,38,86,20,"[206, 452, 750, 960, 1171, 1579, 1985, 2563, 2936, 3508, 4220, 4971, 5947, 6638, 7501]","[300, 654, 1034, 1490, 1854, 2239, 2737, 3381, 4251, 4570, 5263, 5729, 6462, 7086, 7659]","[205, 369, 723, 1191, 1539, 2052, 2461, 2718, 3386, 3953, 4456, 4812, 5742, 6836, 7351]","[170, 304, 394, 976, 1141, 1648, 1965, 2271, 2631, 3263, 3587, 3785, 4692, 5092, 5486]","[170, 318, 425, 633, 769, 1214, 1374, 1594, 2054, 2439, 2597, 2893, 3654, 4362, 4668]",7501,7659,7351,5486,4668,41,137,92,26,19,"[205, 440, 601, 1039, 1478, 2030, 2377, 2676, 2934, 3551, 4053, 4722, 5289, 5486, 6000]","[201, 363, 568, 770, 1192, 1736, 2277, 2671, 2969, 3645, 4035, 4596, 5355, 5780, 6517]","[212, 529, 904, 1216, 1467, 2047, 2454, 3089, 3780, 4095, 4701, 4926, 5607, 5945, 6573]","[264, 354, 483, 688, 1196, 1425, 1560, 1780, 1960, 2197, 2703, 2848, 2943, 3038, 3223]","[232, 326, 460, 860, 950, 1294, 1514, 1787, 2025, 2294, 2565, 2828, 3099, 3241, 3620]",6000,6517,6573,3223,3620,1501,1142,778,2263,1048,6732,15,dire
7552579810,93,74,129,128,65,"[0, 325, 648, 1597, 1799, 2529, 3267, 3678, 4432, 4673, 5672, 5889, 6306, 7628, 8225]","[0, 280, 655, 986, 1316, 1696, 2187, 2584, 3611, 4374, 4996, 5988, 6321, 6772, 7742]","[0, 246, 579, 1004, 1473, 1765, 2313, 3048, 3997, 4500, 5393, 6031, 6331, 6960, 7440]","[0, 170, 260, 436, 588, 793, 1083, 1455, 1924, 2629, 3270, 3669, 3806, 4168, 4764]","[0, 170, 290, 505, 645, 876, 1080, 1578, 1810, 2109, 2648, 2977, 3506, 4123, 4351]",8225,7742,7440,4764,4351,95,11,123,102,14,"[0, 215, 476, 605, 1142, 1427, 1676, 1887, 2040, 2250, 2690, 2926, 3231, 3326, 3669]","[0, 221, 507, 854, 1124, 1338, 1428, 1518, 1838, 1928, 2398, 2572, 2815, 3063, 3388]","[0, 170, 299, 557, 687, 777, 867, 957, 1092, 1182, 1449, 1678, 1816, 1911, 2443]","[0, 209, 391, 685, 924, 1052, 1142, 1232, 1367, 1457, 1724, 1814, 1950, 2045, 2388]","[0, 170, 260, 350, 695, 785, 924, 1052, 1187, 1277, 1544, 1775, 1911, 2006, 2101]",3669,3388,2443,2388,2101,4556,4354,4997,2376,2250,18533,15,radiant
7552662207,48,46,96,66,123,"[230, 568, 1193, 1470, 2113, 2668, 2844, 3582, 4346, 4571, 5475, 6193, 6941, 7675, 8253]","[399, 754, 968, 1468, 1889, 2480, 3097, 3592, 4334, 5257, 6007, 6651, 7480, 7741, 8481]","[313, 560, 981, 1230, 1557, 2107, 2358, 3227, 3826, 4499, 4961, 5174, 5751, 6310, 6567]","[195, 297, 539, 722, 1292, 1653, 1859, 2462, 2808, 3115, 3506, 3874, 4336, 4703, 4922]","[195, 285, 538, 628, 941, 1096, 1263, 1443, 1713, 2121, 2669, 2891, 3140, 3303, 3868]",8253,8481,6567,4922,3868,41,90,29,119,91,"[209, 604, 731, 1115, 1470, 1763, 2047, 2335, 2628, 2928, 3241, 3498, 3919, 4400, 4894]","[289, 540, 800, 1110, 1360, 1768, 1944, 2577, 2986, 3794, 3977, 4723, 5282, 5921, 6303]","[242, 548, 828, 1293, 1417, 1542, 1918, 2044, 2617, 3479, 3997, 4391, 5357, 5773, 6008]","[170, 607, 697, 1035, 1171, 1307, 1479, 1990, 2080, 2510, 3204, 3551, 3646, 3889, 3984]","[170, 260, 650, 873, 1015, 1105, 1258, 1553, 1744, 2420, 2719, 2809, 2904, 3032, 3444]",4894,6303,6008,3984,3444,3359,2178,559,938,424,7458,15,radiant
7552718510,48,65,112,19,91,"[0, 124, 425, 586, 787, 1103, 1545, 1964, 2377, 3051, 3791, 4656, 5270, 5990, 6328]","[0, 246, 565, 972, 1386, 1682, 2164, 2715, 3249, 4444, 4770, 5682, 6268, 6832, 7836]","[0, 158, 392, 673, 776, 1142, 1387, 1660, 1838, 2145, 2457, 2895, 3376, 3561, 3828]","[0, 90, 180, 270, 360, 702, 837, 1096, 1371, 1716, 2188, 2563, 2758, 3107, 3379]","[19, 211, 301, 408, 516, 665, 818, 953, 1301, 1537, 1755, 2079, 2179, 2322, 2625]",6328,7836,3828,3379,2625,98,25,33,7,20,"[0, 360, 725, 1094, 1224, 1520, 1798, 2193, 2778, 3371, 3998, 4442, 4765, 5282, 6149]","[0, 336, 566, 1004, 1429, 1682, 2384, 2984, 3392, 3814, 4181, 4602, 5002, 5577, 6285]","[0, 285, 694, 1045, 1416, 1794, 2125, 2577, 3029, 3398, 4187, 4300, 4702, 5249, 5753]","[0, 250, 340, 765, 940, 1074, 1164, 1254, 1414, 1549, 1971, 2061, 2562, 3007, 3726]","[0, 250, 469, 653, 901, 991, 1159, 1331, 1491, 1761, 1986, 2218, 2355, 2557, 2882]",6149,6285,5753,3726,2882,179,1551,-1925,-347,-257,-799,15,radiant
7552731302,17,56,96,123,83,"[0, 254, 528, 1027, 1559, 2260, 2597, 2906, 3427, 4083, 4787, 5245, 6127, 6787, 7378]","[0, 164, 431, 770, 1058, 1345, 2006, 2261, 2468, 3055, 3422, 3916, 4571, 4937, 5720]","[0, 164, 396, 676, 1336, 1937, 2316, 2564, 3111, 3794, 4292, 5164, 5491, 6143, 6826]","[0, 130, 220, 710, 966, 1152, 1434, 1524, 1708, 1832, 2372, 2606, 2928, 3556, 4035]","[0, 130, 220, 354, 484, 618, 846, 981, 1116, 1321, 1456, 1830, 1999, 2403, 2803]",7378,5720,6826,4035,2803,48,82,129,58,45,"[0, 282, 515, 838, 1324, 1414, 1718, 2274, 2722, 3257, 3831, 4280, 4945, 5867, 6171]","[0, 281, 574, 838, 1219, 1805, 2371, 2706, 3143, 3345, 3671, 3944, 4076, 4463, 4942]","[0, 249, 683, 1115, 1497, 1967, 2498, 2826, 3358, 3736, 4173, 4902, 5431, 5613, 5809]","[0, 210, 325, 415, 642, 735, 911, 1120, 1340, 1669, 2080, 2418, 2696, 3047, 3430]","[0, 210, 369, 507, 597, 795, 1048, 1226, 1546, 1869, 2104, 2328, 2454, 2602, 2934]",6171,4942,5809,3430,2934,1207,778,1017,605,-131,3476,15,dire
7552840615,72,114,97,105,65,"[383, 637, 917, 1242, 1623, 2163, 2609, 3193, 4116, 4607, 5255, 6090, 6744, 7047, 7591]","[228, 391, 654, 939, 1388, 1954, 2477, 2888, 3337, 3710, 4347, 4509, 5589, 6407, 6908]","[302, 550, 781, 1237, 1446, 1712, 2127, 2620, 3146, 3947, 4460, 5059, 5440, 6211, 6836]","[535, 625, 924, 1137, 1262, 1422, 1654, 1834, 2027, 2231, 2429, 2596, 2866, 3159, 3513]","[194, 302, 521, 667, 806, 1310, 1737, 2077, 2313, 2788, 3266, 3603, 3827, 4326, 4644]",7591,6908,6836,3513,4644,8,53,49,33,20,"[279, 592, 887, 1164, 1481, 1976, 2207, 2569, 3173, 3599, 3801, 4195, 4756, 5205, 5764]","[194, 284, 594, 724, 849, 939, 1105, 1296, 1699, 1917, 2042, 3134, 3482, 3631, 4778]","[230, 562, 847, 1168, 1363, 1570, 1877, 2447, 2915, 3947, 4554, 4956, 5105, 5603, 6145]","[266, 465, 1015, 1291, 1561, 1863, 2121, 2428, 2837, 3455, 3947, 4725, 5086, 5601, 6298]","[194, 284, 453, 605, 779, 931, 1021, 1385, 1565, 1888, 2126, 2478, 2665, 2814, 3342]",5764,4778,6145,6298,3342,1827,2130,691,-2785,1302,3165,15,radiant
7552909311,109,106,21,86,14,"[0, 206, 603, 854, 1273, 1648, 2277, 2678, 2940, 3180, 3591, 4020, 4720, 5527, 6327]","[0, 234, 435, 674, 919, 1385, 1806, 2119, 2574, 3075, 3424, 3907, 4403, 4826, 5251]","[0, 661, 991, 1409, 1740, 2111, 2401, 2831, 3151, 3753, 4094, 4608, 5256, 5574, 6279]","[0, 272, 780, 886, 1069, 1325, 1540, 1755, 1845, 2423, 2958, 3189, 3576, 4130, 4933]","[0, 234, 324, 414, 552, 742, 908, 1116, 1206, 1522, 1788, 2073, 2247, 2568, 2985]",6327,5251,6279,4933,2985,48,59,71,20,79,"[0, 329, 605, 1106, 1440, 1724, 2236, 2611, 2915, 3450, 3999, 4535, 5167, 5678, 6567]","[0, 208, 434, 797, 1052, 1394, 1831, 2779, 3220, 3624, 4604, 5534, 6264, 6828, 7383]","[0, 207, 422, 712, 921, 1287, 1850, 2183, 2901, 3232, 3663, 4127, 4703, 5066, 5160]","[0, 169, 560, 808, 1032, 1232, 1608, 1738, 1928, 2375, 2575, 3143, 3457, 4197, 4291]","[0, 169, 259, 423, 579, 669, 777, 1109, 1379, 1563, 2090, 2315, 2677, 3199, 3422]",6567,7383,5160,4291,3422,-240,-2132,1119,642,-437,-1048,15,dire
7553035705,56,120,97,21,86,"[0, 286, 485, 735, 1131, 1385, 1671, 2278, 2680, 3212, 3562, 4566, 4850, 5476, 5799]","[0, 247, 498, 791, 1162, 1652, 2058, 2492, 2884, 3331, 3771, 4032, 4641, 5506, 6223]","[0, 205, 483, 898, 1152, 1552, 1797, 2208, 2721, 3123, 3586, 4099, 4717, 5349, 6068]","[0, 170, 260, 396, 486, 576, 666, 1396, 1737, 1925, 2052, 2464, 2554, 2882, 3407]","[0, 170, 260, 751, 889, 1238, 1449, 1629, 2091, 2583, 2758, 3044, 3134, 3448, 3597]",5799,6223,6068,3407,3597,48,106,96,84,112,"[0, 279, 579, 829, 1105, 1558, 1800, 2375, 2745, 3396, 3848, 4450, 5163, 5688, 6585]","[0, 256, 640, 1013, 1340, 1699, 2070, 2356, 2794, 3477, 4431, 5615, 6364, 7253, 7688]","[0, 280, 560, 994, 1198, 1786, 2039, 2238, 2635, 3039, 3453, 4018, 4308, 4655, 5039]","[0, 170, 260, 350, 440, 614, 786, 1009, 1099, 1456, 1591, 2120, 2210, 2510, 2730]","[0, 170, 260, 415, 572, 831, 921, 1011, 1148, 1515, 1781, 2310, 2473, 2825, 3088]",6585,7688,5039,2730,3088,-786,-1465,1029,677,509,-36,15,dire
7553046702,126,93,28,121,26,"[593, 1036, 1327, 1824, 2246, 2624, 2997, 3211, 3403, 3674, 3933, 4199, 4930, 5196, 5394]","[533, 886, 1538, 1882, 2242, 2645, 2934, 3339, 3843, 4411, 4914, 5382, 5694, 6241, 7014]","[492, 740, 1034, 1202, 1410, 1624, 1750, 2085, 2528, 2814, 3269, 3529, 3952, 4274, 4559]","[260, 432, 748, 981, 1106, 1521, 1611, 1871, 2063, 2362, 2543, 2691, 3083, 3501, 3634]","[260, 368, 614, 790, 1047, 1182, 1272, 1362, 1554, 1698, 1941, 2172, 2419, 2514, 3156]",5394,7014,4559,3634,3156,44,96,74,45,20,"[612, 977, 1179, 1701, 2240, 2809, 3520, 3849, 4457, 4784, 5388, 5975, 6719, 7335, 8152]","[478, 1023, 1298, 1793, 2036, 2548, 3032, 3209, 3611, 4011, 4494, 5143, 5972, 6417, 7203]","[343, 620, 789, 955, 1185, 1552, 1783, 2207, 2658, 3006, 3311, 3879, 4418, 4722, 5055]","[260, 398, 498, 682, 971, 1277, 1714, 2097, 2586, 2751, 2841, 3438, 4120, 4215, 4538]","[260, 421, 511, 893, 1123, 1539, 1761, 1851, 2348, 2438, 2528, 2886, 3626, 3841, 4089]",8152,7203,5055,4538,4089,-2758,-189,-496,-904,-933,-5280,15,dire
7553047403,70,129,47,26,100,"[520, 812, 1224, 1719, 2038, 2432, 2973, 3319, 3901, 4625, 5383, 6073, 6771, 8156, 8968]","[119, 448, 675, 1038, 1618, 2034, 2439, 2636, 3310, 3576, 3942, 4543, 5610, 6298, 7210]","[61, 342, 564, 894, 1101, 1385, 1634, 1885, 2167, 2912, 3293, 3816, 4847, 5503, 6095]","[119, 328, 418, 680, 805, 941, 1090, 1180, 1609, 1890, 2201, 2592, 3096, 3821, 4207]","[119, 328, 622, 712, 903, 1037, 1198, 1550, 1685, 2312, 2562, 3010, 3565, 4321, 4973]",8968,7210,6095,4207,4973,54,21,104,75,71,"[205, 371, 615, 803, 1138, 1374, 1625, 1880, 2171, 2560, 2984, 3373, 3851, 4294, 4949]","[0, 213, 457, 719, 884, 1160, 1538, 1753, 2246, 2410, 3129, 3258, 3474, 3569, 3700]","[72, 235, 438, 644, 862, 1147, 1237, 1411, 1597, 1799, 2009, 2251, 2544, 2639, 2956]","[72, 201, 337, 427, 557, 687, 821, 1274, 1790, 1880, 2092, 2182, 2345, 2478, 2573]","[72, 201, 291, 381, 511, 641, 767, 1055, 1293, 1383, 1631, 1721, 1937, 2032, 2127]",4949,3700,2956,2573,2127,4019,3510,3139,1634,2846,15148,15,radiant
7553047515,7,10,28,86,30,"[655, 945, 1611, 1994, 2680, 3187, 3597, 4402, 4976, 5533, 6091, 6900, 7791, 8797, 9666]","[527, 790, 1242, 1464, 1971, 2331, 2673, 3346, 4005, 4903, 5608, 6382, 7334, 8148, 8858]","[543, 1033, 1256, 1704, 2099, 2617, 3325, 4082, 4784, 5620, 6470, 7219, 7962, 8345, 9368]","[220, 396, 486, 1100, 1389, 1552, 2002, 2233, 2924, 3273, 3727, 4034, 4506, 4861, 5293]","[220, 357, 536, 780, 931, 1105, 1195, 1468, 1841, 2431, 2745, 3509, 4302, 4879, 5319]",9666,8858,9368,5293,5319,94,129,23,37,20,"[681, 1237, 1623, 1830, 2243, 2407, 2708, 2942, 3362, 3691, 4310, 4711, 4806, 5600, 6042]","[577, 1246, 1503, 1842, 2157, 2369, 2827, 3220, 3525, 3771, 4032, 4219, 4324, 4419, 4644]","[410, 574, 861, 1083, 1398, 1644, 1991, 2252, 2531, 2663, 2954, 3210, 3435, 3530, 3812]","[300, 577, 726, 897, 1391, 1481, 1700, 1790, 1970, 2250, 2395, 2489, 2584, 2679, 2773]","[404, 633, 763, 945, 1080, 1170, 1316, 1508, 1847, 1937, 2027, 2121, 2216, 2619, 2760]",6042,4644,3812,2773,2760,3624,4214,5556,2520,2559,18473,15,radiant
7553048818,106,69,41,65,121,"[0, 251, 467, 794, 1079, 1364, 1709, 2647, 3380, 3920, 4055, 4456, 5072, 5482, 5973]","[0, 285, 739, 960, 1423, 1827, 2313, 2847, 3584, 4001, 4484, 5008, 5775, 6429, 6820]","[0, 169, 747, 943, 1365, 1529, 1808, 2263, 2709, 3133, 3357, 3861, 4349, 5097, 5730]","[0, 169, 553, 891, 1101, 1380, 1537, 2512, 2602, 2816, 3160, 3810, 4044, 4585, 4770]","[0, 169, 369, 553, 795, 903, 1037, 1365, 1455, 1834, 1969, 2527, 2761, 3234, 3505]",5973,6820,5730,4770,3505,93,76,110,5,7,"[0, 203, 443, 738, 1046, 1394, 1653, 2382, 2618, 2766, 3111, 3503, 3761, 3986, 4879]","[0, 205, 422, 742, 1031, 1315, 1514, 1763, 2189, 2520, 3064, 3243, 3619, 3714, 4875]","[0, 213, 450, 615, 745, 1127, 1378, 1769, 2094, 2307, 2648, 2825, 3084, 3179, 3698]","[0, 169, 304, 629, 937, 1346, 1519, 2036, 2250, 2340, 2875, 2965, 3120, 3225, 3544]","[0, 169, 344, 434, 564, 702, 792, 892, 992, 1164, 1436, 1526, 1831, 2131, 2543]",4879,4875,3698,3544,2543,1094,1945,2032,1226,962,7259,15,radiant
7553049303,48,21,47,30,119,"[0, 169, 467, 788, 1197, 1451, 1696, 1906, 2398, 2844, 3151, 3683, 4015, 4476, 5194]","[0, 329, 665, 1001, 1455, 1938, 2377, 2898, 3496, 4038, 4471, 5129, 5662, 6294, 7062]","[0, 250, 457, 754, 983, 1473, 1802, 2124, 2712, 3134, 3474, 4438, 4695, 5398, 5808]","[0, 169, 259, 349, 439, 578, 842, 932, 1352, 1618, 2132, 3056, 3146, 3524, 3831]","[0, 169, 310, 448, 555, 697, 1047, 1137, 1428, 1518, 1653, 2263, 2353, 2763, 3185]",5194,7062,5808,3831,3185,135,71,6,14,26,"[0, 256, 570, 942, 1279, 1600, 1982, 2773, 3282, 3596, 4040, 4130, 4848, 5041, 5488]","[0, 259, 387, 709, 992, 1382, 2134, 2705, 3026, 3280, 4029, 4212, 4791, 5043, 5426]","[0, 204, 440, 619, 896, 1031, 1324, 1516, 1727, 2005, 2304, 2658, 3072, 3594, 4024]","[0, 169, 308, 443, 533, 708, 1083, 1397, 1532, 1622, 2124, 2214, 2691, 2786, 2881]","[0, 169, 259, 349, 439, 569, 753, 1273, 1408, 1498, 1756, 1846, 2097, 2192, 2287]",5488,5426,4024,2881,2287,-294,1636,1784,950,898,4974,15,radiant
7553058513,21,35,95,26,100,"[255, 536, 833, 1332, 1777, 2372, 2724, 3198, 3946, 4404, 4655, 5343, 5968, 6488, 7121]","[204, 493, 826, 1111, 1486, 1861, 2036, 2556, 2735, 3136, 3226, 3712, 4017, 4207, 4661]","[213, 540, 895, 1218, 1727, 1925, 2172, 2510, 2600, 2771, 3057, 3677, 4152, 4520, 4752]","[170, 260, 580, 720, 962, 1052, 1187, 1413, 1503, 1593, 1683, 1881, 2163, 2500, 2845]","[170, 260, 350, 580, 758, 949, 1039, 1219, 1309, 1399, 1489, 1687, 1782, 1877, 1972]",7121,4661,4752,2845,1972,76,25,135,86,85,"[579, 780, 1074, 1271, 1467, 1850, 2604, 3049, 3968, 4469, 5471, 6280, 6907, 7494, 8376]","[319, 678, 855, 989, 1440, 1575, 1942, 2190, 2519, 2877, 3586, 4190, 4505, 4964, 6146]","[740, 864, 1067, 1711, 2034, 2571, 2980, 3278, 3607, 4151, 4753, 5397, 5859, 6276, 6620]","[383, 507, 597, 778, 958, 1430, 1809, 1990, 2851, 3161, 3458, 3704, 4831, 5331, 5683]","[281, 371, 461, 655, 907, 1042, 1173, 1263, 1393, 1577, 1825, 2141, 2615, 2781, 3240]",8376,6146,6620,5683,3240,-1255,-1485,-1868,-2838,-1268,-8714,15,dire
7553084504,102,13,69,86,47,"[0, 202, 491, 648, 1056, 1349, 1483, 1668, 2055, 2314, 2771, 3118, 3773, 4278, 4705]","[0, 166, 256, 531, 824, 1040, 1294, 1493, 1797, 2221, 3135, 3366, 3871, 4003, 4295]","[0, 169, 376, 617, 877, 1086, 1562, 1826, 1956, 2494, 2921, 3225, 3548, 3642, 3737]","[0, 168, 258, 464, 605, 789, 999, 1138, 1228, 1318, 1754, 2008, 2098, 2446, 2541]","[0, 130, 220, 391, 481, 625, 869, 1054, 1169, 1259, 1646, 1785, 1875, 1969, 2114]",4705,4295,3737,2541,2114,46,41,96,31,121,"[0, 726, 1265, 1639, 2082, 2680, 3439, 3766, 4306, 5257, 6023, 6835, 7594, 8373, 9121]","[0, 340, 589, 893, 1239, 1684, 2381, 2895, 3600, 4070, 4535, 4978, 5400, 6253, 6774]","[0, 341, 550, 1198, 1510, 1885, 2349, 3039, 3419, 4118, 4735, 5377, 5814, 6568, 7013]","[0, 269, 409, 778, 930, 1106, 1296, 1450, 1658, 1966, 2893, 3174, 3456, 3766, 3861]","[0, 269, 411, 642, 732, 912, 1083, 1290, 1510, 1815, 2270, 2522, 2738, 3030, 3125]",9121,6774,7013,3861,3125,-4416,-2479,-3276,-1320,-1011,-12502,15,dire
7553086109,54,19,74,21,110,"[0, 259, 458, 1338, 1707, 2047, 2645, 3090, 3365, 3628, 4531, 5279, 5868, 6899, 7538]","[0, 282, 808, 1099, 1497, 1878, 2351, 2680, 3273, 3672, 4451, 4808, 5409, 5839, 6807]","[0, 254, 584, 1043, 1326, 1704, 2113, 2650, 2847, 3558, 3977, 4471, 5325, 5983, 6656]","[0, 170, 324, 414, 647, 771, 1357, 1685, 2128, 2290, 2942, 3212, 3600, 3749, 4068]","[0, 271, 361, 646, 776, 911, 1117, 1497, 1737, 2199, 2808, 3253, 3738, 4175, 4918]",7538,6807,6656,4068,4918,46,96,25,123,26,"[0, 252, 459, 818, 1327, 1626, 1874, 2284, 2463, 3020, 3297, 3605, 4580, 4766, 4860]","[0, 170, 446, 823, 1229, 1479, 1720, 1893, 2263, 2483, 2729, 3053, 3628, 4002, 4341]","[0, 205, 540, 788, 1115, 1375, 1670, 2051, 2315, 2459, 2814, 3142, 3574, 3763, 4112]","[0, 170, 260, 606, 779, 869, 959, 1532, 1669, 1839, 1929, 2019, 2818, 3258, 3442]","[0, 170, 260, 398, 574, 703, 793, 1336, 1426, 1516, 1606, 1862, 2687, 2946, 3040]",4860,4341,4112,3442,3040,2678,2466,2544,626,1878,10192,15,radiant
7553157112,70,20,98,136,83,"[0, 239, 536, 856, 1155, 1478, 1707, 2340, 2803, 3168, 3651, 4318, 5019, 5672, 6260]","[0, 208, 515, 852, 1566, 1959, 2610, 3504, 3966, 4418, 5178, 5792, 6523, 7109, 7649]","[0, 282, 576, 821, 1030, 1246, 1582, 1967, 2395, 2626, 3026, 3992, 4521, 5443, 5672]","[0, 170, 260, 452, 717, 1085, 1861, 2131, 2270, 2360, 2621, 3165, 3394, 3810, 3904]","[0, 216, 306, 481, 620, 756, 916, 1186, 1276, 1437, 1701, 2457, 2671, 3050, 3299]",6260,7649,5672,3904,3299,48,39,29,123,100,"[0, 243, 537, 957, 1116, 1376, 1466, 1750, 2139, 2828, 3068, 3593, 4263, 5553, 6085]","[0, 280, 553, 884, 1339, 1786, 2016, 2369, 2789, 3426, 3806, 4287, 4779, 6333, 6686]","[0, 241, 455, 832, 1197, 1535, 1854, 2330, 2737, 3284, 3718, 3986, 4705, 5477, 5571]","[0, 170, 260, 368, 458, 637, 727, 862, 1212, 1485, 1575, 1903, 2236, 2480, 2752]","[0, 170, 260, 430, 903, 1071, 1199, 1334, 1509, 1711, 1848, 2071, 2309, 2753, 2971]",6085,6686,5571,2752,2971,175,963,101,1152,328,2719,15,radiant
7553455115,8,126,96,9,121,"[0, 453, 821, 1185, 1708, 2213, 2690, 3028, 3553, 3851, 4611, 5283, 5827, 6668, 7310]","[0, 365, 683, 1026, 1358, 1730, 1974, 2384, 2759, 3197, 3703, 4420, 4901, 5578, 6001]","[0, 258, 456, 773, 1112, 1499, 1657, 2198, 2367, 2477, 3184, 3646, 4063, 4567, 4804]","[0, 210, 300, 435, 604, 789, 928, 1247, 1581, 1936, 2396, 2673, 3000, 3369, 3916]","[0, 282, 372, 462, 624, 828, 991, 1395, 1529, 1638, 1993, 2234, 2373, 2784, 3127]",7310,6001,4804,3916,3127,120,56,97,83,86,"[0, 314, 686, 1066, 1368, 1904, 2415, 2748, 3279, 3912, 4312, 4574, 5094, 5851, 6716]","[0, 274, 594, 974, 1182, 1592, 2045, 2670, 3300, 3774, 4231, 4702, 5242, 5678, 6442]","[0, 200, 327, 655, 1245, 1527, 1828, 2228, 2357, 2528, 2933, 3077, 3562, 3835, 4102]","[0, 468, 558, 692, 826, 916, 1143, 1390, 1480, 1614, 1794, 2006, 2144, 2450, 2966]","[0, 231, 408, 498, 669, 759, 939, 1396, 1520, 1610, 1872, 1972, 2108, 2257, 2613]",6716,6442,4102,2966,2613,594,-441,702,950,514,2319,15,radiant
7553527512,13,42,2,86,85,"[0, 207, 456, 663, 1078, 1456, 1713, 1971, 2419, 2547, 2760, 2850, 4527, 5009, 5409]","[0, 294, 657, 1453, 1782, 2108, 2404, 2888, 3391, 3636, 4065, 4366, 5295, 5983, 6311]","[0, 206, 437, 753, 949, 1388, 1665, 1852, 2242, 2688, 3061, 3425, 3781, 4467, 4834]","[0, 170, 260, 366, 514, 692, 826, 1168, 1342, 1432, 1643, 2037, 2773, 3158, 3704]","[0, 170, 260, 528, 662, 839, 929, 1067, 1618, 1708, 1844, 1934, 2638, 2971, 3112]",5409,6311,4834,3704,3112,15,128,71,19,7,"[0, 292, 579, 914, 1411, 1884, 2357, 2773, 3557, 4379, 4923, 5466, 5967, 6849, 7585]","[0, 205, 412, 629, 997, 1175, 1533, 1861, 2266, 2681, 3060, 3445, 3762, 4285, 4715]","[0, 170, 260, 458, 748, 956, 1135, 1277, 1608, 2189, 2437, 3383, 3563, 4108, 4696]","[0, 329, 720, 1073, 1523, 1930, 2623, 3007, 3420, 4011, 4548, 4904, 5160, 5255, 5956]","[0, 170, 260, 350, 485, 625, 889, 1062, 1326, 1462, 1597, 1777, 2165, 2446, 2909]",7585,4715,4696,5956,2909,-2176,1596,138,-2252,203,-2491,15,dire
7553532818,54,106,97,26,30,"[244, 570, 986, 1236, 1559, 2003, 2593, 3204, 3638, 4058, 4524, 5137, 5569, 6465, 7051]","[240, 450, 741, 1087, 1347, 1570, 2098, 2459, 2558, 3183, 3416, 3954, 4477, 5015, 5404]","[544, 840, 1044, 1669, 2107, 2681, 3018, 3260, 3640, 4326, 4853, 5241, 5812, 6111, 6663]","[277, 367, 457, 706, 823, 1034, 1286, 1376, 1466, 1913, 2003, 2264, 2461, 3408, 3730]","[170, 260, 365, 455, 545, 635, 887, 1117, 1207, 1388, 1478, 1693, 2231, 2872, 3082]",7051,5404,6663,3730,3082,73,49,96,58,112,"[337, 761, 1025, 1232, 1807, 2023, 2765, 3816, 4601, 5588, 6044, 7220, 8215, 9592, 10634]","[340, 662, 981, 1252, 1780, 2031, 2587, 3346, 4036, 4624, 4874, 4964, 5468, 6438, 6833]","[205, 567, 869, 1101, 1901, 2444, 2699, 3283, 3591, 4255, 4850, 5297, 6175, 6602, 7188]","[170, 260, 463, 571, 736, 955, 1110, 1637, 2102, 2505, 2655, 2782, 2942, 3451, 3809]","[170, 260, 350, 454, 824, 914, 1359, 1508, 1894, 2119, 2308, 2398, 2558, 2825, 3167]",10634,6833,7188,3809,3167,-3583,-1429,-525,-79,-85,-5701,15,dire
7553597819,82,2,11,53,64,"[0, 337, 659, 1109, 1733, 2226, 2803, 3435, 4204, 4962, 5652, 6527, 6962, 7627, 8339]","[0, 288, 554, 678, 1132, 1367, 1712, 2128, 2528, 2775, 3287, 3750, 4497, 5281, 6518]","[0, 582, 822, 1194, 1524, 1877, 2201, 2736, 2945, 3390, 3657, 4316, 4832, 5272, 5696]","[0, 518, 608, 823, 1053, 1143, 1363, 1821, 2084, 2435, 3221, 3588, 4056, 4569, 5186]","[0, 198, 288, 423, 513, 832, 966, 1264, 1400, 1695, 1987, 2212, 2386, 2625, 2766]",8339,6518,5696,5186,2766,7,59,49,72,85,"[0, 368, 761, 1058, 1515, 1918, 2526, 2952, 3648, 4223, 4739, 5233, 5819, 6135, 6857]","[0, 280, 691, 1192, 1558, 1926, 2245, 2819, 3277, 3650, 4382, 4782, 5123, 5796, 6366]","[0, 244, 541, 870, 1073, 1486, 1865, 2483, 2868, 3611, 4439, 4700, 4926, 5557, 6296]","[0, 210, 374, 510, 600, 725, 919, 1188, 1343, 1712, 1982, 2213, 2380, 2810, 3087]","[0, 210, 325, 691, 781, 951, 1076, 1256, 1346, 1436, 1754, 1896, 1986, 2306, 2823]",6857,6366,6296,3087,2823,1482,152,-600,2099,-57,3076,15,radiant
7553654119,90,32,97,45,83,"[410, 738, 1073, 1460, 1828, 2350, 2942, 3416, 4021, 4318, 4949, 5523, 6341, 7435, 7873]","[144, 431, 628, 849, 1140, 1492, 1713, 2085, 2363, 2621, 3016, 3310, 3798, 4566, 4935]","[144, 350, 582, 732, 1320, 1582, 2111, 2860, 3294, 3818, 4324, 4782, 5705, 6345, 7065]","[144, 463, 553, 703, 793, 912, 1096, 1383, 1489, 1579, 1971, 2146, 2402, 2658, 2870]","[72, 242, 332, 532, 666, 756, 1024, 1199, 1336, 1426, 1562, 1768, 2002, 2491, 2679]",7873,4935,7065,2870,2679,120,21,51,23,112,"[119, 433, 803, 1048, 1638, 2094, 2586, 2879, 3517, 3973, 4588, 4906, 5611, 6112, 6725]","[119, 386, 754, 1171, 1597, 1910, 2270, 2574, 2748, 3309, 3733, 4047, 4666, 5212, 5614]","[119, 348, 438, 595, 760, 1060, 1158, 1280, 1428, 1518, 1792, 2005, 2272, 2508, 2603]","[252, 382, 764, 1120, 1475, 1761, 2109, 2593, 3290, 3737, 4147, 4634, 5372, 5886, 5981]","[387, 714, 804, 1005, 1180, 1305, 1444, 1582, 1845, 1956, 2400, 2572, 2817, 3291, 3482]",6725,5614,2603,5981,3482,1148,-679,4462,-3111,-803,1017,15,dire
7553660710,71,48,64,121,45,"[0, 330, 566, 726, 1210, 1454, 1820, 2138, 2382, 2674, 3107, 3992, 4773, 5470, 6498]","[0, 276, 555, 885, 1209, 1669, 2110, 2553, 3057, 3616, 4081, 4577, 5226, 6022, 6837]","[0, 287, 613, 861, 1302, 1665, 2197, 2791, 3014, 3686, 4627, 4956, 5227, 5994, 6625]","[0, 221, 363, 453, 543, 692, 830, 1006, 1096, 1221, 1556, 1791, 2138, 2656, 3199]","[0, 169, 259, 349, 487, 577, 712, 1152, 1287, 1377, 1826, 2110, 2450, 2979, 3501]",6498,6837,6625,3199,3501,25,53,32,80,20,"[0, 326, 728, 1090, 1351, 1713, 2448, 2983, 3609, 4007, 4551, 5326, 6039, 6626, 7434]","[0, 169, 259, 384, 541, 739, 950, 1271, 1504, 1785, 2438, 2675, 2991, 3185, 3823]","[0, 256, 588, 962, 1489, 1817, 2355, 2869, 3276, 3698, 4142, 4538, 5081, 5448, 5872]","[0, 277, 439, 900, 1029, 1309, 1686, 1949, 2385, 2761, 3228, 3318, 3580, 3798, 4207]","[0, 169, 259, 775, 865, 955, 1045, 1270, 1454, 1815, 2078, 2168, 2312, 2407, 2685]",7434,3823,5872,4207,2685,-936,3014,753,-1008,816,2639,15,dire
7553708506,10,19,69,100,86,"[0, 478, 887, 1062, 1989, 2481, 2690, 2825, 3162, 3695, 4705, 5264, 5742, 6182, 6987]","[0, 248, 576, 957, 1295, 1716, 2190, 2532, 3252, 3506, 4243, 4455, 4712, 5175, 5657]","[0, 201, 291, 554, 885, 1075, 1906, 2085, 2331, 2561, 3035, 3491, 3906, 4133, 4761]","[0, 220, 310, 400, 759, 889, 1147, 1237, 1423, 1618, 2059, 2149, 2239, 2334, 2483]","[0, 174, 264, 354, 490, 620, 797, 887, 1368, 1748, 2163, 2253, 2392, 2523, 2824]",6987,5657,4761,2483,2824,52,6,71,85,26,"[328, 609, 861, 1367, 1786, 2201, 2330, 2625, 2977, 3790, 4540, 5158, 5669, 6315, 6627]","[60, 355, 708, 1039, 1270, 1697, 1945, 2408, 2730, 3206, 3766, 4311, 4845, 5450, 5856]","[60, 307, 795, 1119, 1379, 1731, 2218, 2554, 2798, 2888, 3028, 3458, 4059, 4627, 4769]","[60, 269, 359, 449, 838, 1036, 1351, 1593, 1756, 1925, 2177, 2503, 2682, 3175, 3270]","[60, 269, 423, 513, 647, 777, 867, 1266, 1401, 1625, 1854, 2123, 2298, 2800, 3024]",6627,5856,4769,3270,3024,360,-199,-8,-787,-200,-834,15,radiant
7554078113,89,19,14,128,26,"[364, 954, 1083, 1407, 1688, 2004, 2189, 2591, 2826, 3437, 3868, 4605, 5453, 6039, 6976]","[569, 830, 1126, 1491, 2267, 2760, 3172, 3735, 4654, 5351, 5841, 5971, 6616, 6710, 7312]","[365, 812, 1125, 1290, 1773, 2065, 2286, 2687, 3223, 3769, 4320, 5306, 5837, 6030, 6575]","[305, 440, 657, 747, 982, 1168, 1306, 1497, 1843, 2115, 2642, 2990, 3193, 3287, 3542]","[357, 609, 699, 789, 879, 1059, 1324, 1563, 1837, 2117, 2393, 2626, 2829, 2923, 3243]",6976,7312,6575,3542,3243,21,120,102,123,85,"[879, 1163, 1798, 2256, 2721, 3225, 3826, 4488, 5212, 5703, 6210, 6950, 7223, 7855, 8397]","[534, 696, 1032, 1419, 1543, 2360, 2909, 3423, 3894, 4594, 4842, 5516, 5965, 6659, 7709]","[509, 649, 1022, 1244, 1843, 2416, 2926, 3190, 3712, 4313, 4632, 5571, 6302, 6563, 7535]","[370, 460, 887, 1035, 1200, 1521, 1631, 1971, 2177, 2441, 2746, 3478, 3617, 3995, 4599]","[550, 739, 957, 1093, 1476, 1656, 1816, 2052, 2292, 2472, 2708, 3534, 3673, 4470, 4968]",8397,7709,7535,4599,4968,-1421,-397,-960,-1057,-1725,-5560,15,radiant
7554125309,82,112,40,19,26,"[64, 310, 544, 861, 1266, 1590, 1889, 2328, 2706, 2882, 3568, 4077, 4484, 4922, 5072]","[332, 704, 1112, 1472, 1928, 2375, 2738, 3080, 3615, 4033, 4833, 5131, 5376, 5806, 6551]","[64, 272, 536, 669, 1053, 1220, 1434, 1615, 1845, 2247, 2909, 3263, 3681, 4066, 5624]","[64, 234, 462, 552, 728, 1044, 1193, 1333, 1499, 1638, 1875, 1980, 2070, 2641, 2903]","[64, 283, 373, 607, 868, 1035, 1125, 1285, 1506, 1634, 1724, 1923, 2013, 2370, 3601]",5072,6551,5624,2903,3601,47,98,120,105,84,"[0, 206, 488, 1015, 1332, 2003, 2430, 3018, 3435, 4090, 4508, 5115, 6438, 6828, 7429]","[0, 240, 564, 885, 1271, 1618, 2284, 2956, 3387, 4372, 5007, 5663, 6258, 6643, 7066]","[0, 238, 450, 785, 1104, 1514, 2118, 2576, 2961, 3468, 4042, 4405, 5451, 6205, 7447]","[0, 170, 475, 565, 655, 840, 1106, 1355, 1466, 1816, 2021, 2661, 2895, 3293, 3713]","[0, 170, 260, 437, 573, 933, 1131, 1328, 1418, 1942, 2312, 2523, 2906, 3034, 3698]",7429,7066,7447,3713,3698,-2357,-515,-1823,-810,-97,-5602,15,dire
7554210203,6,78,106,65,112,"[0, 464, 846, 1020, 1272, 1470, 1681, 1898, 2059, 2149, 2402, 2754, 3019, 3328, 3585]","[0, 210, 572, 772, 1112, 1238, 1404, 1747, 2243, 2844, 3049, 3392, 3895, 3990, 4085]","[0, 207, 411, 626, 800, 1011, 1206, 1386, 1523, 1982, 2422, 2718, 3079, 3307, 3438]","[0, 196, 496, 638, 823, 913, 1052, 1326, 1694, 2096, 2378, 2575, 2665, 2760, 3028]","[0, 196, 286, 376, 466, 556, 683, 899, 1024, 1253, 1343, 1507, 1597, 1692, 1810]",3585,4085,3438,3028,1810,10,14,114,45,27,"[0, 245, 619, 990, 1641, 2142, 2633, 2940, 3604, 4239, 4747, 5260, 6200, 6716, 7221]","[0, 247, 639, 969, 1282, 1705, 2068, 2556, 2989, 3443, 3902, 4063, 5169, 6022, 6342]","[0, 326, 711, 1171, 1735, 2240, 2601, 2920, 3337, 3746, 4172, 4654, 5256, 6155, 6886]","[0, 209, 329, 419, 553, 782, 966, 1118, 1351, 1741, 2013, 2155, 2675, 2928, 3674]","[0, 209, 329, 419, 651, 835, 1022, 1339, 1491, 1719, 1907, 1997, 2493, 2804, 3658]",7221,6342,6886,3674,3658,-3636,-2257,-3448,-646,-1848,-11835,15,dire
7554270913,46,13,129,105,20,"[248, 521, 849, 1260, 1562, 1893, 2233, 2874, 3462, 3982, 4548, 5314, 6059, 6804, 7486]","[239, 606, 932, 1386, 1848, 2327, 2782, 3387, 3844, 4405, 4822, 5066, 5810, 6128, 6867]","[256, 530, 892, 1347, 1556, 1976, 2215, 2841, 3288, 3794, 4649, 5233, 5669, 5854, 6129]","[170, 260, 395, 572, 879, 999, 1089, 1309, 1511, 1649, 2055, 2250, 2453, 2817, 3238]","[170, 260, 428, 615, 705, 864, 1006, 1226, 1530, 1620, 1958, 2155, 2486, 2583, 2797]",7486,6867,6129,3238,2797,48,19,96,85,123,"[294, 495, 733, 927, 1218, 1497, 1892, 2306, 2677, 3306, 3702, 4460, 5195, 6172, 6946]","[418, 723, 1016, 1432, 1897, 2269, 2893, 3417, 3863, 4434, 4781, 5143, 5274, 5836, 6219]","[309, 835, 1209, 1455, 1950, 2324, 2774, 3230, 3654, 4547, 4988, 5500, 5904, 6097, 6398]","[260, 350, 440, 530, 711, 846, 1193, 1358, 1448, 1879, 2027, 2119, 2427, 2679, 3163]","[528, 685, 822, 912, 1036, 1281, 1486, 1621, 1711, 2257, 2554, 2726, 2821, 3147, 3812]",6946,6219,6398,3163,3812,540,648,-269,75,-1015,-21,15,dire
7554357902,1,120,92,19,66,"[63, 270, 520, 720, 1059, 1503, 2412, 2791, 3288, 3768, 4247, 4667, 5214, 5479, 6295]","[63, 269, 521, 1041, 1408, 1735, 2235, 2698, 3203, 3947, 4649, 4983, 5344, 6039, 7453]","[63, 271, 554, 923, 1297, 1650, 1740, 2279, 2727, 3443, 3756, 4144, 4641, 5191, 5963]","[63, 268, 358, 448, 627, 833, 1185, 1627, 1717, 2109, 2438, 2668, 2758, 2925, 3629]","[331, 501, 827, 917, 1246, 1574, 1896, 2149, 2352, 2803, 3154, 3513, 3806, 4124, 4698]",6295,7453,5963,3629,4698,48,53,90,97,100,"[0, 279, 631, 863, 1117, 1583, 1994, 2282, 2684, 2985, 3601, 4203, 4817, 5716, 6191]","[0, 170, 260, 648, 823, 993, 1110, 1250, 1447, 1537, 1738, 1981, 2108, 2459, 2554]","[0, 267, 566, 938, 1179, 1605, 1982, 2581, 3129, 3495, 3696, 4292, 4601, 5013, 5146]","[0, 331, 622, 1150, 1631, 1909, 2071, 2268, 2574, 2968, 3277, 3888, 4147, 4836, 5277]","[0, 170, 260, 385, 475, 720, 810, 900, 1097, 1321, 1522, 1712, 1955, 2457, 2562]",6191,2554,5146,5277,2562,104,4899,817,-1648,2136,6308,15,radiant
7554476514,10,120,29,26,83,"[859, 1289, 1793, 2221, 2586, 3207, 3445, 3958, 4432, 5024, 5588, 6823, 7318, 8228, 9027]","[1241, 1528, 1830, 2201, 2948, 3282, 4046, 4426, 5344, 5705, 6161, 7110, 7252, 7687, 8510]","[1025, 1407, 1803, 2128, 2434, 2709, 3150, 3603, 4272, 4804, 5072, 5699, 6203, 6908, 7463]","[603, 737, 919, 1091, 1432, 1721, 1995, 2299, 2555, 2741, 2893, 3168, 3449, 3806, 4179]","[556, 646, 821, 947, 1511, 1836, 2064, 2548, 2728, 2863, 3182, 3741, 3881, 4246, 4747]",9027,8510,7463,4179,4747,93,106,96,105,101,"[795, 1204, 1604, 1853, 2227, 2868, 3178, 3569, 3904, 4384, 5001, 5096, 5948, 6915, 7479]","[852, 1062, 1496, 1586, 1715, 2210, 2391, 3093, 3428, 3806, 4097, 4329, 5255, 5981, 6802]","[914, 1166, 1622, 1953, 2315, 2732, 3015, 3283, 3544, 3876, 4010, 4105, 4767, 6429, 6892]","[350, 492, 761, 894, 1234, 1644, 1734, 1869, 2047, 2172, 2443, 3198, 3710, 4159, 4464]","[498, 623, 1051, 1141, 1283, 1418, 1508, 1879, 2052, 2262, 2461, 2556, 3113, 3733, 4102]",7479,6802,6892,4464,4102,1548,1708,571,-285,645,4187,15,radiant
7554721500,48,62,129,20,84,"[548, 952, 1196, 1602, 2024, 2438, 2770, 3254, 3893, 4604, 5240, 5989, 7239, 7770, 8368]","[754, 1095, 1499, 1829, 2082, 2547, 2907, 3444, 4279, 4480, 5070, 5549, 6022, 6354, 7196]","[491, 850, 1276, 1592, 1924, 2407, 2807, 3241, 3483, 4133, 4553, 5249, 5970, 6350, 6729]","[285, 375, 606, 696, 908, 1136, 1226, 1695, 2115, 2255, 2568, 2876, 3037, 3344, 3678]","[285, 393, 503, 709, 843, 1113, 1381, 2036, 2306, 2396, 2721, 3070, 3255, 3397, 3878]",8368,7196,6729,3678,3878,10,49,39,58,123,"[565, 816, 1111, 1502, 1975, 2230, 2701, 3293, 4005, 4674, 5002, 5762, 6359, 7154, 7772]","[472, 757, 1048, 1364, 1642, 2091, 2365, 2918, 3367, 3670, 4330, 4769, 5536, 6094, 7032]","[646, 965, 1410, 1707, 2188, 2609, 2978, 3670, 4158, 4582, 5060, 5471, 6066, 6886, 7258]","[260, 350, 597, 1078, 1322, 1546, 1695, 2246, 2426, 2619, 2743, 3027, 3122, 3478, 3795]","[359, 467, 603, 693, 783, 963, 1066, 1338, 1518, 1735, 2042, 2581, 2676, 2949, 3203]",7772,7032,7258,3795,3203,596,164,-529,-117,675,789,15,dire
7554771806,10,90,86,51,19,"[1367, 1577, 1976, 2375, 2711, 3295, 3799, 4441, 5257, 6325, 6951, 7871, 8802, 10131, 11362]","[1644, 1912, 2418, 2855, 3305, 3564, 3954, 4647, 5596, 6551, 7095, 8191, 8580, 9163, 9647]","[1492, 1894, 2517, 2991, 3452, 4048, 4607, 5179, 6019, 6427, 6882, 7626, 8218, 8768, 9473]","[672, 834, 1050, 1185, 1654, 2078, 2258, 3138, 3854, 4259, 4441, 4708, 5106, 5821, 6352]","[617, 834, 1050, 1230, 1660, 1966, 2386, 2609, 3414, 3716, 3911, 4217, 4438, 4805, 5073]",11362,9647,9473,6352,5073,48,97,106,123,58,"[1315, 1815, 2257, 2896, 3452, 4012, 4423, 4952, 5613, 5916, 6672, 6785, 7310, 7909, 8403]","[1047, 1577, 1957, 2455, 2785, 3020, 3399, 3787, 4239, 4792, 5360, 5665, 6246, 6341, 7147]","[1310, 1584, 1778, 2084, 2400, 2707, 3201, 3492, 3582, 3677, 4108, 4240, 4761, 5330, 5714]","[531, 740, 830, 1146, 1236, 1326, 1464, 1589, 2227, 2322, 2575, 2786, 3009, 3524, 3799]","[579, 793, 966, 1187, 1294, 1438, 1666, 1961, 2086, 2181, 2587, 2682, 2777, 2872, 3034]",8403,7147,5714,3799,3034,2959,2500,3759,2553,2039,13810,15,radiant
7554887907,25,41,96,9,26,"[0, 335, 628, 1099, 1393, 1777, 2117, 2568, 2863, 3547, 4094, 4246, 5231, 7126, 7661]","[0, 321, 714, 1333, 1738, 2351, 2700, 3001, 3407, 3824, 4379, 5153, 5751, 6363, 6822]","[0, 287, 449, 719, 1171, 1586, 1783, 2148, 2495, 2916, 3267, 3727, 4286, 4947, 5588]","[0, 222, 390, 564, 819, 954, 1176, 1266, 1473, 1980, 2210, 2427, 2851, 3272, 3483]","[0, 170, 348, 553, 780, 1278, 1411, 1538, 1794, 2018, 2421, 2573, 3034, 3567, 3820]",7661,6822,5588,3483,3820,46,22,28,100,101,"[0, 213, 569, 894, 1342, 1637, 2071, 2423, 2916, 3126, 3553, 4120, 4619, 5219, 5911]","[0, 259, 576, 893, 1313, 1557, 1775, 2189, 2478, 2991, 3504, 4373, 4556, 5043, 5408]","[0, 204, 830, 999, 1321, 1499, 1748, 2003, 2209, 2464, 2729, 3067, 3318, 3483, 3772]","[0, 170, 260, 350, 546, 694, 881, 1056, 1190, 1319, 1501, 1645, 1859, 2343, 2545]","[0, 170, 329, 466, 596, 770, 860, 1041, 1131, 1221, 1356, 1500, 1590, 1892, 2094]",5911,5408,3772,2545,2094,1750,1414,1816,938,1726,7644,15,radiant
7554908213,46,53,60,30,102,"[0, 368, 654, 996, 1276, 1719, 2166, 2444, 2908, 3364, 3973, 5076, 5957, 6662, 7091]","[0, 319, 765, 1054, 1381, 1699, 1994, 2585, 2877, 3223, 3837, 4176, 4895, 5521, 5914]","[0, 320, 491, 730, 936, 1227, 1555, 1723, 2011, 2270, 2655, 3068, 3503, 4073, 4352]","[0, 210, 300, 390, 524, 630, 755, 988, 1168, 1308, 1536, 1910, 2509, 2995, 3180]","[0, 210, 300, 441, 574, 664, 815, 950, 1109, 1244, 1578, 1808, 2509, 2726, 2911]",7091,5914,4352,3180,2911,14,81,57,72,26,"[0, 358, 980, 1267, 1807, 2568, 2983, 3784, 4322, 4821, 5748, 6468, 6606, 7198, 7468]","[0, 503, 818, 1106, 1673, 1993, 2419, 2932, 3403, 3775, 4594, 5097, 5559, 6092, 6415]","[0, 258, 709, 1063, 1521, 1881, 2369, 2683, 3131, 3562, 4372, 4798, 5142, 5570, 5747]","[0, 201, 291, 381, 582, 716, 851, 1239, 1374, 1684, 2116, 2206, 2468, 2789, 3093]","[0, 130, 426, 516, 789, 1003, 1187, 1322, 1573, 1780, 2188, 2443, 2577, 3087, 3230]",7468,6415,5747,3093,3230,-377,-501,-1395,87,-319,-2505,15,radiant
7554914302,48,135,74,86,114,"[0, 241, 518, 967, 1322, 1638, 2047, 2474, 2956, 3500, 4129, 4918, 5856, 6506, 7280]","[0, 247, 523, 882, 1168, 1505, 1756, 2324, 2485, 2881, 3349, 4076, 4533, 5168, 5709]","[0, 302, 540, 991, 1447, 1829, 2235, 2571, 3132, 3626, 4255, 4701, 5316, 5911, 6529]","[0, 169, 601, 735, 952, 1042, 1169, 1350, 1440, 1578, 1758, 1938, 2063, 2292, 2573]","[0, 169, 259, 394, 572, 662, 781, 871, 1090, 1180, 1363, 1708, 2115, 2311, 2460]",7280,5709,6529,2573,2460,109,39,57,21,26,"[0, 282, 656, 1143, 1466, 1663, 1977, 2348, 3032, 3555, 4054, 4424, 4793, 5291, 5654]","[0, 292, 648, 1024, 1361, 1735, 2045, 2581, 3163, 3373, 3929, 4477, 4945, 5369, 6131]","[0, 207, 497, 731, 1315, 1725, 2167, 2602, 3036, 3537, 4004, 4460, 4881, 5305, 5600]","[0, 212, 565, 877, 1105, 1290, 1609, 1738, 2309, 2470, 2860, 3125, 3658, 4292, 4784]","[0, 169, 306, 396, 575, 681, 816, 906, 1041, 1131, 1266, 1356, 1483, 1713, 1949]",5654,6131,5600,4784,1949,1626,-422,929,-2211,511,433,15,radiant
7554955116,89,13,56,105,100,"[150, 437, 771, 1033, 1520, 1812, 2147, 2874, 3296, 3859, 4640, 5380, 6187, 7023, 8047]","[283, 782, 1149, 1619, 2063, 2394, 2993, 3572, 4286, 5418, 6457, 6971, 7584, 8608, 9208]","[283, 782, 1036, 1422, 1746, 2076, 2611, 3144, 3571, 4485, 5274, 5947, 6376, 6572, 7494]","[418, 749, 1019, 1345, 1729, 2009, 2280, 2653, 3160, 3531, 3875, 4224, 4983, 5580, 5848]","[105, 436, 526, 664, 754, 844, 979, 1086, 1437, 1757, 2085, 2723, 3261, 3636, 4117]",8047,9208,7494,5848,4117,41,74,38,31,45,"[0, 161, 418, 673, 800, 1510, 1968, 2308, 2611, 2967, 3138, 3470, 4169, 4485, 4987]","[0, 286, 763, 1096, 1491, 2060, 2592, 2972, 3346, 3824, 4290, 4504, 4694, 4789, 4884]","[0, 379, 742, 1023, 1249, 1867, 2195, 2520, 2702, 3244, 3590, 3680, 4418, 4675, 5336]","[0, 90, 205, 295, 385, 860, 967, 1188, 1278, 1413, 1503, 1608, 1698, 1833, 1972]","[0, 128, 263, 398, 488, 971, 1128, 1218, 1308, 1691, 1825, 1915, 2090, 2185, 2547]",4987,4884,5336,1972,2547,3060,4324,2158,3876,1570,14988,15,radiant
7555041119,46,49,129,20,26,"[1100, 1463, 1834, 2287, 2870, 3353, 4073, 4608, 5128, 6264, 6955, 7410, 7604, 8523, 9317]","[1033, 1375, 1781, 2156, 2456, 2956, 3658, 4080, 4553, 4947, 5356, 5848, 6477, 7169, 7657]","[947, 1304, 1785, 2356, 2767, 3134, 3601, 4197, 4893, 5325, 5945, 6371, 6841, 7325, 8452]","[613, 837, 976, 1111, 1447, 1635, 1932, 2264, 2859, 3046, 3293, 3600, 3794, 4062, 4307]","[412, 549, 639, 823, 973, 1081, 1306, 1486, 1666, 1932, 2095, 2349, 2629, 3016, 3261]",9317,7657,8452,4307,3261,13,41,96,58,123,"[677, 982, 1232, 1694, 2035, 2493, 2989, 3264, 3931, 4528, 5043, 5947, 6676, 7429, 7853]","[790, 1071, 1732, 2112, 2447, 2816, 3181, 3509, 3972, 4420, 4900, 5420, 6296, 6835, 7601]","[785, 1232, 1510, 1928, 2343, 2843, 3172, 3709, 4369, 4831, 5366, 5979, 6552, 7223, 7616]","[433, 563, 778, 1188, 1368, 1597, 1687, 1899, 2117, 2284, 2516, 2992, 3132, 3701, 4020]","[350, 480, 570, 775, 1034, 1479, 1618, 1755, 2063, 2253, 2420, 2938, 3322, 4066, 4319]",7853,7601,7616,4020,4319,1464,56,836,287,-1058,1585,15,dire
7555172308,73,90,112,110,97,"[58, 649, 1043, 1412, 1758, 2061, 2670, 3270, 3843, 4562, 5151, 6151, 6790, 7777, 8799]","[58, 430, 631, 1099, 1398, 1658, 1926, 2913, 3366, 3887, 4221, 4692, 5405, 5988, 6276]","[58, 228, 318, 408, 542, 704, 1203, 1562, 2059, 2230, 2616, 2815, 3017, 3848, 4453]","[58, 294, 583, 876, 1172, 1329, 1671, 1984, 2109, 2236, 2616, 2706, 2796, 3194, 3788]","[326, 583, 822, 985, 1263, 1471, 1763, 2185, 2312, 2614, 2812, 3180, 3501, 3976, 4413]",8799,6276,4453,3788,4413,113,98,29,45,47,"[0, 283, 526, 906, 1201, 1530, 2089, 2385, 2924, 3712, 4229, 4883, 5450, 6138, 6675]","[154, 324, 645, 861, 1282, 1804, 2098, 2515, 2922, 3441, 4086, 4837, 5353, 6061, 6495]","[0, 598, 774, 1070, 1486, 1784, 2715, 2839, 3374, 3869, 4597, 5126, 6041, 6516, 6769]","[154, 324, 448, 586, 725, 965, 1233, 1367, 1457, 1593, 2122, 2457, 2754, 2902, 3507]","[0, 332, 422, 512, 602, 692, 1006, 1133, 1350, 1440, 1803, 2138, 2247, 2715, 3179]",6675,6495,6769,3507,3179,2124,-219,-2316,281,1234,1104,15,radiant
7555291916,93,106,97,123,105,"[644, 982, 1422, 1665, 1917, 2476, 2795, 3059, 3641, 4191, 4871, 5420, 5901, 6550, 7337]","[775, 1176, 1560, 1813, 1940, 2555, 3050, 3446, 3658, 4202, 4949, 5629, 6353, 6866, 7690]","[469, 1035, 1445, 1861, 2369, 2940, 3465, 3986, 4652, 5161, 5475, 5883, 6509, 6935, 7543]","[373, 536, 898, 988, 1266, 1446, 1809, 1955, 2135, 2486, 2836, 3415, 3778, 3926, 4493]","[300, 463, 602, 778, 1156, 1336, 1560, 1650, 2078, 2306, 2539, 2720, 2929, 3024, 3488]",7337,7690,7543,4493,3488,73,120,137,58,86,"[595, 959, 1311, 1401, 1908, 2240, 2549, 2983, 3703, 4194, 4996, 5944, 6723, 7834, 9464]","[560, 902, 1286, 1856, 2493, 2856, 3211, 3679, 4265, 4409, 4923, 5467, 5562, 5868, 6648]","[392, 660, 1153, 1656, 1894, 2325, 2782, 3456, 3801, 4516, 5128, 5501, 6350, 6713, 7480]","[245, 644, 815, 1023, 1422, 1592, 1682, 2065, 2323, 2685, 2915, 3118, 3257, 3475, 4157]","[293, 466, 631, 943, 1078, 1213, 1303, 1776, 2006, 2245, 2604, 3089, 3267, 3667, 4143]",9464,6648,7480,4157,4143,-2127,1042,63,336,-655,-1341,15,dire
7555314400,46,106,45,123,83,"[523, 734, 1059, 1430, 1846, 2342, 2706, 3376, 3981, 4652, 5226, 6079, 6533, 7500, 7844]","[514, 757, 1075, 1354, 1641, 1892, 2178, 2476, 2942, 3428, 3892, 4291, 4800, 5194, 5932]","[586, 1000, 1683, 1862, 2189, 2618, 3066, 3156, 3871, 4624, 5062, 5822, 6069, 6491, 6966]","[261, 367, 577, 667, 840, 930, 1020, 1287, 1637, 1926, 2016, 2478, 2574, 2846, 3347]","[261, 400, 534, 663, 838, 928, 1018, 1108, 1332, 1651, 1741, 2142, 2266, 2361, 2705]",7844,5932,6966,3347,2705,95,49,97,119,20,"[627, 945, 1458, 1930, 2384, 2913, 3196, 3946, 4356, 4850, 5419, 6029, 6679, 7320, 8137]","[547, 878, 1178, 1669, 2064, 2836, 3128, 3866, 4425, 5005, 5354, 5831, 6361, 6832, 7385]","[568, 888, 1179, 1469, 1655, 1825, 2466, 3085, 3747, 4329, 4814, 5123, 5422, 5813, 6218]","[261, 351, 490, 681, 822, 1035, 1242, 1577, 1807, 1954, 2044, 2256, 2867, 3144, 3414]","[261, 351, 535, 756, 1065, 1278, 1368, 1634, 1814, 1904, 2049, 2143, 2408, 2714, 3123]",8137,7385,6218,3414,3123,-293,-1453,748,-67,-418,-1483,15,dire
7555372304,93,29,53,59,83,"[0, 290, 524, 892, 1254, 1763, 2118, 2480, 3029, 3606, 4121, 4493, 4843, 5496, 5783]","[0, 327, 609, 855, 1369, 1670, 2154, 2396, 2606, 2696, 3259, 3750, 4380, 4884, 5442]","[0, 170, 260, 469, 637, 1012, 1363, 1690, 1907, 2421, 3091, 3181, 3471, 3714, 4018]","[0, 254, 469, 640, 931, 1110, 1334, 1516, 1736, 2078, 2466, 2858, 3305, 3869, 4098]","[0, 170, 364, 454, 618, 1046, 1277, 1622, 1729, 2007, 2302, 2595, 2811, 2996, 3139]",5783,5442,4018,4098,3139,106,10,96,9,27,"[0, 609, 1168, 1799, 2177, 2772, 3453, 3990, 4742, 5071, 5578, 6018, 6882, 7219, 7989]","[0, 285, 604, 871, 1273, 1883, 2212, 2703, 3315, 3842, 4312, 4768, 5163, 5562, 6109]","[0, 281, 529, 793, 1080, 1491, 1967, 2221, 2523, 2767, 3102, 3544, 3869, 4347, 4967]","[0, 232, 369, 489, 639, 885, 1426, 1908, 2367, 2509, 2599, 2779, 3239, 3432, 3768]","[0, 232, 322, 521, 673, 843, 1157, 1455, 1703, 2041, 2176, 2518, 2966, 3179, 3375]",7989,6109,4967,3768,3375,-2206,-667,-949,330,-236,-3728,15,dire
7555678503,48,106,98,86,100,"[621, 1067, 1312, 1574, 2056, 2210, 2560, 2995, 3296, 3748, 4281, 4819, 6030, 6953, 7735]","[538, 860, 1199, 1524, 1974, 2520, 3202, 3996, 4714, 4859, 5302, 5657, 6787, 7554, 8571]","[506, 763, 968, 1264, 1608, 1893, 2334, 2663, 3410, 3723, 4365, 5046, 5432, 5982, 6470]","[642, 783, 873, 1100, 1225, 1402, 1578, 2267, 2737, 2883, 3103, 3252, 4383, 4614, 5333]","[333, 468, 558, 695, 829, 1006, 1096, 1518, 2123, 2407, 2705, 3018, 3542, 4073, 4382]",7735,8571,6470,5333,4382,46,17,129,53,123,"[733, 1106, 1422, 1668, 2272, 2528, 3228, 3811, 4315, 4590, 5128, 5662, 6402, 6732, 8025]","[651, 1112, 1357, 1743, 2206, 2547, 2986, 3400, 3815, 3952, 4445, 5078, 5530, 5936, 6470]","[629, 874, 1398, 1731, 2159, 2537, 3023, 3416, 4014, 4454, 4714, 5367, 6558, 6652, 7082]","[511, 650, 757, 963, 1402, 1791, 2218, 2308, 2849, 2939, 3212, 3341, 3914, 4008, 4797]","[350, 440, 575, 795, 1089, 1179, 1368, 1503, 1761, 2077, 2218, 2413, 2894, 2988, 3446]",8025,6470,7082,4797,3446,-290,2101,-612,536,936,2671,15,radiant
7555980006,20,109,112,103,64,"[0, 305, 672, 1053, 1685, 2133, 2466, 2804, 3189, 3564, 3865, 4771, 5655, 6215, 6516]","[0, 279, 556, 802, 1255, 1672, 1919, 2046, 2171, 2427, 2753, 3430, 3864, 4378, 4791]","[0, 154, 349, 487, 626, 897, 1048, 1183, 2032, 2740, 3101, 3281, 3639, 3798, 4267]","[0, 236, 564, 939, 1266, 1575, 1816, 1990, 2361, 2685, 3005, 3272, 3549, 3758, 4094]","[0, 154, 591, 681, 929, 1063, 1198, 1332, 1585, 1773, 1900, 2181, 2524, 2956, 3105]",6516,4791,4267,4094,3105,10,55,126,21,85,"[0, 243, 650, 893, 1272, 1474, 1837, 2659, 3490, 3663, 4547, 4857, 5993, 6727, 7584]","[0, 243, 542, 789, 1191, 1633, 1883, 2685, 3509, 3801, 4565, 5054, 5913, 6633, 7875]","[0, 295, 495, 784, 994, 1366, 1866, 2165, 2419, 2811, 3285, 3827, 4475, 5052, 5655]","[0, 209, 299, 389, 566, 956, 1174, 1401, 1847, 2026, 2515, 3010, 3391, 3987, 4707]","[0, 209, 299, 389, 533, 699, 813, 993, 1523, 1921, 2212, 2431, 2831, 3398, 3816]",7584,7875,5655,4707,3816,-1068,-3084,-1388,-613,-711,-6864,15,dire
7556112506,98,21,53,96,111,"[423, 715, 1123, 1464, 1911, 2544, 2942, 3227, 3918, 4286, 4522, 5302, 5650, 6040, 6218]","[423, 681, 1011, 1306, 1721, 2049, 2451, 2970, 3484, 3852, 4251, 4558, 4800, 4950, 5295]","[365, 575, 665, 999, 1135, 1613, 1745, 1895, 2333, 2580, 2947, 3340, 3507, 3688, 3995]","[500, 778, 1168, 1367, 1637, 1889, 2230, 2521, 2872, 3382, 3637, 4184, 4351, 4446, 4541]","[423, 633, 782, 964, 1271, 1584, 1768, 1858, 2227, 2317, 2543, 3040, 3207, 3383, 3526]",6218,5295,3995,4541,3526,19,48,43,102,26,"[292, 490, 836, 1310, 1723, 2183, 2539, 3100, 4026, 4683, 5290, 5659, 6362, 6968, 7591]","[206, 368, 617, 825, 1198, 1530, 2473, 2764, 3163, 3513, 4090, 4648, 5368, 5974, 6800]","[159, 249, 496, 586, 822, 1034, 1407, 1719, 1947, 2317, 2542, 3193, 4275, 4611, 5455]","[159, 249, 378, 514, 729, 899, 1299, 1470, 1779, 1966, 2216, 2602, 3173, 3380, 4046]","[73, 163, 253, 379, 544, 634, 845, 945, 1083, 1704, 2007, 2535, 3066, 3273, 3773]",7591,6800,5455,4046,3773,-1373,-1505,-1460,495,-247,-4090,15,dire
7556149516,80,90,4,86,21,"[0, 163, 391, 783, 1548, 1887, 2277, 2787, 3076, 3954, 4141, 4775, 5263, 5743, 6964]","[0, 129, 403, 632, 826, 1170, 1614, 1962, 2621, 3188, 4499, 5269, 5874, 6337, 6678]","[0, 192, 436, 887, 1109, 1509, 1883, 2107, 2440, 2799, 3243, 3424, 3997, 5190, 5533]","[100, 190, 305, 443, 533, 674, 911, 1105, 1277, 1595, 2176, 2453, 2633, 2969, 3402]","[0, 90, 205, 398, 770, 1092, 1222, 1312, 1558, 1809, 2228, 2460, 2778, 3138, 3469]",6964,6678,5533,3402,3469,73,74,97,20,79,"[247, 696, 1157, 1515, 1652, 1968, 2326, 2737, 3316, 3871, 4709, 5805, 6455, 7257, 8304]","[680, 1007, 1213, 1593, 2050, 2368, 2987, 3375, 3740, 4022, 4563, 5085, 5756, 6343, 6583]","[112, 522, 956, 1204, 1413, 1612, 1835, 2417, 2807, 3316, 3770, 4223, 4668, 5382, 5612]","[112, 362, 542, 790, 880, 1010, 1100, 1235, 1563, 1945, 2653, 3170, 3384, 4311, 4405]","[112, 362, 502, 592, 682, 812, 990, 1251, 1429, 1519, 1901, 2228, 2836, 3039, 3257]",8304,6583,5612,4405,3257,-1340,95,-79,-1003,212,-2115,15,dire
7556191109,25,69,40,123,106,"[0, 167, 433, 562, 815, 1149, 1565, 1897, 2439, 2693, 3337, 3914, 4456, 4842, 5204]","[0, 198, 549, 844, 1519, 2119, 2787, 3032, 3425, 3682, 3995, 5039, 5319, 5956, 6520]","[0, 129, 219, 671, 800, 970, 1168, 1612, 1844, 2092, 2381, 2815, 3052, 3147, 3419]","[0, 129, 219, 356, 621, 891, 1194, 1497, 1587, 1888, 2245, 2482, 2572, 2702, 3171]","[0, 211, 426, 641, 838, 1046, 1218, 1699, 1931, 2478, 3134, 3371, 3902, 4093, 4365]",5204,6520,3419,3171,4365,63,98,96,101,85,"[114, 407, 607, 942, 1675, 2181, 2554, 3334, 3725, 4127, 4794, 5528, 6420, 7298, 7885]","[382, 794, 1033, 1540, 1864, 2517, 3177, 3520, 4218, 4971, 5563, 5897, 6523, 7183, 7906]","[114, 323, 526, 984, 1612, 1910, 2131, 2830, 3321, 3879, 4139, 4984, 5543, 6418, 6731]","[247, 503, 593, 976, 1115, 1205, 1295, 1794, 2470, 2760, 2967, 3799, 4284, 4739, 4951]","[114, 323, 413, 503, 746, 905, 1255, 1612, 1769, 1906, 2159, 2454, 2634, 3088, 3300]",7885,7906,6731,4951,3300,-2681,-1386,-3312,-1780,1065,-8094,15,dire
7556232511,60,90,28,33,30,"[0, 251, 537, 1263, 1597, 1921, 2614, 3144, 4135, 5078, 5665, 6575, 7129, 8017, 8668]","[0, 204, 372, 679, 940, 1299, 1757, 2427, 3067, 3721, 4263, 4625, 5546, 6381, 6726]","[0, 251, 562, 847, 1463, 1945, 2508, 2855, 3137, 3795, 4349, 4929, 5767, 5988, 6591]","[0, 130, 220, 393, 483, 634, 1254, 1344, 1595, 1959, 2266, 2606, 2786, 3359, 3722]","[0, 130, 259, 393, 613, 781, 965, 1100, 1277, 1497, 2015, 2424, 3001, 3666, 3851]",8668,6726,6591,3722,3851,73,74,86,135,56,"[16, 427, 599, 833, 1298, 1867, 2124, 2688, 2970, 3742, 4531, 5784, 6903, 8105, 9319]","[0, 321, 654, 996, 1374, 1791, 2164, 2530, 2787, 3043, 3323, 3413, 4682, 5095, 5578]","[0, 210, 300, 390, 734, 933, 1023, 1129, 1219, 1309, 1524, 1888, 2000, 2332, 2589]","[0, 210, 451, 668, 846, 975, 1065, 1200, 1290, 1451, 1577, 1740, 1931, 2219, 2568]","[17, 262, 352, 481, 605, 733, 837, 965, 1137, 1343, 1433, 1523, 1695, 2082, 2339]",9319,5578,2589,2568,2339,-651,1148,4002,1154,1512,7165,15,radiant
7556255807,47,72,82,20,19,"[0, 239, 439, 810, 1451, 1625, 1981, 2071, 2641, 2981, 3191, 4186, 4645, 5166, 5261]","[0, 251, 517, 804, 1040, 1452, 1915, 2272, 2564, 2907, 3348, 4200, 4616, 5522, 5654]","[0, 245, 524, 650, 1086, 1212, 1506, 1977, 2136, 2392, 3112, 3655, 4173, 4565, 5007]","[0, 170, 275, 365, 500, 641, 750, 940, 1145, 1235, 1370, 2122, 2302, 2511, 2760]","[0, 170, 260, 350, 440, 530, 798, 924, 1051, 1180, 1315, 1867, 2047, 2526, 2709]",5261,5654,5007,2760,2709,106,95,28,27,79,"[331, 622, 1188, 1474, 1601, 1847, 2417, 3123, 3586, 4153, 4695, 4863, 5280, 5591, 6867]","[63, 315, 559, 970, 1394, 1780, 2193, 2534, 2646, 3078, 3689, 3874, 4333, 4796, 5602]","[63, 233, 544, 1057, 1183, 1430, 1770, 2198, 2733, 3045, 3419, 3931, 4467, 4723, 5480]","[63, 233, 388, 815, 1017, 1599, 1802, 2054, 2933, 3207, 3921, 4059, 4408, 5047, 5498]","[63, 233, 353, 457, 601, 731, 1175, 1427, 1748, 2024, 2404, 2781, 2984, 3303, 3642]",6867,5602,5480,5498,3642,-1606,52,-473,-2738,-933,-5698,15,radiant
7556413616,82,120,129,66,86,"[534, 739, 955, 1386, 1509, 2085, 2341, 2822, 3402, 3852, 4635, 5243, 5555, 6486, 7483]","[450, 777, 1139, 1427, 1805, 2221, 2618, 3165, 3630, 4333, 5054, 5578, 6208, 6502, 7178]","[616, 813, 1212, 1515, 1958, 2617, 3063, 3397, 4000, 4851, 5313, 6124, 7081, 7635, 8153]","[303, 461, 645, 844, 1015, 1341, 1639, 1846, 2190, 3100, 3377, 3685, 4283, 4555, 4973]","[312, 402, 596, 770, 860, 1040, 1548, 1706, 1932, 2258, 2542, 2735, 2977, 3532, 3878]",7483,7178,8153,4973,3878,73,47,97,105,7,"[507, 773, 1064, 1559, 2001, 2721, 2980, 3294, 3982, 4491, 5495, 6622, 7648, 8463, 9398]","[412, 757, 1094, 1417, 1794, 2267, 2646, 3131, 3655, 3962, 4408, 4897, 5418, 5997, 6837]","[605, 917, 1213, 1460, 1700, 2262, 2713, 3020, 3595, 4126, 4669, 5150, 5593, 5927, 6533]","[310, 400, 535, 625, 715, 865, 1025, 1236, 1584, 1820, 2127, 2501, 3484, 3758, 4195]","[341, 480, 619, 742, 832, 993, 1083, 1275, 1504, 1992, 2131, 2364, 2934, 3064, 3362]",9398,6837,6533,4195,3362,-1915,341,1620,778,516,1340,15,dire
7556745318,6,53,29,49,86,"[80, 516, 747, 1043, 1614, 2070, 2635, 3028, 3399, 4182, 4474, 5485, 6167, 6626, 6988]","[80, 344, 536, 884, 1397, 1796, 2080, 2881, 3258, 3986, 4384, 4936, 5423, 5815, 6265]","[80, 319, 544, 814, 1144, 1623, 2042, 2576, 3074, 3254, 3912, 4672, 4919, 5481, 5786]","[80, 321, 662, 944, 1236, 1574, 1932, 2191, 2511, 3037, 3242, 3917, 4386, 4730, 5446]","[474, 644, 759, 947, 1128, 1296, 1501, 1991, 2208, 2501, 2716, 3929, 4493, 4716, 5181]",6988,6265,5786,5446,5181,98,93,22,64,2,"[354, 611, 889, 1346, 1704, 1994, 2556, 3330, 3671, 4644, 5056, 6839, 6965, 8356, 8809]","[110, 280, 521, 741, 1292, 1619, 1979, 2142, 2232, 2545, 2680, 3025, 3698, 4215, 4985]","[489, 659, 1258, 1348, 1538, 1790, 1880, 2067, 2393, 2590, 2986, 3622, 3835, 4069, 4807]","[487, 657, 747, 909, 1089, 1224, 1658, 1748, 1923, 2361, 2589, 3289, 3379, 3613, 3993]","[221, 391, 636, 833, 1091, 1226, 1316, 1720, 1853, 2044, 2401, 2882, 3057, 3323, 3726]",8809,4985,4807,3993,3726,-1821,1280,979,1453,1455,3346,15,dire
7556769809,36,70,102,27,79,"[0, 209, 386, 634, 882, 1153, 1524, 1702, 2116, 2324, 3170, 3637, 4081, 4968, 5172]","[0, 279, 616, 827, 1253, 1685, 1922, 2425, 2748, 3485, 3982, 4281, 4671, 5127, 5588]","[0, 286, 573, 966, 1129, 1438, 1959, 2290, 2755, 3131, 3575, 4045, 4519, 4843, 5332]","[0, 170, 547, 637, 1293, 1681, 1814, 2319, 2454, 2740, 2976, 3784, 3997, 4179, 4570]","[0, 170, 260, 395, 485, 678, 901, 1235, 1370, 1567, 1924, 2252, 2342, 2749, 3163]",5172,5588,5332,4570,3163,25,21,14,123,51,"[0, 296, 587, 936, 1366, 2032, 2725, 3334, 3705, 4492, 4914, 5270, 6310, 6680, 7294]","[0, 170, 499, 848, 1271, 1565, 2206, 2445, 2772, 3391, 3952, 4461, 5034, 5364, 5823]","[0, 170, 694, 909, 1332, 1655, 2296, 2663, 3254, 3344, 3554, 4185, 4569, 5171, 5868]","[0, 221, 636, 843, 1042, 1266, 1855, 2057, 2395, 2677, 2883, 3397, 3794, 4194, 4881]","[0, 170, 303, 641, 823, 953, 1154, 1356, 1853, 2314, 2449, 2845, 3096, 3416, 3776]",7294,5823,5868,4881,3776,-2122,-235,-536,-311,-613,-3817,15,dire
7556977117,63,126,21,108,26,"[1, 242, 522, 961, 1378, 1680, 2364, 2538, 2799, 3094, 3500, 4155, 4597, 5791, 6152]","[1, 426, 589, 944, 1356, 1712, 2278, 2661, 3132, 3819, 4879, 5428, 6306, 6616, 7163]","[1, 215, 384, 521, 806, 997, 1380, 1552, 2063, 2188, 2635, 2821, 2911, 3560, 3992]","[1, 171, 370, 576, 976, 1264, 1700, 1838, 1980, 2107, 2332, 2871, 3158, 3576, 3935]","[1, 171, 597, 810, 938, 1044, 1332, 1422, 2106, 2215, 2621, 2711, 2801, 3308, 3493]",6152,7163,3992,3935,3493,70,71,22,20,75,"[1, 247, 547, 875, 1326, 1617, 1992, 2739, 3220, 3908, 4434, 4809, 5257, 5656, 6380]","[1, 171, 615, 823, 1146, 1345, 1674, 2006, 2241, 2877, 3054, 3887, 4315, 4573, 5164]","[1, 259, 573, 778, 1117, 1481, 1811, 2569, 2769, 3035, 3606, 4051, 4411, 4982, 5337]","[1, 171, 308, 398, 578, 708, 1340, 1611, 1701, 2028, 2254, 2490, 2669, 3249, 3398]","[1, 171, 567, 657, 831, 1000, 1122, 1412, 1878, 2000, 2177, 2591, 2681, 2939, 3088]",6380,5164,5337,3398,3088,-228,1999,-1345,537,405,1368,15,dire
7557120004,38,59,49,100,112,"[57, 187, 352, 923, 1386, 1882, 2592, 3144, 3607, 4383, 4985, 5527, 6260, 6787, 6940]","[57, 256, 601, 923, 1514, 1892, 2265, 2809, 3529, 3955, 4431, 4801, 5150, 6232, 6792]","[57, 225, 499, 748, 1092, 1701, 1950, 2371, 2868, 3552, 3939, 4413, 5033, 5846, 6656]","[57, 187, 322, 630, 767, 1046, 1228, 1583, 2007, 2395, 2530, 3000, 3429, 4391, 4899]","[325, 455, 562, 767, 978, 1161, 1464, 1700, 1924, 2204, 2339, 2536, 2875, 3329, 3507]",6940,6792,6656,4899,3507,17,23,93,20,121,"[0, 363, 595, 768, 1154, 1377, 1774, 2142, 3038, 3427, 4160, 4546, 4849, 5772, 6050]","[0, 246, 446, 658, 1063, 1230, 1525, 1885, 2214, 2610, 3015, 3515, 3685, 4173, 5005]","[0, 210, 444, 625, 749, 914, 1049, 1184, 1709, 1889, 2236, 2470, 2868, 3556, 4097]","[0, 210, 394, 764, 854, 1068, 1367, 1502, 1826, 2040, 2410, 2748, 2842, 3185, 3279]","[0, 210, 300, 428, 670, 800, 935, 1107, 1464, 1644, 2164, 2308, 2398, 2807, 2901]",6050,5005,4097,3279,2901,890,1787,2559,1620,606,7462,15,radiant
7557160807,10,120,129,65,20,"[814, 1352, 1807, 2318, 2689, 3137, 3607, 4328, 4968, 5588, 6279, 6966, 7713, 8715, 9732]","[958, 1205, 1616, 1955, 2629, 3039, 3289, 3932, 4543, 4950, 5675, 6459, 6831, 7975, 8560]","[956, 1226, 1676, 2185, 2687, 3048, 3584, 4386, 4665, 5129, 5921, 6286, 6701, 7035, 8005]","[619, 714, 804, 1386, 1726, 1816, 2292, 2671, 3237, 3500, 4005, 4138, 4501, 5295, 5909]","[567, 704, 794, 1033, 1316, 1530, 1959, 2346, 2623, 2762, 3077, 3259, 3624, 4117, 4319]",9732,8560,8005,5909,4319,41,74,29,105,45,"[957, 1227, 1462, 1761, 2167, 2662, 2888, 3151, 3805, 4350, 4772, 5279, 5682, 6340, 6900]","[761, 974, 1268, 1611, 1925, 2519, 2927, 3375, 3949, 4057, 4364, 4734, 5284, 5587, 6357]","[1195, 1546, 2017, 2386, 2859, 3335, 3584, 4110, 4565, 5079, 5604, 6380, 6652, 7338, 7692]","[514, 650, 740, 925, 1015, 1278, 1715, 1941, 2312, 2446, 2727, 3091, 3286, 3444, 3683]","[623, 713, 908, 1043, 1133, 1313, 1403, 1638, 1938, 2421, 2608, 2855, 3089, 3247, 3468]",6900,6357,7692,3683,3468,2832,2203,313,2226,851,8425,15,radiant
7557552704,10,43,23,79,20,"[0, 166, 433, 558, 916, 1250, 1631, 2092, 2427, 2912, 3522, 3889, 4555, 5238, 5507]","[0, 254, 525, 817, 1125, 1502, 1834, 2324, 2658, 3456, 4245, 4701, 5508, 5946, 6825]","[0, 204, 576, 1017, 1406, 1571, 1849, 2257, 2589, 3200, 4005, 4538, 5064, 5766, 6628]","[0, 130, 245, 733, 868, 958, 1177, 1397, 1790, 2200, 2632, 2843, 3135, 3231, 3636]","[0, 130, 245, 335, 473, 563, 714, 804, 1032, 1284, 1599, 1761, 1930, 2175, 2598]",5507,6825,6628,3636,2598,78,6,98,64,21,"[0, 246, 499, 747, 1091, 1522, 1813, 2127, 2585, 3032, 3561, 3997, 4778, 5278, 5593]","[0, 247, 484, 684, 963, 1398, 2116, 2327, 2462, 2731, 3193, 3540, 4232, 4743, 4892]","[0, 367, 763, 1093, 1468, 1842, 2305, 2551, 3047, 3392, 3859, 4528, 4968, 5540, 5733]","[0, 357, 536, 626, 760, 1103, 1309, 1399, 1687, 1955, 2125, 2313, 2742, 2890, 3093]","[0, 210, 352, 489, 579, 937, 1121, 1379, 1734, 2081, 2216, 2365, 2788, 3094, 3559]",5593,4892,5733,3093,3559,-86,1933,895,543,-961,2324,15,radiant
7557709810,128,41,102,14,68,"[0, 314, 598, 1010, 1381, 1804, 2216, 2597, 3663, 4286, 4836, 5450, 5971, 6546, 7185]","[0, 328, 655, 1052, 1465, 1911, 2248, 2627, 3092, 3529, 4164, 4646, 5097, 5637, 6214]","[0, 275, 546, 900, 1351, 1754, 2155, 2567, 2890, 3589, 4198, 4599, 5173, 5742, 6145]","[0, 170, 332, 502, 732, 1006, 1440, 1530, 1669, 2281, 2604, 2755, 2845, 3093, 3239]","[0, 170, 260, 350, 440, 530, 707, 841, 931, 1079, 1335, 1442, 1582, 1731, 1832]",7185,6214,6145,3239,1832,119,6,98,40,75,"[0, 326, 1033, 1564, 2012, 2567, 3364, 3840, 4445, 5086, 5588, 6306, 6746, 7483, 7894]","[0, 296, 583, 1057, 1340, 1806, 2260, 2862, 3297, 3641, 4336, 4868, 5481, 6059, 6636]","[0, 375, 767, 1177, 1558, 1936, 2357, 2976, 3641, 4178, 4653, 5243, 5746, 6269, 6881]","[0, 170, 326, 465, 602, 760, 1153, 1482, 1606, 2004, 2350, 2739, 3218, 3752, 4240]","[0, 170, 260, 441, 545, 635, 810, 1034, 1206, 1468, 1606, 1732, 1921, 2070, 2210]",7894,6636,6881,4240,2210,-709,-422,-736,-1001,-378,-3246,15,dire
7557808608,10,39,96,123,66,"[419, 739, 1346, 1588, 2052, 2534, 3041, 3659, 4325, 4920, 5701, 6635, 6856, 7383, 8169]","[506, 791, 1318, 1747, 2098, 2417, 2726, 3265, 4186, 4551, 5192, 5719, 6103, 6696, 7550]","[396, 764, 1133, 1410, 1838, 2146, 2433, 2898, 3622, 4181, 4713, 5352, 5981, 6261, 6656]","[266, 453, 661, 773, 1025, 1475, 1612, 1877, 2331, 2529, 3069, 3481, 3871, 4132, 4427]","[258, 367, 674, 792, 917, 1269, 1480, 1684, 2234, 2732, 3069, 3582, 3801, 4061, 4608]",8169,7550,6656,4427,4608,95,13,128,53,19,"[558, 794, 1388, 1805, 2208, 2605, 2845, 3309, 3739, 4303, 4836, 5249, 5552, 6244, 6926]","[565, 872, 1206, 1539, 1950, 2305, 3004, 3298, 3472, 3953, 4372, 4751, 5566, 5876, 6296]","[639, 871, 1276, 1484, 1799, 2120, 2516, 3023, 3420, 3865, 4382, 4974, 5544, 5951, 6631]","[300, 395, 600, 735, 825, 1267, 1480, 1722, 1812, 2045, 2248, 2536, 2968, 3195, 3711]","[300, 390, 529, 619, 709, 879, 1107, 1332, 1422, 1980, 2070, 2255, 2620, 2875, 3032]",6926,6296,6631,3711,3032,1243,1254,25,716,1576,4814,15,radiant
7557812714,1,23,97,53,72,"[0, 248, 638, 885, 1271, 1627, 2358, 2935, 3290, 3665, 3951, 4347, 5120, 6188, 6761]","[0, 337, 616, 1071, 1729, 2066, 2679, 3227, 3660, 4255, 4858, 5157, 6423, 7299, 7848]","[0, 292, 613, 947, 1270, 1664, 2046, 2472, 3204, 3545, 4109, 4390, 5100, 5586, 6057]","[0, 209, 299, 389, 568, 704, 853, 1005, 1384, 1474, 1763, 1853, 2536, 2944, 3393]","[0, 209, 629, 765, 992, 1131, 1569, 1757, 1948, 2119, 2347, 2475, 2916, 3277, 3472]",6761,7848,6057,3393,3472,98,41,104,64,26,"[0, 222, 549, 802, 1099, 1465, 1927, 3058, 3606, 4231, 4835, 5527, 5973, 6310, 6678]","[0, 243, 561, 723, 1258, 1573, 1806, 2067, 2326, 2768, 3106, 3461, 4040, 4385, 4747]","[0, 271, 703, 1032, 1372, 1712, 1925, 2513, 2868, 3213, 3699, 4073, 4662, 5013, 5469]","[0, 154, 244, 334, 559, 649, 826, 1293, 1516, 1699, 1971, 2199, 2472, 2687, 2869]","[0, 154, 366, 492, 663, 787, 927, 1393, 1483, 1922, 2101, 2486, 2759, 2937, 3229]",6678,4747,5469,2869,3229,83,3101,588,524,243,4539,15,radiant
7557842012,25,45,129,64,71,"[74, 381, 666, 906, 1152, 1281, 1545, 1911, 2210, 2655, 3134, 3775, 4350, 4772, 5587]","[74, 669, 1002, 1329, 1658, 2001, 2369, 3194, 3496, 3928, 4877, 5079, 5766, 6164, 6611]","[74, 442, 640, 976, 1266, 1510, 1851, 2200, 2324, 2504, 3613, 3815, 3905, 4134, 4801]","[207, 470, 560, 680, 819, 951, 1325, 1636, 1965, 2189, 2727, 2817, 3028, 3123, 3492]","[0, 193, 283, 403, 623, 713, 803, 1119, 1209, 1435, 1834, 2164, 2581, 2724, 2904]",5587,6611,4801,3492,2904,70,113,57,83,123,"[62, 420, 859, 1118, 1571, 2178, 2575, 3118, 3502, 4245, 5102, 5869, 6436, 7197, 7941]","[330, 655, 901, 1415, 1796, 2057, 2672, 2762, 3453, 4324, 5196, 5940, 6362, 7026, 7644]","[62, 358, 717, 1056, 1377, 1766, 2110, 2238, 2535, 2899, 3627, 3928, 4557, 5141, 5735]","[62, 336, 426, 721, 855, 945, 1151, 1330, 1420, 1862, 2173, 2470, 2642, 2915, 3063]","[62, 469, 559, 1026, 1116, 1284, 1374, 1464, 1640, 1955, 2403, 2872, 3044, 3403, 3736]",7941,7644,5735,3063,3736,-2354,-1033,-934,429,-832,-4724,15,dire
7557847702,48,29,74,105,20,"[75, 720, 983, 1403, 1926, 2312, 2684, 3355, 3758, 4350, 4795, 5224, 6220, 7029, 7124]","[141, 436, 723, 960, 1110, 1364, 1644, 1828, 1945, 2331, 2732, 3293, 3855, 4366, 5114]","[208, 588, 797, 1086, 1216, 1643, 2090, 2257, 2879, 3063, 3406, 4018, 4882, 5341, 5659]","[75, 490, 580, 734, 907, 1077, 1492, 1582, 1966, 2377, 2821, 3331, 3731, 4157, 4502]","[0, 681, 801, 998, 1205, 1696, 1975, 2217, 2841, 3025, 3208, 3758, 3960, 4108, 4360]",7124,5114,5659,4502,4360,41,106,38,107,79,"[191, 631, 1033, 1243, 1524, 1900, 2303, 2767, 3245, 3747, 4406, 4637, 5406, 6102, 6718]","[122, 426, 961, 1124, 1514, 1874, 2213, 2738, 3033, 3692, 4477, 4567, 5123, 5731, 6302]","[390, 705, 923, 1050, 1425, 1821, 2197, 2647, 2855, 3260, 4007, 4506, 4956, 5661, 6436]","[122, 252, 425, 550, 675, 1225, 1315, 1450, 1540, 2003, 2489, 2700, 2880, 3443, 3839]","[122, 533, 663, 777, 954, 1129, 1267, 1420, 1786, 1912, 2304, 2568, 2821, 3256, 3917]",6718,6302,6436,3839,3917,406,-1188,-777,663,443,-453,15,dire
7557851908,54,29,21,86,110,"[209, 378, 732, 1094, 1343, 1856, 2103, 2545, 3002, 3522, 3700, 4217, 4598, 5010, 5645]","[209, 535, 821, 1209, 1421, 1741, 2186, 2621, 3107, 3537, 4075, 4540, 4887, 5328, 5910]","[608, 860, 1078, 1363, 1768, 1948, 2158, 2734, 3545, 3737, 3863, 4859, 5108, 5535, 5942]","[132, 301, 441, 832, 922, 1279, 1414, 1771, 2247, 2554, 2830, 3258, 3616, 3862, 5206]","[209, 378, 468, 558, 648, 869, 1006, 1265, 1753, 2270, 2406, 3261, 3715, 3865, 4443]",5645,5910,5942,5206,4443,14,59,129,20,123,"[124, 290, 694, 932, 1126, 1646, 2032, 2404, 2606, 2769, 3147, 3605, 3960, 4458, 5609]","[124, 373, 776, 1140, 1338, 1686, 2264, 2715, 3409, 4273, 4684, 5682, 6303, 6647, 6981]","[392, 565, 983, 1248, 1677, 1885, 2345, 2515, 2956, 3164, 3548, 4051, 4303, 4698, 5281]","[124, 337, 427, 517, 644, 815, 1008, 1274, 1470, 2231, 2460, 2826, 2954, 3297, 3672]","[257, 603, 797, 887, 1073, 1163, 1420, 1510, 1600, 2509, 2728, 2921, 3302, 3451, 4159]",5609,6981,5281,3672,4159,36,-1071,661,1534,284,1444,15,radiant
7557858600,98,51,6,105,100,"[0, 206, 480, 890, 1371, 1669, 2064, 2670, 3093, 3643, 4278, 5011, 5540, 6049, 6519]","[0, 243, 527, 910, 1089, 1447, 1862, 2623, 3013, 3495, 3790, 4443, 5182, 5774, 6365]","[0, 251, 704, 986, 1114, 1451, 1646, 1856, 2073, 2330, 2640, 2864, 3376, 3870, 4275]","[0, 169, 276, 370, 460, 595, 803, 1043, 1178, 1535, 1625, 2117, 2504, 2764, 2905]","[0, 384, 608, 718, 850, 1041, 1131, 1221, 1356, 1529, 1619, 1985, 2458, 2718, 2813]",6519,6365,4275,2905,2813,25,54,47,53,123,"[58, 387, 716, 1074, 1787, 2564, 2936, 3596, 3951, 4529, 5183, 5719, 6280, 7133, 7828]","[58, 263, 467, 681, 962, 1377, 1674, 2013, 2168, 2599, 2887, 3309, 3851, 4258, 4768]","[326, 596, 723, 901, 1187, 1437, 1993, 2313, 2662, 3491, 3980, 4225, 4794, 5526, 5767]","[58, 425, 515, 609, 783, 913, 1124, 1520, 1741, 2239, 2536, 2779, 3101, 3860, 3955]","[58, 330, 493, 583, 761, 891, 1102, 1498, 1588, 1910, 2412, 2797, 3466, 4081, 4176]",7828,4768,5767,3955,4176,-1309,1597,-1492,-1050,-1363,-3617,15,radiant
7557859218,21,39,49,53,119,"[0, 274, 567, 972, 1327, 1687, 2139, 2621, 3283, 3847, 4285, 5190, 5767, 6526, 7121]","[0, 332, 688, 931, 1397, 1809, 2214, 2968, 3429, 4105, 4689, 5500, 5917, 6411, 7188]","[0, 245, 599, 1161, 1529, 1952, 2153, 2533, 3076, 3722, 4421, 5286, 5697, 6511, 7064]","[0, 169, 259, 349, 585, 890, 1124, 1580, 1762, 2247, 2472, 2807, 3003, 3775, 4573]","[0, 169, 259, 789, 1137, 1227, 1577, 1839, 2009, 2205, 2430, 2766, 3003, 3310, 3525]",7121,7188,7064,4573,3525,10,22,47,71,20,"[0, 203, 514, 715, 1222, 1592, 2029, 2483, 2914, 3629, 4155, 4856, 5394, 5912, 6449]","[0, 257, 665, 846, 1138, 1271, 1595, 2089, 2466, 2712, 3394, 3770, 4038, 4378, 4696]","[0, 169, 489, 738, 868, 1077, 1358, 1782, 2077, 2539, 2933, 3230, 3769, 4086, 4341]","[0, 169, 314, 488, 618, 757, 934, 1175, 1282, 1510, 1696, 1834, 2024, 2418, 2630]","[0, 169, 314, 404, 534, 624, 744, 985, 1075, 1165, 1300, 1390, 1686, 1873, 1968]",6449,4696,4341,2630,1968,672,2492,2723,1943,1557,9387,15,radiant
7557888317,2,120,10,14,5,"[0, 239, 436, 634, 1210, 1626, 1859, 2253, 2742, 3441, 4199, 4870, 5489, 5672, 6445]","[0, 412, 776, 1227, 1637, 2007, 2550, 3182, 3692, 4238, 4706, 5388, 5995, 6555, 7167]","[0, 243, 481, 768, 971, 1138, 1625, 2089, 2325, 2503, 3066, 3552, 4315, 4846, 5289]","[0, 273, 412, 502, 1249, 1410, 1699, 1789, 1975, 2253, 2478, 2666, 2964, 3207, 3473]","[0, 170, 260, 398, 488, 578, 761, 890, 980, 1205, 1430, 1520, 1837, 1986, 2235]",6445,7167,5289,3473,2235,48,106,53,96,86,"[0, 208, 569, 974, 1226, 1666, 2048, 2552, 3112, 3681, 4356, 5168, 5827, 6800, 7808]","[0, 361, 759, 1173, 1507, 1928, 2461, 2818, 3506, 4135, 4581, 5149, 5705, 6303, 6946]","[0, 170, 400, 490, 654, 788, 878, 1014, 1423, 1795, 1979, 2381, 2622, 3017, 3337]","[0, 282, 523, 832, 1166, 1752, 1962, 2503, 2980, 3331, 3742, 4141, 4481, 5143, 5692]","[0, 170, 260, 350, 760, 897, 1001, 1174, 1791, 1948, 2363, 2453, 3034, 3601, 3819]",7808,6946,3337,5692,3819,-1363,221,1952,-2219,-1584,-2993,15,dire
7557903306,106,60,20,53,103,"[0, 276, 552, 969, 1420, 1750, 2197, 2744, 3287, 3553, 4067, 4399, 4846, 5102, 5385]","[0, 244, 531, 927, 1293, 1640, 2240, 2552, 2970, 3334, 4290, 4540, 4816, 5178, 5667]","[0, 170, 586, 1172, 1427, 1855, 2130, 2486, 3102, 3470, 3890, 3990, 4545, 4650, 5174]","[0, 170, 260, 433, 658, 1003, 1168, 1387, 1483, 2055, 2286, 2478, 2747, 2949, 3573]","[0, 170, 260, 428, 573, 668, 758, 976, 1150, 1360, 1696, 1845, 2046, 2176, 2397]",5385,5667,5174,3573,2397,73,17,129,66,121,"[0, 250, 492, 678, 1351, 1958, 2330, 3104, 3471, 4072, 5112, 5920, 6752, 7788, 8810]","[0, 361, 719, 1051, 1489, 1910, 2154, 2878, 3240, 3822, 4246, 4737, 5281, 5910, 6605]","[0, 328, 519, 853, 1408, 1498, 1909, 2406, 2930, 3323, 3758, 4178, 4806, 5310, 6196]","[0, 206, 337, 467, 736, 930, 1190, 1995, 2388, 2649, 3042, 3295, 4136, 4793, 5154]","[0, 170, 285, 375, 608, 698, 788, 1227, 1362, 1802, 2001, 2331, 2698, 3102, 3430]",8810,6605,6196,5154,3430,-3425,-938,-1022,-1581,-1033,-7999,15,dire
7557904901,49,41,76,123,20,"[0, 290, 642, 943, 1299, 1770, 2192, 2677, 3223, 3475, 4267, 4667, 4983, 5540, 6171]","[0, 244, 445, 618, 914, 1316, 1615, 2024, 2391, 3106, 3805, 4174, 4753, 4848, 5343]","[0, 169, 383, 706, 901, 1229, 1509, 2120, 2571, 2962, 3735, 4121, 4426, 5306, 5754]","[0, 169, 259, 429, 563, 958, 1093, 1430, 1598, 1887, 2267, 2428, 2651, 2828, 3135]","[0, 169, 259, 349, 439, 590, 725, 906, 1110, 1280, 1757, 2113, 2300, 2602, 2697]",6171,5343,5754,3135,2697,106,22,71,93,53,"[0, 288, 690, 984, 1438, 1763, 2084, 2304, 2775, 3152, 4011, 4139, 4531, 5112, 5662]","[0, 169, 309, 877, 1007, 1255, 1562, 1697, 1897, 1987, 2167, 2497, 3114, 3668, 3869]","[0, 205, 482, 876, 1277, 1871, 2158, 2727, 3267, 3716, 4045, 4257, 4973, 5514, 5663]","[0, 208, 532, 690, 935, 1309, 1601, 2137, 2771, 2999, 3586, 3889, 4513, 5082, 5704]","[0, 169, 259, 383, 558, 688, 846, 981, 1071, 1161, 1455, 1545, 1819, 2128, 2377]",5662,3869,5663,5704,2377,509,1474,91,-2569,320,-175,15,dire
7557909018,21,76,2,100,123,"[0, 244, 513, 898, 1224, 1506, 1919, 2543, 2974, 3995, 4121, 4265, 5497, 5629, 6111]","[0, 328, 564, 897, 1240, 1573, 1936, 2085, 2328, 2754, 3097, 3363, 3596, 3797, 4202]","[0, 292, 560, 880, 1251, 1426, 1870, 2168, 2383, 2806, 3161, 3746, 4066, 4410, 4645]","[0, 209, 299, 469, 652, 742, 880, 1061, 1151, 1486, 1576, 1720, 2082, 2177, 2272]","[0, 209, 526, 662, 1098, 1188, 1335, 1489, 1579, 1769, 1859, 2003, 2365, 2475, 2570]",6111,4202,4645,2272,2570,106,32,33,45,19,"[0, 239, 478, 857, 1190, 1465, 1888, 2352, 3070, 3372, 4061, 4624, 5854, 6522, 7133]","[0, 199, 814, 1060, 1390, 1965, 2498, 2882, 3310, 3491, 4460, 4952, 5801, 5996, 6309]","[0, 210, 551, 1065, 1509, 1713, 2135, 2497, 3098, 3317, 4247, 4882, 5326, 5703, 6332]","[0, 129, 299, 434, 564, 1025, 1286, 1442, 1695, 2063, 2420, 2827, 3369, 3668, 3937]","[0, 129, 219, 611, 788, 914, 1141, 1268, 1725, 1860, 2507, 2745, 3456, 3605, 3700]",7133,6309,6332,3937,3700,-1022,-2107,-1687,-1665,-1130,-7611,15,dire
7557923204,82,21,96,26,83,"[0, 367, 689, 1131, 1610, 2092, 2639, 3093, 4014, 4479, 5203, 6165, 7560, 8328, 8910]","[0, 241, 613, 977, 1573, 1834, 2284, 2697, 3142, 3732, 4094, 4623, 5123, 5722, 6165]","[0, 255, 866, 1377, 1665, 2153, 2833, 3115, 3361, 3689, 4033, 4370, 4940, 5286, 5468]","[0, 169, 387, 524, 614, 839, 1265, 1480, 1689, 1852, 1942, 2360, 3161, 3525, 3829]","[0, 169, 259, 398, 783, 873, 963, 1119, 1247, 1337, 1715, 2059, 2378, 2660, 2848]",8910,6165,5468,3829,2848,46,2,93,14,5,"[0, 376, 846, 1313, 1676, 2274, 2849, 3388, 3889, 4541, 4942, 5544, 6068, 6630, 7050]","[0, 169, 434, 693, 1099, 1453, 1713, 1991, 2218, 2850, 3349, 3985, 4475, 5327, 5856]","[0, 208, 523, 782, 993, 1100, 1459, 2015, 2475, 3013, 3478, 3980, 4373, 4858, 5400]","[0, 218, 373, 537, 713, 955, 1135, 1305, 1589, 2075, 3042, 3730, 4009, 4266, 4659]","[0, 169, 259, 397, 547, 727, 1167, 1461, 1611, 1701, 1893, 2180, 2360, 2557, 2698]",7050,5856,5400,4659,2698,1860,309,68,-830,150,1557,15,radiant
7557955707,120,41,102,107,75,"[0, 257, 622, 1092, 1414, 1614, 2057, 2475, 3015, 3105, 3488, 4181, 4434, 5279, 5679]","[0, 294, 490, 762, 1132, 1530, 1858, 2216, 2615, 3243, 3644, 4197, 4680, 5034, 5570]","[0, 208, 519, 804, 1102, 1433, 1523, 1909, 2313, 2968, 3508, 4040, 4284, 4454, 5054]","[0, 217, 359, 690, 780, 949, 1039, 1174, 1264, 1743, 2194, 2485, 2622, 3063, 3231]","[0, 169, 259, 349, 488, 630, 742, 877, 967, 1057, 1250, 1714, 1983, 2340, 2497]",5679,5570,5054,3231,2497,17,93,97,27,26,"[65, 382, 671, 885, 1282, 1832, 2087, 2460, 2771, 3547, 4127, 4954, 5352, 5782, 6133]","[65, 293, 614, 814, 1323, 1525, 1973, 2354, 2606, 2908, 3625, 3969, 4353, 5166, 5949]","[65, 259, 657, 1096, 1496, 1751, 1992, 2209, 2606, 3164, 3771, 4186, 4303, 4589, 5129]","[65, 259, 549, 705, 883, 1364, 1674, 1885, 2246, 2681, 2951, 3395, 3691, 3968, 4199]","[333, 577, 667, 846, 1137, 1227, 1361, 1511, 1898, 2603, 2873, 3263, 3400, 3781, 3975]",6133,5949,5129,4199,3975,-454,-379,-75,-968,-1478,-3354,15,dire
7558125303,50,54,29,123,20,"[0, 626, 943, 1436, 1930, 2413, 2934, 3379, 4118, 4590, 5054, 5747, 6276, 6619, 7227]","[0, 208, 575, 980, 1368, 1726, 2378, 3040, 3549, 3840, 4209, 5172, 5532, 5814, 6242]","[0, 272, 511, 764, 1120, 1280, 1370, 1670, 2330, 2937, 3600, 4162, 4606, 5047, 5447]","[0, 339, 429, 563, 699, 932, 1084, 1374, 1620, 1850, 2020, 2733, 3263, 3815, 4049]","[0, 238, 328, 418, 554, 644, 856, 1036, 1282, 1512, 1648, 1918, 2213, 2522, 2662]",7227,6242,5447,4049,2662,10,23,17,119,112,"[0, 282, 564, 769, 1096, 1457, 2194, 2921, 3416, 3849, 4394, 4999, 5611, 6763, 7468]","[0, 170, 414, 731, 1103, 1474, 1982, 2430, 2879, 3382, 3939, 4329, 4817, 5405, 5828]","[0, 219, 424, 646, 906, 1179, 1448, 1684, 2165, 2458, 3013, 3444, 4034, 4688, 5221]","[0, 170, 260, 350, 440, 530, 665, 1143, 1277, 1412, 1711, 1969, 2441, 2948, 3214]","[0, 170, 260, 350, 440, 618, 753, 934, 1154, 1356, 1688, 1778, 2001, 2451, 2944]",7468,5828,5221,3214,2944,-241,414,226,835,-282,952,15,dire
7558127419,48,80,86,51,19,"[657, 906, 1372, 1844, 2148, 2406, 2729, 3432, 4046, 4589, 5101, 6094, 7141, 7589, 8084]","[684, 1174, 1375, 1709, 1981, 2459, 2832, 3336, 4096, 4637, 4732, 5133, 5858, 6062, 6724]","[793, 1294, 1769, 2463, 2877, 3104, 3761, 4461, 5283, 5764, 5949, 6386, 6731, 7399, 7494]","[318, 503, 878, 1278, 1506, 1758, 2004, 2375, 2816, 3152, 3247, 3641, 4011, 4211, 4725]","[269, 399, 625, 951, 1131, 1588, 1692, 1935, 2243, 2478, 2654, 2987, 3537, 4010, 4324]",8084,6724,7494,4725,4324,95,33,90,100,26,"[1171, 1750, 2275, 2523, 3148, 3617, 4221, 4796, 5440, 5910, 7233, 7960, 8618, 9407, 10779]","[1185, 1617, 1861, 2266, 2947, 3267, 4008, 4673, 5204, 5704, 6698, 7281, 7914, 8317, 8982]","[1147, 1469, 1903, 2511, 2941, 3695, 4329, 4733, 5153, 5606, 6530, 7414, 7791, 8370, 8919]","[684, 820, 910, 1076, 1211, 1441, 1666, 1824, 2023, 2113, 2697, 3256, 3666, 3895, 4186]","[937, 1075, 1210, 1300, 1435, 1824, 2050, 2209, 2299, 2389, 3004, 3442, 3635, 4026, 4620]",10779,8982,8919,4186,4620,-2695,-2258,-1425,539,-296,-6135,15,dire
7558222315,95,80,74,123,20,"[58, 436, 788, 1170, 1648, 2126, 2596, 2918, 3128, 3449, 3830, 4085, 4747, 5181, 6250]","[58, 384, 587, 1021, 1698, 1888, 2135, 2499, 2841, 3091, 3638, 4124, 4592, 5029, 6204]","[326, 576, 936, 1315, 1565, 1904, 2618, 2931, 3021, 3473, 3964, 4092, 4743, 5282, 6154]","[58, 354, 444, 553, 689, 779, 913, 1087, 1177, 1353, 1597, 1865, 2144, 2373, 3248]","[158, 587, 677, 826, 1219, 1425, 1515, 1679, 1893, 2069, 2204, 2294, 2589, 2862, 3446]",6250,6204,6154,3248,3446,53,114,98,28,3,"[0, 90, 412, 502, 1147, 1410, 1915, 2363, 2683, 2996, 3230, 3564, 4053, 4496, 5190]","[0, 171, 807, 1135, 1526, 2025, 2647, 3097, 3580, 4038, 4378, 5056, 5358, 5772, 5867]","[0, 163, 597, 814, 1159, 1536, 1837, 2268, 3038, 3457, 4045, 4586, 4992, 5753, 5999]","[0, 164, 452, 728, 818, 908, 1043, 1500, 1983, 2490, 2953, 3469, 3960, 4444, 5014]","[0, 90, 419, 590, 1055, 1145, 1493, 1842, 2206, 2335, 2610, 2923, 3299, 3536, 3798]",5190,5867,5999,5014,3798,1060,337,155,-1766,-352,-566,15,dire
7558225004,89,98,106,53,26,"[0, 247, 477, 689, 1170, 1469, 1847, 2319, 2579, 2871, 3349, 3970, 4547, 5183, 5863]","[0, 331, 701, 1066, 1440, 1842, 2343, 2730, 3599, 4459, 5007, 5626, 6159, 6675, 7161]","[0, 284, 517, 1112, 1242, 1457, 1854, 2143, 2329, 2633, 3081, 3285, 3933, 4322, 4725]","[0, 210, 300, 465, 647, 737, 827, 962, 1052, 1323, 1808, 2048, 2321, 2546, 2985]","[0, 210, 300, 411, 541, 715, 1070, 1205, 1406, 1496, 1586, 1901, 1991, 2423, 2615]",5863,7161,4725,2985,2615,97,47,10,121,20,"[0, 167, 556, 787, 1181, 1673, 2306, 2749, 3364, 3909, 4291, 4471, 5097, 5539, 5974]","[0, 213, 538, 709, 1121, 1688, 2124, 2457, 3170, 3592, 4015, 4697, 5255, 5576, 5921]","[0, 130, 421, 790, 1035, 1360, 1688, 2033, 2271, 2654, 3037, 3609, 4070, 4484, 4938]","[2, 136, 613, 738, 872, 1354, 1558, 1648, 2026, 2163, 2485, 2778, 2926, 3112, 3225]","[0, 130, 268, 441, 583, 1067, 1241, 1456, 1781, 1957, 2414, 2594, 2698, 2882, 3132]",5974,5921,4938,3225,3132,-111,1240,-213,-240,-517,159,15,radiant
7558241314,89,108,106,26,123,"[0, 164, 498, 784, 1019, 1579, 1978, 2177, 2615, 3198, 4073, 4392, 5311, 5983, 7008]","[0, 169, 495, 1137, 1551, 1731, 2178, 2515, 2933, 3685, 4304, 4853, 5473, 5693, 6186]","[0, 246, 651, 979, 1317, 1611, 1810, 2221, 2311, 2620, 3063, 3373, 4134, 4472, 5284]","[0, 130, 255, 405, 513, 631, 761, 856, 1104, 1479, 1800, 2219, 2560, 2688, 3205]","[0, 179, 659, 1034, 1169, 1304, 1492, 1599, 1689, 2086, 2580, 2670, 2967, 3061, 3464]",7008,6186,5284,3205,3464,73,46,135,65,20,"[0, 330, 502, 889, 1161, 1551, 1886, 2648, 3183, 4125, 4984, 5870, 6723, 8121, 9085]","[0, 320, 656, 942, 1631, 2051, 2651, 3202, 3833, 4059, 4837, 5332, 6249, 6882, 7341]","[0, 248, 446, 679, 1052, 1456, 1873, 2501, 3025, 3443, 3816, 4349, 4757, 5122, 5798]","[0, 258, 396, 486, 666, 1035, 1125, 1350, 1854, 1944, 2061, 2421, 2658, 3010, 3105]","[0, 297, 433, 560, 710, 1121, 1318, 1565, 1779, 1898, 2194, 2284, 2523, 2824, 2977]",9085,7341,5798,3105,2977,-2077,-1155,-514,100,487,-3159,15,dire
7558281903,19,41,14,26,20,"[307, 639, 923, 1582, 2047, 2407, 3061, 4065, 4369, 4767, 5258, 5806, 5901, 6447, 6770]","[302, 465, 700, 1111, 1337, 1427, 1896, 2274, 2774, 2982, 3156, 3673, 3886, 4030, 4369]","[504, 670, 1004, 1263, 1423, 1670, 2055, 2342, 2432, 2943, 3195, 3645, 4226, 4741, 4903]","[226, 316, 680, 864, 954, 1167, 1464, 1634, 1945, 2071, 2207, 2574, 2755, 3151, 3245]","[190, 321, 411, 546, 680, 815, 1066, 1428, 1567, 1716, 1934, 2293, 2490, 2713, 2807]",6770,4369,4903,3245,2807,54,69,28,53,123,"[329, 772, 1145, 1511, 1873, 2470, 2754, 3157, 3820, 4444, 4928, 5509, 6051, 6808, 7516]","[292, 527, 931, 1087, 1532, 1999, 2336, 2934, 3449, 4080, 4486, 5029, 5366, 5741, 6711]","[284, 613, 904, 1237, 1928, 2595, 3019, 3317, 3753, 4269, 4912, 5306, 6284, 7064, 7724]","[210, 373, 463, 628, 915, 1316, 1623, 1821, 2045, 2566, 3002, 3112, 3875, 4529, 4826]","[210, 404, 494, 654, 926, 1131, 1266, 1392, 1665, 1927, 2248, 2338, 2745, 3173, 3426]",7516,6711,7724,4826,3426,-746,-2342,-2821,-1581,-619,-8109,15,dire
7558300613,128,10,96,123,45,"[0, 182, 422, 788, 1192, 1488, 1924, 2290, 2843, 3535, 3873, 4489, 4579, 4924, 6468]","[0, 245, 579, 1014, 1275, 1717, 2128, 2489, 2978, 3190, 3994, 4408, 4688, 5615, 6390]","[0, 167, 514, 683, 1001, 1267, 1625, 1913, 2185, 2432, 2718, 3393, 3584, 3769, 4237]","[0, 130, 220, 345, 519, 645, 833, 1197, 1563, 1653, 1788, 1943, 2465, 2650, 3151]","[0, 130, 576, 715, 890, 1027, 1117, 1224, 1326, 1501, 1748, 1876, 2318, 2634, 3150]",6468,6390,4237,3151,3150,36,78,20,68,100,"[0, 281, 616, 874, 1331, 1743, 1955, 2446, 3153, 3658, 4145, 4586, 5885, 6294, 6884]","[0, 283, 682, 884, 1252, 1652, 1742, 2174, 2566, 2932, 3348, 3966, 4622, 5127, 5620]","[0, 296, 542, 868, 1532, 1850, 2133, 2563, 2938, 3667, 4393, 4813, 5119, 5500, 5649]","[0, 210, 486, 576, 706, 866, 956, 1094, 1351, 1525, 1839, 2071, 2446, 2779, 2972]","[0, 210, 414, 759, 1169, 1329, 1466, 1970, 2150, 2470, 2747, 3174, 3799, 4193, 4342]",6884,5620,5649,2972,4342,-416,770,-1412,179,-1192,-2071,15,dire
7558380716,120,41,97,105,79,"[330, 664, 1017, 1387, 1803, 1928, 2454, 2759, 3533, 3701, 4000, 4431, 4733, 6010, 6571]","[245, 594, 877, 1153, 1639, 2093, 2253, 2729, 3115, 3323, 3567, 4055, 4381, 4926, 5551]","[281, 548, 784, 990, 1202, 1553, 1843, 2173, 2518, 2980, 3471, 3683, 4116, 4346, 4799]","[210, 300, 436, 566, 1037, 1358, 1448, 1538, 1789, 1905, 1995, 2099, 2346, 2800, 2969]","[210, 300, 390, 520, 689, 779, 869, 959, 1094, 1316, 1568, 1805, 1899, 2228, 2323]",6571,5551,4799,2969,2323,106,93,60,66,101,"[654, 950, 1352, 1837, 2120, 2794, 3021, 3347, 3694, 4574, 5170, 5671, 6235, 6739, 7180]","[185, 585, 929, 1403, 1779, 2224, 2883, 3394, 3856, 4317, 4862, 5615, 6148, 6764, 7689]","[258, 574, 810, 1178, 1338, 1647, 2240, 2666, 3162, 3875, 4167, 4771, 5441, 5875, 6330]","[185, 294, 439, 830, 964, 1116, 1329, 1622, 1712, 2336, 2685, 3308, 3701, 3937, 4438]","[229, 319, 409, 499, 589, 813, 993, 1303, 1653, 2056, 2182, 2485, 2921, 3078, 3522]",7180,7689,6330,4438,3522,-609,-2138,-1531,-1469,-1199,-6946,15,dire
7558405219,48,13,102,21,119,"[2, 287, 594, 932, 1300, 1716, 2094, 2593, 3189, 3663, 4099, 4739, 5309, 6048, 6638]","[0, 279, 545, 908, 1237, 1684, 1984, 2585, 3128, 3659, 4352, 4477, 5085, 5449, 6046]","[0, 248, 533, 780, 1084, 1437, 1634, 1858, 2214, 2909, 3235, 3798, 4278, 4862, 5422]","[2, 176, 270, 360, 456, 635, 795, 928, 1035, 1283, 1418, 1697, 2083, 2274, 2518]","[0, 170, 260, 414, 504, 640, 1022, 1159, 1356, 1585, 1720, 2012, 2493, 2587, 2682]",6638,6046,5422,2518,2682,120,28,89,3,45,"[0, 329, 714, 1085, 1430, 1958, 2353, 3016, 3421, 4051, 4713, 5298, 5661, 6474, 6822]","[0, 220, 481, 775, 1170, 1569, 1950, 2450, 2761, 3267, 3930, 4231, 4997, 5728, 6432]","[0, 309, 638, 886, 1194, 1583, 1845, 2253, 2674, 3010, 3538, 4016, 4818, 5501, 5943]","[0, 220, 335, 517, 647, 753, 1078, 1303, 1717, 1852, 2086, 2640, 2900, 3102, 3318]","[0, 220, 335, 425, 999, 1155, 1245, 1425, 1728, 1921, 2233, 2385, 2696, 2932, 3127]",6822,6432,5943,3318,3127,-184,-386,-521,-800,-445,-2336,15,radiant
7558455414,1,97,106,86,121,"[0, 239, 483, 727, 1034, 1358, 1542, 1731, 1972, 2492, 2990, 3354, 4056, 4855, 5463]","[0, 170, 449, 736, 1148, 1598, 2042, 2476, 3099, 3841, 4609, 5115, 5669, 6184, 7035]","[0, 206, 451, 896, 1255, 1574, 2115, 2715, 3224, 3927, 4527, 5043, 5464, 5824, 6357]","[0, 218, 666, 756, 956, 1208, 1380, 1711, 2146, 3097, 3357, 3447, 3537, 3770, 4137]","[0, 170, 311, 418, 583, 1004, 1299, 1668, 2105, 2525, 2838, 2976, 3066, 3289, 3712]",5463,7035,6357,4137,3712,10,47,17,105,20,"[0, 281, 410, 717, 972, 1352, 1636, 2085, 2649, 3109, 3702, 4137, 4752, 5427, 6035]","[0, 205, 490, 743, 1042, 1478, 1770, 2276, 2927, 3524, 4021, 4734, 5103, 5661, 6126]","[0, 289, 744, 1096, 1504, 1700, 1911, 2074, 2450, 2798, 3237, 3858, 4432, 4642, 5154]","[0, 270, 360, 549, 686, 1010, 1100, 1190, 1372, 1601, 1829, 2063, 2356, 2450, 2618]","[0, 218, 326, 466, 875, 1084, 1208, 1308, 1482, 1662, 1890, 2015, 2105, 2324, 2473]",6035,6126,5154,2618,2473,-572,909,1203,1519,1239,4298,15,radiant
7558600904,90,41,78,105,20,"[313, 628, 927, 1393, 1676, 1942, 2544, 2969, 3611, 3819, 4269, 4598, 4973, 5747, 5944]","[120, 351, 669, 843, 1090, 1303, 1537, 1762, 1955, 2235, 2396, 2842, 3174, 3671, 3890]","[180, 451, 731, 939, 1200, 1290, 1380, 1515, 1926, 2138, 2431, 2660, 2897, 3040, 3217]","[581, 776, 866, 1013, 1147, 1237, 1579, 1714, 1957, 2217, 2355, 2445, 2535, 2630, 2846]","[180, 418, 508, 678, 814, 904, 1097, 1232, 1322, 1542, 1632, 1722, 1812, 2065, 2160]",5944,3890,3217,2846,2160,120,21,38,58,26,"[224, 512, 868, 1108, 1554, 2044, 2470, 3022, 3544, 4095, 4653, 5089, 5737, 6806, 7716]","[490, 704, 1101, 1542, 1869, 2481, 3011, 3660, 4018, 4432, 5018, 5416, 5935, 6468, 7335]","[0, 289, 597, 974, 1549, 1814, 2213, 2794, 3370, 3737, 4559, 5148, 5737, 6356, 6976]","[224, 394, 484, 574, 664, 830, 1180, 1427, 1517, 1989, 2551, 2780, 3093, 3820, 4199]","[357, 527, 664, 825, 1033, 1176, 1311, 1533, 1690, 2149, 2527, 2707, 2857, 3223, 3408]",7716,7335,6976,4199,3408,-1772,-3445,-3759,-1353,-1248,-11577,15,dire
7558677313,77,94,98,86,51,"[0, 207, 567, 778, 1388, 1752, 2119, 2550, 2854, 3331, 4083, 4801, 5239, 5920, 7228]","[0, 285, 524, 1031, 1647, 2034, 2399, 2740, 3125, 3713, 4417, 5002, 5411, 6165, 6901]","[0, 292, 569, 882, 1258, 1534, 1981, 2681, 3012, 3304, 3819, 4264, 4878, 5672, 5985]","[0, 215, 305, 395, 557, 647, 944, 1329, 1577, 1778, 2315, 2742, 3034, 3429, 3983]","[0, 170, 367, 725, 1015, 1105, 1280, 1718, 2079, 2337, 2622, 3070, 3323, 3678, 4055]",7228,6901,5985,3983,4055,69,41,36,121,31,"[62, 305, 542, 1023, 1388, 1626, 1954, 2410, 2809, 3043, 3502, 4060, 4554, 5223, 5777]","[62, 268, 594, 931, 1125, 1460, 1684, 2019, 2279, 2644, 2897, 3119, 3540, 3831, 4397]","[62, 312, 621, 1034, 1377, 1916, 2207, 2499, 3294, 3554, 4095, 4668, 4970, 5547, 5835]","[62, 232, 322, 557, 665, 876, 1011, 1194, 1967, 2224, 2671, 3000, 3136, 3285, 3573]","[330, 500, 590, 710, 800, 930, 1020, 1203, 1319, 1409, 1628, 2099, 2272, 2571, 2859]",5777,4397,5835,3573,2859,1451,2504,150,410,1196,5711,15,radiant
7558701111,76,47,21,136,51,"[0, 325, 685, 964, 1472, 1954, 2405, 2858, 3227, 3540, 4478, 5065, 5490, 5806, 6469]","[0, 243, 497, 738, 1066, 1241, 2061, 2525, 3011, 3459, 4085, 4372, 5073, 5229, 6659]","[0, 277, 552, 728, 936, 1129, 1327, 1742, 2232, 2406, 2707, 3239, 3619, 4137, 4991]","[0, 205, 320, 457, 594, 684, 1024, 1159, 1335, 1507, 1838, 2062, 2447, 2596, 3320]","[0, 219, 352, 442, 532, 622, 712, 847, 1290, 1429, 1711, 1888, 2159, 2254, 2753]",6469,6659,4991,3320,2753,82,17,96,45,105,"[0, 325, 486, 875, 1258, 1573, 2050, 2411, 2992, 3524, 4031, 4499, 5013, 5742, 5890]","[0, 244, 521, 849, 1318, 1619, 2035, 2739, 3633, 3877, 4714, 5182, 6104, 6935, 7312]","[0, 206, 615, 1069, 1450, 1914, 2179, 2557, 2735, 3146, 3767, 4168, 4774, 5425, 6070]","[0, 169, 303, 393, 523, 657, 864, 1048, 1191, 1581, 1974, 2527, 3081, 3386, 3599]","[0, 169, 259, 396, 573, 1115, 1255, 1390, 1568, 1703, 1949, 2110, 2443, 2846, 3256]",5890,7312,6070,3599,3256,579,-653,-1079,-279,-503,-1935,15,dire
7558794800,10,69,13,110,26,"[725, 1012, 1387, 1851, 2222, 2390, 2719, 3225, 3741, 4278, 4644, 5071, 5624, 6158, 6588]","[638, 1055, 1562, 1909, 2493, 2899, 3313, 3787, 4219, 4482, 5136, 5476, 5944, 6637, 6897]","[469, 1033, 1202, 1553, 1756, 2042, 2525, 2894, 3283, 3740, 4131, 4656, 4799, 5508, 6217]","[382, 565, 741, 1131, 1221, 1384, 1495, 1585, 1768, 1858, 1970, 2064, 2251, 2444, 2712]","[666, 865, 1041, 1176, 1266, 1513, 1603, 1693, 1844, 1963, 2175, 2479, 2597, 2827, 2967]",6588,6897,6217,2712,2967,123,15,35,73,51,"[758, 972, 1229, 1587, 2034, 2757, 3299, 3950, 4352, 4750, 5267, 6105, 6735, 7162, 7972]","[663, 917, 1301, 1720, 2136, 2382, 2824, 3252, 3639, 4280, 4914, 5613, 6407, 7167, 7891]","[1038, 1284, 1614, 1904, 2450, 2700, 3108, 3600, 4126, 4380, 4933, 5455, 6344, 7036, 7900]","[723, 813, 1126, 1216, 1488, 2102, 2457, 2824, 3247, 3476, 3820, 4274, 4783, 5060, 5644]","[446, 536, 641, 959, 1139, 1470, 1699, 1894, 2163, 2615, 2842, 3408, 4035, 4352, 4633]",7972,7891,7900,5644,4633,-1384,-994,-1683,-2932,-1666,-8659,15,dire
7558802112,109,13,129,90,100,"[0, 170, 520, 798, 1031, 1319, 1409, 1887, 2118, 2545, 3014, 3554, 3755, 4228, 4754]","[0, 205, 418, 706, 915, 1144, 1603, 1855, 2483, 2929, 4002, 4513, 5024, 5315, 5947]","[0, 170, 555, 957, 1227, 1711, 1997, 2449, 2734, 3414, 4133, 4497, 5054, 5558, 5993]","[0, 219, 405, 540, 630, 837, 927, 1062, 1231, 1526, 2235, 2510, 2636, 2990, 3225]","[0, 170, 260, 394, 484, 620, 829, 1010, 1100, 1568, 1862, 1952, 2129, 2224, 2319]",4754,5947,5993,3225,2319,41,39,137,45,20,"[0, 216, 458, 814, 1219, 1595, 1842, 2122, 2698, 2872, 3511, 4012, 4458, 5076, 5531]","[0, 280, 635, 919, 1325, 1745, 2204, 2696, 3100, 3643, 4271, 4901, 5465, 6007, 6335]","[0, 245, 575, 813, 1137, 1436, 1812, 2192, 3059, 3758, 4552, 5190, 5793, 6225, 6863]","[0, 207, 297, 412, 588, 1141, 1535, 1625, 2092, 2716, 3081, 3321, 3664, 4379, 4709]","[0, 170, 260, 422, 552, 731, 830, 967, 1281, 1457, 1682, 1772, 1970, 2323, 2664]",5531,6335,6863,4709,2664,-777,-388,-870,-1484,-345,-3864,15,dire
7558826219,95,23,20,72,19,"[1250, 1541, 1910, 2253, 2683, 3049, 3649, 4044, 4559, 4931, 5472, 5915, 6346, 7290, 7972]","[1148, 1454, 1775, 2348, 2632, 3263, 3973, 4440, 5363, 5686, 5984, 6231, 6882, 7261, 7749]","[1019, 1415, 1796, 2196, 2500, 2782, 3372, 3728, 4056, 4535, 5066, 5672, 6071, 6652, 7100]","[841, 1040, 1165, 1255, 1418, 1691, 2021, 2188, 2471, 2833, 3117, 3339, 3766, 4106, 4296]","[650, 740, 865, 999, 1422, 2021, 2351, 2518, 2752, 2923, 3216, 3637, 4123, 4385, 4926]",7972,7749,7100,4296,4926,46,41,96,110,21,"[799, 1247, 1673, 1929, 2416, 2872, 3223, 3618, 4400, 5061, 5601, 6313, 7005, 8035, 9230]","[620, 870, 1073, 1432, 1731, 1973, 2558, 2956, 3661, 4171, 4582, 5124, 5446, 5948, 6511]","[617, 1060, 1200, 1566, 2097, 2391, 3119, 3418, 3859, 4074, 4512, 4746, 4937, 5366, 5762]","[340, 430, 520, 752, 881, 1285, 1465, 1600, 2016, 2316, 2746, 3197, 3498, 3846, 4060]","[332, 470, 630, 720, 1123, 1327, 1592, 2015, 2786, 3087, 3308, 3577, 3887, 4476, 4690]",9230,6511,5762,4060,4690,-1258,1238,1338,236,236,1790,15,dire
7558963713,41,97,29,20,45,"[0, 198, 513, 755, 1071, 1448, 1886, 2379, 2705, 2891, 3619, 3870, 4395, 4689, 5886]","[0, 288, 576, 947, 1340, 1773, 2141, 2710, 2922, 3440, 4224, 4640, 4985, 5495, 6644]","[0, 245, 608, 871, 1332, 1589, 1990, 2481, 2875, 3144, 3446, 3622, 3999, 4446, 5345]","[0, 231, 321, 411, 549, 722, 929, 1109, 1199, 1289, 1623, 1887, 2084, 2638, 3162]","[0, 129, 472, 562, 697, 822, 960, 1168, 1304, 1422, 1604, 1785, 1922, 2101, 2617]",5886,6644,5345,3162,2617,48,106,69,40,26,"[0, 287, 923, 1173, 1406, 1851, 2225, 2661, 2967, 3491, 3999, 4423, 4803, 5543, 5782]","[0, 364, 565, 890, 1335, 1629, 2084, 2422, 3094, 3523, 4079, 4353, 4637, 5188, 5579]","[0, 287, 486, 767, 891, 1278, 1785, 2066, 2473, 2841, 3224, 3634, 4308, 4695, 5048]","[0, 209, 337, 642, 732, 822, 957, 1091, 1356, 1589, 1843, 2073, 2665, 3099, 3338]","[0, 209, 379, 514, 604, 743, 918, 1312, 1492, 1707, 2213, 2303, 2393, 2789, 3028]",5782,5579,5048,3338,3028,104,1065,297,-176,-411,879,15,radiant
7558993106,106,109,28,53,112,"[1, 362, 743, 1004, 1449, 1781, 2308, 2739, 3031, 3404, 4098, 4637, 5151, 5799, 6119]","[1, 239, 517, 798, 1149, 1539, 1898, 2248, 2833, 3251, 3767, 4358, 5040, 5565, 6181]","[1, 209, 535, 987, 1482, 1659, 2138, 2637, 3173, 3682, 4175, 4685, 5227, 5824, 6346]","[1, 171, 337, 427, 609, 756, 846, 1295, 1519, 1709, 1889, 2205, 2369, 2677, 2976]","[101, 271, 361, 451, 701, 814, 953, 1378, 1728, 1818, 1998, 2178, 2268, 2516, 2709]",6119,6181,6346,2976,2709,10,29,120,123,20,"[1, 245, 568, 885, 1326, 1606, 2012, 2317, 2583, 2981, 3463, 3989, 4616, 5169, 5786]","[332, 696, 987, 1286, 1654, 1947, 2261, 2741, 2950, 3656, 4427, 5029, 5607, 6171, 6610]","[1, 353, 550, 1009, 1452, 1812, 2268, 2408, 2498, 2878, 3316, 3727, 4142, 4682, 5297]","[64, 295, 432, 572, 902, 1012, 1342, 1482, 1592, 1742, 2023, 2348, 2514, 2627, 2819]","[64, 234, 324, 414, 654, 744, 925, 1065, 1358, 1496, 1974, 2064, 2337, 2431, 2572]",5786,6610,5297,2819,2572,333,-429,1049,157,137,1247,15,dire
7559020110,41,69,23,110,26,"[205, 366, 616, 916, 1204, 1452, 1758, 1978, 2106, 2575, 2950, 3511, 4106, 4674, 6180]","[204, 442, 701, 1166, 2060, 2692, 3007, 3832, 4137, 4754, 5080, 5890, 6042, 6656, 7729]","[326, 654, 1102, 1427, 1909, 2347, 2891, 3557, 4160, 4761, 5129, 5609, 6072, 6436, 7304]","[170, 296, 497, 652, 896, 998, 1399, 1640, 1730, 2076, 2462, 2775, 2972, 3157, 3805]","[221, 311, 447, 585, 955, 1161, 1296, 1801, 1910, 2120, 2669, 2967, 3116, 3401, 4271]",6180,7729,7304,3805,4271,94,120,33,123,85,"[288, 465, 745, 1074, 1479, 1814, 2420, 2566, 3102, 3689, 4245, 4593, 5244, 5981, 6877]","[290, 526, 894, 1351, 1691, 2039, 2417, 2873, 3403, 4189, 4881, 5703, 6644, 7723, 8144]","[206, 568, 843, 1247, 1834, 2052, 2704, 3166, 3874, 4875, 5378, 6113, 6462, 6823, 7088]","[170, 260, 372, 591, 764, 941, 1453, 1543, 1855, 2416, 2699, 2987, 3369, 3635, 3800]","[170, 260, 350, 487, 896, 986, 1263, 1435, 1744, 2198, 2983, 3392, 3760, 4075, 4321]",6877,8144,7088,3800,4321,-697,-415,216,5,-50,-941,15,dire
7559162616,21,82,137,128,26,"[1029, 1240, 1826, 2275, 2609, 3028, 3754, 4212, 4797, 5049, 5577, 6334, 6918, 7779, 8525]","[1188, 1572, 1773, 2161, 2251, 2764, 3201, 3803, 4529, 4959, 5419, 6032, 6957, 8098, 8612]","[1000, 1271, 1439, 1613, 2022, 2433, 3079, 3531, 4083, 4704, 4920, 5538, 5885, 6687, 7245]","[459, 755, 932, 1359, 1557, 1867, 2107, 2311, 2741, 2914, 3009, 3323, 3538, 3921, 4558]","[350, 440, 708, 864, 954, 1134, 1269, 1473, 1716, 1924, 2066, 2477, 2934, 3438, 3907]",8525,8612,7245,4558,3907,46,120,98,123,20,"[734, 1068, 1755, 2061, 2459, 2973, 3401, 3950, 4620, 4811, 5605, 6072, 6844, 7681, 7896]","[882, 1340, 1627, 2121, 2484, 3057, 3183, 3936, 4453, 5110, 5770, 6250, 6857, 7670, 7872]","[752, 1307, 1473, 1721, 1924, 2186, 2462, 2965, 3497, 3909, 4427, 4709, 5178, 5799, 5978]","[395, 603, 693, 1130, 1220, 1492, 1714, 1982, 2346, 2872, 3068, 3233, 3400, 3781, 4010]","[402, 567, 786, 1035, 1161, 1357, 1468, 1644, 2088, 2352, 2631, 2756, 2897, 3117, 3212]",7896,7872,5978,4010,3212,629,740,1267,548,695,3879,15,radiant
7559307810,46,129,103,19,45,"[1227, 1705, 2110, 2450, 2778, 3326, 3880, 4468, 4821, 5853, 6516, 7140, 7838, 8569, 9507]","[1211, 1373, 1667, 1883, 2474, 2999, 3521, 4094, 4669, 5080, 5684, 6294, 6713, 7246, 8006]","[1539, 1804, 2125, 2599, 3036, 3374, 3935, 4813, 5145, 5715, 5943, 6385, 6795, 7145, 7607]","[695, 1001, 1091, 1198, 1362, 1875, 2010, 2351, 2680, 3101, 3490, 3833, 4169, 4576, 4851]","[708, 866, 956, 1313, 1673, 2093, 2392, 2875, 2980, 3379, 3474, 3569, 3764, 3858, 4180]",9507,8006,7607,4851,4180,82,23,29,123,75,"[1143, 1564, 1703, 2057, 2767, 3410, 3893, 4676, 5039, 5658, 6267, 7407, 8083, 8897, 9673]","[1335, 1873, 2205, 2854, 3358, 3665, 4274, 4745, 5520, 6186, 6575, 7799, 8287, 8794, 9358]","[914, 1235, 1561, 1978, 2501, 2999, 3536, 4020, 4797, 5490, 5776, 6307, 6465, 6595, 7032]","[510, 701, 1122, 1305, 1624, 2047, 2230, 2604, 2943, 3307, 3488, 4218, 4536, 4913, 5304]","[488, 666, 883, 1066, 1211, 1466, 1637, 1727, 1963, 2165, 2466, 2899, 3057, 3473, 3703]",9673,9358,7032,5304,3703,-166,-1352,575,-453,477,-919,15,radiant
7559477319,25,120,135,26,51,"[347, 656, 930, 1298, 1801, 2144, 2709, 3195, 3682, 4335, 4737, 5529, 5865, 6463, 6996]","[621, 1045, 1395, 1648, 2192, 2364, 3111, 3743, 4409, 5109, 5904, 6204, 6722, 7279, 7849]","[293, 689, 1096, 1452, 1771, 2080, 2260, 2800, 3049, 3647, 3931, 4508, 4671, 5361, 6142]","[365, 480, 570, 867, 997, 1345, 1622, 1712, 1917, 2237, 2413, 2670, 2799, 3057, 3391]","[265, 380, 470, 604, 780, 968, 1148, 1238, 1398, 1578, 1843, 2075, 2287, 2436, 2894]",6996,7849,6142,3391,2894,10,17,29,110,101,"[168, 501, 661, 1083, 1563, 1883, 2468, 2829, 3378, 3810, 3990, 4530, 5786, 6362, 6559]","[288, 639, 934, 1346, 1790, 2323, 2686, 3225, 3758, 3848, 4228, 4709, 5587, 6237, 6718]","[129, 504, 893, 1247, 1469, 1968, 2292, 2925, 3241, 3662, 4187, 4656, 5188, 5499, 5715]","[129, 244, 334, 698, 884, 1129, 1254, 1344, 1679, 1968, 2280, 2405, 2729, 3042, 3337]","[129, 244, 334, 509, 599, 847, 972, 1107, 1556, 1646, 1853, 2016, 2367, 2728, 2822]",6559,6718,5715,3337,2822,437,1131,427,54,72,2121,15,radiant
7559700108,19,106,44,66,21,"[0, 165, 453, 663, 1014, 1558, 2017, 2564, 2968, 3415, 4210, 4932, 5487, 6007, 6567]","[0, 308, 661, 1118, 1505, 1995, 2370, 2865, 3597, 3687, 4020, 4488, 5125, 5606, 5946]","[0, 209, 415, 745, 1064, 1382, 1680, 2069, 2430, 2751, 3144, 3537, 3774, 4191, 4620]","[0, 129, 219, 466, 691, 931, 1138, 1473, 1702, 2083, 2253, 2568, 2946, 3342, 3637]","[0, 129, 253, 343, 433, 613, 752, 1172, 1357, 1690, 2054, 2345, 2807, 3033, 3163]",6567,5946,4620,3637,3163,49,25,135,100,20,"[0, 326, 574, 931, 1297, 1826, 2252, 2575, 2996, 3402, 4161, 4888, 5623, 6284, 7103]","[0, 591, 916, 1200, 1511, 1700, 1951, 2271, 2777, 3206, 3608, 4197, 5001, 5638, 6146]","[0, 283, 642, 968, 1576, 1905, 2253, 2510, 3012, 3585, 4308, 4872, 5245, 5796, 6205]","[0, 276, 403, 705, 871, 1091, 1280, 1475, 1678, 1827, 2252, 2491, 2707, 3005, 3279]","[0, 209, 334, 424, 662, 887, 1087, 1226, 1491, 1879, 2362, 2554, 2779, 3181, 3512]",7103,6146,6205,3279,3512,-536,-200,-1585,358,-349,-2312,15,dire
7559752002,17,46,14,33,85,"[0, 376, 753, 1221, 1682, 2206, 2634, 3182, 3754, 4363, 4931, 5445, 5975, 7017, 7613]","[0, 240, 364, 562, 789, 1047, 1285, 1578, 2052, 2460, 2871, 3175, 3713, 4247, 4743]","[0, 207, 445, 771, 895, 1422, 1701, 2077, 2841, 3345, 3866, 4430, 5124, 5750, 6228]","[0, 170, 260, 785, 1128, 1346, 1536, 1882, 2576, 2834, 3227, 3659, 4180, 4849, 5328]","[0, 170, 260, 350, 477, 918, 1236, 1894, 2217, 2640, 2956, 3321, 3996, 4376, 4471]",7613,4743,6228,5328,4471,6,35,21,58,86,"[0, 248, 490, 1109, 1199, 1482, 1875, 2374, 2777, 3222, 3829, 4286, 4606, 4932, 5536]","[0, 360, 730, 1151, 1562, 2233, 2882, 3563, 4078, 4624, 5490, 5965, 6952, 7563, 8083]","[0, 206, 607, 984, 1357, 1772, 2264, 2480, 2855, 3407, 3934, 4264, 4354, 5128, 5695]","[0, 170, 260, 639, 811, 901, 1036, 1268, 1402, 1545, 1851, 2158, 2463, 2828, 3021]","[0, 221, 311, 401, 491, 581, 716, 1121, 1211, 1306, 1610, 1832, 2301, 3331, 3536]",5536,8083,5695,3021,3536,2077,-3340,533,2307,935,2512,15,radiant
7559755903,63,71,135,84,121,"[0, 327, 658, 1103, 1445, 2383, 2719, 3625, 4862, 5821, 6581, 7504, 7724, 8284, 8910]","[0, 244, 844, 1077, 1534, 1966, 2269, 2615, 3268, 3701, 4007, 4394, 4744, 5322, 6119]","[0, 322, 521, 901, 1064, 1308, 1643, 2141, 2684, 3137, 3362, 3586, 4266, 4798, 5355]","[0, 169, 259, 612, 747, 1155, 1339, 1625, 2129, 2391, 2616, 3280, 3500, 3886, 4456]","[0, 169, 381, 471, 606, 874, 1089, 1259, 1439, 1665, 1890, 2238, 2418, 2653, 2955]",8910,6119,5355,4456,2955,54,74,97,26,72,"[0, 322, 802, 1262, 1677, 1893, 2785, 3107, 3553, 4112, 4738, 5259, 5525, 6404, 7004]","[0, 291, 614, 1060, 1474, 1708, 2205, 2615, 3066, 3277, 3974, 4462, 5819, 6092, 6527]","[0, 278, 613, 1041, 1376, 1615, 1909, 2148, 2391, 2637, 2955, 3469, 4106, 4764, 5292]","[0, 169, 303, 440, 575, 1030, 1289, 1379, 1548, 1834, 2473, 2669, 2982, 3308, 3734]","[0, 169, 259, 424, 559, 763, 949, 1039, 1208, 1762, 1897, 2093, 2222, 2541, 2941]",7004,6527,5292,3734,2941,1906,-408,63,722,14,2297,15,dire
7559771013,95,120,98,86,100,"[0, 217, 531, 984, 1355, 2049, 2328, 3177, 3549, 4165, 4909, 5554, 6077, 6786, 7569]","[0, 249, 550, 920, 1303, 2051, 2499, 2870, 3637, 4272, 4879, 5514, 6149, 6793, 7356]","[0, 241, 524, 1198, 1446, 1940, 2303, 3058, 3556, 4242, 4626, 5292, 5954, 6661, 6935]","[0, 321, 411, 580, 736, 931, 1188, 1423, 1816, 2054, 2632, 2999, 3392, 4169, 4525]","[0, 169, 311, 485, 575, 933, 1068, 1326, 1518, 1985, 2193, 2337, 2625, 3125, 3487]",7569,7356,6935,4525,3487,106,38,70,110,101,"[0, 324, 698, 1151, 1497, 1908, 2343, 2926, 3256, 3673, 4131, 4462, 4822, 5300, 5945]","[0, 255, 493, 617, 1060, 1305, 1602, 2175, 2532, 2989, 3442, 3672, 4104, 4511, 4740]","[0, 278, 510, 709, 1182, 1624, 2089, 2437, 2789, 3106, 3466, 4132, 4459, 4934, 5319]","[0, 169, 259, 349, 488, 627, 964, 1099, 1271, 1361, 1599, 1689, 1862, 2089, 2352]","[0, 169, 259, 349, 568, 984, 1074, 1209, 1299, 1389, 1627, 2221, 2355, 2450, 2842]",5945,4740,5319,2352,2842,1624,2616,1616,2173,645,8674,15,radiant
7559777415,39,6,97,111,19,"[830, 963, 1250, 1569, 1860, 2316, 2515, 3002, 3693, 4208, 4544, 4973, 5547, 6208, 6775]","[619, 1006, 1177, 1361, 1697, 1980, 2375, 2890, 3438, 3759, 3854, 4314, 4805, 5444, 5734]","[618, 865, 1092, 1285, 1500, 1825, 2004, 2276, 2600, 2803, 3288, 3382, 3691, 4351, 4702]","[642, 770, 896, 1038, 1128, 1411, 1682, 2235, 2514, 2725, 2820, 2948, 3043, 3138, 3828]","[353, 732, 822, 912, 1021, 1339, 1429, 1733, 1823, 1913, 2049, 2191, 2482, 2577, 2860]",6775,5734,4702,3828,2860,69,41,59,58,86,"[1143, 1710, 2080, 2384, 2775, 3111, 3829, 4449, 5130, 6024, 7127, 8084, 9140, 10032, 10358]","[1051, 1424, 1840, 2332, 2790, 3304, 3997, 4306, 4888, 5485, 6436, 6922, 7806, 8777, 9282]","[1192, 1659, 2107, 2728, 3138, 3723, 4222, 4931, 5568, 5909, 6874, 7507, 8132, 8901, 9375]","[491, 666, 800, 986, 1199, 1640, 1999, 2168, 2492, 2835, 3514, 3760, 4245, 4805, 5120]","[591, 763, 853, 1159, 1461, 1736, 2107, 2242, 2622, 3055, 4016, 4110, 4549, 4974, 5132]",10358,9282,9375,5120,5132,-3583,-3548,-4673,-1292,-2272,-15368,15,dire
7559786200,42,128,71,66,31,"[0, 286, 637, 995, 1240, 1662, 1936, 2258, 2708, 3099, 3705, 4107, 4670, 5589, 6464]","[0, 248, 533, 946, 1278, 1753, 2121, 2467, 3001, 4084, 4325, 4863, 5763, 6344, 7018]","[0, 129, 433, 726, 970, 1444, 1829, 2246, 2768, 3019, 3379, 3922, 4457, 4958, 5448]","[0, 129, 243, 418, 667, 870, 1085, 1220, 1486, 1730, 2076, 2458, 3123, 3597, 4117]","[0, 129, 256, 346, 436, 572, 708, 889, 979, 1115, 1432, 1522, 1792, 2281, 2743]",6464,7018,5448,4117,2743,54,13,20,51,101,"[0, 282, 626, 954, 1375, 1783, 2435, 2916, 3400, 3727, 4554, 5040, 5411, 6209, 6974]","[0, 241, 575, 819, 1122, 1456, 2038, 2417, 2758, 2988, 3418, 3830, 4159, 4379, 4681]","[0, 246, 627, 917, 1279, 1657, 2166, 2847, 3181, 3607, 4276, 4493, 5061, 5477, 5864]","[0, 169, 259, 396, 859, 998, 1304, 1782, 1872, 2009, 2418, 2865, 2955, 3140, 3235]","[0, 169, 259, 392, 501, 635, 942, 1126, 1265, 1586, 1850, 2498, 2588, 2885, 3025]",6974,4681,5864,3235,3025,-510,2337,-416,882,-282,2011,15,radiant
7559833511,48,76,97,65,110,"[0, 209, 370, 747, 981, 1187, 1679, 1992, 2301, 2747, 3280, 3675, 4162, 5006, 5614]","[0, 291, 589, 827, 1226, 1576, 1975, 2302, 2827, 3173, 3690, 4161, 4814, 5137, 5750]","[0, 204, 452, 542, 897, 1266, 1442, 1688, 2144, 2605, 2861, 3389, 3891, 4491, 5045]","[0, 170, 260, 458, 885, 1022, 1136, 1283, 1373, 1556, 1992, 2262, 2518, 2681, 3073]","[0, 219, 309, 399, 580, 670, 807, 936, 1026, 1209, 1603, 1804, 1980, 2299, 2710]",5614,5750,5045,3073,2710,25,13,102,3,26,"[0, 326, 600, 845, 1257, 1630, 2122, 2683, 3284, 3876, 4429, 5024, 5380, 6032, 6720]","[0, 242, 430, 758, 1101, 1420, 1581, 1908, 2235, 2639, 3390, 3705, 4114, 4670, 4924]","[0, 209, 591, 758, 1132, 1397, 1757, 2144, 2756, 2960, 3474, 3835, 4544, 4879, 5233]","[0, 170, 285, 375, 505, 595, 706, 967, 1147, 1237, 1372, 1503, 1683, 2093, 2490]","[0, 170, 285, 426, 601, 691, 830, 1457, 1768, 1858, 2126, 2216, 2445, 2593, 2725]",6720,4924,5233,2490,2725,-1106,826,-188,583,-15,100,15,radiant
7559889100,13,95,97,66,138,"[281, 494, 858, 1304, 1672, 2028, 2406, 2919, 3369, 3944, 4575, 5440, 6253, 6758, 7253]","[360, 635, 762, 1277, 1694, 2100, 2535, 2849, 3324, 3648, 4077, 4666, 5470, 6175, 6807]","[232, 610, 876, 1161, 1667, 2045, 2504, 2956, 3394, 3816, 4203, 4442, 4885, 5225, 5738]","[500, 615, 749, 958, 1065, 1395, 1641, 1910, 2247, 2465, 2694, 3089, 3366, 3837, 4440]","[232, 347, 471, 596, 686, 776, 866, 1001, 1243, 1663, 2018, 2307, 2597, 2851, 3194]",7253,6807,5738,4440,3194,73,120,21,58,65,"[452, 858, 1222, 1583, 2195, 2628, 3441, 4272, 4949, 5888, 6625, 7596, 8129, 9563, 10061]","[283, 653, 1143, 1513, 2088, 2532, 2829, 3549, 4194, 4653, 5276, 5827, 6351, 6896, 7556]","[242, 445, 843, 1194, 1602, 1878, 2207, 2575, 3148, 3451, 3763, 4154, 4694, 5330, 5844]","[337, 427, 553, 683, 883, 973, 1118, 1500, 1618, 2018, 2198, 2742, 2927, 3266, 3447]","[237, 327, 462, 592, 770, 887, 1022, 1194, 1318, 1544, 1634, 1980, 2491, 2779, 3234]",10061,7556,5844,3447,3234,-2808,-749,-106,993,-40,-2710,15,radiant
7559896009,93,128,21,66,62,"[0, 572, 662, 1003, 1467, 1792, 2007, 2748, 3231, 3808, 4688, 5315, 5968, 6474, 7258]","[0, 239, 497, 795, 1110, 1503, 1837, 2228, 2441, 2837, 3225, 3994, 4758, 5335, 5873]","[0, 284, 570, 998, 1263, 1559, 1790, 2039, 2486, 3274, 4050, 4680, 5137, 5708, 6456]","[0, 230, 429, 658, 1255, 1403, 2133, 2547, 2694, 2988, 3443, 3666, 4201, 4847, 5105]","[0, 169, 259, 664, 818, 1008, 1307, 1750, 1885, 2048, 2749, 3062, 3472, 3820, 3991]",7258,5873,6456,5105,3991,10,64,92,45,14,"[0, 205, 579, 838, 1315, 1627, 1914, 2203, 2695, 2908, 3192, 3495, 4278, 5002, 5690]","[0, 316, 723, 1043, 1336, 1638, 2291, 2582, 3092, 3515, 4280, 4370, 4781, 5313, 5849]","[0, 206, 589, 831, 1294, 1738, 2447, 2582, 2904, 3253, 3805, 4078, 4806, 5262, 5611]","[0, 169, 259, 349, 567, 721, 1086, 1221, 1578, 1703, 1928, 2380, 3048, 3282, 3492]","[0, 169, 395, 554, 714, 924, 1252, 1493, 1647, 2143, 2553, 2841, 3199, 3294, 3601]",5690,5849,5611,3492,3601,1568,24,845,1613,390,4440,15,radiant
7559921108,48,96,28,123,105,"[0, 241, 527, 949, 1269, 1640, 2035, 2322, 2656, 3237, 3680, 4277, 5074, 5980, 6918]","[0, 322, 560, 809, 1055, 1336, 1789, 2330, 2754, 3228, 3623, 4249, 5009, 5533, 6180]","[0, 367, 653, 1063, 1537, 1904, 2368, 2661, 2932, 3443, 4219, 4646, 4874, 5326, 5743]","[0, 170, 309, 399, 513, 659, 795, 1139, 1528, 1663, 1857, 2002, 2308, 2677, 2960]","[0, 215, 339, 477, 616, 754, 844, 1015, 1109, 1272, 1611, 1764, 2054, 2418, 2619]",6918,6180,5743,2960,2619,63,120,129,26,20,"[0, 242, 572, 701, 958, 1241, 1642, 1968, 2513, 2949, 3563, 4055, 4379, 5188, 5747]","[0, 248, 412, 746, 1002, 1287, 1626, 1860, 2228, 2542, 2940, 3719, 4097, 4864, 5559]","[0, 260, 574, 889, 1064, 1511, 1993, 2409, 2931, 3350, 3662, 4412, 5002, 5852, 6305]","[0, 170, 358, 487, 577, 761, 941, 1444, 1579, 1669, 2177, 2680, 3122, 3662, 3813]","[0, 251, 341, 468, 558, 712, 989, 1222, 1401, 1557, 1804, 2156, 2246, 2539, 2634]",5747,5559,6305,3813,2634,1171,621,-562,-853,-15,362,15,radiant
7559947915,17,129,47,110,100,"[0, 204, 418, 782, 1113, 1464, 1706, 2041, 2365, 3010, 3666, 4202, 4919, 5372, 6048]","[0, 174, 550, 1050, 1263, 1604, 2230, 2608, 2870, 3298, 3833, 4146, 4801, 5220, 5622]","[0, 526, 731, 1088, 1343, 1683, 1843, 2264, 2596, 3261, 3691, 4179, 4744, 5388, 5649]","[0, 90, 180, 352, 442, 572, 662, 927, 1064, 1245, 1473, 1687, 2138, 2480, 2630]","[0, 168, 258, 348, 438, 617, 707, 797, 887, 1063, 1243, 1333, 1790, 2008, 2158]",6048,5622,5649,2630,2158,43,120,41,58,123,"[0, 406, 718, 1093, 1428, 1897, 2262, 2673, 3156, 3711, 4237, 4728, 5533, 6018, 6914]","[0, 323, 528, 962, 1451, 1713, 1803, 2028, 2311, 2622, 3062, 3502, 4186, 4759, 5750]","[0, 287, 589, 867, 1030, 1272, 1719, 1980, 2395, 2741, 3211, 3713, 4078, 4433, 5288]","[0, 250, 389, 576, 715, 805, 1200, 1550, 1927, 2286, 2528, 2745, 2987, 3248, 4139]","[0, 250, 340, 511, 662, 752, 885, 1156, 1353, 1448, 2051, 2273, 2455, 2737, 3550]",6914,5750,5288,4139,3550,-866,-128,361,-1509,-1392,-3534,15,radiant
7559964211,82,98,20,26,112,"[0, 334, 746, 1116, 1484, 1814, 2514, 2799, 3453, 3904, 4313, 4725, 5087, 5672, 6388]","[0, 289, 638, 1092, 1471, 1845, 2197, 2796, 3091, 3593, 4011, 4295, 5005, 5310, 5704]","[0, 331, 777, 1093, 1347, 1816, 2154, 2606, 3102, 3486, 3801, 4118, 4208, 4302, 4547]","[0, 210, 300, 455, 637, 727, 866, 1005, 1184, 1309, 1399, 1658, 1869, 2240, 2406]","[100, 310, 465, 768, 972, 1106, 1243, 1333, 1718, 1808, 1898, 2085, 2540, 2634, 2729]",6388,5704,4547,2406,2729,10,71,74,119,21,"[0, 167, 450, 668, 997, 1295, 1646, 1948, 2486, 2766, 3329, 3755, 4149, 4759, 5292]","[0, 130, 474, 900, 1511, 1801, 2207, 2599, 2854, 3247, 3654, 4476, 4566, 5158, 5663]","[0, 179, 465, 821, 1139, 1556, 1959, 2835, 3574, 3985, 4772, 5170, 5439, 5864, 6082]","[0, 477, 792, 882, 1012, 1122, 1228, 1591, 1681, 2062, 2887, 3268, 3528, 4141, 4475]","[0, 209, 299, 750, 926, 1271, 1454, 1754, 2009, 2431, 3230, 3620, 4006, 4658, 5139]",5292,5663,6082,4475,5139,1096,41,-1535,-2069,-2410,-4877,15,radiant
7559964417,70,113,28,110,123,"[253, 608, 893, 1182, 1669, 2112, 2604, 2935, 3877, 4349, 5046, 5627, 6335, 6886, 7678]","[276, 609, 1057, 1445, 1791, 2523, 2664, 3122, 4188, 4695, 5301, 5767, 6291, 6729, 7236]","[294, 528, 1020, 1204, 1654, 1992, 2352, 2786, 3493, 4144, 4848, 5274, 6236, 6780, 7175]","[170, 260, 350, 523, 942, 1032, 1199, 1373, 1987, 2802, 2982, 3165, 4174, 4283, 4394]","[170, 309, 399, 875, 1014, 1171, 1261, 1612, 1980, 2232, 2412, 2734, 3330, 3425, 3636]",7678,7236,7175,4394,3636,41,17,14,128,105,"[259, 530, 814, 1022, 1335, 1712, 2021, 2167, 2393, 2662, 2957, 3839, 4416, 4836, 5260]","[333, 661, 1030, 1406, 1787, 2209, 2779, 2981, 3071, 3285, 3727, 4694, 4993, 5660, 6086]","[209, 370, 611, 808, 981, 1290, 1662, 2033, 2123, 2420, 3074, 3720, 4077, 4556, 5119]","[221, 358, 546, 636, 766, 901, 1450, 1540, 1630, 1720, 1895, 3751, 3846, 4104, 4198]","[170, 260, 399, 489, 905, 995, 1379, 1469, 1559, 1732, 1963, 2982, 3077, 3172, 3528]",5260,6086,5119,4198,3528,2418,1150,2056,196,108,5928,15,radiant
7559972212,95,17,29,66,86,"[292, 602, 923, 1179, 1466, 1970, 2645, 3049, 3542, 4069, 4559, 5092, 5641, 6397, 6800]","[331, 696, 1049, 1413, 1792, 2127, 2744, 3206, 3661, 4015, 4453, 5152, 6082, 6478, 7029]","[293, 606, 846, 1179, 1516, 2033, 2597, 2950, 3202, 4119, 4754, 5388, 5766, 6021, 6421]","[170, 658, 784, 911, 1050, 1332, 1670, 1968, 2266, 2916, 3539, 4009, 4581, 5133, 5652]","[170, 312, 402, 492, 582, 854, 1073, 1294, 1462, 1733, 1977, 2338, 2639, 2823, 2918]",6800,7029,6421,5652,2918,46,120,97,123,110,"[249, 568, 882, 1203, 1459, 1990, 2397, 2807, 3690, 4150, 4674, 5382, 6310, 7179, 7593]","[206, 531, 1012, 1425, 1753, 2106, 2438, 2926, 3429, 4257, 4362, 4888, 5304, 5552, 5995]","[205, 464, 742, 988, 1187, 1491, 1941, 2236, 2376, 2849, 3306, 3947, 4386, 4847, 5321]","[213, 375, 465, 555, 696, 970, 1126, 1216, 1530, 1907, 2116, 2292, 2611, 2946, 3189]","[170, 260, 397, 487, 577, 677, 860, 969, 1109, 1314, 1404, 1494, 1697, 1888, 2304]",7593,5995,5321,3189,2304,-793,1034,1100,2463,614,4418,15,radiant
7560048306,82,73,29,123,105,"[257, 639, 1028, 1464, 1782, 2399, 2682, 3280, 3743, 4469, 4893, 5582, 6229, 7055, 7997]","[407, 729, 1217, 1615, 1886, 2252, 2756, 3362, 4330, 5070, 6155, 6425, 7941, 8640, 9815]","[383, 877, 1426, 1772, 2363, 2840, 3552, 4044, 4473, 5256, 5958, 6476, 7048, 7452, 8254]","[499, 654, 868, 1004, 1094, 1351, 1644, 1780, 2052, 2269, 2664, 2873, 3143, 3373, 3818]","[231, 514, 651, 844, 934, 1130, 1518, 1620, 1807, 2017, 2175, 2525, 2728, 2870, 3241]",7997,9815,8254,3818,3241,89,7,106,58,86,"[241, 564, 849, 1073, 1363, 1692, 2111, 2689, 3041, 3573, 4330, 5019, 5821, 6589, 7125]","[208, 624, 994, 1330, 1741, 2080, 2767, 3270, 3664, 4195, 4592, 5465, 6254, 6590, 6723]","[169, 336, 747, 1004, 1343, 1576, 2153, 2483, 2847, 3403, 4086, 4292, 4971, 5464, 5864]","[169, 259, 396, 499, 633, 723, 1276, 1366, 1501, 1831, 2234, 2691, 3086, 3487, 3865]","[169, 530, 670, 760, 850, 1061, 1348, 1438, 1792, 2381, 2693, 2882, 3206, 3417, 3667]",7125,6723,5864,3865,3667,872,3092,2390,-47,-426,5881,15,radiant
7560138206,73,98,39,123,5,"[0, 371, 802, 1303, 1563, 1817, 2709, 3218, 3729, 4590, 5399, 6373, 7520, 9111, 9959]","[0, 244, 477, 857, 1018, 1433, 1897, 2238, 2472, 2888, 3200, 3641, 4517, 5502, 5948]","[0, 331, 607, 961, 1410, 1822, 2196, 2743, 3213, 3691, 4349, 5160, 5483, 6068, 6619]","[0, 169, 640, 760, 850, 986, 1194, 1398, 1768, 1868, 2266, 2356, 2871, 3254, 3924]","[0, 169, 365, 550, 685, 775, 1003, 1236, 1504, 1865, 2205, 2540, 2870, 3107, 3291]",9959,5948,6619,3924,3291,22,48,29,45,58,"[0, 357, 962, 1254, 1673, 2098, 2470, 3144, 3550, 3855, 4352, 4784, 5396, 5890, 6388]","[0, 257, 658, 1098, 1381, 1791, 2007, 2480, 2905, 3333, 3950, 4390, 5055, 5890, 6098]","[0, 245, 564, 763, 1170, 1689, 2098, 2617, 3019, 3371, 3831, 4077, 4660, 5416, 5929]","[0, 169, 289, 426, 578, 811, 967, 1291, 1504, 1781, 2014, 2104, 2275, 2548, 2823]","[0, 169, 289, 398, 488, 736, 826, 961, 1056, 1146, 1566, 1688, 1880, 2100, 2317]",6388,6098,5929,2823,2317,3571,-150,690,1101,974,6186,15,radiant
7560377202,10,49,61,128,121,"[609, 813, 1117, 1479, 1821, 2279, 2830, 3294, 3928, 4561, 5155, 5376, 6036, 7003, 7911]","[532, 735, 1017, 1355, 1516, 1965, 2161, 2550, 3453, 4054, 4712, 5674, 6162, 6883, 7330]","[904, 1289, 1555, 2178, 2789, 3355, 3832, 4496, 5306, 5751, 7115, 7427, 8009, 9014, 9509]","[541, 677, 767, 998, 1322, 1715, 1883, 2021, 2249, 2751, 3123, 3427, 3522, 4305, 4601]","[350, 490, 624, 714, 1003, 1267, 1435, 1570, 1902, 2076, 2628, 2883, 3165, 3640, 4149]",7911,7330,9509,4601,4149,70,35,129,123,20,"[948, 1196, 1487, 2008, 2434, 2608, 2912, 3425, 4042, 4721, 5256, 5833, 6507, 7235, 8050]","[530, 819, 1282, 1603, 2002, 2744, 3559, 4307, 5102, 5708, 6562, 6832, 7477, 8115, 8290]","[932, 1348, 1848, 2227, 2633, 3139, 4121, 4681, 5098, 5801, 6596, 6700, 6939, 7386, 7561]","[532, 622, 1099, 1189, 1344, 1544, 1812, 2020, 2362, 2801, 3210, 3421, 3767, 4182, 4402]","[829, 966, 1267, 1572, 1920, 2020, 2425, 2873, 3266, 3383, 3700, 4200, 4439, 4732, 4907]",8050,8290,7561,4402,4907,-139,-960,1948,199,-758,290,15,dire
7560505612,49,10,129,119,65,"[0, 350, 640, 974, 1305, 1518, 2125, 2753, 3179, 3532, 4184, 4580, 5033, 5994, 6547]","[0, 574, 840, 1216, 1504, 1841, 2165, 2794, 3182, 3784, 4337, 5082, 5771, 6456, 7039]","[0, 129, 401, 668, 999, 1387, 1741, 2172, 2405, 2953, 3417, 3708, 4344, 5291, 5847]","[0, 193, 308, 398, 532, 705, 861, 1017, 1107, 1288, 1782, 1928, 2156, 2835, 3031]","[0, 294, 409, 499, 589, 923, 1156, 1361, 1703, 1924, 2287, 2527, 2707, 3445, 3699]",6547,7039,5847,3031,3699,12,126,96,105,79,"[0, 246, 579, 787, 1111, 1274, 1802, 1937, 2313, 2798, 3169, 3397, 4275, 4661, 5184]","[0, 369, 567, 905, 1200, 1443, 1742, 2160, 2526, 3117, 3528, 4044, 4660, 4971, 5395]","[0, 354, 590, 793, 1331, 1634, 1841, 2262, 2689, 3069, 3373, 3642, 4109, 4590, 5157]","[0, 412, 502, 592, 774, 901, 1040, 1470, 1694, 1915, 2154, 2304, 2540, 2686, 2781]","[0, 279, 369, 459, 589, 794, 884, 1155, 1290, 1511, 1601, 1790, 2026, 2221, 2316]",5184,5395,5157,2781,2316,1363,1644,690,250,1383,5330,15,radiant
7560508910,63,106,29,128,20,"[205, 446, 654, 1076, 1351, 1485, 2159, 2525, 2873, 3263, 3717, 4263, 4838, 5092, 5712]","[207, 415, 762, 1016, 1309, 1600, 1909, 2293, 2709, 2996, 3465, 3760, 4531, 4805, 5319]","[205, 452, 739, 1060, 1356, 1620, 2034, 2502, 2921, 3161, 3448, 4134, 4700, 5302, 5939]","[223, 313, 403, 533, 709, 799, 1076, 1303, 1704, 1929, 2019, 2319, 2737, 2832, 3324]","[221, 311, 401, 579, 980, 1107, 1372, 1507, 1683, 1792, 1882, 2005, 2351, 2539, 2879]",5712,5319,5939,3324,2879,17,21,129,33,45,"[326, 685, 1102, 1467, 1927, 2373, 2774, 3287, 3659, 4095, 4943, 5446, 5855, 6554, 6949]","[253, 454, 581, 1128, 1460, 1758, 2185, 2764, 3112, 3470, 4258, 4669, 5188, 5733, 6440]","[254, 541, 803, 1329, 1526, 2043, 2344, 2673, 3170, 3714, 4018, 4594, 4878, 5834, 6208]","[171, 261, 351, 573, 663, 753, 948, 1234, 1373, 1722, 1976, 2178, 2272, 2681, 2776]","[171, 610, 700, 874, 1186, 1276, 1696, 1959, 2049, 2229, 2464, 2665, 3329, 3941, 4207]",6949,6440,6208,2776,4207,-1237,-1121,-269,548,-1328,-3407,15,radiant
7560629402,49,25,23,123,45,"[0, 287, 601, 868, 1171, 1463, 1787, 2067, 2482, 2746, 3302, 3513, 4183, 4734, 5297]","[0, 293, 545, 787, 1021, 1233, 1323, 1648, 2008, 2286, 2853, 3223, 3857, 4462, 5287]","[0, 243, 408, 842, 1194, 1537, 2144, 2334, 3118, 3747, 4345, 5063, 5582, 6232, 6703]","[0, 215, 390, 480, 640, 730, 867, 1004, 1233, 1456, 1768, 2117, 2374, 2591, 3066]","[0, 205, 295, 385, 610, 769, 865, 955, 1184, 1674, 1980, 2070, 2291, 2434, 2960]",5297,5287,6703,3066,2960,59,15,106,102,105,"[0, 244, 442, 603, 1122, 1467, 2021, 2444, 3023, 3512, 4077, 4961, 5465, 6213, 6779]","[0, 243, 492, 1155, 1452, 1853, 2217, 2545, 2872, 3428, 3649, 4412, 4943, 5309, 5662]","[0, 208, 491, 708, 967, 1333, 1468, 1962, 2160, 2540, 3173, 3448, 3885, 4185, 4633]","[0, 170, 317, 407, 532, 871, 1079, 1321, 1411, 1552, 1733, 1960, 2313, 2748, 3152]","[0, 170, 299, 603, 757, 847, 1220, 1577, 1797, 1887, 2128, 2331, 2421, 2837, 3422]",6779,5662,4633,3152,3422,-1482,-375,2070,-86,-462,-335,15,radiant
7560661218,73,93,120,86,105,"[0, 411, 690, 1068, 1410, 1862, 2343, 2809, 3361, 4084, 4977, 5503, 6194, 7192, 7596]","[0, 244, 560, 945, 1186, 1673, 1904, 2185, 2691, 2978, 3358, 3871, 4164, 4661, 4953]","[0, 245, 484, 1009, 1573, 2064, 2288, 2667, 2879, 3370, 3849, 4131, 4692, 5398, 5792]","[0, 258, 348, 485, 916, 1168, 1308, 1443, 1558, 2099, 2540, 2666, 2977, 3197, 3291]","[0, 210, 300, 437, 567, 776, 866, 1048, 1138, 1362, 1620, 1710, 1844, 2196, 2290]",7596,4953,5792,3291,2290,46,21,29,20,136,"[0, 205, 605, 1054, 1453, 1898, 2433, 2676, 3146, 3641, 4244, 4932, 5770, 6121, 6847]","[0, 165, 399, 856, 1064, 1261, 1558, 1841, 2239, 2747, 2980, 3386, 4076, 4713, 5146]","[0, 204, 915, 1194, 1515, 1810, 2168, 2479, 2920, 3482, 3987, 4695, 5188, 5721, 6489]","[0, 130, 272, 423, 537, 627, 751, 841, 931, 1060, 1303, 1623, 1943, 2407, 2712]","[0, 130, 297, 436, 526, 699, 836, 926, 1052, 1142, 1277, 1761, 2046, 2361, 2675]",6847,5146,6489,2712,2675,749,-193,-697,579,-385,53,15,dire
7560727113,95,126,65,120,110,"[328, 624, 992, 1327, 1610, 2149, 2542, 2942, 3399, 4047, 4391, 4860, 5283, 6041, 6672]","[0, 277, 609, 990, 1362, 1639, 2250, 2476, 2924, 3573, 3874, 4188, 4433, 5049, 5389]","[60, 269, 463, 858, 1296, 1598, 2169, 2587, 3145, 3855, 4503, 5775, 6282, 6840, 7125]","[60, 320, 410, 549, 682, 1116, 1312, 1447, 1638, 1818, 2178, 2507, 2927, 3236, 3557]","[160, 369, 459, 549, 679, 882, 1002, 1318, 1457, 1734, 1961, 2129, 2323, 2583, 2946]",6672,5389,7125,3557,2946,48,13,23,123,105,"[0, 164, 416, 663, 1161, 1667, 2205, 2536, 2747, 3160, 3773, 4296, 5030, 5546, 6106]","[0, 199, 438, 684, 1242, 1541, 1988, 2422, 2750, 3211, 4021, 4327, 4889, 5281, 5793]","[0, 178, 579, 790, 984, 1228, 1513, 1858, 2118, 2444, 3293, 3678, 4180, 4645, 4974]","[0, 129, 219, 359, 606, 734, 1337, 1975, 2100, 2190, 2401, 2539, 3041, 3234, 3377]","[0, 129, 219, 309, 469, 627, 1085, 1220, 1348, 1438, 1663, 1911, 2140, 2235, 2375]",6106,5793,4974,3377,2375,566,-404,2151,180,571,3064,15,radiant
7560784306,46,126,135,123,84,"[693, 944, 1401, 1823, 2366, 2964, 3458, 4031, 4389, 5510, 6075, 6940, 7441, 7917, 8357]","[705, 946, 1158, 1481, 1990, 2500, 2881, 3459, 3682, 4200, 4439, 4929, 5355, 5810, 6627]","[858, 1117, 1443, 1775, 2325, 2683, 3019, 3671, 4117, 4700, 4871, 5706, 6000, 6541, 7339]","[328, 418, 618, 753, 888, 1145, 1235, 1525, 1786, 2253, 2486, 2805, 2951, 3330, 4387]","[444, 559, 768, 939, 1091, 1310, 1534, 1824, 2053, 2360, 2508, 2968, 3259, 3885, 4622]",8357,6627,7339,4387,4622,41,23,96,53,26,"[712, 962, 1459, 1704, 1990, 2266, 2748, 3283, 3833, 4254, 4867, 5370, 6292, 7221, 7955]","[1229, 1632, 2155, 2503, 2992, 3285, 3845, 4240, 4613, 5051, 6187, 6942, 7421, 8046, 8387]","[1101, 1460, 1871, 2211, 2664, 3081, 3542, 4170, 4759, 5015, 5506, 5941, 6565, 7210, 7628]","[773, 1092, 1282, 1372, 1681, 1792, 2037, 2216, 2479, 2597, 3018, 3248, 4052, 4670, 4935]","[549, 736, 915, 1005, 1206, 1296, 1488, 1667, 2082, 2276, 2518, 2770, 3257, 3713, 3963]",7955,8387,7628,4935,3963,402,-1760,-289,-548,659,-1536,15,dire
7560901901,72,76,38,20,105,"[314, 619, 937, 1393, 2180, 2572, 2994, 3527, 4144, 4696, 5116, 5710, 6450, 7189, 7706]","[249, 416, 581, 1117, 1448, 1831, 2243, 2817, 3318, 3739, 4020, 4569, 4834, 5250, 5441]","[535, 807, 985, 1260, 1679, 2010, 2281, 2795, 3101, 3575, 4334, 4775, 5231, 5548, 5943]","[229, 358, 465, 692, 978, 1068, 1439, 1616, 1721, 1856, 2061, 2629, 3097, 3385, 3693]","[277, 412, 502, 592, 726, 864, 999, 1089, 1179, 1560, 2281, 2547, 2715, 3165, 3623]",7706,5441,5943,3693,3623,95,23,97,110,26,"[197, 505, 993, 1389, 1718, 2268, 2818, 3252, 3725, 4193, 4728, 5429, 6636, 7404, 8294]","[239, 543, 914, 1123, 1458, 1632, 1942, 2321, 2672, 3158, 3802, 3943, 4637, 4902, 5568]","[207, 491, 808, 1131, 1615, 2236, 2681, 3200, 3607, 4153, 4775, 5053, 5250, 5710, 6298]","[169, 259, 406, 536, 626, 761, 1022, 1134, 1260, 1678, 1924, 2448, 2685, 3092, 3277]","[219, 346, 436, 612, 862, 1156, 1291, 1518, 1733, 1959, 2186, 2353, 2680, 2775, 3123]",8294,5568,6298,3277,3123,-588,-127,-355,416,500,-154,15,dire
7560969500,25,63,97,19,20,"[0, 290, 568, 970, 1400, 1680, 2073, 2471, 2939, 3643, 4142, 4637, 5161, 5752, 6431]","[0, 288, 513, 950, 1159, 1409, 1818, 2176, 2382, 3226, 3855, 4238, 4654, 5222, 5751]","[0, 243, 556, 848, 1258, 1591, 1905, 2413, 2762, 2927, 3499, 3864, 4358, 5102, 5905]","[0, 169, 259, 393, 529, 619, 709, 1373, 1508, 1909, 2044, 2456, 2663, 2828, 3189]","[0, 169, 259, 395, 503, 593, 703, 915, 1083, 1338, 1597, 1725, 1815, 2059, 2310]",6431,5751,5905,3189,2310,70,22,69,65,112,"[0, 288, 617, 959, 1502, 2124, 2501, 3024, 3406, 3877, 4429, 4943, 5526, 6252, 7093]","[0, 620, 939, 1267, 1629, 2052, 2382, 2925, 3515, 3783, 4479, 5157, 5547, 6066, 6702]","[0, 335, 559, 759, 1512, 1848, 2048, 2437, 3056, 3713, 4278, 5084, 5784, 6393, 7176]","[0, 224, 314, 404, 764, 894, 984, 1190, 1602, 1886, 2291, 2923, 3239, 3388, 3906]","[0, 224, 314, 404, 628, 758, 1007, 1284, 1374, 1784, 2145, 2429, 2519, 2668, 2847]",7093,6702,7176,3906,2847,-662,-951,-1271,-717,-537,-4138,15,dire
7561106207,106,14,6,27,85,"[0, 244, 641, 1016, 1550, 1929, 2481, 2832, 3413, 4050, 4669, 5273, 5950, 6687, 7269]","[0, 129, 400, 756, 1351, 1841, 2611, 2864, 3351, 3921, 4258, 4694, 5187, 5730, 6535]","[0, 206, 638, 948, 1238, 1923, 2247, 2441, 2843, 2933, 3365, 3495, 4049, 4508, 4984]","[0, 133, 223, 347, 622, 855, 1123, 1306, 1564, 1676, 1841, 2172, 2687, 2880, 3333]","[0, 90, 285, 422, 512, 1020, 1155, 1406, 1759, 2052, 2497, 2911, 3091, 3334, 3764]",7269,6535,4984,3333,3764,44,25,112,119,3,"[0, 322, 684, 889, 1280, 1559, 1870, 2372, 2959, 3171, 3544, 4282, 4749, 5249, 6090]","[331, 734, 1139, 1546, 1907, 2541, 3048, 3537, 4244, 4538, 5463, 6130, 6655, 6875, 7476]","[63, 349, 584, 997, 1489, 1579, 2037, 2285, 2541, 3104, 3509, 3881, 4285, 4768, 5375]","[63, 313, 664, 792, 970, 1234, 1448, 1595, 1970, 2729, 3326, 3710, 4148, 4546, 4784]","[63, 357, 447, 598, 801, 991, 1081, 1256, 1456, 1727, 1955, 2045, 2490, 2702, 2956]",6090,7476,5375,4784,2956,1179,-941,-391,-1451,808,-796,15,radiant
7561146918,36,59,104,79,22,"[0, 382, 798, 1170, 1580, 2217, 3015, 3427, 4145, 4821, 5047, 5931, 6491, 7514, 8013]","[0, 252, 541, 973, 1343, 1621, 1894, 2177, 2453, 2870, 3475, 4079, 4495, 4976, 5405]","[0, 281, 615, 1019, 1317, 1531, 2067, 2382, 2606, 2926, 3382, 3835, 4169, 4562, 5039]","[0, 170, 260, 432, 653, 743, 906, 996, 1196, 1286, 2037, 2516, 2729, 2985, 3261]","[0, 170, 260, 455, 584, 692, 822, 947, 1115, 1290, 1426, 1739, 2195, 2380, 2558]",8013,5405,5039,3261,2558,25,71,6,86,84,"[0, 335, 658, 993, 1376, 2042, 2430, 2998, 3624, 4516, 5161, 5975, 6949, 7434, 8290]","[0, 329, 563, 930, 1269, 1608, 1749, 2165, 2571, 2909, 3292, 4115, 4879, 5514, 6307]","[0, 290, 610, 817, 1140, 1464, 1863, 2280, 2778, 3219, 3751, 4370, 4543, 5323, 5939]","[0, 170, 307, 397, 563, 750, 840, 1021, 1201, 1613, 2072, 2356, 2716, 3385, 3833]","[0, 170, 260, 350, 528, 666, 756, 976, 1204, 1294, 1547, 1834, 2015, 2602, 2809]",8290,6307,5939,3833,2809,-277,-902,-900,-572,-251,-2902,15,radiant
7561168215,10,98,123,40,71,"[0, 269, 551, 968, 1306, 1746, 2101, 2488, 2853, 3245, 3611, 4097, 4325, 5002, 5231]","[0, 319, 682, 1068, 1236, 1494, 1794, 2141, 2737, 3100, 3472, 3562, 4181, 4310, 4757]","[0, 239, 329, 465, 656, 912, 1355, 1534, 1750, 1963, 2475, 2565, 2742, 3137, 3232]","[0, 229, 515, 712, 898, 1108, 1487, 1844, 2082, 2301, 2598, 2802, 3148, 3431, 3836]","[0, 195, 285, 427, 557, 647, 830, 999, 1089, 1179, 1511, 1662, 1752, 1885, 1980]",5231,4757,3232,3836,1980,63,36,43,112,45,"[380, 707, 906, 1402, 1695, 2124, 2481, 2834, 3446, 3972, 4495, 4929, 5600, 6226, 7112]","[112, 401, 743, 1150, 1521, 2014, 2467, 3143, 3776, 4558, 5028, 5705, 6151, 6530, 7174]","[245, 415, 608, 943, 1331, 1585, 2072, 2304, 3031, 3749, 4093, 4610, 5101, 5555, 6195]","[54, 224, 519, 654, 814, 1113, 1203, 1362, 1578, 1923, 2236, 2667, 3315, 3628, 4102]","[212, 382, 472, 608, 787, 939, 1112, 1315, 1541, 1723, 1994, 2430, 2880, 3078, 3523]",7112,7174,6195,4102,3523,-1881,-2417,-2963,-266,-1543,-9070,15,dire
7561212717,94,137,17,123,90,"[0, 154, 481, 857, 1337, 1708, 1833, 2164, 2432, 3001, 3491, 4181, 4591, 5607, 6105]","[0, 191, 434, 706, 945, 1437, 1676, 1854, 2062, 2611, 3165, 3682, 3999, 4623, 5463]","[0, 273, 560, 1014, 1507, 2057, 2463, 3057, 3419, 3836, 4265, 4519, 4923, 5345, 5691]","[0, 154, 244, 514, 644, 779, 905, 1166, 1404, 1518, 1775, 2076, 2215, 2766, 3130]","[0, 154, 244, 381, 596, 780, 903, 1059, 1295, 1406, 1500, 1813, 1953, 2208, 2545]",6105,5463,5691,3130,2545,95,13,96,65,110,"[0, 317, 560, 758, 1227, 1650, 2141, 2672, 3170, 3722, 4308, 4732, 5175, 5722, 6291]","[0, 292, 542, 821, 1227, 1637, 2053, 2614, 3147, 3589, 4166, 4589, 5051, 5895, 6338]","[0, 243, 598, 962, 1321, 1609, 1952, 2244, 2580, 3032, 3556, 4020, 4397, 5073, 5567]","[0, 209, 299, 389, 863, 973, 1203, 1497, 1662, 1828, 2008, 2272, 2602, 3013, 3355]","[0, 255, 345, 455, 668, 803, 1116, 1472, 1605, 2169, 2349, 2483, 2679, 3045, 3348]",6291,6338,5567,3355,3348,-186,-875,124,-225,-803,-1965,15,dire
7561220700,17,6,57,64,101,"[0, 365, 733, 1099, 1573, 1954, 2240, 2850, 3180, 3856, 4543, 4847, 5607, 6108, 6933]","[0, 288, 685, 881, 1368, 1827, 2345, 2715, 3238, 3693, 4083, 4442, 5220, 5705, 6096]","[0, 170, 555, 804, 1240, 1569, 1733, 2252, 2753, 3181, 3666, 3966, 4263, 4580, 5644]","[0, 170, 260, 388, 555, 690, 828, 918, 1382, 1472, 1686, 1830, 1921, 2081, 2917]","[0, 170, 260, 350, 516, 697, 787, 877, 1344, 1478, 1746, 2092, 2359, 3159, 3685]",6933,6096,5644,2917,3685,48,49,16,71,90,"[0, 208, 519, 970, 1385, 1838, 2280, 3196, 3828, 4352, 4479, 5376, 5976, 6831, 7620]","[0, 260, 582, 996, 1399, 1862, 2359, 2894, 3479, 4247, 5096, 5682, 5974, 6333, 6428]","[0, 276, 442, 661, 799, 1031, 1438, 1866, 2156, 2518, 3119, 3794, 4148, 4751, 4885]","[0, 170, 260, 390, 910, 1000, 1175, 1577, 2161, 2475, 3112, 3489, 3995, 4297, 4903]","[0, 170, 260, 350, 478, 568, 854, 1097, 1354, 1758, 2104, 2766, 2984, 3461, 3805]",7620,6428,4885,4903,3805,-687,-332,759,-1986,-120,-2366,15,radiant
7561287313,19,7,138,86,92,"[0, 322, 675, 937, 1267, 1709, 1927, 2362, 2641, 3011, 3242, 4073, 4479, 4733, 5043]","[0, 242, 475, 790, 1113, 1566, 1813, 2063, 2466, 2774, 3365, 3710, 4132, 4456, 4862]","[0, 207, 833, 968, 1058, 1312, 1501, 1591, 1763, 2108, 2375, 3486, 3720, 4260, 4435]","[0, 218, 308, 500, 674, 903, 1042, 1255, 1513, 1875, 2092, 3102, 3697, 3936, 4117]","[0, 204, 502, 705, 1008, 1332, 1494, 1704, 1839, 2014, 2194, 2859, 3171, 3481, 4031]",5043,4862,4435,4117,4031,46,120,97,123,21,"[0, 244, 559, 962, 1248, 1669, 2527, 3161, 3734, 4604, 5735, 6549, 7220, 8050, 8648]","[0, 288, 533, 981, 1384, 1727, 2507, 2801, 3411, 3587, 4065, 4535, 4974, 5761, 6086]","[0, 243, 581, 970, 1286, 1771, 2027, 2708, 3003, 3645, 4231, 4536, 4991, 5743, 6475]","[0, 170, 309, 545, 728, 958, 1195, 1453, 1682, 1993, 2384, 2730, 2964, 3292, 3491]","[0, 170, 260, 385, 540, 692, 999, 1172, 1480, 1726, 2096, 2457, 2547, 3007, 3101]",8648,6086,6475,3491,3101,-3605,-1224,-2040,626,930,-5313,15,dire
7561335201,95,98,97,110,26,"[0, 207, 411, 698, 1097, 1516, 2026, 2363, 2795, 3293, 3669, 4152, 4484, 5127, 5806]","[0, 324, 607, 1006, 1423, 1767, 2233, 2530, 3231, 3836, 4087, 4177, 4789, 5828, 6829]","[0, 241, 618, 776, 966, 1286, 1858, 2311, 2899, 3393, 3791, 4341, 4958, 5381, 5907]","[0, 169, 300, 390, 480, 615, 750, 1054, 1258, 1483, 1608, 1940, 2127, 2720, 3014]","[0, 169, 259, 385, 558, 898, 1130, 1310, 1489, 1842, 1932, 2022, 2151, 2492, 2804]",5806,6829,5907,3014,2804,48,46,129,45,86,"[60, 265, 546, 945, 1273, 1586, 1918, 2424, 2837, 3513, 4166, 4847, 5295, 6230, 7123]","[60, 354, 521, 819, 1233, 1745, 2316, 2964, 3623, 4191, 4939, 5875, 6525, 7060, 8161]","[328, 497, 727, 1005, 1419, 1583, 2025, 2492, 2711, 3251, 3821, 4274, 4798, 5062, 5972]","[60, 281, 407, 546, 636, 809, 899, 1137, 1467, 1902, 2123, 2712, 2926, 3021, 3476]","[60, 229, 357, 511, 925, 1015, 1274, 1438, 1748, 2011, 2413, 2877, 3100, 3343, 3606]",7123,8161,5972,3476,3606,-1317,-1332,-65,-462,-802,-3978,15,dire
7561360300,46,95,137,86,65,"[0, 245, 647, 1017, 1429, 1897, 2379, 2894, 3465, 4131, 5152, 5609, 5944, 6560, 6918]","[0, 208, 488, 851, 1014, 1313, 1603, 1898, 2245, 2659, 2957, 3334, 3622, 4011, 4555]","[0, 241, 458, 780, 1042, 1410, 1500, 2004, 2371, 2773, 3293, 3430, 4019, 4651, 4746]","[0, 170, 260, 397, 487, 750, 955, 1225, 1360, 1489, 1886, 2208, 2675, 2994, 3214]","[0, 170, 260, 397, 522, 713, 1033, 1421, 1686, 1877, 2057, 2184, 2932, 3408, 3503]",6918,4555,4746,3214,3503,82,106,96,105,20,"[0, 243, 559, 961, 1336, 1666, 2156, 2712, 3322, 3999, 4531, 5258, 5724, 6668, 7951]","[0, 242, 530, 815, 1072, 1369, 1657, 1898, 2265, 2699, 3333, 3814, 4180, 4690, 5311]","[0, 207, 494, 895, 1298, 1592, 2082, 2344, 3087, 3534, 4237, 4711, 5188, 5518, 6119]","[0, 170, 651, 741, 982, 1164, 1254, 1417, 1507, 1698, 2042, 2257, 2656, 3140, 3655]","[0, 214, 338, 496, 666, 822, 983, 1420, 1538, 1704, 2435, 2764, 3171, 3475, 3714]",7951,5311,6119,3655,3714,-1033,-756,-1373,-441,-211,-3814,15,dire
7561374708,98,70,120,58,21,"[0, 207, 375, 722, 1572, 2142, 2388, 2967, 3715, 4116, 4589, 5002, 5579, 6132, 6820]","[0, 247, 616, 982, 1461, 2126, 2687, 3278, 4083, 4541, 5358, 5883, 6439, 7018, 7530]","[0, 358, 580, 897, 1216, 1661, 2284, 2788, 3465, 4148, 4407, 5284, 5669, 6537, 7279]","[0, 170, 278, 368, 739, 1134, 1350, 1615, 2167, 2426, 2641, 3693, 4298, 4608, 4835]","[0, 204, 294, 384, 594, 854, 1023, 1271, 1665, 1845, 2035, 2272, 2362, 2824, 2918]",6820,7530,7279,4835,2918,106,11,88,97,100,"[0, 274, 634, 1084, 1482, 1936, 2227, 2877, 3127, 3535, 4427, 4989, 5408, 6011, 6762]","[0, 244, 627, 990, 1182, 1356, 1566, 2046, 2416, 2701, 3461, 3868, 4428, 5724, 6732]","[0, 170, 304, 473, 612, 747, 899, 1520, 1945, 2150, 2606, 2802, 2998, 3315, 4108]","[0, 241, 408, 722, 1128, 1338, 1631, 1755, 1890, 2142, 2389, 2758, 3132, 3449, 4210]","[0, 170, 280, 434, 559, 817, 986, 1094, 1712, 2082, 2419, 2615, 3043, 3757, 4200]",6762,6732,4108,4210,4200,58,798,3171,625,-1282,3370,15,dire
7561427818,95,13,23,66,65,"[207, 528, 761, 1154, 1503, 1955, 2369, 2703, 3125, 3498, 3999, 4361, 5345, 5961, 6497]","[279, 556, 851, 1233, 1735, 2022, 2611, 2896, 3322, 3735, 4224, 4672, 5689, 6284, 6667]","[170, 413, 619, 986, 1393, 1969, 2581, 2974, 3591, 4111, 4627, 5136, 5937, 6430, 6722]","[208, 314, 495, 742, 933, 1109, 1340, 1934, 2321, 2540, 2711, 2988, 3762, 4341, 4775]","[219, 343, 471, 761, 851, 1135, 1315, 1727, 1817, 1907, 1997, 2166, 3021, 3293, 3858]",6497,6667,6722,4775,3858,48,126,96,123,85,"[221, 449, 740, 1101, 1423, 1864, 2276, 2664, 3146, 3693, 4274, 4801, 5449, 6302, 6728]","[258, 650, 1028, 1568, 1727, 2288, 2663, 3012, 3845, 4269, 4872, 5267, 5565, 6108, 6278]","[259, 512, 842, 1326, 1576, 1735, 2064, 2365, 2936, 3446, 3930, 4564, 5122, 5622, 6171]","[170, 260, 403, 579, 714, 849, 976, 1066, 1248, 1383, 1562, 1652, 2019, 2664, 3067]","[170, 309, 399, 621, 711, 885, 975, 1076, 1253, 1635, 1829, 1985, 2177, 2918, 3299]",6728,6278,6171,3067,3299,-231,389,551,1708,559,2976,15,radiant
7561841307,80,39,129,45,20,"[0, 169, 412, 682, 998, 1353, 1973, 2311, 2607, 3615, 4171, 4636, 4975, 5626, 6243]","[0, 298, 569, 905, 1180, 1512, 1803, 2428, 2704, 2956, 3159, 3712, 4084, 4526, 4901]","[0, 278, 592, 920, 1096, 1575, 1927, 2423, 2905, 3232, 3659, 3957, 4207, 4485, 4860]","[0, 169, 259, 349, 439, 569, 659, 1107, 1197, 1582, 1904, 2094, 2234, 2383, 2948]","[0, 169, 298, 406, 531, 685, 822, 1168, 1258, 1403, 1732, 1822, 2058, 2273, 2548]",6243,4901,4860,2948,2548,10,106,137,21,136,"[0, 169, 334, 567, 1039, 1384, 1787, 2108, 2512, 3080, 3654, 4045, 4552, 5142, 5653]","[0, 278, 638, 889, 1305, 1604, 1953, 2170, 2551, 3153, 3380, 3590, 4307, 4985, 5421]","[0, 267, 720, 964, 1335, 1796, 2029, 2664, 3484, 4017, 4239, 4561, 5374, 5689, 5938]","[0, 501, 638, 778, 1193, 1323, 1511, 1822, 2032, 2465, 2854, 2979, 3355, 3647, 3954]","[0, 233, 429, 749, 872, 1002, 1092, 1354, 1513, 1859, 2326, 2416, 2797, 3343, 3564]",5653,5421,5938,3954,3564,590,-520,-1078,-1006,-1016,-3030,15,dire
7561842010,120,21,28,79,85,"[60, 379, 807, 1057, 1473, 1841, 2180, 2440, 2723, 3181, 3713, 4317, 4569, 4757, 5268]","[60, 394, 623, 1157, 1499, 1828, 2223, 2559, 2958, 3564, 4177, 4722, 4972, 5140, 5516]","[60, 384, 674, 958, 1382, 2111, 2729, 3135, 3575, 4119, 4812, 5318, 5510, 5876, 6573]","[328, 537, 627, 717, 967, 1160, 1315, 1453, 1659, 1913, 2479, 2623, 2915, 3513, 4070]","[60, 269, 406, 680, 987, 1117, 1254, 1426, 1572, 1796, 2379, 2523, 2743, 2933, 3516]",5268,5516,6573,4070,3516,12,39,96,27,112,"[0, 168, 452, 822, 1216, 1486, 1670, 1880, 2090, 2413, 2886, 3257, 4525, 4934, 5531]","[0, 202, 436, 724, 1042, 1458, 1791, 2149, 2797, 3058, 3628, 4537, 4999, 5655, 6132]","[0, 205, 452, 724, 1222, 1431, 1782, 2327, 2818, 3368, 3692, 4036, 4742, 5118, 5849]","[0, 129, 219, 362, 709, 848, 982, 1072, 1492, 1701, 2121, 2477, 3049, 3921, 4127]","[0, 129, 219, 309, 490, 580, 1002, 1186, 1370, 1579, 1849, 2141, 2570, 2725, 2986]",5531,6132,5849,4127,2986,-263,-616,724,-57,530,318,15,dire
7561960102,82,7,14,123,20,"[0, 245, 554, 716, 888, 1221, 1709, 2070, 2865, 3130, 4064, 4987, 5596, 6231, 6996]","[0, 250, 509, 922, 1288, 1783, 2154, 2933, 3361, 4023, 4764, 5238, 5837, 6592, 6925]","[0, 209, 518, 946, 1544, 1759, 2679, 3029, 3949, 4590, 5369, 5677, 6320, 6697, 6944]","[0, 209, 329, 505, 682, 772, 1138, 1350, 1670, 1883, 2333, 2564, 2654, 3051, 3489]","[0, 272, 392, 482, 592, 725, 907, 1036, 1406, 1589, 1932, 2163, 2592, 2805, 3574]",6996,6925,6944,3489,3574,48,61,129,91,121,"[0, 238, 436, 910, 1319, 2123, 2419, 2781, 3083, 3441, 4151, 4647, 5191, 5955, 6456]","[0, 332, 618, 951, 1193, 1635, 2052, 2489, 3051, 3495, 3940, 4168, 4649, 5059, 5549]","[0, 245, 369, 693, 1076, 1407, 1859, 2205, 2663, 3191, 3646, 4110, 4411, 4640, 5335]","[0, 170, 260, 350, 440, 661, 797, 887, 977, 1350, 1636, 1813, 2058, 2572, 2670]","[0, 213, 303, 955, 1139, 1602, 1898, 1988, 2159, 2586, 2766, 2856, 3067, 3367, 3462]",6456,5549,5335,2670,3462,540,1376,1609,819,112,4456,15,dire
7562239303,21,69,43,20,26,"[0, 255, 646, 970, 1461, 1783, 2327, 2603, 3330, 3695, 4253, 4825, 5624, 6212, 6410]","[0, 243, 528, 687, 1242, 1556, 2045, 2396, 2700, 3184, 3789, 4142, 4677, 5521, 5909]","[0, 279, 556, 968, 1272, 1640, 2061, 2479, 3031, 3398, 4161, 5015, 5420, 6156, 6523]","[0, 170, 260, 475, 647, 1031, 1166, 1514, 1744, 1834, 2059, 2359, 2449, 2712, 2807]","[0, 170, 363, 524, 661, 859, 994, 1165, 1300, 1436, 1739, 1967, 2248, 2396, 2491]",6410,5909,6523,2807,2491,18,98,23,53,121,"[0, 568, 934, 1374, 1713, 2357, 2683, 3192, 3724, 4373, 4828, 5904, 6358, 6902, 7852]","[0, 195, 355, 756, 923, 1136, 1613, 2008, 2224, 2669, 3133, 3665, 3920, 4440, 5074]","[0, 346, 618, 782, 1117, 1319, 1914, 2049, 2287, 2737, 3008, 3276, 3755, 4345, 4883]","[0, 263, 353, 708, 798, 1093, 1264, 1399, 1535, 1625, 1932, 2218, 2586, 2834, 3289]","[0, 263, 371, 581, 716, 1055, 1226, 1377, 1518, 1608, 1758, 2235, 2494, 2853, 3256]",7852,5074,4883,3289,3256,-1442,835,1640,-482,-765,-214,15,radiant
7562391407,46,8,49,9,20,"[0, 329, 772, 1269, 1719, 2185, 2735, 3079, 3655, 4170, 4696, 5354, 6141, 6721, 7660]","[0, 278, 526, 862, 1110, 1342, 1591, 1934, 2272, 2666, 3221, 3413, 3921, 4469, 5135]","[0, 169, 492, 678, 1020, 1216, 1639, 1826, 2203, 2449, 2871, 3275, 3589, 4021, 4266]","[0, 169, 316, 445, 818, 947, 1210, 1588, 1678, 1908, 2167, 2597, 2930, 3131, 3376]","[0, 169, 259, 349, 478, 568, 704, 794, 920, 1100, 1317, 1442, 1532, 1752, 2012]",7660,5135,4266,3376,2012,23,44,14,110,40,"[0, 334, 700, 1202, 1554, 2067, 2609, 3189, 3860, 4314, 5263, 6011, 6834, 7643, 8132]","[0, 256, 437, 1178, 1516, 1787, 2143, 2481, 2900, 3282, 3684, 4187, 4863, 5396, 6093]","[0, 242, 477, 744, 1088, 1502, 1795, 2320, 2654, 3032, 3434, 4001, 4593, 5048, 5235]","[0, 204, 328, 418, 508, 661, 1038, 1219, 1346, 1436, 1868, 2125, 2668, 3234, 3697]","[0, 169, 259, 576, 666, 814, 964, 1161, 1661, 1797, 1934, 2294, 2690, 3008, 3521]",8132,6093,5235,3697,3521,-472,-958,-969,-321,-1509,-4229,15,dire
7562405918,137,93,13,86,105,"[1708, 2072, 2443, 2865, 3167, 3515, 4041, 5089, 5909, 6348, 7277, 7725, 8635, 9419, 9879]","[1566, 1976, 2593, 2932, 3463, 3994, 4494, 5185, 5799, 6447, 7112, 7679, 8199, 9165, 9516]","[2168, 2771, 3116, 3589, 3977, 4379, 4857, 5726, 6164, 6877, 7817, 8098, 8713, 9228, 9795]","[951, 1086, 1221, 1358, 1715, 2060, 2370, 2972, 3148, 3436, 3983, 4782, 5071, 5920, 6215]","[1179, 1360, 1604, 1694, 1987, 2125, 2258, 2536, 2784, 3123, 3655, 4170, 5102, 5588, 6100]",9879,9516,9795,6215,6100,39,106,97,110,51,"[2083, 2222, 2604, 2830, 3253, 3731, 4226, 4568, 4968, 5462, 6663, 7246, 7547, 8383, 8758]","[1883, 2173, 2506, 3116, 3601, 3958, 4524, 4722, 5039, 5518, 6139, 6363, 6458, 6756, 7190]","[1778, 1975, 2227, 2471, 2774, 3201, 3569, 4359, 4975, 5277, 5794, 6243, 6801, 7077, 7260]","[968, 1058, 1148, 1238, 1373, 1492, 1601, 1954, 2193, 2449, 3109, 3243, 3360, 3924, 4289]","[708, 798, 888, 1346, 1563, 1653, 1743, 1941, 2111, 2206, 2913, 3174, 3439, 3534, 3628]",8758,7190,7260,4289,3628,1121,2326,2535,1926,2472,10380,15,radiant
7562445719,82,120,112,71,20,"[1031, 1363, 1751, 2463, 2553, 3286, 3624, 4227, 4537, 4982, 5239, 5706, 6149, 6777, 7563]","[1010, 1390, 1677, 2197, 2542, 2958, 3168, 3430, 3669, 4337, 4856, 5208, 5641, 6238, 6544]","[870, 1080, 1238, 1475, 1783, 2047, 2264, 2563, 2957, 3317, 4054, 4566, 4661, 4805, 5068]","[490, 667, 791, 1211, 1457, 1999, 2173, 2310, 2594, 2887, 3296, 3391, 3754, 4327, 4819]","[440, 624, 714, 1086, 1448, 1787, 2059, 2206, 2296, 2587, 2681, 2786, 2881, 3166, 3260]",7563,6544,5068,4819,3260,10,106,97,62,123,"[1753, 2229, 2788, 3326, 3581, 4451, 5294, 5915, 6536, 7294, 8090, 8715, 9514, 10467, 11336]","[1475, 1899, 2641, 2979, 3392, 4325, 5067, 5585, 6782, 7389, 8029, 8818, 9577, 10007, 11066]","[1276, 1798, 2388, 2641, 3019, 3487, 3991, 4530, 5381, 5830, 6343, 6609, 7127, 7785, 8535]","[721, 884, 1364, 1523, 1613, 1929, 2511, 2788, 4229, 4637, 5046, 5754, 6212, 6826, 7870]","[582, 747, 947, 1082, 1550, 1711, 2195, 2342, 2757, 3261, 3616, 3845, 4472, 5088, 5676]",11336,11066,8535,7870,5676,-3773,-4522,-3467,-3051,-2416,-17229,15,dire
7562523900,48,19,14,21,20,"[0, 281, 525, 913, 1224, 1481, 1738, 2068, 2473, 2840, 3233, 3637, 4140, 4681, 5417]","[0, 290, 574, 792, 1259, 1832, 2163, 2591, 3106, 3569, 4154, 4667, 5189, 5307, 5860]","[0, 170, 386, 550, 973, 1371, 1813, 2277, 2578, 2872, 3255, 3555, 4001, 4424, 5081]","[0, 213, 377, 519, 729, 953, 1125, 1306, 1562, 1652, 1939, 2284, 2422, 2724, 3893]","[0, 170, 260, 618, 788, 970, 1124, 1259, 1535, 1625, 1774, 1903, 2077, 2255, 2771]",5417,5860,5081,3893,2771,109,74,61,86,100,"[0, 586, 781, 1011, 1860, 2213, 2593, 2882, 3337, 3954, 4751, 5266, 5979, 6698, 6991]","[0, 325, 659, 1081, 1668, 2042, 2497, 2917, 3651, 3905, 4272, 5017, 5653, 6425, 6856]","[0, 209, 548, 767, 1367, 1790, 2214, 2697, 3126, 4109, 4621, 5448, 6001, 6708, 7072]","[0, 245, 360, 450, 674, 809, 899, 989, 1263, 1462, 1773, 1973, 2188, 2624, 3114]","[0, 170, 260, 395, 932, 1071, 1161, 1335, 1425, 1691, 2177, 2518, 2777, 3032, 3127]",6991,6856,7072,3114,3127,-1574,-996,-1991,779,-356,-4138,15,radiant
7562563601,89,13,97,66,119,"[646, 906, 1263, 1557, 2178, 2660, 3090, 3565, 4345, 5043, 5743, 6583, 7075, 7483, 8027]","[489, 613, 703, 924, 1305, 2198, 2619, 2709, 3173, 3434, 3923, 4310, 4881, 5474, 6212]","[505, 943, 1566, 1811, 2217, 2679, 3257, 3347, 3764, 4046, 4721, 5383, 5940, 6245, 7076]","[285, 524, 633, 882, 1256, 1902, 2170, 2312, 2638, 2969, 3144, 3656, 3932, 4145, 4512]","[260, 350, 607, 697, 952, 1253, 1445, 1535, 1900, 1990, 2433, 2618, 2713, 2834, 3106]",8027,6212,7076,4512,3106,113,14,112,123,136,"[946, 1400, 1737, 1947, 2461, 3101, 3315, 4182, 5125, 5640, 6297, 6991, 7269, 8161, 8874]","[946, 1420, 1692, 2305, 2792, 3244, 3555, 4387, 5058, 5569, 5988, 7212, 7678, 8417, 8943]","[483, 653, 1007, 1431, 1538, 2003, 2441, 2788, 3159, 3547, 3776, 4264, 4545, 5346, 5780]","[519, 697, 916, 1163, 1298, 1456, 1587, 2159, 2415, 2559, 2777, 3402, 3721, 4047, 4274]","[415, 553, 911, 1001, 1091, 1249, 1367, 1657, 2094, 2238, 2592, 2831, 3304, 3533, 3760]",8874,8943,5780,4274,3760,-847,-2731,1296,238,-654,-2698,15,radiant
7562655919,106,82,43,114,90,"[0, 294, 733, 1215, 1713, 1970, 2391, 2833, 3400, 3922, 4436, 5039, 5867, 6723, 7261]","[0, 283, 568, 932, 1297, 1423, 1768, 1936, 2133, 2361, 2847, 3194, 3535, 4181, 4697]","[0, 175, 375, 715, 1084, 1555, 2136, 2421, 2903, 3403, 4120, 4512, 4816, 5173, 5405]","[0, 172, 695, 820, 1001, 1182, 1461, 1648, 1859, 2125, 2539, 3013, 3425, 3757, 3993]","[0, 216, 383, 553, 726, 903, 1085, 1221, 1546, 1636, 2348, 2639, 3077, 3262, 3535]",7261,4697,5405,3993,3535,4,60,25,86,37,"[0, 237, 671, 952, 1322, 1534, 1821, 2025, 2252, 2616, 3203, 3579, 4097, 4621, 4984]","[0, 241, 488, 953, 1154, 1603, 1764, 2693, 3183, 3795, 4407, 5137, 5367, 6143, 6875]","[0, 365, 844, 1146, 1599, 2115, 2776, 3179, 3720, 4268, 4883, 5505, 6033, 6491, 7094]","[0, 169, 259, 617, 747, 1008, 1145, 1527, 1699, 2124, 2632, 2949, 3347, 3768, 4348]","[0, 169, 418, 572, 702, 945, 1084, 1432, 1691, 2044, 2269, 3146, 3465, 3614, 3888]",4984,6875,7094,4348,3888,2277,-2178,-1689,-355,-353,-2298,15,radiant
7562744702,129,97,59,121,123,"[816, 1191, 1595, 1769, 2043, 2593, 2954, 3240, 3543, 4056, 4584, 5140, 5496, 5846, 6231]","[503, 793, 1201, 1798, 2160, 2538, 2969, 3360, 3934, 4256, 4508, 4903, 4998, 5252, 5572]","[620, 909, 1230, 1718, 1923, 2258, 2756, 3005, 3353, 3626, 4453, 4548, 5097, 5192, 5389]","[352, 565, 720, 846, 936, 1071, 1161, 1299, 1434, 1524, 1674, 1939, 2265, 2360, 2454]","[260, 350, 484, 701, 791, 926, 1132, 1549, 1684, 1774, 1961, 2056, 2485, 2580, 2674]",6231,5572,5389,2454,2674,73,98,39,9,19,"[859, 1124, 1849, 2276, 2631, 3134, 3669, 4261, 4858, 6169, 7067, 8357, 8722, 10037, 11504]","[468, 721, 1350, 1758, 2218, 2651, 2942, 3483, 4317, 4832, 5808, 6793, 7449, 8131, 8965]","[434, 657, 872, 1223, 1455, 1791, 2387, 3031, 3623, 4145, 4737, 5347, 6028, 6605, 7466]","[828, 970, 1240, 1422, 1512, 1836, 2173, 2523, 2794, 3118, 3554, 4098, 4720, 5000, 5511]","[333, 470, 712, 1019, 1156, 1291, 1505, 1743, 2113, 2441, 2936, 3299, 3677, 3967, 4379]",11504,8965,7466,5511,4379,-5273,-3393,-2077,-3057,-1705,-15505,15,dire
7563208314,39,21,49,19,20,"[0, 280, 480, 730, 1130, 1405, 1604, 2021, 2797, 3084, 3511, 3929, 4509, 4986, 5411]","[0, 208, 409, 788, 1143, 1395, 2298, 2766, 3189, 3679, 4083, 4566, 5076, 5624, 6431]","[0, 242, 527, 818, 1020, 1595, 1842, 2458, 2680, 3100, 3609, 4106, 4556, 5156, 6223]","[0, 221, 311, 665, 785, 910, 1000, 1135, 1338, 1563, 1923, 2256, 2436, 2630, 2725]","[0, 170, 260, 575, 754, 879, 1065, 1264, 1369, 1459, 1682, 1865, 2089, 2432, 3134]",5411,6431,6223,2725,3134,48,43,129,105,119,"[0, 170, 455, 853, 1232, 1466, 1696, 1964, 2235, 2841, 3431, 3839, 4586, 5451, 6251]","[0, 696, 954, 1341, 1620, 1877, 2367, 2694, 3012, 3633, 3944, 4287, 4700, 5535, 5924]","[0, 232, 562, 795, 1127, 1433, 1658, 1837, 2169, 2577, 3323, 3570, 4264, 4843, 5434]","[0, 232, 322, 456, 586, 716, 1025, 1206, 1315, 1685, 2016, 2106, 2349, 2646, 3022]","[0, 232, 521, 611, 886, 1225, 1315, 1450, 1625, 1805, 2060, 2238, 2645, 3328, 3680]",6251,5924,5434,3022,3680,-840,507,789,-297,-546,-387,15,radiant
7563295705,73,49,106,123,121,"[0, 354, 960, 1395, 1672, 1967, 2290, 2502, 2795, 3182, 3702, 4449, 5158, 5793, 6991]","[0, 199, 631, 911, 1146, 1505, 2028, 2253, 2964, 3424, 4191, 4837, 5196, 5694, 6585]","[0, 175, 457, 749, 996, 1208, 1435, 1690, 1993, 2287, 2790, 3323, 3462, 3973, 4744]","[0, 129, 553, 744, 834, 924, 1187, 1312, 1576, 1762, 1942, 2345, 2530, 2658, 3199]","[0, 247, 481, 633, 801, 1013, 1103, 1193, 1455, 1860, 2040, 2295, 2545, 2774, 3170]",6991,6585,4744,3199,3170,98,33,25,100,51,"[0, 336, 781, 1155, 1687, 2303, 2850, 3523, 4197, 4379, 4854, 5314, 5729, 6555, 6931]","[0, 243, 493, 809, 1175, 1705, 2009, 2602, 3582, 4283, 4939, 5729, 6084, 6591, 7148]","[0, 295, 633, 797, 1170, 1358, 1483, 1950, 2379, 2659, 3079, 3490, 4180, 4660, 5213]","[0, 209, 334, 424, 554, 779, 958, 1164, 1471, 1719, 1899, 2133, 2304, 2584, 2754]","[0, 209, 299, 389, 519, 731, 821, 1405, 1680, 1804, 1984, 2248, 2389, 2659, 2819]",6931,7148,5213,2754,2819,60,-563,-469,445,351,-176,15,radiant
7563784607,76,48,71,14,45,"[0, 242, 717, 1084, 1532, 1818, 2360, 2766, 3158, 3898, 4343, 5372, 5855, 6990, 7540]","[0, 293, 606, 968, 1129, 1690, 1780, 2023, 2534, 2962, 3321, 3872, 4312, 5113, 5750]","[0, 170, 290, 426, 600, 818, 908, 1065, 1305, 1469, 1643, 2173, 2347, 2786, 3102]","[0, 170, 401, 612, 1058, 1332, 1813, 1999, 2320, 2644, 2993, 3285, 3522, 4000, 4365]","[0, 170, 374, 464, 764, 1352, 1538, 1991, 2423, 2719, 3077, 4007, 4097, 4402, 4747]",7540,5750,3102,4365,4747,25,39,49,64,121,"[0, 256, 820, 1070, 1650, 2171, 2535, 3340, 3928, 4573, 5153, 5709, 6252, 7053, 7755]","[0, 280, 568, 884, 1093, 1409, 1736, 2176, 2469, 2785, 3140, 3320, 4202, 4628, 5062]","[0, 244, 566, 887, 1381, 1926, 2384, 2854, 3431, 3954, 4462, 4933, 5844, 6467, 7477]","[0, 170, 260, 350, 534, 713, 852, 1113, 1287, 1425, 1625, 1984, 2509, 2914, 3742]","[0, 170, 501, 591, 851, 1134, 1389, 1666, 1852, 1942, 2121, 2338, 2632, 2893, 3335]",7755,5062,7477,3742,3335,-215,688,-4375,623,1412,-1867,15,dire
7563797619,48,104,80,53,26,"[0, 242, 476, 962, 1127, 1555, 1918, 2440, 2888, 3507, 4034, 5074, 5847, 6736, 7326]","[0, 214, 386, 797, 1095, 1414, 1962, 2172, 2762, 3524, 3695, 4404, 4797, 5053, 5209]","[0, 310, 523, 975, 1386, 1722, 2279, 2637, 2815, 2944, 3245, 3643, 3823, 4011, 4219]","[0, 169, 295, 422, 561, 805, 1010, 1461, 1639, 1775, 1890, 2203, 2848, 2997, 3371]","[0, 169, 414, 504, 594, 748, 961, 1186, 1305, 1610, 1746, 1976, 2302, 2451, 2607]",7326,5209,4219,3371,2607,46,120,71,14,85,"[0, 203, 615, 997, 1316, 1595, 1685, 2416, 2992, 3309, 4010, 4461, 5311, 6326, 6881]","[0, 273, 598, 894, 1161, 1487, 1959, 2306, 2801, 3628, 4274, 4721, 5529, 6488, 6997]","[0, 204, 475, 763, 988, 1337, 1948, 2658, 3110, 3571, 4305, 4851, 5631, 6053, 6559]","[0, 169, 306, 505, 643, 773, 1055, 1656, 1951, 2131, 2915, 3095, 3615, 3868, 3963]","[0, 169, 259, 404, 536, 666, 849, 1139, 1689, 1869, 2386, 2566, 2656, 2980, 3075]",6881,6997,6559,3963,3075,445,-1788,-2340,-592,-468,-4743,15,dire
7563837503,78,10,106,105,51,"[0, 170, 575, 921, 1120, 1565, 1990, 2534, 3020, 3514, 3982, 4786, 5362, 5925, 6392]","[0, 170, 373, 576, 942, 1187, 1593, 2092, 2354, 2644, 3174, 3675, 4456, 4975, 5564]","[0, 329, 609, 1057, 1432, 1760, 2072, 2562, 3009, 3733, 4159, 4721, 5385, 5702, 6130]","[0, 170, 260, 386, 476, 566, 700, 934, 1071, 1161, 1399, 1673, 2035, 2183, 2519]","[0, 221, 311, 401, 591, 727, 867, 1099, 1189, 1423, 2016, 2262, 2544, 3050, 3206]",6392,5564,6130,2519,3206,1,120,129,86,26,"[0, 207, 507, 851, 1485, 1679, 1880, 2253, 2387, 2809, 3007, 3285, 3595, 4395, 4967]","[0, 282, 518, 897, 1307, 1790, 2188, 2392, 2866, 3117, 3651, 4049, 5043, 5602, 6293]","[0, 324, 599, 918, 1443, 1870, 2254, 2561, 2889, 3306, 3617, 3965, 4407, 5004, 5622]","[0, 220, 384, 480, 627, 830, 920, 1113, 1546, 1664, 1894, 2104, 2336, 2518, 2710]","[0, 170, 285, 419, 590, 945, 1083, 1218, 1308, 1457, 1636, 1726, 2563, 2657, 2854]",4967,6293,5622,2710,2854,1425,-729,508,-191,352,1365,15,radiant
7564035105,53,41,69,126,71,"[0, 259, 471, 818, 1535, 1898, 2363, 2798, 3150, 3880, 4220, 4810, 5476, 6163, 6508]","[0, 205, 438, 802, 1133, 1335, 1539, 1776, 2064, 2368, 2620, 3235, 3995, 4390, 4560]","[0, 170, 324, 454, 763, 940, 1583, 1713, 2040, 2381, 2557, 3115, 3385, 3654, 3820]","[0, 238, 493, 934, 1152, 1483, 1645, 1859, 2501, 3230, 3477, 3709, 4096, 4244, 4514]","[0, 170, 260, 417, 587, 696, 1134, 1224, 1420, 1684, 1859, 2091, 2492, 2677, 2772]",6508,4560,3820,4514,2772,25,129,62,119,51,"[0, 214, 507, 791, 919, 1136, 1357, 1802, 2044, 2675, 3205, 3556, 4243, 4920, 5745]","[0, 279, 577, 857, 1229, 1832, 2191, 2678, 3095, 3396, 3913, 4335, 4821, 5335, 5773]","[0, 289, 592, 907, 1336, 1669, 1997, 2462, 2938, 3681, 4539, 4675, 4995, 5708, 5904]","[0, 170, 298, 409, 545, 635, 1013, 1193, 1283, 1655, 2221, 2357, 2863, 3278, 3373]","[0, 170, 268, 443, 533, 667, 765, 945, 1120, 1496, 1859, 2346, 2934, 3082, 3177]",5745,5773,5904,3373,3177,763,-1213,-2084,1141,-405,-1798,15,dire
7564044018,48,104,138,74,136,"[0, 282, 557, 843, 1390, 1768, 2273, 2723, 3487, 3763, 4266, 5069, 5745, 6452, 7386]","[0, 247, 524, 921, 1309, 1774, 2203, 2512, 3244, 3858, 4373, 5399, 6034, 6360, 7069]","[0, 209, 514, 621, 866, 1004, 1193, 1351, 1531, 1690, 2016, 2373, 2598, 3065, 3598]","[0, 322, 484, 863, 1113, 1455, 1703, 2203, 2652, 2868, 3101, 3681, 3983, 4558, 5086]","[0, 209, 299, 421, 624, 748, 991, 1081, 1434, 1593, 1849, 2049, 2229, 2506, 2810]",7386,7069,3598,5086,2810,106,69,93,26,40,"[0, 286, 646, 999, 1443, 1895, 2327, 2864, 3246, 3457, 4412, 4575, 5263, 5616, 5890]","[0, 202, 641, 913, 1386, 1633, 2012, 2364, 2828, 3352, 3969, 4249, 4922, 5354, 5684]","[0, 513, 710, 836, 1090, 1388, 1770, 2103, 2457, 2645, 3121, 3487, 3908, 4466, 5125]","[0, 129, 293, 656, 845, 935, 1340, 1475, 1676, 1813, 2734, 2824, 3013, 3198, 3475]","[0, 210, 300, 390, 480, 570, 670, 805, 1006, 1289, 1497, 1809, 1953, 2138, 2333]",5890,5684,5125,3475,2333,1496,1385,-1527,1611,477,3442,15,radiant
7564244018,41,13,49,110,26,"[0, 241, 557, 832, 1127, 1446, 1790, 2329, 2809, 3172, 3611, 4255, 4591, 5048, 5600]","[0, 165, 522, 893, 1312, 1758, 2052, 2723, 3052, 3597, 3955, 5097, 5542, 6095, 6557]","[0, 204, 455, 695, 981, 1202, 1482, 2092, 2450, 3121, 3601, 4169, 4582, 5119, 5548]","[0, 130, 265, 426, 574, 1097, 1235, 1460, 1814, 1942, 2077, 2425, 2672, 2916, 3011]","[0, 130, 272, 406, 583, 673, 1031, 1256, 1476, 1566, 1801, 2103, 2365, 2482, 2577]",5600,6557,5548,3011,2577,73,17,96,128,45,"[0, 408, 701, 1056, 1494, 1996, 2249, 2718, 3109, 3651, 4500, 4930, 5874, 6942, 7740]","[0, 411, 783, 1197, 1638, 1960, 2394, 2755, 3282, 3627, 4211, 4509, 5134, 5577, 6305]","[0, 248, 541, 897, 1269, 1359, 1767, 2139, 2599, 2886, 3438, 3967, 4838, 5513, 6173]","[0, 210, 339, 459, 585, 917, 1007, 1132, 1539, 1752, 2159, 2287, 3048, 3601, 3869]","[0, 210, 319, 485, 624, 952, 1068, 1193, 1397, 1608, 2030, 2369, 2597, 2799, 3255]",7740,6305,6173,3869,3255,-2140,252,-625,-858,-678,-4049,15,dire
7564643705,120,93,28,123,20,"[0, 278, 611, 947, 1310, 1721, 2370, 3268, 3805, 4194, 5377, 5945, 6521, 7550, 8091]","[0, 170, 423, 750, 951, 1123, 1322, 1761, 1928, 2353, 2818, 3259, 3686, 4335, 4852]","[0, 254, 495, 842, 1175, 1380, 1935, 2516, 2671, 3191, 3775, 4326, 5128, 5843, 6095]","[0, 170, 305, 440, 530, 620, 1167, 1918, 2230, 2647, 3060, 3397, 3577, 4396, 4845]","[0, 170, 260, 404, 576, 691, 864, 1338, 1635, 1770, 2094, 2300, 2495, 3015, 3295]",8091,4852,6095,4845,3295,10,17,96,100,86,"[0, 204, 477, 796, 960, 1339, 1593, 1997, 2376, 2601, 3037, 3551, 4014, 4446, 5085]","[0, 365, 742, 1025, 1307, 1724, 2265, 2743, 3236, 3494, 4131, 4825, 4997, 5355, 5918]","[0, 206, 444, 601, 887, 1296, 1824, 2194, 2831, 3216, 3351, 3867, 4488, 5186, 6322]","[0, 170, 260, 396, 531, 661, 1230, 1320, 1533, 1803, 2022, 2271, 2440, 2625, 3237]","[0, 170, 307, 466, 637, 767, 970, 1060, 1249, 1374, 1668, 2070, 2205, 2390, 2834]",5085,5918,6322,3237,2834,3006,-1066,-227,1608,461,3782,15,radiant
7564980905,98,106,102,123,20,"[331, 570, 696, 1148, 1617, 2034, 2367, 3285, 4013, 4579, 5347, 5847, 6627, 7385, 8379]","[63, 347, 720, 1126, 1544, 1959, 2296, 2747, 3285, 3926, 4545, 5154, 6098, 6794, 7117]","[63, 268, 494, 795, 1169, 1498, 2004, 2409, 2799, 3357, 3685, 4592, 5241, 5829, 6525]","[63, 233, 323, 461, 634, 1592, 1682, 1939, 2223, 2754, 3231, 3655, 3835, 4543, 4691]","[63, 233, 622, 846, 1057, 1482, 2034, 2302, 2811, 3134, 3386, 3603, 3951, 4340, 4615]",8379,7117,6525,4691,4615,40,4,23,136,53,"[0, 281, 371, 677, 1145, 1470, 1763, 2308, 2803, 3284, 3820, 4358, 4873, 5155, 5544]","[0, 247, 648, 943, 1272, 1637, 1901, 2226, 2616, 3099, 3505, 3936, 4255, 4581, 5111]","[0, 288, 569, 888, 1215, 1544, 2052, 2428, 2821, 2911, 3545, 3897, 4294, 4622, 5195]","[0, 170, 297, 412, 824, 1107, 1553, 1711, 2305, 2834, 3063, 3440, 3620, 4053, 4434]","[0, 432, 522, 660, 876, 1052, 1226, 1361, 1786, 2318, 2498, 2829, 3666, 3797, 4036]",5544,5111,5195,4434,4036,2835,2006,1330,257,579,7007,15,radiant
7565176702,53,120,40,97,30,"[0, 580, 707, 1055, 1307, 1731, 1840, 2047, 2930, 3236, 4256, 4513, 5191, 5796, 6473]","[0, 346, 616, 867, 1125, 1493, 1687, 2625, 2879, 3231, 3700, 3790, 4192, 4716, 5235]","[0, 192, 492, 661, 924, 1435, 1666, 1801, 2228, 2415, 2706, 2796, 3126, 3429, 3907]","[0, 192, 331, 459, 753, 1097, 1561, 1977, 2155, 2436, 2862, 3036, 3409, 3794, 4181]","[0, 292, 434, 568, 816, 1353, 1566, 1701, 1963, 2232, 2585, 2675, 2765, 2914, 3387]",6473,5235,3907,4181,3387,98,41,69,123,79,"[0, 368, 680, 1004, 1364, 1785, 2200, 2445, 3261, 3490, 4335, 5365, 5597, 6525, 7095]","[0, 247, 495, 700, 996, 1533, 1817, 2322, 2630, 3292, 3747, 4510, 4872, 5169, 5581]","[0, 210, 492, 686, 971, 1147, 1556, 2019, 2163, 2786, 3212, 3606, 3877, 4348, 4607]","[0, 210, 300, 425, 563, 728, 938, 1131, 1221, 1472, 1699, 2201, 2345, 2549, 2730]","[0, 210, 300, 390, 480, 659, 749, 839, 1145, 1539, 1674, 2017, 2213, 2483, 2835]",7095,5581,4607,2730,2835,-622,-346,-700,1451,552,335,15,radiant
7565218900,53,137,112,26,106,"[577, 1018, 1299, 1840, 2404, 2531, 2870, 3393, 4276, 4777, 5528, 6013, 6801, 7707, 8760]","[239, 482, 699, 982, 1386, 1686, 2166, 2675, 3573, 3802, 4586, 4948, 5332, 6174, 6918]","[280, 579, 900, 1233, 1360, 1749, 2073, 2604, 3095, 3290, 3603, 4026, 4488, 4891, 5516]","[228, 376, 466, 661, 878, 1012, 1295, 1470, 1752, 2290, 2438, 2743, 2986, 3330, 3783]","[264, 388, 478, 657, 765, 855, 1233, 1404, 1808, 2019, 2212, 2501, 2918, 3368, 3518]",8760,6918,5516,3783,3518,69,7,95,31,72,"[243, 482, 884, 1060, 1261, 1666, 2366, 2577, 2925, 3230, 3356, 3963, 4607, 4822, 5185]","[213, 423, 833, 1110, 1366, 1736, 2082, 2523, 2824, 3056, 3388, 3784, 4109, 4494, 4793]","[276, 671, 894, 1234, 1564, 1778, 2042, 2258, 2651, 3078, 3289, 3672, 4012, 4183, 4407]","[169, 259, 478, 607, 856, 990, 1170, 1305, 1484, 1807, 2196, 2436, 2734, 2829, 2923]","[169, 259, 349, 487, 625, 952, 1257, 1522, 1866, 2001, 2140, 2230, 2379, 2515, 2609]",5185,4793,4407,2923,2609,3575,2125,1109,860,909,8578,15,radiant
7565263812,93,82,97,123,86,"[1556, 2043, 2622, 3162, 3596, 4218, 5005, 5393, 5483, 5935, 6225, 6373, 7023, 8192, 8666]","[794, 1239, 1444, 2126, 2434, 2690, 3419, 4029, 4508, 4906, 5280, 6859, 7668, 7998, 8763]","[1188, 1541, 1927, 2537, 2983, 3669, 4028, 4154, 4736, 5090, 5285, 5641, 6051, 6603, 6883]","[1047, 1568, 1704, 1839, 1964, 2220, 2490, 2816, 2953, 3222, 3317, 3674, 3832, 4252, 4347]","[597, 842, 1039, 1247, 1383, 1776, 2183, 2452, 2786, 3024, 3286, 3890, 4186, 4516, 4611]",8666,8763,6883,4347,4611,41,78,114,26,20,"[1176, 1452, 1710, 2426, 2727, 3530, 4104, 4551, 5462, 6613, 7012, 7710, 8322, 8590, 9094]","[1110, 1240, 1558, 1841, 2355, 2648, 3030, 3464, 3933, 4396, 5012, 5405, 6284, 7576, 8551]","[1818, 2121, 2627, 2997, 3631, 3893, 4535, 4995, 5670, 6632, 7623, 8031, 8616, 9633, 10467]","[989, 1157, 1392, 1581, 1992, 2704, 2928, 3206, 3564, 4017, 4423, 4784, 5031, 5771, 5956]","[591, 763, 899, 1181, 1611, 2025, 2211, 2301, 2596, 3135, 3320, 3664, 4028, 4592, 4827]",9094,8551,10467,5956,4827,-428,212,-3584,-1609,-216,-5625,15,dire
7565351207,25,13,135,136,20,"[0, 253, 399, 771, 1373, 1751, 2535, 2888, 3215, 4063, 4731, 5127, 5770, 6474, 7245]","[0, 328, 698, 940, 1217, 1554, 1875, 2564, 3034, 3758, 4227, 4335, 5025, 5872, 6351]","[0, 290, 595, 851, 1293, 1655, 1890, 2265, 2700, 2945, 3496, 4068, 4365, 5180, 5904]","[0, 170, 260, 752, 996, 1248, 1482, 1798, 1888, 2085, 2464, 2593, 3060, 3379, 3801]","[0, 170, 260, 350, 525, 660, 777, 956, 1117, 1314, 1493, 1583, 1912, 2245, 2600]",7245,6351,5904,3801,2600,41,129,120,58,105,"[0, 207, 499, 709, 913, 1442, 1953, 2490, 2839, 3286, 3892, 4183, 5067, 5638, 6302]","[0, 206, 548, 906, 1355, 1611, 1775, 2598, 3276, 3596, 4128, 4795, 5436, 6189, 6801]","[0, 289, 589, 788, 1243, 1624, 2070, 2518, 2936, 3159, 3735, 4340, 4675, 4871, 5226]","[0, 170, 260, 350, 440, 836, 971, 1515, 1760, 2004, 2350, 2558, 3010, 3223, 3437]","[0, 170, 260, 437, 576, 706, 841, 1278, 1458, 1675, 2294, 2664, 2844, 3170, 3390]",6302,6801,5226,3437,3390,943,-450,678,364,-790,745,15,dire
7565441012,10,14,19,69,53,"[0, 324, 592, 1001, 1319, 1679, 1926, 2497, 2939, 3313, 3875, 4752, 5237, 5809, 6338]","[0, 278, 442, 769, 1110, 1450, 2076, 2394, 3294, 3808, 3980, 5347, 5437, 6384, 6993]","[0, 313, 703, 987, 1495, 1860, 2577, 3033, 3510, 3803, 4280, 4674, 5025, 5591, 6654]","[0, 170, 260, 431, 553, 976, 1270, 1533, 1813, 2120, 2413, 3030, 3252, 3575, 3955]","[0, 170, 307, 397, 531, 670, 1323, 1579, 1974, 2100, 2401, 2865, 3199, 3859, 4193]",6338,6993,6654,3955,4193,8,104,22,50,85,"[0, 250, 619, 709, 929, 1195, 1776, 2001, 2273, 2678, 3370, 3631, 4396, 4772, 5232]","[0, 205, 568, 886, 1349, 1561, 2170, 2588, 3108, 3623, 3940, 4555, 4811, 5351, 5704]","[0, 323, 740, 1069, 1604, 2006, 2334, 3019, 3441, 3626, 4162, 4804, 5472, 5948, 6543]","[0, 170, 260, 514, 999, 1089, 1775, 2031, 2183, 2731, 3094, 3494, 3836, 4229, 4770]","[0, 170, 260, 396, 486, 852, 1186, 1366, 1542, 1764, 2413, 2660, 3005, 3099, 3313]",5232,5704,6543,4770,3313,1106,1289,111,-815,880,2571,15,dire
7565603215,113,63,14,72,26,"[0, 282, 621, 901, 1169, 1539, 1937, 2271, 2686, 3149, 3821, 4133, 4439, 4951, 5476]","[0, 245, 561, 970, 1274, 1590, 2017, 2242, 2441, 3141, 3634, 4229, 4669, 5456, 6026]","[0, 290, 604, 855, 1252, 1574, 1852, 1942, 2409, 2977, 3425, 3751, 4296, 4859, 5428]","[0, 261, 351, 489, 856, 1093, 1259, 1408, 1754, 2301, 2679, 2944, 3477, 3835, 3981]","[0, 209, 640, 730, 865, 1073, 1258, 1348, 1874, 2132, 2488, 2624, 2804, 3007, 3187]",5476,6026,5428,3981,3187,21,98,49,105,58,"[0, 237, 484, 890, 1220, 1800, 2285, 2791, 2881, 3595, 4095, 4508, 5201, 5924, 6590]","[0, 287, 499, 907, 1285, 1704, 2435, 3219, 3637, 4355, 4445, 4719, 5613, 6152, 6568]","[0, 248, 558, 769, 1346, 1707, 2240, 2426, 2913, 3369, 3774, 4053, 4657, 5233, 5737]","[0, 129, 219, 309, 796, 930, 1143, 1494, 1584, 1793, 1883, 2009, 2224, 2632, 2727]","[0, 181, 306, 396, 535, 992, 1263, 1614, 1704, 2011, 2141, 2575, 2720, 2972, 3229]",6590,6568,5737,2727,3229,-1114,-542,-309,1254,-42,-753,15,radiant
7565753404,49,32,137,121,26,"[1007, 1282, 1696, 1988, 2583, 2882, 3105, 3281, 3796, 4131, 4621, 5421, 6068, 6605, 7236]","[664, 1077, 1400, 1768, 2179, 2701, 2834, 3445, 3875, 4572, 4830, 5161, 5513, 5984, 6810]","[788, 1002, 1332, 1733, 2288, 3095, 3703, 4239, 4410, 5103, 5859, 6279, 6434, 6687, 7209]","[418, 508, 681, 868, 1073, 1396, 1535, 1777, 1912, 2239, 2384, 2569, 2664, 2758, 3216]","[553, 715, 876, 1031, 1471, 1689, 1817, 1907, 2216, 2391, 2619, 3178, 3514, 3608, 3903]",7236,6810,7209,3216,3903,41,78,53,90,20,"[478, 816, 1523, 1767, 2111, 2334, 2693, 3183, 3737, 4160, 4539, 4863, 5377, 5824, 6148]","[372, 708, 798, 1207, 1414, 2048, 2508, 3063, 3699, 4175, 4718, 5249, 5688, 6168, 6702]","[319, 493, 787, 1016, 1384, 1509, 1827, 2366, 2665, 2806, 2896, 3045, 3431, 3742, 3960]","[535, 814, 1052, 1531, 1832, 2344, 2599, 3371, 4301, 4541, 4786, 5225, 5572, 6027, 6449]","[219, 309, 567, 707, 879, 1086, 1324, 1685, 2038, 2334, 2488, 2676, 2874, 2968, 3126]",6148,6702,3960,6449,3126,1088,108,3249,-3233,777,1989,15,radiant
7565832312,95,57,97,123,87,"[0, 170, 465, 780, 1058, 1390, 1926, 2301, 2940, 3381, 3849, 4651, 5258, 6203, 7045]","[0, 311, 546, 965, 1451, 1851, 2381, 2945, 3395, 3878, 4302, 4823, 5215, 5344, 5936]","[0, 170, 446, 648, 1165, 1361, 1681, 1903, 2435, 2920, 3616, 4065, 4926, 5021, 5368]","[0, 220, 328, 418, 635, 729, 984, 1119, 1338, 1476, 1662, 1982, 2214, 2481, 2861]","[0, 170, 295, 430, 520, 610, 873, 1008, 1265, 1399, 1534, 1920, 2094, 2595, 2743]",7045,5936,5368,2861,2743,94,96,106,53,105,"[0, 170, 373, 729, 1257, 1702, 2070, 2526, 3236, 3715, 4195, 4829, 5480, 6473, 7369]","[0, 170, 564, 854, 1326, 1677, 2020, 2411, 2877, 3272, 3869, 4264, 4912, 5608, 6074]","[0, 276, 562, 920, 1129, 1309, 1541, 1667, 2339, 2821, 3540, 3936, 4408, 5554, 6014]","[0, 170, 260, 399, 947, 1119, 1254, 1344, 1973, 2229, 2663, 2753, 3107, 3984, 4225]","[0, 170, 310, 447, 670, 795, 935, 1073, 1470, 1851, 2090, 2234, 2639, 3325, 3484]",7369,6074,6014,4225,3484,-324,-138,-646,-1364,-741,-3213,15,dire
7565999305,98,95,43,90,20,"[0, 382, 669, 1045, 1570, 2056, 2519, 3122, 3737, 4427, 5301, 6138, 6478, 7068, 7594]","[0, 219, 504, 772, 1262, 1711, 2086, 2560, 2999, 3524, 4093, 4563, 4943, 5436, 6116]","[0, 216, 526, 880, 1174, 1624, 1880, 2372, 2798, 3352, 3803, 4179, 4604, 4934, 5393]","[0, 180, 270, 713, 839, 929, 1019, 1233, 1485, 1712, 1919, 2157, 2479, 2644, 2815]","[0, 281, 371, 480, 664, 799, 889, 1489, 1903, 2083, 2346, 2577, 2667, 2832, 2980]",7594,6116,5393,2815,2980,36,106,129,88,110,"[0, 353, 558, 873, 1206, 1584, 2026, 2378, 2721, 2984, 3482, 3876, 4479, 5057, 5558]","[0, 388, 717, 1001, 1315, 1525, 1812, 2098, 2469, 2818, 3301, 3588, 3857, 4375, 4834]","[0, 269, 474, 646, 944, 1153, 1632, 2099, 2353, 2767, 3120, 3522, 4045, 4431, 4862]","[0, 235, 360, 487, 577, 711, 846, 1192, 1355, 1494, 1629, 2026, 2116, 2265, 2558]","[0, 235, 361, 451, 541, 631, 783, 873, 1008, 1119, 1326, 1622, 1712, 1997, 2091]",5558,4834,4862,2558,2091,2036,1282,531,257,889,4995,15,radiant
7566090506,41,98,97,128,105,"[76, 321, 609, 857, 1142, 1426, 1862, 2493, 2909, 3440, 4218, 4474, 4757, 5427, 5942]","[76, 281, 643, 967, 1287, 1774, 2074, 2584, 2979, 3679, 4216, 4375, 4967, 5294, 5806]","[76, 359, 740, 938, 1288, 1694, 2124, 2341, 2934, 3510, 3764, 4233, 4742, 5202, 5556]","[209, 636, 778, 1019, 1195, 1386, 1565, 1700, 1790, 2118, 2647, 2737, 2873, 2967, 3062]","[76, 246, 469, 589, 807, 1034, 1169, 1304, 1605, 1931, 2111, 2201, 2291, 2400, 2534]",5942,5806,5556,3062,2534,21,137,135,53,19,"[250, 469, 944, 1352, 1796, 2230, 2697, 3140, 3766, 4427, 5016, 5500, 6318, 6956, 7663]","[117, 375, 608, 909, 1463, 1747, 2241, 3031, 3541, 3744, 4164, 4417, 4949, 5440, 5882]","[117, 287, 599, 860, 1233, 1361, 1801, 2205, 2572, 2831, 3227, 3771, 4784, 5074, 5532]","[117, 287, 377, 467, 597, 914, 1004, 1463, 2037, 2332, 2572, 2882, 3448, 3813, 4250]","[385, 555, 765, 855, 985, 1272, 1619, 1906, 2244, 2334, 2667, 2794, 3634, 3935, 4262]",7663,5882,5532,4250,4262,-1721,-76,24,-1188,-1728,-4689,15,radiant
7566202716,70,21,49,123,75,"[0, 321, 516, 991, 1317, 1589, 2624, 2997, 3087, 3676, 4182, 4836, 5323, 6309, 7003]","[0, 301, 574, 888, 1283, 1389, 1707, 2032, 2417, 2872, 3164, 3732, 4405, 4959, 5534]","[0, 246, 580, 776, 1027, 1446, 1715, 2044, 2447, 2823, 3336, 3696, 4368, 4754, 5269]","[0, 210, 337, 427, 563, 671, 761, 896, 986, 1076, 1256, 1425, 1695, 1906, 2164]","[0, 210, 350, 488, 623, 729, 938, 1073, 1235, 1366, 1501, 1606, 1876, 2270, 2579]",7003,5534,5269,2164,2579,102,98,39,110,26,"[0, 253, 899, 1199, 1655, 2089, 2720, 3374, 3623, 4025, 4545, 5064, 5416, 6058, 6767]","[0, 201, 517, 757, 1061, 1294, 1556, 1941, 2350, 2607, 2778, 3126, 3788, 4504, 5433]","[0, 164, 373, 497, 747, 943, 1152, 1403, 1704, 1916, 2244, 2338, 2644, 3078, 3626]","[0, 130, 295, 385, 554, 932, 1188, 1368, 1749, 2070, 2252, 2393, 2565, 2879, 3186]","[0, 176, 313, 403, 493, 583, 940, 1120, 1437, 1601, 1736, 1886, 1976, 2268, 2546]",6767,5433,3626,3186,2546,236,101,1643,-1022,33,991,15,radiant
7566439806,102,21,106,100,121,"[206, 449, 811, 1095, 1474, 1825, 2148, 2870, 3297, 3684, 4368, 4633, 5137, 5747, 6484]","[73, 356, 602, 1003, 1390, 1979, 2221, 3200, 3435, 3820, 4139, 4465, 4870, 5400, 6513]","[73, 404, 685, 968, 1333, 1771, 1979, 2610, 3195, 3601, 4197, 4522, 5309, 5912, 6477]","[0, 170, 304, 677, 767, 1015, 1105, 1300, 1621, 1711, 2054, 2297, 3223, 3748, 4162]","[73, 243, 333, 653, 795, 1041, 1181, 1454, 1589, 1803, 2328, 2453, 2977, 3299, 4019]",6484,6513,6477,4162,4019,63,120,19,20,101,"[310, 567, 897, 1393, 1945, 2335, 3137, 3435, 3970, 4678, 5367, 5935, 6192, 7036, 7579]","[445, 703, 864, 1322, 1789, 2171, 2388, 2962, 3485, 4033, 4481, 4993, 5432, 5951, 6745]","[310, 591, 874, 1284, 1957, 2236, 2611, 2868, 3182, 3526, 3661, 4055, 4485, 4779, 5023]","[177, 347, 437, 620, 973, 1156, 1481, 1680, 1836, 2050, 2586, 2746, 2848, 2997, 3217]","[116, 286, 376, 526, 737, 891, 1026, 1213, 1503, 1869, 2184, 2274, 2485, 2634, 2939]",7579,6745,5023,3217,2939,-1095,-232,1454,945,1080,2152,15,radiant
7566572217,28,93,106,53,26,"[0, 129, 329, 567, 847, 1379, 1779, 2263, 2912, 3610, 4433, 4973, 5367, 6028, 6634]","[58, 315, 644, 1041, 1425, 1793, 2030, 2550, 2685, 3039, 3664, 4006, 4716, 5363, 5845]","[58, 314, 635, 976, 1356, 1805, 1966, 2332, 2796, 3183, 3763, 4244, 4540, 4899, 5189]","[326, 520, 610, 971, 1061, 1516, 1719, 1856, 2035, 2297, 2707, 2926, 3252, 3450, 4064]","[58, 385, 546, 751, 888, 1157, 1538, 1707, 1891, 2209, 2525, 2615, 2705, 2800, 3291]",6634,5845,5189,4064,3291,41,38,120,101,102,"[0, 293, 625, 858, 1102, 1605, 1935, 2354, 2631, 3138, 3491, 3974, 4629, 5202, 5799]","[0, 243, 391, 556, 901, 1264, 1650, 2384, 2836, 3530, 3944, 4526, 4879, 5776, 6276]","[0, 247, 689, 1050, 1431, 1677, 2094, 2399, 2783, 3235, 3833, 4490, 5169, 5681, 5892]","[0, 209, 302, 392, 482, 652, 1328, 2009, 2424, 2706, 2978, 3143, 3590, 4251, 4393]","[0, 209, 299, 428, 518, 741, 831, 1046, 1181, 1460, 1640, 1779, 1915, 2371, 2635]",5799,6276,5892,4393,2635,835,-431,-703,-329,656,28,15,radiant
7566636803,10,49,104,9,26,"[0, 166, 405, 729, 1089, 1303, 1712, 2171, 2735, 3370, 3928, 4573, 4980, 5210, 6102]","[0, 165, 330, 622, 996, 1316, 1733, 2115, 2437, 2749, 3002, 3610, 3961, 4311, 4955]","[0, 129, 454, 831, 1126, 1339, 1516, 1805, 2033, 2543, 3041, 3436, 3666, 4106, 4538]","[0, 129, 219, 353, 443, 578, 668, 896, 1037, 1512, 2117, 2499, 2914, 3058, 3397]","[2, 184, 321, 517, 619, 767, 912, 1129, 1219, 1407, 1672, 1923, 2151, 2246, 2479]",6102,4955,4538,3397,2479,89,96,74,45,72,"[0, 243, 579, 979, 1138, 1499, 1778, 2182, 2478, 2841, 3279, 3994, 4612, 5496, 6503]","[0, 363, 744, 1114, 1390, 1792, 2331, 2670, 3143, 3654, 4172, 4496, 5389, 5850, 6322]","[0, 329, 604, 870, 1094, 1355, 1559, 1776, 2003, 2904, 3047, 3390, 3771, 4373, 4701]","[0, 209, 666, 828, 1015, 1149, 1308, 1488, 1842, 2265, 2401, 2843, 3379, 3900, 4346]","[0, 209, 299, 506, 596, 731, 868, 1048, 1302, 1731, 1977, 2300, 3176, 3499, 3849]",6503,6322,4701,4346,3849,-401,-1367,-163,-949,-1370,-4250,15,dire
7566637019,49,95,107,123,121,"[376, 738, 1053, 1261, 1714, 2316, 2815, 3482, 3886, 4635, 5577, 5867, 6674, 7170, 7645]","[240, 522, 719, 1019, 1459, 1654, 2386, 3053, 3304, 3661, 4056, 4660, 5159, 5584, 6201]","[506, 870, 1157, 1494, 1794, 2128, 2691, 3515, 4037, 4716, 5351, 5937, 6280, 7383, 7678]","[373, 583, 673, 763, 940, 1351, 1896, 2378, 2468, 2648, 3113, 3366, 3608, 4112, 4297]","[108, 318, 408, 498, 707, 797, 1127, 1418, 1553, 1786, 2057, 2362, 2982, 3474, 3661]",7645,6201,7678,4297,3661,82,126,69,64,45,"[154, 309, 630, 1149, 1396, 1603, 1812, 2030, 2478, 2856, 3207, 3764, 4356, 4672, 5160]","[287, 564, 818, 1217, 1504, 1956, 2526, 3122, 3794, 4089, 4857, 5020, 5460, 5997, 6181]","[154, 378, 499, 900, 1128, 1577, 1856, 2173, 2425, 2750, 3446, 3907, 4287, 4873, 5326]","[154, 309, 486, 606, 993, 1183, 1396, 1639, 1833, 2166, 2991, 3156, 3246, 3494, 3589]","[287, 691, 781, 992, 1160, 1285, 1421, 1601, 1795, 1979, 2413, 2503, 2593, 2878, 3127]",5160,6181,5326,3589,3127,2485,20,2352,708,534,6099,15,radiant
7566638207,97,107,136,72,100,"[0, 323, 574, 1002, 1402, 1737, 2817, 3119, 3846, 4493, 5159, 5620, 6265, 7050, 7351]","[0, 279, 498, 859, 1179, 1383, 1761, 2022, 2452, 2914, 3361, 3780, 4252, 4985, 5796]","[0, 204, 439, 1015, 1348, 1879, 2389, 2992, 3930, 4209, 5367, 6136, 6989, 7365, 8131]","[100, 270, 663, 922, 1056, 1233, 1399, 1579, 1879, 1991, 2544, 2871, 3139, 3345, 3630]","[100, 270, 411, 576, 716, 862, 1040, 1258, 1616, 1706, 2378, 2623, 2992, 3332, 3796]",7351,5796,8131,3630,3796,49,21,78,53,86,"[0, 363, 699, 1094, 1466, 2010, 2644, 2898, 3344, 3639, 3950, 4129, 4710, 5251, 5650]","[0, 287, 562, 682, 1186, 1386, 1646, 2256, 2609, 3079, 3630, 3850, 4554, 5204, 5736]","[0, 260, 500, 774, 1134, 1260, 1779, 2110, 2200, 2669, 3341, 4122, 4284, 5273, 5390]","[0, 170, 260, 415, 505, 595, 1063, 1425, 1515, 1706, 2078, 2222, 2723, 3358, 3569]","[0, 170, 605, 725, 861, 994, 1302, 1437, 1571, 1741, 2225, 2531, 2655, 3027, 3211]",5650,5736,5390,3569,3211,1701,60,2741,61,585,5148,15,dire
7566642807,93,33,106,19,79,"[61, 420, 939, 1149, 1390, 1829, 2296, 2735, 3111, 3453, 4013, 4821, 5637, 6214, 6939]","[0, 376, 699, 1057, 1582, 2223, 2598, 3009, 3586, 3890, 4070, 4729, 5027, 5370, 5981]","[61, 395, 628, 907, 1159, 1518, 1852, 2246, 2810, 3413, 3795, 4409, 4800, 4968, 5530]","[61, 311, 401, 491, 691, 901, 1036, 1294, 1713, 2117, 2252, 2481, 2738, 2832, 3281]","[329, 579, 726, 816, 906, 1094, 1278, 1436, 1747, 1940, 2213, 2457, 2683, 2863, 3350]",6939,5981,5530,3281,3350,48,71,74,123,20,"[0, 265, 512, 806, 1157, 1305, 1395, 1838, 2047, 2301, 3064, 3870, 4525, 5330, 5479]","[0, 400, 654, 949, 1324, 1565, 1802, 1966, 2549, 2864, 3342, 3621, 4065, 5007, 5479]","[0, 340, 697, 1074, 1315, 1718, 2083, 2173, 2548, 2885, 3284, 3612, 4031, 4703, 5078]","[0, 159, 300, 390, 798, 936, 1193, 1301, 1470, 1651, 1870, 2051, 2291, 2766, 3200]","[0, 361, 451, 594, 790, 899, 989, 1079, 1248, 1338, 1536, 1815, 2052, 2240, 2407]",5479,5479,5078,3200,2407,1460,502,452,81,943,3438,15,radiant
7566660314,74,32,55,20,19,"[0, 288, 591, 885, 1544, 2017, 2679, 3270, 3719, 4704, 5122, 6104, 6686, 7270, 7766]","[0, 325, 548, 885, 1052, 1387, 1713, 2038, 2128, 2424, 2551, 2746, 3378, 4035, 4707]","[0, 324, 611, 1024, 1202, 1670, 1937, 2571, 2848, 3419, 4011, 4532, 4975, 5264, 5358]","[0, 250, 353, 443, 569, 992, 1430, 1916, 2006, 2898, 2988, 3093, 3906, 4181, 4431]","[0, 250, 340, 430, 520, 686, 776, 1097, 1317, 1627, 1717, 2035, 2478, 2785, 3294]",7766,4707,5358,4431,3294,48,40,120,88,64,"[326, 582, 959, 1344, 1795, 2352, 2976, 3305, 3866, 4507, 5233, 5878, 6093, 7093, 7971]","[58, 377, 784, 979, 1446, 2246, 2972, 3526, 4110, 4410, 4674, 5176, 5948, 6563, 6844]","[58, 220, 588, 957, 1291, 1421, 1784, 2344, 2803, 2893, 3164, 3383, 3749, 4436, 4642]","[58, 206, 315, 405, 569, 787, 1043, 1306, 1531, 1747, 2259, 2718, 3615, 4262, 4670]","[58, 206, 296, 386, 492, 622, 856, 946, 1499, 1680, 2211, 2444, 2927, 3337, 3717]",7971,6844,4642,4670,3717,-205,-2137,716,-239,-423,-2288,15,dire
7566664510,89,78,19,72,68,"[445, 701, 947, 1074, 1295, 1617, 1791, 2100, 2598, 3273, 3901, 4299, 5135, 5924, 6906]","[447, 573, 845, 1211, 1511, 1721, 2145, 2511, 2802, 3564, 3866, 4505, 4824, 5264, 6240]","[179, 339, 701, 943, 1459, 1705, 2045, 2432, 2704, 3281, 3665, 4118, 4533, 4795, 5730]","[179, 304, 445, 581, 710, 936, 1202, 1510, 1875, 2244, 2424, 2890, 3094, 3478, 4604]","[119, 254, 344, 450, 589, 725, 906, 1041, 1445, 1864, 2124, 2903, 3110, 3205, 3936]",6906,6240,5730,4604,3936,73,47,29,45,100,"[0, 571, 929, 1309, 1615, 1969, 2296, 2682, 3145, 4127, 4488, 5071, 5445, 6545, 7252]","[280, 628, 909, 1198, 1669, 2101, 2257, 2813, 3361, 3915, 4215, 4588, 5105, 5592, 6002]","[147, 494, 631, 947, 1387, 1844, 2256, 2581, 2999, 3505, 4210, 4640, 4985, 5812, 6018]","[147, 422, 598, 815, 990, 1369, 1499, 1844, 2071, 2279, 2405, 2560, 2944, 3559, 3859]","[280, 555, 758, 878, 1055, 1434, 1913, 2003, 2430, 2638, 2892, 2982, 3483, 3776, 3871]",7252,6002,6018,3859,3871,-346,238,-288,745,65,414,15,radiant
7566671907,25,76,28,31,26,"[63, 263, 500, 733, 1144, 1397, 1557, 1889, 2265, 2607, 2920, 3506, 4124, 4592, 5109]","[63, 308, 674, 970, 1264, 1461, 2053, 2588, 3115, 3542, 3670, 4254, 4496, 4895, 5366]","[63, 270, 550, 895, 1151, 1635, 2152, 2368, 2857, 3169, 3681, 4241, 4910, 5211, 5524]","[63, 237, 373, 508, 646, 977, 1067, 1201, 1381, 1952, 2042, 2233, 2628, 2743, 2895]","[331, 460, 550, 684, 774, 911, 1050, 1187, 1367, 1457, 1592, 1810, 1930, 2025, 2312]",5109,5366,5524,2895,2312,61,74,41,21,20,"[0, 248, 459, 851, 1022, 1393, 1865, 2475, 2896, 3308, 3831, 4526, 4888, 5545, 5989]","[70, 402, 601, 844, 1129, 1728, 1928, 2345, 2677, 3302, 3656, 4101, 4272, 4679, 5244]","[70, 313, 476, 674, 998, 1324, 1580, 1896, 2081, 2282, 2538, 2962, 3218, 3597, 4365]","[203, 412, 552, 910, 1057, 1187, 1586, 1838, 1928, 2293, 2473, 2902, 3128, 3627, 3884]","[70, 279, 406, 496, 606, 854, 961, 1203, 1293, 1458, 1638, 1818, 1908, 2179, 2473]",5989,5244,4365,3884,2473,-880,122,1159,-989,-161,-749,15,dire
7566684319,95,39,29,53,64,"[0, 284, 737, 1156, 1402, 1682, 2401, 2881, 3131, 3506, 4123, 4594, 5008, 5612, 6227]","[0, 322, 573, 905, 1117, 1448, 1965, 2253, 2563, 3228, 4050, 4472, 4856, 5381, 5746]","[0, 245, 531, 732, 981, 1206, 1420, 1859, 2370, 2797, 2887, 3214, 3842, 4208, 4428]","[0, 170, 309, 399, 525, 699, 912, 1108, 1283, 1566, 1921, 2146, 2407, 2785, 3018]","[0, 170, 344, 434, 571, 661, 1062, 1258, 1348, 1575, 1665, 1890, 2096, 2459, 2644]",6227,5746,4428,3018,2644,82,13,137,58,86,"[0, 502, 735, 1283, 1561, 2081, 2766, 3150, 3870, 4420, 5343, 5810, 6625, 7172, 7831]","[0, 246, 607, 820, 1106, 1603, 2022, 2680, 3183, 3711, 4227, 4955, 5571, 6192, 6812]","[0, 207, 636, 904, 1200, 1592, 1880, 2259, 2660, 3138, 3454, 3955, 4566, 5102, 5720]","[0, 234, 324, 696, 786, 916, 1329, 1850, 2083, 2272, 2811, 3097, 3406, 3689, 4027]","[0, 170, 363, 453, 663, 1008, 1263, 1635, 1831, 2202, 2675, 2869, 3094, 3297, 3530]",7831,6812,5720,4027,3530,-1604,-1066,-1292,-1009,-886,-5857,15,dire
7566717109,82,55,63,123,112,"[0, 376, 732, 1020, 1501, 1815, 2095, 2476, 3107, 3832, 4273, 4938, 5560, 6245, 7172]","[0, 331, 916, 1201, 1580, 2268, 2754, 3304, 3881, 4393, 4630, 5060, 6082, 6986, 7473]","[0, 205, 416, 592, 1029, 1373, 1698, 1990, 2412, 2688, 3147, 3471, 3877, 4464, 4975]","[0, 170, 335, 522, 652, 1107, 1209, 1299, 1461, 1839, 2146, 2505, 3031, 3508, 3761]","[0, 170, 260, 350, 590, 844, 934, 1060, 1240, 1449, 1905, 2038, 2321, 2618, 2888]",7172,7473,4975,3761,2888,1,13,102,20,101,"[0, 247, 461, 928, 1160, 1398, 1900, 2314, 2790, 3097, 3731, 4058, 4374, 4693, 5027]","[0, 255, 660, 1067, 1364, 1713, 2238, 2884, 3328, 3626, 3996, 4511, 5333, 5740, 6649]","[0, 287, 446, 716, 1033, 1287, 1411, 1856, 1980, 2366, 2659, 2834, 3301, 3650, 4088]","[0, 307, 397, 788, 976, 1066, 1263, 1803, 1932, 2115, 2403, 2585, 3110, 3297, 3743]","[0, 170, 260, 380, 517, 652, 849, 1150, 1240, 1330, 1465, 1848, 2265, 2656, 2891]",5027,6649,4088,3743,2891,2145,824,887,18,-3,3871,15,radiant
7566732510,48,23,55,66,51,"[116, 346, 760, 1136, 1398, 1861, 2161, 2630, 3298, 3742, 4277, 4876, 5502, 5961, 6784]","[249, 601, 914, 1237, 1661, 2135, 2630, 3439, 4224, 4786, 5282, 5938, 6409, 6904, 7604]","[116, 346, 557, 754, 915, 1316, 1818, 2479, 3166, 3699, 4317, 4595, 5294, 5659, 6412]","[116, 311, 451, 652, 824, 1078, 1225, 1638, 2028, 2345, 2618, 3088, 3482, 3904, 4188]","[384, 579, 669, 830, 1180, 1305, 1764, 2034, 2214, 2355, 2832, 3067, 3450, 3645, 4021]",6784,7604,6412,4188,4021,13,21,96,45,20,"[0, 252, 490, 702, 954, 1044, 1444, 1806, 2181, 2766, 3295, 3456, 4109, 4492, 5002]","[0, 283, 595, 840, 1314, 1657, 1939, 2240, 2625, 3082, 4007, 4322, 4823, 5353, 5712]","[0, 283, 613, 996, 1195, 1368, 2063, 2439, 2601, 3080, 3215, 3412, 3871, 4325, 4955]","[0, 170, 260, 399, 788, 925, 1155, 1245, 1386, 1743, 1966, 2259, 2516, 2665, 2885]","[100, 270, 360, 495, 680, 810, 1073, 1184, 1362, 1554, 1874, 2012, 2474, 2623, 2808]",5002,5712,4955,2885,2808,1782,1892,1457,1303,1213,7647,15,radiant
7566759713,25,69,106,107,30,"[0, 290, 693, 994, 1403, 1815, 2368, 2714, 3326, 3834, 4521, 5218, 5840, 6290, 7205]","[0, 208, 454, 638, 1009, 1384, 1527, 1894, 2201, 2680, 3230, 3692, 4430, 5101, 5846]","[0, 251, 598, 1013, 1274, 1664, 1988, 2159, 2366, 2601, 2905, 3204, 3548, 3948, 4769]","[0, 219, 419, 509, 639, 878, 968, 1140, 1323, 1615, 1969, 2331, 2467, 2928, 3171]","[0, 169, 284, 374, 538, 754, 892, 1027, 1210, 1318, 1611, 1764, 1931, 2296, 2494]",7205,5846,4769,3171,2494,42,49,28,110,86,"[0, 215, 584, 1095, 1463, 2076, 2580, 3263, 3602, 3922, 4414, 4809, 5462, 5708, 6277]","[0, 242, 562, 845, 1199, 1634, 2045, 2298, 2748, 3165, 3624, 3987, 4530, 4922, 5349]","[0, 169, 373, 797, 887, 977, 1224, 1565, 1860, 2165, 2474, 2965, 3477, 3695, 3960]","[0, 169, 651, 1010, 1204, 1387, 1533, 1944, 2155, 2506, 3082, 3403, 3623, 3828, 4150]","[0, 169, 304, 521, 650, 740, 830, 965, 1350, 1440, 1575, 1738, 2108, 2203, 2298]",6277,5349,3960,4150,2298,928,497,809,-979,196,1451,15,radiant
7566769601,48,13,21,14,68,"[0, 168, 297, 660, 1001, 1464, 1887, 2301, 2705, 3137, 3513, 3949, 4678, 5488, 6252]","[0, 202, 476, 687, 1109, 1310, 1843, 2379, 2766, 2986, 3584, 4008, 4338, 4472, 5132]","[0, 215, 751, 915, 1355, 1986, 2477, 2567, 2809, 3233, 3580, 3680, 4156, 4617, 4873]","[0, 168, 258, 664, 913, 1299, 1389, 1858, 2031, 2121, 2333, 2549, 2639, 2863, 3269]","[0, 129, 305, 400, 577, 798, 977, 1402, 1812, 1902, 2150, 2240, 2330, 2554, 2855]",6252,5132,4873,3269,2855,96,106,42,20,112,"[0, 209, 611, 1152, 1405, 1615, 2123, 2445, 2927, 3472, 3940, 4706, 5310, 6295, 6736]","[0, 209, 881, 1200, 1653, 1934, 2313, 2692, 3122, 4314, 4823, 5187, 5590, 6628, 7050]","[0, 256, 457, 619, 895, 1187, 1453, 1895, 2343, 2858, 3440, 4361, 4782, 5849, 6409]","[0, 209, 299, 694, 833, 1194, 1564, 1654, 1744, 2094, 2668, 3009, 3236, 3941, 4325]","[0, 209, 299, 389, 479, 605, 818, 908, 1368, 1718, 1988, 2551, 2970, 3601, 3868]",6736,7050,6409,4325,3868,-484,-1918,-1536,-1056,-1013,-6007,15,dire
7566771908,20,43,93,53,51,"[0, 304, 708, 945, 1388, 1780, 2146, 2848, 3850, 4272, 4810, 5493, 6188, 6752, 7195]","[0, 623, 912, 1212, 1545, 1988, 2545, 2841, 3370, 3793, 4137, 4507, 5147, 5600, 6429]","[0, 309, 507, 744, 950, 1193, 1301, 1476, 1741, 2116, 2382, 2707, 3311, 3759, 4078]","[0, 437, 527, 652, 1038, 1240, 1470, 1788, 2334, 2681, 2816, 3039, 3260, 3705, 3933]","[0, 304, 394, 519, 798, 963, 1343, 1564, 1953, 2214, 2447, 2665, 2951, 3172, 3400]",7195,6429,4078,3933,3400,49,10,60,123,136,"[0, 523, 807, 1081, 1411, 1660, 1868, 2204, 2329, 2690, 2986, 3884, 4416, 4921, 5745]","[0, 170, 460, 1043, 1221, 1720, 2124, 2360, 3027, 3360, 3994, 4535, 5129, 5626, 6296]","[0, 235, 514, 892, 1237, 1639, 2032, 2428, 2870, 3301, 3834, 4242, 4734, 5421, 5590]","[0, 279, 369, 489, 579, 782, 894, 1178, 1317, 1735, 2045, 2451, 2739, 2937, 3301]","[0, 283, 373, 576, 666, 846, 953, 1088, 1178, 1358, 1448, 1995, 2270, 2411, 2560]",5745,6296,5590,3301,2560,1450,133,-1512,632,840,1543,15,radiant
7566868214,25,129,76,105,51,"[366, 736, 990, 1294, 1609, 1777, 2092, 2646, 3186, 3699, 4255, 4882, 5801, 6688, 7540]","[634, 843, 1384, 1678, 1997, 2506, 3085, 3491, 4036, 4717, 5313, 5737, 6517, 7300, 7860]","[176, 431, 835, 1198, 1491, 1934, 2262, 2820, 3163, 3288, 3819, 4436, 4966, 5458, 6378]","[366, 613, 932, 1061, 1151, 1311, 1401, 1491, 1581, 1740, 1992, 2151, 2817, 3091, 3624]","[171, 380, 500, 722, 858, 948, 1205, 1457, 1591, 1727, 1955, 2251, 2545, 2911, 3588]",7540,7860,6378,3624,3588,48,106,92,123,102,"[227, 439, 679, 1109, 1468, 1768, 2069, 2701, 3049, 3747, 4211, 4885, 5805, 6619, 6985]","[227, 494, 795, 1159, 1506, 1675, 2050, 2590, 2934, 3218, 3722, 3847, 4481, 4630, 4980]","[493, 622, 891, 1220, 1441, 1906, 2326, 2699, 3066, 3406, 4152, 4550, 4864, 5217, 5311]","[73, 247, 337, 464, 594, 731, 902, 1082, 1207, 1481, 1804, 1995, 2369, 2568, 2662]","[360, 489, 579, 701, 904, 994, 1251, 1577, 1667, 1757, 1982, 2215, 2641, 2790, 2923]",6985,4980,5311,2662,2923,555,2880,1067,962,665,6129,15,radiant
7567126703,10,120,21,65,110,"[0, 219, 422, 664, 913, 1186, 1571, 1997, 2525, 3019, 3526, 4089, 4676, 5256, 5884]","[0, 362, 524, 975, 1260, 1678, 2045, 2804, 3217, 3655, 4178, 4793, 5213, 5835, 6689]","[0, 251, 522, 924, 1305, 1585, 2101, 2513, 2967, 3418, 3671, 4084, 4454, 5107, 5779]","[0, 170, 260, 398, 567, 743, 955, 1090, 1180, 1316, 1530, 1698, 1992, 2682, 2831]","[0, 170, 260, 427, 517, 607, 791, 1011, 1101, 1191, 1326, 1491, 1581, 2307, 2648]",5884,6689,5779,2831,2648,70,82,98,26,123,"[0, 331, 598, 1004, 1342, 1776, 2069, 2503, 2828, 3437, 3865, 4421, 5023, 5566, 6012]","[0, 222, 661, 884, 1323, 1532, 1963, 2414, 2953, 3284, 3999, 4511, 5113, 5637, 6547]","[0, 299, 685, 1146, 1356, 1684, 2257, 3030, 3538, 4056, 4625, 5111, 5546, 5777, 6822]","[0, 170, 260, 416, 552, 733, 868, 1011, 1127, 1364, 1878, 2572, 2752, 2970, 3311]","[0, 170, 260, 350, 534, 670, 805, 1058, 1220, 1310, 1832, 1922, 2307, 2401, 2767]",6012,6547,6822,3311,2767,-128,142,-1043,-480,-119,-1628,15,dire
7567142708,25,17,43,51,79,"[929, 1217, 1929, 2380, 2756, 3156, 3827, 4105, 4640, 5176, 6025, 6691, 7232, 7870, 8134]","[980, 1264, 1634, 2038, 2385, 2924, 3378, 3818, 4170, 4690, 5042, 5471, 5842, 6560, 7377]","[780, 1060, 1359, 1702, 2014, 2362, 2803, 3187, 3969, 4720, 5184, 5573, 5995, 6515, 6912]","[410, 518, 759, 894, 1031, 1167, 1478, 1826, 2227, 2501, 2715, 3041, 3135, 3568, 3969]","[398, 488, 618, 708, 798, 888, 1012, 1313, 1493, 1772, 1974, 2281, 2471, 2707, 2802]",8134,7377,6912,3969,2802,48,13,49,65,86,"[1108, 1502, 2038, 2576, 3095, 3524, 4022, 4907, 5653, 6473, 7118, 8072, 8981, 10258, 11544]","[922, 1283, 1622, 2165, 2455, 2970, 3396, 3812, 4708, 5414, 6077, 6640, 7890, 8851, 9511]","[794, 1220, 1408, 1797, 2327, 2780, 3316, 3880, 4595, 5346, 5702, 6673, 7246, 8294, 9313]","[450, 627, 717, 842, 1022, 1316, 1629, 2137, 2655, 2745, 3254, 3771, 4467, 5113, 5361]","[957, 1295, 1481, 1778, 2073, 2291, 2381, 2763, 3081, 3171, 3424, 3676, 3953, 4462, 5123]",11544,9511,9313,5361,5123,-3410,-2134,-2401,-1392,-2321,-11658,15,dire
7567422206,106,41,14,123,21,"[0, 328, 576, 856, 1343, 1749, 1839, 2391, 2862, 3263, 3720, 4046, 4269, 4584, 5291]","[0, 290, 710, 1030, 1310, 1564, 2093, 2542, 3005, 3683, 4451, 4946, 5657, 6284, 6785]","[0, 170, 729, 1006, 1482, 1772, 2278, 2498, 2995, 3547, 3936, 4331, 5236, 5421, 6252]","[0, 222, 613, 813, 1226, 1513, 1864, 2211, 2346, 2561, 2948, 3313, 4112, 4442, 4645]","[0, 170, 514, 668, 758, 1020, 1202, 1596, 1765, 2072, 2247, 2613, 3039, 3508, 3844]",5291,6785,6252,4645,3844,95,98,128,31,19,"[0, 170, 409, 614, 1114, 1535, 1709, 2065, 2364, 2454, 3084, 3601, 3863, 4421, 4695]","[0, 292, 574, 1024, 1349, 1766, 2404, 3115, 3529, 4105, 4874, 5304, 5893, 6154, 7141]","[0, 250, 497, 696, 938, 1195, 1452, 1651, 2026, 2383, 2473, 2685, 3500, 4179, 4486]","[0, 207, 349, 527, 768, 921, 1011, 1101, 1697, 1787, 2475, 2722, 3444, 3982, 4320]","[0, 170, 260, 464, 594, 724, 862, 952, 1087, 1177, 1518, 1608, 1698, 1935, 2333]",4695,7141,4486,4320,2333,596,-356,1766,325,1511,3842,15,dire
7567721608,63,98,43,90,83,"[0, 331, 917, 1404, 1796, 2450, 3007, 3501, 4061, 4317, 4670, 5067, 5427, 6398, 6594]","[0, 364, 761, 1253, 1507, 1956, 2716, 3163, 3550, 4136, 4486, 4719, 5112, 5611, 5968]","[21, 269, 612, 906, 1187, 1613, 1870, 2191, 2449, 2880, 3258, 3631, 4225, 4730, 4910]","[0, 210, 374, 917, 1083, 1190, 1520, 1655, 1745, 1880, 2196, 2357, 2760, 3388, 3522]","[0, 210, 490, 681, 910, 1362, 1618, 1753, 1914, 2049, 2184, 2518, 2741, 3378, 3544]",6594,5968,4910,3522,3544,46,77,45,20,26,"[0, 130, 518, 907, 1364, 1648, 2186, 2548, 3007, 3506, 3963, 4672, 4936, 5951, 7004]","[0, 207, 571, 890, 1486, 1949, 2075, 2708, 3044, 3627, 4120, 4324, 4826, 5868, 6504]","[0, 253, 542, 914, 1316, 1489, 1725, 2126, 2337, 2680, 3115, 3618, 4200, 4706, 5211]","[0, 130, 220, 326, 589, 872, 1261, 1384, 1474, 2032, 2167, 2404, 2539, 3236, 3651]","[0, 130, 220, 560, 776, 911, 1218, 1322, 1517, 1607, 1871, 2218, 2308, 2766, 3137]",7004,6504,5211,3651,3137,-410,-536,-301,-129,407,-969,15,dire
7567823304,14,103,13,63,21,"[0, 372, 761, 1195, 1769, 2253, 2772, 3488, 4068, 4912, 6013, 6103, 6778, 7078, 8310]","[0, 547, 839, 1088, 1684, 2373, 2804, 3122, 3537, 3861, 4322, 4872, 5583, 5879, 7209]","[0, 792, 1044, 1278, 1697, 2070, 2448, 2815, 3114, 3616, 3779, 4381, 4471, 5232, 5956]","[20, 300, 594, 777, 1025, 1581, 1845, 2179, 2397, 2622, 2971, 3242, 3510, 3605, 3929]","[100, 639, 729, 868, 1259, 1504, 1825, 2276, 2501, 3050, 3241, 3510, 4024, 4208, 4657]",8310,7209,5956,3929,4657,113,82,20,51,5,"[0, 364, 649, 1020, 1317, 1540, 2001, 2308, 2730, 3235, 3829, 4465, 5289, 5956, 6439]","[0, 229, 554, 682, 1028, 1414, 1849, 2092, 2480, 2880, 3659, 4204, 5328, 6028, 6757]","[0, 605, 767, 976, 1182, 1272, 1813, 2201, 2513, 2935, 3363, 3805, 4303, 4815, 5141]","[0, 268, 358, 448, 554, 678, 942, 1127, 1673, 1857, 2231, 2469, 3362, 3692, 3888]","[100, 501, 591, 681, 817, 907, 1330, 1923, 2013, 2153, 2379, 2964, 3443, 3787, 4172]",6439,6757,5141,3888,4172,1871,452,815,41,485,3664,15,radiant
7568258612,120,96,54,86,65,"[0, 213, 540, 937, 1316, 1698, 2101, 2402, 2841, 3528, 4424, 4845, 5810, 6511, 7415]","[0, 216, 508, 958, 1290, 1535, 1955, 2571, 3045, 3459, 3725, 4024, 4672, 5205, 6170]","[0, 199, 563, 722, 1029, 1227, 1575, 2012, 2191, 2428, 2999, 3376, 3925, 4407, 5219]","[0, 129, 222, 312, 402, 492, 582, 948, 1126, 1320, 1575, 1665, 1958, 2244, 2698]","[100, 229, 319, 409, 499, 589, 767, 857, 1127, 1254, 1517, 1607, 2148, 2577, 3077]",7415,6170,5219,2698,3077,39,102,78,123,72,"[0, 321, 687, 1053, 1459, 1800, 2194, 2861, 3277, 3783, 4304, 5238, 5675, 5963, 6206]","[0, 256, 548, 904, 1192, 1670, 1914, 2344, 2921, 3345, 3770, 4248, 4777, 5143, 5738]","[0, 280, 548, 828, 1451, 2034, 2279, 2612, 2996, 3412, 3718, 4204, 4696, 4997, 5813]","[0, 209, 299, 433, 589, 797, 887, 1131, 1346, 1591, 1995, 2313, 2466, 2607, 2860]","[0, 209, 316, 485, 575, 1024, 1236, 1416, 1906, 1996, 2219, 3028, 3181, 3392, 3700]",6206,5738,5813,2860,3700,1209,432,-594,-162,-623,262,15,dire
7568314510,41,128,98,65,45,"[0, 215, 535, 909, 1144, 1430, 1912, 2246, 2946, 3237, 3749, 4410, 5286, 5921, 6460]","[0, 240, 647, 931, 1341, 2161, 3096, 3431, 4200, 4528, 5252, 6083, 6853, 7493, 8042]","[0, 164, 514, 837, 1162, 1330, 1876, 2263, 2702, 3174, 3760, 4499, 5205, 6084, 6620]","[0, 129, 219, 309, 417, 682, 1331, 1421, 2030, 2120, 2891, 3140, 3442, 3667, 3926]","[0, 129, 219, 309, 433, 563, 787, 877, 1427, 1681, 2020, 2269, 2618, 2932, 3195]",6460,8042,6620,3926,3195,94,17,106,53,85,"[0, 290, 464, 671, 991, 1443, 1854, 2230, 2961, 3402, 3822, 4093, 4779, 5433, 5870]","[0, 325, 526, 808, 933, 1171, 1565, 1968, 2326, 2854, 3199, 3391, 3899, 4429, 4863]","[0, 284, 573, 737, 1206, 1530, 1989, 2180, 2304, 2709, 3242, 3332, 3513, 3948, 4430]","[0, 209, 299, 406, 541, 631, 986, 1121, 1331, 1424, 1853, 1953, 2053, 2653, 3987]","[0, 209, 299, 389, 579, 732, 946, 1081, 1291, 1381, 1529, 1843, 2142, 2705, 3095]",5870,4863,4430,3987,3095,590,3179,2190,-61,100,5998,15,radiant
7568353308,4,22,69,110,121,"[0, 204, 561, 915, 1403, 1790, 2248, 2679, 3018, 3163, 3465, 3895, 4582, 5018, 5757]","[0, 326, 723, 1046, 1453, 1780, 2194, 2706, 2988, 3420, 4181, 4491, 5034, 5492, 6375]","[0, 206, 333, 423, 634, 1050, 1140, 1266, 1737, 2199, 2581, 2765, 3665, 4155, 4363]","[0, 170, 260, 417, 555, 896, 1776, 1866, 2213, 2498, 2623, 3109, 3508, 3773, 4120]","[0, 170, 260, 422, 512, 788, 1136, 1226, 1360, 1495, 1748, 1885, 2335, 2484, 2867]",5757,6375,4363,4120,2867,21,120,129,53,136,"[0, 251, 864, 1647, 2173, 2614, 3224, 3865, 4392, 4517, 5611, 6303, 6843, 7293, 8064]","[0, 329, 682, 1095, 1548, 1923, 2525, 2828, 3700, 4182, 5106, 5776, 6095, 6707, 7388]","[0, 274, 585, 746, 914, 1294, 1747, 2118, 2600, 3206, 3751, 3985, 4237, 4484, 5052]","[0, 170, 344, 591, 776, 1128, 1567, 1930, 2284, 2507, 3313, 3916, 4208, 4467, 4719]","[0, 170, 673, 921, 1106, 1444, 1718, 1853, 2110, 2200, 2452, 2770, 2933, 3241, 3640]",8064,7388,5052,4719,3640,-2307,-1013,-689,-599,-773,-5381,15,dire
7568433407,114,71,2,123,121,"[62, 303, 502, 703, 912, 1283, 1578, 2057, 2457, 2835, 3689, 4158, 4573, 4810, 5385]","[60, 353, 667, 914, 1078, 1293, 1706, 2235, 2574, 2916, 3839, 4144, 4789, 5350, 5711]","[328, 534, 880, 1105, 1338, 1743, 2326, 2873, 3267, 3471, 4127, 4845, 5271, 5668, 6156]","[60, 229, 319, 615, 705, 1070, 1324, 1586, 1721, 2113, 2332, 2737, 3087, 3430, 3961]","[60, 229, 337, 472, 664, 895, 1032, 1744, 2014, 2220, 2662, 2904, 3200, 3386, 3550]",5385,5711,6156,3961,3550,63,65,29,100,79,"[0, 250, 559, 876, 1232, 1445, 1689, 2003, 2317, 2726, 3299, 3389, 3817, 4348, 4745]","[0, 274, 562, 894, 1173, 1543, 2070, 2501, 2942, 3350, 3566, 3829, 4225, 4392, 4764]","[0, 169, 375, 704, 1154, 1591, 1911, 2261, 2652, 2742, 2926, 3253, 3540, 4242, 4692]","[0, 169, 259, 435, 565, 703, 793, 883, 1060, 1430, 1520, 1610, 1700, 2002, 2143]","[0, 169, 259, 397, 572, 799, 972, 1325, 1425, 1622, 2027, 2117, 2207, 2614, 2985]",4745,4764,4692,2143,2985,640,947,1464,1818,565,5434,15,dire
7568469704,93,97,47,19,112,"[0, 237, 582, 791, 1116, 1447, 1748, 1924, 2246, 2573, 2875, 3262, 3543, 4185, 4666]","[0, 316, 720, 965, 1263, 1586, 1808, 1993, 2370, 2645, 2998, 3444, 4426, 4824, 5085]","[0, 268, 495, 831, 1171, 1460, 1901, 2266, 2735, 2825, 3034, 3859, 4213, 4437, 4995]","[0, 194, 434, 524, 625, 760, 1094, 1184, 1681, 1855, 1975, 2218, 2512, 2813, 3424]","[0, 194, 284, 485, 623, 774, 864, 1069, 1375, 1534, 1754, 2042, 2205, 2457, 2718]",4666,5085,4995,3424,2718,102,76,96,121,26,"[0, 205, 1023, 1149, 1681, 1914, 2280, 2889, 3346, 3644, 4123, 4786, 5300, 6149, 6567]","[0, 285, 571, 734, 1023, 1156, 1400, 1672, 2017, 2587, 2945, 3331, 3791, 4336, 4897]","[0, 244, 605, 1045, 1505, 1795, 2188, 2770, 3147, 3631, 3934, 4298, 4864, 5445, 5847]","[0, 169, 259, 488, 672, 795, 977, 1293, 1716, 1892, 2378, 2468, 2793, 3080, 3282]","[0, 169, 540, 634, 844, 934, 1113, 1293, 1453, 1629, 1747, 1837, 2017, 2179, 2286]",6567,4897,5847,3282,2286,-1901,188,-852,142,432,-1991,15,radiant
7568521109,82,76,33,51,83,"[0, 323, 880, 1380, 1620, 2277, 2680, 3184, 3879, 4884, 5532, 5925, 6918, 7445, 8321]","[0, 372, 700, 981, 1437, 1838, 2393, 2904, 3401, 3956, 4272, 4840, 5356, 5760, 6218]","[0, 286, 567, 900, 1185, 1412, 1722, 2011, 2236, 2801, 2967, 3608, 4223, 4973, 5461]","[0, 250, 340, 492, 582, 883, 1095, 1399, 1579, 1951, 2459, 2654, 3025, 3626, 3810]","[100, 350, 550, 791, 881, 1033, 1183, 1566, 1827, 2394, 2802, 3099, 3426, 3696, 4116]",8321,6218,5461,3810,4116,72,98,137,121,100,"[19, 255, 470, 796, 1411, 1667, 2106, 2938, 3276, 3556, 3745, 4259, 4946, 5561, 6244]","[0, 235, 372, 706, 954, 1205, 1462, 1766, 2178, 2506, 2949, 3809, 4105, 4374, 4652]","[19, 222, 460, 638, 1126, 1535, 2048, 2382, 3223, 3521, 4390, 4860, 4961, 5068, 5549]","[0, 432, 573, 663, 802, 927, 1129, 1308, 1893, 2032, 2322, 2619, 2773, 2903, 2997]","[0, 164, 254, 344, 575, 665, 847, 1260, 1485, 1575, 1710, 2146, 2284, 2709, 2803]",6244,4652,5549,2997,2803,2077,1566,-88,813,1313,5681,15,radiant
7568521216,41,128,47,19,112,"[0, 618, 780, 1177, 1373, 1834, 2032, 2715, 3189, 3439, 3615, 4140, 4944, 5386, 5590]","[0, 374, 720, 1122, 1284, 1751, 2198, 3095, 3185, 3814, 3904, 4537, 5128, 5580, 6233]","[0, 247, 483, 731, 903, 1029, 1365, 1949, 2039, 2241, 2571, 3084, 3486, 3911, 4464]","[0, 210, 300, 481, 571, 756, 893, 1193, 1516, 1606, 1696, 2080, 2682, 2878, 2973]","[0, 273, 397, 534, 624, 759, 849, 1301, 1624, 1889, 1979, 2311, 2876, 3344, 3582]",5590,6233,4464,2973,3582,21,96,137,45,26,"[0, 167, 467, 870, 1272, 1726, 2048, 2261, 2828, 3336, 3847, 4363, 4979, 5332, 5909]","[0, 130, 374, 656, 1101, 1420, 1840, 2050, 2628, 2973, 3338, 3652, 4128, 4319, 4971]","[0, 285, 546, 921, 1499, 1661, 2026, 2116, 3046, 3516, 4306, 5066, 5231, 5422, 5617]","[0, 180, 270, 406, 581, 727, 866, 956, 1323, 1452, 1773, 2015, 2345, 2860, 3719]","[0, 130, 220, 310, 488, 626, 799, 889, 1191, 1449, 1632, 2017, 2107, 2201, 2620]",5909,4971,5617,3719,2620,-319,1262,-1153,-746,962,6,15,dire
7568606319,10,69,17,58,26,"[0, 220, 459, 964, 1419, 1798, 2168, 2321, 2614, 3168, 3641, 4085, 5066, 5466, 6214]","[0, 314, 571, 994, 1283, 1572, 1900, 2222, 2593, 2927, 3347, 4133, 4590, 5604, 6066]","[0, 289, 611, 979, 1398, 1842, 2473, 2817, 3362, 3542, 3694, 4121, 5070, 5553, 6115]","[0, 170, 260, 394, 590, 680, 1131, 1393, 1587, 1722, 1865, 2102, 2570, 2768, 3216]","[100, 515, 605, 806, 936, 1112, 1406, 1544, 1690, 1814, 2106, 2373, 3064, 3213, 3685]",6214,6066,6115,3216,3685,49,25,96,121,51,"[0, 328, 612, 907, 1387, 1824, 2204, 2535, 3160, 3975, 4477, 5085, 5570, 6195, 6815]","[0, 584, 1100, 1425, 1747, 2108, 2649, 3110, 3627, 4051, 4408, 4902, 5414, 6142, 6966]","[0, 240, 636, 807, 1138, 1431, 1912, 2685, 2980, 3336, 3793, 4211, 4385, 5172, 5395]","[0, 170, 260, 350, 506, 640, 999, 1178, 1279, 1514, 1994, 2174, 2353, 2640, 2955]","[0, 239, 402, 538, 719, 817, 1141, 1403, 1542, 1905, 2165, 2385, 2536, 2819, 2913]",6815,6966,5395,2955,2913,-601,-900,720,261,772,252,15,radiant
7568781105,46,41,137,65,26,"[608, 1057, 1456, 1872, 2294, 2630, 3083, 3717, 4433, 5524, 5778, 6593, 7253, 7899, 8689]","[493, 846, 1214, 1615, 1865, 2208, 2582, 3020, 3503, 4244, 4706, 5168, 5826, 6265, 6932]","[533, 843, 1537, 1803, 2370, 2875, 3640, 3971, 4640, 5344, 5509, 6544, 6780, 7296, 7749]","[260, 350, 485, 580, 914, 1233, 1460, 1751, 2015, 2540, 2630, 3031, 3512, 3828, 4092]","[260, 395, 547, 637, 866, 1046, 1204, 1343, 1632, 2127, 2217, 2501, 2795, 2985, 3421]",8689,6932,7749,4092,3421,1,13,97,123,110,"[517, 642, 967, 1284, 1542, 1838, 2124, 2371, 2646, 3035, 3814, 4524, 5199, 5730, 6452]","[555, 926, 1141, 1489, 1819, 2032, 2484, 3126, 3559, 3952, 4527, 5201, 6036, 6577, 7148]","[528, 766, 1053, 1530, 1833, 2122, 2547, 3217, 3627, 4332, 4553, 5203, 5533, 6167, 6795]","[260, 387, 477, 726, 1468, 1637, 1727, 1817, 1955, 2290, 2499, 3015, 3261, 3655, 4061]","[312, 402, 492, 622, 770, 918, 1033, 1161, 1289, 1564, 1790, 2019, 2194, 2403, 2865]",6452,7148,6795,4061,2865,2237,-216,954,31,556,3562,15,dire
7568789619,94,29,106,123,68,"[0, 416, 630, 921, 1212, 1378, 1586, 1844, 2062, 2361, 2960, 3462, 3815, 4634, 5345]","[0, 288, 697, 1159, 1535, 2110, 2650, 3193, 3789, 4283, 5184, 5402, 5492, 6204, 6559]","[0, 170, 374, 769, 1084, 1342, 1669, 2080, 2736, 3356, 3876, 4128, 4491, 4786, 5162]","[100, 346, 436, 653, 743, 1089, 1228, 1318, 1707, 2003, 2347, 2523, 3024, 3555, 4090]","[0, 284, 374, 591, 745, 1162, 1252, 1348, 1692, 1925, 2269, 2422, 2609, 2899, 3171]",5345,6559,5162,4090,3171,41,49,47,19,58,"[0, 205, 495, 854, 1271, 1742, 2330, 2733, 3272, 3812, 4344, 4868, 5691, 6340, 6698]","[0, 251, 508, 722, 1081, 1257, 1944, 2532, 3238, 3689, 4002, 4405, 5112, 5433, 5955]","[0, 272, 430, 826, 1122, 1589, 1810, 2297, 2557, 2852, 3123, 3338, 3832, 4495, 4671]","[100, 570, 828, 1268, 1406, 1737, 1827, 2031, 2440, 2530, 2710, 2865, 3438, 3774, 4006]","[0, 571, 661, 879, 1033, 1123, 1422, 1663, 1942, 2139, 2603, 2796, 3246, 3689, 3931]",6698,5955,4671,4006,3931,-1353,604,491,84,-760,-934,15,radiant
7569025607,21,74,112,85,7,"[0, 169, 440, 875, 1064, 1601, 1967, 2422, 2718, 3249, 3615, 3967, 4956, 5443, 5818]","[0, 243, 536, 731, 1000, 1595, 2003, 2389, 2762, 3222, 3564, 4273, 4905, 5425, 6015]","[0, 205, 295, 665, 755, 1246, 1617, 1954, 2183, 2769, 3020, 3764, 4335, 4936, 5614]","[0, 130, 220, 798, 888, 1484, 1714, 2189, 2279, 2820, 3036, 3246, 3946, 4219, 4664]","[0, 130, 220, 349, 456, 763, 898, 1033, 1157, 1569, 1704, 2083, 2531, 2814, 3197]",5818,6015,5614,4664,3197,126,15,96,27,26,"[0, 367, 643, 1012, 1373, 1621, 1950, 2209, 2669, 3203, 3626, 3904, 4262, 4448, 4543]","[0, 170, 368, 496, 694, 1040, 1355, 1648, 2197, 2565, 3193, 3365, 3863, 4198, 5215]","[0, 204, 444, 724, 973, 1108, 1531, 1655, 2025, 2288, 2548, 2816, 2951, 3100, 3435]","[0, 170, 260, 350, 440, 530, 667, 792, 1066, 1347, 1485, 1575, 1665, 1977, 2154]","[0, 213, 303, 393, 521, 655, 793, 883, 1150, 1334, 1617, 1735, 1825, 1974, 2118]",4543,5215,3435,2154,2118,1275,800,2179,2510,1079,7843,15,radiant
7569048715,70,36,96,27,68,"[0, 205, 534, 852, 1280, 1745, 2160, 2540, 3443, 3983, 4470, 4965, 5451, 5957, 6439]","[0, 206, 571, 820, 1220, 1682, 2103, 2426, 2807, 3197, 3710, 4515, 5392, 5986, 6550]","[0, 279, 625, 786, 1147, 1521, 1648, 1774, 2196, 2320, 2632, 3157, 3653, 4139, 4467]","[0, 270, 378, 798, 1095, 1230, 1365, 1555, 1842, 1932, 2068, 2623, 3075, 3382, 3537]","[0, 170, 260, 350, 528, 894, 1035, 1125, 1338, 1428, 1567, 1865, 2229, 2492, 2914]",6439,6550,4467,3537,2914,95,50,98,102,83,"[0, 170, 444, 570, 940, 1030, 1325, 1848, 2192, 2493, 2738, 3031, 3802, 4209, 4529]","[0, 327, 485, 683, 1146, 1438, 1688, 2396, 2625, 3130, 3480, 4042, 4620, 4823, 5140]","[0, 283, 373, 587, 777, 935, 1180, 1610, 1890, 1998, 2257, 2401, 3047, 3310, 3887]","[0, 204, 381, 471, 640, 764, 898, 1037, 1264, 1354, 1444, 1579, 1979, 2119, 2316]","[0, 270, 360, 450, 540, 630, 720, 1079, 1259, 1349, 1486, 1576, 1962, 2056, 2250]",4529,5140,3887,2316,2250,1910,1410,580,1221,664,5785,15,radiant
7569050306,41,13,97,50,87,"[0, 241, 589, 986, 1403, 1770, 2134, 2521, 2924, 3181, 3425, 3913, 4496, 4782, 5179]","[0, 169, 503, 826, 1096, 1351, 1646, 2092, 2419, 2672, 2919, 3120, 3946, 4397, 5481]","[0, 320, 448, 794, 1328, 1812, 2352, 3082, 3326, 3739, 4156, 4380, 4638, 5119, 5573]","[0, 169, 259, 427, 552, 876, 966, 1104, 1263, 1353, 1849, 2022, 2382, 2631, 3288]","[0, 169, 272, 452, 621, 794, 1101, 1428, 1518, 1675, 1765, 1960, 2320, 2628, 3014]",5179,5481,5573,3288,3014,113,102,81,40,27,"[0, 326, 526, 951, 1617, 1958, 2299, 2706, 3037, 3731, 4092, 4218, 5381, 6264, 6359]","[0, 208, 470, 693, 1012, 1409, 1556, 1782, 1987, 2179, 2269, 2619, 3209, 3919, 4077]","[0, 204, 425, 784, 914, 1125, 1574, 1830, 2269, 2645, 2894, 3144, 3519, 3986, 4343]","[0, 169, 259, 395, 559, 748, 883, 1066, 1294, 1431, 1608, 1698, 2568, 2753, 2848]","[0, 169, 259, 459, 634, 805, 895, 1030, 1159, 1306, 1537, 1790, 2042, 2790, 2885]",6359,4077,4343,2848,2885,-1180,1404,1230,440,129,2023,15,dire
7569069818,25,63,28,20,31,"[0, 291, 875, 1409, 1895, 2146, 2702, 3413, 3946, 4666, 5604, 6378, 7244, 8273, 8983]","[0, 286, 569, 810, 1100, 1371, 1820, 2378, 2540, 3066, 3651, 3991, 4375, 5050, 5690]","[0, 205, 587, 786, 1328, 1453, 1891, 2312, 3070, 3601, 4294, 4921, 5279, 6047, 6591]","[0, 130, 384, 474, 949, 1155, 1846, 2120, 2545, 3014, 3431, 3767, 4292, 4685, 5048]","[0, 130, 220, 358, 488, 578, 1208, 1433, 1634, 1724, 2141, 2637, 2877, 3225, 3373]",8983,5690,6591,5048,3373,93,13,102,107,30,"[0, 210, 373, 987, 1165, 1542, 1737, 1976, 2976, 3145, 3271, 3716, 3944, 4354, 4948]","[0, 321, 611, 854, 1225, 1507, 1672, 1957, 2283, 2864, 3098, 3622, 3819, 4402, 4638]","[0, 247, 411, 617, 937, 1139, 1435, 1602, 2103, 2316, 2742, 3179, 3303, 3485, 3656]","[0, 269, 359, 479, 666, 756, 846, 1271, 1659, 1943, 2033, 2339, 2429, 2795, 2936]","[0, 537, 627, 821, 911, 1049, 1401, 1601, 1840, 1969, 2093, 2238, 2328, 2563, 2811]",4948,4638,3656,2936,2811,4035,1052,2935,2112,562,10696,15,radiant
7569216703,120,21,96,79,20,"[63, 309, 573, 929, 1341, 1735, 2065, 2509, 2931, 3469, 3559, 3874, 4565, 5025, 5800]","[63, 233, 514, 968, 1333, 1985, 2202, 2678, 3120, 3518, 3955, 4429, 5261, 5767, 6485]","[63, 277, 402, 724, 1242, 1366, 1583, 1952, 2299, 2666, 3445, 3973, 4226, 5017, 5839]","[331, 501, 591, 916, 1172, 1262, 1709, 2276, 2366, 2658, 2843, 3014, 3325, 3783, 3970]","[63, 278, 414, 551, 721, 960, 1050, 1251, 1341, 1746, 1931, 2319, 2409, 2594, 2833]",5800,6485,5839,3970,2833,48,13,69,58,119,"[0, 170, 445, 694, 1110, 1527, 1790, 1985, 2535, 3028, 3471, 3851, 4597, 5361, 5735]","[0, 327, 646, 1062, 1295, 1671, 2033, 2414, 2704, 3202, 3834, 4334, 4757, 5375, 5976]","[0, 170, 688, 934, 1186, 1315, 1883, 2118, 2428, 2669, 2996, 3620, 4020, 4685, 5448]","[0, 172, 262, 400, 537, 914, 1300, 1390, 1565, 1655, 2284, 2613, 2930, 3575, 3753]","[0, 170, 414, 504, 594, 684, 774, 864, 954, 1044, 1384, 1611, 1823, 2250, 2431]",5735,5976,5448,3753,2431,65,509,391,217,402,1584,15,dire
7569457300,94,17,137,105,58,"[2, 362, 646, 1006, 1293, 1821, 2260, 2522, 2916, 3293, 3660, 4244, 5080, 5713, 6563]","[0, 403, 766, 1104, 1515, 1861, 2489, 2816, 3292, 3637, 4210, 4764, 5069, 5627, 5957]","[0, 249, 569, 825, 1067, 1357, 1814, 2310, 2779, 3309, 3861, 3951, 4438, 4752, 5263]","[0, 210, 339, 429, 519, 662, 992, 1127, 1300, 1390, 1525, 1997, 2087, 2333, 2704]","[0, 212, 302, 392, 498, 681, 1095, 1230, 1560, 1717, 1921, 2297, 2424, 2760, 2901]",6563,5957,5263,2704,2901,89,49,28,65,121,"[0, 502, 769, 1126, 1715, 2222, 2745, 3096, 3609, 4184, 4754, 5371, 6159, 6658, 7361]","[0, 324, 597, 1013, 1434, 1858, 2255, 2639, 3160, 3875, 4530, 5066, 5741, 6410, 6906]","[0, 235, 603, 919, 1328, 1528, 1968, 2445, 2808, 3130, 3657, 4145, 4325, 4465, 5169]","[0, 200, 314, 434, 585, 804, 1271, 1704, 1870, 2234, 2715, 2808, 3061, 3811, 4208]","[0, 243, 333, 633, 847, 1083, 1289, 1523, 1613, 1842, 2096, 2186, 2441, 2762, 2911]",7361,6906,5169,4208,2911,-798,-949,94,-1504,-10,-3167,15,dire
7569609418,10,98,106,19,3,"[0, 245, 573, 936, 1312, 1728, 2058, 2533, 3124, 3687, 4130, 4878, 5421, 6006, 6599]","[0, 241, 439, 794, 1052, 1579, 1823, 1950, 2659, 2949, 3420, 3609, 4382, 4948, 5527]","[0, 245, 410, 766, 1013, 1300, 1542, 2195, 2659, 3139, 3499, 3861, 4623, 4998, 5410]","[0, 217, 375, 511, 644, 927, 1183, 1307, 1594, 1891, 2405, 2495, 3138, 3675, 3769]","[0, 170, 260, 396, 542, 700, 836, 972, 1279, 1459, 1662, 1851, 2494, 2726, 2820]",6599,5527,5410,3769,2820,70,76,78,20,112,"[0, 204, 569, 983, 1386, 1778, 2493, 3191, 3650, 4065, 4622, 5548, 6157, 6633, 7266]","[0, 208, 516, 857, 1179, 1469, 1902, 2119, 2474, 3263, 3583, 3877, 4233, 4911, 5946]","[0, 209, 334, 621, 989, 1165, 1558, 1889, 2097, 2397, 2895, 3209, 3508, 3756, 4239]","[100, 270, 748, 933, 1368, 1502, 2002, 2175, 2280, 2732, 3142, 3318, 3606, 4002, 4538]","[0, 170, 260, 433, 591, 735, 951, 1092, 1182, 1328, 1463, 1698, 1919, 2318, 2661]",7266,5946,4239,4538,2661,-667,-419,1171,-769,159,-525,15,dire
7569767419,82,17,96,123,110,"[173, 462, 1104, 1376, 1657, 2076, 2787, 3366, 3751, 4332, 4672, 5262, 5815, 6695, 7682]","[116, 441, 716, 1167, 1491, 1864, 2250, 2659, 3006, 3650, 4027, 4336, 4805, 5109, 5294]","[173, 302, 559, 1036, 1351, 1700, 2223, 2868, 3199, 3543, 4091, 4351, 4987, 5619, 6181]","[574, 703, 902, 1259, 1447, 1777, 2044, 2179, 2355, 2494, 3052, 3452, 3637, 3822, 4216]","[306, 435, 850, 1178, 1268, 1358, 1538, 1673, 1808, 1898, 2033, 2123, 2213, 2448, 2633]",7682,5294,6181,4216,2633,49,120,112,128,136,"[0, 278, 567, 1097, 1437, 1649, 2057, 2406, 2813, 3541, 3888, 4316, 4735, 5550, 6344]","[163, 393, 798, 1105, 1474, 1863, 2546, 3019, 3442, 3888, 4222, 4615, 5160, 5980, 6336]","[429, 583, 707, 1600, 1805, 1895, 2316, 2722, 3196, 3711, 4077, 4167, 4626, 5370, 5745]","[163, 317, 407, 635, 811, 911, 1081, 1314, 1491, 1730, 1865, 2000, 2410, 3102, 3197]","[81, 272, 362, 744, 874, 964, 1236, 1626, 1801, 1992, 2308, 2683, 2906, 3424, 3519]",6344,6336,5745,3197,3519,1338,-1042,436,1019,-886,865,15,radiant
7569807712,21,67,1,37,97,"[0, 129, 328, 695, 833, 1280, 1526, 2211, 2601, 3140, 3665, 3755, 4107, 4557, 5119]","[0, 245, 523, 871, 1189, 1574, 2212, 2633, 3020, 3355, 3532, 3955, 4636, 4873, 4968]","[0, 288, 575, 980, 1337, 1464, 1911, 2299, 2495, 2935, 3158, 3495, 4287, 4419, 4754]","[0, 129, 234, 369, 503, 628, 919, 1155, 1291, 1494, 1584, 1718, 2667, 2926, 3057]","[0, 129, 254, 390, 518, 756, 931, 1210, 1348, 1474, 1701, 1818, 2059, 2346, 2522]",5119,4968,4754,3057,2522,82,120,69,68,20,"[0, 247, 482, 771, 1440, 1713, 2314, 2893, 3369, 3959, 4614, 5162, 5944, 6870, 8081]","[0, 291, 652, 966, 1458, 1668, 2530, 2880, 3260, 3829, 4314, 5006, 5646, 6149, 6943]","[0, 209, 443, 892, 1226, 1810, 2078, 2541, 2863, 3703, 4114, 4624, 4956, 5777, 6209]","[0, 209, 299, 476, 638, 772, 993, 1173, 1263, 1790, 2499, 2672, 3206, 3546, 4056]","[0, 209, 299, 443, 533, 1007, 1421, 1759, 1849, 2077, 2433, 2658, 2891, 3286, 3757]",8081,6943,6209,4056,3757,-2962,-1975,-1455,-999,-1235,-8626,15,dire
7569905905,48,76,33,53,26,"[0, 255, 519, 1093, 1468, 1841, 2430, 2854, 3309, 3497, 4006, 4635, 5187, 5804, 6151]","[0, 248, 601, 879, 1441, 1729, 2077, 2335, 2720, 3107, 3568, 3811, 4281, 4754, 5336]","[0, 280, 925, 1466, 2075, 2482, 3093, 3801, 4472, 5119, 5570, 5940, 6446, 6611, 7389]","[0, 210, 341, 519, 789, 923, 1077, 1806, 2121, 2421, 2902, 3121, 3590, 4402, 4749]","[0, 210, 394, 552, 744, 834, 1056, 1732, 1958, 2379, 2559, 2649, 2758, 3032, 3287]",6151,5336,7389,4749,3287,98,41,112,3,100,"[0, 203, 499, 831, 1113, 1454, 1967, 2375, 2794, 3905, 4542, 4791, 5078, 6049, 6416]","[0, 279, 578, 943, 1195, 1478, 1759, 2013, 2564, 2960, 3401, 4217, 4465, 5233, 5551]","[0, 205, 687, 820, 969, 1211, 1508, 2066, 2450, 2592, 3773, 4239, 4588, 5726, 6109]","[0, 130, 257, 367, 610, 700, 889, 979, 1159, 1604, 2026, 2287, 2377, 2815, 3255]","[0, 130, 309, 399, 549, 639, 729, 948, 1128, 1573, 1763, 2024, 2197, 2917, 3449]",6416,5551,6109,3255,3449,-265,-215,1280,1494,-162,2132,15,radiant
7569953309,46,74,120,65,26,"[0, 541, 942, 1239, 1732, 2097, 2597, 3235, 3721, 4369, 5008, 5358, 5831, 6678, 7268]","[0, 264, 662, 791, 1276, 1448, 2039, 2250, 2761, 3239, 3574, 3814, 4532, 5103, 5684]","[0, 192, 589, 1049, 1266, 1659, 2100, 2394, 2848, 3298, 3857, 4042, 4263, 4920, 5530]","[0, 130, 220, 573, 728, 931, 1243, 1450, 1540, 1750, 2200, 2486, 2576, 3176, 3711]","[0, 192, 362, 549, 639, 897, 1083, 1219, 1459, 1711, 2102, 2192, 2349, 2676, 2794]",7268,5684,5530,3711,2794,49,135,59,123,72,"[0, 247, 640, 926, 1499, 1915, 2507, 2889, 3613, 4396, 4950, 5533, 6114, 6777, 7426]","[0, 248, 710, 1031, 1528, 1957, 2416, 3202, 3676, 4122, 5141, 5992, 6504, 7052, 7758]","[0, 332, 633, 941, 1235, 1568, 1861, 2303, 2752, 3327, 4259, 4751, 5451, 6247, 6558]","[0, 210, 402, 976, 1066, 1707, 1866, 2168, 2348, 2600, 2958, 3227, 3654, 4094, 4631]","[0, 210, 372, 462, 561, 814, 904, 994, 1174, 1591, 1841, 2163, 2379, 2684, 2832]",7426,7758,6558,4631,2832,-158,-2074,-1028,-920,-38,-4218,15,dire
7570096908,94,97,106,26,90,"[0, 251, 379, 671, 1035, 1412, 1875, 2263, 2646, 3072, 3510, 4090, 4686, 5315, 5898]","[0, 248, 608, 1059, 1436, 2038, 2337, 3205, 3544, 3963, 4579, 5059, 5463, 5597, 6271]","[0, 208, 567, 937, 1273, 1928, 2257, 2580, 3080, 3419, 4139, 4264, 4443, 4943, 5176]","[0, 170, 260, 565, 655, 867, 973, 1505, 1685, 2108, 2243, 2382, 2487, 2768, 3037]","[0, 170, 260, 398, 575, 700, 835, 1064, 1283, 1803, 1945, 2092, 2411, 2554, 2835]",5898,6271,5176,3037,2835,48,29,50,45,84,"[0, 209, 546, 787, 877, 1171, 1503, 1631, 2148, 2485, 2753, 3338, 3936, 4508, 5210]","[0, 206, 644, 971, 1322, 1576, 1842, 2228, 2753, 3014, 3457, 4217, 4973, 5530, 6412]","[0, 281, 597, 927, 1178, 1456, 2000, 2719, 2967, 3142, 3925, 4227, 5156, 6023, 6847]","[0, 170, 285, 419, 509, 699, 824, 1086, 1299, 1427, 1773, 2002, 2378, 2657, 3376]","[0, 170, 324, 414, 504, 679, 769, 859, 1035, 1162, 1297, 1532, 1852, 2234, 2472]",5210,6412,6847,3376,2472,688,-141,-1671,-339,363,-1100,15,dire
7570164716,74,41,45,14,3,"[0, 404, 788, 1274, 1514, 1934, 2388, 2781, 3407, 3784, 3964, 4584, 5166, 6575, 7143]","[0, 247, 423, 683, 1029, 1270, 1501, 1704, 1947, 2362, 2759, 3333, 4124, 4685, 5075]","[0, 358, 702, 1072, 1605, 2150, 2557, 2770, 3115, 3402, 4022, 4138, 4795, 5162, 5503]","[0, 545, 871, 1005, 1530, 1700, 1851, 2128, 2509, 2649, 2829, 3195, 3724, 4521, 4615]","[0, 210, 300, 410, 572, 791, 993, 1176, 1378, 1503, 1734, 1966, 2056, 2758, 2852]",7143,5075,5503,4615,2852,43,13,63,64,26,"[0, 257, 541, 902, 1112, 1421, 1996, 2086, 2786, 3761, 4440, 5168, 5812, 5994, 6881]","[0, 205, 744, 974, 1344, 1553, 1820, 2082, 2448, 3130, 3737, 4015, 4384, 4603, 4875]","[0, 177, 393, 689, 825, 1267, 1845, 2185, 2527, 2847, 3188, 3722, 3977, 4350, 4899]","[0, 130, 220, 310, 500, 607, 1093, 1183, 1583, 2079, 2721, 2902, 3622, 4051, 4498]","[0, 130, 254, 388, 478, 602, 706, 845, 1025, 1445, 1867, 2344, 2822, 3295, 3505]",6881,4875,4899,4498,3505,262,200,604,117,-653,530,15,dire
7570182918,23,48,100,53,20,"[0, 333, 650, 1103, 1345, 1804, 2390, 2874, 3455, 4405, 4973, 5412, 6312, 6705, 7575]","[0, 280, 546, 1010, 1335, 1635, 2083, 2463, 2916, 3350, 3992, 4547, 5299, 5962, 7022]","[0, 207, 855, 1137, 1539, 1867, 2320, 2594, 3169, 3614, 3860, 4373, 5064, 5492, 6070]","[0, 169, 259, 658, 748, 885, 1255, 1501, 1764, 2014, 2320, 2731, 3277, 3816, 4258]","[0, 169, 327, 464, 822, 972, 1107, 1366, 1587, 1677, 1812, 2125, 2717, 2964, 3544]",7575,7022,6070,4258,3544,14,54,29,86,26,"[0, 245, 594, 980, 1616, 1840, 2213, 2397, 3249, 3426, 4071, 4543, 5218, 5889, 6425]","[0, 205, 670, 1083, 1333, 1805, 2171, 2771, 2926, 3215, 3848, 4037, 4578, 5242, 5723]","[0, 203, 511, 762, 1100, 1548, 1986, 2165, 2589, 3051, 3566, 4051, 4448, 4830, 4979]","[0, 169, 284, 604, 734, 945, 1035, 1170, 1820, 1910, 2450, 2850, 3010, 3105, 3614]","[0, 169, 284, 457, 631, 761, 897, 1077, 1408, 1517, 1887, 2026, 2186, 2399, 2583]",6425,5723,4979,3614,2583,1150,1299,1091,644,961,5145,15,radiant
7570202102,35,47,25,110,31,"[0, 325, 526, 990, 1440, 1785, 2313, 2727, 3249, 3576, 4057, 4536, 5311, 5851, 6282]","[0, 518, 774, 971, 1299, 1782, 2114, 2432, 3023, 3489, 4396, 4730, 5245, 5588, 6298]","[0, 244, 640, 972, 1381, 1541, 1938, 2434, 3288, 3459, 3762, 4021, 4389, 4767, 5228]","[0, 213, 303, 393, 531, 840, 993, 1211, 1529, 1740, 2009, 2099, 2189, 2568, 3172]","[0, 130, 220, 376, 466, 563, 653, 854, 1167, 1257, 1514, 1604, 1808, 1957, 2244]",6282,6298,5228,3172,2244,17,21,57,58,64,"[0, 362, 696, 1055, 1258, 1541, 1964, 2230, 2717, 2937, 3778, 4533, 4938, 5211, 6178]","[0, 333, 622, 837, 1086, 1495, 1870, 2369, 2659, 2985, 3296, 3750, 4239, 4544, 5250]","[0, 210, 537, 847, 1229, 1554, 1918, 2284, 2540, 2793, 3350, 4000, 4090, 4723, 5332]","[0, 210, 317, 463, 593, 767, 938, 1170, 1555, 1827, 1962, 2616, 2833, 3076, 3446]","[0, 210, 300, 436, 611, 975, 1109, 1294, 1429, 1603, 1900, 2806, 3130, 3306, 3693]",6178,5250,5332,3446,3693,104,1048,-104,-274,-1449,-675,15,dire
7570367219,48,25,137,65,20,"[1251, 1551, 2430, 2981, 3504, 4038, 4669, 5468, 6456, 7222, 8173, 8815, 9760, 10512, 11282]","[1719, 2093, 2548, 2928, 3597, 3966, 4578, 5109, 5886, 6356, 7044, 7854, 8519, 9018, 9714]","[1411, 1591, 1963, 2720, 3261, 3724, 4435, 4525, 5032, 5282, 5743, 5982, 6680, 7265, 7732]","[673, 781, 1177, 1496, 1913, 2003, 2459, 2549, 2821, 3136, 3363, 3688, 4099, 4194, 4327]","[925, 1105, 1362, 1636, 2062, 2181, 2452, 2592, 2818, 2913, 3115, 3263, 3402, 3497, 3797]",11282,9714,7732,4327,3797,10,106,69,110,26,"[1265, 1560, 1935, 2362, 2785, 3288, 3897, 4432, 4749, 5374, 6015, 6794, 7637, 9100, 9724]","[1183, 1442, 2145, 2561, 3128, 3548, 4119, 4506, 4796, 5227, 5953, 6750, 7502, 8138, 8699]","[1077, 1453, 1883, 2380, 2624, 2971, 3697, 4338, 4684, 5248, 5667, 6574, 7140, 7618, 8162]","[440, 613, 974, 1109, 1329, 1683, 1939, 2295, 2443, 2766, 3067, 3437, 3697, 4157, 4298]","[533, 664, 937, 1072, 1292, 1481, 1616, 1799, 2034, 2228, 2589, 3020, 3272, 3692, 3910]",9724,8699,8162,4298,3910,1558,1015,-430,29,-113,2059,15,dire
7570395410,95,135,120,138,5,"[0, 257, 500, 856, 1248, 1457, 2064, 2327, 2831, 3377, 4122, 4642, 5238, 6171, 6740]","[0, 295, 631, 795, 1177, 1502, 1933, 2271, 2755, 3306, 3942, 4377, 4790, 5701, 6461]","[0, 206, 494, 788, 1011, 1544, 1713, 2057, 2617, 3034, 3717, 4121, 4661, 5513, 6124]","[0, 170, 304, 394, 532, 778, 998, 1258, 1774, 1909, 2088, 2186, 2528, 3057, 3349]","[0, 170, 260, 397, 536, 646, 829, 1008, 1175, 1349, 1536, 1626, 1964, 2495, 3046]",6740,6461,6124,3349,3046,18,49,137,9,58,"[0, 246, 559, 720, 1142, 1613, 1976, 2489, 3008, 3626, 4259, 5099, 5623, 6066, 6676]","[0, 400, 690, 1010, 1315, 1560, 1936, 2391, 2728, 3286, 3750, 4337, 4725, 4909, 5405]","[0, 209, 444, 680, 1049, 1475, 1685, 2091, 2554, 2860, 3303, 4005, 4293, 4700, 5031]","[0, 217, 397, 585, 832, 1033, 1123, 1302, 1392, 1788, 1949, 2307, 2504, 2807, 3026]","[0, 170, 260, 350, 559, 716, 855, 1084, 1228, 1438, 1627, 1973, 2245, 2590, 2789]",6676,5405,5031,3026,2789,64,1056,1093,323,257,2793,15,radiant
7570460816,25,71,44,69,85,"[0, 247, 577, 958, 1412, 2004, 2504, 2945, 3548, 3972, 4688, 5292, 5782, 6314, 6979]","[0, 283, 556, 902, 1440, 2073, 2455, 2903, 3251, 3784, 4551, 4741, 5226, 5665, 6349]","[0, 239, 482, 1095, 1417, 1625, 1974, 2394, 2789, 3235, 3430, 4036, 4572, 4994, 5448]","[0, 130, 275, 451, 942, 1218, 1498, 1716, 1949, 2143, 2550, 2870, 3131, 3835, 4101]","[0, 130, 220, 604, 734, 824, 1016, 1153, 1243, 1333, 1423, 1674, 1936, 2084, 2269]",6979,6349,5448,4101,2269,77,10,126,29,86,"[0, 366, 649, 1063, 1428, 1826, 2162, 2658, 3048, 3632, 4755, 5052, 5347, 5864, 6356]","[0, 373, 540, 811, 1225, 1404, 1822, 2388, 2649, 3076, 3423, 3765, 4413, 4773, 5214]","[0, 332, 577, 871, 1176, 1507, 1913, 2356, 2817, 2943, 3219, 3790, 4407, 4845, 5532]","[0, 210, 300, 435, 574, 664, 881, 1065, 1321, 1411, 2017, 2187, 2391, 2795, 3215]","[0, 210, 300, 390, 480, 789, 879, 1106, 1196, 1370, 1922, 2073, 2288, 2657, 3226]",6356,5214,5532,3215,3226,623,1135,-84,886,-957,1603,15,radiant
7570468116,49,80,28,86,3,"[0, 247, 614, 1093, 1370, 2068, 2367, 2927, 3419, 3768, 4350, 4565, 5527, 6179, 6725]","[0, 206, 409, 684, 927, 1366, 1692, 1986, 2357, 2820, 3290, 3719, 4602, 5125, 5582]","[0, 212, 636, 979, 1395, 1771, 2155, 2698, 3141, 3651, 4115, 4354, 5080, 5549, 5872]","[0, 129, 269, 481, 728, 905, 1040, 1168, 1483, 1573, 1753, 2150, 2537, 3185, 3588]","[0, 129, 564, 911, 1050, 1230, 1836, 1926, 2147, 2237, 2417, 2617, 3091, 3497, 3752]",6725,5582,5872,3588,3752,89,17,71,26,85,"[0, 243, 605, 950, 1233, 1571, 1947, 2418, 3002, 3329, 3806, 4474, 4971, 5945, 6748]","[0, 365, 734, 1149, 1374, 1791, 2167, 2422, 3098, 3861, 4208, 4589, 4974, 5234, 5795]","[0, 209, 440, 902, 1189, 1521, 1878, 2172, 2628, 3255, 3445, 3889, 4398, 4808, 5539]","[0, 209, 299, 635, 725, 908, 1159, 1249, 1697, 1826, 2100, 2467, 2937, 3106, 3681]","[0, 209, 344, 464, 601, 1035, 1169, 1319, 1735, 1825, 2080, 2308, 2616, 2779, 3061]",6748,5795,5539,3681,3061,-23,-213,333,-93,691,695,15,radiant
7570519515,82,49,51,66,86,"[0, 215, 484, 718, 1082, 1442, 1771, 2252, 2831, 3575, 4187, 4867, 5373, 6114, 6649]","[0, 220, 575, 980, 1426, 1805, 2203, 2805, 3143, 3438, 3813, 4331, 4930, 5354, 5603]","[0, 202, 443, 964, 1251, 1719, 2011, 2551, 2997, 3296, 3985, 4639, 5048, 5748, 5880]","[0, 130, 220, 310, 471, 674, 852, 1102, 1276, 1366, 1716, 1827, 2042, 2571, 2779]","[0, 130, 220, 432, 522, 631, 727, 907, 1042, 1207, 1367, 1542, 1632, 2078, 2345]",6649,5603,5880,2779,2345,10,129,23,58,105,"[0, 262, 541, 890, 1259, 1813, 2311, 2681, 3169, 3647, 4321, 4877, 5530, 6150, 6695]","[0, 336, 580, 1306, 1740, 2335, 2828, 3375, 3952, 4652, 5137, 5891, 6634, 7392, 7903]","[0, 253, 622, 1006, 1376, 1758, 2141, 2546, 3145, 3737, 4450, 4788, 5240, 5952, 6609]","[0, 210, 300, 420, 510, 689, 839, 1125, 1323, 1719, 1979, 2288, 2414, 2633, 2961]","[0, 210, 300, 490, 580, 710, 845, 1155, 1377, 1626, 2152, 2371, 2655, 2840, 3127]",6695,7903,6609,2961,3127,-46,-2300,-729,-182,-782,-4039,15,radiant
7570561812,15,19,96,20,112,"[0, 207, 530, 862, 1137, 1542, 1863, 2199, 2568, 2858, 3831, 4327, 5008, 5400, 5646]","[0, 283, 564, 969, 1250, 1453, 1801, 2201, 2674, 3060, 3851, 4688, 5044, 5934, 6539]","[0, 419, 720, 885, 1206, 1444, 1900, 2490, 2894, 3180, 3680, 4249, 4740, 5465, 5922]","[0, 169, 259, 397, 522, 892, 1084, 1174, 1264, 1490, 1724, 1995, 2131, 2614, 3040]","[0, 249, 339, 467, 641, 731, 861, 1071, 1206, 1341, 1615, 1896, 2082, 2457, 2939]",5646,6539,5922,3040,2939,1,49,61,62,123,"[0, 242, 533, 975, 1343, 1771, 2263, 2547, 2768, 3515, 3776, 4287, 5077, 5172, 5896]","[0, 208, 405, 730, 977, 1301, 1680, 1946, 2583, 3109, 3388, 3761, 4378, 4824, 5027]","[0, 602, 887, 1094, 1371, 1536, 2032, 2766, 3162, 3514, 4135, 4563, 5045, 5645, 6410]","[100, 327, 417, 531, 693, 827, 1027, 1182, 1398, 1533, 2492, 3119, 3389, 3520, 4437]","[0, 227, 317, 430, 553, 784, 964, 1192, 1282, 1545, 1816, 2035, 2305, 2422, 2625]",5896,5027,6410,4437,2625,-250,1512,-488,-1397,314,-309,15,radiant
7570722909,46,41,38,138,91,"[0, 246, 577, 941, 1214, 1550, 1966, 2346, 2921, 3368, 3855, 4511, 5119, 5650, 6085]","[0, 163, 343, 814, 972, 1335, 1786, 2247, 2883, 3156, 3706, 4428, 4845, 5362, 5886]","[0, 247, 418, 710, 983, 1110, 1498, 1676, 2254, 2682, 3053, 3656, 3782, 4142, 4977]","[0, 166, 301, 491, 594, 684, 915, 1176, 1266, 1555, 1825, 2271, 2362, 2538, 2736]","[0, 129, 300, 439, 529, 666, 838, 1017, 1256, 1383, 1478, 1736, 1877, 2102, 2295]",6085,5886,4977,2736,2295,113,21,17,58,88,"[0, 256, 575, 862, 1576, 2010, 2557, 3207, 3542, 4096, 4872, 5804, 6604, 7397, 8004]","[0, 253, 423, 754, 1103, 1507, 1894, 2341, 2763, 3165, 3819, 4243, 4686, 5152, 5625]","[0, 374, 624, 906, 1246, 1552, 1790, 2203, 2761, 3129, 3883, 4327, 4969, 5460, 6078]","[0, 209, 299, 389, 670, 981, 1309, 1897, 1987, 2408, 2917, 3244, 3505, 3791, 4028]","[0, 209, 386, 476, 689, 845, 984, 1119, 1357, 1482, 1989, 2079, 2614, 2811, 3006]",8004,5625,6078,4028,3006,-1919,261,-1101,-1292,-711,-4762,15,dire
7570740708,49,35,28,53,123,"[0, 170, 547, 788, 999, 1303, 1687, 2162, 2612, 3049, 3327, 3942, 4473, 5001, 5729]","[0, 297, 487, 893, 1120, 1518, 1745, 1967, 2383, 2732, 3242, 3879, 4599, 5168, 5701]","[0, 284, 572, 986, 1542, 2333, 2868, 3512, 4115, 4407, 5695, 5903, 6869, 7602, 8199]","[0, 170, 285, 375, 549, 729, 1031, 1242, 1625, 1806, 1986, 2326, 2659, 3168, 3653]","[0, 170, 285, 375, 559, 864, 1041, 1243, 1359, 1969, 2149, 2281, 2695, 2987, 3291]",5729,5701,8199,3653,3291,73,43,29,105,20,"[0, 289, 695, 1056, 1442, 1678, 2215, 3180, 3346, 3634, 3892, 4578, 5036, 5819, 6782]","[0, 291, 653, 1028, 1413, 1938, 2514, 3220, 3749, 4598, 5457, 5973, 6194, 6715, 7242]","[0, 291, 612, 935, 1360, 1724, 2040, 2577, 2725, 3254, 3790, 4302, 4784, 5381, 5932]","[0, 170, 260, 703, 958, 1048, 1221, 1615, 2014, 2277, 2542, 2772, 3177, 3451, 3722]","[100, 322, 412, 549, 639, 959, 1116, 1412, 1578, 1834, 2044, 2229, 2326, 2566, 2761]",6782,7242,5932,3722,2761,-1053,-1541,2267,-69,530,134,15,dire
7570812500,10,17,123,38,21,"[0, 242, 521, 717, 1095, 1546, 1893, 2256, 2796, 3431, 3763, 4589, 5462, 6242, 6650]","[0, 277, 602, 970, 1370, 1682, 2193, 2752, 3351, 3889, 4443, 4780, 5879, 6597, 6958]","[0, 317, 407, 595, 798, 1019, 1352, 1536, 1626, 1716, 1851, 2253, 3065, 3550, 4066]","[0, 239, 505, 788, 1338, 1719, 1944, 2325, 2887, 3069, 3416, 4088, 4722, 5421, 5806]","[0, 221, 360, 453, 717, 891, 1142, 1325, 1545, 1804, 2006, 2308, 2959, 3297, 3493]",6650,6958,4066,5806,3493,95,57,98,37,86,"[0, 209, 561, 975, 1173, 1578, 1811, 2659, 3034, 3332, 3894, 4211, 4844, 5431, 5942]","[0, 294, 623, 1036, 1373, 1672, 1879, 2425, 2826, 3174, 3662, 4171, 4380, 4740, 5005]","[0, 258, 458, 820, 1093, 1420, 1802, 2013, 2229, 2546, 2935, 3202, 3292, 3630, 4341]","[0, 170, 260, 398, 528, 618, 727, 817, 952, 1077, 1304, 1443, 1667, 1875, 2214]","[0, 170, 260, 395, 573, 953, 1095, 1309, 1488, 1613, 1901, 2065, 2155, 2295, 2443]",5942,5005,4341,2214,2443,708,1953,-275,3592,1050,7028,15,dire
7570954607,36,67,21,37,79,"[0, 244, 658, 1036, 1409, 1786, 2236, 2916, 3346, 3840, 4257, 4541, 5085, 5842, 6403]","[0, 201, 485, 737, 908, 1190, 1457, 1881, 2096, 2392, 2482, 2656, 2826, 3167, 3636]","[0, 331, 612, 906, 1337, 1817, 2271, 2631, 3047, 3810, 3900, 4466, 5265, 5651, 5981]","[0, 294, 384, 831, 1000, 1288, 1455, 1590, 1680, 2214, 2387, 2618, 2875, 3156, 3251]","[0, 130, 220, 310, 418, 557, 730, 961, 1051, 1347, 1437, 1610, 2289, 2653, 2855]",6403,3636,5981,3251,2855,63,98,120,102,112,"[0, 317, 613, 1038, 1410, 1705, 1933, 2334, 2793, 3644, 4134, 4638, 5221, 5944, 6884]","[0, 246, 679, 1098, 1297, 1513, 1973, 2234, 2746, 3467, 4161, 5278, 5673, 6339, 7046]","[0, 288, 622, 1006, 1387, 1757, 2319, 2618, 3299, 3814, 4498, 5290, 5697, 6263, 6653]","[0, 535, 625, 1176, 1306, 1600, 1733, 1993, 2118, 2538, 2930, 3188, 3278, 3827, 4277]","[0, 210, 490, 668, 816, 953, 1133, 1268, 1358, 1925, 2117, 2490, 2741, 3195, 3495]",6884,7046,6653,4277,3495,-481,-3410,-672,-1026,-640,-6229,15,dire
7571447909,41,49,78,53,110,"[0, 207, 517, 970, 1243, 1523, 1801, 2021, 2334, 2887, 3474, 3847, 4252, 4489, 5021]","[0, 280, 581, 946, 1364, 1775, 2318, 2684, 3198, 3780, 4195, 4467, 4933, 5578, 6036]","[0, 169, 330, 623, 970, 1213, 1621, 2002, 2465, 2922, 3347, 3608, 4221, 4817, 5036]","[0, 169, 298, 388, 478, 833, 1151, 1592, 1682, 1889, 2214, 2517, 3307, 3492, 3924]","[0, 169, 259, 366, 456, 662, 914, 1080, 1170, 1260, 1823, 2076, 2267, 2537, 2933]",5021,6036,5036,3924,2933,8,28,97,123,26,"[0, 537, 1100, 1473, 1772, 2014, 2781, 3108, 3843, 4362, 4886, 5516, 6045, 6776, 7572]","[0, 221, 472, 739, 1245, 1864, 2315, 2876, 3311, 3565, 4095, 4336, 4949, 5456, 6192]","[0, 333, 753, 1109, 1519, 1858, 2230, 2685, 3153, 3434, 4131, 4643, 5193, 6042, 6670]","[0, 169, 259, 558, 744, 903, 1164, 1299, 1462, 1662, 2027, 2117, 2351, 2744, 2967]","[0, 235, 389, 496, 631, 721, 895, 1030, 1120, 1612, 2102, 2192, 2311, 2700, 2891]",7572,6192,6670,2967,2891,-2551,-156,-1634,957,42,-3342,15,dire
7571494203,4,23,135,86,20,"[0, 241, 518, 901, 1233, 1415, 1671, 1870, 2261, 2689, 3117, 3570, 4189, 4476, 5045]","[0, 244, 485, 894, 1354, 1602, 2047, 2483, 3172, 3554, 4130, 4822, 5161, 5595, 6403]","[0, 208, 588, 763, 1224, 1494, 1929, 2101, 2512, 3174, 3497, 4209, 4512, 4907, 5142]","[0, 169, 600, 779, 998, 1088, 1542, 1680, 1815, 2057, 2482, 2703, 3126, 3752, 4110]","[0, 169, 311, 481, 611, 929, 1133, 1223, 1564, 1802, 1937, 2417, 2537, 2724, 3364]",5045,6403,5142,4110,3364,114,97,120,58,26,"[0, 203, 473, 842, 1255, 1711, 1956, 2348, 2636, 2854, 3602, 4142, 4733, 5293, 5908]","[0, 203, 432, 681, 965, 1384, 1871, 2287, 2951, 3551, 4054, 4451, 4874, 5560, 5745]","[0, 251, 721, 1189, 1560, 1855, 2188, 2432, 3081, 3542, 4242, 5037, 5405, 5905, 6399]","[0, 169, 321, 458, 588, 965, 1074, 1417, 1604, 1946, 2241, 2390, 2747, 3085, 3646]","[0, 169, 284, 374, 504, 638, 728, 922, 1102, 1236, 1669, 1884, 2072, 2275, 2589]",5908,5745,6399,3646,2589,-863,658,-1257,464,775,-223,15,radiant
7571634401,35,123,17,96,14,"[0, 167, 634, 1076, 1349, 1665, 2718, 3130, 3453, 4354, 4764, 5240, 5456, 5551, 5805]","[0, 129, 306, 632, 722, 916, 1340, 1704, 1794, 2095, 2230, 2664, 2804, 2899, 3113]","[0, 247, 411, 552, 820, 1118, 1386, 1562, 1820, 2124, 2472, 2842, 3328, 3558, 3812]","[0, 164, 560, 852, 1105, 1484, 1736, 2057, 2435, 2884, 3019, 3500, 3939, 4440, 4915]","[0, 129, 310, 553, 738, 846, 1255, 1462, 1552, 1931, 2221, 2979, 3198, 3534, 3629]",5805,3113,3812,4915,3629,82,98,39,53,40,"[0, 571, 784, 1462, 1875, 2632, 3245, 3642, 4119, 4688, 5578, 6204, 6867, 8179, 9118]","[0, 278, 582, 863, 1277, 1738, 2028, 2371, 2814, 3227, 3786, 4135, 4785, 5642, 6276]","[0, 407, 613, 1033, 1477, 1816, 2251, 2674, 3170, 3588, 3994, 4499, 4926, 5546, 6068]","[0, 209, 501, 716, 846, 1031, 1728, 2045, 2513, 2603, 2738, 3100, 3190, 4009, 4158]","[0, 269, 359, 778, 931, 1247, 1522, 1722, 1857, 1947, 2232, 2491, 2629, 3428, 3629]",9118,6276,6068,4158,3629,-3313,-3163,-2256,757,0,-7975,15,dire
7571635206,95,57,53,74,26,"[0, 217, 537, 627, 913, 1520, 1799, 2558, 2764, 3062, 3285, 3575, 4175, 4534, 4966]","[0, 256, 540, 900, 1110, 1510, 1726, 2049, 2460, 3267, 3730, 4106, 4660, 5076, 6129]","[0, 169, 637, 727, 1063, 1501, 1719, 2420, 2873, 3378, 3846, 4422, 4827, 4971, 5609]","[0, 293, 602, 817, 1306, 1713, 1921, 2340, 2594, 2729, 3070, 3467, 3899, 4602, 5077]","[0, 205, 295, 430, 569, 708, 843, 1001, 1419, 1702, 2052, 2228, 2455, 2637, 2906]",4966,6129,5609,5077,2906,76,63,108,112,72,"[0, 169, 503, 831, 1011, 1235, 1520, 1765, 2014, 2551, 2691, 3007, 3778, 4108, 4600]","[0, 284, 557, 1095, 1422, 1931, 2768, 3201, 3486, 3689, 3779, 3982, 4778, 5370, 5762]","[0, 252, 415, 898, 1125, 1315, 1870, 1960, 2437, 3005, 3271, 3446, 3896, 4504, 5171]","[0, 169, 298, 497, 587, 715, 1054, 1144, 1371, 1803, 1967, 2095, 2656, 3291, 3972]","[0, 169, 259, 349, 439, 578, 952, 1089, 1179, 1314, 1454, 1596, 2015, 2209, 2909]",4600,5762,5171,3972,2909,366,367,438,1105,-3,2273,15,dire
7571660219,25,97,37,135,64,"[0, 258, 706, 1083, 1492, 1986, 2488, 2861, 3307, 4075, 4899, 5271, 5727, 6584, 7369]","[0, 290, 562, 853, 1227, 1854, 2426, 2653, 3194, 3694, 4142, 4621, 5006, 5436, 5813]","[0, 169, 304, 703, 822, 952, 1442, 1689, 1823, 2794, 3025, 3435, 4042, 4265, 4441]","[0, 169, 295, 731, 929, 1314, 1615, 1785, 2170, 2556, 2954, 3570, 3973, 4529, 4704]","[0, 169, 259, 405, 558, 688, 1031, 1200, 1349, 1825, 1987, 2221, 2471, 2611, 2859]",7369,5813,4441,4704,2859,48,129,106,45,20,"[0, 215, 426, 609, 813, 1057, 1378, 2149, 2516, 2903, 3449, 3879, 4768, 5485, 6365]","[0, 208, 443, 1042, 1374, 1624, 1844, 2087, 2472, 2676, 2977, 3720, 4226, 5081, 5709]","[0, 242, 481, 896, 1207, 1503, 1750, 2010, 2323, 2824, 3244, 3820, 4481, 5039, 5533]","[0, 169, 259, 424, 559, 649, 902, 1118, 1298, 1439, 1755, 2475, 2770, 3209, 4365]","[0, 169, 278, 444, 534, 690, 780, 1279, 1582, 1841, 2235, 2914, 3058, 3383, 3915]",6365,5709,5533,4365,3915,1004,104,-1092,339,-1056,-701,15,dire
7571688104,94,13,97,84,45,"[0, 200, 497, 773, 1057, 1480, 1743, 2445, 3304, 3799, 4543, 5041, 5509, 6345, 7198]","[0, 280, 579, 876, 1293, 1552, 2103, 2452, 2799, 3264, 3601, 4417, 4759, 5302, 6140]","[0, 167, 483, 812, 1027, 1313, 1667, 2346, 2956, 3337, 3472, 4068, 4282, 4901, 5310]","[0, 269, 359, 493, 583, 983, 1331, 1511, 1782, 2008, 2143, 2233, 2442, 2608, 3063]","[18, 453, 789, 879, 969, 1219, 1416, 1596, 1686, 1998, 2260, 2534, 2677, 2977, 3340]",7198,6140,5310,3063,3340,41,106,33,40,30,"[0, 368, 681, 1063, 1268, 1706, 2138, 2701, 3200, 3434, 4115, 4750, 5469, 6133, 7419]","[0, 412, 711, 1003, 1250, 1429, 1554, 2028, 2315, 2691, 3863, 4007, 4580, 4729, 5134]","[0, 250, 475, 790, 1172, 1608, 1805, 2665, 2831, 2958, 3126, 3358, 3842, 4452, 4911]","[0, 250, 365, 722, 1143, 1278, 1602, 1788, 1878, 1968, 2093, 2237, 3150, 3382, 3722]","[0, 284, 399, 489, 659, 835, 925, 1462, 1670, 1760, 2275, 2419, 2910, 3363, 3618]",7419,5134,4911,3722,3618,-221,1006,399,-659,-278,247,15,dire
7571869818,94,38,49,110,19,"[0, 256, 576, 948, 1399, 1796, 2123, 2573, 3089, 3501, 4142, 4900, 5443, 6264, 6871]","[0, 296, 605, 888, 1357, 1699, 2546, 3156, 3931, 4370, 4909, 5395, 5956, 6607, 7653]","[0, 283, 553, 968, 1132, 1599, 2061, 2334, 2755, 3367, 3907, 4540, 5106, 5563, 6042]","[0, 172, 262, 421, 559, 1237, 1597, 1732, 1897, 2048, 2391, 2571, 2748, 3094, 3310]","[0, 170, 262, 356, 495, 709, 989, 1124, 1290, 1425, 1860, 2216, 2484, 2778, 3160]",6871,7653,6042,3310,3160,89,35,129,123,58,"[0, 208, 506, 798, 1134, 1478, 1657, 2181, 2527, 2805, 3387, 3785, 4479, 5605, 6197]","[0, 240, 547, 834, 1082, 1345, 1758, 2096, 2625, 3100, 3714, 4003, 4329, 5295, 5572]","[0, 245, 514, 797, 1158, 1283, 1659, 2193, 2526, 2776, 3153, 3550, 4036, 4344, 4809]","[0, 170, 274, 382, 518, 691, 855, 990, 1131, 1274, 1409, 1701, 1918, 2424, 2616]","[0, 170, 296, 465, 573, 935, 1086, 1267, 1487, 1688, 2052, 2298, 2508, 2932, 3282]",6197,5572,4809,2616,3282,674,2081,1233,694,-122,4560,15,radiant
7572018617,73,76,137,121,26,"[296, 686, 1229, 1690, 1819, 2470, 2803, 3555, 3825, 4644, 4909, 5538, 6266, 7115, 7943]","[345, 589, 917, 1202, 1583, 2235, 2676, 3207, 3649, 4119, 4515, 4780, 5640, 6563, 6773]","[241, 525, 1061, 1480, 1692, 2269, 2782, 3369, 3903, 4512, 4682, 4772, 5455, 6397, 7033]","[169, 259, 516, 1102, 1235, 1618, 1874, 2139, 2364, 2553, 2723, 2830, 2979, 3548, 3771]","[205, 295, 482, 572, 744, 855, 990, 1264, 1444, 1738, 2081, 2412, 2728, 3213, 3494]",7943,6773,7033,3771,3494,135,41,106,138,20,"[353, 641, 940, 1313, 1837, 2198, 2698, 2873, 3461, 4227, 4966, 5248, 5735, 6389, 7033]","[169, 416, 581, 1048, 1404, 1530, 1831, 2064, 2400, 2545, 2910, 3445, 3926, 4593, 5198]","[203, 487, 795, 1209, 1510, 1638, 2234, 2402, 2755, 3235, 3464, 3829, 4330, 4613, 4961]","[514, 649, 739, 995, 1566, 1703, 1918, 2060, 2429, 2690, 3182, 3395, 3660, 4032, 4323]","[169, 352, 442, 679, 876, 1001, 1177, 1267, 1481, 1924, 2235, 2325, 2627, 2910, 3192]",7033,5198,4961,4323,3192,910,1575,2072,-552,302,4307,15,radiant
7572212105,22,49,41,58,14,"[1666, 1949, 2513, 3117, 3475, 4134, 4705, 5221, 6196, 6674, 6858, 7469, 8341, 8497, 9423]","[1258, 1681, 1956, 2342, 2785, 3441, 4002, 4198, 4760, 5017, 5625, 5970, 6065, 6367, 7085]","[1121, 1622, 1864, 2178, 2390, 2584, 2971, 3625, 4067, 4641, 5320, 5732, 6195, 6459, 6553]","[534, 642, 894, 1042, 1132, 1407, 1640, 1749, 2389, 2596, 2729, 3202, 3494, 3665, 3992]","[919, 1054, 1144, 1279, 1369, 1683, 2092, 2324, 2885, 2980, 3074, 3169, 3468, 3575, 3950]",9423,7085,6553,3992,3950,82,96,113,123,5,"[1713, 1974, 2527, 2880, 3311, 4081, 5153, 5733, 6587, 7289, 8517, 9276, 10443, 11856, 13320]","[1316, 1460, 1920, 2323, 2815, 3558, 4637, 5126, 5296, 5690, 6760, 7435, 8151, 8473, 9196]","[1442, 1734, 1959, 2341, 2778, 3630, 4355, 5041, 5293, 5697, 6170, 6675, 7526, 8314, 9227]","[627, 762, 1061, 1528, 1791, 2390, 2868, 3072, 3494, 3697, 4303, 5026, 5812, 6261, 6704]","[642, 732, 904, 1090, 1597, 1846, 2046, 2136, 2226, 2457, 2886, 3071, 3318, 3808, 4291]",13320,9196,9227,6704,4291,-3897,-2111,-2674,-2712,-341,-11735,15,dire
7572766816,61,47,19,14,138,"[0, 240, 430, 554, 819, 961, 1111, 1437, 1882, 2593, 2907, 3501, 4086, 4580, 5123]","[0, 257, 442, 773, 1186, 1548, 2011, 2374, 2672, 3286, 3852, 4665, 5471, 6143, 7055]","[0, 574, 800, 1170, 1608, 1978, 2260, 2499, 2746, 2920, 3500, 3840, 4324, 4715, 5251]","[0, 236, 351, 441, 768, 898, 1110, 1326, 1416, 1670, 2295, 2928, 3452, 3703, 4194]","[0, 236, 351, 457, 632, 762, 868, 974, 1064, 1326, 1754, 2179, 2762, 2999, 3455]",5123,7055,5251,4194,3455,94,69,129,51,26,"[0, 203, 693, 1136, 1463, 2044, 2374, 3279, 3781, 4244, 4856, 5644, 6330, 7146, 7872]","[0, 208, 729, 1164, 1867, 2679, 3291, 3874, 4135, 4316, 5314, 5717, 6325, 6803, 7445]","[0, 245, 611, 907, 1087, 1427, 1636, 2172, 2642, 3054, 3746, 4416, 4758, 5205, 5613]","[0, 169, 327, 466, 596, 800, 890, 1394, 1484, 1736, 2155, 2507, 2803, 2981, 3129]","[0, 169, 332, 519, 760, 964, 1290, 1441, 1629, 1802, 2255, 2475, 2707, 2856, 3062]",7872,7445,5613,3129,3062,-2749,-390,-362,1065,393,-2043,15,dire
7573055806,94,120,96,53,26,"[0, 286, 609, 940, 1309, 1593, 1926, 2374, 2775, 3202, 3440, 3969, 4606, 5182, 5881]","[0, 287, 620, 1061, 1871, 1961, 2392, 2773, 3357, 3777, 4307, 4914, 5314, 5902, 6738]","[0, 210, 883, 1203, 1808, 2317, 2674, 3226, 3898, 4290, 4870, 5337, 5845, 6309, 6797]","[0, 210, 300, 474, 719, 1075, 1210, 1618, 1939, 2063, 2494, 2704, 2969, 3576, 3670]","[0, 210, 385, 607, 829, 1213, 1303, 1483, 1627, 1764, 2027, 2327, 2607, 2943, 3086]",5881,6738,6797,3670,3086,106,93,28,5,105,"[0, 182, 487, 817, 1207, 1753, 1981, 2252, 2848, 3266, 4243, 4509, 4947, 5608, 6614]","[0, 165, 408, 644, 1013, 1138, 1416, 1633, 2014, 2460, 2948, 3352, 3968, 4696, 5053]","[0, 166, 408, 573, 894, 1329, 1744, 2120, 2426, 2638, 2966, 3539, 4011, 4621, 5297]","[0, 169, 259, 444, 642, 732, 868, 1263, 1446, 1867, 2354, 2478, 2629, 3185, 3348]","[0, 130, 220, 310, 440, 720, 855, 1077, 1217, 1484, 1920, 2274, 2585, 2835, 3154]",6614,5053,5297,3348,3154,-733,1685,1500,322,-68,2706,15,radiant
7573090202,95,46,45,112,107,"[0, 254, 471, 975, 1217, 1612, 2005, 2716, 3419, 3952, 4614, 4704, 5276, 6163, 7139]","[0, 208, 771, 1157, 1755, 2037, 2698, 3109, 3718, 4326, 4897, 5965, 6354, 7442, 7975]","[0, 279, 559, 950, 1252, 1636, 2051, 2756, 3052, 3739, 4187, 4505, 5224, 5948, 6520]","[0, 170, 298, 684, 821, 1130, 1583, 1953, 2166, 2346, 2604, 3048, 3512, 4134, 4449]","[0, 170, 302, 422, 672, 762, 1181, 1495, 1797, 2004, 2743, 3139, 3422, 3863, 4367]",7139,7975,6520,4449,4367,13,14,29,31,26,"[0, 170, 441, 768, 1166, 1681, 2048, 2353, 2849, 3141, 3726, 4593, 5514, 6148, 6694]","[0, 364, 573, 775, 941, 1117, 1701, 1997, 2646, 3149, 3437, 4301, 4820, 5040, 5307]","[0, 209, 739, 881, 1049, 1458, 1864, 2179, 2814, 3106, 3493, 4021, 4356, 4538, 4633]","[0, 170, 260, 350, 480, 675, 908, 1081, 1597, 1732, 2107, 2542, 2900, 3116, 3245]","[0, 218, 563, 653, 831, 1018, 1108, 1369, 1584, 1719, 2068, 2205, 2537, 2632, 2740]",6694,5307,4633,3245,2740,445,2668,1887,1204,1627,7831,15,radiant
7573242905,38,11,106,105,86,"[0, 533, 931, 1173, 1584, 1989, 2466, 2875, 3581, 4347, 4825, 5247, 5756, 6316, 6840]","[0, 328, 650, 859, 1405, 1785, 2284, 2688, 3055, 3454, 4018, 4585, 4941, 5491, 5960]","[0, 357, 755, 1073, 1410, 1737, 2162, 2809, 3146, 3645, 4146, 4698, 5048, 5564, 5886]","[0, 170, 260, 350, 512, 650, 838, 1037, 1376, 1675, 1972, 2541, 2948, 3498, 4185]","[0, 231, 321, 411, 545, 715, 941, 1031, 1544, 1724, 1904, 2203, 2630, 2954, 3049]",6840,5960,5886,4185,3049,71,22,41,119,5,"[0, 205, 511, 772, 1177, 1745, 2037, 2526, 3110, 3796, 4570, 4939, 6072, 6389, 6644]","[0, 334, 662, 916, 1259, 1663, 2039, 2248, 2577, 3138, 3485, 3883, 4577, 5138, 5986]","[0, 170, 332, 572, 775, 999, 1251, 1378, 1582, 1898, 2457, 2817, 3329, 3810, 4141]","[0, 170, 260, 396, 575, 665, 800, 890, 1349, 1698, 1790, 1880, 2436, 2574, 2843]","[0, 251, 341, 431, 600, 690, 825, 915, 1050, 1306, 1416, 1590, 1974, 2068, 2163]",6644,5986,4141,2843,2163,196,-26,1745,1342,886,4143,15,radiant
7573302602,46,29,39,121,31,"[0, 213, 685, 1282, 1711, 2166, 2830, 3352, 3993, 4508, 4995, 5530, 6134, 6852, 7607]","[0, 203, 481, 678, 1197, 1478, 1907, 2185, 2596, 3188, 3974, 4546, 5206, 5754, 6061]","[0, 241, 576, 1035, 1360, 1736, 2167, 2613, 3108, 3715, 4365, 4699, 5791, 6101, 6362]","[0, 130, 220, 310, 492, 630, 801, 938, 1076, 1263, 1882, 1972, 2152, 2403, 2498]","[0, 130, 575, 742, 898, 1037, 1171, 1436, 1573, 1760, 2086, 2623, 3056, 3369, 3464]",7607,6061,6362,2498,3464,95,16,71,23,101,"[0, 364, 564, 868, 1394, 1703, 2119, 2631, 3048, 3219, 3655, 4043, 4737, 5105, 5628]","[0, 291, 537, 1255, 1671, 1918, 2148, 2500, 2881, 3090, 3572, 3991, 4838, 5557, 5885]","[0, 210, 300, 407, 603, 732, 979, 1110, 1245, 1910, 2221, 2311, 2401, 2765, 3144]","[0, 377, 728, 1126, 1584, 1997, 2362, 2751, 3091, 3478, 3869, 4067, 4251, 5083, 5794]","[0, 210, 300, 508, 638, 792, 882, 1275, 1410, 1632, 2234, 2609, 2745, 3074, 3277]",5628,5885,3144,5794,3277,1979,176,3218,-3296,187,2264,15,dire
7573415915,25,18,2,87,5,"[1, 338, 748, 1185, 1560, 2139, 2632, 3051, 3487, 4297, 5075, 6057, 6630, 7879, 8512]","[1, 290, 508, 905, 1248, 1600, 1997, 2161, 2568, 2870, 3318, 3869, 4320, 4707, 5445]","[1, 245, 691, 1024, 1524, 1846, 2496, 2921, 3308, 3764, 4368, 4942, 5235, 5713, 6533]","[1, 131, 571, 696, 855, 1299, 1407, 1497, 1632, 1856, 2084, 2740, 2967, 3463, 3875]","[1, 131, 221, 391, 528, 658, 834, 924, 1059, 1282, 1466, 2004, 2240, 2702, 2995]",8512,5445,6533,3875,2995,114,15,74,58,26,"[1, 342, 669, 961, 1357, 1809, 2188, 2790, 3380, 3760, 4356, 5019, 5376, 6081, 6716]","[1, 389, 630, 1076, 1374, 2032, 2242, 2796, 3463, 3767, 4410, 5083, 5450, 6185, 6663]","[1, 322, 543, 915, 1243, 1690, 1938, 2381, 2845, 3183, 3495, 3675, 4191, 4654, 5059]","[1, 236, 326, 435, 525, 1210, 1317, 1744, 2196, 2357, 2492, 2672, 3042, 3538, 3978]","[1, 236, 326, 416, 550, 687, 777, 912, 1492, 1631, 1814, 1994, 2084, 2446, 2541]",6716,6663,5059,3978,2541,1796,-1218,1474,-103,454,2403,15,dire
7573491301,98,67,33,9,19,"[0, 281, 481, 897, 1301, 1720, 2136, 2617, 3176, 3587, 4941, 5277, 6382, 7092, 7754]","[0, 165, 449, 809, 1167, 1457, 1661, 1896, 2061, 2374, 2711, 3228, 3511, 4051, 4725]","[0, 253, 578, 1015, 1502, 1919, 2373, 2748, 3141, 3599, 4075, 4702, 5369, 6060, 6460]","[0, 180, 314, 786, 969, 1263, 1419, 1567, 1756, 1938, 2678, 2887, 3191, 3430, 3677]","[0, 130, 220, 310, 400, 538, 675, 810, 1030, 1120, 1817, 1961, 2351, 2590, 2770]",7754,4725,6460,3677,2770,10,28,90,85,26,"[0, 247, 406, 602, 789, 1251, 1755, 2426, 2882, 3335, 3793, 4375, 5035, 5504, 6131]","[0, 284, 477, 872, 1198, 1487, 1869, 2510, 2965, 3326, 3730, 3874, 4743, 5322, 5780]","[0, 259, 552, 890, 1140, 1518, 1957, 2499, 2956, 3701, 3899, 4364, 5015, 5516, 6228]","[0, 210, 300, 409, 499, 635, 770, 1042, 1260, 1724, 1814, 2130, 2450, 2604, 2903]","[0, 210, 300, 620, 759, 1180, 1315, 1584, 1803, 2270, 2534, 2696, 3025, 3174, 3560]",6131,5780,6228,2903,3560,1623,-1055,232,774,-790,784,15,dire
7573506400,77,11,114,19,7,"[50, 284, 561, 855, 1150, 1504, 1917, 2303, 2635, 3157, 3617, 4199, 4800, 5663, 6277]","[50, 284, 563, 939, 1258, 1576, 1862, 2527, 3016, 3534, 3821, 4380, 5584, 5883, 6050]","[50, 369, 736, 1109, 1381, 1585, 1926, 2215, 2645, 2910, 3072, 3493, 3975, 4608, 5058]","[50, 245, 335, 511, 846, 936, 1026, 1165, 1301, 1391, 1735, 2083, 2557, 3107, 3246]","[50, 245, 335, 473, 593, 727, 863, 953, 1043, 1133, 1271, 1860, 2087, 2274, 2619]",6277,6050,5058,3246,2619,25,8,71,93,5,"[0, 250, 624, 1081, 1726, 2104, 2954, 3490, 3944, 4373, 4762, 5215, 5731, 6767, 6954]","[0, 324, 649, 1014, 1267, 1472, 1770, 2097, 2521, 3004, 3551, 4112, 5066, 5732, 6390]","[0, 209, 512, 804, 1330, 1621, 1977, 2295, 2680, 3014, 3306, 3887, 4437, 5287, 5743]","[0, 170, 260, 367, 547, 683, 849, 1001, 1138, 1567, 2126, 2624, 2967, 3307, 3720]","[0, 170, 281, 412, 549, 639, 729, 819, 909, 1045, 1224, 1363, 1615, 1725, 1820]",6954,6390,5743,3720,1820,-677,-340,-685,-474,799,-1377,15,radiant
7573544108,89,43,96,58,26,"[209, 450, 888, 1142, 1426, 1882, 2251, 2764, 2924, 3104, 3364, 4269, 4983, 5741, 6330]","[322, 740, 1024, 1598, 2012, 2442, 3053, 3589, 4061, 4577, 5040, 5675, 6042, 6555, 7055]","[260, 497, 942, 1142, 1495, 1882, 2229, 2788, 3114, 3895, 4442, 4657, 5280, 5642, 6077]","[209, 299, 433, 523, 646, 769, 1066, 1212, 1500, 1763, 1962, 2178, 2894, 3422, 3731]","[209, 342, 823, 980, 1117, 1223, 1488, 1641, 2075, 2255, 2391, 2589, 2956, 3110, 3259]",6330,7055,6077,3731,3259,48,49,137,27,105,"[209, 375, 618, 982, 1109, 1488, 1888, 2234, 2753, 3398, 3938, 4803, 6112, 6944, 7655]","[207, 483, 825, 1276, 1484, 1963, 2551, 3313, 3740, 4454, 5159, 5361, 5911, 6306, 6850]","[200, 445, 845, 1052, 1568, 1785, 2240, 2634, 2769, 3593, 3809, 4229, 4681, 5155, 5547]","[177, 312, 406, 634, 797, 977, 1067, 1316, 1500, 2089, 2196, 2521, 3018, 3255, 3719]","[129, 254, 344, 575, 665, 884, 1204, 1294, 1685, 1993, 2130, 2519, 3205, 3346, 3600]",7655,6850,5547,3719,3600,-1325,205,530,12,-341,-919,15,dire
7573558401,46,98,49,62,85,"[0, 207, 521, 912, 1079, 1289, 1607, 1878, 2400, 2823, 3275, 3411, 4093, 4311, 4729]","[0, 309, 641, 1054, 1619, 2019, 2702, 3280, 3961, 4642, 6016, 6832, 7463, 7889, 8734]","[0, 279, 474, 764, 1175, 1393, 1766, 2198, 2808, 3273, 4113, 4733, 5685, 6070, 6329]","[5, 172, 262, 352, 500, 630, 851, 1359, 1642, 2032, 2846, 3304, 3538, 3669, 4000]","[0, 155, 245, 412, 502, 592, 727, 837, 1118, 1381, 1814, 1921, 2155, 2250, 2509]",4729,8734,6329,4000,2509,48,53,84,126,51,"[0, 329, 735, 1218, 1669, 2067, 2584, 2820, 3172, 3579, 4054, 4672, 5419, 6106, 6831]","[0, 317, 565, 904, 1327, 1783, 2030, 2538, 2946, 3483, 3951, 4607, 5491, 6147, 7242]","[0, 210, 300, 743, 877, 1022, 1247, 1643, 1841, 2341, 2436, 2655, 3085, 3981, 4405]","[0, 210, 334, 667, 791, 1040, 1337, 1511, 1649, 2573, 2907, 2997, 3491, 4213, 4965]","[0, 210, 300, 454, 544, 679, 1059, 1194, 1588, 1678, 1850, 2267, 3012, 3597, 4054]",6831,7242,4405,4965,4054,-2102,1492,1924,-965,-1545,-1196,15,dire
7573683309,1,41,137,33,121,"[0, 244, 556, 811, 1391, 1766, 2089, 2498, 2768, 3497, 4172, 4939, 5704, 6229, 6631]","[0, 206, 438, 565, 846, 1304, 1468, 1867, 2239, 2599, 3056, 3322, 3767, 4433, 4989]","[0, 205, 484, 779, 1155, 1485, 1963, 2453, 2955, 3207, 3674, 4163, 4341, 4718, 5211]","[0, 170, 295, 385, 499, 717, 1128, 1535, 1783, 1873, 2527, 2801, 2891, 3169, 3388]","[0, 214, 646, 956, 1229, 1395, 1814, 2073, 2180, 2289, 2559, 2928, 3106, 3424, 3518]",6631,4989,5211,3388,3518,94,129,126,65,86,"[0, 217, 506, 879, 1134, 1348, 1788, 1994, 2255, 2753, 3087, 3355, 3568, 4090, 4614]","[0, 260, 510, 904, 1192, 1556, 1944, 2272, 2683, 3233, 3839, 4658, 4913, 5474, 6223]","[0, 219, 579, 1025, 1394, 1609, 2104, 2521, 2848, 3712, 4200, 4664, 5044, 5497, 6106]","[0, 206, 315, 455, 617, 707, 842, 977, 1150, 1580, 1765, 2159, 2343, 2859, 3294]","[0, 170, 260, 857, 987, 1092, 1510, 1878, 2194, 2799, 3217, 3480, 3831, 4076, 4210]",4614,6223,6106,3294,4210,2017,-1234,-895,94,-692,-710,15,dire
7573878007,48,106,47,26,100,"[0, 202, 399, 775, 939, 1125, 1487, 1957, 2138, 2969, 3396, 3889, 4398, 4948, 5703]","[0, 228, 392, 687, 816, 906, 1119, 1260, 1813, 2168, 2559, 3037, 3468, 4161, 4572]","[0, 189, 487, 855, 1103, 1724, 1971, 2871, 3109, 3520, 4469, 4665, 5018, 5751, 6312]","[100, 298, 388, 478, 568, 756, 893, 1304, 1523, 1925, 2950, 3040, 3448, 3633, 3875]","[0, 154, 244, 378, 468, 583, 718, 1277, 1367, 1663, 2001, 2125, 2215, 2857, 3154]",5703,4572,6312,3875,3154,73,114,49,123,79,"[0, 368, 819, 1102, 1438, 1571, 2059, 2149, 2541, 3279, 3642, 4206, 5037, 6395, 6965]","[0, 327, 693, 1069, 1443, 2074, 2450, 2905, 3355, 3903, 4166, 4502, 5120, 5412, 5594]","[0, 294, 581, 791, 953, 1543, 1994, 2373, 2950, 3245, 3884, 4567, 5115, 5542, 6067]","[0, 209, 299, 389, 479, 676, 812, 902, 1141, 1406, 1702, 1792, 1882, 2197, 2292]","[0, 209, 299, 442, 870, 960, 1281, 1371, 1521, 1830, 2055, 2156, 2282, 2549, 2664]",6965,5594,6067,2292,2664,-1262,-1022,245,1583,490,34,15,radiant
7575056413,46,43,96,86,100,"[0, 297, 630, 1087, 1546, 2171, 2725, 3295, 3728, 4491, 5175, 5645, 6389, 7313, 7977]","[0, 322, 653, 983, 1269, 1498, 1854, 2196, 2635, 3200, 3727, 3943, 4561, 5071, 5824]","[0, 315, 621, 1044, 1287, 1754, 2231, 2717, 3228, 3765, 4454, 4957, 5562, 5862, 6613]","[0, 256, 395, 987, 1127, 1295, 1529, 1857, 2300, 2390, 2615, 2705, 2933, 3232, 3730]","[0, 210, 300, 464, 554, 730, 1126, 1264, 1460, 1694, 1919, 2270, 2597, 2765, 2991]",7977,5824,6613,3730,2991,39,21,67,26,3,"[0, 291, 533, 792, 1123, 1461, 1806, 2191, 2881, 3551, 4195, 4782, 5395, 6245, 7190]","[0, 289, 668, 1079, 1529, 1803, 2102, 2477, 2879, 3220, 3701, 4547, 5190, 6052, 6424]","[0, 206, 523, 764, 1134, 1489, 1867, 2235, 2643, 3244, 3924, 4360, 4704, 5124, 5815]","[0, 130, 220, 310, 445, 540, 630, 768, 903, 1212, 1448, 1816, 1936, 2324, 2559]","[0, 130, 220, 310, 444, 548, 744, 880, 1137, 1227, 1362, 1611, 1701, 2012, 2247]",7190,6424,5815,2559,2247,787,-600,798,1171,744,2900,15,radiant
7575121814,21,48,53,102,121,"[0, 256, 625, 907, 1355, 1803, 2221, 2540, 3168, 3585, 4101, 4767, 6099, 6891, 8065]","[0, 585, 854, 1153, 1279, 1484, 1766, 2152, 2688, 3120, 3545, 4010, 5008, 5561, 5991]","[0, 366, 631, 912, 1274, 1653, 1850, 2228, 2485, 2609, 3171, 3528, 4094, 4500, 4995]","[0, 376, 500, 590, 824, 914, 1004, 1094, 1350, 1440, 1693, 1984, 2412, 2661, 3039]","[0, 130, 220, 317, 451, 585, 675, 889, 1072, 1207, 1643, 2145, 2573, 2820, 3094]",8065,5991,4995,3039,3094,10,126,49,86,87,"[0, 240, 647, 1014, 1504, 2103, 2593, 3057, 3510, 4055, 4611, 5115, 5853, 6403, 6849]","[0, 287, 548, 907, 1253, 1508, 2006, 2190, 2630, 3311, 3827, 4795, 5435, 5897, 6418]","[0, 245, 621, 948, 1270, 1612, 2016, 2295, 2813, 3114, 3831, 4452, 4770, 5409, 5861]","[0, 170, 307, 444, 534, 688, 871, 1087, 1421, 1648, 2207, 2604, 2930, 3079, 3475]","[0, 170, 260, 378, 517, 703, 902, 1057, 1157, 1341, 1611, 2008, 2218, 2367, 2876]",6849,6418,5861,3475,2876,1216,-427,-866,-436,218,-295,15,radiant
7575225916,69,21,23,19,83,"[0, 164, 483, 831, 1368, 1992, 2332, 2999, 3449, 3973, 4630, 5323, 5973, 6649, 7292]","[0, 199, 364, 1103, 1498, 1800, 1969, 2593, 2928, 3331, 4081, 4478, 4973, 5652, 6158]","[0, 255, 570, 1100, 1259, 1710, 2296, 2592, 2916, 3463, 3857, 4470, 4971, 5440, 6498]","[0, 174, 264, 607, 776, 1051, 1141, 1465, 1599, 1930, 2175, 2355, 2653, 3114, 3501]","[0, 129, 219, 548, 681, 853, 943, 1106, 1327, 1551, 1641, 2262, 2737, 2922, 3141]",7292,6158,6498,3501,3141,44,74,71,27,20,"[0, 209, 631, 959, 1176, 1478, 1650, 2196, 2549, 2873, 3425, 4487, 4841, 5307, 5817]","[0, 649, 859, 1295, 1671, 1972, 2367, 2575, 2966, 3383, 3977, 4847, 5337, 6242, 6580]","[0, 370, 582, 880, 1194, 1529, 1856, 2144, 2291, 2562, 2904, 3479, 4171, 4799, 5521]","[0, 264, 354, 631, 874, 1012, 1271, 1361, 1496, 1676, 2018, 2246, 2484, 2900, 3230]","[0, 264, 549, 639, 769, 859, 949, 1151, 1332, 1597, 1838, 2291, 2381, 2848, 3207]",5817,6580,5521,3230,3207,1475,-422,977,271,-66,2235,15,radiant
7575309713,53,98,84,28,86,"[1, 287, 574, 980, 1344, 1995, 2433, 2885, 3235, 3842, 4216, 4673, 5423, 6784, 7210]","[1, 285, 612, 904, 1264, 1748, 2243, 2557, 3113, 3578, 4132, 4639, 4819, 5110, 5566]","[1, 171, 351, 486, 576, 930, 1112, 1284, 1615, 2063, 2593, 2905, 3229, 4224, 4738]","[1, 373, 726, 1053, 1454, 2269, 2487, 2655, 3231, 3401, 4134, 4580, 4785, 5004, 5231]","[1, 171, 261, 385, 521, 736, 915, 1005, 1281, 1772, 2055, 2328, 2631, 3414, 3657]",7210,5566,4738,5231,3657,48,97,23,14,64,"[1, 332, 700, 997, 1236, 1618, 2090, 2464, 3044, 3571, 4445, 5181, 5702, 6713, 7430]","[1, 280, 650, 1144, 1747, 2152, 2556, 3026, 3775, 4180, 4800, 5555, 6018, 6760, 7665]","[1, 282, 555, 961, 1176, 1530, 1912, 2406, 2687, 2948, 3715, 4338, 5186, 5806, 6198]","[1, 171, 261, 398, 566, 802, 940, 1238, 1459, 1740, 2217, 2607, 2885, 3631, 4024]","[1, 171, 261, 351, 441, 615, 752, 857, 947, 1190, 2009, 2697, 3080, 3341, 3595]",7430,7665,6198,4024,3595,-220,-2099,-1460,1207,62,-2510,15,radiant
7575446802,120,4,97,65,5,"[0, 276, 608, 960, 1390, 1885, 2293, 2976, 3506, 3929, 4658, 5448, 6336, 6929, 7868]","[0, 282, 607, 974, 1240, 1562, 1849, 1939, 2215, 2580, 3194, 3926, 4422, 4920, 5309]","[0, 245, 475, 1067, 1496, 1918, 2334, 2747, 3386, 3706, 4366, 4991, 5819, 6409, 7140]","[0, 170, 276, 411, 531, 692, 1000, 1164, 1436, 1657, 2014, 2415, 2595, 2888, 3299]","[0, 220, 310, 961, 1226, 1461, 1655, 1839, 2236, 2362, 2591, 3309, 3508, 3821, 4213]",7868,5309,7140,3299,4213,29,90,93,58,86,"[0, 207, 385, 671, 911, 1300, 1601, 2014, 2544, 3127, 3508, 3978, 4547, 5110, 5467]","[0, 249, 564, 895, 1242, 1534, 1940, 2574, 2983, 3601, 3834, 4362, 4625, 5281, 5756]","[0, 258, 544, 779, 1273, 1517, 1878, 2229, 2373, 2907, 3466, 3781, 4440, 5274, 5782]","[0, 170, 260, 350, 440, 592, 700, 835, 1121, 1597, 1807, 2144, 2406, 2914, 3075]","[0, 170, 360, 488, 578, 764, 854, 1096, 1510, 1846, 2507, 2779, 3209, 3470, 3636]",5467,5756,5782,3075,3636,2401,-447,1358,224,577,4113,15,radiant
7575450011,13,14,100,2,72,"[0, 368, 605, 1021, 1504, 2000, 2444, 2979, 3318, 3724, 3961, 4808, 5614, 6299, 6810]","[0, 325, 622, 1071, 1521, 2036, 2581, 2882, 3518, 4027, 4714, 4980, 5147, 6056, 6245]","[0, 320, 521, 941, 1277, 1604, 2066, 2437, 2643, 3237, 3696, 3962, 4401, 4712, 5299]","[0, 209, 299, 433, 612, 786, 1402, 1845, 2501, 3177, 3472, 4122, 4290, 4731, 5101]","[0, 209, 299, 389, 519, 609, 748, 1154, 1325, 1647, 1819, 1979, 2136, 2447, 2541]",6810,6245,5299,5101,2541,11,10,114,86,5,"[0, 198, 394, 760, 1178, 1663, 2178, 2685, 3225, 3530, 3959, 4402, 5054, 6025, 6572]","[0, 251, 656, 1104, 1519, 1930, 2504, 3035, 3230, 3542, 4049, 4527, 5198, 5892, 6547]","[0, 200, 407, 691, 1028, 1618, 1872, 2135, 2414, 2757, 2982, 3649, 4038, 4386, 4673]","[0, 177, 285, 508, 598, 1282, 1408, 1608, 1698, 2127, 2580, 3638, 3923, 4119, 4309]","[0, 129, 239, 378, 517, 679, 769, 894, 984, 1344, 1530, 2008, 2458, 2928, 3118]",6572,6547,4673,4309,3118,238,-302,626,792,-577,777,15,dire
7575469801,109,71,29,21,56,"[0, 280, 449, 738, 1007, 1346, 1696, 2006, 2450, 2745, 3497, 4005, 4761, 5299, 5998]","[0, 330, 542, 632, 845, 935, 1025, 1338, 1556, 1729, 2121, 2495, 2799, 3309, 3607]","[0, 245, 441, 729, 1294, 1549, 1711, 2150, 2563, 3020, 3549, 4093, 4383, 5227, 5993]","[0, 218, 359, 509, 728, 818, 993, 1571, 1661, 1848, 2316, 2639, 3015, 3407, 3865]","[0, 169, 259, 364, 494, 679, 839, 1008, 1268, 1491, 2055, 2251, 2619, 2870, 2987]",5998,3607,5993,3865,2987,48,25,137,58,83,"[0, 308, 702, 915, 1354, 1847, 2540, 3006, 3594, 4195, 4984, 5601, 6330, 7161, 8299]","[0, 322, 640, 1047, 1368, 1747, 2175, 2559, 3074, 3727, 4164, 4530, 5293, 5952, 6612]","[0, 205, 456, 656, 1072, 1415, 1997, 2376, 2789, 3292, 3715, 4268, 4693, 5537, 6168]","[0, 232, 322, 412, 502, 670, 852, 942, 1346, 1557, 1813, 2123, 2397, 2649, 3097]","[0, 549, 639, 729, 866, 1000, 1298, 1396, 1600, 1690, 1825, 2041, 2433, 2735, 3096]",8299,6612,6168,3097,3096,-2301,-3005,-175,768,-109,-4822,15,dire
7575497407,10,11,43,19,20,"[0, 280, 632, 1120, 1499, 2029, 2473, 2921, 3409, 3615, 4087, 4299, 4866, 5547, 6418]","[0, 217, 553, 1011, 1388, 1710, 2132, 2677, 3185, 3713, 4399, 4652, 4971, 5493, 6304]","[0, 251, 497, 861, 1187, 1492, 1906, 2313, 2801, 3335, 3796, 4569, 4994, 5417, 6594]","[0, 130, 257, 382, 556, 646, 772, 908, 1045, 1225, 1351, 1684, 2017, 2276, 2753]","[0, 130, 220, 345, 482, 572, 791, 881, 1017, 1165, 1304, 1394, 1630, 1829, 2104]",6418,6304,6594,2753,2104,14,25,2,5,27,"[0, 580, 978, 1437, 1687, 2143, 2587, 3076, 3716, 4326, 5071, 5957, 6576, 7144, 7759]","[0, 354, 808, 1298, 1729, 2264, 2832, 3385, 3900, 4358, 4877, 5554, 6232, 6670, 7407]","[0, 284, 613, 808, 1065, 1565, 1694, 2112, 2575, 3361, 3885, 4863, 5210, 5784, 6273]","[0, 274, 561, 720, 1058, 1231, 1546, 1722, 2030, 2294, 2501, 2898, 3177, 3641, 3952]","[0, 261, 351, 441, 571, 736, 826, 956, 1314, 1608, 1943, 2714, 2939, 3213, 3812]",7759,7407,6273,3952,3812,-1341,-1103,321,-1199,-1708,-5030,15,dire
7575506109,25,49,74,105,136,"[1152, 1564, 1854, 2491, 3051, 3396, 4091, 4554, 5223, 6321, 7070, 7637, 8623, 9144, 9997]","[1567, 1909, 2550, 2924, 3287, 3857, 4438, 4615, 5207, 5553, 5868, 6559, 7112, 7679, 8092]","[1190, 1480, 1910, 2464, 2903, 3121, 3338, 3692, 4230, 4723, 4818, 5212, 6280, 6688, 7328]","[757, 1145, 1235, 1464, 1813, 1985, 2417, 2627, 2885, 3948, 4337, 4432, 4854, 5502, 6218]","[846, 1054, 1457, 1637, 1764, 1936, 2195, 2285, 2548, 3115, 3481, 3713, 4053, 4301, 4736]",9997,8092,7328,6218,4736,98,90,41,65,26,"[1568, 1955, 2381, 2943, 3573, 4610, 5340, 6054, 6824, 7029, 7619, 8308, 9400, 9988, 10641]","[1606, 1951, 2178, 2783, 3011, 4070, 4680, 5156, 5580, 6481, 6806, 7126, 8130, 8683, 9298]","[1155, 1369, 1547, 1969, 2321, 2848, 3315, 3838, 4290, 4822, 5325, 5753, 6533, 6793, 8014]","[944, 1161, 1587, 1888, 1978, 2694, 3196, 3564, 3795, 4010, 4633, 5221, 5604, 5699, 6199]","[709, 799, 1068, 1248, 1441, 1953, 2256, 2752, 2926, 3021, 3390, 3761, 4350, 4649, 4744]",10641,9298,8014,6199,4744,-644,-1206,-686,19,-8,-2525,15,dire
7575532318,82,112,106,19,68,"[129, 448, 816, 1219, 1959, 2487, 2970, 3468, 4051, 4788, 5876, 6506, 7816, 8577, 9956]","[238, 464, 867, 1156, 1485, 1841, 2251, 2712, 3490, 3896, 4685, 5263, 5448, 5854, 6691]","[201, 484, 735, 1124, 1360, 1485, 1964, 2170, 2591, 2920, 3812, 4259, 4877, 5318, 6098]","[129, 255, 473, 576, 812, 902, 1299, 1535, 2056, 2267, 2818, 3451, 3723, 4043, 4863]","[129, 219, 361, 512, 776, 950, 1221, 1401, 1689, 1852, 2593, 2857, 3266, 3572, 4024]",9956,6691,6098,4863,4024,76,120,95,128,30,"[318, 667, 964, 1296, 1532, 2157, 2523, 2934, 3401, 4370, 4478, 5217, 6498, 6872, 7039]","[209, 483, 937, 1222, 1536, 1756, 2129, 2607, 3028, 3462, 3552, 4037, 4808, 5352, 5446]","[285, 493, 858, 1220, 1598, 1920, 2220, 2538, 2628, 2937, 3197, 3403, 3759, 4335, 4588]","[257, 386, 493, 678, 853, 1079, 1375, 1510, 1679, 2072, 2325, 2531, 2810, 3233, 3327]","[245, 335, 472, 602, 736, 875, 1032, 1213, 1303, 1536, 1626, 1716, 1865, 1995, 2089]",7039,5446,4588,3327,2089,2917,1245,1510,1536,1935,9143,15,radiant
7575553506,25,97,80,119,5,"[0, 240, 583, 987, 1376, 1739, 2075, 2289, 3018, 3445, 4425, 4929, 5441, 6409, 6998]","[0, 169, 499, 901, 1184, 1363, 1794, 2298, 2703, 3089, 3600, 4259, 4805, 5844, 6438]","[0, 205, 580, 835, 1204, 1677, 2150, 2778, 3315, 3687, 4437, 4877, 5337, 5928, 6622]","[0, 169, 259, 473, 612, 768, 858, 1221, 1345, 1435, 2008, 2302, 2471, 2763, 3113]","[0, 254, 344, 478, 663, 771, 1093, 1272, 1439, 1574, 1983, 2277, 2367, 2708, 2885]",6998,6438,6622,3113,2885,10,39,129,65,85,"[0, 206, 603, 1165, 1467, 1705, 1961, 2276, 2671, 3056, 3504, 4412, 4902, 5701, 6282]","[0, 290, 464, 799, 1051, 1266, 1601, 2382, 2655, 3157, 3480, 4161, 4845, 5441, 6153]","[0, 214, 527, 788, 1076, 1490, 1924, 2227, 2604, 3057, 3373, 3939, 4496, 4884, 5357]","[0, 169, 259, 349, 479, 677, 1075, 1369, 1760, 2025, 2289, 3005, 3234, 3426, 3845]","[0, 169, 259, 468, 642, 772, 1017, 1482, 1654, 1744, 1834, 2335, 2495, 2639, 2885]",6282,6153,5357,3845,2885,716,285,1265,-732,0,1534,15,dire
7575612016,106,25,129,58,26,"[135, 376, 701, 1235, 1492, 1933, 2346, 2945, 3292, 4148, 5241, 5778, 6558, 7427, 8019]","[135, 406, 889, 1435, 1884, 2296, 2596, 3277, 3619, 4092, 4560, 5402, 5821, 6750, 7353]","[401, 829, 1032, 1417, 1823, 2108, 2709, 3101, 3475, 4285, 4634, 5259, 5715, 6173, 6524]","[237, 461, 551, 681, 1177, 1578, 1935, 2103, 2349, 2951, 3593, 3784, 4050, 4361, 4561]","[137, 361, 501, 675, 765, 907, 1035, 1171, 1438, 1770, 2337, 2557, 2889, 3163, 3311]",8019,7353,6524,4561,3311,49,59,86,98,79,"[61, 222, 623, 914, 1108, 1441, 1605, 1836, 2122, 2586, 3003, 3616, 4128, 4634, 5542]","[61, 151, 241, 566, 785, 1080, 1215, 1462, 1912, 2407, 2990, 3360, 3615, 4079, 4565]","[61, 199, 289, 424, 558, 648, 786, 939, 1076, 1418, 2223, 2646, 2832, 3353, 3501]","[329, 491, 734, 1077, 1332, 1747, 2040, 2323, 2581, 2716, 3115, 3253, 3429, 3524, 3744]","[61, 151, 241, 380, 470, 560, 812, 902, 1260, 1561, 2291, 2556, 2646, 2896, 3316]",5542,4565,3501,3744,3316,2477,2788,3023,817,-5,9100,15,radiant
7575770400,18,46,97,40,111,"[0, 242, 523, 974, 1387, 1598, 2093, 2677, 3226, 3562, 4155, 4870, 5591, 5907, 6884]","[0, 254, 453, 615, 787, 1083, 1482, 2052, 2569, 2834, 3450, 3888, 4093, 4888, 5771]","[0, 204, 563, 815, 1272, 1478, 1892, 2221, 2854, 2999, 3343, 3957, 4577, 5133, 5694]","[0, 169, 259, 353, 489, 627, 770, 915, 1106, 1435, 1838, 2160, 2481, 2724, 3655]","[0, 169, 305, 441, 580, 670, 809, 1191, 1351, 1666, 1815, 1931, 2202, 2351, 3105]",6884,5771,5694,3655,3105,89,49,104,105,86,"[0, 206, 533, 863, 1576, 1848, 2370, 2701, 3168, 3605, 4269, 4835, 5517, 6133, 7080]","[0, 327, 773, 1101, 1307, 1670, 2062, 2557, 2946, 3543, 4049, 4595, 5495, 6096, 6215]","[0, 323, 559, 1052, 1528, 1946, 2361, 2751, 3123, 3601, 4087, 4432, 5143, 5713, 6022]","[100, 269, 359, 449, 606, 696, 876, 1056, 1308, 1490, 1670, 1760, 2219, 2585, 2679]","[0, 169, 309, 496, 586, 724, 903, 1083, 1303, 1570, 1788, 1878, 2163, 2402, 2496]",7080,6215,6022,2679,2496,-196,-444,-328,976,609,617,15,radiant
7575788217,120,97,80,119,58,"[0, 241, 491, 869, 1293, 1681, 1975, 2584, 2986, 3409, 4030, 5116, 5596, 6273, 6901]","[0, 217, 574, 877, 1413, 1579, 2027, 2279, 2566, 3032, 3578, 4283, 4837, 5203, 5966]","[0, 207, 528, 931, 1416, 1716, 2114, 2618, 2900, 3371, 3636, 3983, 4288, 5106, 5649]","[0, 170, 595, 700, 961, 1098, 1330, 1465, 1606, 1933, 2255, 2860, 2950, 3283, 3468]","[0, 207, 297, 435, 605, 695, 975, 1232, 1483, 1675, 1912, 2219, 2421, 2926, 3263]",6901,5966,5649,3468,3263,25,54,129,5,100,"[0, 366, 743, 1123, 1560, 2030, 2451, 3019, 3462, 4198, 4686, 5404, 5773, 6172, 6784]","[0, 170, 409, 569, 1121, 1492, 1839, 2323, 2856, 3439, 4006, 4597, 5086, 5669, 6239]","[0, 258, 432, 804, 1243, 1498, 1972, 2300, 2806, 3264, 4031, 4781, 5215, 5676, 6083]","[0, 219, 309, 413, 670, 878, 968, 1125, 1270, 1360, 1495, 2067, 2277, 2535, 2812]","[0, 170, 260, 350, 568, 658, 856, 991, 1081, 1331, 1466, 1646, 1736, 1928, 2199]",6784,6239,6083,2812,2199,117,-273,-434,656,1064,1130,15,dire
7576274609,95,29,98,45,119,"[0, 316, 583, 1043, 1377, 1856, 2284, 2637, 3067, 3744, 4093, 4510, 5239, 5434, 6403]","[0, 314, 597, 830, 1105, 1584, 2077, 2568, 3000, 3595, 4328, 4937, 5389, 6138, 6570]","[0, 384, 708, 1006, 1400, 1880, 2208, 2617, 2836, 3402, 4069, 4667, 4963, 5761, 6227]","[0, 194, 284, 470, 646, 1047, 1213, 1628, 2036, 2387, 2831, 3052, 3142, 3412, 3927]","[0, 194, 284, 708, 838, 1000, 1351, 1609, 2048, 2228, 2438, 2668, 2854, 3097, 3396]",6403,6570,6227,3927,3396,106,84,41,40,21,"[0, 232, 356, 520, 802, 1018, 1513, 1724, 2162, 2561, 3241, 3531, 3920, 4425, 4846]","[0, 265, 431, 629, 993, 1298, 1555, 1911, 2207, 2521, 3031, 3486, 3576, 3986, 4230]","[0, 194, 468, 726, 1009, 1358, 1600, 1869, 2030, 2199, 2538, 2778, 3349, 3802, 4312]","[0, 194, 284, 419, 587, 834, 924, 1014, 1235, 1325, 1691, 1781, 2004, 2353, 2624]","[0, 194, 284, 374, 558, 693, 1081, 1171, 1410, 1585, 1765, 1855, 2058, 2581, 2993]",4846,4230,4312,2624,2993,1557,2340,1915,1303,403,7518,15,radiant
7576855616,61,48,59,123,64,"[0, 217, 576, 900, 1336, 1743, 2224, 2868, 3627, 4048, 4773, 5352, 6099, 6417, 7436]","[0, 251, 678, 1129, 1501, 1947, 2413, 2656, 3290, 3889, 4489, 4916, 5267, 5553, 6220]","[0, 292, 592, 1044, 1414, 1867, 2281, 2767, 3306, 3905, 4630, 5001, 5621, 6274, 6920]","[0, 170, 260, 400, 534, 624, 714, 894, 1368, 1671, 1806, 1977, 2101, 2246, 2439]","[0, 170, 276, 366, 811, 922, 1072, 1162, 1287, 1486, 1621, 1711, 2054, 2640, 2995]",7436,6220,6920,2439,2995,46,22,14,74,5,"[0, 242, 608, 968, 1269, 1821, 2265, 2715, 3236, 3716, 4302, 4923, 5681, 6593, 7109]","[0, 334, 732, 1150, 1519, 2276, 2858, 3471, 4197, 4659, 5176, 5516, 6160, 6417, 7071]","[0, 287, 595, 1081, 1618, 2176, 2576, 3127, 3584, 3971, 4272, 4726, 5615, 6069, 6453]","[0, 170, 260, 395, 625, 794, 1020, 1734, 1914, 2049, 2265, 2634, 2932, 3314, 3463]","[0, 170, 365, 503, 593, 736, 936, 1106, 1292, 1427, 1582, 1672, 2007, 2343, 2493]",7109,7071,6453,3463,2493,327,-851,467,-1024,502,-579,15,dire
7576963416,54,126,2,30,5,"[0, 233, 472, 910, 1275, 1549, 1914, 2429, 2825, 2915, 3050, 3462, 3827, 4585, 4977]","[0, 202, 523, 862, 1359, 1659, 1989, 2402, 2821, 3345, 3861, 4364, 5132, 5325, 5663]","[0, 239, 402, 687, 985, 1271, 1740, 2181, 2698, 3314, 3628, 4161, 4812, 5115, 5818]","[0, 129, 219, 309, 759, 898, 1281, 1406, 1580, 2161, 2644, 2872, 3253, 3348, 3676]","[0, 129, 219, 357, 494, 584, 720, 845, 1039, 1129, 1264, 1404, 1586, 1719, 1926]",4977,5663,5818,3676,1926,82,23,7,88,71,"[0, 290, 667, 950, 1277, 1847, 2793, 3481, 3964, 4848, 5216, 5902, 6605, 7033, 8101]","[0, 293, 740, 1102, 1464, 1937, 2337, 2637, 3285, 3813, 4361, 4987, 5674, 6148, 7020]","[0, 280, 570, 886, 1381, 1728, 2145, 2832, 3277, 3717, 4106, 4584, 5202, 5399, 6185]","[0, 209, 350, 440, 530, 708, 919, 1163, 1298, 1717, 2179, 2359, 2876, 3220, 3423]","[0, 209, 333, 423, 513, 826, 1111, 1355, 1498, 1736, 1861, 2182, 2652, 2747, 2984]",8101,7020,6185,3423,2984,-3124,-1357,-367,253,-1058,-5653,15,dire
7577028402,48,35,21,26,100,"[0, 203, 446, 682, 967, 1261, 1781, 2429, 2776, 3443, 3869, 4578, 5192, 5891, 6624]","[0, 219, 618, 950, 1289, 2052, 2573, 3369, 4229, 5206, 6254, 6654, 7566, 8468, 9037]","[0, 204, 599, 809, 1219, 1528, 1952, 2495, 3059, 3565, 4271, 4783, 5611, 6402, 6998]","[0, 130, 569, 659, 749, 885, 975, 1110, 1511, 1960, 2208, 2372, 2810, 3051, 3331]","[0, 130, 220, 376, 512, 702, 882, 1410, 1500, 1968, 2142, 2373, 2625, 2810, 3274]",6624,9037,6998,3331,3274,46,22,96,86,27,"[0, 335, 738, 1225, 1632, 2029, 2395, 2881, 3214, 3655, 3837, 4414, 4811, 5546, 6369]","[0, 329, 645, 1058, 1527, 1942, 2199, 2588, 3059, 3414, 3965, 4851, 5371, 6478, 6763]","[0, 280, 704, 1038, 1519, 1979, 2253, 2415, 2702, 2831, 3152, 3722, 4436, 5214, 5804]","[0, 210, 300, 417, 884, 974, 1064, 1154, 1589, 1889, 1979, 2271, 2426, 2977, 3222]","[0, 210, 300, 435, 615, 769, 859, 997, 1195, 1285, 1375, 1644, 1734, 2123, 2368]",6369,6763,5804,3222,2368,255,2274,1194,109,906,4738,15,radiant
7577175100,52,84,4,48,121,"[0, 334, 583, 877, 1249, 1652, 2000, 2563, 3249, 3803, 4622, 5897, 6508, 7020, 7551]","[0, 280, 536, 716, 1229, 1485, 1952, 2293, 2506, 2857, 3316, 4467, 5282, 5424, 5856]","[0, 283, 560, 818, 1196, 1596, 1759, 2297, 3020, 3578, 4000, 4945, 5489, 6017, 6732]","[0, 215, 305, 395, 485, 575, 710, 879, 1186, 1491, 1704, 2678, 2935, 3241, 3707]","[0, 170, 260, 424, 514, 642, 732, 867, 1244, 1426, 1516, 2017, 2152, 2353, 2677]",7551,5856,6732,3707,2677,69,126,21,45,87,"[0, 242, 519, 865, 1167, 1493, 1905, 2390, 2575, 2916, 3302, 3442, 3961, 4470, 5083]","[0, 325, 648, 1020, 1360, 1818, 2277, 2419, 2924, 3486, 3774, 3912, 4420, 5238, 6201]","[0, 242, 652, 933, 1279, 1656, 1993, 2386, 2818, 3315, 3695, 3977, 4321, 5128, 5759]","[0, 170, 260, 350, 526, 616, 706, 908, 1032, 1305, 1616, 1744, 1878, 2290, 2512]","[0, 170, 615, 795, 954, 1089, 1179, 1317, 1407, 1727, 1939, 2029, 2119, 2637, 2966]",5083,6201,5759,2512,2966,2468,-345,973,1195,-289,4002,15,dire
7577206517,48,39,137,65,84,"[0, 274, 695, 1019, 1230, 1395, 1805, 2302, 2570, 3022, 3616, 4261, 4855, 5899, 6597]","[0, 314, 599, 775, 1284, 1541, 2294, 2814, 3496, 3586, 4112, 5166, 5620, 5803, 6397]","[0, 202, 365, 752, 1062, 1467, 1636, 2134, 2588, 3005, 3274, 4144, 4446, 5117, 5476]","[0, 520, 610, 745, 835, 1107, 1319, 1536, 1744, 1952, 2225, 2476, 2995, 3487, 3706]","[0, 204, 294, 440, 584, 1216, 1577, 1729, 1865, 2161, 2499, 3122, 3304, 3579, 3886]",6597,6397,5476,3706,3886,10,126,96,53,121,"[0, 245, 517, 799, 1243, 1609, 2112, 2612, 2981, 3545, 4228, 4779, 5690, 6318, 6938]","[0, 286, 497, 698, 910, 1186, 1512, 1803, 2147, 2656, 2966, 3147, 3388, 3917, 4608]","[0, 209, 376, 740, 1153, 1818, 2208, 2814, 3194, 3637, 4088, 4301, 4891, 5471, 5981]","[0, 209, 299, 433, 830, 1002, 1314, 1523, 1752, 1906, 2075, 2165, 2391, 2751, 3303]","[0, 209, 415, 526, 787, 959, 1223, 1485, 1703, 2298, 2434, 2780, 2915, 3178, 3592]",6938,4608,5981,3303,3592,-341,1789,-505,403,294,1640,15,radiant
7577341016,109,126,14,119,85,"[0, 275, 644, 939, 1419, 1963, 2347, 2864, 3412, 3978, 4515, 5000, 5588, 6260, 6842]","[0, 366, 804, 1210, 1633, 2161, 2611, 3160, 3715, 4189, 4745, 5480, 6033, 6665, 7349]","[0, 239, 484, 935, 1303, 1755, 2119, 2658, 3134, 3432, 3885, 4387, 4597, 5081, 5692]","[0, 170, 260, 398, 537, 716, 806, 988, 1542, 1681, 1815, 2552, 2642, 2904, 3134]","[0, 170, 260, 350, 485, 663, 753, 891, 1026, 1116, 1254, 1392, 1528, 1623, 1808]",6842,7349,5692,3134,1808,17,10,16,86,87,"[0, 330, 826, 1387, 1976, 2457, 2962, 3538, 4118, 4631, 5179, 5639, 6309, 6613, 7390]","[0, 282, 654, 1015, 1523, 1972, 2265, 2793, 3001, 3532, 3847, 4150, 4444, 5092, 5956]","[0, 275, 648, 1154, 1601, 2022, 2416, 2870, 3320, 3777, 4231, 4724, 5184, 5484, 6167]","[0, 170, 296, 492, 670, 869, 1006, 1189, 1279, 1553, 1723, 1912, 2153, 2298, 2744]","[0, 221, 352, 461, 635, 770, 860, 1044, 1153, 1590, 1741, 1884, 1974, 2432, 2748]",7390,5956,6167,2744,2748,-548,1393,-475,390,-940,-180,15,radiant
7577579206,93,120,28,66,123,"[0, 170, 482, 698, 985, 1188, 1681, 2091, 2951, 3888, 4521, 4953, 5660, 6137, 6855]","[0, 288, 562, 894, 1022, 1314, 2053, 2388, 3066, 3321, 4427, 4857, 5521, 6095, 6798]","[0, 204, 530, 767, 997, 1436, 1825, 2237, 2327, 2671, 3171, 3898, 4196, 4741, 5339]","[0, 216, 366, 770, 918, 1113, 1508, 1782, 2333, 2787, 3262, 3595, 3958, 4281, 4980]","[0, 170, 309, 399, 580, 805, 985, 1247, 1337, 1427, 1751, 1977, 2410, 2558, 2932]",6855,6798,5339,4980,2932,48,106,14,53,27,"[0, 208, 483, 863, 1096, 1545, 2030, 2485, 2992, 3679, 4184, 4833, 5575, 6426, 7342]","[0, 276, 602, 1064, 1588, 1978, 2544, 2869, 3766, 4360, 4488, 4742, 5044, 5680, 5956]","[0, 205, 441, 1054, 1278, 1797, 2050, 2501, 2916, 3310, 3697, 3787, 3877, 4486, 4923]","[0, 170, 260, 602, 761, 941, 1300, 1554, 1924, 2285, 2503, 2658, 2826, 3128, 3292]","[0, 220, 310, 682, 772, 989, 1145, 1399, 1534, 1987, 2251, 2341, 2431, 3216, 3452]",7342,5956,4923,3292,3452,-487,842,416,1688,-520,1939,15,radiant
7577870703,10,49,53,97,26,"[0, 204, 473, 802, 1170, 1394, 1899, 2400, 2900, 3260, 4074, 4663, 5294, 5798, 5927]","[0, 314, 604, 1085, 1251, 1496, 2090, 2553, 3137, 3599, 4274, 4618, 5115, 5884, 6284]","[0, 170, 260, 350, 528, 656, 1122, 1245, 1479, 1569, 1905, 2748, 2972, 3298, 3495]","[0, 242, 489, 774, 1059, 1360, 1616, 1958, 2225, 2614, 3051, 3653, 3887, 4466, 4827]","[0, 170, 358, 492, 622, 712, 880, 970, 1060, 1150, 1389, 1562, 1817, 2201, 2466]",5927,6284,3495,4827,2466,48,65,96,20,79,"[0, 294, 572, 736, 1107, 1349, 1928, 2365, 2894, 3660, 4318, 5094, 5821, 6668, 7318]","[0, 209, 497, 829, 1135, 1404, 1747, 2280, 2869, 3665, 3983, 4503, 5004, 5905, 6282]","[0, 255, 611, 899, 1301, 1671, 2044, 2479, 2820, 3279, 3877, 4458, 4979, 5521, 6311]","[0, 170, 260, 445, 940, 1084, 1507, 1687, 1834, 2090, 2380, 2614, 3032, 3531, 3680]","[0, 170, 279, 422, 641, 731, 821, 1050, 1314, 1633, 2210, 2822, 3088, 3409, 3766]",7318,6282,6311,3680,3766,-1391,2,-2816,1147,-1300,-4358,15,radiant
7577913613,106,128,10,58,45,"[0, 473, 1017, 1420, 1812, 2144, 2738, 3289, 3959, 4245, 4489, 5227, 5698, 6206, 7305]","[0, 333, 542, 907, 1358, 1947, 2385, 3000, 3306, 3961, 4231, 4763, 5493, 6260, 6669]","[0, 245, 594, 854, 1113, 1506, 1892, 2182, 2764, 3195, 3704, 3888, 4409, 4901, 5525]","[0, 170, 306, 396, 770, 1055, 1667, 2341, 2649, 3122, 3547, 3731, 4224, 4946, 5261]","[0, 170, 275, 365, 501, 719, 809, 989, 1253, 1603, 1934, 2267, 2688, 3335, 3595]",7305,6669,5525,5261,3595,33,15,98,110,62,"[58, 263, 454, 837, 1149, 1554, 1943, 2394, 2917, 3245, 3474, 4003, 4621, 4964, 5287]","[326, 530, 698, 861, 1064, 1274, 1653, 1904, 2162, 2386, 2903, 3899, 4181, 4523, 4869]","[0, 204, 461, 802, 1173, 1497, 1804, 2192, 2327, 2788, 3184, 3457, 3897, 4329, 4424]","[58, 228, 382, 493, 655, 780, 1084, 1500, 1635, 2029, 2338, 3045, 3225, 3535, 3794]","[58, 228, 360, 508, 645, 782, 896, 1045, 1322, 1544, 1783, 2370, 2709, 2923, 3465]",5287,4869,4424,3794,3465,2018,1800,1101,1467,130,6516,15,radiant
7578076914,25,70,98,20,121,"[0, 278, 402, 655, 979, 1223, 1762, 2325, 2855, 3249, 3865, 3992, 4177, 4609, 5263]","[0, 628, 805, 963, 1419, 1699, 1941, 2150, 2452, 2542, 3205, 3760, 4097, 4836, 5230]","[0, 278, 563, 1081, 1398, 1758, 2072, 2416, 2826, 3443, 4187, 4328, 4565, 5126, 5861]","[100, 339, 429, 563, 825, 1170, 1260, 1505, 1595, 1685, 2195, 2457, 2607, 2850, 3011]","[0, 218, 308, 479, 663, 799, 1154, 1474, 1593, 1683, 2008, 2098, 2248, 2396, 2643]",5263,5230,5861,3011,2643,113,114,29,53,27,"[0, 289, 650, 992, 1366, 1780, 2140, 2658, 3406, 4102, 4817, 5877, 6840, 7541, 7899]","[0, 293, 612, 935, 1247, 1537, 1732, 2037, 2494, 2823, 3040, 3499, 4439, 4971, 5390]","[0, 208, 569, 772, 1116, 1331, 1603, 2247, 2834, 3516, 3845, 4581, 5222, 5926, 6498]","[0, 170, 260, 901, 1283, 1465, 2051, 2296, 2768, 3285, 3614, 4097, 4836, 5159, 5568]","[0, 170, 260, 350, 577, 707, 944, 1125, 1509, 1715, 1932, 2184, 2922, 3125, 3219]",7899,5390,6498,5568,3219,-2636,-160,-637,-2557,-576,-6566,15,dire
7578151603,44,98,23,75,101,"[0, 244, 454, 857, 1436, 1770, 2246, 2669, 3151, 3369, 3782, 4325, 4775, 5637, 6110]","[0, 208, 621, 957, 1373, 1791, 2195, 2509, 2842, 3601, 4441, 4920, 5534, 6789, 7245]","[0, 243, 443, 685, 924, 1110, 1348, 1664, 2238, 2445, 3292, 3833, 4281, 4940, 5738]","[0, 169, 259, 394, 601, 739, 999, 1356, 1446, 1672, 2061, 2448, 2583, 3089, 3437]","[0, 169, 605, 908, 1082, 1216, 1306, 1498, 1874, 1964, 2359, 2600, 2690, 2929, 3078]",6110,7245,5738,3437,3078,38,114,93,123,26,"[0, 243, 537, 844, 1127, 1873, 2318, 2621, 3292, 3551, 4339, 4693, 5407, 5971, 6833]","[0, 281, 599, 827, 1291, 1587, 2072, 2579, 3029, 3513, 3826, 4626, 5270, 6171, 6612]","[0, 275, 478, 875, 1114, 1373, 1742, 2111, 2606, 3151, 3391, 4180, 4686, 5257, 5676]","[0, 169, 303, 441, 647, 1136, 1226, 1445, 1868, 2222, 2462, 2774, 2894, 3254, 3581]","[0, 169, 259, 394, 519, 771, 878, 1058, 1283, 1472, 1738, 2045, 2135, 2745, 3023]",6833,6612,5676,3581,3023,-723,633,62,-144,55,-117,15,dire
7578386514,73,39,129,58,26,"[0, 538, 807, 1376, 1848, 2208, 2753, 3097, 3689, 4106, 4854, 5182, 5995, 6441, 6870]","[0, 279, 561, 878, 1312, 1565, 2084, 2398, 2857, 3191, 3798, 4398, 5070, 5788, 6273]","[0, 361, 690, 936, 1220, 1770, 2368, 2762, 3100, 3670, 4180, 4479, 4956, 5395, 5709]","[100, 653, 743, 833, 1027, 1212, 1320, 1563, 1903, 2088, 2240, 2530, 2899, 3142, 3453]","[0, 285, 440, 530, 763, 925, 1423, 1513, 1696, 1986, 2453, 2692, 3021, 3222, 3617]",6870,6273,5709,3453,3617,48,28,21,100,20,"[0, 278, 677, 1080, 1654, 2057, 2255, 2834, 3257, 3511, 4035, 4744, 5772, 6360, 7332]","[0, 129, 492, 827, 1206, 1586, 1984, 2367, 2815, 3142, 3428, 4107, 4450, 4918, 5519]","[0, 422, 765, 1058, 1389, 1682, 1997, 2531, 2920, 3193, 3817, 4189, 4780, 5082, 5582]","[0, 129, 219, 309, 565, 701, 1066, 1293, 1640, 1865, 2000, 2313, 2646, 2990, 3198]","[0, 206, 326, 516, 784, 964, 1089, 1305, 1487, 1695, 1978, 2240, 2535, 2630, 2928]",7332,5519,5582,3198,2928,-462,754,127,255,689,1363,15,radiant
7578531212,41,120,98,65,121,"[0, 239, 441, 570, 947, 1099, 1298, 1756, 2094, 2453, 2854, 3279, 3656, 4129, 4972]","[0, 247, 499, 822, 1135, 1386, 1574, 1995, 2171, 2729, 3313, 3502, 4479, 4971, 5972]","[0, 206, 333, 648, 872, 1117, 1315, 1915, 2158, 2774, 3686, 4255, 4421, 5405, 6027]","[0, 170, 341, 526, 898, 1074, 1164, 1631, 1721, 1858, 2253, 2460, 2864, 3246, 3815]","[0, 170, 310, 419, 593, 736, 860, 1257, 1347, 1572, 2041, 2131, 2489, 2728, 3292]",4972,5972,6027,3815,3292,46,23,96,68,26,"[0, 323, 667, 868, 1356, 1660, 2218, 2701, 3203, 3783, 4268, 4915, 5757, 6474, 7195]","[0, 294, 619, 1029, 1318, 1734, 2157, 2549, 3065, 3689, 4128, 4582, 4821, 5476, 5684]","[0, 241, 482, 695, 1114, 1435, 1716, 2107, 2462, 2879, 3014, 3390, 3605, 4200, 4334]","[0, 170, 260, 350, 440, 610, 918, 1172, 1262, 1505, 1852, 2212, 2408, 2730, 2825]","[0, 170, 593, 683, 922, 1012, 1293, 1473, 1590, 1722, 1867, 2003, 2181, 2388, 2521]",7195,5684,4334,2825,2521,-2223,288,1693,990,771,1519,15,radiant
7578636015,113,46,49,86,85,"[0, 380, 698, 1103, 1906, 2356, 2689, 3051, 3516, 3975, 4516, 5081, 5738, 6278, 7131]","[0, 239, 440, 854, 1384, 1643, 1984, 2421, 3016, 3516, 4270, 4974, 5674, 6268, 7098]","[0, 204, 562, 889, 1333, 1725, 2083, 2173, 2819, 3554, 3933, 4488, 5204, 5688, 6367]","[0, 170, 260, 386, 623, 781, 1213, 1372, 1764, 2053, 2243, 2582, 3060, 4346, 4688]","[0, 170, 260, 395, 530, 706, 913, 1003, 1230, 1669, 1759, 1998, 2137, 2456, 2605]",7131,7098,6367,4688,2605,11,6,96,84,19,"[0, 326, 703, 1072, 1604, 2152, 2717, 3407, 3931, 4582, 5093, 5680, 6356, 6822, 7125]","[0, 279, 477, 800, 1130, 1539, 1904, 2362, 2603, 2772, 3183, 3610, 4375, 4874, 5448]","[0, 209, 498, 796, 1167, 1410, 1746, 2043, 2295, 2685, 2933, 3387, 4037, 4481, 4931]","[0, 170, 305, 395, 560, 660, 1034, 1169, 1341, 1465, 1601, 1751, 2012, 2215, 2388]","[0, 170, 260, 350, 515, 605, 822, 996, 1086, 1176, 1451, 1674, 1971, 2302, 2536]",7125,5448,4931,2388,2536,6,1650,1436,2300,69,5461,15,radiant
7578647418,1,63,120,105,100,"[0, 241, 572, 863, 1194, 1357, 1688, 1896, 2073, 2458, 3084, 3875, 4580, 4986, 5220]","[0, 221, 386, 748, 1246, 1819, 2487, 2879, 3444, 4109, 4467, 5322, 5808, 6447, 6761]","[0, 279, 563, 1008, 1409, 1772, 2185, 2518, 3042, 3672, 4056, 4576, 5086, 5478, 5824]","[0, 170, 278, 413, 543, 711, 880, 1015, 1135, 1643, 1778, 2316, 2447, 2865, 3089]","[0, 208, 298, 424, 691, 856, 1093, 1482, 1618, 1909, 2081, 2579, 2808, 3215, 3309]",5220,6761,5824,3089,3309,94,98,106,65,86,"[0, 389, 559, 981, 1143, 1433, 1821, 2216, 2599, 3018, 3303, 3972, 4423, 5044, 5850]","[0, 305, 601, 1055, 1221, 1628, 2165, 2590, 3188, 4051, 4547, 5227, 5940, 6681, 7220]","[0, 688, 931, 1437, 1730, 2109, 2582, 3394, 3724, 4172, 4549, 5284, 5870, 6236, 6790]","[0, 232, 322, 459, 549, 719, 1110, 1403, 1519, 1813, 1950, 2442, 2806, 3180, 3457]","[0, 232, 358, 497, 736, 906, 1342, 1639, 1787, 2159, 2563, 2759, 3412, 3655, 3940]",5850,7220,6790,3457,3940,-630,-459,-966,-368,-631,-3054,15,radiant
7578648816,80,98,74,105,26,"[0, 256, 536, 992, 1236, 1638, 2198, 2446, 2792, 3254, 3908, 4579, 5077, 5272, 6168]","[0, 294, 544, 1030, 1386, 1623, 1955, 2089, 2713, 3220, 3885, 4450, 5072, 5647, 5929]","[0, 296, 609, 996, 1251, 1482, 1774, 2116, 2782, 3333, 3646, 4095, 4554, 5000, 5792]","[0, 170, 260, 475, 565, 655, 745, 835, 1139, 1401, 1705, 1949, 2440, 2649, 3115]","[0, 170, 260, 394, 518, 608, 724, 814, 1296, 1692, 1821, 1911, 2205, 2438, 2622]",6168,5929,5792,3115,2622,25,120,97,86,83,"[0, 204, 570, 1126, 1801, 2353, 2728, 3437, 3861, 4328, 4841, 5441, 5914, 6462, 6839]","[0, 347, 633, 922, 1383, 1769, 1980, 2604, 2817, 3146, 3780, 4142, 4848, 5099, 5769]","[0, 255, 874, 1037, 1364, 1738, 1962, 2281, 2578, 2826, 3190, 3621, 4163, 4530, 4836]","[0, 209, 368, 504, 641, 839, 958, 1198, 1580, 1670, 1937, 2105, 2331, 2812, 3291]","[0, 170, 260, 503, 713, 1291, 1510, 1938, 2028, 2118, 2253, 2691, 2917, 3199, 3353]",6839,5769,4836,3291,3353,-671,160,956,-176,-731,-462,15,dire
7578694819,18,106,129,123,110,"[73, 319, 690, 1130, 1546, 1934, 2182, 2651, 3574, 4110, 5015, 5462, 6799, 8406, 9828]","[206, 416, 669, 859, 1115, 1205, 1474, 1778, 2275, 2460, 3318, 3826, 4502, 4952, 5220]","[73, 352, 476, 862, 1120, 1426, 1794, 2135, 2393, 2835, 3327, 3650, 4392, 4747, 5058]","[73, 283, 373, 508, 598, 725, 815, 995, 1085, 1302, 1584, 1837, 2078, 2526, 2839]","[73, 283, 373, 508, 650, 853, 943, 1123, 1251, 1520, 2197, 2640, 3387, 3939, 4285]",9828,5220,5058,2839,4285,73,50,53,96,5,"[390, 599, 1030, 1339, 1797, 2368, 3067, 3373, 4023, 4963, 5871, 6744, 6970, 8441, 9411]","[253, 573, 891, 1439, 1683, 2213, 2730, 3183, 3638, 4239, 4567, 4934, 5390, 5766, 6272]","[220, 350, 633, 888, 1242, 1682, 1939, 2029, 2274, 3018, 3349, 3669, 3794, 4134, 4747]","[120, 325, 600, 805, 1175, 1386, 1854, 2325, 2632, 2944, 3250, 3409, 3499, 3821, 3953]","[120, 302, 470, 560, 716, 854, 1158, 1305, 1676, 1931, 2223, 2360, 2450, 2628, 2857]",9411,6272,4747,3953,2857,417,-1052,311,-1114,1428,-10,15,radiant
7578698215,97,49,74,121,45,"[0, 248, 515, 813, 1123, 1499, 1722, 2324, 2571, 3196, 3752, 4100, 4291, 4876, 5398]","[0, 170, 531, 819, 1040, 1211, 1461, 1596, 1946, 2332, 2828, 3198, 3695, 3806, 4296]","[0, 214, 588, 947, 1273, 1610, 1941, 2778, 3075, 3165, 3300, 3432, 4083, 4336, 5368]","[0, 170, 260, 463, 553, 728, 902, 1297, 1753, 1887, 2022, 2112, 2275, 2519, 3100]","[0, 214, 356, 515, 605, 742, 923, 1058, 1365, 1455, 1749, 1930, 2020, 2115, 2796]",5398,4296,5368,3100,2796,41,47,19,20,51,"[0, 204, 547, 885, 1203, 1716, 1878, 2121, 2672, 3080, 3792, 4836, 5442, 6099, 6544]","[0, 251, 494, 972, 1361, 1710, 2375, 3164, 3598, 4414, 5299, 5661, 6148, 7115, 7719]","[0, 209, 462, 784, 1141, 1508, 1908, 2067, 2546, 2913, 3623, 4151, 4739, 5235, 5673]","[0, 272, 362, 551, 1058, 1188, 1442, 1669, 1961, 2221, 3112, 3464, 3628, 3972, 4495]","[0, 170, 303, 393, 559, 775, 865, 955, 1184, 1394, 2177, 2529, 2874, 3491, 3927]",6544,7719,5673,4495,3927,-1146,-3423,-305,-1395,-1131,-7400,15,dire
7578746005,95,17,20,100,45,"[142, 661, 972, 1338, 1557, 1942, 2193, 2628, 3255, 3591, 4131, 4472, 4919, 5372, 6332]","[408, 792, 1086, 1507, 2036, 2567, 3187, 4462, 4800, 5148, 5753, 6465, 6555, 6704, 7382]","[142, 498, 698, 898, 1285, 1968, 2506, 3159, 3294, 4019, 4255, 4613, 4965, 5542, 6038]","[142, 383, 473, 563, 693, 919, 1358, 1810, 2016, 2251, 2522, 2715, 2969, 3164, 3499]","[142, 587, 677, 848, 978, 1155, 1290, 1854, 2071, 2161, 2417, 2507, 2597, 2772, 3000]",6332,7382,6038,3499,3000,1,96,138,106,83,"[187, 357, 756, 1247, 1442, 1804, 1894, 2154, 2775, 3217, 3642, 4227, 4655, 5216, 5412]","[187, 509, 775, 1044, 1439, 2038, 2410, 2925, 3109, 3678, 4243, 4886, 5457, 5811, 6237]","[320, 702, 792, 931, 1591, 2012, 2166, 2388, 2670, 2841, 3024, 3248, 3709, 4372, 4554]","[121, 367, 494, 775, 1103, 1410, 1582, 1800, 1941, 2820, 3235, 3415, 3969, 4489, 4879]","[588, 758, 1105, 1299, 1635, 1763, 2029, 2164, 2375, 2482, 3098, 3611, 4067, 4367, 4461]",5412,6237,4554,4879,4461,920,1145,1484,-1380,-1461,708,15,dire
7579453609,75,102,90,53,119,"[0, 269, 513, 918, 1555, 1964, 2628, 3005, 3412, 4170, 4635, 5222, 5791, 6457, 7226]","[0, 234, 395, 695, 1025, 1567, 2078, 2393, 2768, 3216, 3625, 4357, 4919, 5402, 5991]","[0, 281, 603, 919, 1095, 1385, 1977, 2289, 2587, 3076, 3680, 4233, 4785, 5652, 5962]","[0, 565, 704, 889, 1091, 1465, 1731, 1866, 2349, 2752, 3004, 3476, 3721, 4284, 4663]","[0, 196, 286, 406, 544, 965, 1145, 1235, 1868, 2135, 2357, 2626, 2716, 3008, 3257]",7226,5991,5962,4663,3257,41,120,98,105,20,"[0, 282, 709, 980, 1375, 1500, 1812, 2340, 2785, 2941, 3260, 3674, 4283, 4665, 4988]","[0, 331, 665, 1153, 1540, 1823, 2222, 2801, 3019, 3395, 4035, 4396, 4959, 5512, 5758]","[0, 210, 446, 768, 1153, 1735, 2326, 2574, 2855, 3058, 3682, 4045, 4472, 4763, 4908]","[0, 210, 300, 390, 480, 695, 889, 979, 1115, 1250, 1599, 1689, 1851, 2146, 2572]","[0, 210, 377, 467, 602, 692, 782, 971, 1221, 1393, 1607, 1854, 1962, 2193, 2640]",4988,5758,4908,2572,2640,2238,233,1054,2091,617,6233,15,radiant
7579518917,48,43,123,97,26,"[0, 174, 479, 722, 1006, 1324, 1627, 2007, 2338, 2834, 3246, 3747, 4423, 5102, 5196]","[0, 506, 756, 1012, 1422, 1670, 2289, 3366, 3791, 4542, 4941, 5462, 6000, 6671, 6804]","[0, 462, 637, 762, 1008, 1133, 1315, 1603, 1796, 2043, 2268, 2599, 3081, 3338, 3609]","[0, 404, 605, 874, 1413, 1760, 2309, 2720, 3265, 3797, 4604, 5099, 5520, 5875, 6257]","[0, 462, 598, 737, 905, 1041, 1176, 1673, 1896, 2178, 2488, 2625, 2765, 3328, 3422]",5196,6804,3609,6257,3422,49,46,28,121,105,"[0, 396, 709, 879, 1140, 1558, 1901, 2430, 2851, 3151, 3484, 4015, 4635, 5061, 6355]","[0, 685, 857, 1224, 1603, 2039, 2334, 2590, 3062, 3560, 4218, 4865, 5295, 5836, 7044]","[0, 206, 477, 889, 1017, 1481, 1949, 2464, 2784, 3222, 3608, 4043, 4604, 4805, 5814]","[0, 438, 528, 666, 756, 975, 1188, 1323, 1727, 2043, 2266, 2410, 2572, 2769, 3392]","[0, 305, 395, 485, 603, 821, 911, 1046, 1181, 1316, 1483, 1699, 1789, 2287, 2861]",6355,7044,5814,3392,2861,-1159,-240,-2205,2865,561,-178,15,radiant
7579888814,46,39,123,19,73,"[1, 216, 485, 766, 1114, 1509, 2219, 2664, 2866, 3226, 3736, 4238, 4773, 5166, 5677]","[1, 246, 427, 688, 1014, 1389, 1608, 2071, 2524, 3056, 3223, 3526, 3937, 4079, 4798]","[1, 171, 296, 425, 550, 640, 815, 1061, 1151, 1400, 1612, 1702, 2256, 2388, 2854]","[1, 205, 366, 495, 812, 919, 1020, 1241, 1331, 1459, 1872, 1962, 2299, 2393, 2856]","[1, 251, 341, 692, 891, 1147, 1398, 1691, 1781, 2030, 2120, 2267, 2405, 2499, 2702]",5677,4798,2854,2856,2702,68,136,43,96,83,"[1, 245, 594, 920, 1419, 1804, 2186, 2403, 3136, 3961, 4341, 4855, 5439, 6025, 6412]","[1, 318, 857, 1581, 1756, 2269, 2977, 3629, 4111, 4993, 5543, 6234, 6645, 7208, 7653]","[1, 358, 595, 911, 1204, 1704, 2352, 2911, 3360, 3737, 4179, 5182, 5860, 6252, 7001]","[1, 271, 554, 907, 997, 1349, 1548, 1683, 1830, 2356, 2589, 2916, 3120, 3719, 4078]","[1, 507, 659, 937, 1100, 1457, 1713, 1848, 2548, 3090, 3585, 3931, 4254, 4557, 4821]",6412,7653,7001,4078,4821,-735,-2855,-4147,-1222,-2119,-11078,15,radiant
7580040907,1,49,14,86,123,"[0, 259, 532, 995, 1259, 1622, 1820, 2629, 3037, 3509, 4101, 4744, 5185, 6131, 6313]","[0, 364, 814, 1190, 1482, 2064, 2584, 2984, 3547, 4006, 4595, 5522, 6399, 7188, 7676]","[0, 282, 612, 871, 1227, 1764, 2284, 2824, 3268, 3752, 4412, 5209, 5569, 6644, 6774]","[0, 261, 351, 758, 848, 1064, 1226, 1506, 1668, 1852, 2250, 2721, 3002, 3428, 3999]","[0, 210, 405, 570, 660, 873, 963, 1308, 1452, 1587, 1888, 2233, 2593, 2996, 3140]",6313,7676,6774,3999,3140,12,106,43,31,121,"[0, 236, 434, 918, 1237, 1354, 1494, 1890, 2116, 2392, 2679, 3070, 3333, 4009, 4605]","[0, 250, 518, 848, 1074, 1435, 1675, 2089, 2306, 2804, 2980, 3243, 3631, 3949, 4269]","[0, 547, 821, 1019, 1599, 1763, 2115, 2388, 2547, 3060, 3318, 3535, 3917, 4275, 5219]","[0, 200, 290, 510, 649, 746, 968, 1058, 1148, 1238, 1376, 1514, 1751, 1968, 2096]","[0, 200, 290, 415, 803, 893, 1031, 1245, 1424, 1514, 1724, 1814, 1904, 2044, 2138]",4605,4269,5219,2096,2138,1708,3407,1555,1903,1002,9575,15,radiant
7580268816,21,48,13,62,64,"[0, 204, 691, 972, 1371, 1641, 2270, 2811, 3644, 4305, 4787, 5781, 6405, 7303, 8040]","[0, 279, 555, 910, 1244, 1659, 2019, 2383, 2887, 3343, 3934, 4646, 5281, 5824, 6183]","[0, 327, 653, 1033, 1356, 1782, 2372, 2810, 3636, 4116, 4609, 4878, 5417, 6155, 6698]","[0, 187, 622, 789, 947, 1077, 1234, 1344, 1606, 1714, 1804, 2022, 2377, 2696, 3086]","[0, 170, 260, 394, 533, 671, 808, 902, 1139, 1274, 1412, 1614, 1790, 1939, 2166]",8040,6183,6698,3086,2166,25,16,138,67,97,"[0, 340, 664, 1085, 1463, 2163, 2800, 3304, 3990, 4557, 5407, 6617, 7268, 8056, 8877]","[0, 280, 571, 1053, 1414, 1741, 2343, 2727, 3173, 3538, 3954, 4380, 4870, 5526, 6243]","[0, 222, 312, 481, 669, 850, 1034, 1195, 1401, 1673, 1977, 2121, 2430, 2716, 2932]","[0, 283, 490, 672, 922, 1135, 1309, 1693, 1865, 2004, 2473, 2720, 3217, 3484, 4046]","[0, 170, 260, 583, 673, 763, 898, 1033, 1404, 1530, 1701, 1883, 2202, 2618, 2979]",8877,6243,2932,4046,2979,-837,-60,3766,-960,-813,1096,15,radiant
7580411710,18,120,137,53,20,"[0, 278, 475, 984, 1356, 1642, 2000, 2319, 2712, 2929, 3385, 3844, 5097, 5617, 6586]","[0, 208, 521, 848, 1186, 1498, 1988, 2359, 2649, 3065, 3688, 4065, 4708, 5371, 5837]","[0, 170, 328, 551, 679, 996, 1306, 1588, 2126, 2341, 2870, 3326, 3632, 3933, 4631]","[0, 270, 411, 1064, 1154, 1284, 1459, 1594, 1835, 2371, 2599, 2812, 3445, 3779, 4269]","[0, 213, 303, 539, 712, 873, 1048, 1257, 1586, 1969, 2262, 2463, 2823, 2918, 3188]",6586,5837,4631,4269,3188,95,39,96,58,105,"[0, 293, 713, 1110, 1461, 2040, 2292, 2784, 3293, 3615, 4138, 4568, 5161, 5841, 6309]","[0, 280, 560, 843, 1214, 1551, 1641, 2195, 2861, 3292, 3710, 4291, 5019, 5804, 6004]","[0, 208, 527, 735, 1078, 1583, 1789, 2212, 2958, 3577, 4315, 5179, 5878, 6131, 6309]","[0, 170, 260, 396, 486, 704, 794, 929, 1298, 1639, 1802, 2037, 2331, 2920, 3182]","[0, 170, 260, 412, 548, 806, 896, 1031, 1121, 1321, 1643, 2166, 2484, 2826, 2920]",6309,6004,6309,3182,2920,277,-167,-1678,1087,268,-213,15,dire
7580511616,62,106,41,53,40,"[2, 170, 453, 790, 1449, 1731, 2336, 2583, 3223, 4088, 5108, 5334, 6540, 7013, 7354]","[0, 243, 503, 833, 1316, 1729, 2100, 2585, 3100, 4059, 4563, 5537, 6264, 6660, 7165]","[0, 164, 326, 926, 1241, 1562, 1861, 2117, 2523, 2931, 3555, 4098, 4877, 5386, 5968]","[0, 131, 264, 354, 622, 718, 1162, 1252, 1688, 1990, 2322, 2607, 3284, 3433, 4174]","[0, 129, 219, 309, 509, 599, 760, 866, 1129, 1564, 1869, 2119, 2382, 2631, 2823]",7354,7165,5968,4174,2823,89,98,39,19,112,"[0, 291, 536, 1151, 1325, 1690, 2002, 2188, 2494, 3060, 3517, 4044, 4513, 5179, 6028]","[0, 247, 707, 894, 1320, 1686, 2022, 2674, 3005, 4062, 4450, 4865, 4955, 5897, 6425]","[0, 361, 649, 1039, 1402, 1713, 1927, 2360, 2537, 3071, 3161, 3378, 3600, 4336, 4702]","[0, 209, 299, 414, 504, 674, 933, 1113, 1203, 1557, 1764, 1931, 2114, 2403, 2746]","[0, 209, 299, 535, 625, 761, 966, 1146, 1236, 1590, 1719, 1844, 2079, 2787, 2928]",6028,6425,4702,2746,2928,1326,740,1266,1428,-105,4655,15,radiant
7580525516,109,7,97,65,20,"[0, 216, 462, 965, 1240, 1590, 1874, 2667, 3127, 3569, 3890, 4369, 5011, 5928, 6579]","[0, 205, 621, 956, 1487, 1781, 2266, 2763, 3063, 3601, 4146, 4813, 4903, 5579, 5805]","[0, 241, 606, 732, 1383, 1820, 2431, 2777, 3567, 3953, 4320, 4979, 5436, 6538, 6982]","[0, 130, 220, 462, 552, 669, 759, 1105, 1195, 1469, 1718, 1863, 1953, 2950, 3045]","[0, 130, 270, 452, 729, 914, 1129, 1264, 1354, 1444, 1797, 2149, 2262, 2843, 2966]",6579,5805,6982,3045,2966,12,120,43,100,31,"[0, 284, 592, 867, 1153, 1543, 1793, 2243, 2415, 2896, 3292, 3842, 4349, 4759, 5153]","[0, 282, 526, 860, 1250, 1923, 2250, 2628, 3413, 3904, 4341, 4724, 5276, 5425, 6215]","[0, 246, 336, 674, 956, 1291, 1932, 2187, 2752, 3363, 3889, 3979, 4433, 4941, 5635]","[0, 210, 334, 590, 680, 953, 1238, 1328, 2012, 2504, 2683, 2773, 2944, 3039, 3408]","[0, 210, 300, 390, 480, 627, 844, 1014, 1197, 1790, 1925, 2389, 2634, 2729, 3060]",5153,6215,5635,3408,3060,1426,-410,1347,-363,-94,1906,15,dire
7580560302,49,43,129,128,121,"[0, 207, 598, 761, 1223, 1703, 2238, 2698, 3001, 3515, 4076, 4592, 5374, 5841, 6412]","[0, 362, 628, 845, 1141, 1418, 1774, 2171, 2761, 3647, 4118, 4411, 5196, 5579, 6025]","[0, 252, 450, 974, 1227, 1521, 1911, 2310, 2803, 3109, 3424, 3893, 4480, 4938, 5415]","[0, 170, 353, 711, 861, 991, 1196, 1405, 1540, 1764, 2014, 2152, 2415, 2509, 2704]","[0, 170, 600, 690, 857, 1080, 1250, 1459, 1594, 2061, 2607, 2697, 2991, 3119, 3433]",6412,6025,5415,2704,3433,47,93,106,123,110,"[0, 241, 522, 858, 1206, 1618, 1818, 2393, 2828, 3203, 3734, 4254, 4530, 5472, 5986]","[0, 170, 483, 700, 1195, 1534, 1838, 1991, 2361, 2852, 3390, 3809, 4596, 5607, 6245]","[0, 170, 440, 719, 1049, 1299, 1795, 2070, 2447, 2707, 3042, 3265, 3441, 4091, 4573]","[100, 270, 360, 497, 856, 1029, 1205, 1373, 1463, 1553, 1741, 1831, 1923, 2125, 2368]","[0, 170, 260, 350, 526, 700, 1062, 1230, 1365, 1455, 1643, 1843, 1946, 2202, 2450]",5986,6245,4573,2368,2450,426,-220,842,336,983,2367,15,dire
7580843816,57,16,10,22,5,"[0, 252, 574, 986, 1351, 1755, 2075, 2446, 2754, 3250, 3959, 4305, 4836, 5470, 5750]","[0, 238, 454, 744, 1094, 1473, 2056, 2446, 2949, 3939, 4387, 4988, 5528, 6028, 6537]","[0, 285, 524, 840, 1243, 1481, 1993, 2421, 2880, 3203, 3941, 4455, 4944, 5039, 5457]","[2, 132, 261, 396, 526, 665, 769, 859, 1036, 1357, 1650, 1788, 2077, 2374, 2791]","[0, 130, 220, 357, 574, 699, 805, 942, 1032, 1122, 1303, 1440, 1674, 1824, 1919]",5750,6537,5457,2791,1919,96,76,89,86,20,"[0, 283, 651, 1189, 1549, 1992, 2285, 3085, 3795, 4371, 4889, 5290, 5806, 6365, 7034]","[0, 320, 606, 949, 1333, 1755, 2199, 2698, 3108, 3554, 3911, 4434, 5063, 6149, 6877]","[0, 288, 491, 787, 1237, 1612, 2126, 2632, 3257, 3682, 4276, 4873, 5433, 6322, 7214]","[0, 210, 349, 483, 617, 707, 842, 1174, 1503, 1638, 2061, 2189, 2279, 2778, 3314]","[0, 210, 300, 533, 668, 808, 994, 1250, 1386, 1519, 1693, 1970, 2124, 2640, 3282]",7034,6877,7214,3314,3282,-1284,-340,-1757,-523,-1363,-5267,15,radiant
7580940704,18,120,80,33,26,"[0, 242, 601, 934, 1113, 1488, 1726, 2083, 2471, 2831, 3514, 3986, 4394, 4910, 5576]","[0, 169, 441, 696, 1176, 1554, 1799, 2285, 2833, 3343, 3943, 4721, 5230, 5703, 6637]","[0, 292, 563, 940, 1212, 1554, 1910, 2371, 2757, 3250, 3677, 4076, 4410, 4758, 5520]","[0, 215, 331, 545, 740, 937, 1064, 1579, 1851, 2030, 2294, 2562, 2652, 3029, 3416]","[0, 169, 302, 437, 527, 632, 751, 969, 1069, 1248, 1514, 1688, 1922, 2150, 2747]",5576,6637,5520,3416,2747,114,49,38,121,105,"[0, 167, 488, 692, 906, 1308, 1470, 1822, 2102, 2248, 2895, 3149, 3785, 4237, 4816]","[0, 267, 621, 908, 1323, 1809, 2142, 2594, 3081, 3547, 4203, 4873, 5347, 5824, 6080]","[61, 224, 503, 783, 1252, 1569, 1858, 2293, 2468, 2724, 2960, 3614, 4034, 4392, 4834]","[61, 388, 478, 651, 784, 969, 1059, 1288, 1378, 1514, 1806, 2145, 2294, 2540, 2790]","[329, 458, 548, 638, 789, 959, 1063, 1243, 1368, 1497, 2003, 2496, 2649, 2961, 3252]",4816,6080,4834,2790,3252,760,557,686,626,-505,2124,15,radiant
7581196114,34,41,28,20,101,"[0, 214, 500, 906, 1289, 1632, 1851, 2111, 2447, 2732, 3010, 3453, 3543, 3638, 3918]","[0, 243, 415, 789, 1193, 1492, 1655, 2041, 2414, 2917, 3271, 4062, 4407, 4698, 5254]","[0, 239, 599, 689, 813, 1348, 1607, 2104, 2399, 2617, 2927, 3174, 3420, 3640, 3872]","[0, 170, 260, 434, 611, 838, 928, 1018, 1152, 1552, 1702, 2053, 2143, 2387, 2666]","[0, 170, 260, 350, 440, 577, 667, 804, 943, 1033, 1183, 1273, 1411, 1506, 1937]",3918,5254,3872,2666,1937,94,25,98,86,26,"[61, 315, 644, 1148, 1465, 1589, 1982, 2368, 2810, 3258, 3874, 4720, 5292, 5688, 6355]","[61, 268, 394, 518, 762, 1050, 1303, 1685, 2064, 2403, 3195, 3934, 4554, 4996, 5090]","[61, 307, 785, 949, 1229, 1789, 2252, 2509, 2909, 3188, 3918, 4262, 4792, 5274, 5474]","[61, 231, 518, 608, 747, 960, 1099, 1189, 1361, 1523, 2187, 2493, 2673, 2912, 3041]","[329, 499, 589, 753, 1021, 1111, 1291, 1381, 1519, 1609, 2025, 2331, 2627, 2866, 3131]",6355,5090,5474,3041,3131,-2437,164,-1602,-375,-1194,-5444,15,dire
7581204412,95,23,69,3,20,"[417, 676, 938, 1188, 1510, 1894, 2494, 2864, 3323, 3791, 4308, 4672, 5143, 5673, 6096]","[151, 435, 773, 972, 1349, 1739, 1911, 2406, 2783, 2922, 3899, 4332, 4773, 5323, 5945]","[151, 321, 661, 868, 1372, 1731, 2298, 2554, 2852, 3327, 4169, 4542, 4846, 5304, 5770]","[151, 370, 460, 584, 713, 1007, 1453, 1595, 1780, 1956, 2226, 2452, 2677, 2977, 3328]","[0, 170, 459, 595, 685, 849, 1028, 1268, 1403, 1741, 2350, 2558, 2786, 2935, 3268]",6096,5945,5770,3328,3268,48,34,28,136,30,"[321, 411, 571, 993, 1320, 1572, 1824, 2330, 2760, 3204, 3823, 4113, 4811, 5312, 5505]","[53, 254, 489, 861, 1144, 1357, 1683, 1939, 2254, 2393, 2920, 3156, 3342, 3484, 3732]","[53, 177, 339, 640, 851, 941, 1068, 1278, 1761, 1851, 2250, 2361, 2451, 2776, 2955]","[53, 180, 270, 360, 539, 663, 753, 877, 1097, 1187, 1586, 1762, 1998, 2158, 2444]","[53, 143, 233, 372, 549, 639, 802, 968, 1353, 1443, 2083, 2173, 2263, 2406, 2501]",5505,3732,2955,2444,2501,591,2213,2815,884,767,7270,15,radiant
7581227105,106,29,80,21,136,"[0, 337, 576, 837, 1454, 1829, 2200, 2728, 3335, 3698, 4127, 4753, 5610, 6383, 7098]","[0, 277, 521, 799, 1313, 1912, 2212, 2637, 3052, 3811, 4313, 5379, 6208, 7102, 7972]","[0, 329, 651, 987, 1274, 1898, 2410, 2903, 3345, 3886, 4421, 5180, 5845, 6592, 7146]","[0, 170, 310, 405, 589, 871, 961, 1313, 1612, 1827, 1917, 2211, 2658, 2855, 3345]","[0, 170, 260, 350, 488, 715, 904, 1084, 1220, 1359, 1782, 2195, 2711, 3036, 3303]",7098,7972,7146,3345,3303,97,12,7,121,19,"[0, 205, 458, 582, 775, 904, 1072, 1378, 1761, 1885, 2196, 2706, 3361, 3514, 4156]","[0, 204, 452, 662, 752, 961, 1293, 1684, 2049, 2366, 2714, 3000, 3533, 3628, 3866]","[0, 205, 376, 719, 809, 1232, 1513, 1724, 1939, 2393, 2616, 2792, 2882, 3098, 3325]","[0, 170, 260, 429, 519, 647, 785, 921, 1056, 1146, 1281, 1537, 1709, 1804, 1953]","[0, 170, 260, 350, 440, 530, 620, 755, 890, 980, 1149, 1276, 1366, 1500, 1594]",4156,3866,3325,1953,1594,2942,4106,3821,1392,1709,13970,15,radiant
7581551218,44,76,43,65,20,"[58, 306, 515, 719, 1306, 1656, 1841, 2046, 2747, 3271, 3754, 4548, 5116, 5610, 6040]","[58, 383, 752, 1057, 1337, 1702, 1947, 2364, 3040, 3874, 4301, 4871, 5371, 5625, 6774]","[326, 568, 1140, 1742, 2150, 2404, 2766, 3351, 3722, 4485, 4683, 5127, 5710, 6643, 7722]","[58, 228, 318, 408, 498, 653, 743, 833, 1215, 1341, 1502, 1734, 1914, 2168, 2749]","[58, 228, 383, 539, 715, 843, 933, 1023, 1203, 1484, 1732, 1910, 2134, 2449, 2804]",6040,6774,7722,2749,2804,4,28,126,105,27,"[0, 204, 467, 593, 966, 1434, 1944, 2203, 2427, 2672, 3120, 3410, 3817, 4270, 4871]","[0, 246, 512, 1021, 1234, 1669, 1962, 2648, 2773, 3103, 3996, 4370, 4888, 5521, 6048]","[0, 206, 534, 708, 916, 1131, 1382, 1636, 1726, 1899, 2572, 2789, 2982, 3560, 3867]","[0, 170, 260, 398, 759, 893, 1028, 1632, 1840, 1980, 2255, 2498, 2588, 2939, 3246]","[0, 214, 304, 394, 580, 764, 948, 1083, 1173, 1480, 1937, 2027, 2163, 2366, 2948]",4871,6048,3867,3246,2948,1169,726,3855,-497,-144,5109,15,radiant
7581551219,13,10,96,21,5,"[0, 337, 514, 816, 1103, 1518, 1870, 2360, 2817, 3391, 3819, 4598, 4965, 5775, 6075]","[0, 242, 573, 863, 1101, 1432, 1760, 2258, 2508, 2804, 3176, 3636, 3823, 4341, 4898]","[0, 240, 498, 901, 1028, 1612, 1897, 2409, 2783, 3050, 3355, 3526, 3852, 4387, 4734]","[0, 169, 610, 748, 838, 1388, 1517, 1924, 2014, 2247, 2382, 2684, 2882, 3314, 3579]","[0, 169, 259, 398, 488, 658, 748, 1328, 1418, 1599, 1734, 1824, 2174, 2457, 2705]",6075,4898,4734,3579,2705,126,136,69,112,86,"[0, 322, 704, 1108, 1435, 1774, 2070, 2361, 2651, 3392, 3804, 3946, 4647, 5229, 5650]","[0, 241, 487, 949, 1186, 1510, 1918, 2307, 3101, 3691, 4535, 4854, 5629, 6098, 6565]","[0, 207, 557, 882, 1500, 1831, 2386, 2768, 3285, 3635, 4229, 4749, 5472, 6016, 6559]","[0, 169, 259, 429, 582, 717, 890, 1130, 1522, 1720, 1944, 2181, 2908, 3261, 3484]","[0, 218, 308, 448, 649, 797, 1011, 1101, 1932, 2022, 2477, 3163, 3520, 4145, 4362]",5650,6565,6559,3484,4362,425,-1667,-1825,95,-1657,-4629,15,dire
7581657607,113,93,28,56,26,"[0, 275, 591, 924, 1334, 1699, 1972, 2678, 2803, 3728, 4201, 4970, 5148, 5608, 6244]","[0, 321, 581, 779, 1030, 1433, 1925, 2311, 2520, 2782, 3045, 3389, 3825, 4277, 4987]","[0, 241, 473, 960, 1358, 1885, 2131, 2472, 2703, 3138, 3614, 4296, 4527, 4872, 5194]","[0, 170, 278, 419, 631, 779, 1001, 1294, 1673, 2113, 2362, 2885, 3242, 3337, 3700]","[0, 170, 297, 435, 641, 820, 1064, 1598, 1723, 1863, 2048, 2375, 2465, 2560, 2783]",6244,4987,5194,3700,2783,49,21,126,114,58,"[0, 241, 573, 821, 1236, 1643, 1937, 2325, 3116, 3494, 4273, 4868, 5115, 5815, 6284]","[0, 170, 511, 801, 1039, 1330, 1793, 2215, 2891, 3334, 3794, 4096, 4714, 5438, 5867]","[0, 208, 495, 743, 1118, 1578, 1948, 2239, 2550, 2863, 3573, 3752, 4839, 5379, 5751]","[0, 218, 372, 580, 1063, 1291, 1426, 1841, 2141, 2241, 2671, 2815, 3108, 3782, 4008]","[0, 170, 260, 411, 549, 684, 835, 1072, 1485, 1575, 2007, 2285, 2697, 3028, 3197]",6284,5867,5751,4008,3197,-40,-880,-557,-308,-414,-2199,15,dire
7581700206,95,36,14,53,26,"[0, 517, 788, 1028, 1283, 1783, 1923, 2810, 3207, 3523, 3880, 4402, 4602, 5617, 6316]","[0, 491, 737, 991, 1270, 1530, 1968, 2488, 2988, 3193, 3283, 3561, 3914, 4892, 5071]","[0, 381, 577, 860, 1260, 1633, 1908, 2314, 3120, 3470, 3808, 4058, 4642, 5073, 5216]","[0, 302, 536, 626, 878, 1004, 1134, 1495, 1698, 2179, 2269, 2413, 2503, 2842, 3116]","[0, 337, 427, 563, 697, 862, 992, 1176, 1442, 1597, 1697, 1841, 2081, 2760, 2855]",6316,5071,5216,3116,2855,47,41,28,121,3,"[0, 543, 864, 1150, 1359, 1734, 2254, 2598, 2946, 3430, 4371, 4888, 5505, 5984, 6407]","[0, 214, 455, 662, 876, 1270, 1591, 1969, 2249, 2635, 3074, 3905, 4252, 4623, 5152]","[0, 307, 475, 821, 1189, 1279, 1959, 2049, 2357, 2571, 3584, 4039, 4815, 5170, 5429]","[0, 268, 441, 548, 683, 773, 1184, 1274, 1364, 1498, 1838, 2183, 2700, 2912, 3084]","[0, 401, 531, 621, 715, 853, 1171, 1261, 1369, 1510, 1884, 2229, 2359, 2454, 2622]",6407,5152,5429,3084,2622,-91,-81,-213,32,233,-120,15,dire
7581788819,10,71,97,5,86,"[0, 208, 504, 843, 1255, 1532, 1866, 2747, 3139, 4011, 4479, 5452, 6418, 6686, 7442]","[0, 482, 790, 1051, 1569, 1699, 2293, 2658, 3036, 3414, 3959, 4579, 5108, 6082, 6510]","[0, 247, 539, 739, 1142, 1623, 1819, 2083, 2531, 2755, 3440, 3770, 3967, 4313, 4804]","[0, 230, 405, 495, 631, 902, 1039, 1386, 1476, 1763, 2405, 2976, 3378, 3723, 3925]","[0, 568, 706, 796, 973, 1103, 1380, 1717, 2092, 2619, 2937, 3237, 3524, 3753, 4450]",7442,6510,4804,3925,4450,106,69,93,65,58,"[0, 322, 818, 1241, 1656, 1823, 2228, 2708, 3119, 3613, 3836, 4126, 5318, 6154, 7104]","[0, 204, 509, 1073, 1528, 1726, 2198, 2481, 3241, 3731, 4152, 4342, 5206, 5850, 6505]","[0, 244, 487, 684, 1059, 1555, 1803, 2307, 2700, 3245, 3731, 4138, 4334, 4795, 5895]","[0, 169, 273, 520, 715, 805, 1043, 1178, 1563, 1929, 2177, 2540, 2884, 3497, 4022]","[0, 169, 259, 383, 618, 1004, 1390, 1570, 2028, 2339, 2528, 2908, 3708, 4149, 4525]",7104,6505,5895,4022,4525,338,5,-1091,-97,-75,-920,15,radiant
7582214316,1,47,23,105,26,"[0, 377, 659, 1024, 1619, 2032, 2400, 3060, 3675, 4051, 4157, 4585, 5004, 5581, 6026]","[0, 201, 492, 701, 1113, 1284, 1652, 2291, 2596, 2964, 3488, 3949, 4418, 5055, 5494]","[0, 495, 728, 991, 1482, 1647, 2010, 2397, 2821, 3286, 3686, 4256, 4918, 5220, 5401]","[0, 398, 488, 599, 798, 1146, 1236, 1778, 2271, 2475, 2565, 2797, 2977, 3148, 3243]","[0, 265, 444, 853, 1104, 1194, 1333, 1697, 1849, 2223, 3179, 3398, 3578, 3809, 3904]",6026,5494,5401,3243,3904,69,17,21,86,72,"[0, 369, 618, 828, 993, 1227, 1513, 1930, 2060, 2322, 2864, 3532, 4010, 4508, 5325]","[0, 366, 650, 1207, 1384, 1707, 2329, 2934, 3380, 4465, 4822, 5219, 5683, 5897, 6341]","[0, 241, 558, 813, 1061, 1484, 1804, 2210, 2977, 3784, 4004, 4422, 5257, 5533, 5878]","[0, 380, 470, 560, 874, 1317, 1543, 1891, 2134, 3035, 3436, 3920, 4561, 4703, 5338]","[0, 646, 736, 1054, 1178, 1399, 1751, 2223, 2464, 3384, 3604, 3694, 4174, 4393, 4788]",5325,6341,5878,5338,4788,701,-847,-477,-2095,-884,-3602,15,radiant
7582237301,114,15,48,51,83,"[0, 322, 715, 1170, 1610, 2243, 2766, 3221, 3824, 4359, 5051, 5538, 6279, 6968, 7681]","[0, 205, 518, 795, 1670, 2042, 2475, 3044, 3774, 4076, 4464, 4879, 5416, 6117, 6926]","[0, 245, 625, 955, 1405, 1868, 2210, 2558, 2980, 3224, 3673, 4130, 4875, 5437, 6104]","[0, 170, 310, 400, 676, 893, 1064, 1455, 1638, 1828, 2182, 2574, 3000, 3430, 3998]","[0, 207, 338, 566, 741, 966, 1245, 1796, 2127, 2255, 2864, 3412, 3592, 3867, 4216]",7681,6926,6104,3998,4216,49,6,11,58,86,"[0, 243, 457, 706, 1063, 1303, 1781, 2316, 2694, 3684, 3994, 4720, 5443, 6205, 6886]","[0, 207, 564, 839, 1004, 1571, 1695, 1915, 2126, 2955, 3416, 3760, 4328, 4681, 5227]","[0, 322, 617, 1003, 1497, 1979, 2523, 3194, 3572, 4151, 4665, 5373, 5993, 6773, 7381]","[0, 221, 311, 401, 491, 698, 943, 1078, 1296, 1553, 1765, 2062, 2353, 2502, 2703]","[0, 217, 307, 470, 605, 739, 920, 1099, 1235, 1676, 1815, 2226, 2507, 2656, 2840]",6886,5227,7381,2703,2840,795,1699,-1277,1295,1376,3888,15,radiant
7582264918,93,106,96,123,26,"[0, 320, 551, 831, 1100, 1428, 1636, 2241, 2415, 2786, 3252, 3687, 4270, 4410, 5078]","[0, 293, 661, 1020, 1345, 1784, 2430, 2845, 3142, 3839, 4303, 4895, 5375, 5961, 6257]","[0, 209, 490, 872, 1111, 1610, 1811, 2254, 2673, 3543, 3853, 4555, 4827, 5076, 5646]","[0, 252, 342, 534, 711, 847, 937, 1433, 1637, 2110, 2245, 2462, 2907, 3610, 3818]","[0, 356, 834, 1017, 1171, 1310, 1411, 1750, 1886, 2091, 2312, 2521, 2735, 2990, 3139]",5078,6257,5646,3818,3139,18,97,23,105,45,"[0, 245, 532, 948, 1398, 1728, 2147, 2905, 3534, 4123, 4541, 5059, 5609, 7071, 7689]","[0, 167, 568, 906, 1268, 1936, 2219, 2771, 3487, 4170, 4588, 5172, 5819, 6262, 6911]","[0, 250, 602, 984, 1345, 1752, 1925, 2394, 2753, 3675, 4168, 4677, 5245, 6058, 6336]","[0, 129, 377, 467, 604, 861, 951, 1131, 1325, 1983, 2261, 2351, 2639, 2816, 3064]","[0, 129, 270, 386, 745, 986, 1081, 1307, 1397, 1798, 1955, 2262, 2406, 3068, 3217]",7689,6911,6336,3064,3217,-2611,-654,-690,754,-78,-3279,15,dire
7582314402,89,120,112,121,96,"[0, 291, 526, 856, 1667, 1960, 2316, 2807, 3467, 3970, 4500, 5108, 5499, 6256, 6984]","[0, 330, 574, 786, 1243, 1578, 2003, 2530, 2869, 3126, 3760, 4082, 4788, 5406, 6012]","[0, 245, 526, 931, 1306, 2059, 2284, 2529, 3139, 3576, 4079, 4642, 5172, 5793, 6468]","[0, 209, 351, 493, 863, 1051, 1190, 1404, 1539, 1800, 1949, 2136, 2281, 2478, 3660]","[0, 209, 372, 556, 787, 1133, 1345, 1451, 1664, 1904, 2158, 2248, 2430, 2715, 3451]",6984,6012,6468,3660,3451,49,4,92,33,100,"[0, 632, 967, 1225, 1596, 1985, 2425, 3190, 3780, 4422, 5021, 5689, 6481, 7426, 7710]","[0, 273, 644, 938, 1352, 1561, 2037, 2485, 2805, 3153, 3555, 3986, 4245, 4896, 5119]","[0, 240, 499, 925, 1098, 1298, 1828, 2376, 2879, 3249, 3837, 4272, 4633, 5125, 5496]","[0, 200, 310, 473, 575, 772, 936, 1173, 1440, 1701, 2039, 2538, 2962, 3377, 3526]","[0, 200, 308, 470, 595, 685, 775, 1087, 1352, 1531, 1666, 1929, 2159, 2473, 2622]",7710,5119,5496,3526,2622,-726,893,972,134,829,2102,15,dire
7582625110,97,105,96,107,102,"[0, 174, 617, 996, 1441, 1870, 2491, 2931, 3472, 4300, 4757, 5690, 6125, 6919, 7855]","[0, 174, 537, 793, 1226, 1614, 1986, 2255, 2501, 3093, 3854, 5095, 5533, 5989, 6433]","[0, 208, 408, 876, 1289, 1684, 1890, 2320, 2484, 3127, 3533, 3945, 4360, 4900, 5482]","[0, 89, 179, 505, 735, 940, 1030, 1165, 1255, 1653, 2358, 2592, 2892, 3514, 4189]","[0, 89, 237, 374, 604, 710, 1179, 1334, 1469, 1708, 2035, 2269, 2621, 2997, 3463]",7855,6433,5482,4189,3463,49,21,41,26,51,"[0, 395, 836, 1225, 1621, 2041, 2653, 3051, 4051, 4156, 5162, 5868, 6602, 7377, 7695]","[0, 324, 613, 1025, 1464, 1691, 2178, 2475, 2767, 3065, 3335, 4014, 4717, 5384, 5593]","[0, 312, 513, 791, 1042, 1218, 1795, 2050, 2411, 2635, 2980, 3788, 4544, 5185, 5723]","[0, 318, 491, 915, 1005, 1133, 1359, 1531, 1898, 2036, 2386, 2923, 3221, 3501, 3650]","[0, 274, 364, 501, 591, 715, 979, 1069, 1240, 1498, 1783, 2381, 2556, 2789, 2988]",7695,5593,5723,3650,2988,160,840,-241,539,475,1773,15,radiant
7582644709,19,63,14,64,101,"[0, 283, 684, 1016, 1354, 1685, 2072, 2328, 3217, 3972, 4502, 4982, 5407, 6234, 6963]","[0, 363, 720, 1060, 1518, 1769, 2256, 2465, 3029, 3641, 4297, 4948, 5367, 5791, 6485]","[0, 296, 670, 906, 1180, 1663, 1888, 2253, 2538, 3038, 3523, 4024, 4533, 4784, 5136]","[0, 210, 300, 390, 528, 664, 884, 1054, 1231, 1482, 1712, 1977, 2486, 2892, 3257]","[0, 210, 300, 419, 509, 668, 758, 893, 1265, 1355, 1829, 2009, 2099, 2465, 2787]",6963,6485,5136,3257,2787,88,104,6,53,26,"[0, 238, 558, 1063, 1521, 1847, 2147, 2755, 3003, 3182, 3767, 4014, 4590, 5245, 5536]","[0, 205, 582, 862, 1216, 1577, 1826, 2197, 2448, 2571, 2927, 3326, 3578, 4135, 4754]","[0, 327, 572, 814, 1177, 1569, 1984, 2475, 2778, 3088, 3616, 3988, 4692, 5373, 5986]","[100, 569, 659, 749, 879, 1015, 1105, 1367, 1457, 1547, 1816, 2082, 2558, 2838, 3269]","[0, 201, 291, 386, 580, 670, 793, 1022, 1112, 1202, 1337, 1442, 1726, 1937, 2031]",5536,4754,5986,3269,2031,1427,1731,-850,-12,756,3052,15,dire
7582691602,25,93,65,51,110,"[0, 276, 604, 1052, 1342, 1797, 2291, 2626, 3484, 4065, 4567, 4952, 5405, 5750, 6354]","[0, 326, 697, 1124, 1377, 1761, 2008, 2357, 2648, 2970, 3320, 3689, 4441, 5197, 5809]","[0, 208, 384, 511, 985, 1137, 1351, 1548, 1824, 2077, 2589, 3132, 3385, 4355, 4527]","[0, 170, 301, 435, 525, 655, 794, 929, 1019, 1154, 1617, 1751, 2003, 2856, 2951]","[0, 170, 260, 464, 657, 826, 952, 1086, 1211, 1383, 1605, 1695, 1948, 2136, 2384]",6354,5809,4527,2951,2384,70,14,129,119,111,"[0, 332, 677, 1114, 1485, 2130, 2595, 2956, 3945, 4509, 5113, 5606, 6138, 6604, 6936]","[0, 277, 545, 905, 1319, 1652, 1932, 2303, 2516, 3123, 3808, 3898, 4388, 4977, 5741]","[0, 204, 535, 862, 1143, 1475, 1962, 2423, 2912, 3259, 3877, 4291, 4563, 5069, 5527]","[0, 170, 671, 1008, 1564, 1818, 2143, 2278, 2793, 2922, 3377, 3724, 3814, 3909, 4103]","[0, 170, 260, 464, 668, 772, 1036, 1434, 1573, 1707, 2182, 2321, 2411, 2545, 2640]",6936,5741,5527,4103,2640,-582,68,-1000,-1152,-256,-2922,15,radiant
7582756500,120,12,86,14,3,"[0, 240, 613, 1132, 1595, 2093, 2484, 3118, 3728, 4293, 4939, 5481, 6149, 6817, 7389]","[0, 243, 429, 800, 1210, 1629, 2142, 2665, 3056, 3422, 3822, 4092, 4620, 5758, 6103]","[0, 220, 310, 463, 649, 828, 1115, 1357, 1548, 1788, 1926, 2188, 2415, 2734, 3084]","[0, 278, 679, 987, 1313, 1682, 1887, 2134, 2378, 3023, 3476, 3710, 4015, 4635, 5012]","[0, 170, 260, 429, 632, 866, 1047, 1182, 1289, 1424, 1514, 1882, 2073, 2401, 2665]",7389,6103,3084,5012,2665,17,13,38,53,5,"[0, 368, 722, 1226, 1769, 2281, 2940, 3477, 4174, 4618, 5388, 6221, 6828, 7604, 8355]","[0, 293, 581, 989, 1511, 1953, 2493, 3032, 3473, 4041, 4557, 5181, 5787, 6505, 7266]","[0, 242, 404, 736, 1133, 1708, 2030, 2450, 3322, 3695, 4255, 4680, 4923, 5165, 5505]","[0, 170, 260, 436, 613, 882, 1052, 1333, 1423, 1610, 1981, 2490, 2728, 3657, 3877]","[0, 170, 260, 350, 528, 618, 772, 952, 1080, 1191, 1326, 1535, 1682, 2052, 2259]",8355,7266,5505,3877,2259,-966,-1163,-2421,1135,406,-3009,15,dire
7582847210,36,48,58,84,86,"[0, 241, 653, 1089, 1503, 1914, 2326, 3129, 3597, 4138, 4629, 5327, 5840, 6241, 7033]","[0, 325, 641, 1070, 1710, 2268, 2735, 3309, 3767, 4080, 4669, 5389, 5973, 6587, 6772]","[0, 293, 593, 988, 1434, 1850, 2363, 2754, 3432, 3782, 4032, 4397, 4838, 5499, 5766]","[0, 169, 284, 418, 587, 855, 945, 1035, 1299, 1655, 1835, 2033, 2182, 2403, 2588]","[0, 169, 259, 426, 561, 697, 832, 922, 1144, 1273, 1363, 1600, 1765, 1860, 2331]",7033,6772,5766,2588,2331,11,17,28,20,114,"[75, 398, 747, 1205, 1605, 2159, 2915, 3464, 3857, 4521, 5423, 6400, 7441, 8315, 9513]","[75, 447, 850, 1307, 1855, 2512, 3003, 3580, 4052, 4552, 5131, 5683, 6381, 7173, 8497]","[75, 319, 583, 1002, 1424, 1639, 2178, 2533, 3275, 4000, 4454, 5055, 5435, 6210, 7067]","[75, 244, 334, 424, 554, 700, 1016, 1151, 1392, 1728, 2375, 2688, 3063, 3462, 3957]","[75, 244, 334, 424, 554, 684, 866, 1001, 1226, 1768, 1903, 2128, 2477, 2876, 3246]",9513,8497,7067,3957,3246,-2480,-1725,-1301,-1369,-915,-7790,15,dire
7582859002,48,106,96,86,21,"[0, 206, 489, 957, 1348, 1776, 2469, 3011, 3524, 4177, 5071, 5793, 6667, 7759, 8685]","[0, 214, 510, 807, 968, 1298, 1476, 2115, 2769, 3208, 3789, 4205, 4548, 4985, 5510]","[0, 258, 530, 819, 1174, 1393, 1757, 2357, 2803, 3314, 3815, 4546, 5025, 5702, 6145]","[0, 218, 359, 498, 951, 1360, 1580, 1870, 2008, 2424, 2629, 3178, 3394, 3935, 4914]","[0, 170, 260, 394, 583, 699, 789, 1080, 1232, 1394, 1576, 1982, 2720, 3053, 3756]",8685,5510,6145,4914,3756,25,97,14,45,26,"[0, 286, 590, 1090, 1413, 1503, 1945, 2208, 2725, 3138, 3880, 4357, 4711, 5536, 6421]","[0, 209, 520, 820, 1242, 1420, 1778, 2019, 2653, 2949, 3450, 3557, 4367, 5144, 5838]","[0, 279, 515, 679, 1177, 1267, 1457, 1832, 2321, 2708, 3177, 3714, 4347, 4706, 4801]","[0, 215, 305, 395, 584, 762, 867, 957, 1209, 1299, 1784, 1920, 2194, 2556, 2651]","[0, 170, 312, 438, 615, 792, 885, 975, 1155, 1245, 1517, 1607, 2488, 2823, 2981]",6421,5838,4801,2651,2981,2264,-328,1344,2263,775,6318,15,radiant
7583012200,89,106,137,112,105,"[0, 321, 625, 1048, 1256, 1628, 2355, 2621, 3145, 3698, 4447, 5148, 5565, 6279, 7260]","[0, 243, 446, 536, 735, 934, 1522, 1867, 2158, 2611, 2985, 3584, 4215, 4748, 4847]","[0, 296, 533, 977, 1172, 1512, 2129, 2566, 3072, 3331, 4207, 4703, 5176, 5976, 6071]","[0, 209, 299, 389, 479, 697, 1075, 1291, 1381, 1507, 1717, 1841, 2217, 2511, 2825]","[0, 209, 299, 389, 479, 657, 1035, 1170, 1322, 1489, 1705, 1795, 2010, 2159, 2254]",7260,4847,6071,2825,2254,73,46,50,19,111,"[0, 263, 527, 991, 1528, 2095, 2284, 2623, 2982, 3638, 4502, 5049, 6274, 7237, 8104]","[0, 205, 530, 693, 1212, 1577, 1902, 2423, 2918, 3550, 4162, 4733, 5490, 6408, 6984]","[0, 166, 479, 971, 1422, 1913, 2523, 2929, 3605, 4063, 4402, 5049, 5517, 6023, 6649]","[0, 168, 334, 588, 762, 913, 1070, 1323, 1503, 1633, 2028, 2240, 2584, 2939, 3173]","[0, 229, 349, 439, 529, 619, 917, 1007, 1187, 1367, 1568, 1851, 2090, 2239, 2646]",8104,6984,6649,3173,2646,-844,-2137,-578,-348,-392,-4299,15,dire
7583044908,81,55,114,71,37,"[0, 281, 602, 765, 1282, 1991, 2317, 2585, 3152, 3551, 4106, 4358, 4725, 5796, 6318]","[0, 217, 427, 628, 1075, 1331, 1654, 1935, 2311, 2619, 3078, 3287, 3713, 4568, 4875]","[0, 214, 428, 685, 1016, 1495, 1850, 2313, 2536, 2786, 3130, 3434, 3668, 4389, 4693]","[0, 170, 260, 433, 572, 696, 902, 1163, 1378, 1468, 1867, 2069, 2584, 3054, 3734]","[0, 170, 260, 350, 530, 905, 1118, 1330, 1510, 1600, 2109, 2340, 3012, 3430, 3787]",6318,4875,4693,3734,3787,50,28,21,14,83,"[0, 298, 669, 1042, 1547, 1823, 2303, 2875, 3244, 3924, 4556, 5060, 5557, 5954, 6618]","[0, 296, 544, 991, 1315, 1691, 2348, 2816, 3467, 4180, 4582, 5454, 6033, 6798, 7482]","[0, 204, 462, 706, 1288, 1466, 1859, 2524, 2979, 3440, 4113, 4506, 5000, 5316, 5546]","[0, 170, 260, 436, 717, 903, 1100, 1669, 2173, 2787, 3378, 3655, 3948, 4248, 4623]","[0, 170, 260, 396, 568, 706, 1372, 1552, 1775, 2045, 2369, 2653, 2807, 3010, 3194]",6618,7482,5546,4623,3194,-300,-2607,-853,-889,593,-4056,15,dire
7583124505,14,49,129,74,121,"[0, 207, 631, 917, 1123, 1409, 1730, 2220, 3116, 3626, 3906, 4758, 4987, 5658, 6076]","[0, 255, 567, 779, 1231, 1500, 1746, 2010, 2100, 2615, 3105, 3783, 4877, 5820, 6456]","[0, 366, 722, 969, 1437, 1717, 2003, 2393, 2850, 3453, 4246, 4434, 5131, 5280, 5729]","[0, 169, 284, 422, 556, 658, 788, 878, 968, 1411, 1794, 2307, 2994, 3509, 3992]","[0, 169, 284, 374, 480, 614, 770, 1254, 1887, 2332, 2512, 2960, 3256, 3923, 4331]",6076,6456,5729,3992,4331,82,61,76,66,45,"[0, 203, 511, 906, 1320, 1775, 2101, 2494, 2712, 3205, 3877, 3967, 5120, 5464, 6238]","[0, 331, 599, 1051, 1376, 1667, 2185, 2814, 3199, 3853, 4422, 4512, 4692, 5566, 5749]","[0, 258, 635, 1087, 1252, 1665, 2347, 2717, 3546, 4009, 4387, 5408, 5588, 6242, 6776]","[0, 169, 309, 491, 628, 777, 984, 1308, 2135, 2543, 2831, 3265, 3880, 4393, 4711]","[0, 169, 259, 379, 469, 655, 838, 1220, 1391, 1571, 2111, 2321, 2548, 2767, 3191]",6238,5749,6776,4711,3191,-162,707,-1047,-719,1140,-81,15,radiant
7583211100,48,36,53,2,20,"[0, 281, 957, 1156, 1532, 1767, 2116, 2668, 3137, 3549, 4268, 4779, 5338, 6007, 6806]","[0, 324, 609, 997, 1411, 1984, 2444, 2941, 3729, 4429, 5564, 5969, 6620, 7045, 7338]","[0, 209, 299, 654, 789, 1136, 1434, 1778, 2535, 2625, 3398, 3929, 4417, 4679, 5523]","[0, 376, 771, 1200, 1558, 2018, 2402, 3068, 3562, 3860, 4765, 5305, 6246, 7069, 7403]","[0, 209, 410, 543, 941, 1031, 1661, 2311, 2546, 2707, 3188, 3441, 3733, 3995, 4215]",6806,7338,5523,7403,4215,94,49,74,138,68,"[0, 202, 540, 704, 1151, 1581, 1766, 2294, 2629, 3177, 3431, 3732, 4376, 4816, 5646]","[0, 200, 438, 842, 1004, 1369, 1691, 2057, 2270, 2743, 3201, 3500, 4314, 4899, 5444]","[0, 202, 361, 805, 1194, 1368, 1785, 2132, 2556, 3161, 3323, 3482, 3787, 4224, 4892]","[0, 129, 219, 352, 491, 630, 991, 1447, 1537, 1709, 2103, 2231, 2411, 2607, 2885]","[0, 129, 219, 309, 399, 782, 986, 1177, 1390, 1676, 1766, 2046, 2272, 3064, 3388]",5646,5444,4892,2885,3388,1160,1894,631,4518,827,9030,15,dire
7583651901,95,137,29,26,123,"[0, 302, 953, 1249, 1808, 2530, 2742, 3123, 3617, 4101, 4838, 5327, 5766, 6396, 7037]","[0, 342, 594, 797, 964, 1279, 1746, 1881, 2335, 2580, 3139, 3229, 3755, 4336, 4809]","[0, 275, 505, 670, 1100, 1267, 1643, 1812, 2107, 2479, 2863, 3109, 3526, 4140, 4331]","[0, 229, 540, 793, 1005, 1438, 1779, 1925, 2312, 2585, 3059, 3149, 3239, 3458, 3757]","[0, 598, 888, 978, 1145, 1280, 1459, 1594, 1720, 2106, 2415, 2505, 2678, 2827, 3043]",7037,4809,4331,3757,3043,36,28,96,112,136,"[0, 253, 552, 926, 1174, 1664, 2163, 3079, 3755, 4326, 5073, 5992, 6533, 7372, 9097]","[0, 252, 609, 846, 1319, 1681, 2232, 3177, 3467, 3557, 3862, 4629, 5404, 5982, 6648]","[0, 209, 517, 973, 1294, 1435, 1796, 2010, 2504, 2888, 3152, 3658, 4092, 4630, 4988]","[0, 170, 488, 622, 794, 884, 1022, 1328, 1643, 1733, 1823, 2155, 2245, 2394, 2933]","[0, 170, 480, 570, 660, 750, 888, 1409, 1574, 1746, 1873, 2113, 2400, 2585, 2991]",9097,6648,4988,2933,2991,-2060,-1839,-657,824,52,-3680,15,dire
7583888910,54,69,123,97,121,"[64, 312, 723, 1160, 1705, 2045, 2505, 2917, 3599, 4169, 4652, 5263, 5642, 6354, 7124]","[0, 169, 403, 662, 1063, 1445, 1841, 2091, 2762, 3491, 3963, 4093, 4662, 5242, 5661]","[64, 295, 430, 639, 774, 1372, 1564, 1654, 2089, 2344, 2453, 2683, 2867, 3278, 3941]","[64, 231, 519, 884, 1289, 1617, 2129, 2717, 3128, 3433, 4054, 4634, 5157, 5484, 6125]","[332, 462, 587, 783, 1047, 1155, 1617, 1914, 2237, 2539, 2629, 2936, 3026, 3174, 3458]",7124,5661,3941,6125,3458,82,120,55,65,105,"[0, 335, 899, 1176, 1343, 1510, 1903, 2608, 3176, 3662, 4379, 5439, 6080, 6506, 7369]","[0, 284, 562, 899, 1071, 1287, 1550, 2055, 2477, 3563, 4170, 4880, 5412, 5665, 6342]","[0, 246, 488, 905, 1029, 1617, 1745, 2282, 2382, 2778, 3458, 3858, 4442, 4696, 5210]","[0, 210, 373, 676, 771, 1326, 1455, 1728, 1818, 2473, 2861, 3260, 3538, 3881, 4214]","[0, 254, 394, 588, 764, 1008, 1108, 1472, 1847, 2398, 2799, 3170, 3349, 3511, 3831]",7369,6342,5210,4214,3831,-245,-681,-1269,1911,-373,-657,15,radiant
7584103800,18,49,112,129,5,"[0, 253, 644, 927, 1140, 1471, 2012, 2421, 2800, 3368, 3983, 4345, 5299, 5870, 6717]","[0, 213, 674, 972, 1383, 1880, 2179, 2539, 2977, 3409, 4011, 4907, 5328, 5626, 6411]","[0, 170, 260, 350, 559, 698, 870, 1008, 1282, 1798, 2178, 2492, 2670, 2764, 3258]","[0, 170, 337, 534, 1054, 1370, 1691, 1979, 2401, 2656, 3066, 3331, 3509, 3603, 3930]","[0, 170, 260, 685, 818, 908, 1079, 1217, 1527, 1944, 2163, 2536, 2714, 2808, 3256]",6717,6411,3258,3930,3256,48,28,106,64,26,"[0, 204, 525, 649, 1131, 1421, 1773, 2739, 3122, 3886, 4492, 4989, 6156, 6805, 7800]","[0, 243, 555, 870, 1691, 1935, 2263, 2816, 3462, 4049, 4966, 5491, 5924, 6633, 7166]","[0, 272, 531, 899, 1116, 1576, 1958, 2364, 2858, 3262, 4170, 4513, 5289, 5755, 6033]","[0, 170, 260, 350, 878, 968, 1109, 1337, 1504, 1801, 2026, 2193, 2626, 2813, 3278]","[0, 170, 312, 402, 492, 689, 779, 1041, 1180, 1363, 1769, 1859, 2122, 2270, 2419]",7800,7166,6033,3278,2419,-1083,-755,-2775,652,837,-3124,15,radiant
7584141103,49,23,4,64,87,"[0, 208, 491, 780, 1065, 1385, 1597, 1773, 2081, 2519, 2879, 3534, 3965, 4237, 4955]","[0, 313, 667, 1035, 1525, 1898, 2508, 2958, 3414, 3866, 4603, 4917, 5183, 6079, 6996]","[0, 257, 602, 860, 1385, 1747, 2021, 2277, 2483, 2662, 3184, 3309, 3912, 4299, 4568]","[0, 170, 260, 350, 533, 623, 811, 901, 991, 1128, 1731, 1821, 1911, 2345, 2619]","[0, 170, 260, 350, 582, 716, 851, 941, 1031, 1121, 1532, 1841, 1931, 2025, 2580]",4955,6996,4568,2619,2580,70,71,104,112,111,"[0, 255, 727, 1085, 1453, 1818, 2164, 2667, 3135, 3536, 3741, 4716, 5272, 6043, 6697]","[0, 283, 717, 1049, 1550, 1921, 2385, 2672, 3063, 3395, 3744, 4299, 5092, 5830, 6110]","[0, 257, 416, 868, 998, 1365, 1838, 2441, 2910, 3285, 3999, 4212, 4783, 5754, 6061]","[0, 170, 260, 398, 528, 667, 954, 1299, 1488, 1736, 1960, 2287, 2697, 3482, 3577]","[0, 170, 260, 739, 924, 1058, 1192, 1405, 1560, 1695, 1832, 1922, 2059, 2608, 2823]",6697,6110,6061,3577,2823,-1742,886,-1493,-958,-243,-3550,15,dire
7584179905,48,22,32,53,84,"[0, 215, 524, 804, 1042, 1425, 1651, 2047, 2561, 3145, 3680, 4497, 5258, 5941, 6462]","[0, 251, 652, 1102, 1549, 1995, 2373, 3080, 3722, 4215, 4644, 5165, 5578, 6582, 7179]","[0, 242, 498, 782, 1038, 1167, 1684, 2189, 2279, 2531, 2752, 3131, 3828, 4244, 4911]","[0, 130, 237, 327, 462, 552, 788, 1130, 1254, 1570, 1894, 2231, 2469, 3005, 3508]","[0, 130, 267, 375, 465, 555, 645, 825, 923, 1071, 1452, 1704, 1841, 2103, 2197]",6462,7179,4911,3508,2197,46,42,74,85,21,"[0, 284, 519, 976, 1334, 1769, 2209, 2568, 3277, 3878, 4768, 5710, 6157, 6825, 7291]","[0, 328, 623, 936, 1400, 1896, 2343, 3225, 3817, 4222, 4971, 5423, 5879, 6540, 6974]","[0, 403, 809, 1250, 1664, 2430, 2936, 3556, 4126, 4593, 5182, 5485, 6055, 6489, 6794]","[0, 210, 340, 430, 582, 734, 864, 1039, 1177, 1311, 1697, 1976, 2116, 2338, 2587]","[0, 210, 300, 434, 571, 707, 934, 1159, 1322, 1412, 1731, 1869, 2036, 2185, 2358]",7291,6974,6794,2587,2358,-829,205,-1883,921,-161,-1747,15,radiant
7584193705,78,46,13,86,58,"[0, 207, 370, 751, 1075, 1165, 1623, 1890, 2433, 2742, 3064, 3711, 4543, 4940, 5354]","[0, 247, 421, 736, 935, 1378, 1505, 2012, 2529, 3053, 3541, 4408, 4992, 5700, 6455]","[0, 370, 612, 896, 1142, 1362, 1495, 1818, 1951, 2347, 2814, 3251, 3791, 4326, 4904]","[0, 169, 306, 430, 555, 703, 841, 982, 1163, 1433, 1663, 1887, 2112, 2868, 3053]","[0, 169, 259, 349, 474, 564, 654, 822, 984, 1294, 1578, 1896, 2270, 2672, 2900]",5354,6455,4904,3053,2900,67,47,137,19,110,"[0, 244, 625, 944, 1144, 1631, 1919, 2356, 2683, 2979, 3333, 3701, 3958, 4592, 5010]","[0, 250, 722, 1103, 1417, 1940, 2608, 2998, 3496, 4039, 4675, 5183, 5797, 6289, 6807]","[0, 169, 674, 990, 1323, 1583, 2102, 2557, 2806, 3341, 3844, 4213, 4509, 5080, 5961]","[0, 169, 284, 419, 597, 722, 1186, 1321, 1493, 1677, 1857, 2102, 2364, 2877, 3279]","[0, 169, 325, 797, 982, 1125, 1315, 1523, 1673, 1933, 2484, 2838, 3066, 3398, 3493]",5010,6807,5961,3279,3493,344,-352,-1057,-226,-593,-1884,15,radiant
7584220301,48,17,98,86,84,"[0, 293, 654, 903, 1075, 1236, 1552, 1900, 2172, 2498, 2987, 3288, 3744, 4592, 5191]","[0, 403, 763, 1207, 1750, 2125, 2708, 3138, 3520, 3990, 4516, 5120, 5601, 6381, 7072]","[0, 170, 337, 646, 857, 1032, 1356, 2313, 2454, 2742, 3151, 3429, 4094, 4772, 5638]","[0, 218, 395, 485, 799, 934, 1071, 1457, 1547, 1758, 1902, 2087, 2177, 3037, 3764]","[0, 170, 260, 350, 474, 564, 654, 758, 848, 938, 1028, 1167, 1257, 1591, 1732]",5191,7072,5638,3764,1732,106,114,97,105,3,"[0, 325, 854, 1190, 1561, 1966, 2421, 3050, 3875, 4338, 5281, 5771, 6243, 6811, 7488]","[0, 208, 539, 830, 1256, 1670, 2129, 2472, 3272, 3684, 4315, 4810, 5466, 6243, 6523]","[0, 204, 447, 764, 1232, 1642, 1979, 2552, 3282, 3701, 4544, 5395, 5856, 6303, 6830]","[0, 170, 260, 695, 834, 1157, 1247, 1426, 1734, 1868, 2347, 2437, 2593, 3054, 3221]","[0, 170, 260, 350, 520, 833, 970, 1060, 1540, 1750, 2131, 2267, 2423, 2771, 2957]",7488,6523,6830,3221,2957,-2297,549,-1192,543,-1225,-3622,15,radiant
7584272611,61,6,14,103,110,"[0, 361, 758, 1197, 1650, 2208, 2867, 3521, 4275, 4844, 5467, 6529, 7705, 9014, 10176]","[0, 259, 465, 712, 1095, 1515, 2028, 2447, 3015, 3506, 3975, 4642, 5313, 5856, 6412]","[0, 170, 510, 803, 1001, 1460, 1966, 2056, 2628, 2718, 3062, 3283, 3574, 3784, 3969]","[0, 170, 598, 688, 778, 960, 1177, 1267, 1639, 1863, 2094, 2184, 2439, 2580, 2765]","[0, 170, 260, 402, 541, 631, 781, 920, 1146, 1282, 1439, 1824, 2163, 2407, 2592]",10176,6412,3969,2765,2592,11,10,114,86,84,"[75, 447, 678, 1136, 1532, 2134, 2584, 3121, 3663, 4318, 5010, 5205, 5505, 5962, 6874]","[75, 328, 529, 898, 1189, 1528, 1926, 2393, 2589, 2831, 3700, 4231, 4816, 5831, 6133]","[75, 284, 561, 834, 1266, 1625, 1862, 2250, 2570, 2786, 3154, 3405, 3495, 3714, 4052]","[75, 296, 386, 525, 749, 1026, 1116, 1382, 1516, 1655, 1938, 2122, 2457, 2895, 3121]","[75, 245, 335, 425, 561, 776, 912, 1047, 1391, 1604, 2061, 2151, 2260, 2637, 2732]",6874,6133,4052,3121,2732,3302,279,-83,-356,-140,3002,15,radiant
7584380217,11,10,84,14,5,"[0, 324, 698, 1289, 1788, 2347, 2843, 3286, 3798, 4277, 4667, 4805, 5430, 5579, 5674]","[0, 244, 527, 899, 1232, 1796, 2339, 3007, 3414, 3700, 4011, 4382, 4969, 5711, 6420]","[0, 239, 442, 742, 1045, 1292, 1536, 1978, 2141, 2571, 2881, 3007, 3116, 3609, 3784]","[0, 169, 259, 382, 680, 923, 1127, 1462, 1767, 2049, 2366, 2921, 3189, 3519, 3684]","[0, 169, 259, 396, 486, 656, 884, 1264, 1433, 1559, 1694, 1895, 2131, 2665, 2805]",5674,6420,3784,3684,2805,25,93,69,86,88,"[0, 407, 745, 1211, 1937, 2377, 2866, 3440, 4092, 4959, 5665, 6174, 7161, 7933, 8386]","[0, 206, 868, 1231, 1733, 2054, 2438, 3122, 3528, 4083, 4690, 5416, 5943, 6552, 6767]","[0, 291, 535, 714, 1052, 1543, 1751, 2146, 2559, 3055, 3690, 4260, 4686, 5154, 5547]","[0, 169, 304, 428, 558, 741, 831, 1047, 1350, 1892, 2148, 2511, 2905, 3054, 3431]","[0, 169, 325, 442, 621, 711, 889, 1089, 1324, 1433, 1745, 1835, 2149, 2541, 2670]",8386,6767,5547,3431,2670,-2712,-347,-1763,253,135,-4434,15,dire
7584551804,48,106,60,21,101,"[0, 332, 606, 1023, 1311, 1715, 1907, 2204, 2764, 3360, 4070, 4528, 5066, 5872, 6374]","[0, 259, 660, 1014, 1387, 1724, 2206, 2537, 3010, 3621, 4185, 4925, 5456, 5941, 6607]","[0, 369, 666, 1015, 1491, 1905, 2368, 2912, 3501, 3885, 4499, 5284, 5608, 6196, 6830]","[0, 210, 300, 484, 614, 744, 837, 1212, 1351, 1661, 2025, 2374, 2606, 2952, 3792]","[0, 210, 398, 766, 896, 1026, 1167, 1425, 1615, 1836, 2132, 2446, 2583, 3229, 3854]",6374,6607,6830,3792,3854,98,120,10,66,121,"[0, 168, 451, 782, 1187, 1587, 2044, 2450, 2943, 3110, 3703, 4379, 4908, 5536, 6235]","[0, 253, 497, 792, 1234, 1690, 2084, 2617, 3513, 3941, 4221, 5227, 5679, 5882, 6190]","[0, 166, 584, 848, 1046, 1325, 1643, 2210, 2649, 3149, 3746, 4305, 4792, 5354, 5752]","[0, 130, 565, 675, 880, 1052, 1237, 1372, 1717, 1946, 2311, 2580, 2926, 3331, 3483]","[0, 130, 265, 355, 560, 650, 789, 924, 1180, 1578, 1755, 2175, 2265, 2678, 2945]",6235,6190,5752,3483,2945,139,417,1078,309,909,2852,15,radiant
7584621405,78,41,106,105,123,"[0, 238, 474, 759, 1147, 1482, 1873, 2345, 2671, 3000, 3409, 3864, 4618, 4851, 5427]","[0, 208, 421, 708, 1154, 1368, 1800, 2036, 2328, 2758, 3346, 3971, 4585, 5223, 5696]","[0, 277, 576, 914, 1163, 1487, 1655, 2106, 2488, 3022, 3261, 3850, 4400, 4837, 5184]","[0, 169, 306, 462, 632, 722, 876, 1500, 1634, 1798, 2161, 2661, 2970, 3203, 3298]","[0, 169, 259, 349, 564, 654, 867, 1153, 1243, 1393, 1830, 2232, 2466, 2872, 2967]",5427,5696,5184,3298,2967,46,93,63,20,19,"[0, 285, 680, 998, 1405, 1745, 2531, 2912, 3513, 4014, 4848, 5120, 5879, 6564, 7525]","[0, 169, 373, 605, 840, 1162, 1517, 1981, 2473, 2961, 3518, 3910, 4384, 4768, 5497]","[0, 290, 505, 718, 1095, 1635, 1794, 2207, 2719, 3087, 3856, 4409, 4993, 5421, 5818]","[0, 216, 396, 497, 648, 1133, 1310, 1490, 1619, 1779, 2052, 2374, 2603, 2846, 3147]","[0, 207, 297, 410, 500, 590, 680, 860, 950, 1270, 1773, 1911, 2139, 2369, 2668]",7525,5497,5818,3147,2668,-2098,199,-634,151,299,-2083,15,dire
7584695605,48,17,53,96,5,"[0, 255, 537, 922, 1340, 1778, 2288, 2729, 3230, 3602, 4113, 4682, 5366, 6275, 6844]","[0, 169, 453, 773, 1179, 1598, 1993, 2165, 2634, 3018, 3520, 4137, 4580, 5176, 5540]","[0, 352, 529, 639, 1184, 1274, 1484, 1608, 2002, 2294, 2460, 2721, 2935, 3383, 3796]","[0, 164, 480, 679, 1014, 1337, 1668, 2061, 2510, 3156, 3690, 4410, 5118, 5624, 5980]","[0, 219, 313, 498, 805, 1001, 1360, 1450, 1584, 2026, 2116, 2331, 2428, 2915, 3169]",6844,5540,3796,5980,3169,73,49,98,9,79,"[0, 330, 534, 807, 1230, 1675, 2035, 2491, 3123, 3962, 4729, 5414, 6428, 7073, 7743]","[0, 318, 653, 1027, 1445, 1940, 2417, 3027, 3516, 3881, 4401, 4783, 5402, 5795, 6197]","[0, 684, 1004, 1335, 1494, 1750, 2104, 2362, 2705, 2939, 3587, 4109, 4748, 5085, 5600]","[0, 408, 546, 722, 890, 1076, 1166, 1346, 1481, 1751, 1970, 2188, 2828, 3332, 3650]","[0, 263, 353, 443, 533, 736, 826, 1050, 1185, 1709, 1889, 2027, 2207, 2396, 2810]",7743,6197,5600,3650,2810,-899,-657,-1804,2330,359,-671,15,radiant
7584866405,73,98,45,14,86,"[0, 377, 867, 1184, 1710, 2155, 2667, 2948, 3198, 3635, 4375, 4822, 5493, 6603, 7274]","[0, 707, 943, 1398, 2055, 2387, 2884, 3302, 3718, 3808, 4103, 4391, 4481, 5105, 5314]","[0, 370, 565, 790, 1174, 1370, 1765, 1935, 2154, 2383, 2621, 2909, 3049, 3521, 3715]","[0, 303, 704, 912, 1108, 1506, 1695, 2151, 2570, 2940, 3396, 3486, 3737, 4234, 4666]","[0, 232, 322, 500, 704, 842, 932, 1105, 1195, 1392, 1630, 1720, 2100, 2393, 2626]",7274,5314,3715,4666,2626,75,106,137,20,91,"[0, 245, 754, 1072, 1444, 1806, 2291, 2630, 2958, 3585, 3962, 4122, 4764, 5524, 6319]","[0, 282, 452, 759, 1120, 1450, 1614, 2118, 2330, 2871, 3474, 3814, 4317, 5099, 5544]","[0, 169, 452, 788, 1156, 1402, 1777, 2161, 2602, 3308, 3764, 4389, 4651, 5455, 5805]","[0, 169, 400, 536, 666, 829, 1069, 1618, 2016, 2430, 2830, 3041, 3355, 3880, 4236]","[0, 169, 366, 456, 857, 947, 1121, 1654, 1897, 2448, 2583, 2743, 3005, 3673, 3996]",6319,5544,5805,4236,3996,955,-230,-2090,430,-1370,-2305,15,dire
7585104700,138,21,49,103,121,"[0, 286, 651, 1022, 1241, 1657, 2150, 2648, 3394, 3618, 4112, 4539, 4778, 5642, 6137]","[0, 253, 431, 760, 1129, 1219, 1479, 1872, 2293, 2929, 3207, 4012, 4876, 5460, 6038]","[0, 210, 447, 807, 946, 1202, 1453, 1738, 1918, 2163, 2424, 2978, 3568, 3944, 4607]","[0, 129, 219, 309, 434, 612, 746, 855, 1403, 2141, 2231, 2501, 2858, 3163, 3484]","[0, 163, 291, 427, 591, 725, 854, 944, 1158, 1392, 1482, 1841, 2379, 2528, 2940]",6137,6038,4607,3484,2940,95,50,97,31,86,"[0, 209, 648, 899, 1359, 1956, 2627, 3111, 3838, 4518, 5129, 5671, 6428, 6715, 7665]","[0, 367, 577, 835, 1184, 1736, 2147, 2487, 3092, 3492, 3922, 4664, 5117, 5634, 6269]","[0, 243, 657, 972, 1444, 1788, 2035, 2311, 2958, 3928, 4312, 4721, 5520, 5952, 6454]","[0, 259, 388, 524, 1108, 1291, 1576, 1726, 2276, 2563, 2867, 3563, 3743, 3838, 4564]","[0, 209, 299, 437, 681, 955, 1097, 1311, 1513, 1950, 2164, 2504, 2768, 2863, 3461]",7665,6269,6454,4564,3461,-1528,-231,-1847,-1080,-521,-5207,15,dire
7585578410,48,137,126,53,121,"[0, 244, 460, 1000, 1359, 1641, 1856, 2433, 2876, 3217, 3733, 4262, 4952, 5935, 7192]","[0, 284, 424, 1327, 1546, 1834, 2247, 2732, 3401, 3539, 4186, 4916, 5274, 5985, 6696]","[0, 283, 411, 744, 951, 1364, 1715, 2094, 2599, 2900, 3481, 4282, 4408, 5313, 5809]","[0, 310, 400, 823, 958, 1185, 1275, 1766, 2406, 2624, 3460, 4022, 4549, 5269, 5857]","[0, 210, 352, 515, 626, 756, 846, 1108, 1198, 1288, 1468, 1774, 2048, 2622, 3017]",7192,6696,5809,5857,3017,10,135,74,20,26,"[0, 166, 490, 874, 1215, 1581, 1971, 2454, 2936, 3492, 3809, 4111, 4742, 5353, 6191]","[0, 244, 562, 992, 1389, 1871, 2336, 2719, 3484, 3781, 4243, 4662, 5168, 5435, 6582]","[0, 292, 619, 962, 1260, 1587, 1871, 2298, 2447, 2943, 3116, 3216, 3536, 3717, 4480]","[0, 130, 254, 344, 517, 626, 1008, 1098, 1449, 1875, 2085, 2211, 2301, 2434, 2868]","[0, 130, 220, 456, 595, 733, 1148, 1238, 1411, 1664, 1886, 1976, 2160, 2255, 2574]",6191,6582,4480,2868,2574,1001,114,1329,2989,443,5876,15,radiant
7585844612,106,114,14,86,5,"[0, 413, 871, 1297, 1821, 2207, 2680, 3249, 3754, 4267, 5028, 5556, 6293, 7263, 7965]","[0, 339, 658, 1038, 1411, 1737, 2185, 2604, 3123, 3447, 4442, 4798, 5980, 6629, 6964]","[0, 256, 660, 1006, 1431, 1850, 2181, 2717, 3216, 3927, 4436, 4692, 5219, 5744, 5875]","[0, 299, 389, 543, 677, 831, 921, 1044, 1178, 1483, 2103, 2396, 3059, 3435, 3813]","[0, 219, 309, 466, 603, 693, 783, 873, 1008, 1170, 1543, 1671, 2039, 2155, 2250]",7965,6964,5875,3813,2250,48,17,18,72,83,"[0, 330, 688, 1058, 1502, 1995, 2598, 3251, 3745, 4239, 4993, 5802, 6513, 7170, 8286]","[0, 330, 884, 1283, 1738, 2323, 2904, 3422, 3938, 4416, 5083, 5843, 6216, 6736, 7793]","[0, 281, 488, 919, 1198, 1607, 1944, 2524, 2979, 3406, 3990, 4510, 4878, 5274, 5660]","[0, 214, 341, 478, 608, 712, 1008, 1205, 1340, 1458, 1703, 2044, 2544, 2850, 3366]","[0, 169, 259, 349, 532, 669, 848, 1028, 1204, 1369, 1641, 1778, 1981, 2361, 2668]",8286,7793,5660,3366,2668,-321,-829,215,447,-418,-906,15,dire
7585961412,48,32,17,27,26,"[0, 216, 552, 926, 1602, 2091, 2328, 2886, 3140, 3592, 3984, 4212, 4841, 5458, 6371]","[0, 218, 492, 867, 1175, 1374, 1787, 2142, 2478, 2966, 3816, 4384, 4982, 5703, 6287]","[0, 285, 593, 970, 1342, 1754, 2063, 2839, 3264, 3631, 4231, 4670, 5080, 5432, 5709]","[0, 130, 298, 449, 626, 807, 897, 1526, 1616, 1934, 2185, 2546, 2782, 3417, 3725]","[0, 130, 250, 340, 479, 579, 669, 775, 865, 1053, 1339, 1570, 1660, 1949, 2246]",6371,6287,5709,3725,2246,25,69,89,9,100,"[0, 366, 734, 1057, 1431, 1890, 2297, 2958, 3472, 4024, 4798, 5721, 6374, 7230, 7974]","[0, 290, 542, 899, 1233, 1563, 1925, 2326, 2881, 3570, 4128, 4361, 4878, 5698, 6238]","[0, 298, 605, 941, 1405, 1856, 2086, 2621, 3227, 3815, 4066, 4596, 5424, 6169, 7058]","[0, 210, 343, 498, 588, 763, 853, 1235, 1733, 1944, 2352, 2621, 2801, 3344, 3562]","[0, 210, 300, 436, 526, 705, 795, 934, 1198, 1490, 1725, 2092, 2331, 2556, 2774]",7974,6238,7058,3562,2774,-1603,49,-1349,163,-528,-3268,15,radiant
7585988215,93,74,96,40,21,"[0, 281, 558, 1533, 1846, 2176, 2553, 3077, 3649, 4377, 4941, 5773, 6035, 6818, 7378]","[0, 210, 373, 653, 1011, 1384, 1747, 1968, 2371, 2876, 3295, 3694, 3802, 4509, 4945]","[0, 210, 385, 865, 1195, 1520, 2026, 2498, 3078, 3584, 4283, 4752, 5349, 6030, 6533]","[0, 210, 300, 695, 822, 1015, 1152, 1517, 1905, 2078, 2397, 2541, 2631, 3314, 3547]","[100, 310, 400, 768, 858, 1033, 1251, 1551, 1731, 2178, 2413, 2557, 2714, 3425, 3657]",7378,4945,6533,3547,3657,61,70,49,53,79,"[0, 284, 600, 971, 1387, 1585, 2087, 2468, 2850, 3225, 3495, 3959, 5135, 5426, 5997]","[0, 258, 455, 740, 946, 1274, 1668, 1811, 2283, 2635, 2740, 3000, 3489, 3983, 4296]","[0, 253, 495, 673, 1011, 1135, 1669, 1777, 1957, 2567, 2924, 3222, 4116, 4265, 4632]","[0, 130, 220, 386, 521, 611, 796, 1191, 1674, 1779, 1915, 2069, 2991, 3221, 3316]","[0, 130, 220, 622, 790, 1011, 1101, 1191, 1592, 1682, 1772, 1862, 2534, 2683, 2885]",5997,4296,4632,3316,2885,1381,649,1901,231,772,4934,15,radiant
7586016207,16,20,54,69,37,"[0, 165, 510, 886, 1327, 1994, 2447, 2988, 3501, 4480, 5098, 5645, 6511, 7850, 7945]","[0, 287, 731, 1218, 1713, 2199, 2572, 3123, 3550, 3895, 4441, 5024, 5114, 6182, 6754]","[0, 202, 471, 829, 1162, 1484, 1741, 2291, 2592, 2720, 3215, 3754, 4298, 5025, 5299]","[0, 130, 325, 428, 654, 1225, 1613, 1793, 2012, 2436, 2628, 3405, 3616, 4202, 4621]","[0, 130, 290, 385, 555, 645, 814, 994, 1132, 1350, 1479, 1569, 1686, 2240, 2358]",7945,6754,5299,4621,2358,18,106,96,26,5,"[0, 320, 602, 1012, 1350, 1733, 2186, 2675, 3226, 3520, 4367, 4863, 5596, 6145, 6662]","[0, 329, 741, 1229, 1554, 1971, 2637, 3203, 3789, 4317, 4771, 4992, 6017, 6433, 7363]","[0, 207, 639, 885, 1353, 1642, 2184, 2765, 3226, 4132, 4591, 5311, 5916, 6327, 7353]","[0, 215, 845, 935, 1063, 1202, 1327, 1678, 1768, 2138, 2568, 2658, 2875, 3184, 3459]","[0, 170, 260, 398, 534, 624, 788, 1059, 1193, 1283, 1418, 1508, 1707, 1856, 2005]",6662,7363,7353,3459,2005,1283,-609,-2054,1162,353,135,15,radiant
7586185405,73,39,28,33,100,"[1, 251, 582, 797, 1207, 1642, 2150, 2890, 3627, 4125, 4916, 5699, 6506, 7516, 8154]","[1, 283, 556, 855, 1336, 1547, 1910, 2096, 2495, 3054, 3572, 4055, 4735, 5769, 5991]","[1, 459, 905, 1172, 1547, 1998, 2246, 2706, 3066, 3156, 3995, 4153, 4476, 4983, 5340]","[1, 171, 463, 567, 702, 963, 1310, 1560, 1667, 1841, 2082, 2208, 2351, 2740, 2910]","[1, 256, 416, 506, 690, 920, 1091, 1500, 1709, 1883, 2244, 2540, 2676, 2974, 3225]",8154,5991,5340,2910,3225,113,63,65,58,136,"[1, 274, 520, 810, 1022, 1421, 1651, 1986, 2202, 2471, 2899, 3588, 3696, 4178, 4622]","[1, 598, 793, 1275, 1687, 1937, 2358, 2811, 3172, 3827, 4178, 4690, 5050, 5292, 5540]","[1, 209, 645, 888, 1295, 1684, 2347, 2795, 2884, 3174, 3956, 4421, 5008, 5493, 6036]","[1, 239, 480, 669, 799, 1257, 1425, 1810, 1899, 2248, 2372, 2658, 2843, 3090, 3288]","[1, 239, 364, 502, 775, 900, 1035, 1244, 1354, 1934, 2040, 2499, 2661, 3078, 3264]",4622,5540,6036,3288,3264,3532,451,-696,-378,-39,2870,15,radiant
7586188703,54,126,105,49,123,"[0, 287, 579, 1011, 1304, 1628, 2073, 2493, 2942, 3147, 3923, 4431, 4917, 5457, 5729]","[0, 323, 646, 1052, 1461, 1830, 2492, 2753, 3445, 3745, 3932, 4178, 4648, 4841, 5342]","[0, 170, 260, 399, 529, 670, 806, 896, 1221, 1311, 1626, 1814, 2302, 2451, 2590]","[0, 250, 462, 675, 933, 1108, 1304, 1488, 1709, 2070, 2205, 2459, 3029, 3347, 3842]","[0, 170, 260, 350, 502, 665, 755, 916, 1043, 1133, 1434, 1562, 1728, 2088, 2345]",5729,5342,2590,3842,2345,69,15,120,72,65,"[0, 248, 540, 840, 1417, 1739, 2222, 2666, 3151, 3677, 4185, 5066, 5787, 6276, 6958]","[0, 290, 567, 1122, 1626, 1967, 2514, 3056, 3707, 4232, 4530, 5103, 5428, 5924, 6666]","[0, 274, 533, 900, 1293, 1668, 1845, 2449, 2821, 3904, 4465, 5305, 5790, 6078, 6636]","[0, 170, 285, 455, 725, 815, 1023, 1203, 1293, 1850, 2145, 2289, 2449, 2598, 3038]","[0, 170, 367, 457, 700, 836, 987, 1167, 1438, 1617, 2245, 2511, 2978, 3127, 3489]",6958,6666,6636,3038,3489,-1229,-1324,-4046,804,-1144,-6939,15,dire
7586617402,109,126,29,21,112,"[0, 318, 560, 1087, 1485, 1720, 2301, 2730, 3142, 3877, 4258, 4845, 5689, 6087, 6181]","[0, 298, 619, 913, 1204, 1402, 1651, 2035, 2497, 3301, 3840, 4235, 4851, 5093, 5711]","[0, 207, 405, 798, 1092, 1384, 1584, 2141, 2400, 2721, 2856, 3017, 3381, 3906, 4228]","[0, 213, 352, 442, 579, 839, 1068, 1275, 1455, 1678, 2227, 2317, 2680, 3077, 3344]","[0, 170, 260, 441, 531, 621, 906, 1008, 1194, 1747, 2030, 2120, 2210, 2649, 2909]",6181,5711,4228,3344,2909,41,25,53,96,20,"[0, 320, 788, 1172, 1596, 1950, 2456, 2828, 3361, 4014, 4663, 5664, 6200, 6829, 7224]","[0, 588, 860, 1107, 1655, 2010, 2440, 2750, 3349, 3796, 4446, 4820, 5013, 5262, 5446]","[0, 268, 614, 741, 837, 1047, 1464, 1989, 2306, 2645, 3014, 3490, 3801, 4728, 5032]","[0, 248, 375, 517, 899, 1109, 1279, 1594, 2057, 2277, 2725, 3203, 3538, 3927, 4240]","[0, 234, 632, 1043, 1179, 1679, 2045, 2289, 2668, 2842, 3222, 3519, 3690, 4203, 4393]",7224,5446,5032,4240,4393,-1043,265,-804,-896,-1484,-3962,15,dire
7586877601,94,43,21,5,100,"[0, 210, 439, 713, 999, 1417, 1870, 2122, 2746, 3219, 4172, 4840, 5339, 5708, 6094]","[0, 337, 582, 956, 1353, 1807, 2243, 2585, 2928, 3510, 4324, 5180, 5615, 6223, 6843]","[0, 293, 512, 823, 1022, 1359, 1718, 2099, 2549, 3358, 3800, 4360, 4920, 5281, 5716]","[0, 331, 754, 844, 981, 1358, 1578, 1687, 2237, 2372, 2932, 3437, 3665, 3904, 4213]","[0, 210, 300, 470, 597, 727, 937, 1078, 1168, 1384, 1781, 2007, 2332, 2571, 2750]",6094,6843,5716,4213,2750,95,39,28,58,20,"[0, 130, 520, 811, 1258, 1455, 2449, 2903, 3465, 4179, 4771, 5383, 6366, 7635, 8452]","[0, 205, 455, 907, 1197, 1532, 2001, 2476, 3067, 3359, 3449, 4135, 4611, 5190, 5708]","[0, 206, 539, 951, 1222, 1417, 1544, 1974, 2143, 2516, 2640, 2820, 3381, 4044, 4273]","[0, 130, 220, 345, 435, 762, 852, 1226, 1361, 1451, 1624, 1855, 1945, 2663, 2892]","[0, 130, 438, 563, 653, 757, 1069, 1354, 1533, 1751, 1841, 2083, 2319, 2924, 3153]",8452,5708,4273,2892,3153,-2358,1135,1443,1321,-403,1138,15,dire
7587043018,2,74,42,123,86,"[0, 275, 564, 954, 1477, 1816, 2546, 3013, 3486, 4152, 5170, 5830, 6484, 6998, 8773]","[0, 330, 589, 824, 1196, 1607, 2053, 2414, 2909, 3415, 3892, 4818, 5177, 5882, 6015]","[0, 244, 571, 851, 1166, 1523, 1756, 2215, 2611, 3152, 3340, 3642, 4099, 4329, 4499]","[0, 221, 363, 504, 683, 871, 961, 1135, 1276, 1679, 1769, 1950, 2187, 2321, 2452]","[0, 219, 343, 433, 563, 701, 803, 893, 983, 1290, 1486, 1576, 1893, 2186, 2712]",8773,6015,4499,2452,2712,13,69,8,101,5,"[0, 290, 646, 1057, 1509, 1838, 2251, 2985, 3834, 4350, 4926, 6229, 6809, 7589, 8506]","[0, 329, 653, 981, 1348, 1840, 2811, 3095, 3576, 3943, 4499, 5429, 6149, 6633, 7548]","[0, 328, 649, 1024, 1220, 1779, 2189, 2681, 3223, 3653, 4077, 4744, 5424, 5978, 6399]","[0, 169, 305, 482, 572, 795, 1249, 1339, 1429, 1564, 2193, 2437, 2635, 2775, 3299]","[0, 169, 259, 408, 517, 741, 831, 966, 1056, 1285, 1563, 1886, 2118, 2330, 3409]",8506,7548,6399,3299,3409,267,-1533,-1900,-847,-697,-4710,15,dire
7587097513,102,120,129,58,26,"[0, 206, 478, 727, 1096, 1547, 2067, 2470, 2945, 3319, 3862, 4234, 4672, 5282, 6126]","[0, 315, 652, 1000, 1433, 1845, 2300, 2737, 3174, 3623, 4390, 5047, 5641, 6240, 6882]","[0, 255, 531, 810, 1104, 1314, 1559, 2026, 2447, 2899, 3705, 4090, 5037, 5380, 5690]","[200, 370, 460, 550, 736, 913, 1040, 1130, 1369, 1630, 1900, 2171, 2361, 2547, 2893]","[0, 170, 260, 350, 440, 579, 792, 882, 972, 1062, 1381, 1566, 1822, 2020, 2281]",6126,6882,5690,2893,2281,53,106,19,138,51,"[0, 205, 597, 897, 1147, 1750, 2198, 2478, 3102, 3489, 4137, 4754, 5208, 5754, 6455]","[0, 254, 581, 1032, 1475, 1836, 2209, 2780, 3355, 3565, 4159, 4400, 4833, 5281, 6018]","[0, 255, 454, 1225, 1464, 1753, 2152, 2699, 3104, 3516, 4040, 4288, 4638, 5136, 5231]","[0, 170, 260, 444, 574, 917, 1007, 1167, 1448, 1584, 2029, 2165, 2273, 2667, 2833]","[0, 170, 260, 350, 526, 780, 870, 1098, 1503, 1709, 2052, 2214, 2304, 2591, 2686]",6455,6018,5231,2833,2686,-329,864,459,60,-405,649,15,radiant
7587374304,39,18,53,2,14,"[0, 362, 611, 1024, 1433, 1921, 2502, 3209, 3732, 3996, 4987, 5614, 6281, 7095, 7347]","[0, 248, 621, 868, 1337, 1757, 1920, 2334, 2782, 3122, 3474, 3853, 4729, 5226, 5886]","[0, 268, 392, 740, 924, 1315, 1656, 2182, 2412, 2772, 3547, 4120, 4410, 5008, 5476]","[0, 348, 629, 1025, 1399, 1718, 1886, 1976, 2324, 3108, 4081, 4396, 4871, 5349, 5817]","[0, 536, 662, 752, 984, 1154, 1330, 1689, 1972, 2062, 2691, 3022, 3595, 4599, 5225]",7347,5886,5476,5817,5225,84,11,93,26,20,"[0, 166, 448, 935, 1387, 2022, 2603, 3063, 3729, 4517, 5340, 6334, 7431, 8131, 8853]","[0, 293, 568, 852, 1219, 1624, 1792, 2550, 2976, 3417, 3866, 4383, 5129, 5735, 7109]","[0, 234, 591, 788, 1118, 1835, 2514, 3147, 3390, 3480, 3570, 4262, 4772, 5605, 5840]","[0, 129, 249, 339, 429, 877, 1112, 1372, 1597, 1735, 2064, 2552, 2642, 2880, 3029]","[0, 129, 249, 626, 795, 1090, 1284, 1477, 1655, 1782, 1872, 2479, 2713, 3103, 3276]",8853,7109,5840,3029,3276,-1506,-1223,-364,2788,1949,1644,15,radiant
7587417311,61,10,23,19,84,"[0, 251, 537, 900, 1389, 1834, 2336, 2784, 3302, 3713, 4196, 4762, 5380, 6200, 7149]","[0, 253, 688, 1139, 1546, 1927, 2417, 3044, 3562, 3958, 4422, 4876, 5703, 6167, 6734]","[0, 292, 615, 928, 1363, 1880, 2434, 3192, 3664, 4052, 4806, 5271, 5361, 6073, 6529]","[0, 207, 314, 434, 569, 751, 935, 1153, 1436, 1526, 1740, 1918, 2008, 2556, 2927]","[0, 169, 259, 379, 469, 604, 760, 994, 1174, 1264, 1836, 1926, 2287, 2603, 2787]",7149,6734,6529,2927,2787,48,106,21,5,88,"[0, 327, 753, 1148, 1669, 2093, 2690, 3302, 3916, 4546, 5184, 6058, 6782, 7542, 8333]","[0, 329, 724, 1217, 1541, 2050, 2685, 3331, 3914, 4551, 5191, 5643, 6537, 7077, 8087]","[0, 242, 592, 940, 1270, 1829, 2281, 2679, 3128, 3580, 4191, 4696, 5005, 5803, 6314]","[0, 169, 284, 374, 513, 603, 776, 1273, 1363, 1453, 1603, 1813, 2243, 2801, 2985]","[0, 208, 368, 480, 570, 707, 886, 976, 1110, 1248, 1514, 1794, 2394, 3033, 3417]",8333,8087,6314,2985,3417,-1184,-1353,215,-58,-630,-3010,15,dire
7587530705,48,106,7,84,86,"[0, 246, 453, 817, 1151, 1543, 1977, 2301, 2921, 3354, 4274, 5002, 5510, 6118, 7240]","[0, 284, 706, 1260, 1517, 1962, 2342, 2857, 3499, 4068, 4746, 5276, 5735, 7006, 7617]","[0, 205, 484, 736, 940, 1235, 1647, 2151, 2452, 2985, 3205, 3670, 4186, 4698, 5068]","[0, 170, 260, 396, 486, 718, 822, 937, 1164, 1315, 1617, 1797, 1988, 2210, 2312]","[0, 204, 294, 430, 556, 693, 783, 873, 1053, 1192, 1628, 1854, 2038, 2187, 2663]",7240,7617,5068,2312,2663,95,39,97,119,85,"[0, 254, 629, 1141, 1508, 2052, 2427, 2869, 3418, 3964, 4845, 5240, 5981, 6695, 7566]","[0, 250, 497, 824, 1268, 1566, 1835, 2136, 2536, 2962, 3452, 3800, 3972, 4257, 4829]","[0, 206, 527, 1176, 1726, 1966, 2604, 3063, 3559, 3929, 4313, 4605, 5248, 5834, 6096]","[0, 209, 299, 460, 647, 781, 964, 1366, 1547, 1683, 1818, 2287, 3179, 3308, 3687]","[0, 170, 260, 397, 522, 630, 820, 1077, 1294, 1406, 1911, 2059, 2285, 2380, 2851]",7566,4829,6096,3687,2851,-326,2788,-1028,-1375,-188,-129,15,radiant
7587545113,96,63,17,20,71,"[0, 130, 398, 750, 1170, 1558, 2018, 2416, 3370, 3975, 4534, 5190, 5655, 6323, 6679]","[0, 571, 771, 1210, 1528, 2049, 2337, 2685, 3088, 3556, 4066, 4676, 5065, 5583, 6180]","[0, 293, 647, 985, 1515, 1766, 2052, 2444, 2837, 3139, 3472, 4023, 4212, 4816, 5258]","[0, 498, 588, 946, 1188, 1352, 1687, 1851, 1985, 2536, 2626, 3340, 3548, 3872, 4004]","[0, 498, 638, 808, 1214, 1378, 1603, 1892, 2301, 2627, 2717, 3107, 3218, 3639, 3869]",6679,6180,5258,4004,3869,47,106,41,53,62,"[0, 574, 903, 1189, 1693, 1969, 2265, 2654, 3347, 3886, 4471, 4805, 5337, 6181, 6707]","[0, 405, 706, 1089, 1462, 1953, 2425, 2972, 3482, 4042, 4519, 5071, 5704, 6156, 6487]","[0, 210, 494, 724, 1175, 1385, 1713, 1890, 2259, 2745, 3202, 3813, 4571, 5191, 5626]","[0, 409, 499, 589, 919, 1009, 1099, 1282, 1598, 2032, 2331, 2824, 3514, 4153, 4338]","[0, 336, 426, 659, 874, 976, 1112, 1339, 1486, 1785, 2308, 2422, 2994, 3642, 3737]",6707,6487,5626,4338,3737,-28,-307,-368,-334,132,-905,15,dire
7587585409,53,48,104,33,5,"[0, 327, 686, 1030, 1439, 1971, 2653, 3153, 3403, 3826, 4230, 4725, 5717, 6202, 7002]","[0, 242, 575, 996, 1421, 1872, 2500, 3035, 3681, 4402, 5088, 5952, 6590, 7310, 7774]","[0, 278, 733, 1106, 1640, 1937, 2513, 3028, 3490, 3935, 4505, 5112, 5399, 6019, 6554]","[0, 170, 260, 350, 533, 623, 807, 1069, 1378, 1650, 2057, 2411, 2788, 3281, 3635]","[0, 170, 279, 414, 551, 1006, 1217, 1354, 1489, 1579, 1830, 1974, 2183, 2503, 2777]",7002,7774,6554,3635,2777,73,22,2,84,74,"[0, 297, 725, 1223, 1696, 2254, 2975, 3560, 4771, 5433, 6441, 7205, 8735, 9779, 11200]","[0, 249, 580, 989, 1496, 2089, 2669, 2966, 3708, 4281, 4711, 5076, 5567, 6105, 6446]","[0, 202, 446, 862, 1107, 1613, 2137, 2654, 3225, 3723, 4285, 4539, 5181, 5713, 6074]","[0, 130, 220, 310, 448, 538, 721, 831, 1006, 1157, 1292, 1537, 1990, 2133, 2505]","[0, 130, 220, 357, 447, 537, 717, 807, 942, 1152, 1571, 1910, 2217, 2600, 2895]",11200,6446,6074,2505,2895,-4198,1328,480,1130,-118,-1378,15,radiant
7587621709,70,47,17,66,26,"[246, 568, 898, 1379, 1856, 2331, 2608, 2983, 3465, 3965, 4573, 5379, 5725, 6790, 7661]","[329, 539, 665, 1114, 1942, 2472, 2959, 3490, 4086, 4583, 5380, 5776, 6427, 6852, 7255]","[113, 479, 856, 1067, 1396, 1644, 2374, 2997, 3369, 3690, 4029, 4539, 5177, 6046, 6521]","[213, 423, 533, 735, 1073, 1274, 1581, 1863, 2125, 2477, 2900, 3050, 3444, 3905, 4300]","[113, 323, 458, 665, 920, 1023, 1193, 1447, 1607, 2052, 2819, 3039, 3321, 4068, 4163]",7661,7255,6521,4300,4163,73,74,129,14,68,"[1, 356, 684, 953, 1083, 1307, 1549, 1907, 2303, 2954, 3629, 4520, 4984, 5739, 6386]","[1, 240, 401, 944, 1225, 1807, 2218, 2818, 3293, 3793, 4515, 4963, 5210, 5683, 6307]","[1, 131, 330, 508, 856, 986, 1536, 2101, 2350, 2440, 2756, 3360, 4304, 4824, 5285]","[1, 226, 316, 406, 496, 953, 1062, 1393, 2206, 2359, 2742, 3122, 3394, 3856, 4141]","[1, 359, 449, 539, 629, 796, 1295, 1666, 1856, 1946, 2447, 2687, 3068, 3735, 4183]",6386,6307,5285,4141,4183,1275,948,1236,159,-20,3598,15,radiant
7587662408,18,49,9,86,71,"[0, 334, 475, 794, 1208, 1606, 1873, 2331, 2676, 3081, 3527, 3985, 4466, 5058, 5674]","[0, 205, 372, 810, 1215, 1685, 2288, 2631, 2877, 3195, 3660, 4112, 4510, 4943, 5475]","[0, 332, 539, 991, 1323, 1663, 1987, 2405, 2806, 3366, 3843, 4255, 5084, 5603, 6378]","[0, 170, 353, 489, 664, 895, 1095, 1270, 1409, 1659, 1839, 1975, 2150, 2290, 2431]","[0, 170, 260, 396, 602, 737, 827, 1002, 1092, 1227, 1362, 1639, 1765, 2071, 2464]",5674,5475,6378,2431,2464,48,64,129,128,111,"[0, 246, 482, 809, 1097, 1378, 1503, 1857, 2106, 2470, 2962, 3556, 4168, 4747, 5391]","[0, 239, 606, 1062, 1393, 1810, 2172, 2636, 3148, 3483, 4002, 4418, 4723, 5423, 5607]","[0, 243, 495, 735, 1109, 1486, 1981, 2405, 2766, 3169, 3668, 4448, 4846, 5389, 5982]","[0, 170, 276, 382, 604, 734, 873, 1008, 1102, 1240, 1611, 1905, 2094, 2600, 2884]","[0, 170, 260, 439, 529, 659, 749, 955, 1129, 1373, 1776, 1968, 2144, 2338, 2645]",5391,5607,5982,2884,2645,283,-132,396,-453,-181,-87,15,dire
7588356005,138,21,76,83,84,"[0, 265, 586, 863, 1188, 1643, 2016, 2354, 2845, 3551, 3938, 4406, 5092, 5442, 6052]","[0, 616, 830, 1156, 1280, 1528, 1683, 1967, 2356, 2653, 2896, 3377, 3788, 4269, 4613]","[0, 302, 465, 626, 915, 1238, 1411, 1610, 1821, 2125, 2511, 2779, 2959, 3228, 3639]","[0, 226, 316, 610, 700, 1172, 1601, 1711, 2086, 2377, 3308, 3481, 3571, 3719, 4292]","[0, 226, 316, 493, 583, 713, 803, 893, 983, 1145, 1235, 1575, 2003, 2200, 2420]",6052,4613,3639,4292,2420,35,95,15,123,75,"[0, 284, 536, 774, 1147, 1561, 1940, 2586, 3333, 3591, 4699, 4789, 5456, 6363, 6698]","[0, 257, 616, 1187, 1567, 1790, 2587, 2909, 3692, 4067, 4702, 5590, 6224, 6536, 7206]","[0, 252, 463, 734, 923, 1359, 1576, 1945, 2237, 2493, 3037, 3833, 4142, 4768, 5311]","[0, 170, 260, 401, 491, 632, 722, 984, 1156, 1337, 1775, 1995, 2330, 2681, 3321]","[0, 170, 260, 489, 643, 773, 1025, 1240, 1491, 1581, 2307, 2682, 2862, 3201, 3386]",6698,7206,5311,3321,3386,-646,-2593,-1672,971,-966,-4906,15,dire
7588370313,49,82,15,58,100,"[0, 326, 566, 903, 1182, 1421, 1987, 2307, 2905, 3202, 3413, 3785, 4220, 4772, 5238]","[0, 370, 636, 921, 1179, 1495, 1964, 2553, 3233, 3821, 4049, 4490, 5356, 5915, 6180]","[0, 370, 621, 999, 1247, 1337, 1567, 1730, 2087, 2229, 2590, 3075, 3436, 3966, 4321]","[0, 250, 340, 515, 821, 911, 1131, 1535, 1753, 1894, 2312, 2437, 2721, 3131, 3296]","[0, 250, 340, 642, 732, 822, 957, 1196, 1376, 1502, 1713, 1803, 2111, 2389, 2534]",5238,6180,4321,3296,2534,63,80,102,123,27,"[0, 539, 852, 1338, 1556, 2344, 2742, 3472, 4272, 4690, 5660, 6215, 6694, 7614, 8231]","[0, 233, 449, 818, 1226, 1556, 2057, 2482, 2909, 3365, 3667, 4109, 4572, 5177, 5949]","[0, 90, 414, 924, 1095, 1310, 1694, 2147, 2713, 3117, 3518, 3890, 4727, 5091, 5514]","[0, 159, 285, 466, 556, 904, 1052, 1271, 1503, 1630, 2327, 2762, 3001, 3470, 3810]","[0, 159, 249, 427, 517, 607, 807, 966, 1179, 1269, 1688, 2132, 2538, 2907, 3346]",8231,5949,5514,3810,3346,-2993,231,-1193,-514,-812,-5281,15,dire
7588454903,1,69,80,123,112,"[0, 240, 508, 710, 1125, 1449, 1753, 2044, 2211, 2465, 3285, 4136, 4555, 5328, 5834]","[0, 324, 684, 1056, 1492, 1945, 2336, 2767, 3348, 3777, 3985, 4422, 4911, 5394, 5932]","[0, 279, 526, 899, 1309, 1791, 2162, 2780, 3149, 3581, 3927, 4295, 4813, 5404, 5879]","[0, 170, 285, 471, 607, 697, 804, 1315, 1657, 1837, 2235, 2610, 2748, 2978, 3263]","[0, 170, 334, 424, 609, 743, 833, 1013, 1103, 1464, 2194, 2452, 2586, 2865, 3036]",5834,5932,5879,3263,3036,94,90,136,58,91,"[0, 279, 535, 738, 973, 1482, 1847, 2339, 2765, 3198, 3668, 4436, 4896, 6041, 6639]","[0, 440, 694, 902, 1162, 1514, 2051, 2460, 3246, 3630, 4277, 4822, 5400, 5886, 6519]","[0, 537, 1003, 1291, 1646, 1947, 2242, 2724, 3076, 3557, 3647, 4061, 4637, 5068, 5687]","[0, 232, 322, 412, 502, 716, 806, 1145, 1280, 1435, 1611, 1735, 1982, 2515, 2811]","[0, 269, 558, 695, 832, 968, 1058, 1234, 1373, 1597, 1826, 1916, 2054, 2546, 2736]",6639,6519,5687,2811,2736,-805,-587,192,452,300,-448,15,radiant
7588655005,94,96,106,123,112,"[0, 289, 647, 936, 1334, 1748, 2028, 2505, 2985, 3422, 3884, 4345, 4882, 5476, 5749]","[0, 277, 519, 939, 1312, 1654, 1977, 2402, 2845, 3197, 4376, 5133, 5650, 6225, 7102]","[0, 322, 650, 922, 1411, 1801, 2152, 2614, 3019, 3468, 3935, 4253, 4704, 5140, 5372]","[0, 170, 260, 398, 553, 927, 1017, 1157, 1632, 1812, 2246, 2912, 3053, 3148, 3243]","[0, 170, 260, 714, 804, 894, 984, 1124, 1329, 1619, 1891, 2246, 2421, 2561, 2911]",5749,7102,5372,3243,2911,120,10,69,33,20,"[0, 295, 458, 824, 1138, 1465, 1849, 2255, 2937, 3442, 3967, 4635, 5218, 5789, 7206]","[0, 170, 440, 763, 1087, 1251, 1852, 2333, 2602, 3011, 3252, 3787, 4181, 4844, 5827]","[0, 242, 482, 1236, 1527, 1813, 2107, 2638, 3201, 3614, 4115, 4821, 5359, 6021, 7389]","[0, 170, 260, 350, 566, 745, 1071, 1243, 1431, 1625, 2140, 2537, 2746, 3406, 3900]","[0, 271, 413, 658, 826, 956, 1277, 1456, 1671, 1933, 2398, 2627, 2762, 3158, 3563]",7206,5827,7389,3900,3563,-1457,1275,-2017,-657,-652,-3508,15,radiant
7588849413,95,60,97,65,91,"[0, 279, 649, 972, 1812, 2379, 2823, 3357, 3954, 4111, 4698, 5175, 5794, 6193, 7055]","[0, 293, 459, 973, 1356, 1741, 2163, 2569, 3078, 3366, 3861, 4252, 4912, 5341, 5872]","[0, 331, 650, 855, 1320, 1680, 2203, 2842, 3296, 3756, 4355, 4854, 5130, 5492, 5677]","[0, 210, 300, 416, 651, 776, 941, 1148, 1355, 1877, 2167, 2540, 3098, 3330, 3613]","[0, 310, 400, 490, 808, 942, 1151, 1241, 1395, 1485, 2020, 2211, 2344, 2576, 2810]",7055,5872,5677,3613,2810,41,22,112,123,102,"[0, 204, 474, 680, 876, 1418, 1808, 1955, 2195, 2659, 3174, 3692, 4051, 4737, 5115]","[0, 293, 614, 1262, 1488, 1905, 2460, 2595, 2981, 3811, 4417, 4755, 5311, 6279, 6774]","[0, 130, 220, 569, 778, 1158, 1455, 1718, 2129, 2617, 2752, 3143, 3651, 4240, 4952]","[0, 130, 265, 619, 799, 975, 1197, 1332, 1422, 1920, 2055, 2195, 2314, 2752, 3120]","[0, 130, 220, 376, 518, 648, 738, 954, 1082, 1272, 1407, 1595, 1780, 2490, 3063]",5115,6774,4952,3120,3063,1940,-902,725,493,-253,2003,15,dire
7589043306,17,14,43,19,20,"[329, 619, 960, 1288, 1628, 2146, 2620, 3004, 3498, 3913, 4473, 4846, 5372, 5771, 5876]","[61, 340, 853, 1172, 1699, 2026, 2406, 2768, 2903, 3435, 3693, 4003, 4545, 4911, 5042]","[0, 170, 531, 793, 1364, 1699, 1987, 2154, 2497, 3386, 3802, 3976, 4404, 4535, 5130]","[61, 231, 321, 711, 933, 1367, 1457, 1552, 1735, 2018, 2404, 2494, 2584, 2717, 2968]","[61, 231, 389, 568, 739, 929, 1403, 1493, 1628, 2063, 2198, 2288, 2422, 2829, 2924]",5876,5042,5130,2968,2924,42,98,80,72,26,"[0, 285, 642, 964, 1380, 1899, 2180, 2816, 3265, 3727, 4298, 4634, 5369, 5978, 6576]","[0, 454, 859, 1154, 1396, 1988, 2078, 2444, 3077, 3566, 4320, 4957, 5614, 6102, 6662]","[0, 291, 559, 964, 1138, 1418, 1865, 2511, 3022, 3349, 4080, 4615, 5169, 6528, 7089]","[0, 252, 342, 432, 571, 741, 846, 1277, 1810, 1990, 2466, 2643, 2899, 3192, 3879]","[0, 170, 260, 350, 440, 610, 797, 1116, 1206, 1386, 1673, 2145, 2408, 2942, 3411]",6576,6662,7089,3879,3411,-700,-1620,-1959,-911,-487,-5677,15,dire
7589073410,84,14,8,26,121,"[0, 221, 531, 818, 1118, 1684, 2133, 2993, 3947, 4128, 4987, 5607, 6050, 6755, 8927]","[0, 328, 659, 1146, 1418, 2262, 2646, 3019, 3790, 4246, 4923, 5408, 6363, 6712, 7482]","[0, 279, 477, 642, 931, 1139, 1509, 1662, 2009, 2183, 2750, 3295, 3637, 4103, 4523]","[0, 169, 259, 366, 456, 595, 685, 1188, 1596, 1763, 1853, 1943, 2471, 2771, 3043]","[0, 169, 297, 387, 521, 762, 896, 986, 1306, 1396, 1666, 1929, 2263, 2566, 3144]",8927,7482,4523,3043,3144,61,21,129,20,19,"[0, 240, 513, 979, 1442, 1726, 2078, 2546, 3156, 3860, 4581, 5203, 5939, 6731, 7133]","[0, 291, 614, 1216, 1633, 1914, 2173, 2583, 2846, 3322, 3918, 4362, 4946, 5715, 6209]","[0, 328, 656, 1142, 1686, 1935, 2303, 2711, 3086, 4023, 4379, 4745, 5012, 5668, 5797]","[0, 502, 592, 981, 1126, 1321, 1456, 1556, 1692, 1872, 2142, 2469, 2690, 3210, 3305]","[0, 234, 324, 511, 698, 788, 959, 1193, 1565, 1964, 2386, 2476, 2676, 3040, 3238]",7133,6209,5797,3305,3238,1794,1273,-1274,-262,-94,1437,15,radiant
7589153912,70,98,120,112,58,"[0, 201, 540, 927, 1229, 1730, 2127, 2526, 3031, 3919, 4259, 4548, 5176, 5791, 6486]","[0, 251, 534, 1011, 1426, 1821, 2245, 2894, 3351, 3845, 4512, 4958, 5622, 6494, 6840]","[0, 246, 499, 672, 880, 1318, 1669, 2066, 2348, 2989, 3460, 3894, 4254, 4754, 5298]","[0, 129, 219, 355, 590, 763, 898, 1171, 1305, 1690, 1953, 2367, 2798, 3131, 3271]","[0, 172, 262, 404, 511, 1009, 1099, 1189, 1378, 1869, 1959, 2066, 2419, 2715, 2855]",6486,6840,5298,3271,2855,14,101,102,26,84,"[0, 243, 594, 951, 1134, 1448, 1743, 2177, 2824, 3128, 3581, 3780, 4399, 5269, 6067]","[0, 395, 594, 910, 1356, 1624, 2235, 2541, 3527, 4125, 4412, 4686, 4866, 5830, 6401]","[0, 246, 570, 941, 1265, 1827, 1962, 2141, 2521, 2765, 3201, 3857, 4634, 5044, 5492]","[0, 209, 299, 389, 528, 662, 980, 1070, 1516, 1651, 1918, 2205, 2432, 2773, 3014]","[0, 209, 299, 435, 525, 660, 842, 979, 1159, 1440, 1575, 1842, 2328, 2477, 2671]",6067,6401,5492,3014,2671,419,439,-194,257,184,1105,15,radiant
7589575411,113,14,106,91,5,"[0, 204, 546, 939, 1147, 1639, 2132, 2510, 2906, 3626, 4309, 5257, 6132, 6896, 7917]","[0, 293, 584, 1013, 1647, 1808, 2352, 3097, 3429, 4002, 4452, 5256, 5636, 6196, 7048]","[0, 282, 614, 853, 1282, 1649, 2255, 2512, 2845, 3236, 4034, 4546, 5188, 5482, 6338]","[0, 170, 260, 765, 1359, 1449, 1667, 2079, 2413, 2645, 2988, 3218, 3733, 4095, 4669]","[0, 219, 309, 445, 581, 731, 981, 1203, 1544, 1634, 2017, 2607, 3029, 3467, 3944]",7917,7048,6338,4669,3944,36,10,49,58,123,"[0, 282, 576, 974, 1364, 1799, 2031, 2471, 3245, 3671, 3935, 4381, 4971, 5448, 6018]","[0, 248, 498, 884, 1095, 1517, 1930, 2258, 2473, 2817, 3174, 3705, 4187, 4484, 5147]","[0, 247, 444, 1038, 1361, 1727, 2062, 2298, 2658, 3078, 3586, 3968, 4307, 4700, 5100]","[0, 170, 260, 619, 709, 906, 1041, 1131, 1376, 1667, 1870, 2224, 2547, 2642, 2829]","[0, 213, 409, 616, 757, 940, 1134, 1348, 1438, 1656, 1795, 2024, 2286, 2413, 2815]",6018,5147,5100,2829,2815,1899,1901,1238,1840,1129,8007,15,radiant
7589670807,54,65,137,43,31,"[398, 560, 755, 1091, 1295, 1600, 1941, 2221, 2488, 3003, 3443, 3835, 4636, 5229, 5607]","[263, 352, 467, 605, 1035, 1227, 1379, 1643, 1778, 2114, 2429, 2722, 3121, 3571, 4370]","[130, 345, 530, 918, 1351, 1553, 1708, 2153, 2409, 3118, 3460, 3861, 3951, 4841, 5331]","[130, 292, 629, 873, 1245, 1414, 1687, 2188, 2278, 2841, 3128, 3780, 3870, 4211, 4487]","[130, 219, 381, 471, 561, 730, 820, 1084, 1174, 1510, 1600, 1777, 1867, 2140, 2398]",5607,4370,5331,4487,2398,48,35,96,21,20,"[129, 378, 794, 1010, 1213, 1629, 2209, 2709, 3205, 3627, 4493, 5064, 5448, 6386, 7270]","[335, 655, 944, 1301, 1667, 2081, 2595, 2956, 3364, 3736, 4683, 5026, 5475, 6127, 6952]","[202, 451, 935, 1193, 1722, 2190, 2562, 3341, 3904, 4384, 4973, 5492, 6384, 7093, 8066]","[568, 817, 1202, 1292, 1656, 1976, 2146, 2568, 2888, 3108, 3879, 4175, 4716, 4940, 5983]","[202, 499, 589, 703, 812, 902, 1155, 1335, 1484, 1811, 2512, 2829, 3096, 3452, 3706]",7270,6952,8066,5983,3706,-1663,-2582,-2735,-1496,-1308,-9784,15,dire
7589891206,10,61,108,123,20,"[0, 206, 443, 678, 960, 1321, 1805, 2280, 2843, 3183, 3765, 4163, 4814, 5449, 6166]","[0, 164, 456, 896, 1303, 1687, 2257, 2777, 3773, 4621, 5085, 5844, 7041, 8059, 8876]","[0, 167, 367, 776, 1204, 1537, 1815, 2630, 3365, 3612, 3990, 4589, 5216, 6122, 6709]","[0, 129, 219, 309, 512, 769, 871, 1130, 1497, 1769, 2186, 2355, 2658, 3337, 3822]","[100, 229, 363, 463, 604, 734, 984, 1119, 1389, 1575, 1964, 2133, 2313, 2899, 3203]",6166,8876,6709,3822,3203,89,21,90,53,19,"[0, 313, 688, 923, 1137, 1523, 1741, 2083, 2336, 3044, 3565, 3978, 4502, 4681, 5324]","[0, 658, 948, 1165, 1411, 1775, 2326, 2688, 3153, 3569, 4059, 4752, 5193, 5401, 5700]","[0, 328, 606, 941, 1312, 1601, 2159, 2454, 2674, 3006, 3568, 3936, 4312, 4581, 4972]","[0, 268, 358, 466, 684, 857, 1061, 1422, 1557, 1992, 2331, 2523, 2622, 2817, 3066]","[0, 268, 358, 460, 624, 761, 965, 1169, 1388, 1672, 1807, 1951, 2041, 2136, 2231]",5324,5700,4972,3066,2231,842,3176,1737,756,972,7483,15,radiant
7590250603,48,53,47,123,137,"[0, 256, 585, 1036, 1363, 1632, 1942, 2544, 2996, 3398, 4169, 4706, 5746, 6498, 7254]","[0, 170, 260, 434, 524, 663, 753, 1073, 1281, 1544, 2155, 2617, 3277, 3735, 4025]","[0, 252, 494, 829, 1201, 1500, 1907, 2521, 2947, 3209, 3538, 3988, 4078, 4588, 5054]","[0, 270, 360, 719, 890, 994, 1084, 1264, 1399, 1539, 2280, 2462, 2581, 3045, 3378]","[0, 244, 334, 579, 873, 1099, 1272, 1827, 2191, 2528, 3650, 4005, 4095, 4588, 4736]",7254,4025,5054,3378,4736,49,46,80,27,86,"[0, 273, 521, 1003, 1221, 1921, 2400, 2819, 3193, 4215, 4595, 5139, 5855, 6576, 6899]","[0, 300, 496, 730, 961, 1230, 1544, 1823, 2504, 2806, 3232, 3633, 3723, 4438, 4855]","[0, 280, 599, 867, 992, 1361, 1774, 2070, 2524, 3025, 3422, 4054, 4587, 5080, 5872]","[0, 195, 285, 716, 806, 896, 1112, 1430, 1884, 2136, 2352, 3022, 3293, 4096, 4356]","[0, 195, 285, 471, 611, 929, 1283, 1410, 1840, 2146, 2400, 2596, 2916, 3516, 3838]",6899,4855,5872,4356,3838,355,-830,-818,-978,898,-1373,15,dire
7590356016,73,90,106,86,26,"[0, 553, 1016, 1400, 1604, 1932, 2362, 2711, 3305, 3860, 4499, 4874, 5524, 6155, 7154]","[0, 722, 1158, 1488, 1831, 2121, 2539, 3287, 3977, 4529, 5107, 5662, 6286, 6891, 7432]","[0, 416, 795, 1164, 1620, 1911, 2430, 2882, 3305, 3811, 4225, 4723, 4999, 5390, 6174]","[0, 297, 588, 678, 882, 1281, 1460, 1660, 1927, 2062, 2152, 2315, 2563, 2818, 3314]","[0, 297, 387, 486, 583, 711, 941, 1141, 1406, 1733, 1836, 1970, 2286, 2523, 2708]",7154,7432,6174,3314,2708,18,28,43,19,20,"[0, 324, 842, 1180, 1633, 1963, 2251, 2565, 3171, 3767, 4374, 5837, 6497, 7275, 7876]","[0, 395, 725, 1011, 1497, 2021, 2543, 2826, 3346, 3769, 4273, 4916, 5805, 6264, 6636]","[0, 296, 497, 799, 958, 1245, 1614, 1961, 2399, 2731, 3281, 3978, 4290, 4726, 5161]","[0, 239, 329, 509, 682, 807, 970, 1060, 1150, 1375, 1510, 1941, 2329, 2535, 2935]","[0, 372, 555, 739, 829, 988, 1123, 1213, 1303, 1438, 1620, 2149, 2425, 2608, 2703]",7876,6636,5161,2935,2703,-722,796,1013,379,5,1471,15,dire
7590366816,98,92,57,33,88,"[0, 329, 689, 1090, 1563, 2013, 2353, 3273, 3563, 4488, 5000, 5389, 6091, 6917, 7307]","[0, 286, 799, 983, 1708, 2244, 2492, 2825, 3257, 3705, 4529, 4925, 5514, 6104, 6807]","[0, 259, 641, 1084, 1312, 1685, 2178, 2713, 2929, 3534, 3868, 4586, 5233, 6051, 6399]","[0, 271, 838, 928, 1058, 1148, 1393, 1584, 1826, 2496, 3009, 3210, 3913, 4345, 4592]","[0, 170, 364, 625, 918, 1095, 1271, 1445, 1789, 2003, 2271, 2504, 2859, 3100, 3321]",7307,6807,6399,4592,3321,62,72,90,19,135,"[58, 328, 595, 885, 1229, 1319, 1864, 2202, 2312, 2512, 3047, 3277, 3872, 4402, 4551]","[58, 228, 423, 513, 1162, 1404, 1581, 1929, 2303, 2804, 3181, 3793, 4340, 5131, 5622]","[326, 544, 885, 1210, 1832, 1922, 2232, 2707, 2797, 3367, 3660, 4084, 4723, 5243, 5751]","[58, 299, 540, 873, 1368, 1660, 1857, 2260, 2385, 2800, 3382, 3827, 4454, 4846, 4995]","[58, 299, 460, 983, 1310, 1516, 2106, 2529, 2801, 3332, 3665, 3994, 4477, 4878, 5247]",4551,5622,5751,4995,5247,2756,1185,648,-403,-1926,2260,15,dire
7590828718,129,17,95,31,26,"[328, 573, 749, 1188, 1942, 2246, 2481, 3090, 3476, 4170, 4563, 5129, 5472, 6303, 6737]","[0, 294, 663, 1040, 1493, 1847, 2550, 3384, 3685, 4160, 4666, 4850, 5943, 6685, 7218]","[60, 269, 445, 612, 959, 1231, 1403, 1755, 2232, 2785, 3080, 3430, 4198, 4735, 5200]","[60, 230, 357, 447, 537, 627, 1052, 1232, 1491, 1866, 2312, 2436, 3147, 3415, 3633]","[60, 230, 320, 556, 1008, 1098, 1188, 1583, 1673, 1891, 2231, 2415, 3203, 3756, 4125]",6737,7218,5200,3633,4125,63,57,123,2,105,"[0, 170, 468, 723, 971, 1100, 1382, 1561, 2003, 2295, 2732, 3331, 3691, 4086, 4561]","[0, 241, 437, 1009, 1335, 1626, 2091, 2551, 2713, 3060, 3481, 3847, 4150, 4782, 5062]","[0, 216, 355, 625, 759, 1071, 1489, 1625, 1715, 2076, 2346, 2979, 3069, 3478, 3867]","[0, 246, 460, 737, 1021, 1270, 1441, 1727, 2133, 2940, 3303, 3985, 4161, 4513, 4937]","[0, 170, 260, 648, 944, 1034, 1292, 1404, 1494, 1630, 1855, 2218, 2308, 2546, 2730]",4561,5062,3867,4937,2730,2176,2156,1333,-1304,1395,5756,15,radiant
7590849510,48,80,96,66,45,"[0, 251, 689, 982, 1566, 1961, 2170, 2599, 3057, 3534, 4188, 4787, 5222, 6110, 6922]","[0, 324, 621, 974, 1625, 2001, 2447, 3135, 3641, 4108, 4638, 5480, 5717, 6458, 7129]","[0, 206, 455, 561, 1338, 1756, 2251, 2653, 3281, 3630, 4070, 4595, 5044, 5435, 5648]","[0, 170, 329, 453, 717, 834, 945, 1238, 1544, 2217, 2973, 3521, 3938, 4318, 4927]","[0, 208, 392, 537, 756, 846, 984, 1367, 1556, 1959, 2246, 2498, 2637, 3251, 4022]",6922,7129,5648,4927,4022,23,17,41,5,123,"[0, 208, 448, 731, 1213, 1545, 2011, 2532, 2929, 3303, 4042, 4132, 4479, 5217, 5527]","[0, 242, 539, 703, 838, 1083, 1519, 1690, 2077, 2631, 3030, 3120, 3738, 4398, 4786]","[0, 204, 438, 1022, 1269, 1403, 1530, 1815, 2114, 2455, 2703, 3162, 3495, 4097, 4662]","[0, 170, 621, 792, 948, 1038, 1258, 1393, 1483, 1724, 1993, 2083, 2388, 2956, 3096]","[0, 170, 260, 408, 585, 689, 1071, 1330, 1472, 1562, 2004, 2094, 2434, 2601, 2744]",5527,4786,4662,3096,2744,1395,2343,986,1831,1278,7833,15,radiant
7590862303,95,13,96,26,100,"[0, 210, 571, 936, 1147, 1566, 2073, 2646, 3426, 3588, 4072, 4390, 4699, 5389, 5976]","[0, 362, 687, 815, 977, 1349, 1641, 1898, 2393, 2929, 3395, 3692, 4252, 5260, 5529]","[0, 244, 481, 727, 1156, 1246, 1468, 1797, 2105, 2594, 3000, 3390, 3638, 4341, 4812]","[100, 310, 400, 540, 630, 765, 1060, 1283, 1511, 1621, 2118, 2256, 2531, 3394, 4147]","[0, 210, 300, 390, 578, 668, 1075, 1229, 1502, 1737, 1916, 2055, 2503, 2858, 3430]",5976,5529,4812,4147,3430,28,39,6,20,51,"[0, 130, 483, 767, 1219, 1527, 2039, 2392, 2482, 3231, 3831, 4203, 4457, 5056, 5411]","[0, 259, 556, 1307, 1648, 2044, 2810, 3158, 3563, 3813, 4075, 4381, 4568, 4770, 5694]","[0, 164, 406, 566, 1069, 1270, 1550, 1859, 2038, 2258, 2769, 3091, 3864, 4503, 4598]","[0, 130, 220, 353, 745, 860, 1351, 1677, 2081, 2349, 2623, 2713, 3047, 3338, 3918]","[0, 130, 220, 310, 600, 690, 921, 1146, 1236, 1622, 1757, 1847, 2264, 2555, 2973]",5411,5694,4598,3918,2973,565,-165,214,229,457,1300,15,radiant
7591136209,46,106,28,53,5,"[0, 294, 568, 953, 1351, 1679, 2132, 2491, 2994, 3255, 3554, 4076, 4342, 4819, 5234]","[0, 252, 579, 876, 1443, 1950, 2246, 2617, 3240, 3545, 3858, 4188, 4844, 5267, 6069]","[0, 208, 495, 795, 1289, 1692, 1853, 1988, 2408, 2923, 3427, 3842, 4580, 4997, 5635]","[0, 550, 677, 1314, 1720, 1972, 2206, 2386, 2808, 3063, 3325, 3515, 4241, 4665, 5336]","[0, 170, 307, 585, 788, 975, 1416, 1595, 1685, 1775, 1910, 2023, 2446, 2689, 3066]",5234,6069,5635,5336,3066,1,129,90,17,121,"[0, 316, 635, 993, 1360, 1735, 2077, 2574, 3196, 3581, 4345, 4816, 5513, 6005, 6956]","[0, 241, 530, 721, 934, 1260, 1505, 2086, 2502, 2703, 3176, 3666, 4224, 4930, 5834]","[0, 423, 553, 673, 783, 1110, 1314, 1448, 1753, 2330, 2933, 3162, 3460, 4343, 4521]","[0, 291, 657, 1067, 1290, 1380, 2189, 2735, 2955, 3900, 4385, 4643, 5023, 6080, 6260]","[0, 170, 351, 471, 619, 709, 799, 1342, 1432, 1713, 2031, 2180, 2671, 3030, 3125]",6956,5834,4521,6260,3125,-1722,235,1114,-924,-59,-1356,15,dire
7591146603,8,106,102,123,112,"[0, 574, 844, 1168, 1513, 2055, 2418, 3091, 3593, 4175, 4595, 5002, 5720, 6339, 7022]","[0, 319, 646, 897, 1296, 1663, 2031, 2405, 2910, 3409, 4252, 4727, 5430, 6092, 6484]","[0, 368, 539, 880, 1084, 1283, 1409, 1499, 1589, 1972, 2440, 2737, 3040, 3826, 4184]","[0, 210, 300, 506, 596, 906, 996, 1342, 1470, 1711, 2205, 2588, 3594, 3864, 4122]","[0, 271, 379, 469, 606, 774, 909, 1657, 1747, 1985, 2168, 2464, 2680, 3031, 3217]",7022,6484,4184,4122,3217,136,14,137,20,91,"[0, 167, 485, 836, 1331, 1978, 2429, 3132, 3907, 4440, 5060, 5774, 6142, 6495, 7438]","[0, 130, 438, 646, 927, 1179, 1686, 2000, 2313, 3061, 3577, 3896, 4328, 4915, 5505]","[0, 205, 525, 771, 1069, 1475, 2129, 2301, 2773, 3236, 3597, 4089, 4571, 5015, 5387]","[0, 177, 285, 375, 510, 669, 1111, 1246, 1381, 1683, 1858, 2191, 2472, 2767, 3012]","[0, 130, 265, 440, 614, 845, 1026, 1300, 1832, 1967, 2407, 2701, 2890, 2984, 3329]",7438,5505,5387,3012,3329,-416,979,-1203,1110,-112,358,15,dire
7591716813,46,10,98,79,123,"[0, 333, 548, 918, 1399, 1814, 2288, 2865, 3500, 3590, 4521, 4849, 5342, 5745, 6458]","[0, 210, 414, 617, 815, 1061, 1403, 1819, 2230, 2354, 2891, 3461, 4049, 4680, 4926]","[0, 328, 650, 903, 1307, 1625, 1837, 2198, 2604, 2694, 3187, 3649, 3910, 4357, 4659]","[0, 210, 300, 390, 528, 663, 753, 843, 981, 1203, 1665, 1839, 1979, 2127, 2277]","[0, 298, 388, 478, 651, 785, 974, 1130, 1350, 1440, 1530, 1673, 1824, 2155, 2312]",6458,4926,4659,2277,2312,49,120,6,110,86,"[0, 249, 569, 915, 1286, 2128, 2615, 3100, 3420, 4416, 4908, 5819, 6665, 7258, 7486]","[0, 251, 623, 865, 1237, 1498, 2191, 2723, 3240, 3985, 4634, 5104, 5738, 6628, 7033]","[0, 216, 509, 874, 1164, 1489, 1906, 2199, 2565, 3131, 3676, 4300, 4772, 5206, 5798]","[0, 130, 220, 355, 529, 657, 792, 969, 1105, 1576, 2059, 2349, 2629, 3163, 3619]","[100, 230, 320, 501, 631, 836, 1035, 1170, 1389, 1705, 1976, 2241, 2755, 3367, 3462]",7486,7033,5798,3619,3462,-1028,-2107,-1139,-1342,-1150,-6766,15,dire
7592853213,15,93,21,33,19,"[0, 254, 584, 826, 1197, 1528, 1898, 2096, 2559, 2780, 3502, 4535, 4947, 5322, 6003]","[0, 287, 487, 773, 1181, 1394, 1748, 2168, 2591, 3167, 4100, 4650, 5169, 6002, 6327]","[0, 243, 367, 694, 1260, 1633, 2082, 2431, 3218, 3606, 3902, 4524, 4758, 5020, 5375]","[0, 169, 259, 397, 532, 667, 1021, 1148, 1326, 1547, 1955, 2273, 2613, 2762, 2952]","[0, 217, 307, 397, 612, 747, 858, 999, 1177, 1563, 1895, 2315, 2482, 2752, 2981]",6003,6327,5375,2952,2981,4,46,129,72,65,"[0, 169, 756, 1136, 1587, 2011, 2344, 2946, 3267, 3477, 3640, 4223, 4976, 5527, 6002]","[0, 284, 588, 840, 1090, 1330, 1642, 2098, 2607, 3176, 3610, 4488, 5041, 6016, 6565]","[0, 208, 454, 769, 1019, 1419, 1740, 2214, 2576, 2990, 3560, 3955, 4501, 4996, 5614]","[0, 206, 296, 386, 476, 651, 974, 1154, 1272, 1648, 1921, 2246, 2611, 3000, 3248]","[0, 169, 333, 471, 621, 751, 1202, 1467, 1867, 2111, 2519, 2687, 3074, 3317, 3515]",6002,6565,5614,3248,3515,1,-238,-239,-296,-534,-1306,15,radiant
7593018617,82,129,50,79,5,"[0, 204, 441, 836, 1136, 1496, 2064, 2269, 2764, 3467, 4081, 5057, 5526, 6354, 7485]","[0, 291, 576, 821, 1204, 1536, 1991, 2600, 3106, 3604, 4286, 4949, 5396, 5866, 6743]","[0, 244, 497, 787, 1248, 1623, 1981, 2518, 2929, 3276, 3589, 4200, 4756, 5290, 5576]","[0, 170, 260, 350, 490, 620, 710, 845, 935, 1042, 1380, 1705, 2161, 2256, 2507]","[100, 313, 449, 587, 677, 925, 1015, 1185, 1275, 1448, 1846, 2084, 2228, 2323, 2555]",7485,6743,5576,2507,2555,89,49,23,123,9,"[0, 290, 530, 731, 1116, 1553, 1868, 2358, 2716, 3190, 3782, 4407, 5054, 5825, 6302]","[0, 209, 517, 682, 1214, 1625, 1938, 2558, 2935, 3412, 3666, 4090, 4880, 5591, 6404]","[0, 279, 441, 617, 788, 1050, 1253, 1628, 1999, 2477, 2679, 3081, 3462, 4107, 4570]","[0, 218, 406, 496, 717, 1165, 1255, 1545, 1720, 1994, 2248, 2764, 2944, 3480, 3763]","[0, 270, 458, 596, 807, 1034, 1392, 1673, 1918, 2255, 2674, 3064, 3485, 3846, 4122]",6302,6404,4570,3763,4122,1183,339,1006,-1256,-1567,-295,15,dire
7593062809,12,61,96,19,26,"[0, 270, 645, 735, 1174, 1474, 1757, 2174, 2962, 3344, 3783, 4309, 4969, 5741, 6425]","[0, 231, 510, 754, 1309, 1728, 2172, 2471, 3103, 3951, 4309, 4743, 4833, 5556, 6259]","[0, 304, 469, 722, 1153, 1604, 1941, 2323, 2661, 3190, 3534, 4079, 4430, 5009, 5604]","[0, 195, 331, 421, 541, 718, 841, 1021, 1454, 1813, 2259, 2791, 3076, 3809, 4464]","[0, 538, 628, 757, 965, 1115, 1205, 1512, 1870, 2169, 2259, 2506, 2596, 2999, 3184]",6425,6259,5604,4464,3184,73,94,23,100,86,"[0, 250, 703, 1246, 1637, 1810, 2380, 2884, 3210, 4407, 4985, 5847, 6399, 7458, 8397]","[0, 324, 540, 751, 998, 1212, 1384, 1837, 2052, 2324, 2681, 2947, 3242, 3632, 4245]","[0, 279, 603, 904, 1192, 1518, 1825, 2809, 3462, 4067, 4642, 5275, 5801, 6130, 6426]","[0, 170, 260, 439, 529, 619, 709, 889, 979, 1253, 1463, 1785, 2080, 2174, 2365]","[0, 170, 374, 727, 896, 1036, 1175, 1422, 1643, 1924, 2110, 2283, 2761, 2905, 3305]",8397,4245,6426,2365,3305,-1972,2014,-822,2099,-121,1198,15,dire
7593178412,94,137,39,33,27,"[0, 256, 802, 1179, 1754, 2156, 2490, 2769, 3276, 3731, 4410, 4883, 5787, 6410, 7290]","[0, 329, 491, 986, 1544, 1834, 2202, 2785, 3104, 3451, 4107, 4834, 5318, 5913, 6531]","[0, 364, 645, 858, 1186, 1463, 1920, 2237, 2731, 3138, 3536, 4367, 4712, 5318, 5543]","[0, 170, 277, 449, 688, 905, 1197, 1710, 2093, 2485, 3255, 3738, 4352, 4785, 5301]","[0, 170, 330, 468, 829, 994, 1084, 1316, 1908, 2214, 2575, 3105, 3491, 3865, 4043]",7290,6531,5543,5301,4043,13,7,8,100,86,"[0, 285, 486, 657, 938, 1222, 1433, 1658, 1822, 2483, 2885, 3281, 3769, 3957, 4691]","[0, 284, 447, 738, 1034, 1365, 1695, 2163, 2376, 2587, 2963, 3350, 3792, 4225, 4699]","[0, 205, 505, 631, 938, 1280, 1593, 1984, 2372, 2857, 3023, 3220, 3388, 3708, 3942]","[0, 170, 260, 350, 721, 811, 950, 1433, 1523, 1729, 1819, 1909, 1999, 2326, 2676]","[0, 286, 437, 527, 749, 839, 929, 1263, 1423, 1624, 1762, 1904, 2064, 2259, 2372]",4691,4699,3942,2676,2372,2599,1832,1601,2625,1671,10328,15,radiant
7593282101,48,90,28,21,136,"[0, 163, 506, 789, 995, 1282, 1934, 2610, 3034, 3612, 4084, 4581, 5386, 5481, 6160]","[0, 257, 601, 888, 1191, 1578, 2019, 2359, 3050, 3538, 3896, 4254, 4565, 4699, 5069]","[0, 166, 316, 630, 1083, 1322, 1661, 2126, 2379, 2739, 2885, 3419, 3733, 3828, 4327]","[0, 129, 292, 732, 835, 978, 1306, 1396, 1620, 1801, 1927, 2172, 2406, 2501, 2824]","[0, 174, 333, 423, 513, 622, 1094, 1233, 1323, 1413, 1503, 1647, 1737, 1832, 1981]",6160,5069,4327,2824,1981,41,120,96,20,45,"[0, 315, 547, 782, 1060, 1344, 1624, 2005, 2386, 2804, 3192, 3610, 4332, 5315, 5941]","[0, 362, 796, 1198, 1687, 2095, 2705, 3757, 3937, 4267, 4817, 5568, 5746, 6317, 6959]","[0, 284, 571, 819, 1177, 1449, 1783, 2207, 2616, 3069, 3347, 4123, 4491, 5061, 5437]","[0, 209, 299, 445, 813, 1047, 1137, 1626, 1806, 2030, 2861, 3367, 3545, 3978, 4245]","[0, 209, 299, 389, 594, 727, 1162, 1380, 1608, 1698, 1823, 2052, 2285, 2783, 3224]",5941,6959,5437,4245,3224,219,-1890,-1110,-1421,-1243,-5445,15,dire
7593576711,94,90,20,71,85,"[0, 245, 491, 855, 1135, 1537, 1857, 2267, 2809, 2937, 3204, 3674, 4045, 4410, 4676]","[0, 444, 828, 1190, 1537, 2033, 2548, 3284, 3513, 3867, 4626, 5306, 6237, 6521, 6731]","[0, 247, 473, 1017, 1420, 1701, 1961, 2177, 2477, 3008, 3535, 3958, 4712, 4894, 5587]","[0, 222, 337, 498, 588, 718, 808, 943, 1033, 1123, 1587, 1820, 2470, 2760, 2953]","[0, 170, 285, 422, 512, 759, 885, 1020, 1110, 1284, 1549, 1639, 1933, 2027, 2122]",4676,6731,5587,2953,2122,49,120,43,123,30,"[0, 267, 549, 1081, 1277, 1520, 1976, 2750, 3055, 3361, 4237, 4960, 5898, 6149, 6873]","[0, 306, 577, 957, 1361, 1705, 2355, 2567, 2844, 3370, 3786, 4240, 4749, 5319, 6105]","[0, 233, 408, 665, 794, 984, 1238, 1625, 1790, 2187, 2624, 3203, 3795, 3988, 4400]","[0, 266, 459, 549, 764, 971, 1296, 1448, 1538, 2053, 2368, 2749, 3287, 3601, 4039]","[0, 240, 367, 590, 680, 785, 1314, 1503, 1637, 1727, 2042, 2380, 2882, 3075, 3493]",6873,6105,4400,4039,3493,-2197,626,1187,-1086,-1371,-2841,15,radiant
7594024404,12,13,96,123,128,"[0, 245, 715, 994, 1322, 1798, 2214, 2515, 2754, 3056, 3571, 3989, 4260, 4606, 5131]","[0, 283, 614, 900, 1192, 1413, 1705, 1958, 2328, 2963, 3156, 3841, 4031, 4299, 4817]","[0, 208, 573, 789, 1115, 1324, 1710, 2090, 2487, 3171, 3261, 3492, 3937, 4162, 4907]","[0, 170, 260, 350, 485, 575, 757, 895, 985, 1325, 1462, 1814, 1910, 2397, 2537]","[0, 170, 339, 478, 730, 820, 1001, 1091, 1181, 1350, 1478, 1665, 1755, 1850, 1990]",5131,4817,4907,2537,1990,93,71,120,110,20,"[0, 218, 529, 1096, 1312, 1737, 2223, 2651, 3077, 3336, 3932, 4573, 5181, 5756, 6222]","[0, 247, 602, 981, 1313, 1675, 2042, 2409, 3399, 3895, 4517, 5123, 6014, 6347, 6870]","[0, 245, 506, 677, 1016, 1213, 1623, 2032, 2449, 2955, 3896, 4226, 4443, 5039, 5516]","[0, 170, 629, 766, 902, 1221, 1631, 1745, 2242, 2509, 2925, 3108, 3377, 4176, 4592]","[0, 170, 285, 422, 512, 724, 951, 1088, 1269, 1441, 1668, 1812, 2361, 2694, 2987]",6222,6870,5516,4592,2987,-1091,-2053,-609,-2055,-997,-6805,15,dire
7594159214,46,93,98,65,20,"[0, 290, 566, 819, 1299, 1661, 2186, 2579, 2984, 3510, 3937, 4696, 5541, 6050, 6619]","[0, 242, 491, 833, 1165, 1608, 1908, 2251, 2506, 2663, 3183, 3877, 4237, 4883, 5606]","[0, 207, 616, 1076, 1362, 2185, 2521, 3112, 3871, 4574, 5235, 5504, 6503, 7133, 7446]","[0, 169, 259, 414, 504, 763, 1041, 1485, 1575, 1888, 2160, 2445, 3017, 3741, 4314]","[0, 169, 304, 469, 608, 968, 1148, 1843, 2023, 2673, 2808, 2988, 3483, 4068, 4372]",6619,5606,7446,4314,4372,48,13,102,123,26,"[0, 208, 410, 696, 1044, 1170, 1625, 1847, 2222, 2861, 3390, 3894, 4294, 5173, 5855]","[0, 328, 619, 1027, 1445, 1832, 2149, 2557, 3019, 3344, 3934, 4209, 4421, 4771, 5197]","[0, 203, 405, 919, 1162, 1587, 2189, 2713, 3151, 3654, 4151, 5097, 5621, 6083, 6809]","[0, 169, 259, 424, 597, 787, 1220, 1676, 2174, 2664, 2935, 3201, 3291, 3404, 3775]","[0, 217, 357, 447, 630, 770, 925, 1060, 1409, 1734, 1923, 2100, 2190, 2484, 2700]",5855,5197,6809,3775,2700,764,409,637,539,1672,4021,15,radiant
7594427402,70,13,96,105,5,"[0, 204, 488, 814, 981, 1318, 1642, 1803, 2336, 2925, 3304, 3650, 4018, 4632, 5388]","[0, 326, 563, 898, 1125, 1605, 1822, 2111, 2403, 2733, 3166, 3491, 3928, 4550, 5116]","[0, 215, 606, 1035, 1289, 1840, 2138, 2352, 2721, 3263, 3687, 4064, 4244, 4595, 5244]","[0, 169, 464, 599, 689, 1408, 1623, 1713, 1852, 2092, 2227, 2856, 3269, 3447, 4421]","[0, 169, 514, 946, 1036, 1338, 1473, 1563, 1886, 2198, 2333, 2566, 3122, 3310, 3658]",5388,5116,5244,4421,3658,21,49,54,19,121,"[0, 169, 857, 1138, 1508, 2086, 2383, 2682, 3014, 3429, 3679, 3978, 4627, 5341, 5765]","[0, 286, 528, 818, 1175, 1542, 2081, 2839, 3380, 3832, 4663, 4948, 5474, 5916, 6677]","[0, 203, 367, 601, 846, 974, 1372, 1758, 2150, 2491, 2734, 2850, 3536, 4508, 4797]","[0, 169, 371, 513, 603, 836, 1096, 1502, 1639, 1729, 1819, 2136, 2607, 2921, 3106]","[0, 169, 259, 367, 505, 595, 855, 1065, 1155, 1338, 1428, 1643, 1972, 2394, 2579]",5765,6677,4797,3106,2579,-377,-1561,447,1315,1079,903,15,dire
7594577403,36,76,16,20,110,"[0, 336, 703, 893, 1017, 1386, 1718, 2274, 2700, 3000, 3247, 3832, 4659, 5154, 5643]","[0, 280, 527, 989, 1250, 1614, 2103, 2274, 3329, 3785, 4187, 4860, 5517, 6030, 6512]","[0, 280, 567, 895, 1361, 1894, 2309, 3166, 4076, 4689, 5034, 5815, 6345, 6708, 7285]","[0, 500, 590, 680, 770, 908, 1088, 1298, 1653, 1788, 1878, 2235, 2615, 3218, 3367]","[0, 232, 322, 412, 630, 811, 991, 1420, 1764, 2127, 2292, 2670, 3050, 3275, 3561]",5643,6512,7285,3367,3561,129,106,70,53,128,"[0, 301, 569, 836, 1290, 1657, 2105, 2349, 2824, 3283, 3764, 3990, 4447, 5020, 5285]","[0, 512, 830, 1081, 1396, 1671, 2000, 2748, 2978, 3068, 3283, 3427, 3656, 4007, 4384]","[0, 481, 793, 1006, 1528, 1931, 2374, 2620, 2785, 3204, 3435, 3845, 4116, 4301, 4666]","[0, 262, 352, 459, 598, 703, 838, 1054, 1274, 1364, 1501, 1645, 1871, 2189, 2339]","[0, 192, 282, 409, 547, 683, 912, 1280, 1370, 1460, 1598, 1742, 1832, 2075, 2336]",5285,4384,4666,2339,2336,358,2128,2619,1028,1225,7358,15,radiant
7594924106,73,95,120,123,5,"[1, 352, 694, 1241, 1595, 1851, 2164, 2600, 3171, 3897, 4336, 5194, 6019, 6847, 8181]","[1, 204, 567, 923, 1293, 1838, 2113, 2481, 2957, 3211, 3762, 4162, 4603, 5032, 5585]","[1, 620, 847, 1154, 1402, 1729, 2111, 2412, 2689, 2928, 3269, 3835, 4351, 5016, 5603]","[1, 291, 430, 626, 754, 963, 1053, 1420, 1521, 1630, 2283, 2373, 2663, 2871, 3214]","[1, 598, 740, 877, 1068, 1281, 1371, 1581, 1752, 1923, 2191, 2374, 2608, 2771, 3074]",8181,5585,5603,3214,3074,39,18,102,26,110,"[1, 289, 631, 916, 1337, 1675, 2260, 2869, 3577, 3779, 4033, 4439, 4789, 5438, 6034]","[1, 209, 487, 910, 1318, 1698, 2186, 2921, 3662, 4433, 5035, 6046, 6485, 7256, 7775]","[1, 209, 519, 943, 1226, 1351, 1775, 2110, 2268, 2714, 3065, 3629, 4057, 4833, 5236]","[1, 384, 572, 736, 866, 1008, 1186, 1649, 1739, 1906, 2041, 2547, 2891, 3179, 3459]","[1, 170, 260, 424, 572, 678, 784, 964, 1104, 1271, 1615, 1759, 1955, 2313, 2408]",6034,7775,5236,3459,2408,2147,-2190,367,-245,666,745,15,radiant
7594930014,82,13,29,86,5,"[0, 170, 482, 855, 1053, 1658, 2288, 2908, 3190, 3725, 4266, 4880, 5581, 6442, 7120]","[0, 241, 523, 787, 914, 1204, 1425, 1683, 1991, 2702, 3272, 3811, 4349, 4980, 5513]","[0, 219, 533, 812, 1174, 1551, 1919, 2371, 2766, 3037, 3560, 4062, 4699, 5474, 6184]","[0, 170, 345, 435, 569, 694, 905, 1040, 1225, 1662, 1844, 2102, 2519, 2812, 3198]","[0, 221, 413, 551, 682, 889, 1179, 1323, 1665, 2064, 2264, 2354, 2590, 2936, 3191]",7120,5513,6184,3198,3191,95,59,129,105,26,"[0, 209, 492, 849, 1227, 1560, 1981, 2461, 2829, 3523, 4015, 4467, 4957, 5697, 6424]","[0, 278, 609, 938, 1292, 1635, 2079, 2575, 3102, 3564, 4186, 4546, 4961, 5857, 6631]","[0, 246, 518, 798, 1087, 1533, 1697, 2040, 2536, 2778, 2957, 3416, 3881, 4572, 4980]","[0, 170, 308, 444, 574, 932, 1022, 1648, 1849, 2214, 2432, 2719, 3103, 3435, 3952]","[0, 214, 356, 494, 669, 759, 909, 1184, 1385, 1577, 1851, 2019, 2199, 2530, 2715]",6424,6631,4980,3952,2715,696,-1118,1204,-754,476,504,15,dire
7595374901,11,17,40,84,93,"[1, 253, 574, 815, 1144, 1573, 1991, 2770, 3214, 3669, 3855, 4640, 5076, 5548, 6088]","[1, 406, 686, 1135, 1514, 1970, 2830, 3280, 3888, 4381, 5033, 5841, 6398, 7019, 7718]","[1, 278, 589, 923, 1164, 1654, 2025, 2426, 2957, 3624, 4217, 5222, 5407, 5811, 6209]","[1, 171, 261, 396, 533, 708, 845, 1086, 1620, 2006, 2145, 2553, 2940, 3466, 3680]","[1, 171, 261, 395, 485, 740, 830, 920, 1100, 1238, 1374, 1807, 2103, 2357, 2452]",6088,7718,6209,3680,2452,18,13,71,121,85,"[1, 320, 653, 1091, 1451, 2338, 2807, 3349, 3737, 4394, 4889, 5452, 6061, 6635, 7394]","[1, 326, 730, 1138, 1553, 2010, 2381, 2998, 3713, 4098, 5221, 5926, 6644, 7126, 7749]","[1, 206, 549, 794, 1121, 1318, 1714, 1915, 2136, 2471, 3198, 3465, 3960, 4551, 5532]","[1, 217, 307, 397, 567, 657, 792, 882, 972, 1111, 1536, 1626, 1819, 2099, 2672]","[1, 171, 261, 413, 503, 721, 858, 1116, 1248, 1389, 1524, 1974, 2283, 2464, 2698]",7394,7749,5532,2672,2698,-1306,-31,677,1008,-246,102,15,radiant
7595378008,49,76,65,112,20,"[0, 254, 527, 847, 1099, 1603, 2084, 2676, 3534, 3781, 4576, 5346, 5912, 6296, 7347]","[0, 274, 628, 958, 1207, 1579, 2048, 2435, 2831, 3360, 4087, 4542, 4925, 5708, 6959]","[0, 206, 367, 601, 803, 1243, 1725, 2186, 2655, 3174, 4008, 4296, 4728, 5278, 6513]","[0, 217, 327, 421, 511, 601, 1032, 1196, 1286, 1440, 2127, 2466, 2879, 3028, 3447]","[0, 170, 359, 494, 584, 910, 1281, 1371, 1461, 1719, 2213, 2380, 2728, 3027, 3405]",7347,6959,6513,3447,3405,138,15,137,96,100,"[0, 242, 514, 844, 1123, 1561, 1729, 2083, 2749, 2954, 3297, 3841, 4609, 5289, 5891]","[0, 170, 383, 624, 984, 1395, 1868, 1958, 2300, 2778, 2907, 3157, 3339, 3840, 4101]","[0, 255, 584, 877, 1766, 2020, 2436, 2928, 3526, 3813, 3987, 4178, 4823, 5006, 5258]","[0, 170, 280, 414, 537, 695, 833, 960, 1547, 1804, 1894, 2042, 3081, 3481, 3885]","[0, 215, 305, 395, 563, 885, 1172, 1280, 1597, 1809, 1899, 2298, 2651, 2746, 2886]",5891,4101,5258,3885,2886,1456,2858,1255,-438,519,5650,15,radiant
7595443702,70,46,104,14,5,"[0, 289, 654, 1182, 1662, 2360, 3085, 3568, 4029, 4702, 5213, 5898, 6548, 7320, 8219]","[0, 332, 571, 1060, 1617, 2180, 2961, 3517, 4328, 5085, 5766, 6584, 7111, 7995, 8343]","[0, 280, 514, 876, 1108, 1816, 2322, 2939, 3189, 3472, 3918, 4393, 4642, 5104, 5199]","[0, 130, 220, 310, 435, 670, 1014, 1391, 1481, 1635, 1770, 2138, 2228, 2413, 2508]","[0, 130, 220, 357, 585, 807, 1027, 1137, 1275, 1433, 1615, 1847, 1947, 2132, 2316]",8219,8343,5199,2508,2316,13,41,96,93,87,"[0, 421, 742, 1161, 1491, 1900, 2319, 2809, 3533, 4040, 4554, 4970, 5555, 5880, 6163]","[0, 254, 682, 1229, 1390, 1866, 2384, 3079, 3481, 4304, 4439, 4940, 5629, 6119, 6859]","[0, 317, 697, 1145, 1474, 1891, 2297, 2768, 3203, 3637, 4144, 4679, 5582, 5971, 6619]","[0, 210, 300, 455, 545, 635, 966, 1101, 1281, 1461, 1680, 1815, 2636, 2785, 2985]","[0, 210, 300, 537, 627, 795, 885, 1067, 1247, 1566, 1701, 2186, 2519, 2991, 3191]",6163,6859,6619,2985,3191,2056,1484,-1420,-477,-875,768,15,dire
7595464805,48,17,120,65,5,"[0, 359, 590, 921, 1359, 2005, 2475, 2993, 3585, 4187, 4829, 5501, 6235, 7256, 8276]","[0, 388, 996, 1259, 1736, 2070, 2407, 2844, 3115, 3938, 4426, 4792, 5218, 5848, 6586]","[0, 247, 558, 918, 1339, 1594, 2133, 2546, 3019, 3540, 4027, 4538, 4940, 5261, 6390]","[0, 538, 628, 718, 838, 1249, 1430, 1565, 1886, 2113, 2388, 2607, 3156, 3931, 4280]","[0, 270, 360, 450, 617, 970, 1129, 1301, 1436, 1581, 1868, 1958, 2223, 2419, 2768]",8276,6586,6390,4280,2768,98,10,55,53,19,"[0, 287, 532, 910, 1248, 1584, 1989, 2533, 3049, 3175, 3561, 4435, 5009, 5583, 6149]","[0, 129, 331, 610, 813, 1149, 1513, 1894, 2267, 2779, 3295, 3701, 4046, 4598, 5185]","[0, 287, 452, 665, 880, 1005, 1256, 1769, 2217, 2585, 3352, 3770, 4384, 4863, 5387]","[0, 129, 219, 358, 448, 538, 628, 911, 1121, 1294, 1418, 1686, 1994, 2265, 2563]","[0, 129, 267, 401, 491, 581, 793, 1225, 1315, 1405, 1586, 1996, 2274, 2423, 2792]",6149,5185,5387,2563,2792,2127,1401,1003,1717,-24,6224,15,radiant
7595475910,7,37,96,42,87,"[0, 206, 445, 811, 1188, 1528, 1704, 2164, 2490, 3070, 3160, 4167, 4635, 4989, 5228]","[0, 182, 272, 489, 998, 1180, 1433, 1733, 2079, 2242, 2585, 3895, 4157, 4555, 4914]","[0, 168, 500, 816, 1201, 1529, 1724, 2184, 2787, 2877, 3004, 3272, 3723, 4660, 4912]","[0, 253, 496, 816, 1192, 1493, 1901, 2465, 2709, 2896, 3118, 3630, 4120, 4495, 4888]","[0, 130, 264, 829, 966, 1102, 1211, 1438, 1596, 2037, 2127, 2784, 3011, 3598, 3769]",5228,4914,4912,4888,3769,93,102,129,26,91,"[0, 249, 558, 909, 1375, 1624, 2186, 2718, 3033, 3744, 4292, 4905, 5483, 6120, 6639]","[0, 267, 498, 782, 1185, 1562, 2309, 2699, 3417, 4271, 4954, 5185, 5826, 6269, 6930]","[0, 343, 712, 1117, 1454, 1778, 2561, 2766, 3448, 3796, 4254, 4555, 4954, 5507, 5958]","[0, 586, 731, 872, 1217, 1355, 1569, 1835, 2195, 2521, 2967, 3057, 3201, 3344, 3493]","[0, 267, 357, 738, 916, 1043, 1385, 1565, 1837, 2148, 2376, 2466, 2646, 2786, 3376]",6639,6930,5958,3493,3376,-1411,-2016,-1046,1395,393,-2685,15,dire
7595488105,48,49,19,86,3,"[269, 478, 775, 1053, 1288, 1394, 1653, 2307, 2509, 2907, 3600, 4024, 4575, 5271, 5814]","[136, 384, 745, 1066, 1642, 1976, 2372, 2628, 3387, 3837, 4164, 4927, 5563, 5980, 6336]","[269, 550, 869, 1167, 1591, 1816, 2334, 3158, 3539, 3894, 4465, 5210, 5672, 5858, 6043]","[72, 333, 466, 604, 812, 949, 1039, 1375, 1631, 1831, 2167, 2549, 2718, 3039, 3195]","[136, 345, 435, 525, 655, 784, 968, 1273, 1694, 1784, 1874, 2227, 2413, 2508, 2731]",5814,6336,6043,3195,2731,113,6,21,58,20,"[60, 340, 584, 999, 1283, 1573, 1990, 2337, 2523, 2872, 3479, 4547, 5138, 5711, 6395]","[60, 225, 466, 869, 1173, 1556, 1840, 2206, 2432, 2801, 3448, 3766, 4446, 5116, 5702]","[60, 262, 460, 709, 799, 1433, 1738, 2137, 2792, 3307, 3808, 4170, 4709, 4992, 5365]","[328, 457, 547, 685, 1038, 1180, 1514, 1667, 1757, 2130, 2403, 2677, 3023, 3653, 4164]","[60, 189, 279, 416, 506, 1174, 1363, 1453, 1664, 1843, 2116, 2427, 3105, 3363, 3708]",6395,5702,5365,4164,3708,-581,634,678,-969,-977,-1215,15,dire
7595537105,65,67,43,74,84,"[0, 330, 701, 1614, 2352, 2858, 3359, 4211, 5140, 5777, 6621, 7381, 7732, 8621, 9048]","[0, 247, 574, 901, 1322, 1815, 2259, 2827, 3154, 3532, 4184, 4811, 5483, 6396, 6765]","[0, 323, 615, 740, 1075, 1239, 1480, 1658, 1900, 2175, 2464, 2902, 3290, 3648, 3809]","[0, 169, 259, 349, 518, 648, 738, 1006, 1230, 1425, 1714, 2505, 2620, 3071, 3738]","[0, 169, 287, 377, 556, 859, 993, 1429, 1601, 1736, 1871, 2224, 2471, 2730, 2870]",9048,6765,3809,3738,2870,33,25,10,105,103,"[0, 324, 571, 1227, 1699, 2040, 2472, 2929, 3626, 4071, 4636, 5476, 6033, 6291, 6438]","[0, 363, 780, 1076, 1248, 1372, 1856, 2327, 2456, 2633, 3245, 3733, 4245, 4794, 5346]","[0, 243, 650, 1101, 1481, 1906, 2509, 3010, 3335, 3786, 4128, 4474, 4727, 5238, 5675]","[0, 169, 259, 462, 690, 780, 899, 1079, 1169, 1432, 1777, 2090, 2180, 2374, 2577]","[0, 169, 259, 674, 866, 1000, 1139, 1323, 1497, 1631, 1811, 2091, 2227, 2452, 2693]",6438,5346,5675,2577,2693,2610,1419,-1866,1161,177,3501,15,radiant
7595612013,39,93,137,90,86,"[0, 246, 570, 893, 1380, 1798, 2238, 2709, 3150, 3596, 4341, 4849, 5118, 5472, 6027]","[0, 206, 765, 1128, 1294, 1678, 2013, 2561, 3091, 3711, 4077, 4666, 5093, 5764, 6314]","[0, 169, 450, 696, 947, 1457, 1780, 2308, 2583, 3081, 3613, 4462, 4790, 4939, 5375]","[0, 269, 398, 590, 768, 891, 1071, 1251, 1380, 1567, 1850, 2194, 2509, 2869, 3341]","[100, 316, 485, 623, 713, 921, 1093, 1435, 1584, 1674, 1809, 2056, 2349, 2543, 2763]",6027,6314,5375,3341,2763,89,120,49,26,5,"[0, 238, 451, 770, 1071, 1354, 1708, 2228, 2550, 2871, 3207, 3794, 4387, 5215, 5889]","[64, 302, 591, 986, 1226, 1652, 2184, 2519, 2698, 3638, 3954, 4374, 4876, 5539, 5785]","[332, 552, 744, 950, 1316, 1588, 1882, 2053, 2420, 2806, 3345, 3995, 4480, 5150, 5435]","[64, 271, 405, 533, 672, 802, 996, 1121, 1233, 1576, 1666, 2161, 2382, 2531, 2673]","[64, 233, 342, 476, 647, 890, 1025, 1115, 1205, 1641, 1904, 2234, 2746, 2895, 3142]",5889,5785,5435,2673,3142,138,529,-60,668,-379,896,15,radiant
7595761202,18,39,29,86,20,"[0, 248, 536, 846, 1425, 1823, 2229, 2875, 3408, 3964, 4669, 5265, 5706, 6387, 6878]","[0, 365, 729, 1058, 1581, 1893, 2331, 2924, 3160, 3707, 4318, 4699, 5213, 5995, 6267]","[0, 329, 561, 838, 1077, 1314, 1603, 1899, 2295, 2846, 3383, 4004, 4599, 5511, 6076]","[0, 170, 260, 722, 825, 915, 1280, 1457, 1747, 2072, 2435, 2667, 2904, 3479, 3621]","[100, 270, 360, 450, 624, 714, 804, 1003, 1311, 1416, 1683, 1773, 2006, 2376, 2501]",6878,6267,6076,3621,2501,70,96,120,33,114,"[0, 170, 435, 943, 1397, 1861, 2588, 2931, 3562, 4072, 4930, 5659, 6247, 7025, 7653]","[0, 204, 610, 996, 1404, 1932, 2532, 3119, 3930, 4193, 4908, 5731, 6480, 6665, 7257]","[0, 207, 534, 1011, 1383, 1825, 2222, 2730, 3217, 3731, 4180, 4747, 5315, 5464, 6092]","[0, 170, 290, 707, 897, 1159, 1289, 1606, 1873, 2088, 2700, 3159, 3803, 4315, 4881]","[0, 170, 290, 440, 658, 906, 1293, 1558, 2163, 2253, 2590, 2874, 3024, 3305, 3490]",7653,7257,6092,4881,3490,-775,-990,-16,-1260,-989,-4030,15,dire
7596251310,49,93,29,112,121,"[0, 170, 618, 966, 1427, 1918, 2350, 2474, 2928, 3586, 4090, 4515, 5070, 5716, 6696]","[0, 245, 373, 1099, 1564, 1805, 2347, 2734, 3619, 3886, 4545, 5094, 5975, 6285, 6608]","[0, 244, 551, 824, 986, 1274, 1364, 1750, 2006, 2262, 3189, 3484, 3664, 4084, 5262]","[0, 170, 260, 464, 554, 719, 809, 899, 1034, 1124, 1547, 1717, 2005, 2147, 2474]","[0, 271, 361, 861, 1074, 1286, 1470, 1560, 2143, 2352, 2724, 2866, 3154, 3248, 3853]",6696,6608,5262,2474,3853,21,106,136,20,91,"[0, 208, 447, 887, 1293, 1951, 2467, 2903, 3003, 3655, 3948, 4282, 4989, 5397, 5956]","[0, 323, 596, 955, 1237, 1525, 1650, 2270, 2606, 3323, 3658, 4024, 4666, 5228, 5793]","[0, 204, 542, 794, 1124, 1456, 1955, 2337, 2581, 3056, 3199, 3783, 4488, 5099, 5287]","[0, 170, 260, 350, 488, 882, 1051, 1459, 1549, 1855, 2028, 2275, 2499, 2741, 2836]","[0, 170, 600, 690, 827, 957, 1164, 1391, 1481, 1726, 1952, 2168, 3056, 3296, 3391]",5956,5793,5287,2836,3391,740,815,-25,-362,462,1630,15,radiant
7596368016,89,22,69,123,9,"[0, 245, 488, 901, 1191, 1722, 2438, 3174, 3786, 4461, 5017, 6003, 6451, 7161, 8499]","[0, 325, 637, 1055, 1572, 1992, 2370, 2927, 3550, 4225, 4856, 5283, 6424, 7118, 7782]","[0, 292, 560, 926, 1562, 1903, 2264, 2908, 3331, 3970, 4514, 4954, 5636, 6196, 6706]","[0, 170, 304, 494, 655, 785, 972, 1264, 1548, 1737, 1888, 2285, 2647, 2949, 3348]","[0, 218, 358, 522, 695, 889, 1082, 1286, 1564, 1819, 2183, 2391, 3026, 3324, 3747]",8499,7782,6706,3348,3747,94,73,129,26,5,"[0, 253, 603, 958, 1360, 1799, 2219, 2641, 3145, 3697, 4429, 5160, 5744, 6016, 6669]","[0, 426, 766, 1127, 1482, 1813, 1990, 2498, 3001, 3621, 4411, 4904, 5428, 6106, 6457]","[0, 278, 587, 880, 1281, 1735, 2280, 2815, 3320, 3718, 4358, 4625, 4937, 5501, 5829]","[0, 172, 274, 364, 552, 874, 999, 1284, 1420, 1603, 1991, 2168, 2540, 2635, 2800]","[0, 170, 285, 420, 550, 687, 853, 1113, 1276, 1412, 1811, 1938, 2117, 2212, 2420]",6669,6457,5829,2800,2420,1830,1325,877,548,1327,5907,15,radiant
7596687303,18,120,135,20,121,"[0, 316, 624, 871, 1285, 1637, 1952, 2505, 2990, 3793, 4480, 5074, 5752, 6444, 7125]","[0, 248, 531, 898, 1237, 1527, 2161, 2671, 3079, 3378, 3791, 4366, 4852, 5338, 5769]","[0, 283, 565, 733, 859, 1103, 1314, 1449, 1751, 2168, 2396, 2726, 2868, 3300, 3596]","[0, 210, 346, 528, 666, 802, 908, 1074, 1216, 1441, 1670, 2201, 2489, 2667, 3380]","[0, 210, 347, 437, 624, 1170, 1307, 1442, 1617, 2028, 2465, 2748, 2838, 2994, 3280]",7125,5769,3596,3380,3280,114,28,106,5,26,"[0, 182, 490, 1006, 1306, 1631, 2211, 2498, 2896, 3172, 3621, 3785, 4254, 4767, 5311]","[0, 130, 377, 576, 1222, 1348, 1792, 2016, 2593, 3042, 3658, 4137, 4587, 5472, 6009]","[0, 279, 651, 964, 1373, 2061, 2393, 2845, 3589, 4210, 4771, 5657, 5977, 6618, 6881]","[0, 233, 366, 902, 1126, 1445, 1662, 2105, 2371, 2461, 2641, 2767, 3262, 3567, 3754]","[0, 130, 220, 310, 560, 698, 834, 1156, 1422, 1644, 1824, 2030, 2120, 2394, 2594]",5311,6009,6881,3754,2594,1814,-240,-3285,-374,686,-1399,15,radiant
7596756308,10,120,28,65,20,"[63, 345, 585, 867, 1193, 1966, 2472, 2915, 3562, 4103, 4472, 5111, 5362, 5604, 6209]","[63, 295, 649, 1025, 1403, 1834, 2197, 2330, 2688, 3187, 3582, 3967, 4089, 4679, 5186]","[331, 641, 1042, 1292, 1798, 2098, 2552, 3001, 3476, 3894, 4345, 5404, 5939, 6622, 6845]","[63, 428, 518, 608, 743, 873, 980, 1173, 1694, 1892, 2291, 2745, 2984, 3393, 3577]","[63, 442, 637, 727, 898, 1154, 1255, 1470, 1737, 1924, 2059, 2198, 2385, 2570, 2823]",6209,5186,6845,3577,2823,69,93,126,79,9,"[0, 374, 606, 891, 1170, 1300, 1675, 2210, 2746, 3111, 3862, 4330, 4500, 5623, 6335]","[0, 170, 537, 771, 1137, 1496, 1978, 2385, 2763, 3100, 3756, 4123, 4635, 5287, 5984]","[0, 328, 700, 1117, 1534, 1863, 2347, 3030, 3564, 3736, 4197, 4557, 5285, 5698, 6562]","[0, 321, 411, 621, 759, 849, 1140, 1360, 1495, 1585, 2093, 2217, 2506, 2969, 3259]","[0, 440, 530, 694, 863, 953, 1192, 1412, 1595, 1721, 2213, 2303, 2508, 2798, 3061]",6335,5984,6562,3259,3061,-126,-798,283,318,-238,-561,15,dire
7597199202,74,80,93,121,26,"[0, 316, 598, 886, 1260, 1678, 1924, 2508, 2990, 3214, 3500, 3973, 4595, 5544, 5872]","[0, 297, 647, 1075, 1348, 2088, 2451, 2915, 3152, 3242, 3410, 3706, 4321, 5033, 5390]","[0, 285, 555, 948, 1256, 1593, 1946, 2364, 2782, 3448, 4041, 4963, 5883, 6799, 7353]","[0, 254, 387, 593, 764, 926, 1254, 1434, 1741, 1926, 2162, 2342, 2874, 3404, 3617]","[100, 309, 442, 612, 798, 1008, 1423, 1513, 1603, 1817, 2224, 2404, 2853, 3462, 3556]",5872,5390,7353,3617,3556,13,107,20,48,112,"[0, 590, 843, 1223, 1431, 1723, 2110, 2479, 3040, 3637, 4261, 5015, 5469, 5654, 6138]","[0, 199, 575, 849, 1312, 1605, 1902, 2237, 2603, 3594, 4283, 5222, 5548, 5746, 6013]","[0, 323, 642, 967, 1206, 1661, 1949, 2490, 2738, 2908, 3258, 3472, 4045, 4397, 4491]","[0, 199, 289, 637, 811, 901, 1036, 1662, 1786, 2022, 2393, 3429, 3671, 3820, 3914]","[0, 199, 289, 409, 602, 737, 872, 1008, 1255, 1796, 2044, 2644, 2837, 2986, 3080]",6138,6013,4491,3914,3080,-266,-623,2862,-297,476,2152,15,radiant
7597227611,15,93,28,5,87,"[0, 324, 639, 1030, 1431, 1903, 2499, 2971, 3554, 3911, 4585, 5750, 6347, 6911, 7767]","[0, 243, 451, 831, 1170, 1490, 1971, 2587, 3039, 3473, 3870, 4506, 5057, 6153, 6916]","[0, 274, 641, 970, 1348, 2048, 2231, 2864, 2954, 3451, 3850, 4030, 4514, 5223, 5626]","[0, 217, 307, 397, 532, 776, 889, 1085, 1224, 1335, 1610, 1811, 2062, 2433, 2573]","[0, 170, 260, 396, 535, 671, 761, 1038, 1166, 1339, 1600, 1780, 1957, 2426, 2740]",7767,6916,5626,2573,2740,71,105,44,100,26,"[0, 207, 745, 1063, 1356, 1972, 2253, 2843, 3260, 3682, 4121, 4417, 4966, 5459, 5607]","[0, 328, 696, 1103, 1432, 1839, 2268, 2861, 3499, 4029, 4555, 4645, 5212, 5894, 6391]","[0, 208, 501, 785, 1147, 1341, 1784, 2045, 2438, 2839, 3353, 3928, 4270, 4699, 5193]","[0, 170, 260, 385, 742, 832, 1187, 1413, 1710, 1862, 2371, 2775, 2909, 3137, 3285]","[0, 217, 380, 520, 722, 941, 1035, 1262, 1352, 1486, 1621, 1851, 1941, 2084, 2232]",5607,6391,5193,3285,2232,2160,525,433,-712,508,2914,15,radiant
7597255404,73,98,120,123,58,"[0, 289, 562, 1124, 1514, 1872, 2135, 2380, 2700, 3127, 3880, 4236, 4909, 5844, 7186]","[0, 258, 610, 1255, 1489, 1779, 2087, 2349, 2725, 3127, 3805, 4743, 4995, 5727, 6250]","[0, 281, 547, 869, 1274, 1890, 2477, 3276, 3657, 4330, 4950, 5749, 6178, 6714, 6983]","[0, 170, 260, 496, 630, 767, 1054, 1277, 1412, 1644, 1973, 2187, 2326, 3097, 3303]","[0, 170, 260, 396, 726, 816, 991, 1113, 1265, 1709, 1934, 2259, 2385, 2723, 2842]",7186,6250,6983,3303,2842,11,90,96,27,20,"[0, 170, 551, 838, 1251, 1490, 2123, 2911, 3446, 3941, 4468, 5240, 5798, 6477, 7270]","[0, 335, 757, 1005, 1260, 1608, 1991, 2778, 3286, 3832, 4568, 5239, 5892, 6517, 7157]","[0, 207, 517, 810, 1280, 1684, 2063, 2884, 3276, 3773, 4405, 4899, 5455, 5908, 6275]","[0, 213, 364, 499, 726, 950, 1087, 1432, 1658, 1748, 1928, 2588, 2760, 2956, 3177]","[0, 170, 285, 390, 480, 659, 830, 1153, 1591, 1907, 2120, 2644, 2857, 3026, 3217]",7270,7157,6275,3177,3217,-84,-907,708,126,-375,-532,15,dire
7597320600,10,73,19,65,105,"[0, 290, 530, 851, 1397, 1804, 2175, 2617, 3117, 3451, 4110, 4632, 5089, 5360, 6075]","[0, 287, 505, 814, 1024, 1272, 1362, 1893, 2214, 2614, 2988, 3930, 4115, 4543, 5420]","[0, 278, 538, 815, 1153, 1520, 1979, 2269, 2906, 3592, 4038, 4291, 4649, 5102, 5795]","[0, 170, 260, 350, 489, 635, 846, 1026, 1304, 1495, 1721, 2248, 2679, 3120, 3389]","[0, 221, 382, 560, 897, 1073, 1163, 1343, 1621, 2100, 2392, 2766, 2987, 3150, 3443]",6075,5420,5795,3389,3443,14,113,71,53,26,"[0, 170, 968, 1323, 1578, 1887, 2675, 3085, 3220, 3710, 3940, 4812, 5063, 5811, 6768]","[0, 256, 491, 699, 1079, 1540, 1863, 2317, 2671, 3053, 3568, 4265, 5426, 6097, 6875]","[0, 252, 495, 877, 1089, 1417, 1866, 2256, 2707, 3144, 3800, 4153, 4406, 4794, 5293]","[0, 170, 312, 451, 541, 631, 840, 992, 1127, 1445, 1761, 1982, 2367, 3228, 3673]","[0, 214, 578, 712, 900, 1270, 1551, 1852, 2110, 2499, 2634, 2953, 3486, 3780, 4342]",6768,6875,5293,3673,4342,-693,-1455,502,-284,-899,-2829,15,radiant
7597334717,17,16,10,14,5,"[0, 376, 849, 1240, 1744, 2291, 2874, 3394, 3959, 4469, 5081, 5518, 5764, 6230, 7143]","[0, 245, 537, 1005, 1400, 1924, 2612, 3113, 3502, 4012, 4327, 5210, 5560, 6126, 6562]","[0, 290, 576, 834, 1172, 1503, 1877, 2347, 2711, 3387, 4089, 4319, 4893, 5331, 6061]","[0, 169, 302, 673, 809, 948, 1374, 1615, 1791, 2303, 2983, 3197, 3530, 3970, 4396]","[0, 203, 327, 462, 598, 747, 882, 1062, 1169, 1353, 1639, 1784, 1874, 1969, 2349]",7143,6562,6061,4396,2349,25,48,49,84,86,"[0, 313, 648, 1062, 1442, 1938, 2723, 3439, 4160, 4799, 5552, 6531, 7059, 7549, 8239]","[0, 266, 670, 1515, 1900, 2280, 2955, 3577, 3999, 4225, 4843, 5488, 6071, 6700, 7661]","[0, 266, 677, 1003, 1409, 1655, 2323, 3023, 3493, 3733, 4036, 4674, 5421, 5966, 6599]","[0, 194, 284, 579, 791, 940, 1230, 1736, 1941, 2112, 2437, 3024, 3195, 3494, 3912]","[0, 194, 284, 465, 644, 781, 1129, 1353, 1491, 1703, 2195, 2704, 2823, 3180, 3485]",8239,7661,6599,3912,3485,-1096,-1099,-538,484,-1136,-3385,15,dire
7597391314,109,128,7,123,102,"[0, 204, 541, 1008, 1394, 1813, 2215, 2526, 3036, 3533, 3857, 4473, 4849, 5181, 5800]","[0, 280, 622, 1034, 1637, 2061, 2617, 3116, 3559, 3774, 4086, 4810, 5066, 5406, 6363]","[0, 362, 818, 1258, 1692, 2196, 2748, 3193, 3727, 4070, 4507, 4597, 5300, 5607, 6726]","[0, 170, 260, 398, 567, 706, 943, 1078, 1217, 1307, 1483, 2150, 2505, 2728, 3235]","[0, 170, 260, 399, 592, 780, 920, 1123, 1538, 1743, 1985, 2112, 2483, 2790, 3454]",5800,6363,6726,3235,3454,106,77,8,86,84,"[0, 366, 745, 1185, 1585, 2205, 2768, 3156, 3614, 4275, 4794, 5428, 6044, 6404, 7084]","[0, 246, 558, 1097, 1551, 1864, 2293, 2729, 3027, 3252, 3867, 4480, 4660, 5616, 5911]","[0, 241, 694, 1131, 1492, 1818, 2135, 2481, 2970, 3853, 4383, 5123, 5324, 5900, 6088]","[0, 213, 303, 468, 662, 865, 1054, 1162, 1416, 1724, 1949, 2383, 2563, 2711, 3152]","[0, 170, 260, 380, 515, 605, 855, 945, 1197, 1591, 1816, 2094, 2481, 2748, 2897]",7084,5911,6088,3152,2897,-1284,452,638,83,557,446,15,dire
7597463909,95,23,13,123,87,"[0, 304, 809, 1133, 1565, 1674, 2461, 2789, 3228, 3511, 3803, 4344, 5191, 5611, 5915]","[0, 198, 657, 1019, 1109, 1731, 2101, 2229, 2616, 2774, 2998, 3481, 3805, 4577, 4892]","[0, 207, 372, 659, 869, 1113, 1430, 1637, 1761, 2135, 2300, 2724, 3095, 3228, 3571]","[0, 130, 369, 508, 598, 972, 1062, 1152, 1534, 1624, 1964, 2603, 3053, 3481, 3754]","[0, 356, 528, 618, 805, 895, 1114, 1204, 1343, 1638, 1773, 2302, 2530, 2790, 3549]",5915,4892,3571,3754,3549,106,70,36,100,105,"[0, 367, 781, 1072, 1680, 2094, 2781, 3531, 4177, 4812, 5439, 6331, 6873, 7629, 7995]","[0, 370, 614, 1018, 1548, 2049, 2571, 3096, 3691, 4211, 4965, 5644, 6336, 6690, 7529]","[0, 304, 430, 641, 1052, 1712, 1944, 2449, 2789, 3557, 4377, 4850, 5135, 5741, 6965]","[0, 300, 427, 835, 925, 1099, 1451, 1760, 1985, 2243, 2416, 3009, 3319, 3932, 4867]","[0, 533, 858, 948, 1117, 1293, 1476, 1780, 2089, 2347, 2584, 3190, 3394, 3905, 4307]",7995,7529,6965,4867,4307,-2080,-2637,-3394,-1113,-758,-9982,15,dire
7597714703,72,69,81,112,136,"[0, 404, 703, 1199, 1524, 1893, 2508, 3004, 3597, 4430, 5227, 5918, 6621, 7259, 8117]","[0, 273, 721, 1067, 1522, 1947, 2765, 3203, 3781, 4406, 4668, 5060, 5490, 6105, 6565]","[0, 236, 445, 831, 1162, 1678, 1964, 2254, 2416, 3236, 3510, 3971, 4541, 4814, 5412]","[0, 198, 335, 474, 655, 792, 1211, 1301, 1481, 1661, 2002, 2823, 2967, 3116, 3298]","[0, 198, 288, 494, 584, 722, 812, 993, 1479, 1688, 1917, 2148, 2339, 2543, 2690]",8117,6565,5412,3298,2690,106,42,123,93,33,"[0, 349, 551, 954, 1322, 1913, 2239, 2561, 2992, 3623, 4038, 4699, 5185, 5752, 6701]","[0, 226, 610, 868, 1257, 1703, 1901, 2259, 2537, 2905, 3146, 3694, 3983, 4720, 5119]","[0, 192, 332, 422, 720, 854, 1167, 1305, 1654, 1947, 2415, 2588, 2939, 3503, 3955]","[0, 354, 527, 940, 1183, 1406, 1746, 2139, 2506, 2919, 3447, 3796, 4414, 4899, 5748]","[0, 460, 550, 687, 893, 1322, 1602, 1796, 2235, 2603, 2990, 3264, 3533, 3807, 4458]",6701,5119,3955,5748,4458,1416,1446,1457,-2450,-1768,101,15,radiant
7598034204,21,41,43,65,100,"[0, 244, 707, 1113, 1480, 2135, 2551, 2876, 3486, 4112, 4783, 5646, 6315, 6958, 7436]","[0, 266, 511, 791, 1123, 1440, 1765, 1972, 2230, 2635, 3330, 3940, 5241, 5875, 6559]","[0, 354, 1002, 1416, 1827, 1962, 2451, 3396, 3800, 4217, 4725, 5269, 5531, 6129, 6535]","[0, 194, 284, 422, 571, 675, 825, 1336, 1774, 2379, 3049, 3484, 4028, 4494, 4758]","[0, 194, 483, 827, 994, 1180, 1270, 1494, 1674, 2030, 2288, 2542, 2878, 3106, 3248]",7436,6559,6535,4758,3248,46,4,129,20,119,"[0, 277, 585, 938, 1260, 1537, 1925, 2338, 2836, 3349, 4025, 4539, 4853, 5497, 6091]","[0, 206, 431, 675, 985, 1115, 1439, 1879, 2082, 2469, 2723, 3013, 3237, 3552, 3905]","[0, 217, 559, 870, 1115, 1564, 1888, 2228, 2649, 3172, 3301, 3626, 3716, 4398, 4619]","[0, 208, 323, 413, 523, 755, 890, 1224, 1365, 1455, 1644, 1882, 2106, 2201, 2448]","[0, 169, 284, 374, 485, 882, 972, 1149, 1304, 1421, 1650, 1902, 2402, 2497, 2640]",6091,3905,4619,2448,2640,1345,2654,1916,2310,608,8833,15,radiant
7598302418,21,19,53,96,100,"[0, 213, 574, 911, 1111, 1495, 2012, 2588, 3340, 4047, 4866, 5892, 6214, 6693, 7547]","[0, 242, 526, 935, 1347, 1606, 2105, 2829, 3596, 4022, 4366, 5005, 5312, 5638, 6497]","[0, 169, 476, 566, 656, 873, 1370, 1586, 1948, 2303, 2621, 3363, 3669, 3818, 4327]","[0, 169, 422, 666, 921, 1169, 1760, 2171, 2710, 2881, 3387, 3712, 4048, 4595, 4969]","[0, 169, 259, 394, 484, 623, 1035, 1359, 1494, 1711, 2186, 2516, 2606, 3026, 3475]",7547,6497,4327,4969,3475,25,10,123,129,20,"[0, 626, 918, 1291, 1633, 2033, 2645, 3081, 3616, 4050, 4653, 5089, 5635, 6126, 6859]","[0, 270, 579, 989, 1319, 1728, 2105, 2601, 3135, 3694, 4244, 4910, 5583, 6052, 6813]","[0, 234, 324, 682, 861, 1015, 1105, 1822, 2034, 2124, 2401, 2491, 2721, 2906, 3046]","[0, 254, 571, 900, 1244, 1564, 2044, 2378, 2699, 2965, 3100, 3383, 3681, 3944, 4341]","[0, 234, 324, 421, 556, 780, 882, 1315, 1479, 1746, 1881, 1971, 2587, 2772, 3046]",6859,6813,3046,4341,3046,688,-316,1281,628,429,2710,15,radiant
7598302507,70,49,96,123,20,"[0, 241, 490, 894, 1157, 1611, 2175, 2301, 2504, 2893, 3255, 3866, 4316, 4912, 5399]","[0, 287, 480, 570, 695, 914, 1206, 1378, 1782, 2100, 2529, 2752, 3238, 3961, 4213]","[0, 243, 525, 813, 976, 1224, 1431, 1819, 2165, 2703, 3291, 3593, 4183, 5065, 5799]","[0, 170, 260, 401, 491, 702, 837, 1046, 1265, 1369, 1504, 1754, 2342, 2680, 2884]","[0, 219, 309, 483, 573, 737, 872, 996, 1086, 1356, 1566, 1921, 2194, 2528, 2719]",5399,4213,5799,2884,2719,18,59,69,105,26,"[292, 534, 841, 1191, 1527, 1799, 2435, 2894, 3337, 4001, 4767, 5319, 5880, 6827, 7592]","[159, 451, 852, 1304, 1687, 2141, 2785, 3265, 3738, 4274, 5009, 5403, 6155, 6746, 7647]","[159, 415, 994, 1196, 1569, 2010, 2303, 3050, 3661, 4165, 4785, 5185, 5864, 6473, 6912]","[527, 697, 832, 968, 1103, 1228, 1432, 1719, 1855, 2063, 2316, 2565, 2912, 3638, 3782]","[292, 462, 659, 834, 972, 1157, 1301, 1625, 1849, 2197, 2496, 2653, 2872, 3411, 3673]",7592,7647,6912,3782,3673,-2193,-3434,-1113,-898,-954,-8592,15,dire
7598355413,70,23,69,123,79,"[1, 282, 637, 952, 1361, 1773, 2370, 2809, 3108, 3415, 3646, 4229, 4749, 5859, 6330]","[1, 402, 695, 1185, 1681, 2013, 2182, 2477, 3097, 3749, 4267, 5226, 5837, 6544, 7076]","[1, 247, 405, 855, 1075, 1311, 1912, 2272, 2692, 2859, 3134, 3264, 3720, 4131, 4810]","[1, 171, 291, 500, 659, 789, 1134, 1270, 1360, 1633, 1984, 2123, 2361, 2802, 2897]","[1, 171, 291, 461, 597, 1042, 1262, 1665, 1769, 1859, 2402, 2492, 2708, 3265, 3499]",6330,7076,4810,2897,3499,21,97,40,96,85,"[1, 327, 657, 1031, 1629, 2141, 2404, 2880, 3372, 3791, 4491, 5034, 5633, 6180, 6702]","[1, 210, 571, 1102, 1521, 2038, 2412, 2917, 3540, 3903, 4185, 4466, 4916, 5156, 5420]","[1, 244, 574, 751, 999, 1410, 1839, 2027, 2411, 3004, 3336, 3879, 4085, 4179, 4519]","[1, 171, 261, 387, 524, 722, 961, 1051, 1305, 1495, 2180, 2669, 2924, 3194, 3632]","[1, 510, 600, 735, 1003, 1217, 1402, 1538, 1797, 1887, 2245, 2810, 2949, 3043, 3292]",6702,5420,4519,3632,3292,-372,1656,291,-735,207,1047,15,radiant
7598393405,135,10,13,123,65,"[0, 333, 657, 1073, 1404, 1764, 2288, 2986, 3462, 3875, 4382, 4922, 5816, 6215, 7155]","[0, 363, 600, 803, 1087, 1345, 1715, 2202, 2653, 3017, 3566, 4142, 4959, 5216, 5678]","[0, 319, 609, 900, 1224, 1472, 1913, 2264, 2696, 3038, 3205, 3780, 4257, 4402, 4748]","[0, 734, 824, 1012, 1344, 1523, 1613, 1783, 1994, 2131, 2810, 3056, 3827, 4189, 4341]","[0, 371, 461, 587, 721, 822, 939, 1113, 1222, 1312, 1636, 1780, 1960, 2214, 2600]",7155,5678,4748,4341,2600,44,19,97,66,105,"[0, 316, 406, 766, 1010, 1385, 1669, 2147, 2524, 2938, 3576, 4168, 4491, 5136, 5930]","[0, 576, 786, 1160, 1624, 2007, 2417, 2825, 3797, 4276, 5159, 5501, 5897, 6903, 7151]","[0, 355, 515, 866, 1253, 1590, 2167, 2437, 2993, 3582, 4169, 4536, 5314, 6185, 6690]","[0, 413, 623, 801, 971, 1149, 1269, 1497, 1802, 2054, 2400, 2772, 3035, 3537, 3851]","[0, 199, 289, 425, 552, 682, 869, 959, 1147, 1469, 1771, 1861, 2531, 3019, 3449]",5930,7151,6690,3851,3449,1225,-1473,-1942,490,-849,-2549,15,dire
7598478916,46,98,25,20,19,"[0, 280, 525, 868, 1061, 1435, 1790, 2097, 2466, 2681, 3077, 3852, 4377, 5166, 5787]","[0, 229, 509, 751, 1234, 1475, 1956, 2294, 2996, 3534, 3884, 4560, 5249, 5855, 6489]","[0, 276, 564, 805, 1242, 1370, 1868, 2111, 2585, 3027, 3665, 4028, 4678, 5229, 6173]","[0, 195, 686, 810, 900, 1260, 1350, 1440, 1783, 1987, 2309, 2501, 2681, 2922, 3092]","[0, 195, 285, 375, 530, 620, 830, 920, 1167, 1652, 1789, 2081, 2261, 2472, 2836]",5787,6489,6173,3092,2836,49,76,129,79,9,"[0, 244, 504, 872, 1217, 1638, 1919, 2510, 2671, 3111, 3694, 4050, 4868, 5381, 5816]","[0, 243, 540, 855, 1180, 1718, 2113, 2671, 3117, 3482, 4045, 4428, 4833, 5486, 5948]","[0, 294, 560, 1152, 1651, 1980, 2398, 2909, 3420, 3841, 4503, 4956, 5546, 5888, 6416]","[0, 170, 592, 765, 990, 1311, 1535, 1919, 2279, 2369, 2689, 2796, 3465, 4111, 4337]","[0, 170, 285, 419, 529, 718, 853, 1139, 1330, 1533, 1815, 2011, 2381, 2873, 3238]",5816,5948,6416,4337,3238,-29,541,-243,-1245,-402,-1378,15,dire
7598603510,94,129,97,66,121,"[0, 273, 610, 897, 1276, 1685, 2058, 2666, 3124, 3709, 4309, 5049, 6127, 7104, 7991]","[0, 169, 452, 891, 1053, 1423, 1898, 2258, 2795, 3706, 4174, 4968, 6048, 6483, 7304]","[0, 244, 534, 833, 1047, 1549, 2226, 2661, 2879, 3456, 3911, 4202, 5475, 5684, 6084]","[0, 169, 278, 424, 563, 773, 1041, 1329, 1521, 2002, 2350, 2691, 3195, 3522, 3990]","[0, 240, 330, 513, 764, 1006, 1160, 1405, 1559, 2107, 2427, 3023, 3566, 3799, 4056]",7991,7304,6084,3990,4056,8,98,43,7,20,"[0, 543, 791, 1104, 1747, 1982, 2441, 2903, 3147, 3394, 3615, 4242, 4814, 5427, 5991]","[0, 169, 430, 646, 1088, 1297, 1564, 1953, 2315, 2792, 3044, 3787, 4418, 4888, 4983]","[0, 277, 593, 810, 1215, 1475, 2019, 2307, 2681, 3008, 3482, 3758, 3848, 4371, 4711]","[100, 337, 446, 536, 701, 791, 926, 1102, 1367, 1457, 1547, 1691, 1915, 2150, 2245]","[0, 237, 375, 515, 749, 842, 1026, 1120, 1255, 1353, 1443, 1587, 1687, 1836, 2254]",5991,4983,4711,2245,2254,2000,2321,1373,1745,1802,9241,15,radiant
7598915010,18,106,135,9,26,"[0, 207, 480, 771, 1149, 1407, 1925, 2251, 2530, 2759, 3216, 3486, 4041, 4544, 5243]","[0, 326, 574, 895, 1167, 1530, 1970, 2182, 2674, 3050, 3366, 3779, 4161, 4724, 5555]","[0, 323, 489, 836, 1296, 1622, 2039, 2604, 3132, 3591, 4069, 4476, 4801, 5210, 5789]","[0, 169, 259, 575, 838, 1194, 1453, 1608, 1791, 2164, 2569, 2934, 3103, 3519, 3868]","[0, 169, 259, 349, 514, 652, 916, 1104, 1453, 1772, 1944, 2168, 2258, 2620, 2979]",5243,5555,5789,3868,2979,48,129,97,105,112,"[0, 208, 525, 787, 1132, 1589, 2058, 2319, 2586, 2987, 3532, 4197, 4759, 5301, 6094]","[0, 244, 524, 856, 1174, 1736, 2233, 2694, 2888, 3238, 3694, 3983, 4989, 5501, 5983]","[0, 280, 576, 859, 1344, 1711, 2286, 2950, 3407, 3893, 4394, 4816, 5513, 6105, 6650]","[0, 218, 308, 755, 845, 1076, 1373, 1508, 2000, 2197, 2332, 2422, 3018, 3325, 3467]","[0, 169, 307, 397, 740, 904, 1128, 1263, 1779, 1950, 2230, 2468, 3008, 3302, 3397]",6094,5983,6650,3467,3397,-851,-428,-861,401,-418,-2157,15,dire
7598987603,10,52,16,86,100,"[0, 206, 439, 792, 1154, 1663, 1963, 2622, 2955, 3729, 4193, 4707, 5130, 5555, 5822]","[0, 293, 574, 940, 1319, 1655, 2476, 2951, 3377, 3980, 4492, 4911, 5325, 5889, 6437]","[0, 293, 542, 1011, 1179, 1269, 1566, 2076, 2201, 2677, 3378, 3698, 4192, 4841, 5666]","[0, 169, 259, 442, 572, 878, 1050, 1216, 1306, 1573, 2055, 2145, 2964, 3235, 3450]","[0, 169, 259, 398, 939, 1187, 1325, 1874, 1964, 2168, 2435, 2638, 2728, 3134, 3500]",5822,6437,5666,3450,3500,35,49,61,26,68,"[0, 361, 696, 1077, 1530, 1871, 2245, 2738, 3118, 3940, 4500, 5315, 6100, 6739, 7633]","[0, 244, 614, 883, 1251, 1378, 2002, 2282, 2738, 3018, 3488, 4148, 4398, 5000, 5774]","[0, 207, 569, 847, 1220, 1683, 1975, 2554, 3037, 3498, 3682, 4444, 4824, 5400, 5784]","[0, 169, 259, 349, 488, 578, 759, 1018, 1143, 1526, 1814, 2744, 2834, 3221, 3424]","[0, 169, 259, 349, 484, 655, 790, 1024, 1114, 1204, 1294, 1642, 1849, 2238, 2688]",7633,5774,5784,3424,2688,-1811,663,-118,26,812,-428,15,dire
7599033210,96,128,93,123,86,"[0, 655, 1102, 1354, 1606, 1992, 2408, 2786, 3166, 3569, 3924, 4593, 5158, 5589, 6250]","[0, 429, 719, 1093, 1471, 1876, 2298, 2619, 3023, 3273, 3601, 4339, 4811, 5374, 5778]","[0, 315, 637, 971, 1216, 1612, 1857, 1947, 2483, 2603, 3269, 3761, 4298, 5001, 5615]","[0, 303, 536, 665, 755, 958, 1320, 1492, 1710, 1847, 1937, 2295, 2479, 2734, 2874]","[0, 254, 344, 454, 583, 757, 847, 937, 1117, 1293, 1383, 1632, 1817, 2072, 2181]",6250,5778,5615,2874,2181,41,106,23,20,21,"[0, 164, 438, 841, 1168, 1446, 1557, 1898, 2230, 2608, 3098, 3646, 4145, 5064, 5632]","[0, 201, 516, 881, 1207, 1775, 2074, 2638, 3288, 3547, 3717, 4401, 4858, 5291, 5912]","[0, 168, 507, 831, 999, 1504, 1755, 2317, 2688, 3270, 3730, 4326, 5250, 5970, 6539]","[0, 129, 291, 381, 567, 909, 1016, 1369, 1684, 1774, 2256, 2796, 3017, 3665, 4171]","[0, 129, 244, 346, 486, 794, 933, 1530, 1688, 1883, 2073, 2258, 2348, 2967, 3531]",5632,5912,6539,4171,3531,618,-134,-924,-1297,-1350,-3087,15,dire
7599072306,48,59,21,112,85,"[0, 331, 612, 979, 1430, 1559, 1782, 2306, 2759, 3226, 3667, 4115, 4609, 5601, 6231]","[0, 662, 1035, 1373, 1751, 2162, 2556, 3068, 3749, 4495, 5058, 5816, 6497, 7043, 8276]","[0, 407, 815, 1224, 1694, 2069, 2670, 3103, 3610, 4266, 4799, 5512, 6233, 6974, 7787]","[0, 275, 495, 585, 675, 765, 891, 981, 1324, 1593, 1728, 2010, 2297, 2671, 3116]","[0, 210, 300, 453, 543, 633, 912, 1098, 1362, 1536, 1715, 1909, 2020, 2115, 2378]",6231,8276,7787,3116,2378,10,22,40,86,43,"[0, 167, 295, 600, 935, 1384, 1849, 2093, 2503, 3021, 3334, 4122, 4563, 5370, 6881]","[0, 323, 729, 1107, 1550, 1918, 2516, 2899, 3464, 4066, 4498, 5364, 5769, 6258, 7259]","[0, 178, 578, 859, 1235, 1652, 1984, 2162, 2497, 2947, 3443, 4226, 4964, 5499, 6374]","[0, 130, 220, 389, 479, 799, 979, 1215, 1305, 1395, 1700, 2066, 2871, 3407, 3785]","[0, 130, 344, 500, 590, 776, 960, 1050, 1220, 1429, 1739, 2491, 2894, 3224, 3318]",6881,7259,6374,3785,3318,-650,1017,1413,-669,-940,171,15,radiant
7599079114,1,17,16,14,3,"[0, 255, 520, 924, 1291, 1707, 2119, 2279, 2451, 3574, 4008, 4394, 4965, 5545, 6203]","[0, 325, 652, 1069, 1483, 1939, 2357, 2805, 3906, 4607, 5219, 5822, 6458, 7027, 7522]","[0, 211, 606, 1064, 1433, 1844, 2126, 2706, 3743, 4138, 4570, 4907, 5596, 6325, 6879]","[0, 90, 275, 766, 1200, 1578, 1717, 2072, 2162, 2868, 3223, 3568, 3772, 4013, 4420]","[0, 90, 180, 317, 455, 545, 635, 836, 1138, 1580, 1761, 2141, 2654, 2856, 3490]",6203,7522,6879,4420,3490,46,120,2,84,26,"[0, 280, 651, 1021, 1265, 1664, 2167, 2780, 3300, 3601, 4426, 5050, 5445, 5990, 6685]","[0, 367, 700, 1113, 1645, 2025, 2725, 3355, 3956, 4524, 4913, 5394, 5604, 6163, 6679]","[0, 279, 599, 877, 1253, 1541, 1845, 2336, 2658, 3306, 3684, 3971, 4501, 4822, 5055]","[0, 210, 300, 483, 610, 720, 884, 1064, 1272, 1379, 1690, 1874, 1964, 2094, 2223]","[0, 210, 347, 437, 573, 663, 753, 938, 1074, 1266, 1451, 1762, 1852, 2281, 2376]",6685,6679,5055,2223,2376,-482,843,1824,2197,1114,5496,15,radiant
7599121510,19,10,98,26,83,"[0, 370, 698, 1106, 1525, 1972, 2420, 2995, 3385, 3976, 4414, 5075, 5552, 6373, 6540]","[0, 242, 555, 885, 1295, 1679, 1927, 2697, 2898, 3310, 3595, 4052, 4612, 5124, 5641]","[0, 329, 689, 1013, 1395, 1722, 2304, 2498, 2662, 3088, 3375, 4031, 4727, 5349, 5443]","[0, 382, 472, 562, 697, 831, 1093, 1216, 1306, 1519, 1609, 1973, 2201, 2841, 3016]","[0, 170, 260, 394, 586, 951, 1131, 1528, 1662, 1886, 2013, 2150, 2400, 3075, 3301]",6540,5641,5443,3016,3301,46,11,14,30,5,"[0, 281, 686, 825, 1445, 1842, 2084, 2664, 3314, 3543, 4277, 4616, 5154, 5864, 6481]","[0, 414, 895, 1264, 1799, 2232, 2743, 3408, 4154, 4415, 5108, 5727, 6387, 7064, 8243]","[0, 241, 526, 786, 1210, 1740, 2101, 2486, 3007, 3553, 4198, 4847, 5360, 5920, 6791]","[0, 170, 296, 434, 818, 1176, 1311, 1539, 1911, 2111, 2980, 3070, 3398, 3637, 3879]","[0, 510, 649, 862, 1339, 1508, 1643, 2120, 2255, 2382, 2607, 2885, 3155, 3351, 3499]",6481,8243,6791,3879,3499,59,-2602,-1348,-863,-198,-4952,15,dire
7600037606,4,129,126,31,27,"[0, 287, 666, 1028, 1313, 1533, 1794, 2239, 2526, 3291, 3771, 4161, 4730, 5238, 5709]","[0, 217, 739, 967, 1410, 1609, 2030, 2542, 2833, 3250, 3826, 4502, 5030, 5472, 6210]","[0, 362, 565, 788, 1202, 1488, 1945, 2523, 2905, 3571, 3751, 4395, 4700, 5489, 6128]","[0, 169, 329, 419, 509, 600, 739, 930, 1020, 1349, 1529, 1854, 2348, 2443, 2678]","[0, 169, 326, 416, 599, 689, 824, 1049, 1139, 1383, 1563, 1861, 2187, 2282, 2517]",5709,6210,6128,2678,2517,34,41,96,110,86,"[0, 243, 583, 967, 1251, 1511, 2013, 2257, 2664, 3024, 3759, 4010, 4315, 5173, 5894]","[0, 207, 493, 829, 1188, 1508, 1666, 2063, 2465, 2748, 3199, 3435, 4017, 4525, 5277]","[0, 207, 861, 1138, 1637, 2002, 2324, 2632, 3261, 3657, 4106, 4600, 5400, 6044, 6398]","[0, 169, 259, 426, 574, 710, 848, 938, 1073, 1236, 1581, 1671, 1846, 2088, 2731]","[0, 169, 336, 426, 652, 795, 885, 975, 1284, 1447, 1898, 2032, 2675, 3136, 3676]",5894,5277,6398,2731,3676,-185,933,-270,-53,-1159,-734,15,radiant
7600161008,114,60,21,14,86,"[0, 344, 635, 1087, 1466, 2271, 2659, 3204, 3712, 4399, 4799, 5228, 5318, 5645, 5794]","[0, 297, 499, 881, 1078, 1208, 1459, 1981, 2545, 3042, 3711, 4104, 4581, 5081, 5573]","[0, 382, 717, 1053, 1414, 1664, 1913, 2468, 3099, 3562, 3950, 4150, 4502, 5227, 5893]","[0, 260, 350, 440, 916, 1046, 1469, 1884, 2051, 2190, 2540, 2911, 3145, 3472, 3621]","[0, 260, 394, 484, 574, 704, 847, 1090, 1304, 1495, 2183, 2343, 2739, 3005, 3227]",5794,5573,5893,3621,3227,18,97,69,58,45,"[0, 167, 538, 628, 996, 1309, 1694, 1998, 2498, 2862, 3295, 4068, 4565, 5362, 6629]","[0, 239, 486, 664, 862, 952, 1215, 1395, 1802, 2025, 2901, 3289, 3774, 4076, 4955]","[0, 164, 437, 688, 969, 1377, 1768, 1963, 2188, 2397, 2874, 3423, 3646, 3870, 4349]","[0, 130, 220, 438, 830, 1026, 1929, 2154, 2262, 2393, 2501, 2785, 2929, 3302, 3753]","[0, 130, 220, 316, 453, 627, 798, 1288, 1378, 1591, 1932, 2177, 2321, 2461, 3146]",6629,4955,4349,3753,3146,-835,618,1544,-132,81,1276,15,radiant
7600393009,48,22,129,30,84,"[0, 294, 555, 895, 1300, 1532, 1798, 2941, 3340, 3805, 4452, 5020, 5769, 6573, 7452]","[0, 253, 585, 1009, 1384, 1801, 2543, 3142, 3825, 4464, 5132, 5627, 6522, 7039, 7764]","[0, 212, 758, 1063, 1374, 1843, 2203, 2821, 3151, 3503, 3873, 4263, 5004, 5471, 6030]","[0, 130, 297, 387, 477, 801, 891, 1111, 1292, 1636, 1869, 1997, 2321, 2551, 2905]","[0, 130, 220, 395, 531, 621, 757, 1168, 1343, 1496, 1977, 2188, 3043, 3224, 3480]",7452,7764,6030,2905,3480,1,39,38,123,83,"[0, 293, 619, 1267, 1635, 2044, 2323, 2817, 3142, 3737, 4386, 4952, 5351, 5749, 6811]","[0, 405, 696, 893, 1269, 1646, 2084, 2627, 3014, 3600, 4184, 4712, 5066, 5817, 6550]","[0, 247, 495, 788, 1187, 1672, 1909, 2330, 2543, 2943, 3292, 3419, 3550, 4558, 5260]","[0, 210, 339, 473, 635, 806, 1080, 1344, 1584, 1674, 1975, 2065, 2236, 2501, 2893]","[0, 210, 406, 607, 777, 948, 1300, 1525, 1661, 2014, 2343, 2518, 2780, 3045, 3355]",6811,6550,5260,2893,3355,641,1214,770,12,125,2762,15,dire
7600480014,48,120,97,86,79,"[0, 243, 640, 1021, 1347, 1751, 2169, 2652, 3156, 3767, 4329, 5046, 5436, 6512, 7277]","[0, 204, 535, 824, 1285, 1658, 2202, 2547, 3087, 3496, 3764, 4293, 4639, 5008, 5595]","[0, 252, 602, 886, 1213, 1541, 2016, 2536, 3147, 3397, 3790, 4403, 4648, 5245, 5867]","[0, 170, 655, 766, 901, 1108, 1322, 1452, 1715, 1972, 2107, 2327, 2417, 2814, 2995]","[0, 170, 260, 394, 484, 841, 1025, 1204, 1385, 1503, 1691, 2105, 2516, 2956, 3180]",7277,5595,5867,2995,3180,106,93,23,123,105,"[0, 279, 562, 918, 1289, 1613, 1864, 2368, 2698, 3190, 3575, 4122, 4644, 5206, 5772]","[0, 323, 533, 889, 979, 1464, 1712, 2018, 2277, 2778, 3290, 3856, 4418, 5207, 5697]","[0, 209, 616, 895, 1263, 1393, 1959, 2410, 2908, 3616, 4245, 4805, 5828, 6465, 6966]","[0, 270, 573, 663, 821, 1027, 1403, 1586, 1676, 1961, 2119, 2586, 3072, 3311, 3488]","[0, 170, 311, 425, 515, 645, 851, 1457, 1580, 1948, 2083, 2390, 3011, 3498, 3935]",5772,5697,6966,3488,3935,1505,-102,-1099,-493,-755,-944,15,dire
7600548215,19,48,98,66,5,"[0, 252, 522, 845, 1250, 1660, 2039, 2669, 2992, 3530, 4117, 4442, 4719, 5258, 5643]","[0, 208, 489, 816, 1109, 1280, 1562, 2494, 2940, 3239, 3617, 3881, 4260, 4636, 5182]","[0, 206, 588, 1294, 1593, 2058, 2471, 3123, 3379, 3625, 5136, 5599, 6213, 6819, 7121]","[0, 170, 260, 434, 585, 904, 1172, 1574, 1895, 2161, 2569, 2994, 3460, 3609, 3743]","[0, 170, 347, 839, 979, 1107, 1197, 1369, 1663, 1802, 2183, 2360, 2782, 4089, 4436]",5643,5182,7121,3743,4436,90,69,93,20,26,"[56, 237, 396, 778, 1113, 1552, 2033, 2622, 3129, 3779, 4473, 5593, 7105, 7728, 8445]","[56, 146, 351, 575, 902, 1194, 1715, 2037, 2177, 2831, 3159, 3672, 4792, 5200, 6044]","[56, 219, 849, 1249, 1696, 2270, 2798, 3047, 3816, 4632, 5284, 5758, 6858, 7077, 7839]","[56, 146, 507, 861, 1309, 1843, 2205, 2900, 3202, 3506, 3669, 3989, 4173, 4376, 4781]","[324, 414, 706, 875, 1119, 1471, 1606, 1819, 2036, 2288, 2580, 3290, 3551, 3754, 4147]",8445,6044,7839,4781,4147,-2802,-862,-718,-1038,289,-5131,15,radiant
7600575200,18,49,19,53,26,"[0, 260, 582, 906, 1399, 1857, 2380, 2835, 3386, 3963, 4534, 5196, 6068, 6713, 7359]","[0, 221, 471, 800, 1014, 1176, 1758, 2298, 2546, 3070, 3620, 3937, 4672, 5501, 5929]","[0, 240, 450, 774, 1073, 1394, 1725, 2052, 2427, 2812, 3100, 3663, 3948, 4237, 4460]","[0, 170, 260, 721, 855, 945, 1201, 1291, 1429, 1688, 1870, 2318, 2632, 3089, 3366]","[0, 170, 299, 389, 479, 569, 749, 839, 973, 1063, 1198, 1372, 1601, 2193, 2360]",7359,5929,4460,3366,2360,81,86,95,27,126,"[0, 206, 541, 960, 1249, 1699, 2141, 2676, 3331, 3893, 4363, 5265, 5826, 6433, 7001]","[0, 256, 646, 926, 1181, 1392, 1518, 1860, 2572, 2977, 3426, 3943, 4324, 4740, 5248]","[0, 329, 632, 887, 1329, 1750, 2187, 2412, 2930, 3323, 3857, 4198, 4509, 4984, 5317]","[0, 170, 260, 399, 540, 901, 1037, 1176, 1621, 1845, 1980, 2250, 2482, 2905, 3375]","[0, 170, 260, 398, 488, 706, 845, 1029, 1317, 1407, 1542, 1877, 2366, 2633, 2826]",7001,5248,5317,3375,2826,358,681,-857,-9,-466,-293,15,radiant
7600731101,4,22,48,51,65,"[0, 210, 457, 857, 1142, 1370, 1585, 2515, 2605, 2927, 3678, 4696, 5285, 6060, 6804]","[0, 295, 648, 1107, 1568, 1961, 2413, 3136, 3586, 3968, 4366, 5084, 5438, 5989, 6462]","[0, 315, 599, 1036, 1288, 1631, 1992, 2416, 2895, 3335, 4118, 4819, 5451, 6120, 6828]","[0, 210, 300, 570, 781, 931, 1189, 1431, 1820, 2160, 3006, 3301, 3525, 3985, 4594]","[0, 210, 300, 507, 646, 736, 864, 1248, 1338, 1550, 2018, 2678, 3112, 3470, 3820]",6804,6462,6828,4594,3820,17,93,96,79,20,"[0, 283, 702, 1153, 1650, 2096, 2506, 2853, 3457, 3863, 4441, 4954, 5654, 6306, 6794]","[0, 243, 500, 741, 1187, 1751, 2039, 2543, 2932, 3294, 3714, 3942, 4591, 5156, 5711]","[0, 165, 417, 944, 1434, 1805, 2399, 2941, 3347, 3796, 4242, 4632, 5146, 5748, 6139]","[0, 130, 220, 857, 1079, 1386, 1573, 1797, 1918, 2135, 2516, 2754, 3392, 3649, 4190]","[0, 130, 220, 353, 557, 762, 852, 1127, 1403, 1512, 1782, 1872, 2045, 2519, 2965]",6794,5711,6139,4190,2965,10,751,689,404,855,2709,15,radiant
7600735707,126,109,123,71,68,"[0, 251, 518, 1145, 1364, 1571, 1881, 2088, 2677, 3096, 3480, 3778, 4036, 4509, 5011]","[0, 214, 488, 851, 1054, 1374, 1675, 1927, 2498, 3034, 3349, 3593, 4084, 4505, 5060]","[0, 202, 292, 382, 524, 701, 1240, 1330, 1609, 1889, 2083, 2772, 3195, 3503, 3859]","[0, 506, 776, 1097, 1424, 1713, 2051, 2260, 2901, 3207, 3380, 3588, 3810, 4038, 4367]","[0, 129, 219, 353, 443, 577, 729, 819, 1136, 1581, 1724, 2059, 2185, 2383, 2587]",5011,5060,3859,4367,2587,48,129,74,112,20,"[0, 244, 484, 943, 1291, 1576, 2026, 2308, 2925, 3492, 4368, 4889, 5956, 6800, 7298]","[0, 281, 538, 847, 1099, 1426, 1627, 1896, 2391, 2688, 3728, 4193, 4711, 5403, 5850]","[0, 328, 579, 669, 1022, 1265, 1889, 2302, 3122, 3212, 4381, 5486, 5793, 6268, 6508]","[0, 209, 299, 437, 527, 701, 791, 881, 1322, 1633, 2211, 2507, 2962, 3321, 3505]","[0, 209, 299, 389, 479, 569, 708, 798, 1102, 1303, 1704, 2009, 2263, 2533, 2916]",7298,5850,6508,3505,2916,-2287,-790,-2649,862,-329,-5193,15,dire
7600736706,62,54,35,72,3,"[0, 212, 555, 893, 1248, 1709, 2122, 2481, 2736, 3188, 3727, 4246, 4513, 5101, 6116]","[0, 199, 522, 775, 1547, 1834, 2451, 2931, 3622, 3970, 4421, 5184, 5982, 7062, 8099]","[0, 280, 531, 913, 1176, 1520, 2068, 2608, 3353, 4467, 5047, 5856, 6526, 7038, 7625]","[0, 130, 220, 310, 447, 627, 717, 852, 1032, 1250, 1429, 1519, 1663, 1950, 2305]","[0, 130, 220, 310, 532, 907, 1244, 1442, 1622, 1793, 1977, 2067, 2423, 2572, 2867]",6116,8099,7625,2305,2867,10,22,2,9,43,"[0, 292, 654, 1019, 1438, 1890, 2544, 3125, 3968, 4268, 4774, 5195, 5961, 6577, 7148]","[0, 170, 430, 804, 1138, 1502, 1788, 2520, 3400, 3649, 4088, 4838, 5335, 5828, 6575]","[0, 242, 486, 798, 924, 1370, 1537, 1936, 2274, 2532, 2950, 3301, 3551, 3800, 3976]","[0, 170, 260, 470, 560, 690, 882, 1241, 1537, 1872, 2395, 2575, 2718, 2955, 3296]","[0, 170, 301, 470, 609, 1024, 1241, 1554, 2032, 2256, 2391, 2636, 2825, 3083, 3224]",7148,6575,3976,3296,3224,-1032,1524,3649,-991,-357,2793,15,dire
7600854609,63,71,93,66,119,"[0, 285, 459, 861, 1691, 2084, 2613, 2892, 3501, 3728, 4561, 5209, 5868, 6452, 7230]","[0, 172, 714, 1136, 1409, 1778, 2396, 2935, 3461, 4050, 4579, 5049, 5629, 6368, 6686]","[0, 333, 611, 1079, 1412, 1770, 2184, 2779, 3207, 3558, 4391, 4822, 5392, 6161, 6670]","[0, 170, 260, 458, 736, 904, 1120, 1311, 1534, 1869, 2252, 2532, 2836, 3435, 3920]","[0, 174, 350, 496, 603, 816, 970, 1183, 1363, 1694, 2360, 2567, 3027, 4016, 4183]",7230,6686,6670,3920,4183,89,73,106,9,51,"[56, 324, 486, 576, 703, 1062, 1328, 1597, 1877, 2135, 2552, 3142, 3761, 4355, 5028]","[56, 372, 689, 890, 1237, 1556, 2044, 2531, 2973, 3304, 4177, 4435, 5094, 5649, 6115]","[324, 623, 822, 995, 1358, 1765, 2018, 2239, 2780, 3335, 4093, 4333, 4854, 5001, 5442]","[56, 251, 389, 529, 892, 982, 1229, 1433, 1741, 2242, 2461, 2637, 2896, 2991, 3377]","[56, 251, 361, 471, 561, 664, 799, 941, 1308, 1565, 1784, 1874, 2132, 2461, 2595]",5028,6115,5442,3377,2595,2202,571,1228,543,1588,6132,15,radiant
7600932715,48,25,28,123,69,"[0, 636, 952, 1164, 1543, 1703, 2176, 2696, 3138, 3632, 4649, 5189, 5859, 6673, 7393]","[0, 377, 625, 883, 1179, 1691, 2042, 2456, 2790, 3272, 4203, 4675, 5008, 5845, 6277]","[0, 256, 711, 1264, 1583, 1946, 2354, 2772, 3346, 3762, 4171, 4538, 4929, 5249, 5344]","[0, 256, 464, 750, 840, 1238, 1655, 1938, 2120, 2429, 2886, 3095, 3373, 4177, 4272]","[0, 389, 479, 821, 1018, 1126, 1378, 2032, 2167, 2382, 2967, 3245, 3643, 4122, 4387]",7393,6277,5344,4272,4387,93,17,14,26,21,"[0, 315, 569, 810, 1173, 1500, 1948, 2242, 2666, 3098, 3654, 4534, 5266, 5889, 6533]","[0, 290, 556, 831, 1071, 1473, 1845, 2592, 3081, 3637, 3914, 4155, 5294, 6283, 6821]","[0, 281, 642, 1168, 1338, 1662, 1911, 2458, 2979, 3745, 4074, 4491, 4701, 5214, 5616]","[0, 445, 535, 645, 802, 980, 1070, 1357, 1447, 1537, 1954, 2583, 2954, 3536, 3740]","[0, 209, 299, 486, 634, 773, 948, 1173, 1263, 1400, 1639, 1783, 2265, 2822, 3328]",6533,6821,5616,3740,3328,860,-544,-272,532,1059,1635,15,dire
7601046103,57,109,96,86,5,"[0, 381, 718, 1118, 1573, 2301, 2850, 3773, 4257, 4787, 5298, 5836, 6079, 6647, 7402]","[0, 329, 691, 905, 1512, 1778, 2161, 2837, 3423, 3671, 4241, 4654, 5373, 5933, 6468]","[0, 294, 663, 1098, 1579, 2040, 2542, 3150, 3691, 4102, 4626, 5215, 5896, 5991, 6689]","[0, 170, 260, 399, 569, 659, 794, 1018, 1243, 1381, 1565, 1675, 1765, 2027, 2701]","[0, 170, 260, 391, 647, 737, 868, 1141, 1370, 1460, 2021, 2135, 2225, 2367, 3124]",7402,6468,6689,2701,3124,18,85,88,13,84,"[0, 328, 589, 1086, 1532, 1965, 2564, 3095, 3587, 4358, 5064, 5754, 6645, 7588, 8682]","[0, 204, 636, 952, 1281, 1625, 2078, 2398, 2938, 3953, 4231, 4539, 5113, 5682, 6818]","[0, 170, 260, 372, 506, 631, 770, 910, 1044, 1552, 1827, 2199, 2631, 3060, 3585]","[0, 241, 367, 583, 954, 1096, 1338, 1546, 1717, 2215, 2820, 3010, 3269, 4021, 4620]","[0, 170, 260, 350, 489, 627, 761, 851, 987, 1167, 1302, 1392, 1552, 1647, 1979]",8682,6818,3585,4620,1979,-1280,-350,3104,-1919,1145,700,15,radiant
7601365508,48,36,71,21,20,"[0, 280, 603, 894, 1110, 1324, 1556, 1842, 2212, 3008, 3684, 4263, 5117, 5924, 6608]","[0, 253, 607, 972, 1342, 1667, 2262, 2642, 3270, 3785, 4267, 4843, 5471, 6711, 7422]","[0, 169, 531, 735, 1003, 1399, 1604, 2029, 2409, 2754, 2968, 3401, 3966, 4654, 5618]","[0, 169, 310, 452, 721, 811, 901, 1370, 1717, 1948, 2062, 2299, 2660, 3150, 3503]","[0, 169, 279, 369, 699, 949, 1039, 1482, 1715, 2016, 2371, 2565, 2715, 3315, 3857]",6608,7422,5618,3503,3857,10,49,13,45,53,"[0, 205, 551, 988, 1326, 1695, 2027, 2399, 2940, 3431, 4079, 4697, 5277, 5964, 6576]","[0, 240, 590, 973, 1258, 1493, 1905, 2330, 2884, 3324, 3865, 4425, 4908, 5486, 6253]","[0, 255, 605, 888, 1142, 1469, 1676, 2076, 2794, 3263, 4089, 4586, 5253, 5734, 6290]","[0, 508, 679, 803, 1026, 1116, 1406, 1496, 1942, 2068, 2716, 2960, 3299, 3540, 4052]","[0, 169, 289, 425, 603, 693, 1066, 1389, 1614, 1779, 2429, 2519, 2800, 3226, 3594]",6576,6253,6290,4052,3594,32,1169,-672,-549,263,243,15,dire
7601749215,21,126,49,105,20,"[0, 286, 573, 1016, 1374, 1857, 2104, 2661, 3178, 3589, 4062, 5126, 5560, 6324, 6912]","[0, 488, 886, 1081, 1387, 1755, 2120, 2517, 2770, 3543, 4323, 4792, 5434, 6109, 6465]","[0, 555, 866, 1066, 1498, 1623, 1870, 2196, 2321, 2456, 2635, 2869, 3436, 3786, 4279]","[0, 454, 544, 634, 754, 844, 978, 1182, 1403, 1538, 1776, 2061, 2269, 2577, 2901]","[0, 321, 411, 545, 900, 1084, 1174, 1264, 1628, 1863, 2092, 2675, 2819, 3111, 3206]",6912,6465,4279,2901,3206,93,106,97,91,26,"[0, 199, 579, 1040, 1276, 2042, 2453, 2722, 3186, 3670, 3866, 4611, 5248, 6033, 6857]","[0, 453, 631, 956, 1282, 1613, 1913, 2529, 3001, 3807, 3897, 3987, 4560, 5270, 5947]","[0, 587, 870, 1271, 1741, 2064, 2926, 3208, 3369, 3554, 3942, 4235, 4746, 5036, 5741]","[0, 477, 567, 743, 833, 1172, 1352, 1442, 1796, 2107, 2197, 2287, 2421, 2650, 2956]","[0, 681, 771, 998, 1208, 1338, 1680, 1859, 1949, 2116, 2206, 2474, 2564, 2659, 2966]",6857,5947,5741,2956,2966,55,518,-1462,-55,240,-704,15,dire
7601831103,10,76,96,53,100,"[0, 239, 566, 844, 1128, 1530, 1735, 2282, 2849, 3591, 4023, 4741, 5483, 6039, 6454]","[0, 207, 455, 737, 991, 1403, 1727, 2135, 2350, 3308, 3555, 3788, 3950, 4614, 5350]","[0, 170, 368, 732, 1195, 1406, 1694, 2111, 2492, 2848, 3285, 3605, 3951, 4923, 5273]","[0, 170, 260, 394, 528, 864, 1226, 1449, 1539, 1752, 1842, 2074, 2369, 2765, 2984]","[0, 170, 260, 350, 478, 695, 785, 1066, 1156, 1381, 1471, 1561, 1785, 2144, 2363]",6454,5350,5273,2984,2363,48,137,43,123,21,"[0, 205, 748, 980, 1220, 1680, 2199, 2686, 3173, 3401, 3929, 4577, 5392, 5542, 6821]","[0, 243, 577, 919, 1196, 1532, 1843, 2595, 3233, 3622, 4136, 4423, 5563, 5771, 6420]","[0, 207, 467, 756, 1082, 1461, 1865, 2028, 2676, 2923, 3512, 3813, 4204, 4646, 5465]","[0, 170, 309, 399, 519, 920, 1089, 1507, 1940, 2157, 2842, 3001, 3502, 3870, 4701]","[0, 170, 319, 409, 575, 700, 1054, 1144, 1346, 1475, 1733, 1877, 2191, 2656, 3407]",6821,6420,5465,4701,3407,-367,-1070,-192,-1717,-1044,-4390,15,radiant
7601988906,98,18,23,65,86,"[0, 294, 631, 872, 1194, 1771, 1861, 2435, 2986, 3425, 4098, 4652, 5337, 5882, 6442]","[0, 206, 484, 886, 1169, 1602, 1881, 2152, 2640, 3124, 3895, 4479, 5138, 5962, 6378]","[0, 257, 500, 802, 1178, 1595, 1987, 2448, 2665, 3040, 3605, 4154, 4470, 5028, 5652]","[0, 169, 259, 732, 902, 1253, 1358, 1540, 1917, 2444, 3160, 3404, 3613, 4185, 4319]","[0, 169, 276, 446, 663, 884, 1022, 1204, 1405, 1593, 2026, 2248, 2478, 2753, 2848]",6442,6378,5652,4319,2848,48,114,129,26,5,"[0, 169, 519, 835, 1081, 1490, 1870, 2381, 3021, 3598, 4172, 4748, 5083, 5676, 6619]","[0, 323, 732, 1090, 1539, 2180, 2711, 2801, 3440, 3530, 4034, 4503, 5347, 6500, 7214]","[0, 297, 504, 903, 1197, 1361, 1779, 2251, 2681, 3097, 3686, 3951, 4834, 5328, 5947]","[0, 169, 259, 368, 458, 595, 722, 812, 902, 1167, 1479, 1574, 1911, 2554, 2900]","[0, 169, 259, 349, 510, 600, 783, 873, 1195, 1285, 1510, 1713, 2012, 2555, 2751]",6619,7214,5947,2900,2751,-177,-836,-295,1419,97,208,15,dire
7602106509,48,19,28,53,51,"[58, 228, 541, 932, 1206, 1560, 1978, 2497, 2946, 3333, 3947, 4571, 5293, 6363, 7069]","[58, 301, 708, 1116, 1713, 2134, 2743, 3049, 3340, 4002, 4304, 4734, 5467, 6317, 6618]","[58, 346, 617, 992, 1498, 1804, 2101, 2266, 2929, 3412, 4076, 4656, 5311, 6174, 6427]","[58, 232, 338, 571, 785, 1033, 1231, 1512, 1602, 1711, 1906, 2226, 2666, 3479, 3906]","[326, 546, 636, 792, 953, 1129, 1254, 1513, 1603, 1748, 1917, 2097, 2366, 2605, 2699]",7069,6618,6427,3906,2699,89,128,96,26,121,"[0, 215, 539, 903, 1424, 1851, 2158, 2770, 3201, 3511, 3991, 4798, 5388, 6208, 6645]","[0, 303, 543, 874, 1123, 1660, 1989, 2434, 2685, 3152, 3680, 3984, 4391, 4703, 5094]","[0, 205, 508, 785, 1284, 1706, 2211, 2426, 2928, 3434, 4022, 4902, 5328, 5497, 6010]","[0, 170, 278, 604, 694, 932, 1089, 1179, 1722, 1812, 2055, 2523, 2657, 2826, 3332]","[0, 170, 342, 432, 603, 698, 873, 1075, 1287, 1377, 1620, 1922, 2131, 2300, 2558]",6645,5094,6010,3332,2558,424,1524,417,574,141,3080,15,radiant
7602415801,25,70,60,86,31,"[0, 287, 656, 1028, 1557, 1936, 2382, 2791, 3353, 4259, 4823, 5416, 6450, 7130, 7781]","[0, 327, 640, 923, 1444, 1751, 2452, 2821, 3264, 3762, 4024, 4149, 4514, 5517, 5872]","[0, 250, 651, 1025, 1427, 1810, 2263, 2858, 3420, 3945, 4592, 4937, 5178, 5472, 5858]","[0, 169, 259, 349, 439, 573, 759, 939, 1119, 1344, 1776, 1866, 2073, 2448, 2686]","[0, 169, 344, 434, 671, 805, 1254, 1498, 1682, 2085, 2303, 2428, 2665, 3013, 3142]",7781,5872,5858,2686,3142,44,96,32,88,5,"[0, 291, 571, 1007, 1388, 1865, 2267, 2705, 3098, 3472, 4015, 4542, 5476, 6096, 7087]","[0, 241, 583, 918, 1251, 1581, 1833, 2226, 2479, 2817, 3748, 4581, 5027, 5230, 5793]","[0, 281, 501, 798, 1047, 1293, 1507, 1957, 2159, 2386, 2910, 3325, 3907, 4110, 4442]","[0, 169, 259, 423, 560, 777, 867, 1008, 1136, 1272, 1721, 2234, 2512, 2715, 3233]","[0, 169, 259, 478, 568, 765, 873, 1010, 1100, 1190, 1589, 1973, 2347, 2557, 2732]",7087,5793,4442,3233,2732,694,79,1416,-547,410,2052,15,dire
7602497900,13,104,93,14,121,"[0, 326, 581, 909, 1156, 1576, 1983, 2553, 3005, 3484, 4247, 4979, 5371, 5972, 6527]","[0, 321, 659, 1069, 1539, 2022, 2548, 3080, 3555, 4046, 4826, 5276, 6148, 6676, 6937]","[0, 283, 564, 726, 1159, 1394, 1530, 1658, 1833, 1962, 2335, 2702, 3147, 3588, 4137]","[0, 169, 318, 408, 590, 832, 1023, 1158, 1364, 1503, 1898, 2412, 2620, 2858, 3048]","[0, 169, 309, 491, 719, 849, 1066, 1191, 1318, 1493, 1700, 2017, 2427, 2565, 2660]",6527,6937,4137,3048,2660,46,4,81,84,86,"[0, 402, 685, 993, 1314, 1677, 2040, 2413, 2883, 3529, 3843, 4409, 5163, 5942, 6663]","[0, 239, 659, 1100, 1447, 1903, 2336, 3011, 3474, 3999, 4517, 5225, 5771, 6624, 7231]","[0, 204, 707, 995, 1279, 1598, 2095, 2418, 2782, 3714, 4279, 4791, 5546, 6183, 6589]","[0, 169, 259, 349, 477, 601, 743, 1020, 1192, 1439, 1529, 1709, 1799, 2230, 2341]","[0, 169, 259, 349, 485, 624, 759, 1032, 1122, 1570, 1660, 1928, 2018, 2353, 2501]",6663,7231,6589,2341,2501,-136,-294,-2452,707,159,-2016,15,radiant
7602527211,21,93,49,9,86,"[0, 291, 656, 1061, 1386, 2042, 2476, 3397, 3906, 4625, 5183, 5903, 6256, 6784, 7582]","[0, 243, 469, 969, 1258, 1468, 1628, 2029, 2335, 3074, 3511, 3779, 4345, 5347, 5933]","[0, 206, 557, 931, 1323, 1413, 1920, 2386, 3123, 3758, 4506, 4892, 5337, 5684, 6549]","[0, 218, 392, 607, 824, 1218, 1663, 1934, 2426, 2852, 3129, 3353, 3616, 3899, 4609]","[0, 170, 260, 769, 1030, 1120, 1210, 1541, 1802, 2131, 2447, 2585, 2694, 3036, 3560]",7582,5933,6549,4609,3560,95,47,17,5,105,"[0, 216, 478, 883, 1287, 1785, 2241, 2719, 3020, 3478, 3875, 4464, 5453, 6065, 6529]","[0, 310, 551, 919, 1254, 1636, 2157, 2452, 2824, 3470, 3996, 4289, 4647, 4971, 5511]","[0, 611, 925, 1300, 1583, 1707, 1834, 2040, 2503, 2642, 3301, 3874, 4598, 5072, 5167]","[0, 234, 349, 439, 575, 711, 801, 891, 1031, 1422, 1512, 1834, 2076, 2310, 2405]","[0, 234, 349, 558, 697, 873, 1009, 1099, 1189, 1557, 1765, 2040, 2222, 2475, 2570]",6529,5511,5167,2405,2570,1053,422,1382,2204,990,6051,15,radiant
7602528301,48,21,98,123,110,"[0, 328, 660, 1071, 1484, 1890, 2589, 3106, 3640, 4280, 4870, 5599, 6130, 7156, 8469]","[0, 244, 619, 868, 1126, 1417, 1594, 2031, 2241, 2567, 3177, 3468, 4035, 4595, 5361]","[0, 364, 645, 916, 1218, 1594, 2026, 2916, 3963, 4383, 4659, 5244, 5595, 6786, 7570]","[0, 170, 260, 350, 520, 610, 700, 1251, 1801, 2173, 2538, 2658, 2932, 3625, 3923]","[0, 170, 260, 399, 536, 672, 905, 995, 1188, 1481, 1835, 1925, 2015, 2161, 2500]",8469,5361,7570,3923,2500,72,13,71,53,86,"[0, 246, 370, 768, 1159, 1611, 2035, 2395, 2871, 3462, 4222, 5043, 5558, 6019, 6495]","[0, 333, 653, 1101, 1461, 1916, 2271, 2566, 3070, 3523, 4502, 5308, 5829, 6211, 6852]","[0, 204, 588, 994, 1487, 1931, 2412, 2966, 3955, 4340, 5054, 5786, 6458, 6688, 7237]","[0, 170, 260, 380, 950, 1085, 1193, 1283, 1373, 1551, 1936, 2265, 2576, 2889, 3444]","[0, 219, 360, 528, 715, 852, 1094, 1184, 1320, 1571, 2026, 2417, 2756, 3246, 3639]",6495,6852,7237,3444,3639,1974,-1491,333,479,-1139,156,15,dire
7602639202,14,95,39,86,85,"[0, 273, 622, 879, 1482, 1790, 2256, 2673, 3132, 3767, 4288, 4938, 5465, 6281, 6808]","[0, 599, 991, 1262, 1829, 2028, 2612, 2866, 3546, 3796, 4304, 4979, 5602, 6105, 6612]","[0, 219, 385, 747, 1111, 1411, 1670, 2386, 2635, 3177, 3909, 4691, 5593, 6074, 6539]","[0, 219, 357, 558, 696, 824, 959, 1094, 1232, 1456, 1767, 2627, 2826, 3327, 3670]","[0, 244, 334, 424, 671, 761, 1068, 1203, 1412, 1758, 2123, 2511, 2784, 2968, 3592]",6808,6612,6539,3670,3592,1,7,21,76,5,"[0, 328, 649, 977, 1434, 1919, 2427, 2870, 3294, 3648, 4448, 4941, 5443, 6075, 7073]","[0, 205, 495, 700, 1114, 1497, 1836, 2055, 2329, 2539, 2666, 2876, 3085, 3805, 3979]","[0, 332, 508, 693, 1035, 1434, 1609, 1955, 2045, 2974, 3401, 3832, 4163, 4644, 5284]","[0, 170, 260, 387, 517, 653, 743, 923, 1013, 1522, 1612, 1740, 1830, 2546, 2675]","[0, 170, 260, 398, 661, 751, 879, 1037, 1127, 1237, 1547, 1637, 1727, 1822, 2206]",7073,3979,5284,2675,2206,-265,2633,1255,995,1386,6004,15,dire
7602747503,25,71,93,87,121,"[0, 240, 657, 1071, 1400, 1731, 2350, 2983, 3409, 3868, 4530, 5051, 5503, 7093, 7760]","[0, 282, 636, 1082, 1466, 1830, 2305, 2835, 3450, 3860, 4580, 4907, 5890, 6394, 6971]","[0, 293, 1155, 1282, 1460, 1755, 2118, 2665, 2880, 3561, 3704, 3914, 4420, 4931, 5665]","[0, 170, 385, 475, 802, 892, 1483, 1639, 1972, 2503, 2593, 2683, 3185, 3433, 4001]","[0, 170, 260, 350, 440, 530, 634, 756, 894, 1054, 1360, 1450, 1540, 2265, 2691]",7760,6971,5665,4001,2691,6,106,14,114,5,"[0, 294, 616, 1030, 1419, 1898, 2276, 2701, 3490, 4149, 4642, 5319, 5966, 6625, 7297]","[0, 283, 409, 626, 993, 1312, 1761, 2015, 2524, 3214, 3705, 4290, 4797, 5260, 5880]","[0, 170, 372, 824, 1592, 1804, 2266, 2374, 2857, 3058, 3868, 4231, 4906, 5277, 5726]","[0, 170, 260, 396, 755, 845, 1079, 1230, 2105, 2243, 2834, 2924, 3245, 3340, 3750]","[0, 170, 277, 367, 497, 587, 715, 805, 1075, 1187, 1376, 1466, 1556, 1651, 1939]",7297,5880,5726,3750,1939,463,1091,-61,251,752,2496,15,dire
7602837205,10,49,136,91,101,"[0, 204, 565, 885, 1321, 1703, 1990, 2518, 2993, 3495, 4050, 4670, 5265, 5812, 6501]","[0, 303, 511, 976, 1390, 1874, 2318, 3043, 3641, 4119, 4555, 5320, 5879, 6113, 6622]","[0, 272, 436, 674, 1147, 1539, 2285, 2749, 3163, 3879, 4268, 4887, 5319, 5957, 6940]","[0, 199, 289, 379, 560, 650, 1237, 1474, 1628, 2284, 2544, 2647, 2821, 2993, 3431]","[0, 467, 557, 693, 1062, 1196, 1286, 1551, 1661, 1886, 2021, 2173, 2307, 2669, 3024]",6501,6622,6940,3431,3024,48,60,112,20,79,"[0, 248, 774, 934, 1185, 1469, 1635, 2002, 2343, 2946, 3419, 4072, 4753, 5325, 6088]","[0, 282, 580, 842, 1137, 1422, 1985, 2310, 2434, 2788, 3208, 3625, 4192, 4714, 5250]","[0, 325, 635, 926, 1285, 1488, 1837, 2083, 2536, 2804, 3518, 4114, 4465, 4810, 5493]","[0, 210, 397, 527, 851, 989, 1079, 1169, 1297, 1477, 1612, 1822, 1912, 2395, 2996]","[0, 210, 325, 415, 550, 686, 879, 969, 1059, 1278, 1550, 1760, 1898, 2302, 3095]",6088,5250,5493,2996,3095,413,1372,1447,435,-71,3596,15,radiant
7602935601,76,120,104,138,100,"[0, 248, 462, 780, 1086, 1282, 1639, 1803, 2235, 2817, 3217, 3821, 4386, 4759, 5687]","[0, 282, 567, 903, 1031, 1284, 1992, 2301, 2609, 3218, 3773, 4362, 4949, 5701, 6151]","[0, 334, 606, 816, 1065, 1540, 1858, 2399, 2653, 3264, 3692, 4250, 4802, 5422, 6028]","[0, 210, 300, 426, 565, 731, 905, 1241, 1466, 1747, 1951, 2227, 2379, 2723, 3195]","[0, 210, 300, 436, 526, 958, 1093, 1183, 1573, 2208, 2382, 2658, 2748, 3016, 3471]",5687,6151,6028,3195,3471,12,35,20,123,40,"[0, 215, 532, 769, 1179, 1269, 1680, 1925, 2492, 2897, 3279, 3826, 4291, 5060, 5709]","[0, 210, 407, 656, 1041, 1303, 1677, 2153, 2961, 3455, 3856, 4280, 4819, 5021, 6145]","[0, 252, 448, 882, 1291, 1610, 2047, 2182, 2534, 3126, 3517, 3752, 4149, 4587, 4916]","[0, 130, 220, 401, 932, 1311, 1401, 1491, 1630, 1947, 2037, 2208, 2436, 2750, 3159]","[0, 130, 220, 310, 440, 530, 667, 757, 946, 1397, 1625, 1929, 2191, 2434, 2929]",5709,6145,4916,3159,2929,-22,6,1112,36,542,1674,15,dire
7603277412,18,78,106,79,5,"[0, 169, 576, 904, 1280, 1685, 2135, 2506, 3187, 3720, 4162, 5615, 6264, 7298, 8055]","[0, 215, 609, 852, 1090, 1291, 1606, 1997, 2593, 2890, 3491, 4061, 4608, 5583, 6442]","[0, 205, 529, 1019, 1399, 2043, 2218, 3016, 3433, 3806, 4164, 4734, 5084, 5400, 6147]","[0, 169, 259, 444, 534, 679, 807, 1045, 1180, 1561, 1696, 2309, 2677, 3253, 3601]","[0, 169, 259, 434, 590, 761, 959, 1580, 1890, 2199, 2649, 3239, 3578, 3817, 4038]",8055,6442,6147,3601,4038,10,129,126,123,45,"[0, 216, 466, 712, 1087, 1569, 2128, 2591, 3014, 3364, 3859, 4527, 4848, 5310, 5984]","[0, 203, 570, 898, 1071, 1355, 1645, 2142, 2562, 3157, 3541, 4289, 4813, 5640, 5925]","[0, 327, 667, 1118, 1403, 1886, 2156, 2285, 2744, 3160, 3759, 4001, 4471, 4834, 5047]","[0, 169, 259, 398, 488, 876, 1087, 1265, 1447, 1587, 1885, 2157, 2286, 2623, 3025]","[0, 169, 261, 351, 441, 620, 755, 845, 980, 1120, 1599, 1885, 2019, 2302, 2669]",5984,5925,5047,3025,2669,2071,517,1100,576,1369,5633,15,radiant
7603672316,98,10,21,86,84,"[0, 207, 447, 1154, 1604, 2136, 2273, 3032, 3635, 4848, 5715, 5850, 6417, 7154, 7771]","[0, 248, 528, 819, 1180, 1465, 1963, 2592, 3052, 3559, 4219, 4445, 5074, 5554, 6197]","[0, 284, 445, 985, 1298, 1579, 2064, 2360, 2860, 3259, 3530, 3841, 4403, 4774, 5456]","[100, 270, 360, 450, 736, 1001, 1151, 1241, 1423, 1908, 2579, 2791, 3019, 3409, 3704]","[0, 170, 260, 396, 526, 616, 755, 995, 1130, 1493, 1894, 2304, 2582, 3042, 3489]",7771,6197,5456,3704,3489,109,52,69,20,90,"[0, 280, 544, 845, 1246, 1419, 1842, 2218, 2638, 3066, 3546, 3688, 4341, 5003, 5806]","[0, 256, 615, 1019, 1400, 1926, 2361, 2705, 3327, 4004, 4335, 4602, 5612, 6583, 7308]","[0, 209, 514, 708, 1148, 1631, 1833, 2069, 2409, 2813, 4057, 4340, 4752, 5220, 5654]","[0, 170, 674, 794, 1187, 1388, 1478, 1790, 1925, 2182, 2553, 2823, 2913, 3317, 3584]","[0, 170, 285, 405, 627, 804, 941, 1408, 1543, 1965, 2197, 2589, 2730, 3079, 3292]",5806,7308,5654,3584,3292,1965,-1111,-198,120,197,973,15,dire
7603706619,46,95,17,19,121,"[0, 217, 550, 956, 1377, 1881, 2205, 2733, 3594, 4061, 4808, 5698, 6800, 7509, 8284]","[0, 206, 471, 783, 1218, 1559, 1957, 2346, 2887, 3245, 3747, 4350, 5076, 5817, 6376]","[56, 271, 430, 795, 1164, 1745, 2120, 2493, 2583, 3395, 3976, 4752, 5121, 5216, 5704]","[324, 528, 664, 1104, 1272, 1510, 1762, 2130, 2420, 2764, 3261, 3772, 4239, 4542, 4996]","[56, 225, 506, 648, 738, 907, 1067, 1225, 1409, 1730, 2137, 2477, 2776, 2935, 3197]",8284,6376,5704,4996,3197,97,1,105,126,20,"[0, 249, 417, 903, 1138, 1531, 1948, 2239, 2592, 3215, 4057, 4147, 4621, 4952, 5371]","[0, 169, 441, 802, 965, 1306, 1664, 2086, 2669, 2928, 3196, 3439, 3686, 4638, 4845]","[0, 169, 259, 480, 691, 830, 1017, 1972, 2201, 2421, 2556, 2646, 2830, 3512, 4339]","[0, 169, 293, 451, 579, 753, 920, 1130, 1220, 1803, 2027, 2283, 2412, 2953, 3556]","[0, 169, 259, 436, 526, 699, 837, 972, 1146, 1414, 1504, 1594, 1784, 2258, 2353]",5371,4845,4339,3556,2353,2913,1531,1365,1440,844,8093,15,radiant
7603755806,41,106,29,68,26,"[0, 303, 428, 667, 989, 1204, 1413, 1771, 2023, 2113, 2499, 2705, 3033, 3501, 3596]","[0, 285, 486, 774, 1146, 1236, 1326, 1561, 1732, 1822, 2369, 2654, 3075, 3337, 3484]","[0, 268, 469, 692, 939, 1171, 1651, 2110, 2607, 3113, 3527, 3758, 4010, 4104, 4199]","[0, 195, 285, 375, 595, 685, 820, 910, 1045, 1475, 1655, 1778, 1871, 2009, 2189]","[0, 195, 319, 464, 594, 684, 774, 864, 999, 1089, 1401, 1491, 1603, 1697, 1792]",3596,3484,4199,2189,1792,18,98,22,135,111,"[59, 311, 652, 1098, 1622, 2046, 2453, 2852, 3424, 3950, 4635, 5673, 6266, 6925, 8071]","[59, 380, 817, 1295, 1668, 2196, 2561, 3155, 3897, 4559, 4949, 5658, 6561, 7361, 8073]","[59, 229, 319, 439, 721, 1116, 1359, 1783, 2220, 2685, 2820, 3259, 3616, 4234, 4675]","[327, 534, 806, 1213, 1831, 2439, 2976, 3362, 4004, 4555, 4952, 5690, 6375, 6996, 7334]","[59, 229, 363, 526, 616, 810, 998, 1223, 1502, 1947, 2220, 2542, 2753, 3030, 3539]",8071,8073,4675,7334,3539,-4475,-4589,-476,-5145,-1747,-16432,15,dire
7604119300,13,41,78,123,136,"[0, 297, 571, 915, 1403, 1653, 1990, 2698, 2877, 2967, 3716, 4097, 4704, 5050, 5318]","[0, 170, 494, 659, 936, 1101, 1675, 1921, 2152, 2422, 2808, 2986, 3452, 3722, 4095]","[0, 242, 408, 772, 1070, 1687, 1976, 2304, 2762, 3548, 3951, 4450, 5208, 5674, 5769]","[0, 170, 391, 481, 700, 986, 1397, 1532, 1667, 2181, 2559, 2649, 2894, 3104, 3199]","[0, 170, 260, 402, 532, 622, 930, 1176, 1316, 1406, 1944, 2034, 2814, 2909, 3050]",5318,4095,5769,3199,3050,48,129,25,30,100,"[0, 205, 557, 844, 1050, 1581, 1968, 2757, 3101, 3523, 4035, 4694, 5337, 5970, 6864]","[0, 296, 458, 877, 1524, 1897, 2095, 2385, 2857, 3559, 3985, 4406, 4856, 5229, 5537]","[0, 287, 669, 908, 1196, 1632, 2245, 2467, 2942, 3415, 3882, 4421, 4832, 5343, 5949]","[0, 170, 260, 350, 440, 530, 940, 1187, 1624, 1766, 2391, 2579, 3169, 3372, 3585]","[0, 170, 260, 394, 725, 815, 905, 1165, 1593, 2086, 2900, 3231, 3411, 3966, 4316]",6864,5537,5949,3585,4316,-1546,-1442,-180,-386,-1266,-4820,15,dire
7604869804,49,123,17,96,21,"[0, 205, 533, 1073, 1319, 1734, 1896, 2519, 2984, 3546, 4148, 4779, 5254, 5811, 6576]","[0, 565, 706, 796, 986, 1406, 1496, 1902, 2328, 2433, 2772, 3207, 3614, 4110, 4426]","[0, 288, 460, 744, 1046, 1452, 1702, 2100, 2526, 3073, 3804, 4416, 4843, 5437, 6011]","[0, 297, 457, 774, 1103, 1584, 1914, 2572, 2953, 3397, 4070, 4897, 5607, 6351, 6979]","[0, 430, 544, 988, 1078, 1209, 1333, 1519, 1970, 2136, 2584, 3271, 3514, 4041, 4625]",6576,4426,6011,6979,4625,138,22,19,79,91,"[0, 170, 377, 657, 1067, 1308, 1634, 2061, 2548, 2875, 3487, 4091, 4461, 4871, 5640]","[0, 280, 612, 1030, 1471, 1965, 2417, 2871, 3471, 3965, 4641, 4731, 5348, 5848, 6036]","[0, 325, 530, 656, 1365, 1723, 1902, 2037, 2467, 2727, 3204, 3333, 4180, 4520, 4616]","[0, 170, 260, 350, 515, 680, 1103, 1238, 1472, 1690, 1906, 2152, 2326, 2520, 2815]","[0, 170, 260, 350, 560, 725, 861, 1044, 1328, 1418, 1598, 1743, 1835, 1931, 2032]",5640,6036,4616,2815,2032,936,-1610,1395,4164,2593,7478,15,radiant
7604869900,12,13,98,9,26,"[0, 278, 549, 861, 1263, 1547, 2258, 2522, 3080, 3683, 4122, 4790, 5275, 5942, 6323]","[0, 284, 621, 1030, 1447, 1828, 2267, 2775, 3401, 3743, 4078, 4783, 5010, 5105, 5506]","[0, 206, 499, 1154, 1598, 2265, 2633, 3152, 3673, 4064, 4621, 5444, 6076, 6322, 6643]","[0, 220, 378, 503, 633, 772, 972, 1062, 1478, 1613, 2146, 2571, 2830, 3067, 3162]","[0, 169, 259, 441, 615, 872, 962, 1123, 1322, 1457, 1966, 2211, 2301, 2547, 2681]",6323,5506,6643,3162,2681,41,120,112,19,20,"[0, 242, 552, 1066, 1493, 1945, 2265, 2628, 2941, 3376, 3535, 3847, 4423, 5135, 5637]","[0, 316, 750, 1147, 1525, 1975, 2137, 2775, 3688, 4144, 4481, 5178, 5594, 6611, 7052]","[0, 169, 598, 866, 1198, 1439, 1649, 2077, 2406, 2713, 3066, 3585, 3992, 4441, 5027]","[0, 169, 301, 391, 521, 682, 790, 971, 1189, 1447, 1613, 1941, 2054, 2731, 2880]","[0, 169, 259, 464, 635, 995, 1085, 1175, 1709, 2282, 2493, 2722, 2812, 3308, 3457]",5637,7052,5027,2880,3457,686,-1546,1616,282,-776,262,15,radiant
7604962313,98,19,41,45,83,"[0, 213, 501, 828, 1028, 1680, 2066, 2325, 3069, 3430, 3614, 4132, 4622, 5139, 5616]","[0, 325, 730, 1127, 1458, 1720, 1975, 2289, 2556, 3094, 3713, 4233, 4429, 4747, 5061]","[0, 212, 492, 690, 865, 1159, 1532, 1911, 2286, 3079, 4127, 4632, 5104, 5252, 5447]","[0, 130, 267, 451, 541, 860, 1246, 1336, 1655, 2188, 2684, 3050, 3263, 3658, 3753]","[0, 130, 220, 310, 400, 538, 673, 809, 1128, 1218, 1644, 1854, 1944, 2166, 2261]",5616,5061,5447,3753,2261,70,74,104,53,86,"[60, 385, 702, 1078, 1545, 1826, 2473, 3310, 3726, 4533, 5118, 5674, 6609, 7543, 8602]","[60, 390, 776, 1024, 1428, 1739, 2116, 2537, 3165, 3545, 3758, 3896, 4541, 5063, 5914]","[60, 345, 618, 814, 1402, 1920, 2524, 2747, 3280, 3406, 3934, 4097, 4699, 5793, 6310]","[328, 538, 658, 854, 1009, 1169, 1350, 1516, 1775, 1950, 2075, 2223, 2465, 3047, 3422]","[60, 270, 434, 568, 704, 1017, 1396, 1566, 1702, 1872, 1962, 2124, 2366, 3164, 3616]",8602,5914,6310,3422,3616,-2986,-853,-863,331,-1355,-5726,15,dire
7605068005,10,23,136,57,20,"[0, 273, 470, 835, 1340, 1706, 2180, 2477, 2982, 3343, 3879, 4508, 5102, 5775, 6327]","[0, 374, 740, 1274, 1402, 1994, 2428, 2743, 3328, 3770, 4573, 5338, 5885, 6211, 6761]","[0, 251, 570, 815, 1157, 1527, 1768, 2172, 2357, 2634, 3053, 3324, 3896, 4189, 4580]","[0, 170, 260, 350, 489, 579, 669, 759, 1119, 1209, 1344, 1686, 2196, 2713, 3110]","[0, 170, 260, 350, 440, 578, 668, 758, 980, 1165, 1481, 1742, 1844, 2140, 2427]",6327,6761,4580,3110,2427,1,74,96,26,105,"[0, 257, 531, 946, 1076, 1609, 1966, 2448, 3037, 3582, 3920, 4516, 4803, 5372, 5907]","[0, 208, 528, 864, 1383, 1680, 2097, 2630, 2945, 3368, 3657, 4119, 4440, 4715, 5019]","[0, 504, 742, 1089, 1340, 1804, 2070, 2354, 2668, 3038, 3369, 3587, 4067, 4370, 4666]","[0, 288, 416, 506, 683, 888, 1023, 1177, 1267, 1402, 1539, 1629, 1883, 2371, 2504]","[0, 236, 326, 416, 546, 737, 872, 1101, 1191, 1382, 1520, 1610, 1771, 2402, 2497]",5907,5019,4666,2504,2497,420,1742,-86,606,-70,2612,15,dire
7605460614,18,120,57,112,20,"[0, 279, 633, 968, 1281, 1490, 1966, 2413, 2675, 2951, 3755, 4569, 5234, 6041, 7210]","[0, 248, 539, 752, 1334, 1677, 2016, 2648, 3111, 3562, 4230, 5044, 5756, 6005, 7259]","[0, 209, 495, 913, 1222, 1611, 2008, 2538, 2861, 3751, 3956, 4437, 4784, 4968, 5570]","[0, 170, 260, 435, 525, 651, 811, 1215, 1305, 1395, 1768, 2923, 3108, 3315, 3657]","[0, 170, 260, 397, 841, 1009, 1275, 1529, 1783, 1956, 2215, 2667, 2801, 2995, 3441]",7210,7259,5570,3657,3441,49,136,12,121,91,"[0, 279, 595, 1026, 1259, 1590, 2047, 2485, 2970, 3688, 3963, 4624, 5049, 5962, 6223]","[0, 240, 608, 904, 1303, 1858, 2516, 2851, 3520, 4170, 4802, 5071, 5317, 5924, 6226]","[0, 296, 492, 777, 1182, 1636, 1863, 2172, 2636, 3178, 3451, 3887, 4275, 5097, 5727]","[0, 170, 260, 451, 590, 912, 1006, 1122, 1556, 1905, 2410, 2748, 2838, 3489, 3584]","[0, 170, 260, 350, 486, 743, 1004, 1094, 1721, 2151, 2463, 2721, 2821, 3209, 3339]",6223,6226,5727,3584,3339,987,1033,-157,73,102,2038,15,dire
7605501015,1,98,19,40,88,"[0, 207, 480, 800, 1243, 1806, 2449, 2847, 3169, 3650, 4271, 4927, 5227, 5925, 6534]","[0, 329, 648, 936, 1347, 1939, 2157, 2842, 3113, 3759, 4775, 5009, 6105, 6894, 7090]","[0, 282, 532, 937, 1396, 1568, 2039, 2366, 2851, 3112, 3859, 4366, 4913, 5439, 5745]","[0, 170, 260, 394, 620, 792, 1165, 1340, 1505, 1678, 2486, 2720, 2810, 3048, 3296]","[0, 170, 304, 394, 571, 661, 815, 1159, 1549, 1686, 2027, 2747, 2950, 3250, 3345]",6534,7090,5745,3296,3345,17,41,104,65,20,"[0, 280, 605, 1052, 1502, 1968, 2135, 2305, 2881, 3090, 3664, 4607, 4973, 5613, 6139]","[0, 206, 497, 798, 1166, 1381, 1581, 1831, 2136, 2311, 2755, 3403, 3644, 4152, 4499]","[0, 244, 450, 687, 1363, 1492, 1997, 2348, 2807, 3217, 3605, 4090, 4951, 5519, 6032]","[0, 213, 303, 393, 591, 681, 898, 1500, 1916, 2051, 2229, 2570, 2741, 3056, 3541]","[0, 170, 260, 350, 525, 741, 914, 1306, 1521, 1656, 2065, 2344, 2581, 2935, 3366]",6139,4499,6032,3541,3366,395,2591,-287,-245,-21,2433,15,radiant
7605620914,114,90,97,19,20,"[0, 329, 586, 1020, 1382, 1557, 2141, 2486, 3349, 3732, 4197, 4542, 5045, 5676, 5975]","[0, 285, 652, 818, 1234, 1607, 2019, 2875, 3728, 4317, 4746, 5248, 5644, 5878, 6061]","[0, 240, 445, 804, 1160, 1660, 2083, 2322, 2631, 3142, 3624, 4307, 4798, 5234, 5764]","[0, 169, 259, 379, 519, 655, 792, 1078, 1388, 1659, 2056, 2200, 2336, 2485, 2969]","[0, 269, 359, 524, 663, 753, 921, 1235, 1625, 1715, 2119, 2263, 2500, 2649, 2744]",5975,6061,5764,2969,2744,38,93,137,66,86,"[0, 169, 454, 844, 1493, 1843, 2194, 2649, 3334, 3754, 4470, 5077, 5691, 6757, 7591]","[0, 246, 441, 736, 994, 1526, 1862, 2301, 2732, 3173, 3660, 4251, 4817, 5237, 5926]","[0, 284, 605, 1193, 1651, 2067, 2625, 3071, 3491, 4176, 4686, 4776, 5293, 5725, 6493]","[0, 220, 310, 445, 596, 850, 1052, 1268, 1523, 1855, 2251, 2712, 2978, 3271, 3682]","[0, 169, 295, 472, 676, 920, 1085, 1258, 1568, 1777, 2181, 2516, 2606, 2900, 3744]",7591,5926,6493,3682,3744,-1616,135,-729,-713,-1000,-3923,15,dire
7605720616,120,129,114,40,26,"[0, 326, 689, 1013, 1347, 1862, 2191, 2559, 3048, 3462, 3949, 4329, 4802, 5378, 5981]","[0, 284, 651, 1016, 1230, 1796, 2202, 2620, 3136, 3794, 4351, 4865, 5337, 6049, 6344]","[0, 289, 456, 828, 1234, 1474, 1740, 2226, 2586, 3071, 3466, 3835, 4140, 4943, 5274]","[0, 169, 259, 399, 489, 619, 831, 1398, 1488, 1681, 1816, 1953, 2043, 2346, 2514]","[0, 169, 259, 349, 524, 745, 835, 974, 1064, 1448, 1629, 1729, 1819, 2102, 2235]",5981,6344,5274,2514,2235,73,43,137,19,121,"[0, 330, 663, 1098, 1528, 1658, 2058, 2703, 3600, 3952, 4307, 4998, 5824, 6732, 7551]","[0, 203, 735, 1122, 1680, 2061, 2477, 2952, 3404, 4168, 4563, 5036, 6179, 6509, 7090]","[0, 333, 702, 1064, 1343, 1695, 2148, 2558, 3006, 3242, 3760, 4434, 5176, 5921, 6302]","[0, 169, 324, 414, 675, 765, 855, 1184, 1324, 1767, 1966, 2165, 2588, 2885, 3131]","[0, 169, 298, 501, 746, 853, 1051, 1445, 1585, 1725, 1859, 2003, 2401, 2837, 3026]",7551,7090,6302,3131,3026,-1570,-746,-1028,-617,-791,-4752,15,dire
7605901606,22,10,96,9,20,"[0, 326, 698, 1113, 1447, 1894, 2473, 3075, 3776, 4413, 4808, 5703, 6223, 7042, 7627]","[0, 242, 483, 743, 1031, 1282, 1447, 2257, 2455, 3054, 3509, 3832, 3971, 4496, 4892]","[0, 292, 604, 1509, 1801, 2233, 2556, 2936, 3286, 3692, 4317, 4716, 5041, 5425, 5575]","[0, 170, 260, 510, 648, 773, 963, 1142, 1296, 1540, 1856, 2123, 2851, 3155, 3528]","[0, 170, 260, 413, 536, 912, 1041, 1413, 1574, 1843, 2070, 2608, 2710, 2912, 3055]",7627,4892,5575,3528,3055,1,13,49,86,68,"[0, 291, 526, 820, 1232, 1515, 1990, 2445, 2758, 3046, 3502, 3919, 4387, 4805, 5238]","[0, 332, 605, 962, 1374, 1811, 2308, 2610, 3230, 3569, 4099, 4653, 5586, 6005, 6664]","[0, 207, 477, 712, 891, 1387, 1608, 2027, 2242, 2369, 2539, 3219, 3495, 4038, 4402]","[0, 218, 308, 428, 518, 913, 1048, 1138, 1228, 1693, 1878, 2440, 3091, 3347, 4186]","[0, 170, 260, 380, 518, 654, 855, 990, 1080, 1425, 1560, 1650, 1740, 2169, 2419]",5238,6664,4402,4186,2419,2389,-1772,1173,-658,636,1768,15,radiant
7606077915,95,120,128,92,31,"[57, 233, 512, 836, 1041, 1610, 2140, 2360, 2665, 2932, 3199, 3999, 4418, 4893, 5259]","[57, 221, 502, 746, 1116, 1456, 1812, 2124, 2467, 2852, 2942, 3723, 4182, 4510, 5078]","[325, 455, 733, 905, 1249, 1655, 2154, 2414, 2633, 3064, 3503, 3895, 4653, 4847, 5145]","[57, 237, 327, 640, 730, 908, 1414, 1713, 1965, 2104, 2389, 2924, 3275, 3434, 3860]","[57, 187, 277, 367, 457, 685, 868, 1003, 1093, 1183, 1273, 1787, 2050, 2145, 2451]",5259,5078,5145,3860,2451,15,74,57,85,20,"[0, 623, 783, 1292, 1534, 1860, 2384, 2867, 3359, 3961, 4394, 4852, 5379, 5983, 6407]","[0, 396, 870, 1129, 1722, 2159, 2642, 3124, 3750, 4195, 4578, 5237, 5691, 6174, 6356]","[0, 244, 535, 854, 1538, 1789, 1918, 2381, 2994, 3567, 4070, 4240, 4825, 5421, 6049]","[0, 418, 508, 678, 768, 945, 1388, 1568, 1715, 2040, 2434, 2649, 2879, 3082, 3177]","[0, 312, 457, 593, 853, 983, 1073, 1253, 1523, 1758, 1893, 2062, 2326, 2576, 2718]",6407,6356,6049,3177,2718,-1148,-1278,-904,683,-267,-2914,15,dire
7606128700,48,135,39,5,26,"[0, 348, 512, 944, 1231, 1720, 2119, 2738, 3417, 4134, 4835, 5200, 5885, 7251, 7918]","[0, 364, 571, 785, 1185, 1839, 2185, 2775, 3263, 3582, 4339, 4911, 5638, 5995, 6651]","[0, 1153, 1468, 1939, 2221, 3007, 3516, 3921, 4383, 4906, 5259, 5600, 6230, 6595, 6863]","[0, 307, 444, 534, 795, 1058, 1197, 1466, 1942, 2091, 2467, 2884, 3303, 3452, 3801]","[0, 344, 434, 524, 698, 1333, 1423, 1665, 1920, 2118, 2404, 2494, 2809, 3137, 3309]",7918,6651,6863,3801,3309,73,74,96,105,79,"[0, 279, 588, 953, 1306, 1568, 1979, 2289, 2884, 3527, 4373, 4805, 5483, 6261, 7052]","[0, 537, 756, 1170, 1502, 1995, 2252, 2737, 3119, 3536, 3784, 3993, 4382, 4903, 5328]","[0, 373, 622, 1106, 1514, 1826, 2189, 2636, 2876, 3166, 3895, 4308, 4449, 5119, 5292]","[0, 129, 348, 438, 622, 1083, 1173, 1263, 1483, 1573, 1756, 2050, 2285, 2558, 2881]","[0, 304, 394, 531, 686, 864, 954, 1044, 1184, 1350, 1642, 1947, 2037, 2377, 2520]",7052,5328,5292,2881,2520,866,1323,1571,920,789,5469,15,radiant
7606260002,73,21,28,45,26,"[0, 366, 833, 1212, 1631, 2058, 2379, 3066, 3338, 3772, 4976, 5667, 6517, 7868, 8460]","[0, 260, 591, 1000, 1708, 2038, 2467, 2557, 3314, 4208, 4779, 5686, 6178, 6736, 7257]","[0, 369, 497, 972, 1319, 1611, 1990, 2151, 2432, 2649, 3085, 3669, 4016, 4662, 5158]","[0, 364, 454, 544, 681, 771, 1131, 1337, 1427, 1945, 2463, 2706, 3171, 3904, 4279]","[0, 210, 344, 434, 572, 708, 798, 937, 1340, 1677, 2204, 2702, 2888, 3138, 3415]",8460,7257,5158,4279,3415,98,15,106,65,83,"[0, 503, 830, 1131, 1452, 1652, 2019, 2487, 3053, 3600, 4069, 4691, 5136, 5816, 6259]","[0, 198, 420, 630, 765, 1002, 1328, 1577, 2048, 2471, 2852, 3268, 3433, 3863, 4225]","[0, 322, 572, 1034, 1159, 1531, 2019, 2614, 3345, 3509, 4136, 4646, 5029, 5473, 5622]","[0, 198, 288, 412, 825, 955, 1568, 1835, 1973, 2063, 2312, 2678, 2942, 3281, 3790]","[0, 198, 288, 423, 513, 643, 733, 880, 1288, 1421, 1654, 1834, 2054, 2317, 2601]",6259,4225,5622,3790,2601,2201,3032,-464,489,814,6072,15,dire
7606268617,44,17,129,86,121,"[0, 239, 911, 1302, 1548, 1793, 2291, 2833, 3042, 3672, 4158, 4809, 5283, 5957, 6798]","[0, 222, 475, 745, 1117, 1583, 1953, 2491, 2743, 3039, 3543, 4693, 5316, 5851, 6792]","[0, 154, 439, 801, 1056, 1237, 1409, 1589, 1950, 2330, 2942, 3209, 3943, 4598, 5200]","[0, 227, 383, 473, 610, 758, 1092, 1594, 1955, 2811, 3381, 3833, 4030, 4387, 5106]","[0, 255, 433, 606, 708, 916, 1361, 1754, 1844, 2246, 2530, 3059, 3945, 4303, 4917]",6798,6792,5200,5106,4917,46,90,58,97,123,"[111, 435, 666, 1093, 1429, 1970, 2448, 3368, 3894, 4448, 5222, 5561, 6579, 7071, 7851]","[244, 539, 925, 1294, 1678, 2063, 2404, 3335, 3764, 4314, 5142, 5569, 5946, 6641, 6842]","[379, 588, 678, 817, 1329, 1486, 1639, 2200, 2533, 2795, 3703, 3838, 3938, 4198, 4475]","[111, 354, 643, 1111, 1610, 1989, 2306, 2714, 3010, 3519, 3873, 4414, 4829, 5349, 5549]","[111, 320, 410, 584, 720, 810, 959, 1189, 1409, 1575, 1745, 1963, 2090, 2338, 2732]",7851,6842,4475,5549,2732,-1053,-50,725,-443,2185,1364,15,radiant
7606543711,18,65,104,121,84,"[0, 333, 653, 1050, 1373, 1775, 2192, 2940, 3353, 3725, 4583, 5323, 5894, 6697, 7460]","[0, 170, 378, 763, 1040, 1363, 1615, 2024, 2235, 3106, 3785, 4159, 4853, 5437, 6044]","[0, 323, 488, 811, 1232, 1710, 1871, 1961, 2535, 3256, 3640, 3944, 4084, 4575, 4823]","[0, 170, 260, 437, 616, 1112, 1202, 1292, 1382, 1620, 1875, 2020, 2114, 2361, 2709]","[0, 170, 260, 405, 535, 671, 859, 989, 1079, 1169, 1625, 1857, 1947, 2091, 2507]",7460,6044,4823,2709,2507,123,106,11,97,93,"[0, 202, 570, 1088, 1505, 1915, 2206, 2499, 2876, 3220, 3650, 4154, 4856, 5491, 6293]","[0, 253, 584, 871, 1367, 1774, 2373, 3433, 3841, 4149, 4438, 4996, 5556, 6272, 6683]","[0, 199, 862, 1332, 1776, 2340, 2751, 3399, 3802, 4394, 5026, 5597, 6424, 6728, 8027]","[0, 130, 296, 592, 729, 952, 1042, 1332, 1477, 1626, 1851, 2006, 2276, 2524, 3047]","[0, 130, 220, 422, 512, 651, 741, 876, 1011, 1101, 1326, 1462, 1955, 2169, 2626]",6293,6683,8027,3047,2626,1167,-639,-3204,-338,-119,-3133,15,radiant
7606777810,21,97,49,45,20,"[0, 253, 545, 955, 1664, 2439, 3084, 3734, 4505, 5492, 6030, 6576, 7686, 8094, 9258]","[0, 294, 607, 1088, 1634, 1882, 2363, 2890, 3525, 4049, 4644, 5121, 6130, 7418, 8096]","[0, 209, 467, 744, 999, 1326, 1848, 2135, 2766, 3244, 4319, 4885, 5630, 6383, 6671]","[0, 345, 435, 573, 815, 1154, 1322, 1456, 1681, 1901, 2475, 2565, 3113, 3666, 4092]","[0, 130, 220, 310, 400, 534, 707, 797, 1022, 1159, 1525, 1615, 2036, 2300, 3164]",9258,8096,6671,4092,3164,73,74,129,86,128,"[0, 387, 588, 810, 1270, 1726, 2106, 2567, 3248, 3603, 4034, 4679, 5199, 5726, 6025]","[0, 260, 516, 779, 988, 1450, 1660, 1785, 2038, 2205, 2435, 2697, 2787, 3234, 3646]","[0, 261, 509, 747, 1319, 1720, 1965, 2443, 3018, 3194, 3370, 3723, 3813, 4434, 4760]","[0, 494, 609, 762, 976, 1239, 1377, 1591, 1906, 1996, 2169, 2313, 2564, 3584, 3895]","[0, 274, 409, 563, 878, 1048, 1398, 1535, 1715, 1939, 2229, 2373, 2483, 3041, 3264]",6025,3646,4760,3895,3264,3233,4450,1911,197,-100,9691,15,radiant
7606980009,67,36,20,53,105,"[0, 169, 575, 894, 1286, 1491, 1878, 2292, 2751, 3011, 3469, 3643, 4603, 5029, 5568]","[0, 165, 456, 775, 1022, 1146, 1307, 1561, 1651, 2248, 2447, 3154, 3904, 4211, 4931]","[0, 242, 549, 825, 1328, 1759, 1957, 2554, 2778, 3083, 3306, 3568, 4133, 4227, 5083]","[0, 130, 220, 465, 677, 811, 1150, 1471, 1605, 1695, 1868, 2292, 2644, 2821, 3453]","[0, 130, 586, 713, 1262, 1598, 1722, 2440, 2594, 2763, 2853, 2943, 3510, 3719, 4115]",5568,4931,5083,3453,4115,43,21,92,19,100,"[0, 374, 820, 1073, 1562, 2201, 2550, 3216, 4002, 4379, 4938, 5532, 5914, 6859, 7317]","[0, 267, 567, 783, 1069, 1159, 1625, 1817, 2466, 2889, 3772, 4202, 4852, 5634, 6405]","[0, 305, 593, 863, 1173, 1592, 1977, 2366, 2672, 3050, 3628, 4350, 5052, 5692, 6038]","[0, 246, 373, 463, 597, 807, 1027, 1117, 1333, 1778, 2158, 2649, 2778, 3095, 3319]","[0, 636, 1020, 1205, 1295, 1385, 2076, 2166, 2465, 2665, 3236, 3604, 3694, 4066, 4471]",7317,6405,6038,3319,4471,-1749,-1474,-955,134,-356,-4400,15,radiant
7607064506,54,120,81,136,68,"[0, 292, 567, 812, 1214, 1605, 2002, 2238, 2676, 2978, 3467, 4006, 4303, 4398, 4694]","[324, 570, 861, 997, 1288, 1717, 2051, 2466, 2870, 3153, 3560, 4075, 4165, 4629, 4993]","[56, 225, 463, 656, 792, 922, 1136, 1638, 1975, 2149, 2273, 3303, 3518, 3613, 3807]","[56, 225, 315, 442, 577, 746, 995, 1291, 1381, 1471, 1768, 2784, 2874, 2984, 3487]","[56, 225, 315, 405, 541, 718, 855, 945, 1083, 1173, 1309, 1552, 1642, 1789, 1984]",4694,4993,3807,3487,1984,48,13,29,20,105,"[0, 169, 581, 941, 1705, 2415, 2746, 3070, 3717, 4547, 5027, 5538, 6094, 7034, 7810]","[0, 203, 472, 693, 961, 1256, 1504, 2400, 2784, 3025, 3723, 3813, 4631, 5602, 6431]","[0, 169, 524, 880, 1239, 1626, 2028, 2437, 2856, 3179, 3597, 4068, 4565, 5179, 5636]","[0, 169, 259, 349, 580, 1006, 1096, 1357, 1584, 1984, 2513, 2603, 3148, 3586, 3681]","[0, 169, 259, 395, 660, 750, 885, 1019, 1244, 1471, 1679, 1816, 2221, 2693, 2834]",7810,6431,5636,3681,2834,-3116,-1438,-1829,-194,-850,-7427,15,dire
7607071600,18,129,120,79,86,"[0, 242, 509, 813, 1264, 1562, 1852, 2204, 2734, 3178, 3957, 4695, 5548, 6098, 7020]","[0, 249, 412, 692, 1200, 1488, 1749, 2015, 2275, 2514, 2849, 3182, 3625, 4302, 4741]","[0, 344, 664, 965, 1402, 1788, 2309, 2654, 3275, 3660, 3971, 4478, 5393, 5816, 6625]","[0, 170, 599, 689, 857, 986, 1076, 1211, 1526, 1711, 1902, 2008, 2412, 2627, 3159]","[0, 170, 260, 385, 636, 979, 1126, 1406, 1604, 1900, 2221, 2465, 2764, 3015, 3344]",7020,4741,6625,3159,3344,95,106,49,123,64,"[0, 243, 605, 856, 1469, 1829, 2390, 2889, 3301, 3757, 4342, 4839, 5510, 6024, 6612]","[0, 328, 733, 1120, 1567, 1840, 2211, 2704, 3169, 3522, 3908, 4399, 4699, 5014, 5582]","[0, 170, 453, 672, 1087, 1349, 1666, 2159, 2402, 2788, 3227, 3516, 4213, 4714, 5292]","[0, 170, 260, 413, 543, 719, 809, 1188, 1278, 1605, 1928, 2124, 2286, 2642, 2869]","[0, 170, 260, 395, 525, 692, 905, 1103, 1193, 1559, 1739, 1867, 2005, 2154, 2293]",6612,5582,5292,2869,2293,408,-841,1333,290,1051,2241,15,radiant
7607094907,16,89,107,75,50,"[73, 240, 561, 1188, 1530, 1992, 2321, 2987, 3634, 3798, 4095, 4432, 4919, 5138, 5581]","[0, 291, 516, 606, 888, 1017, 1622, 1927, 2270, 2397, 2757, 3221, 3744, 4181, 4721]","[73, 354, 634, 856, 1406, 1829, 2721, 3259, 3739, 3979, 4646, 5547, 5876, 6414, 7040]","[206, 336, 426, 516, 843, 933, 1161, 1423, 1552, 1642, 2404, 3206, 3886, 4431, 4748]","[73, 203, 293, 655, 745, 862, 1229, 1610, 1780, 1870, 2004, 2231, 2778, 3391, 3885]",5581,4721,7040,4748,3885,71,93,19,85,64,"[176, 388, 730, 1195, 1419, 1888, 2018, 2724, 2972, 3443, 3770, 4450, 4865, 5172, 5918]","[178, 459, 732, 1052, 1385, 1594, 1759, 2171, 2467, 3108, 3505, 3916, 4158, 4533, 4872]","[121, 402, 634, 919, 1203, 1534, 1889, 2196, 2654, 3449, 4029, 4280, 4370, 4648, 4968]","[178, 388, 478, 831, 961, 1051, 1225, 1561, 1763, 3182, 3362, 3452, 3759, 3925, 4020]","[712, 924, 1014, 1317, 1447, 1671, 1891, 2314, 2569, 2845, 3078, 3335, 3489, 3584, 3965]",5918,4872,4968,4020,3965,-337,-151,2072,728,-80,2232,15,radiant
7607217700,35,29,114,86,100,"[0, 164, 522, 651, 897, 1144, 1328, 1564, 2154, 2886, 3141, 4045, 4135, 4317, 4505]","[0, 249, 470, 806, 1208, 1408, 1626, 2201, 2521, 3215, 3511, 4070, 4321, 4732, 5037]","[0, 209, 492, 617, 1037, 1161, 1383, 1713, 1877, 2055, 2241, 2527, 2785, 3214, 3567]","[0, 129, 346, 436, 575, 665, 965, 1395, 1485, 1815, 1989, 2290, 2451, 2677, 2772]","[0, 129, 244, 334, 424, 548, 963, 1053, 1606, 1784, 1874, 2323, 2413, 2508, 2603]",4505,5037,3567,2772,2603,113,14,63,119,87,"[110, 354, 603, 846, 1104, 1311, 1815, 2108, 2564, 3385, 4104, 4988, 5618, 6339, 7199]","[186, 434, 682, 1576, 1700, 2123, 2707, 3128, 3784, 4410, 5196, 5946, 6700, 6939, 7628]","[110, 319, 670, 973, 1377, 1870, 2220, 2452, 2941, 3157, 3863, 4494, 5218, 5962, 6886]","[378, 587, 713, 970, 1208, 1347, 1701, 1791, 2013, 2531, 2962, 3851, 4338, 4814, 5484]","[110, 319, 604, 694, 784, 984, 1189, 1279, 1650, 1830, 1994, 2489, 2688, 3019, 3431]",7199,7628,6886,5484,3431,-2694,-2591,-3319,-2712,-828,-12144,15,dire
7607360702,113,93,28,45,112,"[0, 370, 583, 1031, 1308, 1693, 2062, 2676, 2978, 3737, 4395, 4974, 5758, 6392, 6853]","[0, 321, 647, 976, 1172, 1815, 2320, 2779, 3102, 3719, 4570, 5469, 6212, 6921, 7148]","[0, 245, 455, 667, 1196, 1618, 2092, 2353, 3040, 3503, 4010, 4455, 5149, 5794, 6365]","[0, 210, 396, 525, 698, 1095, 1507, 1642, 1971, 2202, 2723, 2903, 3227, 3635, 4138]","[0, 210, 300, 390, 575, 854, 1277, 1412, 1706, 1932, 2116, 2342, 2908, 3280, 3429]",6853,7148,6365,4138,3429,106,18,29,14,87,"[0, 239, 624, 912, 1209, 1764, 2332, 2881, 3391, 3529, 4305, 4668, 4878, 5321, 5840]","[0, 169, 378, 688, 851, 951, 1086, 1465, 1742, 2212, 2591, 3195, 3636, 3855, 4745]","[0, 203, 703, 844, 1069, 1559, 1740, 1951, 2388, 2768, 3146, 3810, 4207, 4489, 5001]","[0, 130, 325, 433, 691, 869, 1004, 1238, 1458, 2010, 2145, 2281, 2419, 2661, 2953]","[0, 130, 250, 386, 515, 626, 761, 897, 1247, 1337, 1643, 1836, 1952, 2060, 2405]",5840,4745,5001,2953,2405,1013,2403,1364,1185,1024,6989,15,radiant
7607426114,48,78,13,86,138,"[0, 286, 531, 1064, 1564, 1901, 2532, 2975, 3345, 3875, 4257, 4698, 5637, 6184, 6985]","[0, 170, 438, 747, 994, 1202, 1329, 1654, 1988, 2352, 2706, 3296, 4264, 4791, 5343]","[0, 312, 551, 820, 1152, 1416, 1634, 1945, 2476, 2995, 3587, 3901, 4394, 5171, 5507]","[0, 170, 307, 427, 662, 801, 994, 1454, 1718, 1931, 2180, 2308, 2715, 3178, 3348]","[0, 170, 260, 380, 600, 726, 816, 951, 1375, 1515, 1650, 1815, 2338, 2820, 3118]",6985,5343,5507,3348,3118,21,98,19,100,26,"[0, 542, 971, 1339, 1713, 2124, 2537, 2863, 3439, 3757, 4150, 4577, 4667, 5055, 5648]","[0, 204, 499, 783, 1028, 1362, 1659, 1874, 2114, 2537, 3054, 3535, 3970, 4645, 5238]","[0, 256, 604, 921, 1221, 1549, 2176, 2795, 3150, 3753, 4096, 4458, 4893, 5088, 5433]","[0, 239, 354, 489, 624, 800, 935, 1101, 1281, 1371, 1687, 1899, 2131, 2489, 2584]","[0, 170, 285, 410, 581, 759, 894, 1060, 1195, 1550, 1703, 1832, 2026, 2203, 2500]",5648,5238,5433,2584,2500,1337,105,74,764,618,2898,15,radiant
7607461619,14,13,53,107,31,"[0, 244, 554, 802, 1523, 2074, 2534, 2869, 3563, 3809, 4787, 5376, 5770, 6396, 7162]","[0, 203, 486, 853, 1144, 1626, 1867, 2339, 3062, 3486, 4170, 4643, 5140, 5372, 6064]","[0, 213, 407, 497, 782, 872, 1127, 1343, 1526, 1616, 1968, 2600, 2962, 3664, 4314]","[0, 130, 316, 557, 687, 812, 976, 1220, 1527, 1927, 2435, 3066, 3267, 3663, 4240]","[0, 481, 623, 761, 1101, 1319, 1843, 2202, 2605, 2695, 3340, 3888, 4316, 4536, 5239]",7162,6064,4314,4240,5239,15,120,21,20,91,"[0, 210, 471, 752, 1185, 1618, 1979, 2637, 3074, 3594, 4122, 4850, 5374, 6159, 6733]","[0, 281, 533, 833, 1285, 1617, 2097, 2715, 3169, 3954, 4526, 5063, 5402, 5984, 6334]","[0, 295, 578, 814, 904, 1356, 1939, 2403, 2762, 3126, 3793, 4165, 4844, 5463, 5929]","[0, 532, 622, 712, 802, 892, 1068, 1344, 1518, 2144, 2426, 2656, 2746, 2930, 3025]","[0, 210, 337, 427, 517, 624, 763, 981, 1117, 1256, 1538, 1834, 1930, 2163, 2293]",6733,6334,5929,3025,2293,429,-270,-1615,1215,2946,2705,15,radiant
7607666802,93,49,135,52,86,"[0, 283, 681, 967, 1341, 1678, 1992, 2400, 2683, 3117, 3630, 4151, 4539, 4688, 5451]","[0, 282, 702, 973, 1343, 1714, 2126, 2596, 2890, 3684, 4325, 4660, 5289, 5624, 6098]","[0, 331, 718, 976, 1382, 1681, 2359, 2630, 3073, 3725, 4404, 4959, 5165, 5860, 6435]","[100, 360, 1008, 1168, 1455, 1612, 1702, 1837, 1927, 2272, 2738, 2929, 3198, 3523, 3912]","[0, 210, 334, 428, 622, 821, 1025, 1406, 1496, 1781, 2159, 2591, 3064, 3389, 3574]",5451,6098,6435,3912,3574,109,98,137,27,45,"[0, 167, 524, 861, 1304, 1639, 1903, 2311, 2782, 3197, 3801, 4403, 4918, 5784, 6169]","[0, 178, 413, 655, 1060, 1443, 1838, 2008, 2489, 2949, 3399, 3919, 4095, 4863, 5275]","[0, 169, 586, 935, 1397, 1725, 2224, 2495, 2895, 3271, 3406, 3729, 4127, 4771, 5147]","[0, 165, 300, 440, 648, 784, 874, 1132, 1222, 1312, 1447, 1787, 2121, 2528, 2771]","[0, 130, 220, 356, 535, 699, 1064, 1366, 1456, 1773, 1987, 2233, 2476, 2840, 3083]",6169,5275,5147,2771,3083,-718,823,1288,1141,491,3025,15,dire
7607767417,41,28,35,123,26,"[0, 290, 502, 762, 1318, 1563, 2153, 2727, 3083, 3209, 3547, 3773, 4368, 4626, 5433]","[0, 531, 899, 1277, 1453, 1580, 2074, 2544, 3467, 3885, 4335, 4858, 5642, 6605, 7609]","[0, 263, 438, 642, 816, 1140, 1266, 1426, 1678, 2215, 2749, 3108, 3415, 3603, 4350]","[0, 228, 542, 632, 767, 857, 1133, 1359, 1535, 1625, 1805, 2018, 2360, 2548, 2838]","[0, 228, 318, 452, 622, 712, 898, 1247, 1386, 1476, 1656, 2039, 2129, 2314, 2643]",5433,7609,4350,2838,2643,98,19,95,60,37,"[0, 285, 574, 935, 1274, 1470, 1917, 2718, 3179, 3946, 4783, 5364, 5625, 6524, 6836]","[0, 254, 499, 949, 1290, 1699, 2112, 2531, 2965, 3337, 3928, 4626, 5033, 5395, 5797]","[0, 170, 344, 480, 570, 705, 887, 1131, 1355, 1937, 2624, 2898, 3107, 3552, 3864]","[0, 288, 460, 791, 1076, 1541, 1895, 2578, 2912, 3393, 3869, 4493, 5310, 5964, 6320]","[0, 206, 296, 386, 524, 998, 1181, 1404, 1584, 1710, 2292, 2766, 3084, 3936, 4085]",6836,5797,3864,6320,4085,-1403,1812,486,-3482,-1442,-4029,15,dire
7607899304,129,22,41,105,112,"[0, 210, 542, 788, 1343, 1589, 1897, 2379, 2625, 3014, 3397, 3637, 4064, 4494, 4912]","[0, 333, 753, 1163, 1451, 1947, 2683, 2945, 3471, 4176, 4655, 5502, 6065, 7261, 7669]","[0, 217, 620, 865, 1171, 1497, 1825, 2496, 2813, 3486, 3812, 4089, 4624, 5372, 5687]","[0, 170, 260, 350, 480, 617, 833, 1230, 1320, 1805, 1940, 2287, 2695, 2951, 3506]","[0, 170, 260, 350, 572, 662, 966, 1101, 1191, 1843, 1978, 2176, 2362, 2607, 2878]",4912,7669,5687,3506,2878,49,45,32,21,37,"[0, 218, 521, 1122, 1571, 2022, 2586, 3124, 3619, 3867, 4258, 5094, 5693, 6100, 6414]","[0, 254, 502, 873, 1199, 1541, 1960, 2406, 3112, 3293, 3624, 4195, 4664, 4922, 5475]","[0, 279, 548, 684, 890, 1307, 1604, 1929, 2534, 2850, 3352, 3697, 4066, 4247, 4801]","[0, 518, 608, 867, 1020, 1202, 1508, 1775, 1865, 2087, 2428, 2608, 2783, 3214, 3308]","[0, 170, 260, 350, 730, 865, 1002, 1137, 1528, 1755, 2085, 2544, 2781, 2941, 3139]",6414,5475,4801,3308,3139,-1502,2194,886,198,-261,1515,15,radiant
7608021100,52,93,129,9,112,"[0, 289, 577, 950, 1285, 2007, 2382, 3007, 3309, 3616, 4105, 4633, 5595, 6679, 7031]","[0, 286, 605, 821, 985, 1453, 1902, 2291, 2861, 3349, 3695, 4370, 5065, 5707, 6159]","[0, 283, 531, 807, 1122, 1412, 1695, 1996, 2365, 2869, 3336, 3848, 4588, 5128, 5859]","[0, 222, 361, 555, 741, 1062, 1214, 1502, 1592, 1682, 1868, 2297, 2604, 3122, 3498]","[100, 270, 404, 494, 584, 767, 857, 947, 1109, 1199, 1455, 1703, 1996, 2427, 2686]",7031,6159,5859,3498,2686,48,106,97,123,105,"[0, 251, 654, 1021, 1473, 2091, 2457, 3008, 3604, 4108, 4830, 5463, 6136, 6599, 7079]","[0, 324, 539, 986, 1279, 1602, 1856, 2109, 2684, 3207, 3677, 3871, 4362, 4885, 5421]","[0, 278, 602, 972, 1381, 1711, 1992, 2519, 3018, 3594, 4164, 4866, 5725, 5921, 6471]","[0, 170, 310, 430, 560, 688, 826, 1068, 1346, 1575, 1710, 1865, 2198, 2552, 2819]","[0, 170, 260, 380, 555, 764, 854, 1036, 1194, 1397, 1532, 1676, 1805, 1915, 2226]",7079,5421,6471,2819,2226,-48,738,-612,679,460,1217,15,radiant
7608027516,90,69,51,105,83,"[0, 289, 600, 968, 1097, 1421, 1716, 2688, 3115, 3432, 4269, 4633, 4809, 5428, 5806]","[0, 324, 610, 944, 1358, 1718, 2264, 2698, 3114, 3841, 4554, 4962, 5345, 5938, 6626]","[0, 243, 402, 691, 1072, 1442, 1690, 2116, 2724, 3348, 4107, 4333, 4710, 5419, 5722]","[0, 169, 337, 474, 582, 712, 802, 937, 1283, 1418, 1702, 1987, 2126, 2631, 2725]","[0, 169, 259, 349, 503, 682, 784, 1012, 1102, 1256, 1584, 1971, 2406, 2706, 2800]",5806,6626,5722,2725,2800,94,120,129,9,20,"[0, 213, 532, 910, 1335, 1674, 2129, 2524, 3039, 3329, 4009, 4836, 5419, 6060, 6833]","[0, 169, 415, 778, 1195, 1534, 1965, 2576, 3032, 3583, 4134, 4724, 5358, 5900, 6448]","[0, 217, 609, 904, 1278, 1620, 2029, 2357, 2650, 3040, 3224, 3971, 5002, 5605, 6504]","[0, 169, 374, 518, 1100, 1482, 1709, 1936, 2111, 2620, 2728, 3181, 3582, 3836, 4000]","[0, 169, 296, 386, 623, 713, 1066, 1228, 1318, 1408, 1702, 2174, 2687, 3008, 3253]",6833,6448,6504,4000,3253,-1027,178,-782,-1275,-453,-3359,15,dire
7608138213,18,129,23,105,58,"[0, 252, 573, 887, 1629, 1949, 2388, 2773, 3148, 3547, 4526, 5280, 5774, 6644, 7176]","[0, 215, 573, 1057, 1389, 1870, 2116, 2610, 2923, 3122, 3460, 4012, 4562, 5085, 5347]","[0, 250, 623, 921, 1168, 1574, 2066, 2585, 2703, 2925, 3491, 4004, 4543, 4935, 5137]","[0, 130, 220, 372, 507, 804, 985, 1217, 1437, 1540, 1945, 2115, 2205, 2504, 2661]","[0, 130, 220, 310, 493, 583, 703, 1104, 1194, 1319, 1803, 2063, 2442, 2653, 2748]",7176,5347,5137,2661,2748,98,128,41,136,79,"[0, 297, 739, 1061, 1361, 1824, 2233, 3148, 3614, 3988, 4743, 5326, 6101, 6546, 7849]","[0, 293, 579, 869, 1208, 1773, 2035, 2375, 2903, 3385, 4232, 4757, 5493, 5748, 6441]","[0, 317, 519, 609, 917, 1085, 1302, 1649, 1893, 2095, 2623, 2837, 3275, 3514, 4044]","[0, 210, 300, 435, 644, 1092, 1182, 1317, 1452, 1780, 2005, 2225, 2456, 2720, 3199]","[0, 210, 300, 406, 541, 671, 805, 960, 1065, 1155, 1533, 1841, 2066, 2468, 2798]",7849,6441,4044,3199,2798,-673,-1094,1093,-538,-50,-1262,15,radiant
7608344219,48,106,104,22,84,"[0, 322, 529, 940, 1335, 1785, 2366, 2735, 3307, 3701, 4318, 5004, 5698, 6223, 7002]","[0, 283, 611, 936, 1375, 1621, 1793, 2231, 2515, 2931, 3522, 4097, 4385, 4943, 5651]","[0, 328, 632, 1029, 1450, 1897, 2302, 3094, 3538, 3971, 4379, 4918, 5467, 5745, 6053]","[0, 169, 259, 407, 543, 739, 834, 1152, 1242, 1415, 1550, 1640, 1880, 2091, 2429]","[0, 169, 264, 402, 492, 640, 774, 1098, 1235, 1526, 1660, 1794, 2076, 2321, 2625]",7002,5651,6053,2429,2625,18,50,96,5,86,"[0, 251, 647, 1014, 1382, 1798, 2111, 2607, 3158, 3743, 4250, 4802, 5380, 5945, 6655]","[0, 239, 575, 890, 1264, 1712, 2172, 2684, 3094, 3547, 4110, 4523, 5201, 5722, 6469]","[0, 244, 681, 1009, 1473, 1812, 2274, 2672, 3271, 3828, 4216, 4636, 5022, 5379, 5883]","[0, 169, 259, 349, 596, 735, 825, 915, 1181, 1317, 1496, 1728, 1818, 1913, 2514]","[0, 169, 304, 440, 570, 786, 922, 1142, 1380, 1517, 1775, 1865, 2092, 2236, 2898]",6655,6469,5883,2514,2898,347,-818,170,-85,-273,-659,15,radiant
7608362808,48,23,49,27,102,"[0, 245, 496, 1054, 1450, 1749, 2136, 2476, 2955, 3335, 3853, 4536, 5317, 5825, 7009]","[0, 245, 592, 1074, 1284, 1452, 1824, 2333, 2749, 3004, 3516, 3963, 4395, 5231, 5878]","[0, 292, 602, 982, 1275, 1528, 2105, 2459, 2886, 3294, 3471, 4014, 4388, 5176, 5543]","[0, 209, 299, 487, 666, 891, 1148, 1336, 1472, 1892, 2276, 2741, 2921, 3511, 4087]","[0, 209, 444, 701, 822, 956, 1120, 1255, 1529, 1798, 2224, 2544, 2724, 3116, 3733]",7009,5878,5543,4087,3733,4,135,50,19,5,"[0, 164, 582, 964, 1370, 1760, 2296, 2826, 3188, 3476, 4005, 4480, 5209, 5915, 7043]","[0, 240, 488, 689, 1019, 1484, 1809, 2358, 2596, 3166, 3462, 3844, 4427, 4938, 5291]","[0, 520, 760, 1038, 1367, 1699, 2015, 2662, 3185, 3527, 3944, 4153, 4780, 4875, 5077]","[0, 129, 303, 476, 611, 895, 1020, 1292, 1382, 1546, 1636, 1772, 2282, 2430, 3012]","[0, 129, 244, 334, 516, 606, 696, 963, 1098, 1188, 1447, 1584, 1921, 2016, 2158]",7043,5291,5077,3012,2158,-34,587,466,1075,1575,3669,15,radiant
7608505603,18,106,98,86,5,"[0, 283, 654, 1041, 1460, 1878, 2247, 2851, 3463, 3972, 4652, 5394, 6186, 6961, 7716]","[0, 330, 532, 849, 1183, 1600, 1885, 2175, 2530, 2978, 3442, 3911, 4408, 4935, 5365]","[0, 241, 492, 826, 1307, 1715, 1998, 2088, 2620, 2758, 2927, 3296, 3472, 4123, 4374]","[0, 170, 260, 388, 737, 952, 1086, 1387, 1871, 2088, 2391, 2801, 2891, 3114, 3384]","[0, 170, 260, 461, 779, 914, 1004, 1094, 1263, 1353, 1708, 1937, 2038, 2186, 2366]",7716,5365,4374,3384,2366,70,76,71,14,3,"[0, 302, 637, 842, 1478, 1648, 2095, 2576, 2906, 3452, 4120, 4515, 4882, 5566, 6088]","[0, 286, 532, 934, 1264, 1558, 1731, 2272, 2697, 3040, 3552, 4032, 4662, 5234, 5780]","[0, 325, 639, 1098, 1614, 2026, 2472, 2893, 3267, 3608, 4036, 4384, 4840, 5490, 6107]","[0, 500, 653, 871, 1372, 1651, 2086, 2260, 2463, 2650, 3143, 3376, 3569, 3996, 4230]","[0, 232, 322, 412, 750, 1182, 1405, 1788, 2052, 2186, 2932, 3332, 3738, 3941, 4157]",6088,5780,6107,4230,4157,1628,-415,-1733,-846,-1791,-3157,15,radiant
7608725209,126,113,96,45,87,"[0, 326, 787, 1271, 1706, 2152, 2806, 3259, 3862, 4456, 5026, 5639, 6041, 6637, 7286]","[0, 321, 689, 1040, 1375, 1681, 2133, 2625, 2952, 3745, 4285, 5160, 5693, 6397, 6588]","[0, 284, 608, 889, 1343, 1696, 2232, 2410, 2800, 3099, 3562, 3868, 4275, 4633, 4728]","[0, 209, 299, 484, 659, 828, 1011, 1215, 1436, 1691, 2002, 2546, 2680, 2917, 3057]","[0, 209, 299, 436, 575, 731, 868, 1004, 1094, 1331, 1575, 1665, 1913, 2042, 2137]",7286,6588,4728,3057,2137,25,8,137,86,68,"[0, 253, 575, 948, 1393, 1817, 2258, 3040, 3380, 4108, 4592, 5381, 6161, 6739, 7477]","[0, 256, 578, 912, 1203, 1437, 1627, 2131, 2690, 3310, 4043, 4669, 4967, 5518, 6559]","[0, 506, 680, 1004, 1321, 1534, 1913, 2069, 2289, 2655, 3014, 3362, 4312, 4742, 5724]","[0, 129, 219, 309, 409, 874, 1082, 1172, 1993, 2646, 2864, 3258, 3714, 4267, 4633]","[0, 202, 400, 539, 674, 764, 935, 1117, 1289, 1618, 1829, 2033, 2266, 2819, 3338]",7477,6559,5724,4633,3338,-191,29,-996,-1576,-1201,-3935,15,dire
7608734818,94,90,129,9,26,"[0, 243, 482, 740, 915, 1222, 1750, 2242, 2658, 3161, 3660, 3950, 4537, 5265, 5946]","[0, 289, 615, 1144, 1403, 1951, 2623, 2919, 3483, 3842, 4775, 5161, 5712, 6330, 7063]","[0, 254, 578, 792, 1276, 1527, 1757, 2204, 2412, 2799, 3151, 3758, 4353, 4851, 5183]","[0, 218, 357, 909, 1076, 1166, 1446, 1941, 2072, 2741, 3528, 3678, 3961, 4187, 4602]","[0, 170, 332, 422, 600, 690, 780, 1088, 1178, 1478, 1871, 1961, 2141, 2290, 2578]",5946,7063,5183,4602,2578,95,106,96,105,21,"[0, 229, 527, 1004, 1203, 1694, 2010, 2205, 2778, 3276, 3839, 4172, 5019, 5463, 6161]","[0, 232, 502, 869, 1357, 1647, 2101, 2510, 2922, 3664, 4175, 4590, 5168, 5429, 5864]","[0, 232, 592, 916, 1276, 1559, 1937, 2351, 2635, 3060, 3375, 3866, 4386, 4638, 4948]","[0, 195, 285, 419, 509, 689, 824, 950, 1186, 1723, 1963, 2138, 2326, 2566, 2958]","[0, 246, 336, 683, 819, 909, 1128, 1218, 1426, 1713, 2036, 2155, 2346, 2588, 2817]",6161,5864,4948,2958,2817,-215,1199,235,1644,-239,2624,15,radiant
7608867500,109,13,96,5,26,"[0, 298, 496, 624, 943, 1306, 1733, 2219, 2573, 3048, 3941, 4271, 5083, 5837, 6435]","[0, 364, 682, 889, 1213, 1464, 1727, 2218, 2779, 3427, 3976, 4726, 5382, 5759, 6529]","[0, 290, 571, 1014, 1384, 1821, 2400, 2801, 3131, 3257, 3679, 4088, 4469, 5280, 5686]","[0, 210, 346, 524, 614, 794, 929, 1239, 1403, 1845, 2180, 2366, 2756, 2995, 3198]","[0, 210, 300, 390, 621, 757, 1185, 1321, 1455, 1717, 2029, 2173, 2878, 3188, 3332]",6435,6529,5686,3198,3332,15,54,97,9,27,"[58, 427, 763, 1083, 1446, 1853, 2331, 2763, 3243, 3618, 4130, 4678, 5023, 5675, 5983]","[58, 277, 621, 862, 1271, 1435, 1525, 1984, 2698, 3089, 3664, 4178, 4506, 5330, 5970]","[58, 277, 545, 791, 1034, 1307, 1777, 2222, 2642, 3071, 3161, 3715, 4073, 4794, 5509]","[326, 556, 706, 796, 1022, 1212, 1543, 1963, 2229, 2623, 2760, 3107, 3332, 3739, 3948]","[58, 242, 332, 458, 598, 739, 906, 1512, 1741, 2009, 2319, 2715, 2859, 3145, 3283]",5983,5970,5509,3948,3283,452,559,177,-750,49,487,15,radiant
7609066006,94,120,123,96,112,"[0, 257, 883, 1249, 1579, 2039, 2468, 2971, 3438, 4002, 4491, 5296, 5872, 6489, 7134]","[0, 259, 594, 943, 1305, 1896, 2342, 2755, 3623, 4079, 4642, 5287, 5657, 6139, 7053]","[0, 169, 336, 426, 628, 848, 1201, 1385, 1624, 2272, 2652, 2998, 3130, 3475, 4063]","[0, 207, 716, 1125, 1474, 1674, 1870, 2077, 2440, 2713, 3598, 3988, 4129, 4297, 4657]","[0, 169, 334, 468, 621, 723, 813, 991, 1126, 1693, 2099, 2851, 2941, 3493, 3954]",7134,7053,4063,4657,3954,4,105,107,19,53,"[0, 274, 482, 837, 1703, 2015, 2473, 3015, 3271, 3726, 3921, 4011, 4265, 5112, 5850]","[0, 169, 298, 418, 771, 936, 1103, 1536, 1705, 2266, 3417, 3581, 4040, 4591, 4989]","[0, 250, 566, 890, 1377, 1795, 2005, 2297, 2739, 3231, 3994, 4702, 4916, 5250, 5593]","[0, 205, 491, 907, 1277, 1513, 1882, 2203, 2412, 2789, 3280, 3836, 4023, 4478, 4977]","[0, 169, 259, 379, 553, 800, 1124, 1303, 1393, 1674, 1843, 2328, 3152, 3844, 4029]",5850,4989,5593,4977,4029,1284,2064,-1530,-320,-75,1423,15,radiant
7609240510,70,23,17,109,21,"[62, 302, 814, 1057, 1382, 1854, 2138, 2462, 2905, 3481, 4236, 4860, 5324, 5995, 6565]","[62, 278, 553, 928, 1214, 1467, 1997, 2493, 2992, 3470, 4388, 5015, 5644, 6141, 6287]","[62, 305, 694, 1099, 1460, 1782, 1917, 2680, 2935, 3864, 4574, 5293, 5985, 6201, 6857]","[62, 231, 321, 740, 923, 1053, 1503, 2132, 2497, 2827, 3209, 3502, 3633, 3830, 4252]","[430, 651, 842, 965, 1131, 1367, 1502, 1725, 1954, 2333, 2762, 3228, 3472, 3567, 3706]",6565,6287,6857,4252,3706,36,48,14,20,91,"[0, 251, 569, 814, 1229, 1748, 2148, 2326, 3106, 3668, 4203, 4758, 5280, 6875, 7465]","[0, 207, 484, 735, 1309, 1455, 1749, 2081, 2551, 2939, 3595, 3793, 4473, 5150, 5775]","[0, 205, 371, 573, 817, 1179, 1705, 2246, 2606, 3173, 3541, 3680, 4138, 4753, 5117]","[0, 169, 259, 349, 560, 816, 943, 1033, 1175, 1496, 1631, 1815, 2058, 2615, 2818]","[0, 169, 293, 383, 521, 705, 1003, 1247, 1472, 1676, 1947, 2199, 2307, 2695, 3079]",7465,5775,5117,2818,3079,-900,512,1740,1434,627,3413,15,dire
7609245218,95,15,52,19,9,"[0, 216, 644, 993, 1243, 1413, 1744, 2039, 2341, 2738, 3173, 4032, 4367, 5068, 5523]","[0, 206, 435, 683, 877, 1273, 1923, 2391, 2737, 3245, 3678, 4031, 4631, 5532, 5908]","[0, 254, 631, 998, 1244, 1647, 2213, 2393, 2717, 3254, 3888, 4448, 4971, 5760, 6247]","[0, 234, 349, 439, 576, 794, 977, 1237, 1560, 1688, 2417, 2612, 2990, 3632, 3944]","[0, 502, 617, 755, 879, 1049, 1339, 1683, 1857, 2109, 2624, 2804, 3132, 3852, 4067]",5523,5908,6247,3944,4067,18,13,65,53,51,"[0, 245, 490, 680, 1168, 1258, 1531, 1704, 2024, 2438, 2988, 3836, 4418, 4862, 5919]","[0, 297, 546, 990, 1286, 1660, 2029, 2534, 2817, 3243, 3646, 3893, 4458, 4831, 5613]","[0, 329, 619, 905, 1187, 1935, 2192, 2596, 2851, 3200, 3371, 4137, 4292, 4666, 5370]","[0, 170, 260, 350, 530, 783, 873, 1008, 1098, 1357, 1555, 1664, 1995, 2323, 2634]","[0, 170, 295, 481, 618, 871, 961, 1134, 1224, 1314, 1592, 1972, 2218, 2750, 3033]",5919,5613,5370,2634,3033,-396,295,877,1310,1034,3120,15,dire
7609292902,74,42,99,86,19,"[0, 171, 453, 865, 1364, 1876, 2355, 2792, 3327, 3536, 4125, 4647, 5152, 5344, 5929]","[0, 125, 327, 492, 750, 1259, 1560, 1883, 2295, 2629, 3047, 3290, 3773, 4404, 4922]","[0, 258, 631, 917, 1264, 1516, 2122, 2449, 2868, 3644, 3797, 4172, 4724, 5420, 6209]","[0, 136, 270, 395, 586, 866, 956, 1046, 1463, 1688, 2027, 2152, 2530, 2872, 3078]","[0, 90, 180, 270, 409, 539, 719, 933, 1104, 1194, 1415, 1505, 1595, 1690, 1821]",5929,4922,6209,3078,1821,12,120,96,9,105,"[0, 288, 661, 1019, 1185, 1504, 1833, 2301, 2737, 3331, 3885, 4290, 4986, 5470, 6082]","[0, 361, 676, 1052, 1342, 1586, 2098, 2278, 2583, 2847, 3444, 3908, 4546, 5066, 5528]","[0, 285, 594, 839, 1390, 1720, 2130, 2507, 2972, 3245, 3647, 4226, 4490, 5101, 5690]","[0, 302, 489, 667, 757, 1155, 1399, 1708, 2003, 2225, 3019, 3220, 3486, 3669, 4131]","[0, 250, 340, 547, 688, 839, 1020, 1200, 1290, 1514, 1787, 2066, 2250, 2605, 2846]",6082,5528,5690,4131,2846,-153,-606,519,-1053,-1025,-2318,15,dire
7609332606,49,29,120,123,5,"[0, 204, 487, 696, 978, 1466, 1866, 2148, 2635, 2832, 3380, 4044, 4647, 5243, 5719]","[0, 295, 579, 1001, 1250, 1534, 1821, 2193, 2573, 3073, 3464, 3921, 4471, 5196, 5979]","[0, 288, 498, 941, 1346, 1727, 2138, 2590, 3029, 3336, 3590, 4059, 4753, 5258, 5604]","[0, 390, 480, 570, 660, 750, 887, 977, 1067, 1411, 1826, 1965, 2224, 2557, 2750]","[0, 214, 353, 498, 765, 904, 994, 1131, 1243, 1368, 1599, 1845, 2012, 2141, 2248]",5719,5979,5604,2750,2248,90,93,109,96,65,"[327, 740, 908, 1218, 1512, 1907, 2305, 2972, 3679, 4200, 5070, 5523, 6025, 6708, 7233]","[0, 220, 420, 792, 1034, 1397, 1859, 2450, 2750, 3180, 3769, 4270, 4958, 5646, 6336]","[59, 229, 319, 409, 543, 673, 1068, 1294, 1660, 1948, 2278, 2368, 2624, 2856, 3075]","[59, 229, 644, 932, 1305, 1542, 1877, 2331, 2719, 3067, 3774, 4067, 4503, 5132, 5298]","[59, 229, 333, 423, 513, 688, 858, 1056, 1448, 1789, 2300, 2537, 2827, 3450, 3929]",7233,6336,3075,5298,3929,-1514,-357,2529,-2548,-1681,-3571,15,radiant
7609349210,70,13,96,5,79,"[0, 243, 523, 685, 1066, 1526, 2057, 2673, 3243, 3781, 4399, 4991, 5741, 6308, 7038]","[0, 278, 569, 904, 1276, 1629, 1956, 2370, 3144, 3584, 3946, 4205, 5024, 5382, 5772]","[0, 309, 596, 974, 1316, 1605, 2136, 2636, 3064, 3544, 3976, 4596, 5113, 5389, 5919]","[0, 504, 594, 684, 823, 1317, 1532, 1679, 1992, 2137, 2520, 2798, 3122, 3430, 3525]","[0, 169, 305, 520, 610, 740, 877, 1224, 1503, 1648, 1917, 2149, 2547, 2696, 2966]",7038,5772,5919,3525,2966,46,18,97,20,65,"[0, 329, 629, 1031, 1408, 1883, 2255, 2857, 3108, 3669, 4598, 5478, 6027, 6840, 7358]","[0, 250, 728, 1148, 1505, 1871, 2145, 2688, 3378, 3977, 4802, 5553, 6237, 6940, 7710]","[0, 206, 739, 1141, 1438, 2096, 2434, 2923, 3478, 3882, 4394, 4853, 5014, 5187, 5736]","[0, 169, 259, 398, 535, 643, 789, 1063, 1153, 1243, 1584, 1768, 1880, 2134, 2400]","[0, 169, 333, 423, 557, 731, 1072, 1511, 1601, 1691, 1994, 2474, 2696, 3042, 3339]",7358,7710,5736,2400,3339,-320,-1938,183,1125,-373,-1323,15,radiant
7609451708,94,21,123,19,75,"[0, 217, 498, 876, 1202, 1528, 1859, 2245, 2798, 3250, 3590, 3886, 4131, 4533, 4771]","[0, 294, 587, 910, 1356, 1544, 1916, 2044, 2309, 2693, 3381, 3517, 3861, 4461, 4676]","[0, 244, 569, 888, 1379, 1778, 2076, 2287, 2562, 2828, 3193, 3422, 3902, 4065, 4370]","[0, 129, 219, 343, 514, 679, 901, 1091, 1181, 1365, 1675, 1896, 2040, 2189, 2284]","[0, 129, 219, 353, 524, 659, 749, 861, 951, 1041, 1277, 1367, 1655, 1916, 2036]",4771,4676,4370,2284,2036,13,69,41,109,110,"[0, 315, 614, 822, 1062, 1282, 1612, 2392, 3225, 3654, 4406, 5051, 5585, 6487, 7038]","[0, 284, 593, 985, 1309, 1681, 1918, 2457, 2912, 3352, 3789, 4393, 4996, 5717, 6264]","[0, 209, 445, 693, 1015, 1297, 1472, 1979, 2309, 2742, 2949, 3362, 3778, 4234, 4602]","[0, 209, 299, 438, 568, 736, 826, 1279, 1518, 1703, 2578, 2875, 2965, 3231, 3326]","[0, 209, 386, 476, 606, 735, 825, 1051, 1186, 1324, 1494, 1674, 1764, 2069, 2422]",7038,6264,4602,3326,2422,-2267,-1588,-232,-1042,-386,-5515,15,dire
7609482509,89,120,96,9,79,"[0, 252, 502, 1042, 1322, 1728, 2154, 2550, 2911, 3536, 4056, 4350, 5209, 5828, 6434]","[0, 281, 561, 854, 1254, 1588, 1920, 2385, 2976, 3474, 4095, 4374, 4779, 5423, 5894]","[0, 169, 477, 918, 1334, 1624, 2169, 2588, 2922, 3698, 4194, 4643, 5466, 5891, 6304]","[0, 169, 259, 417, 507, 687, 846, 999, 1096, 1307, 1593, 1798, 2086, 2298, 2613]","[100, 269, 359, 573, 924, 1014, 1349, 1484, 1574, 1742, 1946, 2036, 2290, 2502, 2633]",6434,5894,6304,2613,2633,12,52,23,65,85,"[0, 238, 539, 855, 1196, 1441, 1681, 2146, 2604, 2913, 3311, 3630, 4322, 5000, 5534]","[0, 277, 1123, 1457, 1862, 2171, 2407, 2880, 3581, 4329, 4779, 5692, 6279, 6782, 7361]","[0, 169, 553, 805, 1268, 1628, 1845, 2305, 2896, 3324, 3659, 4209, 4793, 5637, 6221]","[2, 171, 286, 395, 577, 707, 797, 977, 1067, 1539, 1754, 2054, 2846, 3337, 3701]","[0, 169, 284, 672, 811, 1010, 1197, 1377, 1568, 1781, 2085, 2321, 2823, 3289, 3519]",5534,7361,6221,3701,3519,900,-1467,83,-1088,-886,-2458,15,dire
7609689310,93,69,17,109,40,"[0, 245, 1068, 1513, 1937, 2230, 2631, 2930, 3332, 4196, 4379, 5147, 5701, 6459, 7057]","[0, 247, 418, 1069, 1414, 1889, 2526, 2859, 3428, 3900, 4635, 5658, 6360, 7008, 7643]","[0, 290, 701, 1134, 1460, 1869, 2265, 2727, 3287, 3805, 4197, 4653, 5703, 5798, 6194]","[0, 170, 260, 648, 799, 937, 1181, 1271, 1361, 1784, 2035, 2264, 2651, 3348, 3585]","[0, 170, 402, 536, 806, 896, 1070, 1344, 1496, 1766, 1856, 2224, 2527, 2905, 3214]",7057,7643,6194,3585,3214,77,53,49,20,102,"[0, 254, 544, 842, 1122, 1411, 1772, 2215, 2549, 3094, 3648, 4150, 4676, 5237, 5757]","[0, 270, 398, 720, 1031, 1248, 1383, 1799, 2065, 2230, 2803, 3347, 3879, 4566, 5151]","[0, 294, 576, 892, 1343, 1756, 2320, 3077, 3410, 3762, 4223, 4776, 5652, 5987, 6370]","[0, 207, 370, 807, 1051, 1609, 1949, 2218, 2609, 2738, 3086, 3673, 3984, 4133, 4517]","[0, 170, 309, 447, 617, 906, 1089, 1224, 1419, 1509, 1822, 2014, 2296, 2462, 2557]",5757,5151,6370,4517,2557,1300,2492,-176,-932,657,3341,15,radiant
7609815506,35,8,49,84,123,"[0, 325, 663, 1112, 1719, 2184, 2705, 3244, 3839, 4425, 4957, 5451, 6260, 6945, 7581]","[0, 252, 517, 919, 1203, 1594, 1947, 2303, 2702, 3168, 3648, 4232, 4962, 5734, 6238]","[0, 252, 564, 763, 1063, 1274, 1404, 1644, 1949, 2529, 2928, 3613, 4167, 4827, 5453]","[0, 170, 260, 394, 484, 574, 749, 887, 977, 1111, 1239, 1377, 1719, 1992, 2087]","[0, 170, 608, 784, 958, 1094, 1263, 1353, 1509, 1644, 1849, 2438, 2786, 2934, 3320]",7581,6238,5453,2087,3320,25,59,14,5,86,"[0, 328, 819, 1178, 1722, 2176, 2927, 3483, 4037, 4702, 5449, 5983, 6618, 7566, 8118]","[0, 207, 367, 659, 919, 1520, 2317, 2737, 3130, 3739, 4169, 4656, 5531, 5679, 6334]","[0, 280, 551, 867, 1162, 1455, 1879, 2254, 2649, 2988, 3387, 3739, 4560, 4708, 5267]","[0, 170, 260, 467, 601, 816, 1182, 1362, 1452, 1587, 1767, 1946, 2036, 2694, 3038]","[0, 170, 360, 495, 664, 842, 1059, 1287, 1421, 1612, 2050, 2187, 2382, 2754, 3117]",8118,6334,5267,3038,3117,-537,-96,186,-951,203,-1195,15,dire
7610125407,97,48,16,121,87,"[0, 130, 497, 835, 1157, 1651, 2156, 2503, 3002, 3732, 4693, 5386, 6189, 6849, 7335]","[0, 246, 655, 1037, 1365, 1957, 2563, 3037, 3583, 4127, 4695, 5424, 6051, 6916, 7584]","[0, 249, 487, 851, 1163, 1458, 1673, 1931, 2712, 3180, 3701, 4348, 4849, 5514, 6059]","[0, 130, 615, 750, 864, 1197, 1287, 1377, 1887, 1977, 2197, 2335, 2613, 2908, 3323]","[0, 130, 220, 356, 449, 559, 649, 739, 916, 1027, 1161, 1301, 1680, 1828, 1923]",7335,7584,6059,3323,1923,113,7,9,19,5,"[0, 289, 539, 922, 1381, 1558, 1828, 2400, 2998, 3518, 4261, 4578, 5198, 5842, 6426]","[0, 216, 591, 1029, 1346, 1635, 2117, 2479, 3099, 3580, 4105, 4284, 4781, 5543, 6210]","[0, 254, 540, 1065, 1474, 1709, 2145, 2437, 3122, 3499, 3949, 4463, 4876, 5357, 6309]","[0, 170, 260, 395, 529, 619, 758, 897, 1338, 1428, 1811, 1995, 2550, 2955, 3271]","[0, 170, 318, 531, 670, 760, 1094, 1184, 1499, 1638, 2008, 2201, 2373, 2651, 2756]",6426,6210,6309,3271,2756,909,1374,-250,52,-833,1252,15,radiant
7610281513,48,17,49,109,5,"[0, 250, 621, 1050, 1388, 1901, 2524, 3098, 3782, 4298, 5032, 5890, 6611, 7111, 8192]","[0, 364, 607, 1061, 1393, 1793, 2083, 2749, 3264, 3453, 4402, 4741, 5324, 6166, 6920]","[0, 323, 603, 897, 1301, 1722, 2212, 2703, 3322, 3648, 4160, 4778, 5203, 5866, 6984]","[0, 170, 260, 364, 516, 653, 783, 921, 1103, 1295, 1522, 1822, 2063, 2275, 3111]","[0, 170, 260, 350, 457, 547, 677, 776, 945, 1035, 1170, 1260, 1364, 1700, 2128]",8192,6920,6984,3111,2128,69,41,51,40,84,"[0, 323, 569, 906, 1341, 1740, 2167, 2731, 3617, 4532, 5275, 5706, 6366, 7103, 8004]","[0, 245, 478, 938, 1311, 1769, 2109, 2439, 2737, 3238, 3867, 4276, 4966, 5603, 6192]","[0, 207, 580, 904, 1211, 1537, 1956, 2413, 2731, 3385, 4093, 4850, 5419, 6075, 6341]","[0, 170, 616, 735, 1067, 1376, 1633, 2032, 2291, 2953, 3487, 3842, 4260, 4800, 5194]","[0, 170, 260, 418, 543, 678, 813, 903, 993, 1330, 1508, 1663, 1817, 2044, 2139]",8004,6192,6341,5194,2139,188,728,643,-2083,-11,-535,15,dire
7610326311,21,27,102,65,85,"[2, 659, 1176, 1409, 2084, 2677, 3154, 3907, 4603, 5115, 5812, 6433, 7915, 8607, 9699]","[2, 357, 614, 1237, 1694, 1933, 2254, 2831, 3208, 3422, 3868, 4508, 4821, 5383, 5585]","[0, 439, 816, 1181, 1398, 1834, 2157, 2470, 2859, 2996, 3809, 4027, 4619, 5211, 5766]","[0, 450, 595, 775, 1096, 1226, 1316, 1654, 1807, 2251, 2696, 3568, 4220, 4637, 5151]","[0, 214, 492, 691, 963, 1349, 1485, 1760, 1928, 2309, 2925, 3154, 3531, 3866, 4417]",9699,5585,5766,5151,4417,89,78,53,17,20,"[0, 207, 297, 591, 814, 1011, 1298, 1639, 1931, 2462, 2983, 3394, 4025, 4658, 5123]","[0, 348, 544, 775, 1309, 1541, 1747, 2069, 2309, 2740, 3180, 3731, 4026, 4568, 5029]","[0, 176, 337, 457, 638, 846, 936, 1119, 1529, 2224, 2503, 2866, 3161, 3626, 4561]","[0, 287, 691, 900, 1282, 1697, 2094, 2432, 2979, 3512, 4053, 4645, 5060, 5678, 6394]","[0, 176, 266, 386, 476, 833, 923, 1106, 1335, 1538, 1852, 1942, 2284, 2902, 3249]",5123,5029,4561,6394,3249,4576,556,1205,-1243,1168,6262,15,dire
7610361001,93,78,15,58,19,"[0, 246, 497, 694, 1099, 1584, 1926, 2192, 2643, 3601, 4163, 4673, 5144, 5554, 5958]","[0, 210, 300, 533, 833, 1068, 1561, 2082, 2252, 2762, 3261, 3632, 4361, 4716, 5199]","[0, 285, 619, 988, 1199, 1440, 1674, 2089, 2294, 3024, 3325, 3852, 4443, 4934, 5409]","[0, 261, 351, 492, 630, 1235, 1392, 1501, 1818, 2229, 2453, 2722, 3015, 3346, 3495]","[0, 249, 425, 515, 656, 858, 948, 1038, 1402, 1835, 2150, 2285, 2551, 2663, 2859]",5958,5199,5409,3495,2859,41,49,21,56,85,"[0, 289, 566, 835, 1092, 1602, 1893, 2392, 2840, 3267, 3708, 3956, 4232, 4839, 5141]","[0, 165, 463, 856, 1040, 1339, 1620, 2133, 2223, 2313, 2853, 3317, 3621, 4129, 4601]","[0, 199, 601, 924, 1138, 1405, 1812, 2324, 2714, 2850, 3362, 3812, 4071, 4544, 4886]","[0, 130, 245, 353, 443, 582, 754, 1095, 1220, 1430, 1718, 1897, 2150, 2441, 2808]","[0, 130, 245, 452, 542, 753, 843, 1133, 1269, 1429, 1581, 1671, 1809, 2184, 2388]",5141,4601,4886,2808,2388,817,598,523,687,471,3096,15,radiant
7610580601,93,129,23,91,123,"[0, 255, 644, 921, 1140, 2056, 2583, 2877, 3326, 3657, 3954, 4906, 5346, 6050, 6864]","[0, 208, 560, 848, 1102, 1523, 2078, 2492, 2800, 3094, 3694, 3985, 4510, 5141, 5605]","[0, 326, 540, 838, 1171, 1538, 1806, 2461, 3142, 3854, 4354, 4758, 5202, 5882, 6509]","[0, 170, 346, 474, 612, 1011, 1264, 1423, 1688, 2279, 2471, 2715, 2947, 3208, 3456]","[0, 170, 264, 708, 798, 929, 1110, 1269, 1419, 1651, 1821, 1911, 2175, 2522, 2688]",6864,5605,6509,3456,2688,89,49,96,27,5,"[0, 204, 527, 857, 1153, 1565, 1969, 2485, 2822, 3461, 4043, 4836, 5676, 6571, 7520]","[0, 248, 544, 847, 1217, 1469, 2182, 2587, 3102, 3524, 4078, 4422, 5131, 5359, 5990]","[0, 209, 463, 840, 1158, 1367, 1672, 2367, 2738, 3203, 3636, 4163, 4624, 5411, 6298]","[0, 170, 297, 387, 539, 629, 808, 898, 1084, 1357, 1447, 1963, 2152, 2466, 2772]","[0, 170, 260, 397, 500, 639, 774, 864, 999, 1159, 1401, 1702, 2064, 2415, 2766]",7520,5990,6298,2772,2766,-656,-385,211,684,-78,-224,15,radiant
7610750910,1,23,28,19,110,"[0, 266, 568, 827, 1039, 1289, 1621, 2052, 2494, 2794, 3462, 3755, 4022, 4263, 4792]","[0, 270, 775, 1073, 1277, 1659, 2039, 2746, 3099, 3690, 4102, 4410, 5361, 5867, 6489]","[0, 230, 431, 764, 1121, 1484, 1770, 2401, 2947, 3560, 4149, 4701, 4855, 5400, 5829]","[0, 195, 285, 375, 465, 555, 739, 1040, 1291, 1546, 1912, 2062, 2153, 2458, 3087]","[0, 195, 285, 375, 465, 620, 797, 1036, 1126, 1272, 1825, 1915, 2147, 2242, 2729]",4792,6489,5829,3087,2729,15,54,33,100,87,"[0, 208, 529, 912, 1283, 1690, 2192, 2525, 2943, 3663, 3804, 4315, 4893, 5681, 5831]","[0, 244, 479, 675, 1010, 1172, 1421, 1933, 2328, 2656, 2957, 3493, 3864, 4325, 4915]","[0, 331, 531, 767, 1183, 1443, 1854, 2342, 2842, 3367, 3851, 4757, 5398, 6134, 6434]","[0, 170, 305, 395, 565, 690, 830, 945, 1531, 1731, 1821, 2134, 2389, 2690, 2959]","[0, 170, 260, 360, 494, 636, 726, 1071, 1321, 1521, 1611, 1923, 2370, 2754, 2849]",5831,4915,6434,2959,2849,-1039,1574,-605,128,-120,-62,15,dire
7610800301,18,74,137,79,9,"[0, 208, 527, 842, 1061, 1362, 1523, 2168, 2638, 3041, 3427, 3862, 4910, 5510, 6095]","[0, 205, 407, 702, 910, 1211, 1581, 2079, 2503, 2593, 2819, 3495, 3978, 4338, 4549]","[0, 288, 996, 1476, 2079, 2455, 2834, 3247, 3665, 4262, 4724, 5118, 5606, 6088, 6183]","[0, 169, 327, 502, 677, 784, 994, 1129, 1265, 1502, 1637, 1817, 2411, 2636, 2731]","[0, 213, 303, 505, 635, 803, 893, 1138, 1228, 1466, 1708, 1918, 2413, 2562, 2885]",6095,4549,6183,2731,2885,21,19,28,121,20,"[0, 250, 499, 933, 1384, 1836, 2171, 2630, 3066, 3870, 4532, 5040, 5544, 5966, 6625]","[0, 205, 486, 730, 1050, 1362, 1673, 1972, 2454, 2977, 3384, 4173, 4656, 4948, 5415]","[0, 291, 491, 827, 1423, 1825, 2515, 3248, 3646, 4137, 4598, 5298, 5821, 6138, 6565]","[0, 206, 296, 386, 780, 989, 1502, 1804, 1894, 2222, 2687, 2961, 3137, 3478, 3800]","[0, 169, 259, 349, 549, 679, 1077, 1284, 1396, 1760, 1986, 2315, 2405, 2639, 3058]",6625,5415,6565,3800,3058,-530,-866,-382,-1069,-173,-3020,15,dire
7610815600,18,120,129,105,26,"[57, 453, 680, 1099, 1493, 1985, 2265, 2693, 3207, 3708, 4218, 4842, 5328, 6466, 7112]","[57, 354, 745, 1166, 1674, 1927, 2462, 2951, 3661, 4406, 4881, 5394, 6021, 6203, 6738]","[325, 550, 844, 1221, 1845, 2092, 2446, 2873, 2963, 3580, 3836, 4374, 4640, 4935, 5541]","[157, 382, 497, 635, 835, 970, 1181, 1383, 1473, 1919, 2225, 2482, 2945, 3373, 3984]","[57, 282, 397, 562, 922, 1012, 1102, 1198, 1322, 1683, 1861, 2037, 2267, 2438, 2623]",7112,6738,5541,3984,2623,1,78,137,58,123,"[0, 170, 641, 1070, 1471, 1917, 2236, 2674, 3365, 3859, 4403, 4802, 5818, 6468, 7573]","[0, 244, 524, 807, 1035, 1441, 1932, 2397, 2871, 3348, 4099, 4773, 5204, 5774, 6405]","[0, 241, 720, 1061, 1399, 1738, 1955, 2552, 3018, 3279, 3642, 4087, 4495, 4950, 5374]","[0, 217, 332, 803, 983, 1136, 1226, 1595, 1849, 1984, 2209, 2353, 2753, 3057, 3298]","[0, 170, 285, 393, 483, 573, 757, 847, 1226, 1526, 1834, 2144, 2310, 2772, 2968]",7573,6405,5374,3298,2968,-461,333,167,686,-345,380,15,dire
7611052212,63,19,47,79,20,"[0, 233, 590, 1186, 2007, 2167, 2859, 3376, 4175, 4592, 5233, 5997, 6853, 7623, 8010]","[0, 383, 674, 1053, 1503, 1879, 2290, 2639, 3097, 3823, 4629, 5270, 5586, 6184, 6847]","[0, 195, 836, 1202, 1486, 1951, 2586, 2800, 3260, 3593, 4068, 4927, 5744, 6116, 6909]","[0, 195, 350, 491, 646, 736, 1160, 1300, 1750, 1965, 2488, 2748, 3005, 3345, 4255]","[0, 245, 335, 544, 800, 890, 1146, 1236, 1417, 1767, 2133, 2413, 3116, 3404, 3707]",8010,6847,6909,4255,3707,61,73,70,65,21,"[0, 289, 529, 858, 1097, 1472, 1672, 2183, 2644, 2820, 3307, 3896, 4330, 4925, 5411]","[0, 291, 502, 635, 725, 1148, 1489, 1852, 1988, 2415, 3071, 3449, 3945, 4691, 5283]","[0, 313, 601, 1013, 1211, 1504, 1965, 2213, 2920, 3338, 3541, 3991, 4208, 4436, 4856]","[0, 214, 304, 431, 521, 699, 936, 1026, 1247, 1337, 1427, 1700, 2250, 2620, 3006]","[0, 170, 260, 399, 507, 685, 820, 910, 1000, 1129, 1219, 1353, 1723, 1909, 2088]",5411,5283,4856,3006,2088,2599,1564,2053,1249,1619,9084,15,radiant
7611209103,44,28,121,62,85,"[0, 239, 647, 961, 1447, 1658, 2205, 2607, 2879, 3441, 3737, 4149, 4925, 5376, 5809]","[0, 290, 652, 1122, 1488, 2017, 2437, 2753, 3377, 3750, 4369, 4739, 5533, 6038, 6563]","[0, 170, 260, 616, 746, 974, 1183, 1273, 1493, 1823, 2258, 2384, 2932, 3489, 3876]","[0, 368, 630, 990, 1345, 1745, 1880, 2259, 2750, 3337, 3977, 4181, 4856, 5332, 5593]","[0, 170, 260, 565, 775, 865, 1077, 1266, 1356, 1482, 1662, 1845, 2465, 2845, 2940]",5809,6563,3876,5593,2940,109,120,129,101,5,"[0, 295, 536, 820, 1019, 1347, 1653, 2059, 2502, 3555, 4122, 4635, 5015, 5658, 6321]","[0, 366, 664, 1084, 1338, 1680, 2008, 2461, 2827, 3154, 3661, 4222, 4946, 5394, 5961]","[0, 267, 357, 557, 836, 1411, 1538, 1834, 2179, 2641, 3002, 3480, 4095, 4662, 5264]","[0, 526, 616, 745, 835, 1236, 1326, 1461, 1596, 1979, 2399, 2642, 2822, 3011, 3499]","[0, 302, 437, 652, 806, 1027, 1389, 1670, 1805, 2120, 2602, 2848, 3303, 3485, 3870]",6321,5961,5264,3499,3870,-512,602,-1388,2094,-930,-134,15,radiant
7611279703,95,106,4,105,91,"[0, 239, 603, 1143, 1698, 2025, 2571, 2884, 3186, 3535, 3761, 4195, 4549, 5045, 5650]","[0, 250, 612, 1016, 1364, 1613, 1825, 2374, 2773, 3492, 3876, 4356, 4964, 5526, 5953]","[0, 238, 590, 877, 1255, 1612, 2083, 2386, 2751, 3226, 3454, 3612, 4212, 4675, 4770]","[0, 170, 603, 693, 827, 952, 1383, 1543, 1712, 1931, 2253, 2396, 2486, 2800, 2981]","[0, 170, 260, 463, 600, 725, 982, 1117, 1246, 1381, 1516, 1606, 1696, 1845, 2083]",5650,5953,4770,2981,2083,120,57,93,58,20,"[0, 315, 611, 977, 1298, 1719, 2355, 2811, 3425, 4025, 4618, 5084, 5503, 5991, 6463]","[0, 170, 488, 615, 856, 1262, 1564, 1892, 2310, 2790, 3666, 4045, 4951, 5373, 5726]","[0, 249, 557, 719, 1085, 1459, 1671, 1979, 2192, 2409, 2768, 3263, 3787, 4389, 5032]","[0, 170, 276, 441, 571, 749, 852, 1072, 1281, 1658, 2062, 2206, 2511, 3075, 3511]","[0, 170, 260, 350, 544, 674, 764, 899, 989, 1373, 1598, 1783, 2053, 2289, 2497]",6463,5726,5032,3511,2497,-813,227,-262,-530,-414,-1792,15,dire
7611332019,18,59,86,97,66,"[0, 250, 531, 745, 1203, 1678, 1966, 2460, 2852, 3603, 4005, 4761, 5450, 6139, 6713]","[0, 202, 416, 624, 1023, 1437, 1896, 2218, 2773, 3350, 3910, 4311, 4650, 5024, 5458]","[0, 129, 219, 344, 1004, 1259, 1432, 1669, 1759, 2026, 2163, 2253, 2766, 2930, 3195]","[0, 198, 548, 763, 1496, 1866, 2052, 2329, 2474, 2860, 3269, 3616, 3868, 4385, 5070]","[0, 129, 219, 385, 501, 626, 872, 1053, 1240, 1423, 1589, 1869, 2447, 2874, 3186]",6713,5458,3195,5070,3186,50,106,96,121,105,"[108, 397, 929, 1215, 1625, 1950, 2524, 2891, 3475, 4055, 4448, 4909, 5941, 6570, 7238]","[108, 393, 660, 942, 1085, 1493, 1863, 2215, 2729, 3144, 3657, 4145, 4541, 4880, 5732]","[509, 762, 1071, 1468, 1760, 2143, 2553, 2930, 3484, 3738, 4187, 4779, 5395, 5837, 6292]","[108, 317, 432, 522, 663, 850, 1104, 1295, 1671, 1805, 2047, 2438, 2723, 3084, 3815]","[108, 317, 432, 604, 694, 862, 997, 1087, 1508, 1645, 1870, 2156, 2732, 2912, 3546]",7238,5732,6292,3815,3546,-525,-274,-3097,1255,-360,-3001,15,dire
7611472802,95,129,114,5,91,"[0, 283, 482, 822, 1295, 1647, 2158, 2804, 3309, 3924, 4814, 5633, 5993, 6434, 7125]","[0, 249, 571, 873, 1480, 1957, 2244, 2740, 3026, 3382, 3932, 4266, 5178, 5748, 6315]","[0, 214, 566, 1035, 1444, 1938, 2528, 3237, 3857, 4152, 4828, 5221, 6210, 6375, 6761]","[0, 130, 220, 310, 485, 649, 883, 1040, 1405, 1778, 2068, 2443, 3012, 3355, 4134]","[0, 130, 220, 344, 694, 918, 1008, 1175, 1489, 1641, 1930, 2165, 2539, 2679, 2774]",7125,6315,6761,4134,2774,46,86,135,23,100,"[0, 322, 487, 802, 1164, 1567, 1786, 2112, 2517, 3039, 3386, 4053, 4198, 4761, 5051]","[0, 261, 351, 441, 739, 1058, 1148, 1328, 1418, 1508, 1684, 1933, 2078, 2437, 4207]","[0, 210, 755, 918, 1293, 1398, 1488, 1741, 1867, 1996, 2238, 2483, 2813, 3266, 3968]","[0, 282, 447, 693, 863, 1085, 1329, 1714, 1898, 2241, 2708, 2798, 2995, 3307, 3850]","[0, 210, 380, 470, 778, 904, 994, 1174, 1264, 1511, 1601, 1939, 2216, 2490, 3451]",5051,4207,3968,3850,3451,2074,2108,2793,284,-677,6582,15,radiant
7611599303,106,35,49,5,30,"[0, 208, 580, 940, 1384, 1635, 2163, 2652, 3328, 3854, 4482, 4844, 5577, 5925, 6672]","[0, 291, 500, 747, 1042, 1382, 1895, 1985, 2199, 2536, 3274, 3652, 4094, 5102, 5298]","[0, 248, 501, 667, 948, 1276, 1479, 1892, 2367, 2817, 3273, 3733, 4367, 4946, 5245]","[0, 170, 260, 394, 484, 574, 756, 1401, 1727, 1953, 2060, 2196, 2422, 2571, 2828]","[0, 170, 260, 475, 565, 655, 745, 835, 1015, 1170, 1297, 1457, 1670, 1911, 2136]",6672,5298,5245,2828,2136,46,11,96,85,121,"[0, 252, 660, 1072, 1780, 2461, 2952, 3373, 4041, 4719, 5614, 6308, 6888, 7902, 8701]","[0, 325, 691, 1108, 1446, 1847, 2346, 3442, 4036, 4722, 5524, 6108, 6818, 7659, 8709]","[0, 282, 626, 949, 1360, 1734, 1897, 2101, 2627, 2753, 3217, 3568, 3894, 4473, 5098]","[0, 170, 260, 366, 566, 700, 808, 910, 1117, 1207, 1432, 1593, 1727, 1822, 1971]","[0, 170, 260, 386, 525, 660, 750, 840, 1020, 1110, 1731, 1875, 2062, 2399, 2548]",8701,8709,5098,1971,2548,-2029,-3411,147,857,-412,-4848,15,dire
7611630505,106,109,14,86,84,"[0, 291, 699, 1067, 1462, 1907, 2273, 2673, 3127, 3445, 3794, 4250, 4545, 5374, 6934]","[0, 241, 488, 797, 1046, 1463, 1587, 2201, 2553, 3001, 3127, 3547, 3919, 4918, 5976]","[0, 246, 517, 835, 1333, 1778, 2172, 2772, 3163, 3812, 3902, 4404, 4870, 5685, 6495]","[0, 169, 259, 414, 1020, 1206, 1395, 1745, 1835, 2270, 2360, 2605, 2793, 3318, 3646]","[0, 169, 259, 538, 679, 856, 983, 1655, 1791, 1925, 2015, 2248, 2338, 3207, 4231]",6934,5976,6495,3646,4231,114,98,48,97,20,"[64, 311, 510, 851, 1121, 1483, 2163, 2378, 3131, 3333, 4342, 4885, 5598, 6374, 6766]","[332, 625, 1028, 1467, 1823, 2237, 3257, 3836, 4247, 5157, 6095, 6512, 7303, 7836, 7931]","[0, 169, 409, 623, 966, 1292, 1740, 2171, 2582, 3032, 3548, 4087, 4912, 5142, 5840]","[64, 233, 323, 757, 922, 1106, 1311, 1401, 1660, 2068, 2490, 2994, 3522, 3980, 4314]","[64, 233, 323, 413, 626, 762, 897, 1089, 1224, 1645, 1871, 2015, 2427, 2697, 2792]",6766,7931,5840,4314,2792,168,-1955,655,-668,1439,-361,15,radiant
7611692118,53,25,59,128,87,"[0, 326, 614, 1061, 1351, 2022, 2783, 3175, 3631, 4142, 4450, 5214, 5544, 6339, 7149]","[0, 325, 661, 908, 1244, 1614, 1955, 2614, 3059, 3817, 4174, 4703, 5262, 5913, 7239]","[0, 208, 578, 700, 1008, 1279, 1509, 1648, 2113, 2492, 2808, 3169, 4365, 4779, 5254]","[0, 270, 360, 450, 834, 1022, 1112, 1587, 1722, 2219, 2570, 2708, 2849, 3433, 3932]","[0, 169, 259, 395, 485, 621, 795, 1261, 1430, 1804, 1985, 2180, 2628, 2969, 3258]",7149,7239,5254,3932,3258,43,6,96,85,86,"[0, 367, 753, 1180, 1703, 2161, 2570, 3448, 3874, 4333, 5098, 5663, 5980, 6833, 7521]","[0, 213, 501, 844, 1521, 1770, 2353, 2918, 3203, 3642, 4094, 4447, 4862, 5261, 5702]","[0, 169, 561, 773, 1190, 1557, 1870, 2291, 2424, 2552, 3121, 3856, 4273, 4976, 5109]","[0, 169, 259, 398, 653, 791, 925, 1402, 1541, 1882, 2077, 2505, 3252, 3564, 3755]","[0, 169, 305, 395, 560, 787, 877, 1105, 1430, 1520, 2242, 2607, 2752, 2937, 3156]",7521,5702,5109,3755,3156,-372,1537,145,177,102,1589,15,dire
7611703304,109,97,22,105,20,"[0, 246, 663, 955, 1328, 1626, 1936, 2302, 2769, 2933, 3251, 3645, 3979, 4437, 4936]","[0, 290, 622, 831, 1473, 1735, 2385, 2792, 3412, 3886, 4395, 5368, 5854, 6431, 7229]","[0, 293, 562, 925, 1164, 1498, 1918, 2125, 2862, 3190, 3744, 4513, 4797, 5117, 5713]","[0, 170, 260, 366, 577, 792, 987, 1077, 1766, 1856, 1995, 2340, 2764, 3179, 3312]","[0, 170, 343, 530, 620, 710, 1105, 1244, 1561, 1651, 1741, 1998, 2261, 2757, 3078]",4936,7229,5713,3312,3078,10,36,96,53,136,"[0, 243, 492, 840, 1127, 1616, 1881, 2369, 2907, 3348, 3616, 4094, 4738, 5642, 6381]","[0, 340, 657, 1104, 1507, 2127, 2501, 3010, 3974, 4680, 5094, 5755, 6658, 7350, 7877]","[0, 268, 429, 725, 863, 1270, 1490, 1891, 2274, 2619, 3004, 3952, 4331, 4713, 5392]","[0, 501, 630, 765, 904, 1127, 1309, 1399, 1489, 2075, 2459, 2871, 3375, 3669, 4158]","[0, 278, 368, 458, 592, 994, 1127, 1217, 1307, 1563, 1691, 2039, 2184, 2452, 2885]",6381,7877,5392,4158,2885,-1445,-648,321,-846,193,-2425,15,dire
7611725802,95,96,21,86,26,"[0, 332, 993, 1396, 2023, 2375, 2928, 3377, 3713, 4288, 4886, 5544, 6095, 6368, 6959]","[0, 170, 737, 1111, 1846, 2135, 2514, 3389, 3649, 4014, 4825, 5735, 6200, 6688, 7192]","[0, 260, 537, 933, 1142, 1471, 1803, 2321, 2775, 3395, 3622, 4118, 4884, 5032, 5727]","[0, 170, 431, 658, 1012, 1210, 1543, 1822, 1912, 2406, 2653, 3342, 4381, 4731, 5192]","[0, 170, 354, 489, 689, 862, 1029, 1119, 1227, 1718, 1930, 2409, 3224, 3372, 3958]",6959,7192,5727,5192,3958,15,25,97,105,51,"[0, 209, 551, 786, 1001, 1613, 2312, 2402, 3382, 3988, 4230, 4826, 5415, 6429, 7150]","[0, 255, 484, 771, 1023, 1711, 2052, 2549, 3279, 3619, 4088, 4326, 4584, 5058, 5676]","[0, 205, 495, 659, 846, 1113, 1696, 1859, 2507, 2925, 3625, 3995, 4260, 4812, 5014]","[0, 170, 466, 599, 761, 1262, 1616, 1706, 2145, 2502, 2774, 2864, 3653, 4293, 4442]","[0, 170, 260, 350, 477, 813, 948, 1162, 1402, 1594, 1914, 2261, 2522, 3126, 3275]",7150,5676,5014,4442,3275,-191,1516,713,750,683,3471,15,dire
7611842709,18,129,106,105,79,"[0, 181, 516, 922, 1203, 1641, 1929, 2163, 2416, 2870, 3241, 3888, 4772, 5439, 6097]","[0, 141, 445, 854, 1224, 1517, 2038, 2527, 2984, 3369, 3782, 4178, 4878, 5383, 5889]","[0, 203, 514, 891, 1063, 1344, 1721, 1970, 2268, 2594, 2890, 3230, 3567, 4284, 4675]","[0, 90, 180, 317, 455, 957, 1094, 1220, 1396, 1592, 1767, 2262, 2422, 2709, 2990]","[0, 90, 180, 270, 378, 525, 925, 1015, 1105, 1466, 1556, 2047, 2229, 2666, 2891]",6097,5889,4675,2990,2891,95,78,13,58,5,"[111, 361, 673, 1216, 1546, 2034, 2585, 2931, 3546, 3999, 4633, 5255, 5734, 6357, 7299]","[244, 494, 852, 1213, 1554, 1881, 2241, 2918, 3248, 3738, 4595, 4892, 5441, 6044, 6562]","[111, 512, 781, 1146, 1403, 1726, 2237, 2676, 2845, 3618, 4250, 4634, 5237, 5698, 6266]","[379, 629, 719, 853, 991, 1121, 1211, 1461, 1609, 1850, 2193, 2425, 2695, 2870, 3145]","[111, 410, 500, 720, 810, 1029, 1305, 1559, 1694, 1844, 2328, 2418, 2790, 2932, 3240]",7299,6562,6266,3145,3240,-1202,-673,-1591,-155,-349,-3970,15,dire
7611850401,106,41,2,86,5,"[0, 330, 724, 1094, 1522, 1947, 2624, 3311, 4050, 4614, 5347, 6337, 6838, 7926, 8728]","[0, 328, 613, 931, 1146, 1601, 2053, 2548, 3254, 3714, 4203, 4705, 5053, 6190, 6568]","[0, 285, 536, 946, 1287, 1629, 2018, 2845, 3277, 3683, 4155, 4692, 5521, 6030, 6652]","[0, 170, 260, 396, 486, 576, 711, 936, 1026, 1467, 1602, 2115, 2252, 2806, 3057]","[0, 170, 260, 350, 440, 577, 778, 1003, 1306, 1396, 1578, 1878, 1990, 2693, 2807]",8728,6568,6652,3057,2807,95,39,71,45,20,"[0, 254, 750, 1233, 1679, 2085, 2503, 3033, 3441, 4146, 4779, 5311, 5844, 6660, 7332]","[0, 382, 725, 1075, 1495, 1939, 2535, 2897, 3394, 4260, 5031, 5121, 5333, 6167, 7245]","[0, 170, 551, 1032, 1229, 1616, 1953, 2328, 2951, 3360, 3955, 4734, 5205, 5603, 5919]","[0, 204, 319, 485, 575, 798, 971, 1188, 1360, 1880, 2087, 2365, 2587, 3001, 3525]","[0, 170, 285, 452, 542, 725, 864, 954, 1044, 1320, 1502, 1640, 1790, 2048, 2364]",7332,7245,5919,3525,2364,1396,-677,733,-468,443,1427,15,dire
7611956203,113,28,120,105,20,"[0, 272, 668, 954, 1547, 2071, 2335, 2816, 3245, 3601, 3974, 4492, 4967, 5912, 6625]","[0, 130, 506, 753, 1162, 1424, 1803, 2222, 2587, 2973, 3482, 3930, 4508, 5492, 6126]","[0, 238, 588, 965, 1328, 1703, 2419, 2985, 3549, 3962, 4523, 5038, 5309, 5919, 6383]","[0, 467, 557, 691, 829, 969, 1342, 1574, 1878, 2271, 2573, 2713, 2938, 3549, 3899]","[0, 199, 289, 533, 911, 1125, 1419, 1778, 1925, 2285, 2800, 3016, 3480, 3988, 4280]",6625,6126,6383,3899,4280,63,137,23,72,121,"[0, 243, 495, 888, 1263, 1623, 1965, 2520, 2888, 3518, 3879, 4371, 4731, 4879, 5387]","[0, 323, 584, 912, 1203, 1529, 1799, 1979, 2157, 2359, 3060, 3515, 4506, 4884, 5862]","[0, 280, 488, 858, 1541, 1650, 2265, 2695, 3070, 3513, 3658, 4153, 4568, 5101, 5870]","[0, 170, 260, 350, 526, 668, 758, 972, 1062, 1264, 1409, 1499, 2227, 2380, 2735]","[0, 170, 490, 669, 965, 1055, 1267, 1447, 1704, 1906, 2188, 2278, 2491, 2703, 2924]",5387,5862,5870,2735,2924,1238,264,513,1164,1356,4535,15,dire
7611958600,94,7,23,105,65,"[0, 335, 567, 799, 1359, 1888, 2228, 2773, 3256, 3722, 4547, 5075, 5456, 6119, 6668]","[0, 325, 615, 956, 1165, 1548, 2001, 2502, 2980, 3309, 3868, 4434, 4772, 5444, 5790]","[0, 262, 695, 1060, 1363, 1972, 2353, 2533, 3347, 3640, 4525, 4821, 5467, 6469, 7022]","[0, 169, 259, 349, 451, 875, 1385, 1800, 1969, 2361, 2543, 2677, 2953, 3390, 3737]","[100, 271, 410, 500, 667, 1023, 1248, 1863, 2016, 2126, 2379, 2640, 2837, 3470, 3874]",6668,5790,7022,3737,3874,89,69,128,79,9,"[0, 214, 530, 766, 1073, 1400, 1879, 2211, 2540, 3103, 3571, 3854, 4558, 5181, 5844]","[0, 235, 540, 897, 1033, 1237, 1584, 1837, 2308, 2870, 3620, 4097, 4469, 5136, 5848]","[0, 352, 681, 885, 1178, 1434, 1797, 2261, 2521, 2846, 3424, 3817, 4448, 4932, 5180]","[0, 200, 290, 479, 616, 1180, 1270, 1514, 1703, 2209, 2704, 2838, 3240, 3404, 3499]","[0, 468, 618, 921, 1011, 1303, 1530, 1729, 1819, 2040, 2331, 2519, 2724, 2873, 3034]",5844,5848,5180,3499,3034,824,-58,1842,238,840,3686,15,radiant
7612109715,109,38,106,85,27,"[0, 322, 520, 841, 1203, 1575, 2018, 2286, 2766, 3199, 3701, 4233, 4981, 5732, 6377]","[0, 367, 577, 1026, 1187, 1775, 1987, 2681, 3165, 3484, 4274, 4867, 5350, 6170, 6664]","[0, 372, 658, 917, 1286, 1661, 2051, 2824, 3169, 3463, 3943, 4408, 4745, 5077, 5433]","[0, 210, 338, 517, 656, 786, 876, 1410, 1641, 1731, 1988, 2263, 2421, 2594, 2724]","[0, 210, 334, 468, 558, 771, 861, 1070, 1301, 1436, 1645, 1735, 2139, 2486, 2617]",6377,6664,5433,2724,2617,12,13,129,9,123,"[0, 252, 574, 827, 1429, 1762, 2323, 2506, 3076, 3379, 3886, 4440, 5190, 5597, 6259]","[0, 245, 520, 808, 1098, 1188, 1520, 1655, 2171, 3071, 3744, 3962, 4646, 5092, 5607]","[0, 532, 696, 893, 1299, 1722, 1922, 2411, 2849, 3326, 3963, 4534, 5138, 5712, 6285]","[0, 192, 282, 459, 973, 1063, 1654, 1891, 2376, 2709, 2889, 3238, 4024, 4317, 4524]","[0, 192, 282, 455, 630, 756, 1003, 1138, 1370, 1538, 1718, 2052, 2530, 2794, 3033]",6259,5607,6285,4524,3033,118,1057,-852,-1800,-416,-1893,15,dire
7612131018,49,78,21,58,9,"[0, 213, 437, 681, 1137, 1457, 2006, 2400, 2947, 3320, 4012, 4651, 5665, 6397, 7223]","[0, 250, 527, 847, 1096, 1502, 1954, 2265, 2665, 3127, 3683, 4153, 4622, 4956, 5564]","[0, 325, 700, 1155, 1458, 1752, 2229, 2600, 3050, 3639, 3940, 4630, 5204, 6003, 6807]","[0, 474, 564, 698, 852, 959, 1049, 1435, 1574, 1688, 1904, 2221, 2611, 2856, 3313]","[0, 166, 304, 474, 665, 800, 966, 1192, 1282, 1372, 1741, 1923, 2358, 2554, 2818]",7223,5564,6807,3313,2818,73,69,137,5,65,"[0, 366, 1039, 1509, 1853, 2149, 2672, 3186, 3695, 4112, 4866, 5255, 5669, 6375, 7039]","[0, 210, 539, 687, 1083, 1502, 1664, 2201, 2734, 3147, 3764, 3971, 4620, 5053, 5771]","[0, 293, 501, 834, 1077, 1364, 1663, 2007, 2308, 2930, 3467, 4034, 4737, 5386, 5872]","[0, 210, 372, 538, 742, 832, 1014, 1504, 1639, 2077, 2593, 2761, 2851, 3113, 3208]","[0, 210, 367, 543, 713, 850, 1297, 1652, 1787, 2219, 2642, 2732, 3220, 3569, 4017]",7039,5771,5872,3208,4017,184,-207,935,105,-1199,-182,15,dire
7612171311,89,23,60,9,45,"[0, 130, 331, 691, 984, 1261, 1609, 1974, 2389, 2863, 3531, 4156, 4734, 5458, 6141]","[0, 237, 594, 1083, 1342, 1649, 2235, 2547, 3370, 3933, 4726, 5633, 6004, 6822, 7076]","[0, 214, 486, 770, 1100, 1390, 1915, 2306, 2867, 3333, 4193, 4675, 5327, 5782, 6123]","[0, 130, 220, 421, 544, 680, 826, 1054, 1184, 1871, 2307, 2702, 2933, 3268, 3573]","[100, 230, 368, 488, 693, 783, 873, 1001, 1292, 1584, 2056, 2371, 2655, 2883, 3298]",6141,7076,6123,3573,3298,73,49,13,128,85,"[0, 371, 827, 1139, 1599, 1897, 2376, 3278, 4156, 5108, 6095, 6405, 7474, 8500, 10294]","[0, 300, 628, 892, 1274, 1601, 2059, 2580, 3041, 3320, 3983, 4553, 5160, 5634, 6392]","[0, 330, 650, 943, 1362, 1563, 1812, 2137, 2463, 3043, 3223, 3751, 4336, 4707, 5495]","[0, 214, 402, 545, 750, 895, 1034, 1124, 1509, 2057, 2391, 2578, 2855, 3103, 3627]","[2, 212, 302, 439, 1019, 1109, 1248, 1468, 1626, 1868, 2104, 2194, 2421, 2642, 2965]",10294,6392,5495,3627,2965,-4153,684,628,-54,333,-2562,15,dire
7612195805,48,78,19,123,103,"[0, 273, 601, 1043, 1330, 1828, 2243, 2676, 3155, 3649, 4252, 4962, 5428, 6120, 7088]","[0, 277, 559, 1095, 1386, 1656, 2122, 2516, 3114, 3385, 4078, 4737, 5318, 5795, 6142]","[0, 273, 565, 848, 1259, 1694, 1955, 2298, 2984, 3348, 3812, 4377, 4916, 5174, 5479]","[0, 199, 289, 444, 534, 624, 795, 1002, 1213, 1525, 1946, 2458, 2623, 2945, 3495]","[0, 195, 285, 375, 465, 600, 735, 825, 969, 1291, 1542, 2070, 2208, 2303, 2446]",7088,6142,5479,3495,2446,89,13,129,110,138,"[0, 220, 492, 773, 1273, 1656, 2073, 2485, 2730, 3116, 3629, 3947, 4748, 5657, 6349]","[0, 277, 522, 770, 1139, 1427, 1870, 2183, 2619, 3206, 3528, 3672, 4386, 5017, 5535]","[0, 206, 455, 766, 892, 1172, 1531, 1692, 2031, 2553, 3053, 3197, 3556, 4191, 4786]","[0, 170, 260, 350, 486, 860, 972, 1153, 1339, 1674, 1993, 2277, 2475, 2678, 2898]","[0, 170, 309, 443, 578, 767, 902, 1256, 1346, 1709, 1933, 2242, 2508, 2755, 2975]",6349,5535,4786,2898,2975,739,607,693,597,-529,2107,15,radiant
7612206614,113,21,129,109,64,"[0, 200, 522, 781, 1145, 1435, 1769, 2126, 2780, 2956, 3489, 4232, 4815, 5443, 5868]","[0, 204, 498, 1029, 1333, 1735, 2001, 2370, 2723, 3230, 3824, 4265, 5407, 5852, 6167]","[0, 200, 408, 720, 1035, 1424, 1808, 2108, 2638, 3084, 3542, 3760, 4412, 4852, 5440]","[0, 130, 220, 358, 448, 819, 955, 1045, 1240, 1860, 2085, 2201, 2406, 2725, 2946]","[0, 130, 220, 404, 900, 1016, 1343, 1559, 1812, 2123, 2742, 3362, 3615, 3860, 4009]",5868,6167,5440,2946,4009,22,76,29,123,100,"[0, 410, 659, 1082, 1523, 2052, 2450, 2837, 3429, 4198, 4884, 5406, 6620, 7325, 8387]","[0, 281, 482, 648, 1098, 1312, 1537, 1661, 1868, 2289, 2649, 2973, 3582, 4102, 4717]","[0, 210, 537, 884, 1299, 1665, 2359, 2517, 2795, 3189, 3883, 3973, 4737, 5251, 5906]","[0, 245, 335, 459, 629, 948, 1216, 1356, 1491, 1977, 2358, 2533, 3233, 3490, 4108]","[0, 257, 347, 437, 653, 743, 868, 958, 1093, 1687, 1867, 1991, 2696, 2791, 3250]",8387,4717,5906,4108,3250,-2519,1450,-466,-1162,759,-1938,15,dire
7612212318,95,126,129,40,121,"[0, 251, 919, 1262, 1769, 2344, 2989, 3280, 3783, 4306, 4926, 5532, 5919, 6731, 7504]","[0, 319, 664, 1071, 1409, 1870, 2206, 3016, 3468, 4285, 4864, 5216, 5538, 6091, 6633]","[0, 135, 390, 553, 803, 1085, 1251, 1908, 2253, 2944, 3463, 3777, 4295, 4429, 5073]","[0, 129, 302, 392, 570, 707, 1051, 1141, 1428, 1785, 2021, 2301, 2572, 2946, 3443]","[0, 129, 219, 309, 399, 489, 579, 762, 988, 1309, 1537, 1764, 1854, 2048, 2248]",7504,6633,5073,3443,2248,84,90,96,37,53,"[0, 294, 733, 1167, 1410, 1899, 2276, 2673, 3103, 3647, 4199, 4806, 5336, 6323, 6851]","[0, 356, 684, 1007, 1429, 1721, 2142, 2782, 2872, 3527, 3902, 4528, 4899, 5347, 5884]","[0, 209, 567, 797, 953, 1203, 1408, 2160, 2365, 2504, 2853, 3228, 3813, 4268, 4689]","[0, 209, 299, 518, 608, 792, 983, 1231, 1360, 1617, 1903, 2086, 2369, 2742, 2977]","[0, 209, 299, 419, 716, 851, 975, 1155, 1620, 1970, 2174, 2324, 2516, 3085, 3412]",6851,5884,4689,2977,3412,653,749,384,466,-1164,1088,15,radiant
7612301106,25,36,23,123,111,"[0, 402, 838, 1167, 1535, 2031, 2380, 2836, 3456, 4401, 5047, 5859, 7133, 7889, 8606]","[0, 400, 633, 980, 1428, 1766, 2519, 3110, 3432, 4265, 4848, 5637, 6284, 7391, 8228]","[0, 250, 600, 961, 1503, 1762, 2125, 2549, 3010, 3486, 4148, 4908, 5355, 5991, 6703]","[0, 250, 343, 478, 624, 733, 868, 1273, 1480, 1756, 1992, 2420, 2571, 2790, 3017]","[0, 250, 374, 1015, 1153, 1287, 1602, 2091, 2181, 2438, 2709, 2934, 3038, 3262, 3914]",8606,8228,6703,3017,3914,18,55,64,109,37,"[0, 159, 367, 768, 1176, 1627, 2089, 2292, 2742, 2996, 3392, 3832, 4417, 4942, 5490]","[0, 206, 477, 921, 1126, 1314, 1630, 1892, 2213, 2551, 3051, 3685, 4170, 4408, 4704]","[0, 206, 576, 824, 1000, 1418, 1816, 2184, 2803, 3005, 3446, 3962, 4052, 4686, 4882]","[0, 90, 180, 365, 495, 740, 1190, 1314, 1721, 1811, 2226, 2484, 2774, 3172, 3343]","[0, 90, 180, 270, 494, 628, 980, 1232, 1507, 1722, 1893, 2240, 2377, 2577, 2672]",5490,4704,4882,3343,2672,3116,3524,1821,-326,1242,9377,15,radiant
7612312609,138,97,137,65,91,"[59, 229, 459, 752, 1198, 1791, 2311, 2922, 3388, 4008, 4609, 5241, 5895, 6345, 7329]","[327, 618, 961, 1530, 2068, 2434, 2927, 3455, 4296, 4764, 5340, 5527, 6789, 7071, 7573]","[0, 397, 716, 1036, 1284, 1709, 2115, 2563, 2755, 3442, 3670, 4168, 4812, 5376, 5902]","[59, 229, 405, 611, 1026, 1337, 1515, 2284, 2475, 2720, 2861, 3098, 3462, 3709, 4046]","[59, 229, 398, 488, 749, 1023, 1647, 1943, 2033, 2609, 2872, 3262, 3499, 3659, 4004]",7329,7573,5902,4046,4004,10,17,52,19,5,"[0, 250, 501, 745, 1143, 1433, 1970, 2286, 2478, 2828, 3348, 4436, 4813, 5513, 5877]","[0, 170, 539, 913, 1548, 1800, 2041, 2575, 2953, 3161, 3296, 3790, 4105, 4618, 4892]","[0, 244, 479, 774, 1147, 1674, 1846, 2028, 2274, 2747, 3171, 3422, 4122, 4558, 5104]","[0, 170, 347, 437, 610, 890, 980, 1375, 1499, 1932, 2312, 2692, 2892, 3268, 3530]","[0, 170, 260, 350, 440, 877, 967, 1137, 1227, 1435, 1570, 1660, 1935, 2178, 2273]",5877,4892,5104,3530,2273,1452,2681,798,516,1731,7178,15,radiant
7612444217,19,41,96,86,121,"[0, 327, 533, 955, 1294, 1676, 2084, 2582, 2710, 3004, 3597, 4081, 4515, 4889, 5301]","[0, 205, 485, 721, 1078, 1358, 1853, 2273, 2485, 2741, 2913, 3174, 3584, 3863, 4313]","[0, 298, 460, 663, 1400, 1559, 1821, 2252, 2563, 2931, 3255, 3853, 4164, 4521, 5018]","[0, 170, 260, 350, 682, 772, 1114, 1399, 1489, 1696, 2038, 2221, 2357, 2573, 2964]","[0, 170, 260, 397, 487, 621, 840, 1081, 1234, 1324, 1537, 1662, 1817, 1911, 2530]",5301,4313,5018,2964,2530,46,78,23,9,27,"[0, 206, 403, 769, 976, 1583, 1924, 2337, 2748, 3258, 3633, 4323, 5022, 5936, 6541]","[0, 205, 615, 859, 1063, 1638, 1931, 2257, 2546, 3077, 3504, 4012, 4387, 5009, 6049]","[0, 258, 733, 1035, 1327, 1656, 2191, 2700, 3408, 3751, 4885, 5311, 5891, 6461, 6918]","[0, 218, 355, 445, 570, 801, 970, 1060, 1207, 1520, 2225, 2461, 2819, 3165, 3516]","[0, 216, 306, 396, 577, 853, 1172, 1262, 1583, 1739, 2225, 2407, 2910, 3112, 3434]",6541,6049,6918,3516,3434,-1240,-1736,-1900,-552,-904,-6332,15,dire
7612727213,56,90,112,19,52,"[0, 170, 454, 1144, 1695, 2070, 2441, 2684, 3176, 3570, 3899, 4241, 4888, 5504, 5870]","[0, 256, 481, 731, 1054, 1439, 1903, 2349, 2605, 3084, 3366, 3931, 4021, 4927, 5401]","[0, 170, 349, 817, 1175, 1265, 1426, 1680, 1770, 2398, 2744, 2927, 3119, 3500, 3632]","[0, 170, 260, 487, 617, 823, 913, 1003, 1222, 1410, 1681, 1798, 2040, 2297, 2392]","[0, 170, 260, 496, 731, 868, 1005, 1230, 1366, 1494, 1740, 1920, 2151, 2246, 2544]",5870,5401,3632,2392,2544,126,36,96,123,100,"[0, 368, 768, 1055, 1389, 1843, 2221, 2789, 3441, 3780, 4405, 4859, 5869, 6536, 7043]","[0, 243, 615, 986, 1234, 1756, 2636, 3199, 3777, 4512, 5222, 5754, 6510, 7069, 7734]","[0, 207, 932, 1145, 1559, 1995, 2366, 2615, 2833, 3388, 3791, 4270, 4573, 4811, 5400]","[0, 170, 390, 480, 634, 769, 906, 1183, 1445, 1723, 1956, 2357, 2904, 3107, 3915]","[0, 170, 279, 369, 459, 713, 955, 1135, 1317, 1475, 1908, 2060, 2308, 2553, 2877]",7043,7734,5400,3915,2877,-1173,-2333,-1768,-1523,-333,-7130,15,dire
7612885808,69,94,23,20,123,"[0, 232, 592, 860, 1088, 1351, 2247, 2659, 2920, 3286, 4020, 4559, 5540, 6049, 6472]","[0, 232, 407, 599, 976, 1353, 1637, 2145, 2688, 3106, 3795, 4144, 4798, 5418, 5975]","[0, 665, 954, 1302, 1705, 2157, 2528, 3146, 3651, 3996, 4224, 4672, 5227, 5767, 6408]","[0, 329, 419, 539, 646, 1006, 1279, 1622, 1896, 2166, 2508, 2781, 3050, 3149, 3260]","[0, 249, 339, 459, 549, 639, 912, 1002, 1092, 1336, 1518, 1755, 2318, 2509, 2656]",6472,5975,6408,3260,2656,70,106,96,53,5,"[0, 367, 717, 1256, 1739, 2304, 2559, 3121, 3579, 4097, 4662, 5219, 5926, 6720, 7330]","[0, 295, 609, 846, 1090, 1453, 1832, 2235, 3302, 3930, 4493, 4718, 4925, 5396, 6048]","[0, 245, 598, 765, 1156, 1554, 2009, 2372, 2636, 3052, 3513, 3811, 4150, 4749, 5350]","[0, 210, 538, 698, 788, 1300, 1474, 2070, 2398, 2741, 2997, 3232, 3368, 3711, 4282]","[0, 210, 330, 490, 1078, 1311, 1441, 1856, 2186, 2343, 2700, 2790, 3107, 3361, 3745]",7330,6048,5350,4282,3745,-858,-73,1058,-1022,-1089,-1984,15,dire
7613053405,48,98,23,68,20,"[0, 325, 657, 1024, 1346, 1760, 1888, 2527, 2898, 3229, 3640, 4021, 4604, 5317, 6223]","[0, 257, 491, 704, 998, 1243, 1370, 1870, 2357, 3090, 3555, 3978, 4713, 5400, 5869]","[0, 247, 583, 835, 1121, 1372, 1876, 2608, 2987, 3449, 4266, 4814, 5104, 5591, 6124]","[0, 170, 260, 394, 513, 647, 737, 1163, 1288, 1378, 2102, 2528, 2684, 2885, 3337]","[0, 170, 352, 486, 576, 666, 756, 1077, 1167, 1444, 1798, 2171, 2282, 2569, 3265]",6223,5869,6124,3337,3265,138,36,129,119,85,"[0, 255, 689, 1130, 1623, 2094, 2533, 3052, 3584, 4048, 4273, 4715, 5443, 6256, 7137]","[0, 365, 655, 983, 1467, 1797, 2481, 3039, 3555, 4175, 4737, 5214, 5964, 6455, 7254]","[0, 244, 493, 691, 1316, 1517, 2018, 2365, 2996, 3356, 3581, 4009, 4357, 5128, 5972]","[0, 170, 280, 405, 604, 694, 1080, 1478, 1613, 1780, 2383, 2473, 2646, 3240, 3718]","[0, 170, 260, 396, 643, 782, 928, 1251, 1421, 1593, 1856, 2046, 2183, 2612, 3291]",7137,7254,5972,3718,3291,-914,-1385,152,-381,-26,-2554,15,radiant
7613240917,109,19,23,121,112,"[0, 209, 576, 855, 1135, 1382, 1804, 2044, 2431, 3084, 3399, 4232, 4626, 5093, 6318]","[0, 244, 461, 937, 1350, 1790, 2054, 2662, 2954, 3449, 3821, 3949, 4391, 5021, 5774]","[0, 289, 453, 748, 1164, 1571, 2190, 2765, 3342, 3781, 4025, 4657, 5394, 6205, 6715]","[0, 170, 358, 571, 750, 875, 1012, 1157, 1441, 1817, 2079, 2681, 2996, 3186, 3380]","[0, 170, 260, 418, 548, 673, 811, 946, 1287, 1498, 1588, 2006, 2186, 2324, 2518]",6318,5774,6715,3380,2518,48,126,84,43,123,"[0, 170, 440, 901, 1300, 1550, 1761, 2094, 2600, 3059, 3483, 4304, 5066, 5963, 6841]","[0, 286, 617, 946, 1277, 1637, 2052, 2436, 2850, 3251, 4421, 5367, 5989, 6635, 7380]","[0, 170, 260, 399, 562, 652, 742, 871, 1255, 1624, 2245, 2800, 3308, 3638, 3942]","[0, 253, 463, 825, 1119, 1505, 1918, 2315, 2491, 2711, 3457, 3634, 4421, 4818, 5264]","[0, 170, 309, 448, 724, 860, 998, 1652, 1742, 1832, 2170, 2321, 2885, 3178, 3479]",6841,7380,3942,5264,3479,-523,-1606,2773,-1884,-961,-2201,15,dire
7613249411,23,10,21,19,84,"[0, 293, 670, 984, 1350, 1745, 2238, 2593, 3191, 3944, 4463, 5088, 5700, 6330, 7013]","[0, 285, 568, 1010, 1556, 1975, 2358, 2704, 3079, 3435, 3975, 4431, 5293, 5974, 6651]","[0, 204, 490, 903, 1271, 1735, 2107, 2550, 2989, 3393, 4249, 4813, 5384, 5874, 6315]","[0, 221, 311, 480, 570, 725, 815, 954, 1044, 1205, 1460, 1597, 1741, 2057, 2365]","[0, 170, 299, 527, 617, 707, 797, 887, 977, 1177, 1312, 1455, 1934, 2137, 2322]",7013,6651,6315,2365,2322,46,2,107,121,83,"[0, 205, 559, 809, 1171, 1582, 1974, 2606, 3130, 3606, 4141, 4690, 5700, 6433, 7444]","[0, 248, 540, 1107, 1489, 2016, 2486, 3493, 4044, 4853, 5509, 6022, 6400, 6905, 8093]","[0, 255, 524, 846, 1228, 1526, 1785, 2347, 2823, 3156, 3705, 4001, 4514, 4987, 5677]","[0, 205, 295, 464, 634, 841, 931, 1260, 1350, 1698, 1882, 2117, 2375, 2470, 3295]","[0, 170, 260, 350, 682, 772, 910, 1106, 1243, 1421, 1511, 1679, 1817, 2086, 2860]",7444,8093,5677,3295,2860,-431,-1442,638,-930,-538,-2703,15,dire
7613422607,70,86,84,121,88,"[0, 242, 566, 959, 1293, 1701, 2120, 2596, 3044, 3560, 4031, 4424, 4770, 5381, 6383]","[0, 284, 603, 1022, 1281, 1685, 2352, 2881, 3386, 3561, 4052, 4639, 5139, 5973, 7082]","[0, 283, 480, 875, 1219, 1579, 2066, 2266, 2617, 2790, 3287, 3416, 3913, 4111, 4931]","[0, 169, 259, 394, 484, 620, 710, 845, 935, 1046, 1478, 1568, 1775, 2047, 2404]","[0, 169, 309, 446, 536, 626, 995, 1085, 1175, 1313, 1494, 1693, 1783, 2120, 2611]",6383,7082,4931,2404,2611,106,19,54,119,5,"[0, 297, 490, 708, 1158, 1539, 1976, 2355, 2873, 3516, 4386, 4837, 5380, 5529, 5969]","[0, 242, 522, 957, 1547, 1913, 2531, 2915, 3214, 3580, 4020, 4635, 5066, 5974, 6367]","[0, 284, 532, 820, 1071, 1494, 1864, 2550, 3205, 3779, 4431, 4945, 5299, 6117, 6683]","[0, 510, 666, 802, 971, 1108, 1275, 1626, 1915, 2126, 2409, 2499, 2589, 2883, 3194]","[0, 169, 259, 403, 534, 716, 806, 1314, 1767, 1992, 2414, 2524, 2614, 2879, 2974]",5969,6367,6683,3194,2974,414,715,-1752,-790,-363,-1776,15,dire
7613436713,13,93,55,85,19,"[0, 207, 480, 760, 1088, 1379, 1780, 2214, 2786, 3222, 3751, 4202, 4352, 4953, 5548]","[0, 200, 519, 846, 1059, 1574, 1935, 2378, 2732, 3090, 3411, 4010, 4529, 5346, 5913]","[0, 239, 544, 897, 1356, 1590, 1983, 2143, 2518, 3066, 3289, 3807, 4403, 4813, 5464]","[0, 132, 247, 381, 488, 626, 753, 939, 1119, 1397, 1670, 1760, 1886, 2047, 2151]","[0, 132, 627, 772, 1123, 1257, 1347, 1437, 1796, 2010, 2234, 2351, 2469, 2617, 2783]",5548,5913,5464,2151,2783,89,59,129,65,52,"[0, 331, 571, 896, 1202, 1610, 1900, 2357, 2689, 3068, 3450, 4152, 4675, 5363, 6056]","[0, 282, 583, 946, 1156, 1490, 1852, 2633, 3022, 3767, 4286, 5140, 5655, 6190, 6929]","[0, 257, 419, 647, 944, 1303, 1598, 2008, 2468, 3195, 3905, 4451, 5293, 5958, 6475]","[100, 310, 400, 539, 773, 925, 1147, 1659, 2021, 2428, 2925, 3418, 3593, 3777, 4405]","[0, 210, 300, 390, 480, 619, 754, 987, 1125, 1415, 1939, 2279, 2436, 2669, 2928]",6056,6929,6475,4405,2928,-508,-1016,-1011,-2254,-145,-4934,15,dire
7613494811,48,69,49,9,85,"[0, 296, 921, 1420, 1620, 1825, 2371, 2919, 3382, 3916, 4298, 4462, 4730, 5508, 5954]","[0, 297, 614, 905, 1236, 1516, 1797, 2279, 2576, 2816, 3664, 4263, 5050, 5771, 6064]","[0, 319, 637, 1071, 1467, 1754, 2221, 2594, 3193, 3663, 4402, 4610, 4948, 5469, 6089]","[0, 246, 353, 539, 728, 944, 1197, 1409, 1604, 1951, 2285, 2413, 2848, 3091, 3475]","[0, 210, 369, 504, 594, 734, 914, 1155, 1290, 1469, 1685, 1775, 1979, 2161, 2491]",5954,6064,6089,3475,2491,72,46,129,58,123,"[0, 238, 761, 1009, 1548, 1869, 2340, 2867, 3498, 3948, 4569, 5256, 5907, 6746, 7859]","[0, 130, 470, 693, 866, 1226, 1475, 1929, 2286, 2724, 3329, 3804, 4779, 5805, 6512]","[0, 207, 413, 700, 1151, 1514, 1853, 2217, 2625, 3168, 3616, 4310, 5066, 5823, 6420]","[0, 173, 346, 439, 641, 783, 873, 1008, 1422, 1557, 2026, 2424, 2981, 3544, 4064]","[0, 130, 292, 431, 567, 742, 902, 1216, 1387, 1605, 1722, 1964, 2276, 2901, 3081]",7859,6512,6420,4064,3081,-1905,-448,-331,-589,-590,-3863,15,dire
7614749518,80,69,109,14,5,"[0, 369, 617, 789, 1117, 1473, 1908, 2514, 3084, 4145, 4710, 5336, 6267, 7066, 7688]","[0, 328, 652, 1032, 1364, 1940, 2509, 3126, 3620, 4238, 4570, 5280, 6064, 6540, 7027]","[0, 170, 540, 870, 1219, 1472, 1913, 2129, 2368, 2869, 3205, 3715, 4235, 4805, 5407]","[0, 170, 260, 394, 484, 837, 1048, 1308, 1463, 2111, 2490, 2829, 3348, 4033, 4367]","[0, 320, 747, 883, 1019, 1155, 1294, 1520, 1653, 1985, 2244, 2471, 2831, 3111, 3329]",7688,7027,5407,4367,3329,44,48,21,20,83,"[0, 325, 727, 1144, 1550, 2032, 2431, 2980, 3466, 3628, 4433, 5123, 5918, 6580, 7194]","[0, 250, 545, 743, 1155, 1788, 2128, 2741, 3326, 3895, 4318, 4937, 5201, 5897, 6711]","[0, 170, 461, 748, 1074, 1272, 1515, 1974, 2658, 3141, 3984, 4375, 4872, 5692, 6717]","[0, 170, 260, 350, 440, 565, 655, 1065, 1780, 1870, 2095, 2455, 2643, 2993, 3302]","[0, 170, 260, 400, 538, 752, 857, 947, 1178, 1397, 1622, 1712, 1802, 2000, 2451]",7194,6711,6717,3302,2451,494,316,-1310,1065,878,1443,15,radiant
7614789915,73,17,52,5,87,"[0, 288, 777, 1257, 1488, 2007, 2840, 3589, 3937, 4948, 5685, 6588, 8160, 9346, 10463]","[0, 286, 690, 1052, 1503, 2019, 2188, 2753, 3129, 3566, 4041, 5212, 5862, 6315, 6781]","[0, 247, 478, 844, 1138, 1464, 1665, 2022, 2408, 3218, 3812, 4814, 5418, 6058, 6539]","[0, 129, 221, 356, 446, 573, 708, 879, 981, 1189, 1430, 1520, 1813, 1962, 2197]","[0, 129, 219, 309, 399, 489, 624, 714, 820, 1071, 1406, 1818, 2033, 2243, 2524]",10463,6781,6539,2197,2524,18,97,39,79,91,"[0, 363, 779, 1140, 1550, 1972, 2515, 3070, 3670, 4294, 5072, 5762, 6571, 7404, 8229]","[0, 330, 650, 1072, 1430, 1660, 2218, 2715, 3180, 3589, 4010, 4514, 4758, 5578, 6878]","[0, 331, 680, 1085, 1454, 1729, 2214, 2686, 3243, 3721, 4249, 4398, 5014, 5448, 6136]","[0, 209, 299, 419, 509, 599, 783, 873, 963, 1112, 1331, 1421, 1511, 1769, 2204]","[0, 209, 299, 419, 554, 665, 930, 1089, 1233, 1368, 1563, 1709, 1834, 2032, 2126]",8229,6878,6136,2204,2126,2234,-97,403,-7,398,2931,15,radiant
7614872608,73,18,84,27,21,"[0, 429, 691, 1161, 1722, 2705, 3213, 3763, 4478, 4915, 5645, 6166, 8228, 9360, 10083]","[0, 205, 608, 1060, 1514, 1961, 2415, 3005, 3598, 4190, 5135, 5920, 6660, 7573, 8266]","[0, 246, 535, 712, 802, 1136, 1226, 1474, 1728, 1892, 2398, 2488, 3022, 3273, 3798]","[0, 170, 260, 395, 485, 667, 923, 1013, 1188, 1513, 1702, 1969, 2629, 3108, 3274]","[0, 170, 260, 350, 440, 579, 716, 806, 896, 986, 1224, 1314, 1512, 1813, 1907]",10083,8266,3798,3274,1907,39,10,96,86,5,"[0, 290, 659, 867, 1437, 1752, 2347, 3068, 3479, 4230, 4781, 5680, 6249, 6799, 7619]","[0, 206, 620, 915, 1284, 1737, 2123, 2732, 3102, 3769, 4317, 4986, 5501, 6025, 6715]","[0, 170, 478, 809, 1262, 1670, 1980, 2560, 2933, 3642, 4214, 4564, 5107, 5501, 6140]","[0, 170, 356, 497, 627, 717, 824, 1052, 1222, 1538, 1855, 2184, 2297, 2729, 3293]","[0, 170, 260, 350, 497, 587, 722, 812, 947, 1293, 1436, 1545, 1635, 1801, 2063]",7619,6715,6140,3293,2063,2464,1551,-2342,-19,-156,1498,15,radiant
7614970519,41,28,76,110,114,"[0, 232, 577, 802, 1302, 1542, 1860, 2382, 2978, 3511, 3962, 4411, 5012, 5451, 6060]","[0, 231, 518, 840, 1290, 1611, 1964, 2724, 3171, 3593, 4152, 4761, 5320, 5722, 6467]","[0, 305, 624, 950, 1341, 1669, 2087, 2624, 3155, 3704, 4073, 4693, 5335, 5888, 6567]","[100, 294, 419, 509, 685, 882, 1100, 1273, 1648, 1930, 2175, 2361, 2673, 2954, 3375]","[0, 194, 319, 409, 539, 704, 1042, 1310, 1445, 1604, 1694, 1844, 2034, 2183, 2278]",6060,6467,6567,3375,2278,95,13,96,105,103,"[0, 350, 670, 989, 1395, 1904, 2239, 2786, 3285, 3763, 4308, 4963, 5582, 5849, 6455]","[0, 301, 540, 839, 1175, 1492, 1793, 2057, 2426, 2792, 3309, 3837, 4355, 4709, 4976]","[0, 531, 849, 1223, 1739, 2141, 2510, 2795, 3309, 3600, 4184, 4602, 5006, 5396, 5538]","[0, 363, 453, 586, 716, 925, 1015, 1105, 1243, 1333, 1468, 1752, 2066, 2682, 3030]","[0, 194, 284, 374, 504, 765, 900, 990, 1208, 1582, 1717, 1861, 1972, 2067, 2266]",6455,4976,5538,3030,2266,-395,1491,1029,345,12,2482,15,radiant
7615326007,1,129,13,123,58,"[0, 169, 566, 925, 1324, 1488, 2098, 2477, 2768, 3158, 3708, 4276, 5660, 6128, 7011]","[0, 130, 414, 727, 973, 1550, 1724, 1853, 2314, 2537, 3168, 3728, 4467, 5161, 5829]","[0, 288, 606, 870, 1286, 1655, 2048, 2289, 2901, 3664, 4194, 4981, 5682, 6101, 6848]","[0, 130, 220, 310, 437, 835, 1046, 1181, 1518, 1608, 2276, 2572, 2990, 3248, 3562]","[0, 176, 266, 356, 800, 930, 1109, 1244, 1334, 1531, 1879, 2097, 2623, 2871, 3125]",7011,5829,6848,3562,3125,48,46,78,27,105,"[0, 282, 515, 894, 1194, 1485, 1949, 2321, 2904, 3256, 3596, 4273, 5047, 5771, 6526]","[0, 319, 664, 1076, 1356, 1743, 2262, 2683, 3261, 3812, 4324, 4980, 5070, 5392, 5996]","[0, 246, 451, 682, 1044, 1527, 1765, 1987, 2404, 2776, 3417, 3650, 3899, 4434, 4721]","[0, 210, 390, 496, 648, 738, 896, 1081, 1341, 1431, 1787, 2093, 2192, 2491, 2984]","[0, 210, 300, 428, 518, 608, 976, 1166, 1346, 1442, 1731, 1821, 2073, 2507, 2736]",6526,5996,4721,2984,2736,485,-167,2127,578,389,3412,15,radiant
7615645410,13,18,23,58,5,"[0, 206, 569, 852, 1106, 1425, 1727, 2278, 2657, 3051, 3497, 4229, 5409, 6046, 6566]","[0, 254, 570, 1118, 1656, 2080, 2731, 3083, 3689, 4202, 4375, 4811, 5751, 6463, 7271]","[0, 217, 393, 834, 1522, 1777, 2258, 2777, 3140, 3652, 4283, 4913, 5394, 6208, 6590]","[0, 170, 260, 394, 582, 877, 1000, 1474, 1579, 1794, 1992, 2336, 2748, 3262, 3658]","[100, 270, 395, 546, 757, 896, 1094, 1229, 1419, 1554, 1753, 2090, 2734, 2918, 3383]",6566,7271,6590,3658,3383,82,55,19,62,40,"[0, 239, 533, 900, 1101, 1514, 1876, 2421, 2674, 3205, 3516, 4054, 4827, 5369, 6014]","[0, 206, 410, 534, 1247, 1516, 1758, 2923, 3352, 3975, 4541, 5237, 5683, 6058, 6796]","[0, 245, 540, 882, 1319, 1637, 2053, 2235, 2482, 2973, 3555, 4136, 4653, 5272, 5483]","[0, 170, 260, 350, 536, 684, 810, 1104, 1459, 1640, 1833, 2073, 3043, 3245, 3394]","[0, 170, 260, 350, 501, 595, 685, 889, 1101, 1279, 1552, 1895, 2190, 2432, 2984]",6014,6796,5483,3394,2984,552,475,1107,264,399,2797,15,dire
7615652918,21,36,96,109,20,"[0, 311, 561, 899, 1271, 1836, 2173, 2581, 2994, 3661, 3934, 4426, 5011, 5745, 6546]","[0, 238, 509, 711, 1031, 1198, 1498, 1773, 2245, 2595, 2820, 3266, 3541, 4172, 4560]","[0, 266, 775, 1183, 1466, 1642, 2132, 2567, 2982, 3439, 3960, 4344, 4776, 5533, 6076]","[0, 195, 374, 464, 636, 742, 877, 1088, 1178, 1559, 1785, 2089, 2398, 2710, 3393]","[0, 195, 285, 375, 684, 774, 1031, 1263, 1353, 1653, 1834, 2008, 2279, 2572, 2815]",6546,4560,6076,3393,2815,52,93,71,123,121,"[0, 256, 457, 837, 1174, 1475, 2046, 2664, 3068, 3408, 3727, 4247, 4760, 5461, 6255]","[0, 208, 509, 634, 888, 1129, 1334, 1744, 2076, 2268, 2674, 3336, 3952, 4631, 5229]","[0, 170, 370, 549, 1105, 1710, 2035, 2651, 3141, 3775, 4359, 4980, 5537, 6096, 6667]","[0, 170, 260, 402, 882, 1347, 1482, 1972, 2252, 2644, 3387, 3987, 4167, 4538, 5171]","[100, 316, 406, 496, 586, 740, 920, 1175, 1265, 1355, 1525, 1895, 2075, 2331, 2479]",6255,5229,6667,5171,2479,291,-669,-591,-1778,336,-2411,15,dire
7615934413,98,106,78,121,26,"[0, 326, 636, 921, 1305, 1717, 1987, 2800, 2973, 3525, 4226, 4836, 5402, 6073, 6627]","[0, 605, 973, 1350, 1733, 1971, 2528, 2817, 3177, 3646, 4208, 4611, 5455, 6001, 6743]","[0, 170, 331, 649, 902, 1284, 1374, 1831, 2365, 2609, 3032, 3839, 4346, 5079, 5719]","[0, 338, 428, 567, 701, 791, 930, 1231, 1321, 1751, 2075, 2357, 2611, 2904, 3214]","[0, 435, 525, 615, 705, 892, 982, 1216, 1306, 1517, 1843, 2019, 2623, 2916, 3078]",6627,6743,5719,3214,3078,72,21,66,80,19,"[0, 208, 658, 991, 1363, 1575, 2085, 2482, 2874, 3480, 4016, 4456, 4645, 5094, 5522]","[0, 325, 684, 1138, 1473, 1774, 2165, 2865, 3447, 3666, 4095, 4615, 5013, 5613, 6174]","[0, 170, 290, 468, 639, 906, 1064, 1244, 1711, 1801, 1930, 2348, 2853, 3222, 3393]","[0, 170, 472, 670, 949, 1584, 2004, 2632, 3021, 3111, 3369, 3879, 4008, 4298, 4713]","[0, 170, 334, 424, 549, 750, 949, 1303, 1393, 1493, 1630, 1857, 1947, 2042, 2219]",5522,6174,3393,4713,2219,1105,569,2326,-1499,859,3360,15,radiant
7616110516,18,98,43,45,121,"[0, 243, 407, 691, 1032, 1601, 1939, 2318, 2754, 3093, 3792, 4561, 5461, 6448, 6961]","[0, 250, 491, 891, 1304, 1604, 1994, 2489, 2893, 3240, 3938, 4604, 5309, 5976, 6108]","[0, 213, 550, 809, 957, 1279, 1920, 2260, 2603, 2993, 3608, 4380, 4838, 5405, 5573]","[0, 182, 320, 410, 500, 653, 840, 1065, 1200, 1375, 2146, 2470, 2662, 3145, 3367]","[0, 130, 220, 310, 537, 642, 939, 1362, 1713, 2053, 2362, 2506, 2849, 3239, 3334]",6961,6108,5573,3367,3334,53,46,78,100,30,"[59, 375, 586, 988, 1279, 1515, 2429, 2748, 2966, 3363, 4057, 4460, 5049, 5869, 6843]","[59, 316, 740, 1204, 1416, 1685, 1894, 2261, 2648, 3103, 3600, 4106, 4352, 4599, 5676]","[59, 308, 591, 848, 1084, 1337, 1700, 2103, 2434, 2806, 3389, 3941, 4515, 5367, 6030]","[59, 269, 359, 497, 627, 761, 869, 1449, 1539, 1694, 2239, 2457, 2654, 2803, 3266]","[327, 537, 627, 786, 976, 1066, 1277, 1586, 1713, 1803, 1983, 2216, 2403, 2552, 3239]",6843,5676,6030,3266,3239,118,432,-457,101,95,289,15,dire
7616158604,67,109,112,137,100,"[0, 89, 417, 674, 799, 923, 1262, 1721, 2110, 2348, 2808, 3231, 3947, 5218, 5821]","[0, 169, 259, 349, 439, 529, 709, 1282, 1514, 1719, 1985, 2187, 2879, 3312, 3765]","[0, 474, 716, 930, 1570, 1765, 1983, 2271, 2813, 3237, 3793, 4217, 4663, 4938, 5502]","[0, 240, 416, 747, 873, 1086, 1372, 1633, 2021, 2426, 2677, 3068, 3694, 4394, 4764]","[0, 169, 259, 349, 603, 693, 873, 1008, 1098, 1370, 1550, 1928, 2447, 2865, 3332]",5821,3765,5502,4764,3332,49,21,76,9,65,"[0, 409, 606, 885, 1336, 1708, 2234, 2738, 3127, 3900, 4563, 5118, 5327, 5568, 6546]","[0, 324, 748, 1121, 1462, 1787, 2253, 2766, 3055, 3572, 4013, 4517, 4657, 5290, 5631]","[0, 337, 703, 1049, 1503, 1802, 2263, 2718, 3530, 3850, 4288, 4687, 4962, 5111, 5445]","[0, 249, 339, 476, 706, 963, 1165, 1394, 1591, 1980, 2323, 2628, 2988, 3528, 3861]","[0, 249, 339, 429, 612, 826, 979, 1223, 1383, 1636, 1891, 2468, 2866, 3142, 3907]",6546,5631,5445,3861,3907,-725,-1866,57,903,-575,-2206,15,dire
7616192306,73,21,78,45,20,"[328, 692, 1121, 1323, 1699, 2528, 3005, 3825, 4499, 5641, 6409, 7047, 7998, 8624, 9124]","[58, 633, 874, 1296, 1707, 2069, 2784, 3392, 3938, 5024, 5314, 5933, 6735, 6830, 7830]","[58, 314, 601, 802, 1160, 1489, 2052, 2525, 3249, 3793, 4255, 4382, 4788, 5355, 6351]","[58, 415, 697, 787, 923, 1659, 1794, 2163, 2405, 2752, 3015, 3392, 3688, 4088, 4799]","[58, 576, 666, 756, 846, 1006, 1217, 1408, 1578, 1790, 1970, 2132, 2312, 2484, 2723]",9124,7830,6351,4799,2723,48,29,106,100,64,"[0, 205, 490, 990, 1245, 1796, 2038, 2200, 2362, 2730, 3206, 3856, 4472, 5115, 5878]","[0, 243, 509, 925, 1217, 1396, 1800, 2369, 3005, 3651, 4165, 4990, 5475, 5942, 6446]","[0, 473, 746, 1029, 1286, 1673, 1763, 2104, 2513, 2693, 3073, 3228, 3487, 3827, 4394]","[0, 254, 381, 755, 915, 1067, 1340, 2078, 2321, 2501, 2791, 3190, 3280, 3960, 4921]","[0, 254, 344, 676, 766, 1045, 1135, 1225, 1403, 1583, 1964, 2475, 2565, 2969, 3364]",5878,6446,4394,4921,3364,3246,1384,1957,-122,-641,5824,15,dire
7616388415,78,95,137,65,66,"[72, 357, 564, 846, 1223, 1587, 2166, 2855, 3490, 4263, 4995, 5664, 6135, 6775, 7455]","[72, 403, 627, 994, 1522, 2113, 2507, 2746, 3341, 3738, 4280, 4979, 5705, 6380, 7066]","[72, 317, 609, 976, 1274, 1535, 2056, 2683, 3307, 4088, 4364, 4706, 5333, 5792, 6540]","[72, 242, 332, 446, 536, 748, 911, 1354, 1955, 2792, 3203, 3848, 4463, 4824, 5213]","[205, 375, 701, 791, 1314, 1493, 1615, 2069, 2348, 2983, 3420, 3682, 4282, 4701, 5139]",7455,7066,6540,5213,5139,113,25,96,21,5,"[579, 749, 999, 1293, 1646, 1934, 2108, 2462, 2712, 3243, 4275, 4688, 5063, 5728, 6029]","[122, 375, 578, 982, 1432, 1956, 2239, 2428, 2518, 2692, 3408, 3884, 4173, 4473, 5059]","[178, 348, 826, 1127, 1454, 1719, 2057, 2474, 3073, 3260, 3646, 3962, 4052, 4147, 4391]","[311, 481, 571, 705, 883, 1095, 1268, 1419, 2225, 2365, 2631, 2721, 2811, 3025, 3206]","[178, 348, 438, 528, 926, 1076, 1210, 1379, 1606, 1746, 2012, 2102, 2192, 2287, 2435]",6029,5059,4391,3206,2435,1426,2007,2149,2007,2704,10293,15,radiant
7616681204,10,88,129,79,121,"[64, 255, 607, 836, 1206, 1404, 1723, 2387, 2848, 3318, 3798, 4322, 4622, 5022, 5641]","[64, 333, 683, 1013, 1461, 1906, 2536, 2926, 3257, 3835, 4422, 4739, 4988, 5321, 5972]","[64, 271, 622, 1038, 1176, 1418, 1685, 2088, 2687, 3327, 3532, 4032, 4415, 4853, 4948]","[64, 219, 327, 417, 524, 614, 704, 945, 1166, 1337, 1662, 1752, 1889, 1983, 2261]","[332, 487, 577, 714, 804, 894, 1192, 1327, 1667, 2024, 2556, 2926, 3016, 3110, 3388]",5641,5972,4948,2261,3388,13,136,49,53,58,"[265, 601, 998, 1211, 1496, 1841, 2370, 2833, 3285, 3952, 4379, 4857, 5542, 6456, 6810]","[132, 378, 1003, 1301, 1907, 2346, 2753, 3070, 3367, 3840, 4425, 4768, 5639, 6109, 6865]","[69, 317, 616, 1019, 1289, 1851, 2103, 2316, 2720, 3310, 3884, 4232, 4793, 5493, 5958]","[269, 479, 628, 738, 1012, 1149, 1315, 1675, 1849, 2195, 2790, 3017, 3604, 4122, 4414]","[132, 342, 434, 588, 783, 995, 1101, 1255, 1365, 1996, 2365, 2563, 3271, 3597, 3936]",6810,6865,5958,4414,3936,-1169,-893,-1010,-2153,-548,-5773,15,dire
7616783111,94,22,137,9,26,"[0, 193, 441, 680, 1052, 1413, 1818, 2313, 2637, 2964, 3531, 4092, 4558, 5284, 5872]","[0, 252, 501, 834, 1211, 1616, 1800, 2348, 2727, 3462, 3909, 4584, 4889, 5310, 5740]","[0, 170, 492, 892, 1139, 1485, 1926, 2258, 2511, 2684, 3021, 3364, 4417, 4829, 5373]","[0, 139, 309, 497, 673, 767, 994, 1129, 1298, 1449, 1584, 1725, 2121, 2265, 2437]","[0, 89, 179, 351, 481, 571, 661, 796, 898, 1002, 1221, 1311, 1616, 1711, 1806]",5872,5740,5373,2437,1806,109,35,96,123,20,"[0, 249, 518, 883, 1386, 1754, 2417, 2879, 3489, 3940, 4644, 5014, 5622, 6362, 6670]","[0, 249, 509, 877, 1174, 1591, 2308, 2810, 3697, 4140, 4964, 5496, 6146, 6967, 7544]","[0, 285, 631, 920, 1211, 1661, 1939, 2304, 2629, 3065, 3392, 3980, 4513, 5304, 5914]","[100, 349, 478, 675, 898, 1023, 1158, 1293, 1503, 1839, 2136, 2632, 3186, 3568, 4144]","[0, 249, 389, 497, 630, 838, 1139, 1274, 1460, 1664, 1862, 2011, 2253, 2517, 2696]",6670,7544,5914,4144,2696,-798,-1804,-541,-1707,-890,-5740,15,dire
7616790114,96,120,95,53,112,"[328, 684, 948, 1434, 1784, 2529, 2854, 3421, 3909, 4721, 5260, 5697, 6176, 6415, 7147]","[60, 456, 743, 1186, 1680, 2084, 2887, 3488, 4028, 4313, 4962, 5527, 5862, 6338, 7001]","[60, 390, 641, 731, 949, 1287, 1614, 1886, 2240, 2711, 3082, 3331, 3894, 4537, 4984]","[60, 476, 610, 938, 1479, 1894, 2140, 2230, 2320, 2605, 3230, 3470, 4030, 4526, 5176]","[60, 294, 384, 782, 1025, 1391, 1481, 1644, 1781, 2066, 2330, 2464, 2746, 2937, 3208]",7147,7001,4984,5176,3208,46,17,23,123,5,"[0, 203, 490, 903, 1029, 1263, 1673, 2103, 2474, 3160, 3731, 4332, 5540, 6297, 7389]","[0, 462, 858, 1265, 1604, 2027, 2187, 2919, 3611, 4057, 4521, 4909, 5130, 5428, 6179]","[0, 334, 775, 1309, 1709, 2077, 2637, 3192, 4009, 4562, 4856, 5731, 6283, 6822, 7616]","[0, 348, 513, 684, 995, 1125, 1436, 1526, 1616, 1966, 2241, 2651, 2741, 3008, 3509]","[0, 564, 700, 837, 1013, 1225, 1417, 1622, 2161, 2546, 2699, 3248, 3603, 3886, 4260]",7389,6179,7616,3509,4260,-242,822,-2632,1667,-1052,-1437,15,dire
7616882903,1,76,98,27,5,"[0, 154, 410, 691, 937, 1295, 1587, 1911, 2153, 2394, 2683, 2864, 3453, 3968, 4566]","[0, 242, 528, 767, 1192, 1614, 2368, 2706, 3033, 3457, 4086, 4794, 5347, 6210, 6803]","[0, 239, 488, 791, 1084, 1610, 1874, 2211, 2417, 2772, 3411, 3858, 4739, 5255, 5883]","[0, 154, 244, 488, 717, 936, 1219, 1309, 1399, 1571, 1937, 2152, 2638, 3255, 3404]","[0, 154, 244, 462, 721, 894, 1065, 1155, 1370, 1732, 2004, 2149, 2547, 2977, 3178]",4566,6803,5883,3404,3178,72,21,129,85,105,"[0, 258, 610, 898, 1311, 1609, 1900, 2345, 2815, 3242, 3845, 4292, 5114, 5618, 6186]","[0, 378, 629, 927, 1309, 1641, 2065, 2561, 3017, 3311, 3955, 4374, 4802, 5429, 6049]","[0, 290, 722, 1037, 1357, 1765, 2140, 2602, 3142, 3754, 4211, 4969, 5462, 5751, 6228]","[0, 209, 299, 409, 545, 669, 844, 1070, 1202, 1375, 1533, 1715, 2156, 2399, 2598]","[0, 209, 636, 726, 845, 1005, 1095, 1350, 1575, 1710, 1845, 2288, 2819, 2914, 3141]",6186,6049,6228,2598,3141,-1620,754,-345,806,37,-368,15,dire
7617757908,46,25,78,86,30,"[0, 290, 593, 959, 1163, 1525, 1893, 2340, 2739, 3183, 3728, 4538, 5363, 6057, 6566]","[0, 252, 536, 951, 1247, 1631, 2056, 2559, 3173, 3879, 4266, 4894, 5427, 5672, 6409]","[0, 282, 596, 925, 1356, 1644, 2174, 2580, 3032, 3344, 3633, 4094, 4676, 5468, 5842]","[0, 221, 413, 592, 777, 907, 1092, 1227, 1349, 1488, 1748, 2033, 2288, 2631, 2893]","[0, 169, 259, 397, 524, 654, 926, 1164, 1273, 1381, 1627, 1855, 1981, 2379, 3250]",6566,6409,5842,2893,3250,48,49,39,123,84,"[0, 205, 638, 962, 1415, 1730, 2048, 2417, 2929, 3402, 3910, 4447, 5226, 6004, 6792]","[0, 242, 405, 665, 964, 1441, 1881, 2137, 2491, 2816, 3379, 4170, 4920, 5631, 6341]","[0, 254, 450, 755, 1016, 1189, 1440, 1979, 2231, 3063, 3274, 4217, 4702, 5427, 5954]","[0, 215, 389, 479, 730, 1234, 1679, 1815, 2005, 2144, 2555, 3098, 3296, 3910, 4311]","[0, 169, 259, 349, 547, 682, 772, 862, 1023, 1158, 1305, 1545, 1745, 1948, 2227]",6792,6341,5954,4311,2227,-226,68,-112,-1418,1023,-665,15,radiant
7617818313,6,106,96,105,100,"[57, 495, 794, 1041, 1472, 1806, 2325, 2721, 3503, 4057, 4884, 5249, 5834, 6683, 7289]","[325, 581, 810, 1149, 1478, 2213, 2648, 3811, 4567, 5198, 5876, 6409, 7032, 7465, 7788]","[57, 265, 512, 726, 939, 1486, 1657, 1989, 2549, 3118, 3664, 4157, 4739, 5488, 5732]","[57, 284, 374, 547, 637, 816, 951, 1485, 1786, 2405, 2722, 2883, 3169, 3460, 3811]","[57, 284, 442, 581, 753, 1013, 1358, 1727, 1888, 2155, 2458, 2690, 2961, 3200, 3390]",7289,7788,5732,3811,3390,10,11,29,123,85,"[0, 204, 412, 881, 1379, 1661, 2426, 2866, 3129, 3711, 4177, 4598, 4850, 5107, 5865]","[0, 250, 510, 929, 1295, 1633, 1723, 1911, 2299, 2389, 3087, 3502, 4279, 4812, 5348]","[0, 205, 494, 779, 1031, 1367, 1623, 1806, 2465, 2882, 3151, 3241, 3876, 4155, 4358]","[0, 169, 573, 708, 837, 927, 1017, 1107, 1338, 1428, 1547, 1887, 2030, 2125, 2390]","[0, 269, 359, 535, 669, 759, 1088, 1178, 1409, 1499, 1589, 1679, 1916, 2011, 2214]",5865,5348,4358,2390,2214,1424,2440,1374,1421,1176,7835,15,radiant
7617881416,126,95,96,121,101,"[332, 724, 1039, 1237, 1535, 1950, 2400, 2867, 3484, 4080, 4375, 5047, 5646, 6121, 6297]","[64, 310, 568, 1017, 1262, 1511, 1855, 2066, 2345, 2542, 2984, 3974, 4327, 4828, 5279]","[64, 351, 677, 996, 1327, 1867, 2260, 2606, 2942, 3492, 3966, 4329, 4959, 5157, 5696]","[64, 325, 415, 572, 708, 831, 1054, 1144, 1500, 1696, 1838, 2299, 2532, 2800, 3115]","[64, 274, 364, 490, 629, 882, 1105, 1321, 1549, 1729, 1864, 2228, 2597, 2795, 2889]",6297,5279,5696,3115,2889,70,53,135,104,123,"[0, 216, 559, 845, 1125, 1475, 1727, 2198, 2613, 2900, 3541, 4321, 4546, 6171, 6788]","[0, 130, 220, 606, 776, 1176, 1704, 1908, 2074, 2723, 2878, 3358, 3675, 4178, 4688]","[0, 206, 447, 741, 1028, 1451, 1762, 2059, 2268, 2449, 2754, 3280, 3503, 4222, 4616]","[0, 239, 592, 867, 1124, 1564, 1777, 1907, 2457, 2699, 3113, 3642, 4141, 4891, 5177]","[0, 130, 220, 418, 611, 845, 1511, 1678, 1768, 1996, 2387, 2720, 2893, 3554, 3875]",6788,4688,4616,5177,3875,-491,591,1080,-2062,-986,-1868,15,dire
7618010905,61,49,103,123,5,"[0, 330, 572, 1017, 1262, 1671, 2070, 2978, 4018, 4632, 5465, 6701, 7072, 7386, 8191]","[0, 242, 541, 852, 1358, 1696, 1924, 2443, 2980, 3524, 4132, 4679, 5612, 6063, 6692]","[0, 255, 505, 860, 1023, 1765, 2245, 2790, 3202, 3440, 3791, 4081, 4572, 5253, 6218]","[0, 169, 310, 400, 569, 837, 1107, 1355, 1618, 2137, 2579, 3115, 3355, 3590, 3965]","[0, 169, 296, 386, 542, 680, 770, 1272, 1861, 1951, 2576, 3145, 3379, 3528, 4214]",8191,6692,6218,3965,4214,82,47,33,53,26,"[0, 274, 564, 874, 1354, 1566, 1858, 2238, 2618, 3011, 3457, 3785, 4533, 4970, 5387]","[0, 320, 540, 774, 1168, 1420, 1585, 2026, 2203, 2354, 2783, 3201, 3625, 4015, 4182]","[0, 276, 605, 887, 1236, 1477, 2131, 2334, 2707, 2937, 3391, 3749, 4046, 4638, 4965]","[0, 220, 361, 451, 667, 757, 920, 1010, 1229, 1319, 1799, 2306, 2396, 3300, 3449]","[0, 214, 304, 438, 647, 737, 937, 1027, 1275, 1644, 2024, 2277, 2556, 2946, 3095]",5387,4182,4965,3449,3095,2804,2510,1253,516,1119,8202,15,radiant
7618039602,52,61,2,105,121,"[94, 351, 728, 1076, 1581, 2025, 2829, 3427, 4202, 4500, 5442, 6184, 7126, 7971, 8421]","[0, 273, 558, 921, 1159, 1490, 1716, 2066, 2259, 2768, 3155, 3679, 4129, 4848, 5356]","[0, 219, 774, 1179, 1637, 2333, 2915, 3159, 3810, 4395, 5320, 5911, 6283, 7734, 8238]","[245, 414, 577, 697, 858, 1119, 1254, 1817, 2330, 2420, 3002, 3142, 3353, 3943, 4171]","[79, 263, 387, 523, 613, 703, 889, 1076, 1537, 1627, 2341, 2538, 2798, 3548, 3693]",8421,5356,8238,4171,3693,89,33,38,19,5,"[61, 269, 637, 991, 1364, 1716, 1999, 2226, 2956, 3354, 3657, 4046, 4716, 5331, 5900]","[61, 302, 668, 1155, 1596, 2200, 2877, 3266, 4181, 4646, 5352, 5714, 6103, 6373, 6574]","[329, 571, 868, 1343, 1675, 2156, 2449, 2733, 3040, 3541, 3933, 4133, 4740, 5248, 5479]","[61, 230, 350, 566, 727, 967, 1150, 1662, 1921, 2011, 2236, 2326, 2492, 2645, 3044]","[61, 230, 384, 504, 643, 808, 1065, 1638, 1863, 1953, 2178, 2268, 2440, 2643, 2891]",5900,6574,5479,3044,2891,2521,-1218,2759,1127,802,5991,15,radiant
7618139706,60,18,129,86,128,"[0, 291, 563, 835, 1521, 1768, 2083, 2648, 3278, 3657, 4338, 5120, 5507, 6074, 6592]","[0, 328, 642, 1083, 1505, 1713, 1997, 2524, 2888, 3192, 3585, 4132, 4660, 5644, 6359]","[0, 331, 579, 932, 1264, 1505, 1934, 2059, 2383, 2711, 3329, 3885, 4518, 5259, 5953]","[0, 209, 299, 471, 645, 735, 825, 950, 1254, 1415, 1958, 2716, 3196, 3452, 4180]","[0, 209, 299, 389, 957, 1047, 1137, 1434, 1610, 1752, 2210, 2719, 3199, 3690, 4040]",6592,6359,5953,4180,4040,73,10,120,105,121,"[0, 207, 335, 860, 1074, 1807, 2242, 2789, 3662, 4066, 4688, 5277, 5552, 6101, 6978]","[0, 129, 360, 768, 1019, 1454, 1778, 2138, 2497, 2876, 3167, 3822, 4219, 4906, 5471]","[0, 248, 528, 911, 1274, 1716, 2077, 2502, 3042, 3510, 4211, 4996, 5543, 5803, 6344]","[0, 129, 219, 433, 570, 832, 967, 1327, 1683, 1821, 2183, 2498, 2694, 2870, 3063]","[0, 129, 263, 353, 443, 619, 805, 1016, 1326, 1416, 1593, 1683, 1918, 2218, 2365]",6978,5471,6344,3063,2365,-386,888,-391,1117,1675,2903,15,dire
7618205704,82,2,106,65,83,"[0, 245, 526, 938, 1312, 1969, 2414, 2983, 3500, 3999, 4426, 4853, 5620, 6194, 6934]","[0, 279, 479, 805, 1366, 1810, 2268, 2561, 2701, 3017, 3723, 4271, 5250, 5734, 6230]","[0, 309, 590, 835, 1081, 1340, 1856, 1990, 2403, 2575, 2965, 3327, 3554, 4144, 4711]","[0, 195, 285, 422, 638, 768, 997, 1087, 1465, 1637, 2206, 2431, 2788, 3038, 3319]","[0, 195, 285, 375, 584, 852, 1153, 1291, 1508, 1731, 1866, 2152, 2242, 2584, 2801]",6934,6230,4711,3319,2801,10,23,114,88,5,"[0, 240, 482, 778, 1319, 1744, 2304, 2791, 3261, 3821, 4451, 5248, 5914, 6499, 7124]","[0, 216, 613, 1236, 1921, 2193, 2561, 2782, 3317, 3850, 4214, 4882, 5393, 6129, 6756]","[0, 326, 688, 1072, 1451, 1864, 2200, 2826, 3113, 3897, 4424, 5132, 5515, 5766, 6068]","[0, 170, 260, 500, 724, 814, 940, 1174, 1591, 1726, 2427, 2820, 3353, 3764, 3970]","[0, 170, 260, 386, 476, 648, 738, 873, 1208, 1478, 1698, 2032, 2174, 2479, 2938]",7124,6756,6068,3970,2938,-190,-526,-1357,-651,-137,-2861,15,radiant
7618629204,89,22,69,21,20,"[0, 164, 366, 612, 931, 1257, 1920, 2163, 2668, 3053, 3546, 4299, 4789, 5903, 6444]","[0, 172, 430, 804, 1239, 1603, 1893, 2354, 2741, 3581, 4482, 4731, 5593, 6527, 7112]","[0, 207, 634, 976, 1269, 1551, 1980, 2405, 2935, 3377, 4184, 4753, 5490, 6460, 7077]","[0, 131, 611, 970, 1100, 1288, 1391, 1525, 1797, 2062, 2568, 2804, 3056, 3458, 3859]","[0, 129, 219, 358, 523, 699, 1020, 1110, 1307, 1555, 2287, 2658, 2910, 3519, 3800]",6444,7112,7077,3859,3800,114,19,53,109,79,"[0, 245, 531, 891, 1256, 1589, 2034, 2566, 2873, 3426, 3613, 3853, 4148, 4632, 5117]","[0, 291, 500, 918, 1300, 1589, 2041, 2627, 3233, 3586, 4186, 4617, 4830, 5561, 6150]","[0, 209, 299, 466, 604, 773, 942, 1117, 1303, 1552, 1853, 2474, 2989, 3873, 4145]","[2, 299, 595, 1090, 1487, 1863, 2253, 2636, 3047, 3484, 3715, 4054, 4506, 5138, 5252]","[0, 209, 299, 401, 491, 627, 746, 1155, 1474, 1993, 2555, 2768, 2906, 3347, 3442]",5117,6150,4145,5252,3442,1327,962,2932,-1393,358,4186,15,dire
7618832016,48,23,112,58,20,"[0, 165, 326, 706, 1056, 1292, 1614, 1909, 2463, 2813, 3162, 3881, 4425, 5170, 5936]","[0, 217, 461, 844, 1387, 2052, 2301, 2852, 3239, 3952, 4532, 5065, 5741, 6262, 6895]","[0, 218, 624, 991, 1248, 1460, 1899, 2189, 2603, 3177, 3621, 4352, 4940, 5462, 6162]","[0, 130, 224, 314, 496, 813, 920, 1700, 1966, 2440, 3028, 3763, 4235, 4462, 4809]","[0, 182, 272, 631, 838, 928, 1073, 1163, 1338, 1602, 1858, 2280, 2539, 2812, 3265]",5936,6895,6162,4809,3265,78,22,70,123,84,"[330, 576, 945, 1070, 1673, 1965, 2325, 2719, 3184, 3683, 4224, 4353, 4736, 5355, 5740]","[0, 333, 706, 1034, 1361, 1696, 2026, 2369, 2732, 2892, 3428, 3698, 4497, 4856, 5176]","[62, 361, 570, 875, 1103, 1481, 1961, 2458, 2728, 3128, 3663, 4137, 5011, 5405, 6200]","[62, 322, 412, 502, 715, 845, 983, 1163, 1616, 1706, 2082, 2172, 2573, 2833, 2982]","[62, 272, 381, 515, 653, 788, 1192, 1372, 1609, 1750, 2367, 2457, 2586, 2754, 3019]",5740,5176,6200,2982,3019,196,1719,-38,1827,246,3950,15,radiant
7618842515,44,47,36,86,26,"[0, 245, 498, 906, 1152, 1242, 1631, 1921, 2088, 2353, 2443, 3043, 3311, 3690, 3903]","[0, 204, 399, 598, 879, 1091, 1380, 1642, 1809, 1899, 1989, 2079, 2169, 2391, 2486]","[0, 170, 260, 350, 478, 682, 820, 1022, 1146, 1450, 1677, 1805, 2018, 2323, 2418]","[0, 170, 260, 456, 593, 683, 773, 944, 1163, 1455, 1545, 1635, 1725, 1973, 2068]","[0, 170, 260, 350, 440, 575, 665, 755, 845, 979, 1104, 1194, 1284, 1486, 1581]",3903,2486,2418,2068,1581,48,33,126,45,100,"[0, 279, 525, 886, 1223, 1918, 2397, 3081, 4041, 4546, 5320, 6096, 7764, 8467, 9974]","[0, 426, 749, 1143, 1487, 2197, 2530, 3327, 4225, 4720, 5720, 6204, 6736, 7085, 7912]","[0, 299, 588, 982, 1315, 1790, 2539, 3013, 4155, 4618, 5164, 5418, 6202, 6648, 7688]","[0, 293, 487, 1007, 1291, 1583, 1720, 2174, 2815, 3366, 3721, 4067, 4422, 4550, 5582]","[0, 561, 651, 771, 861, 1292, 1429, 1715, 2278, 2497, 3017, 3192, 3502, 3674, 4518]",9974,7912,7688,5582,4518,-6071,-5426,-5270,-3514,-2937,-23218,15,dire
7618866208,113,12,29,31,75,"[0, 295, 619, 1077, 1489, 1842, 2218, 2342, 2592, 3700, 4115, 4997, 5179, 6105, 6712]","[0, 248, 485, 771, 1020, 1345, 1668, 1914, 2243, 2645, 2991, 3225, 3716, 4211, 4999]","[0, 246, 526, 852, 1208, 1532, 1936, 2290, 2538, 3005, 3516, 3808, 4003, 4430, 5181]","[0, 210, 330, 420, 628, 763, 898, 988, 1209, 1389, 1498, 1732, 1822, 2310, 3238]","[0, 210, 330, 466, 591, 725, 815, 953, 1062, 1262, 1690, 1924, 2014, 2634, 3131]",6712,4999,5181,3238,3131,28,95,114,7,79,"[51, 219, 498, 806, 1024, 1396, 1813, 2082, 2592, 2858, 3172, 4119, 4624, 4773, 5601]","[319, 501, 819, 1018, 1262, 1509, 1637, 1880, 2204, 2332, 2550, 2928, 3202, 3502, 4133]","[51, 219, 466, 608, 865, 1107, 1339, 1624, 2277, 2804, 2983, 3391, 4072, 4426, 4914]","[51, 181, 271, 361, 451, 632, 810, 970, 1153, 1253, 1425, 2219, 2647, 2869, 3357]","[51, 181, 271, 361, 495, 669, 796, 931, 1100, 1226, 1316, 1568, 1997, 2146, 2580]",5601,4133,4914,3357,2580,1111,866,267,-119,551,2676,15,radiant
7618873617,113,93,29,105,45,"[0, 571, 901, 1119, 1497, 1784, 2209, 2717, 3242, 3772, 4147, 4999, 5661, 6400, 6610]","[0, 200, 506, 694, 818, 1076, 1346, 1749, 1981, 2121, 2211, 2551, 3206, 4010, 4502]","[0, 168, 439, 600, 889, 1367, 1713, 2118, 2448, 2699, 3123, 3629, 4260, 4631, 5269]","[0, 129, 219, 548, 674, 848, 1223, 1722, 1818, 1908, 2305, 2523, 2667, 3471, 3691]","[0, 129, 219, 309, 448, 624, 750, 840, 974, 1184, 1323, 1688, 1891, 2079, 2631]",6610,4502,5269,3691,2631,46,137,98,53,86,"[0, 248, 493, 805, 1125, 1469, 1879, 2433, 3208, 3582, 3982, 4904, 5254, 6023, 6616]","[0, 243, 766, 1021, 1308, 1691, 2222, 2892, 3656, 4086, 4636, 5557, 6231, 6792, 7804]","[0, 248, 446, 888, 1377, 1929, 2374, 2755, 3451, 4144, 4659, 5129, 5351, 5530, 5625]","[0, 261, 467, 557, 647, 862, 1155, 1527, 2081, 2270, 2807, 3024, 3669, 3848, 4227]","[0, 209, 336, 679, 878, 1093, 1183, 1488, 1696, 1877, 2057, 2560, 2786, 2965, 3415]",6616,7804,5625,4227,3415,-6,-3302,-356,-536,-784,-4984,15,dire
7619033614,6,14,49,79,121,"[0, 165, 530, 774, 1199, 1488, 2014, 2299, 2432, 3142, 3730, 4212, 4533, 4909, 5140]","[0, 251, 531, 672, 926, 1168, 1842, 1969, 2059, 2709, 2989, 3396, 3790, 4190, 4304]","[0, 167, 363, 492, 733, 1052, 1417, 1604, 1830, 2125, 2476, 2774, 3049, 3285, 3590]","[0, 129, 219, 357, 496, 630, 1022, 1112, 1202, 2191, 2416, 2786, 2991, 3190, 3284]","[0, 129, 219, 353, 443, 579, 836, 984, 1121, 1211, 1628, 1764, 2056, 2255, 2403]",5140,4304,3590,3284,2403,46,126,43,128,20,"[0, 331, 856, 1195, 1694, 2025, 2388, 2851, 3648, 4121, 4795, 5219, 5489, 6288, 7003]","[0, 319, 601, 1002, 1374, 1826, 2200, 3159, 3634, 4082, 4327, 4885, 5457, 6001, 6953]","[0, 209, 488, 748, 978, 1286, 1573, 1787, 2009, 2234, 2496, 2674, 3107, 3491, 3969]","[0, 209, 356, 490, 641, 887, 1071, 1255, 1478, 1617, 2211, 2489, 2669, 2953, 3186]","[0, 209, 301, 598, 688, 874, 1009, 1099, 1284, 1386, 1521, 1713, 1893, 2391, 2854]",7003,6953,3969,3186,2854,-1863,-2649,-379,98,-451,-5244,15,dire
7619114301,39,41,23,9,86,"[0, 241, 450, 777, 1194, 1510, 1922, 2563, 3188, 3556, 3905, 4104, 4758, 5235, 5765]","[0, 280, 474, 843, 1421, 1748, 2035, 2319, 2672, 3089, 3602, 3926, 4491, 4953, 5386]","[0, 243, 442, 740, 1354, 1673, 2084, 2219, 2534, 3175, 3850, 4121, 4714, 5114, 5476]","[0, 220, 397, 542, 705, 868, 1016, 1197, 1287, 1540, 1983, 2127, 2478, 2620, 2873]","[0, 217, 307, 624, 909, 1125, 1261, 1498, 1729, 2065, 2603, 2747, 2917, 3060, 3491]",5765,5386,5476,2873,3491,42,106,129,105,26,"[0, 242, 837, 1221, 1576, 1758, 2333, 2912, 3352, 3756, 4166, 4587, 5505, 6271, 6543]","[0, 252, 575, 860, 1206, 1574, 1918, 2225, 2662, 3002, 3335, 3944, 4385, 5337, 5978]","[0, 238, 470, 765, 1044, 1451, 1903, 2278, 2902, 3282, 3860, 4573, 5118, 5702, 6514]","[0, 169, 369, 506, 596, 686, 825, 1270, 1360, 1691, 2166, 2658, 3107, 3777, 4006]","[0, 169, 259, 349, 439, 565, 703, 1189, 1426, 1516, 1921, 2428, 2696, 3175, 3360]",6543,5978,6514,4006,3360,-778,-592,-1038,-1133,131,-3410,15,dire
7619331703,10,74,137,121,3,"[0, 201, 362, 646, 830, 1246, 1385, 1760, 2121, 2592, 2860, 3174, 3513, 3951, 4507]","[0, 219, 456, 782, 1159, 1515, 1919, 2337, 2883, 3393, 3646, 3881, 4266, 4782, 5697]","[0, 164, 359, 543, 780, 953, 1259, 1560, 1843, 2128, 2344, 2506, 3097, 3497, 4556]","[0, 130, 220, 310, 408, 498, 725, 905, 995, 1135, 1225, 1315, 1491, 1668, 2377]","[0, 130, 220, 358, 448, 869, 959, 1139, 1229, 1369, 1459, 1640, 1730, 2091, 2523]",4507,5697,4556,2377,2523,89,14,2,65,105,"[0, 249, 475, 755, 958, 1562, 1943, 2518, 3048, 3493, 4060, 4520, 5046, 5840, 6611]","[0, 329, 572, 949, 1112, 1493, 1710, 1985, 2285, 2524, 2950, 3181, 3441, 3741, 3836]","[0, 210, 429, 700, 1577, 1777, 2156, 2509, 2767, 3022, 3237, 3361, 3627, 3842, 3975]","[0, 210, 334, 424, 681, 876, 1027, 1250, 1359, 1561, 1943, 2401, 2554, 2928, 3144]","[0, 210, 300, 475, 565, 655, 826, 961, 1083, 1173, 1481, 1620, 1747, 1962, 2057]",6611,3836,3975,3144,2057,-2104,1861,581,-767,466,37,15,dire
7619338103,44,106,43,19,79,"[0, 248, 502, 1153, 1278, 1594, 1957, 2414, 2971, 3230, 3600, 4109, 4749, 5045, 5573]","[0, 205, 443, 572, 662, 842, 976, 1250, 1627, 1979, 2267, 2499, 3093, 3479, 4004]","[0, 285, 562, 723, 1034, 1271, 1839, 2000, 2488, 2623, 2913, 3885, 5113, 5430, 6463]","[0, 130, 271, 396, 680, 770, 950, 1040, 1363, 1490, 1580, 1986, 2507, 2698, 3078]","[0, 130, 575, 749, 883, 1038, 1128, 1236, 1411, 1501, 1638, 2044, 2273, 2368, 2633]",5573,4004,6463,3078,2633,35,123,114,21,71,"[0, 276, 526, 814, 1066, 1388, 1586, 2336, 2851, 3588, 4064, 4357, 4607, 5738, 6130]","[0, 242, 502, 761, 1044, 1349, 1815, 2187, 2550, 3211, 3489, 4074, 4453, 5088, 5699]","[0, 277, 796, 1108, 1820, 2272, 2999, 3814, 4266, 5183, 5702, 6367, 6457, 7049, 8076]","[0, 170, 512, 649, 739, 874, 1060, 1255, 1410, 1636, 1986, 2241, 2493, 2696, 3077]","[0, 170, 260, 350, 503, 671, 914, 1176, 1419, 1725, 1901, 2221, 2311, 2867, 3229]",6130,5699,8076,3077,3229,-557,-1695,-1613,1,-596,-4460,15,dire
7619341208,94,11,99,51,90,"[0, 205, 331, 464, 735, 938, 1227, 1440, 1751, 2339, 2614, 2794, 3193, 3545, 3784]","[0, 170, 457, 835, 1049, 1301, 1703, 2084, 2712, 2900, 3346, 3436, 3526, 3672, 3969]","[0, 209, 452, 782, 1112, 1327, 1649, 1791, 2315, 2610, 2700, 3161, 3478, 3651, 3955]","[0, 170, 260, 386, 522, 612, 755, 989, 1505, 1640, 1892, 2072, 2533, 2676, 2854]","[0, 252, 342, 551, 724, 951, 1041, 1236, 1586, 1741, 1831, 1949, 2084, 2367, 2462]",3784,3969,3955,2854,2462,53,13,129,45,100,"[60, 269, 467, 602, 933, 1297, 1663, 2121, 2324, 2819, 3259, 3998, 4666, 5752, 6566]","[60, 347, 714, 1086, 1367, 1763, 2170, 2632, 2767, 3700, 4208, 5328, 6113, 6939, 7311]","[60, 268, 566, 847, 1402, 1876, 2083, 2658, 3411, 3946, 4487, 4989, 5289, 5765, 6095]","[60, 230, 320, 457, 701, 831, 940, 1190, 1406, 1878, 2194, 2574, 2923, 3412, 3915]","[328, 498, 637, 727, 1080, 1259, 1398, 1608, 1893, 2533, 2849, 3152, 3382, 3937, 4225]",6566,7311,6095,3915,4225,-2782,-3342,-2140,-1061,-1763,-11088,15,dire
7619420700,13,40,53,73,65,"[108, 425, 669, 993, 1284, 1579, 2116, 2495, 3100, 3675, 4025, 5346, 5890, 6592, 7177]","[241, 614, 779, 1342, 1728, 2239, 2791, 3217, 3728, 4102, 4428, 5171, 5531, 5846, 6842]","[376, 694, 934, 1413, 1637, 2319, 2450, 2626, 2844, 3289, 3690, 4432, 4817, 5524, 5759]","[108, 566, 705, 844, 979, 1163, 1392, 1929, 2514, 2932, 3384, 4254, 4788, 5506, 5998]","[108, 457, 547, 691, 827, 1091, 1341, 1610, 1933, 2402, 2908, 3278, 3726, 4417, 5210]",7177,6842,5759,5998,5210,98,84,14,72,5,"[0, 175, 638, 803, 1383, 1672, 2595, 2871, 3544, 4402, 4795, 5325, 5784, 6130, 6420]","[0, 197, 539, 914, 1159, 1519, 1770, 2238, 2917, 3313, 3701, 3910, 4272, 4573, 5469]","[0, 128, 421, 511, 1033, 1159, 1249, 1772, 2315, 2918, 3392, 4058, 4196, 4663, 5139]","[0, 89, 204, 294, 471, 610, 1141, 1920, 2120, 2583, 2718, 2895, 3153, 3572, 3910]","[0, 89, 204, 294, 455, 565, 944, 1480, 1716, 1851, 1986, 2239, 2694, 3206, 4200]",6420,5469,5139,3910,4200,757,1373,620,2088,1010,5848,15,radiant
7619550101,25,23,106,9,105,"[0, 290, 635, 1182, 1557, 2231, 2669, 3438, 4186, 4967, 5717, 6818, 7451, 8462, 9434]","[0, 275, 596, 899, 1298, 1740, 2061, 2437, 3046, 3787, 4538, 5391, 6049, 6849, 7587]","[0, 203, 751, 1108, 1439, 1929, 2251, 2361, 2884, 3179, 3658, 4097, 4692, 5152, 5642]","[0, 169, 662, 752, 882, 1320, 1522, 1612, 2185, 2699, 3039, 3202, 3908, 4247, 4740]","[0, 169, 259, 601, 747, 895, 1216, 1434, 1632, 2029, 2467, 2775, 3065, 3331, 3797]",9434,7587,5642,4740,3797,48,129,79,43,110,"[0, 207, 418, 775, 1186, 1518, 1821, 2100, 2500, 2817, 3242, 3538, 3970, 4230, 4912]","[0, 203, 457, 787, 1134, 1381, 1610, 2468, 2602, 3226, 3728, 4211, 4301, 4847, 5282]","[0, 169, 259, 349, 682, 820, 910, 1437, 1671, 1836, 2142, 2556, 2884, 3174, 3677]","[0, 251, 461, 669, 879, 1052, 1368, 1667, 1961, 2131, 2575, 2982, 3189, 3321, 3497]","[0, 169, 259, 675, 778, 886, 1024, 1150, 1340, 1542, 1755, 2309, 2513, 2878, 3492]",4912,5282,3677,3497,3492,4522,2305,1965,1243,305,10340,15,radiant
7619709106,10,107,97,105,103,"[0, 222, 621, 952, 1405, 1615, 2136, 2544, 3021, 3334, 3783, 4374, 4906, 5496, 6131]","[0, 256, 567, 932, 1062, 1237, 1560, 1988, 2208, 2298, 2475, 2735, 3063, 3670, 4030]","[0, 245, 567, 906, 1211, 1470, 1639, 2090, 2350, 2739, 3264, 3613, 4322, 4623, 4819]","[0, 170, 306, 396, 572, 662, 1149, 1239, 1374, 1464, 1554, 1814, 2071, 2434, 2529]","[0, 170, 260, 394, 558, 648, 820, 910, 1045, 1416, 1713, 1973, 2537, 2734, 2829]",6131,4030,4819,2529,2829,41,49,35,86,110,"[0, 170, 419, 633, 1003, 1481, 1759, 2256, 2626, 3081, 3815, 4253, 4895, 5597, 6373]","[0, 209, 535, 823, 1280, 1480, 1818, 2134, 2558, 3249, 4003, 4518, 5258, 5803, 6102]","[0, 244, 553, 997, 1300, 2099, 2468, 2798, 3247, 3899, 4607, 5698, 6242, 6821, 7415]","[0, 221, 311, 440, 619, 760, 1057, 1182, 1403, 1726, 2154, 2374, 2606, 2818, 3481]","[0, 270, 360, 450, 596, 999, 1089, 1214, 1304, 1616, 1979, 2269, 2521, 2819, 3404]",6373,6102,7415,3481,3404,-242,-2072,-2596,-952,-575,-6437,15,dire
7619822517,72,23,43,136,5,"[145, 347, 545, 784, 1073, 1513, 1979, 2363, 2885, 3410, 4093, 4701, 5049, 5256, 6221]","[278, 554, 908, 1408, 1764, 2147, 2758, 3263, 3758, 4230, 4783, 5320, 5744, 6207, 6825]","[145, 362, 597, 827, 1104, 1509, 1807, 2200, 2420, 2791, 3337, 3788, 4192, 4585, 5223]","[145, 275, 365, 455, 631, 783, 873, 1346, 1475, 1695, 2194, 2425, 2571, 2797, 3475]","[278, 457, 597, 739, 887, 1037, 1127, 1217, 1680, 1969, 2317, 2930, 3061, 3343, 3750]",6221,6825,5223,3475,3750,109,22,98,9,26,"[513, 723, 1149, 1492, 2023, 2383, 3179, 3497, 4114, 4857, 5172, 5785, 6469, 6943, 7547]","[120, 365, 770, 1091, 1381, 1748, 1958, 2417, 2926, 3600, 4147, 4479, 4695, 5325, 6021]","[388, 598, 954, 1389, 1554, 1871, 2306, 2518, 2874, 3290, 4028, 4616, 5359, 6069, 6420]","[247, 508, 705, 893, 1157, 1264, 1976, 2200, 2417, 2776, 3010, 3619, 3932, 4480, 4915]","[380, 590, 680, 770, 935, 1025, 1115, 1274, 1430, 1608, 1949, 2196, 2421, 2792, 2950]",7547,6021,6420,4915,2950,-1326,804,-1197,-1440,800,-2359,15,dire
7619853714,18,90,138,106,121,"[0, 206, 707, 997, 1393, 1917, 2263, 2455, 3005, 3626, 4100, 5029, 5635, 6454, 6973]","[0, 209, 543, 915, 1354, 1800, 2401, 2839, 3882, 4464, 4698, 5234, 5723, 6801, 7458]","[0, 129, 219, 309, 475, 565, 910, 1154, 1380, 1705, 1885, 2052, 2233, 2647, 2757]","[0, 207, 532, 897, 1319, 1650, 2124, 2689, 3207, 3453, 3781, 4357, 4638, 5033, 5567]","[0, 129, 300, 434, 573, 740, 882, 972, 1230, 1513, 1693, 1921, 2129, 2385, 2525]",6973,7458,2757,5567,2525,70,129,43,19,52,"[0, 294, 491, 843, 1249, 1593, 1885, 2530, 2848, 3164, 3732, 4206, 4737, 5427, 6118]","[0, 243, 854, 1224, 1548, 2186, 2687, 3016, 3292, 3705, 4163, 4465, 4790, 5149, 5537]","[0, 299, 628, 963, 1270, 1674, 2037, 2414, 2710, 3366, 4359, 4612, 5371, 5889, 6504]","[100, 309, 563, 653, 743, 910, 1045, 1273, 1412, 1712, 2030, 2120, 2338, 2631, 2846]","[0, 209, 299, 406, 565, 704, 842, 1022, 1198, 1500, 1829, 1929, 2146, 2538, 3155]",6118,5537,6504,2846,3155,855,1921,-3747,2721,-630,1120,15,dire
7620049317,95,13,129,86,110,"[0, 600, 882, 1262, 1683, 2346, 2608, 2981, 3490, 3961, 4437, 5052, 5730, 6406, 7371]","[0, 258, 540, 909, 1247, 1676, 1918, 2360, 2696, 3390, 4050, 4521, 4687, 5466, 6035]","[0, 246, 536, 961, 1462, 1851, 2265, 2703, 3529, 3710, 4154, 4531, 4697, 5049, 5824]","[0, 130, 220, 515, 690, 973, 1063, 1596, 1950, 2499, 2680, 2814, 3319, 3631, 4140]","[0, 209, 299, 513, 824, 999, 1266, 1533, 2241, 2659, 2920, 3088, 3229, 3674, 4162]",7371,6035,5824,4140,4162,54,96,49,19,5,"[0, 248, 487, 845, 1301, 1718, 2156, 2595, 3050, 3422, 3981, 4416, 5318, 5920, 6154]","[0, 279, 512, 636, 881, 1160, 1668, 2355, 2651, 2874, 3376, 3810, 4490, 4997, 5440]","[0, 329, 659, 884, 1298, 1578, 2124, 2762, 3159, 3420, 3900, 4487, 5120, 5739, 6253]","[0, 210, 300, 426, 516, 606, 908, 1482, 1848, 1938, 2091, 2181, 2578, 2820, 2915]","[0, 210, 300, 390, 528, 647, 892, 1129, 1452, 1874, 2127, 2274, 2541, 2782, 2877]",6154,5440,6253,2915,2877,1217,595,-429,1225,1285,3893,15,radiant
7620311806,35,1,40,57,7,"[0, 298, 700, 1151, 1577, 2226, 2730, 3334, 3939, 4432, 4981, 5940, 6676, 7989, 8729]","[0, 247, 545, 986, 1376, 1782, 2231, 2694, 3030, 3248, 3681, 3826, 4394, 4804, 5515]","[0, 170, 346, 679, 840, 1511, 1636, 1856, 2359, 3002, 3218, 3389, 3706, 3801, 4155]","[0, 170, 260, 350, 577, 711, 846, 1084, 1193, 1402, 1577, 1705, 1842, 2019, 2289]","[0, 170, 260, 397, 487, 931, 1021, 1155, 1340, 1430, 1646, 1862, 2370, 2465, 2649]",8729,5515,4155,2289,2649,21,49,59,19,5,"[0, 321, 688, 1105, 1635, 2306, 2832, 3412, 3824, 4649, 5012, 5970, 6312, 6950, 7979]","[0, 326, 523, 839, 1208, 1548, 2000, 2159, 2572, 3272, 3758, 5133, 5412, 6167, 6587]","[0, 576, 735, 1298, 1718, 1989, 2448, 2949, 3337, 4038, 4128, 4968, 6120, 6566, 7300]","[0, 170, 295, 385, 563, 688, 869, 959, 1126, 1414, 1504, 2250, 3049, 3361, 3545]","[0, 236, 326, 481, 618, 969, 1108, 1325, 1415, 1643, 1825, 2767, 3029, 3178, 3438]",7979,6587,7300,3545,3438,750,-1072,-3145,-1256,-789,-5512,15,radiant
7620690105,44,23,43,109,19,"[0, 238, 484, 930, 1295, 1720, 2012, 2254, 2507, 2721, 3386, 3975, 4196, 4753, 5201]","[0, 345, 626, 845, 1043, 1454, 1791, 1953, 2368, 2799, 3701, 4024, 4348, 4777, 5618]","[0, 275, 553, 839, 1173, 1383, 1634, 1914, 2330, 2974, 3589, 4386, 4584, 5119, 5782]","[0, 232, 322, 458, 548, 683, 773, 1370, 1589, 1762, 2335, 2560, 2650, 2792, 3125]","[0, 194, 284, 374, 464, 554, 644, 927, 1017, 1190, 1582, 1807, 2096, 2191, 2524]",5201,5618,5782,3125,2524,38,49,25,5,79,"[0, 539, 825, 1221, 1467, 1740, 2205, 2569, 3051, 3704, 4176, 4528, 5694, 6516, 7215]","[0, 274, 450, 695, 1186, 1523, 1842, 2328, 2603, 3192, 3462, 4155, 4729, 5456, 5953]","[0, 286, 614, 872, 1154, 1364, 1893, 2279, 2612, 2963, 3525, 4165, 4597, 5197, 5603]","[0, 234, 370, 460, 655, 745, 1015, 1383, 1557, 1819, 2023, 2158, 2866, 3380, 3702]","[0, 234, 324, 462, 604, 990, 1143, 1278, 1747, 2044, 2260, 2450, 2791, 3184, 3427]",7215,5953,5603,3702,3427,-2014,-335,179,-577,-903,-3650,15,dire
7621065719,109,23,69,85,105,"[0, 209, 493, 942, 1318, 1671, 2174, 2715, 3266, 3769, 4579, 4947, 5562, 6318, 7017]","[0, 330, 779, 1035, 1478, 1847, 2290, 2810, 3392, 4104, 4771, 5384, 5954, 6523, 7186]","[0, 330, 492, 909, 1243, 1784, 2094, 2844, 3216, 3573, 4473, 5206, 5785, 6314, 7020]","[0, 170, 260, 350, 526, 616, 829, 1077, 1281, 1565, 1918, 2256, 2484, 2926, 3256]","[0, 170, 260, 350, 480, 617, 707, 892, 1249, 1604, 1937, 2138, 2301, 2491, 2809]",7017,7186,7020,3256,2809,12,13,129,9,114,"[0, 207, 550, 904, 1151, 1260, 1521, 1740, 2011, 2334, 2810, 2924, 3533, 3907, 4341]","[0, 206, 479, 860, 1184, 1437, 1807, 2140, 2414, 3064, 3662, 3930, 4336, 4995, 5415]","[0, 170, 445, 571, 815, 1299, 1434, 1721, 1932, 2348, 2847, 3205, 3696, 4217, 4473]","[0, 170, 336, 549, 719, 809, 1014, 1529, 1789, 1897, 2183, 2426, 2717, 3025, 3119]","[0, 170, 285, 375, 545, 683, 818, 1000, 1234, 1629, 1809, 1987, 2118, 2268, 2425]",4341,5415,4473,3119,2425,2676,1771,2547,137,384,7515,15,radiant
7621528409,41,97,49,64,112,"[0, 281, 668, 1067, 1529, 1907, 2360, 2826, 3279, 3966, 4292, 4880, 5484, 6394, 7283]","[0, 267, 598, 997, 1398, 1727, 2130, 2825, 3365, 3834, 4447, 5008, 5906, 6666, 7148]","[0, 271, 557, 870, 1028, 1540, 1897, 2479, 2654, 3074, 3370, 3578, 4022, 4750, 5189]","[0, 195, 330, 489, 628, 786, 922, 1109, 1245, 1463, 1921, 2355, 2540, 3511, 3916]","[0, 195, 285, 405, 704, 843, 981, 1229, 1319, 1733, 1868, 1958, 2282, 2741, 2944]",7283,7148,5189,3916,2944,93,23,129,31,45,"[0, 252, 754, 960, 1413, 1682, 1975, 2395, 2726, 3438, 3954, 4707, 5162, 5623, 6899]","[0, 242, 530, 900, 1058, 1370, 1754, 1994, 2502, 3011, 3530, 4071, 4631, 5754, 6228]","[0, 170, 479, 818, 1159, 1618, 2036, 2290, 2669, 2808, 3116, 3488, 3949, 4507, 4830]","[0, 170, 470, 560, 738, 872, 1011, 1180, 1425, 1654, 2010, 2292, 2432, 3119, 3304]","[0, 170, 260, 350, 440, 565, 747, 882, 1051, 1314, 1505, 1678, 1818, 2323, 2671]",6899,6228,4830,3304,2671,384,920,359,612,273,2548,15,radiant
7621666802,138,96,17,9,65,"[0, 290, 540, 959, 1606, 1984, 2403, 2788, 3269, 3807, 4320, 4591, 5405, 5970, 6651]","[0, 255, 585, 865, 1414, 1650, 2000, 2418, 2922, 3307, 4214, 4510, 4939, 5205, 5466]","[0, 278, 567, 933, 1154, 1493, 1896, 2094, 2333, 2679, 3212, 3322, 3780, 3984, 4443]","[0, 174, 304, 437, 722, 872, 1275, 1468, 1558, 1895, 2238, 2647, 3285, 3393, 3970]","[0, 170, 333, 423, 621, 711, 801, 942, 1294, 1429, 1619, 1910, 2259, 2565, 3234]",6651,5466,4443,3970,3234,73,70,13,121,79,"[0, 313, 481, 690, 1113, 1731, 2062, 2894, 3281, 4047, 4444, 5470, 6402, 7377, 8243]","[0, 302, 556, 813, 1101, 1615, 1990, 2388, 2914, 3258, 3738, 4165, 4868, 5634, 6235]","[0, 195, 627, 872, 1217, 1679, 2088, 2602, 3107, 3438, 3768, 4428, 5331, 5635, 6251]","[0, 195, 328, 418, 812, 1068, 1158, 1467, 1686, 1821, 2180, 2521, 3235, 3733, 4215]","[0, 242, 332, 470, 843, 933, 1331, 1987, 2271, 2656, 2833, 3227, 3460, 3764, 4130]",8243,6235,6251,4215,4130,-1592,-769,-1808,-245,-896,-5310,15,dire
7621715017,97,23,42,7,102,"[0, 292, 814, 1216, 1665, 1924, 2325, 2875, 3372, 3823, 4921, 5314, 5915, 7076, 7823]","[0, 217, 662, 823, 1194, 1585, 1811, 2485, 2875, 3417, 4062, 4429, 5020, 5592, 6053]","[0, 251, 807, 1050, 1368, 1821, 2233, 2638, 3003, 3459, 3889, 4697, 5435, 5792, 6482]","[0, 170, 260, 350, 475, 565, 655, 909, 1124, 1214, 1411, 1663, 2114, 2980, 3232]","[0, 170, 334, 424, 734, 871, 967, 1157, 1247, 1384, 1560, 2087, 2267, 2507, 2706]",7823,6053,6482,3232,2706,98,126,70,20,40,"[0, 322, 646, 1017, 1529, 1731, 2135, 2566, 3191, 3648, 3843, 4507, 5109, 5661, 6742]","[0, 240, 479, 927, 1347, 1642, 1928, 2268, 3016, 3371, 3875, 4176, 4473, 5005, 5672]","[0, 260, 1001, 1322, 1836, 2291, 2650, 2947, 3404, 3791, 4192, 4675, 5270, 5628, 6412]","[0, 170, 260, 413, 583, 761, 920, 1100, 1369, 1553, 1748, 1838, 1982, 2521, 2982]","[0, 170, 334, 462, 552, 763, 947, 1202, 1337, 1472, 1757, 1881, 2242, 2481, 2788]",6742,5672,6412,2982,2788,1081,381,70,250,-82,1700,15,radiant
7621798207,120,70,104,86,20,"[0, 310, 593, 968, 1421, 1828, 2234, 2684, 3574, 4292, 5179, 5967, 6737, 7478, 8201]","[0, 253, 542, 863, 1645, 2024, 2745, 2953, 3558, 4338, 4645, 5256, 6316, 6638, 7115]","[0, 170, 534, 869, 1196, 1496, 2118, 2634, 3070, 3598, 4157, 4937, 5654, 6212, 6665]","[0, 207, 297, 494, 584, 674, 1124, 1382, 1607, 1779, 2146, 2344, 2755, 2903, 3222]","[0, 170, 260, 470, 846, 936, 1331, 1584, 1865, 2051, 2515, 2833, 3109, 3257, 3406]",8201,7115,6665,3222,3406,35,48,49,75,5,"[0, 326, 694, 1068, 1538, 2252, 2829, 3503, 4002, 4620, 5424, 6076, 6695, 7812, 8510]","[0, 256, 540, 901, 1392, 1641, 1778, 2174, 2670, 3038, 3508, 4211, 4796, 5338, 6127]","[0, 204, 504, 860, 1122, 1248, 1409, 2024, 2234, 2696, 3434, 3633, 4140, 4977, 5629]","[0, 204, 294, 428, 567, 657, 747, 1199, 1289, 1658, 2270, 2360, 2587, 2900, 3158]","[0, 170, 260, 423, 785, 875, 965, 1100, 1211, 1301, 1479, 1569, 1716, 1810, 1995]",8510,6127,5629,3158,1995,-309,988,1036,64,1411,3190,15,dire
7622335611,41,120,23,27,85,"[0, 330, 592, 822, 1120, 1403, 1863, 2229, 2591, 3396, 3870, 4161, 4464, 5232, 5660]","[0, 379, 700, 1028, 1472, 1962, 2350, 2960, 3662, 4378, 4513, 5336, 5927, 6339, 7016]","[0, 247, 549, 886, 1206, 1524, 1660, 1786, 2480, 2928, 3100, 3349, 3804, 4357, 5081]","[0, 256, 422, 512, 864, 989, 1079, 1492, 1627, 1958, 2093, 2412, 2546, 2748, 3155]","[0, 210, 380, 591, 820, 945, 1080, 1174, 1314, 1588, 1895, 2106, 2307, 2555, 2813]",5660,7016,5081,3155,2813,48,17,96,123,86,"[0, 130, 435, 680, 1041, 1564, 2062, 2516, 2902, 3444, 4010, 4723, 5326, 5903, 6895]","[0, 324, 735, 1102, 1675, 2098, 2512, 3004, 3651, 3824, 4852, 5258, 6001, 6522, 6935]","[0, 130, 438, 716, 1099, 1391, 1900, 2269, 2763, 3195, 3571, 4038, 4572, 5060, 5758]","[0, 130, 272, 737, 916, 1041, 1180, 1315, 1450, 1913, 2308, 2518, 2888, 3131, 3470]","[0, 130, 321, 499, 673, 798, 888, 1068, 1221, 1391, 1916, 2270, 2432, 2663, 3057]",6895,6935,5758,3470,3057,-1235,81,-677,-315,-244,-2390,15,dire
7622509408,109,98,96,105,20,"[0, 207, 453, 762, 1057, 1420, 1813, 2361, 2691, 3099, 3639, 4293, 4791, 5470, 6109]","[0, 322, 680, 1179, 1433, 2011, 2434, 3105, 3472, 3941, 4568, 4716, 5806, 6371, 7052]","[0, 294, 508, 822, 1485, 1773, 2176, 2741, 3406, 4006, 4466, 4971, 5246, 5826, 6436]","[0, 170, 260, 380, 804, 899, 1260, 1531, 1621, 1918, 2141, 2289, 2789, 3095, 3492]","[0, 175, 265, 488, 616, 801, 891, 1092, 1440, 1620, 2010, 2153, 2243, 2482, 2696]",6109,7052,6436,3492,2696,12,13,129,26,51,"[0, 170, 345, 585, 712, 917, 1092, 1317, 1545, 1962, 2276, 2723, 3374, 3882, 4582]","[0, 288, 541, 824, 1153, 1409, 1783, 2036, 2576, 2913, 3357, 4176, 4524, 4849, 5225]","[0, 170, 545, 803, 1088, 1529, 1936, 2365, 2779, 3096, 3665, 4557, 4955, 5475, 5998]","[0, 170, 260, 350, 440, 601, 943, 1063, 1496, 1586, 1765, 2116, 2206, 2399, 2717]","[0, 170, 600, 729, 1057, 1205, 1426, 1516, 1675, 1789, 1924, 2291, 2397, 2597, 2795]",4582,5225,5998,2717,2795,1527,1827,438,775,-99,4468,15,dire
7622513213,78,32,53,120,85,"[0, 208, 483, 762, 1163, 1413, 1735, 2182, 2632, 3120, 3457, 3977, 4332, 4775, 5115]","[0, 326, 628, 953, 1673, 1959, 2417, 2795, 3283, 3882, 4341, 4915, 5212, 5610, 5864]","[0, 170, 332, 471, 636, 909, 999, 1089, 1301, 1742, 2022, 2557, 2694, 3090, 3433]","[0, 207, 564, 776, 1061, 1773, 2085, 2420, 2918, 3453, 4111, 4781, 5367, 5856, 6142]","[0, 170, 260, 350, 562, 709, 802, 892, 1093, 1437, 1558, 1801, 2083, 2318, 2633]",5115,5864,3433,6142,2633,7,93,129,86,5,"[0, 294, 630, 1022, 1330, 1610, 2025, 2473, 2890, 3268, 4152, 4730, 5018, 5426, 5841]","[0, 208, 520, 901, 1250, 1662, 1911, 2163, 2619, 3000, 3438, 3914, 4567, 5083, 5515]","[0, 240, 532, 898, 1261, 1622, 1824, 2348, 2627, 2791, 3341, 3768, 4197, 5055, 5588]","[0, 170, 305, 441, 530, 707, 797, 932, 1246, 1348, 1676, 1962, 2088, 2327, 2484]","[0, 221, 380, 470, 559, 775, 865, 1000, 1157, 1421, 1890, 2256, 2346, 2737, 3158]",5841,5515,5588,2484,3158,-726,349,-2155,3658,-525,601,15,radiant
7622599702,48,19,137,27,79,"[0, 167, 526, 771, 1281, 1494, 1958, 2317, 2762, 3430, 3954, 4784, 5362, 6346, 7416]","[0, 178, 530, 890, 1225, 1576, 1817, 2199, 2558, 3523, 4388, 5364, 6019, 7106, 7868]","[0, 238, 443, 773, 1188, 1439, 2082, 2249, 2904, 3327, 3979, 4215, 4839, 5341, 6139]","[0, 130, 678, 815, 1032, 1460, 1835, 1925, 2090, 2355, 2741, 3183, 3453, 4197, 4520]","[0, 130, 480, 570, 728, 836, 1338, 1428, 1518, 1783, 2129, 2609, 3142, 3552, 3992]",7416,7868,6139,4520,3992,13,96,35,123,58,"[0, 348, 898, 1191, 1423, 1904, 2112, 2377, 2628, 2983, 3361, 3739, 4051, 4422, 4856]","[0, 304, 715, 924, 1014, 1499, 1706, 2006, 2271, 2460, 2676, 3017, 3579, 4010, 4426]","[0, 309, 551, 898, 1197, 1412, 1836, 2336, 2751, 2976, 3269, 3404, 3506, 3741, 3996]","[0, 235, 325, 583, 673, 945, 1351, 1531, 1850, 2450, 2585, 2817, 2966, 3183, 3454]","[0, 235, 395, 485, 575, 793, 1133, 1349, 1488, 1729, 2275, 2427, 2944, 3428, 3656]",4856,4426,3996,3454,3656,2560,3442,2143,1066,336,9547,15,radiant
7622983019,106,46,98,53,86,"[0, 325, 654, 1068, 1477, 1845, 2252, 2736, 3150, 3821, 4448, 5144, 5658, 6665, 6887]","[0, 246, 419, 583, 922, 1251, 1541, 1775, 2195, 2477, 3639, 4103, 4569, 5130, 5751]","[331, 622, 1056, 1501, 1747, 2270, 2607, 3075, 3208, 3370, 3926, 4305, 4923, 5545, 5868]","[63, 233, 323, 462, 552, 642, 778, 1064, 1524, 2041, 2274, 2691, 3008, 4119, 4442]","[63, 233, 323, 448, 538, 674, 764, 854, 988, 1391, 1526, 1832, 1971, 2623, 2832]",6887,5751,5868,4442,2832,39,70,96,119,5,"[0, 286, 690, 1140, 1559, 2129, 2337, 2728, 3129, 3810, 4244, 4678, 5169, 5567, 6240]","[0, 206, 572, 887, 1373, 1734, 2474, 3121, 3620, 4142, 4524, 5137, 5486, 5758, 6567]","[0, 245, 445, 708, 1065, 1276, 1450, 1729, 2130, 2702, 3166, 3635, 4154, 4664, 5192]","[0, 170, 260, 613, 743, 1020, 1187, 1277, 1497, 1602, 1910, 2075, 2212, 2490, 2842]","[0, 170, 260, 350, 529, 701, 1182, 1472, 1693, 1898, 2273, 2408, 2498, 3031, 3125]",6240,6567,5192,2842,3125,647,-816,676,1600,-293,1814,15,radiant
7623011807,36,48,135,64,20,"[0, 316, 681, 1082, 1569, 2065, 2581, 2971, 3485, 4213, 4729, 5258, 6259, 7698, 8236]","[0, 254, 463, 753, 1224, 1424, 1718, 2195, 2564, 3192, 3692, 4426, 4945, 5884, 6602]","[0, 240, 493, 895, 1218, 1615, 2154, 2329, 2869, 3402, 3863, 4038, 4572, 5287, 5686]","[0, 169, 259, 468, 650, 774, 864, 1213, 1473, 1913, 2149, 2386, 2771, 3374, 3695]","[0, 169, 259, 349, 488, 666, 805, 895, 1082, 1216, 1441, 1736, 1982, 2488, 2775]",8236,6602,5686,3695,2775,18,52,28,72,26,"[0, 244, 575, 934, 1425, 1825, 2072, 2645, 2895, 3108, 3577, 3926, 4415, 4931, 5645]","[0, 254, 651, 1024, 1398, 1762, 2308, 2814, 3239, 3429, 3933, 4529, 4883, 4978, 5152]","[0, 240, 494, 674, 1056, 1753, 2048, 2649, 3070, 3379, 3877, 4340, 4951, 5097, 5547]","[0, 169, 278, 751, 928, 1378, 1579, 1791, 2085, 2175, 2648, 2738, 2918, 3141, 3297]","[0, 169, 259, 349, 610, 700, 834, 1007, 1294, 1384, 1574, 1712, 1941, 2036, 2446]",5645,5152,5547,3297,2446,2591,1450,139,398,329,4907,15,dire
7623082102,129,9,72,68,51,"[327, 657, 1101, 1479, 1962, 2334, 2785, 3161, 3765, 3980, 4664, 5151, 5611, 6222, 6759]","[59, 349, 608, 948, 1567, 1893, 2614, 3143, 3798, 4251, 5029, 5237, 5693, 6208, 6626]","[0, 306, 682, 977, 1186, 1812, 2225, 2499, 3002, 3391, 3873, 4462, 4943, 5529, 6272]","[0, 402, 492, 582, 703, 940, 1030, 1246, 1429, 1538, 2048, 2338, 2554, 2703, 3170]","[59, 269, 359, 495, 630, 760, 894, 1029, 1212, 1389, 1704, 1933, 2070, 2219, 2313]",6759,6626,6272,3170,2313,49,19,21,86,20,"[0, 256, 646, 1094, 1501, 1852, 2401, 2934, 3648, 4340, 5085, 5700, 6430, 7142, 7967]","[0, 268, 543, 885, 1126, 1337, 1626, 1914, 2082, 2419, 2543, 3569, 3950, 4530, 4950]","[0, 130, 334, 615, 788, 1001, 1320, 1957, 2343, 2698, 3310, 3745, 4526, 4994, 5176]","[0, 130, 265, 398, 498, 657, 792, 1044, 1355, 1491, 2018, 2162, 2522, 2671, 2833]","[0, 130, 255, 407, 497, 606, 740, 886, 1036, 1250, 1422, 1637, 2049, 2198, 2356]",7967,4950,5176,2833,2356,-1208,1676,1096,337,-43,1858,15,dire
7623097700,104,39,44,69,53,"[0, 371, 686, 1218, 1468, 2011, 2612, 3323, 3731, 4289, 4479, 4941, 5394, 6042, 6802]","[0, 412, 759, 1142, 1559, 1937, 2405, 2921, 3507, 4381, 4937, 5929, 6490, 7053, 7681]","[0, 282, 482, 1219, 1551, 1840, 2073, 2373, 2723, 3056, 3530, 3806, 4475, 4652, 5022]","[0, 210, 318, 499, 589, 818, 1130, 1452, 1615, 2189, 2428, 2804, 3626, 3845, 4577]","[0, 210, 300, 489, 583, 673, 948, 1270, 1408, 1544, 2430, 2725, 3043, 3173, 3809]",6802,7681,5022,4577,3809,25,18,21,110,3,"[0, 293, 568, 977, 1352, 1852, 2517, 3014, 3537, 4097, 4379, 4744, 5487, 6138, 6706]","[0, 212, 615, 984, 1386, 1763, 2047, 2944, 3270, 3756, 4414, 4838, 5366, 6079, 6597]","[0, 130, 373, 730, 1306, 1601, 2091, 2507, 2826, 3260, 3450, 3686, 4233, 4661, 5540]","[0, 130, 268, 358, 513, 922, 1096, 1547, 1682, 1818, 2071, 2871, 3563, 4323, 4591]","[0, 130, 220, 310, 448, 587, 677, 1104, 1242, 1332, 1549, 1955, 2289, 2687, 2994]",6706,6597,5540,4591,2994,96,1084,-518,-14,815,1463,15,radiant
7623291018,95,129,35,86,29,"[0, 327, 621, 1040, 1238, 1820, 1982, 2465, 2684, 3874, 4010, 4617, 5320, 5979, 6716]","[0, 215, 570, 936, 1228, 1709, 2213, 2761, 3256, 3774, 4032, 4495, 4958, 5676, 6635]","[0, 329, 680, 1089, 1468, 1923, 2838, 3348, 3820, 4325, 5186, 5774, 6417, 7398, 8460]","[0, 129, 219, 406, 540, 670, 850, 1076, 1166, 1306, 1396, 1532, 1977, 2481, 2755]","[0, 558, 648, 820, 910, 1172, 1262, 1567, 1752, 1949, 2091, 2200, 2361, 2600, 3248]",6716,6635,8460,2755,3248,44,97,14,52,84,"[0, 289, 695, 1062, 1601, 1964, 2369, 2653, 3220, 3526, 4163, 4701, 5395, 5669, 6661]","[0, 544, 882, 1528, 1749, 2153, 2903, 3247, 3853, 4392, 4615, 4962, 5353, 5980, 6779]","[0, 451, 826, 1336, 1853, 2324, 2877, 3370, 3937, 4452, 5277, 5569, 6279, 6966, 7390]","[0, 276, 439, 766, 926, 1138, 1460, 1595, 2298, 2479, 2788, 3416, 3590, 3842, 4255]","[0, 209, 299, 389, 554, 771, 910, 1045, 1179, 1269, 1424, 1576, 1666, 2339, 2631]",6661,6779,7390,4255,2631,55,-144,1070,-1500,617,98,15,dire
7623382418,18,77,23,65,9,"[0, 207, 517, 801, 1120, 1532, 1860, 2328, 2997, 3689, 4208, 4769, 5509, 6153, 6797]","[0, 208, 488, 800, 1285, 1655, 1900, 2417, 2968, 3596, 4207, 4592, 5078, 5562, 5946]","[0, 321, 628, 994, 1436, 1722, 2170, 2861, 3420, 4158, 4798, 5085, 5738, 6447, 6843]","[0, 170, 260, 410, 715, 805, 895, 1030, 1196, 1456, 1737, 1827, 2252, 2592, 2736]","[0, 213, 416, 553, 806, 1041, 1216, 1466, 1604, 1838, 2111, 2201, 2705, 3084, 3514]",6797,5946,6843,2736,3514,54,52,129,121,26,"[0, 207, 439, 708, 1088, 1367, 1639, 2088, 2597, 2853, 3171, 3619, 4219, 4791, 5380]","[0, 243, 532, 859, 1348, 1763, 2049, 2375, 2947, 3394, 4329, 4714, 5553, 6065, 6627]","[0, 170, 553, 940, 1350, 1567, 2085, 2503, 2865, 3414, 4014, 4594, 5142, 5680, 6052]","[0, 170, 294, 471, 688, 898, 1033, 1123, 1300, 1525, 1868, 1958, 2138, 2335, 2532]","[0, 170, 274, 364, 494, 624, 777, 867, 1044, 1134, 1316, 1546, 1863, 2093, 2242]",5380,6627,6052,2532,2242,1417,-681,791,204,1272,3003,15,dire
7623497900,82,96,17,90,5,"[0, 210, 441, 698, 1019, 1360, 1916, 2350, 2887, 3542, 4010, 4673, 5257, 5997, 6571]","[0, 210, 518, 803, 1103, 1503, 2019, 2345, 2954, 3313, 3771, 3955, 4413, 4991, 5383]","[0, 362, 647, 1015, 1357, 1654, 2223, 2497, 3109, 3552, 4152, 4825, 5302, 5899, 6425]","[0, 249, 430, 568, 704, 838, 1153, 1287, 1377, 1600, 1753, 2023, 2236, 2535, 2630]","[0, 253, 390, 480, 688, 802, 1043, 1133, 1373, 1496, 1648, 1832, 1922, 2272, 2395]",6571,5383,6425,2630,2395,54,13,137,19,110,"[0, 155, 537, 928, 1335, 1580, 2134, 2381, 2848, 3252, 3709, 4215, 4527, 5184, 5749]","[0, 312, 590, 835, 1278, 1658, 2193, 2851, 3248, 3811, 4230, 4755, 5092, 5791, 6374]","[0, 155, 462, 749, 1088, 1347, 1474, 1772, 2306, 2718, 3312, 3851, 4402, 4686, 5084]","[0, 155, 245, 335, 580, 1052, 1142, 1363, 1718, 1808, 1999, 2361, 2728, 3035, 3507]","[0, 205, 295, 385, 562, 652, 835, 970, 1597, 1842, 2125, 2451, 2586, 2952, 3278]",5749,6374,5084,3507,3278,822,-991,1341,-877,-883,-588,15,dire
7623579605,50,11,28,136,72,"[0, 240, 575, 939, 1381, 1793, 2464, 3029, 3242, 3665, 4070, 4781, 5005, 5846, 6501]","[0, 169, 455, 631, 1080, 1485, 1785, 2100, 2544, 3197, 3471, 4017, 4697, 5252, 5982]","[0, 207, 439, 675, 952, 1319, 1584, 1748, 1838, 2248, 2506, 2732, 2960, 3352, 3851]","[0, 221, 311, 438, 626, 1016, 1153, 1283, 1627, 1824, 2202, 2512, 2664, 2975, 3308]","[0, 169, 259, 349, 488, 665, 799, 929, 1108, 1217, 1352, 1627, 1717, 1898, 2209]",6501,5982,3851,3308,2209,46,10,69,119,112,"[0, 208, 606, 877, 1050, 1357, 1534, 2051, 2453, 2944, 3729, 4160, 5139, 5902, 6972]","[0, 293, 527, 927, 1412, 1739, 2013, 2560, 3378, 3546, 4480, 4908, 5474, 5905, 6641]","[0, 507, 795, 1137, 1479, 1698, 2000, 2379, 2897, 3188, 3437, 3794, 4011, 4663, 5481]","[0, 239, 329, 633, 767, 906, 1126, 1306, 1636, 1803, 2144, 2234, 2515, 2610, 3108]","[100, 269, 359, 449, 586, 725, 815, 995, 1295, 1511, 1763, 1901, 2240, 2335, 2776]",6972,6641,5481,3108,2776,-471,-659,-1630,200,-567,-3127,15,dire
7623846810,48,49,23,79,5,"[0, 170, 579, 904, 1193, 1521, 1979, 2278, 2828, 3180, 3582, 4261, 4867, 5605, 6261]","[0, 238, 565, 1010, 1466, 1854, 2276, 2699, 3079, 3649, 4259, 4891, 5308, 5847, 6541]","[0, 260, 543, 830, 1237, 1442, 1781, 1916, 2299, 2861, 3082, 3538, 4490, 5274, 5976]","[0, 170, 260, 384, 519, 649, 789, 924, 1014, 1280, 1893, 1983, 2302, 2635, 2880]","[0, 215, 305, 413, 634, 764, 937, 1072, 1201, 1335, 1779, 2050, 2254, 2636, 2934]",6261,6541,5976,2880,2934,10,98,17,19,110,"[0, 258, 545, 859, 1213, 1700, 2148, 2529, 2914, 3473, 4106, 4824, 5347, 5873, 6575]","[0, 206, 512, 720, 1008, 1253, 1459, 2230, 2805, 3258, 3818, 4170, 4651, 5096, 5630]","[0, 321, 608, 1020, 1303, 1576, 1764, 2077, 2646, 2850, 3537, 4011, 4525, 5200, 5730]","[0, 216, 341, 431, 605, 733, 823, 1048, 1261, 1484, 1761, 1851, 2032, 2257, 2725]","[0, 172, 266, 376, 551, 641, 731, 866, 1190, 1280, 1566, 1656, 1891, 2120, 2484]",6575,5630,5730,2725,2484,-314,911,246,155,450,1448,15,radiant
7623881615,36,4,129,86,123,"[0, 235, 596, 1020, 1494, 1993, 2324, 3035, 3421, 3869, 4712, 5185, 5572, 6225, 6812]","[0, 192, 424, 625, 784, 874, 1203, 1625, 2023, 2296, 2978, 3400, 4114, 4352, 4780]","[0, 263, 693, 976, 1286, 1454, 1913, 2083, 2372, 2822, 3215, 3391, 3840, 4348, 4742]","[0, 154, 854, 944, 1184, 1528, 2024, 2431, 2783, 3111, 3389, 3564, 3849, 4210, 4445]","[0, 154, 244, 350, 483, 573, 934, 1146, 1381, 1580, 1882, 1972, 2145, 2402, 2637]",6812,4780,4742,4445,2637,106,98,93,19,112,"[0, 390, 753, 1042, 1239, 1586, 1833, 2182, 2548, 2819, 3542, 3838, 4419, 4899, 5461]","[0, 234, 563, 851, 1027, 1191, 1690, 2096, 2223, 2712, 2997, 3314, 3404, 4451, 5168]","[0, 341, 539, 1043, 1438, 1665, 1834, 2475, 2885, 3309, 3731, 4057, 4646, 4976, 5713]","[0, 234, 324, 449, 539, 754, 1173, 1468, 1558, 1933, 2113, 2203, 2438, 3149, 3442]","[100, 378, 468, 640, 809, 1142, 1277, 1502, 1592, 1794, 2020, 2231, 2367, 2462, 2755]",5461,5168,5713,3442,2755,1351,-388,-971,1003,-118,877,15,dire
7623943100,48,22,23,21,62,"[0, 227, 600, 889, 1328, 1496, 1726, 2153, 2641, 3126, 3791, 4343, 4941, 5639, 6060]","[0, 337, 838, 1234, 1579, 2063, 2449, 2839, 3328, 3866, 4346, 5004, 5734, 6121, 6524]","[0, 227, 465, 837, 1239, 1365, 2109, 2654, 3232, 3719, 4297, 5039, 5257, 5913, 6448]","[0, 495, 585, 768, 1119, 1301, 1627, 1807, 1946, 2141, 2371, 2730, 3004, 3153, 3501]","[12, 263, 353, 443, 621, 790, 1013, 1251, 1365, 1522, 1672, 1762, 2040, 2201, 2539]",6060,6524,6448,3501,2539,95,112,43,88,5,"[0, 292, 535, 779, 1331, 1616, 1912, 2444, 2940, 3497, 4043, 4502, 5012, 5544, 6055]","[0, 321, 601, 892, 1360, 1450, 2023, 2402, 2819, 3425, 3726, 4354, 5058, 5354, 5725]","[0, 250, 608, 921, 1168, 1624, 2084, 2750, 3156, 3780, 4200, 4722, 5172, 5523, 6350]","[0, 170, 260, 394, 524, 782, 872, 1052, 1272, 1543, 1903, 2485, 2924, 3569, 3809]","[0, 170, 260, 350, 544, 634, 810, 990, 1080, 1508, 1893, 2173, 2380, 2664, 2995]",6055,5725,6350,3809,2995,5,799,98,-308,-456,138,15,dire
7624146019,109,13,96,65,79,"[0, 555, 930, 1289, 1637, 1924, 2484, 2871, 3324, 4041, 4684, 5360, 6236, 6840, 7756]","[0, 208, 469, 596, 977, 1320, 1701, 2149, 2564, 3339, 3920, 4278, 4566, 5351, 6049]","[0, 170, 521, 852, 1217, 1393, 1717, 2312, 2722, 3207, 3504, 4011, 4630, 5026, 5584]","[0, 239, 684, 822, 1005, 1502, 1682, 1846, 2030, 2327, 2800, 2944, 3180, 3274, 3669]","[0, 170, 290, 428, 558, 648, 828, 963, 1106, 1374, 1667, 1857, 2094, 2372, 2998]",7756,6049,5584,3669,2998,18,23,126,5,86,"[0, 202, 499, 754, 1176, 1544, 1911, 2340, 2961, 3586, 4596, 5013, 5524, 6863, 7612]","[0, 178, 769, 1098, 1478, 1803, 2036, 2414, 2969, 3238, 3746, 4397, 4883, 5468, 5718]","[0, 287, 573, 956, 1322, 1708, 2128, 2829, 3159, 3286, 3672, 4382, 5108, 5960, 6244]","[0, 130, 220, 407, 543, 680, 770, 982, 1133, 1301, 1860, 2060, 2540, 2885, 3241]","[0, 130, 311, 401, 540, 793, 883, 1018, 1108, 1198, 1435, 1721, 1899, 2437, 2677]",7612,5718,6244,3241,2677,144,331,-660,428,321,564,15,dire
7624389211,41,120,98,47,105,"[0, 285, 713, 961, 1303, 1522, 1987, 2333, 3038, 3418, 3918, 4298, 4739, 5398, 5699]","[0, 297, 620, 931, 1393, 1606, 2025, 2653, 3258, 3854, 4929, 5271, 6304, 7043, 7138]","[0, 247, 564, 796, 1519, 1865, 2231, 2656, 3053, 3290, 3659, 4248, 4755, 5669, 6146]","[0, 210, 300, 471, 758, 848, 1504, 1684, 2000, 2090, 2727, 3050, 3604, 3933, 4393]","[0, 210, 300, 406, 654, 744, 1321, 1501, 1926, 2270, 2581, 2725, 3196, 3525, 4174]",5699,7138,6146,4393,4174,10,76,96,52,5,"[60, 229, 656, 880, 1087, 1339, 1851, 2251, 2714, 3059, 3605, 4048, 4694, 5816, 6568]","[60, 315, 717, 1171, 1455, 1902, 2427, 2754, 3089, 3269, 3683, 4067, 4720, 5055, 5610]","[328, 693, 898, 1287, 1754, 2306, 2586, 3042, 3358, 3794, 4154, 4770, 4979, 5462, 5839]","[60, 255, 388, 552, 814, 1108, 1508, 1989, 2116, 2637, 3337, 3748, 4003, 5346, 5456]","[160, 355, 445, 552, 642, 751, 1085, 1423, 1513, 1790, 2547, 2667, 2957, 3642, 3807]",6568,5610,5839,5456,3807,-869,1528,307,-1063,367,270,15,radiant
7624424306,95,19,28,66,9,"[0, 179, 470, 723, 1089, 1296, 1765, 2187, 2525, 2931, 3152, 3622, 4093, 4683, 5308]","[0, 169, 442, 772, 1210, 1385, 1681, 2228, 2568, 3289, 3465, 3814, 4265, 4650, 5227]","[0, 256, 576, 868, 1164, 1607, 2106, 2705, 3341, 3870, 4439, 4932, 5336, 5431, 5935]","[0, 130, 254, 392, 598, 688, 896, 1401, 1604, 1729, 2125, 2449, 2677, 2813, 3022]","[0, 130, 220, 310, 528, 1064, 1203, 1537, 1627, 1780, 1915, 2085, 2254, 2632, 2816]",5308,5227,5935,3022,2816,18,15,77,65,5,"[0, 210, 595, 799, 1166, 1525, 1773, 2054, 2350, 2736, 3408, 4040, 4774, 6239, 6985]","[0, 245, 479, 714, 1076, 1544, 1942, 2569, 2784, 3129, 3965, 4817, 5477, 6163, 6718]","[0, 298, 555, 935, 1151, 1482, 1956, 2325, 2780, 3090, 3583, 3941, 4707, 5205, 5578]","[0, 210, 338, 428, 518, 905, 995, 1326, 1451, 1681, 2554, 2856, 3163, 3709, 4132]","[0, 210, 300, 416, 554, 644, 734, 952, 1171, 1580, 1801, 2219, 2417, 2820, 3082]",6985,6718,5578,4132,3082,-1677,-1491,357,-1110,-266,-4187,15,radiant
7624477209,46,72,65,136,20,"[0, 240, 553, 923, 1328, 1821, 2206, 2870, 3450, 4016, 4612, 4820, 5288, 5728, 6371]","[0, 216, 619, 979, 1109, 1510, 1828, 2119, 2439, 2602, 2955, 3500, 4038, 4520, 4790]","[0, 282, 446, 713, 1017, 1328, 1690, 1871, 2394, 2770, 2968, 3225, 3629, 3825, 4129]","[0, 130, 220, 310, 487, 577, 1022, 1244, 1423, 1513, 1748, 2002, 2092, 2287, 2430]","[0, 130, 239, 329, 459, 597, 737, 978, 1095, 1185, 1413, 1809, 1899, 2087, 2253]",6371,4790,4129,2430,2253,49,22,63,5,9,"[0, 210, 456, 691, 1128, 1376, 1837, 2172, 2680, 3282, 3804, 4376, 4991, 5996, 6528]","[0, 365, 801, 1247, 1622, 2065, 2688, 3104, 3586, 4159, 4741, 5232, 5588, 6436, 7052]","[0, 247, 528, 815, 1186, 1672, 1984, 2405, 2865, 3551, 4286, 4895, 5361, 6466, 7291]","[0, 210, 369, 541, 829, 1315, 1525, 1660, 1887, 2278, 2740, 3188, 3370, 4078, 4303]","[0, 256, 447, 615, 775, 865, 955, 1090, 1180, 1597, 1839, 2406, 2741, 3260, 3688]",6528,7052,7291,4303,3688,-157,-2262,-3162,-1873,-1435,-8889,15,dire
7624499802,35,2,10,86,96,"[0, 361, 739, 1153, 1626, 2156, 2554, 3205, 3747, 4508, 5256, 6025, 6721, 7492, 8639]","[0, 250, 564, 1008, 1472, 1952, 2328, 2936, 3473, 4006, 4771, 5195, 5709, 6604, 7318]","[0, 323, 612, 809, 1139, 1511, 1925, 2222, 2677, 2998, 3450, 4042, 4521, 5004, 5984]","[0, 170, 260, 410, 500, 590, 680, 808, 949, 1677, 2080, 2496, 2633, 2933, 3424]","[0, 170, 260, 350, 440, 578, 731, 821, 957, 1220, 1310, 1503, 1593, 1742, 2396]",8639,7318,5984,3424,2396,1,69,21,119,85,"[0, 254, 688, 1133, 1612, 1888, 2473, 2878, 3403, 3858, 4467, 5032, 5789, 6550, 7322]","[0, 314, 626, 1043, 1581, 2197, 2833, 3271, 4270, 4916, 5770, 6605, 7189, 7784, 8329]","[0, 257, 569, 817, 1182, 1477, 1847, 2417, 2645, 2930, 3239, 3614, 3939, 4296, 4424]","[0, 170, 260, 350, 515, 652, 760, 1195, 1375, 1514, 1694, 1784, 1958, 2107, 2256]","[0, 170, 260, 399, 611, 701, 853, 1029, 1312, 1402, 1556, 1694, 1936, 2085, 2179]",7322,8329,4424,2256,2179,1317,-1011,1560,1168,217,3251,15,radiant
7624586412,84,76,44,110,5,"[0, 290, 658, 1093, 1552, 1987, 2437, 3145, 3555, 4285, 4889, 6013, 6558, 7705, 8821]","[0, 236, 602, 1081, 1495, 1943, 2508, 3084, 3558, 4032, 4603, 5422, 6012, 6684, 6934]","[0, 615, 922, 1485, 1841, 2348, 2681, 3242, 3810, 4148, 4682, 5427, 6034, 6709, 7217]","[0, 230, 360, 667, 757, 894, 1082, 1325, 1459, 1637, 1906, 2354, 2780, 3582, 3936]","[0, 304, 434, 613, 749, 939, 1029, 1242, 1381, 1576, 1779, 2173, 2516, 2838, 3340]",8821,6934,7217,3936,3340,25,14,114,53,86,"[0, 393, 763, 1212, 1666, 2278, 2604, 3173, 3832, 4397, 5086, 5876, 6630, 7824, 8628]","[59, 271, 615, 978, 1509, 1900, 2339, 2978, 3393, 3984, 4655, 5120, 5632, 6486, 6808]","[59, 275, 625, 878, 1356, 1720, 2089, 2419, 2953, 3321, 4106, 4488, 4964, 5371, 5733]","[327, 534, 698, 839, 985, 1174, 1452, 1743, 1874, 2041, 2608, 2926, 3442, 3862, 4328]","[59, 228, 318, 408, 538, 676, 766, 948, 1053, 1143, 1964, 2054, 2189, 2374, 2503]",8628,6808,5733,4328,2503,193,126,1484,-392,837,2248,15,dire
7624657601,13,21,1,19,102,"[0, 279, 651, 1128, 1541, 1964, 2348, 2786, 3699, 4140, 4664, 5111, 5545, 6570, 7607]","[0, 243, 607, 1073, 1474, 1835, 2321, 2901, 2991, 3443, 3891, 4315, 5088, 5925, 6787]","[0, 242, 442, 720, 1001, 1234, 1583, 1955, 2254, 2795, 3278, 4325, 4630, 5146, 5534]","[100, 319, 409, 529, 714, 864, 999, 1134, 1368, 1631, 1768, 2115, 2333, 2876, 3393]","[0, 170, 260, 380, 595, 685, 775, 957, 1085, 1268, 1392, 1718, 1808, 2094, 2525]",7607,6787,5534,3393,2525,10,123,71,39,101,"[0, 247, 589, 870, 1322, 1723, 2105, 2663, 3316, 3761, 4337, 4901, 5570, 6085, 6977]","[0, 366, 913, 1298, 1700, 2120, 2659, 3199, 3636, 4250, 4677, 5397, 5972, 6547, 7315]","[0, 294, 717, 1055, 1544, 2218, 2630, 3224, 3559, 3880, 4334, 4633, 5022, 5669, 6178]","[0, 170, 285, 375, 511, 754, 924, 1014, 1151, 1241, 1449, 1825, 1915, 2064, 2419]","[0, 170, 285, 375, 519, 720, 810, 947, 1325, 1464, 1723, 1867, 2075, 2208, 2593]",6977,7315,6178,2419,2593,630,-528,-644,974,-68,364,15,radiant
7624664611,48,13,21,83,20,"[0, 221, 518, 1024, 1320, 1512, 2153, 2319, 2715, 3230, 3825, 4288, 4930, 5341, 6036]","[0, 242, 749, 1007, 1410, 1817, 2004, 2805, 3267, 3728, 4299, 4815, 5394, 5954, 6702]","[0, 259, 529, 922, 1282, 1652, 2512, 2993, 3349, 3767, 4458, 5162, 5801, 6119, 6592]","[0, 170, 285, 408, 538, 667, 1051, 1268, 1399, 1904, 2484, 2574, 2789, 3083, 3436]","[0, 209, 359, 498, 675, 935, 1107, 1349, 1439, 1648, 1965, 2102, 2326, 2420, 2742]",6036,6702,6592,3436,2742,18,39,103,121,85,"[0, 291, 615, 1026, 1438, 1845, 2428, 3010, 3753, 4343, 5092, 5784, 6536, 7086, 7801]","[0, 316, 563, 936, 1336, 1586, 2032, 2435, 2893, 3815, 4283, 4777, 5876, 6597, 7400]","[0, 331, 567, 868, 1309, 1652, 2127, 2539, 3083, 3417, 3799, 4287, 4908, 5390, 6289]","[0, 170, 260, 400, 490, 625, 1273, 1363, 1585, 2146, 2448, 2538, 2830, 3216, 3607]","[0, 170, 277, 443, 661, 751, 857, 947, 1072, 1185, 1365, 1455, 1973, 2121, 2360]",7801,7400,6289,3607,2360,-1765,-698,303,-171,382,-1949,15,radiant
7624763717,10,15,137,86,103,"[0, 276, 634, 984, 1327, 1705, 1987, 2469, 2919, 3138, 3489, 3994, 4424, 5186, 5783]","[0, 264, 437, 773, 1332, 1793, 2164, 2509, 2933, 3219, 3887, 4611, 4879, 5126, 5829]","[0, 194, 501, 779, 1217, 1458, 1958, 2464, 3041, 3167, 4029, 4222, 4678, 5141, 5577]","[0, 248, 390, 518, 750, 840, 1151, 1412, 1533, 1933, 2305, 2771, 3226, 3487, 4014]","[0, 194, 284, 374, 522, 616, 706, 888, 978, 1230, 1607, 1996, 2086, 2347, 2693]",5783,5829,5577,4014,2693,54,120,69,33,105,"[0, 207, 560, 1040, 1370, 1821, 2232, 2854, 3382, 3930, 4482, 5154, 5867, 6446, 7028]","[0, 216, 381, 828, 1165, 1585, 1867, 2200, 2762, 3362, 3885, 4420, 5290, 5938, 6651]","[0, 292, 616, 909, 1223, 1556, 2023, 2442, 2887, 3350, 3836, 4443, 4901, 5550, 5858]","[0, 219, 309, 480, 673, 937, 1061, 1262, 1580, 1752, 2014, 2290, 2455, 3096, 3329]","[0, 169, 259, 719, 857, 947, 1135, 1317, 1456, 1958, 2375, 2734, 2999, 3302, 3477]",7028,6651,5858,3329,3477,-1245,-822,-281,685,-784,-2447,15,dire
7624827905,38,20,53,107,51,"[0, 317, 720, 1039, 1579, 1866, 2501, 2743, 3552, 3812, 4311, 4841, 5404, 6008, 6985]","[0, 324, 488, 860, 1238, 1462, 1670, 1917, 2375, 2593, 3298, 3769, 4536, 5090, 5386]","[0, 195, 285, 375, 771, 861, 1094, 1259, 1559, 1729, 2043, 2322, 2614, 2939, 3324]","[0, 355, 574, 899, 1273, 1406, 1594, 1991, 2242, 2751, 3357, 3447, 3831, 4257, 5007]","[0, 295, 420, 510, 790, 880, 970, 1293, 1865, 2240, 2572, 2816, 3118, 3551, 4020]",6985,5386,3324,5007,4020,120,41,96,123,112,"[0, 332, 754, 1110, 1443, 1901, 2506, 2795, 3094, 3885, 4065, 4603, 5435, 6126, 7275]","[0, 207, 445, 745, 1111, 1482, 1823, 2206, 2386, 3140, 3368, 3985, 4416, 5003, 6011]","[0, 170, 1024, 1148, 1783, 1910, 2361, 3417, 3920, 4200, 4490, 5329, 5675, 6316, 6519]","[0, 170, 415, 505, 805, 895, 1210, 1401, 1787, 2007, 2306, 2543, 2971, 3455, 3774]","[0, 170, 260, 350, 488, 622, 761, 952, 1132, 1389, 1479, 1677, 1940, 2125, 2859]",7275,6011,6519,3774,2859,-290,-625,-3195,1233,1161,-1716,15,dire
7624854612,18,59,69,5,26,"[0, 294, 534, 982, 1352, 1793, 2284, 2724, 3471, 4094, 4641, 5397, 6282, 6620, 7068]","[0, 279, 654, 1076, 1370, 1753, 2452, 2908, 3455, 3786, 3876, 4424, 4961, 5427, 6057]","[0, 331, 582, 924, 1623, 1882, 2051, 2376, 2730, 3011, 3771, 3957, 4408, 4944, 5603]","[0, 170, 341, 466, 601, 735, 1150, 1269, 1418, 1591, 1681, 1938, 2417, 2512, 2660]","[0, 170, 340, 430, 634, 852, 991, 1205, 1340, 1430, 1780, 1870, 2348, 2443, 2638]",7068,6057,5603,2660,2638,54,120,129,100,110,"[0, 170, 545, 970, 1302, 2102, 2658, 3285, 3846, 4328, 5080, 5533, 6066, 6518, 7088]","[0, 289, 479, 724, 1022, 1200, 1598, 2166, 2608, 3180, 3702, 4063, 4777, 5513, 6298]","[0, 170, 593, 867, 1313, 1627, 2033, 2557, 3042, 3511, 4343, 4708, 5271, 5852, 6181]","[0, 170, 285, 375, 589, 679, 1053, 1301, 1436, 1665, 2007, 2097, 2346, 2549, 2890]","[0, 170, 285, 427, 597, 782, 1234, 1447, 1582, 2004, 2497, 2712, 3083, 3368, 3740]",7088,6298,6181,2890,3740,-20,-241,-578,-230,-1102,-2171,15,dire
7624880815,15,96,112,100,88,"[78, 465, 778, 1041, 1404, 1777, 2102, 2421, 3097, 3489, 3820, 4333, 4517, 5043, 5535]","[78, 565, 877, 1194, 1556, 2089, 2563, 2845, 3181, 3509, 3826, 4387, 4925, 5387, 6045]","[211, 706, 1147, 1544, 1949, 2524, 2767, 3096, 3643, 3895, 4452, 4770, 5221, 5782, 6690]","[78, 360, 501, 817, 907, 1206, 1296, 1719, 1938, 2160, 2334, 2617, 2936, 3064, 3280]","[78, 289, 409, 548, 638, 1038, 1128, 1300, 1676, 1899, 2034, 2124, 2675, 2769, 3621]",5535,6045,6690,3280,3621,69,63,53,13,65,"[323, 853, 1131, 1537, 1934, 2269, 2711, 3086, 3709, 4090, 4988, 5461, 6033, 6669, 7313]","[55, 426, 670, 884, 1329, 1858, 2206, 2836, 3136, 3603, 4058, 4534, 5236, 5892, 6179]","[55, 559, 649, 788, 947, 1267, 1357, 1583, 2068, 2263, 2774, 3172, 3514, 3662, 4062]","[55, 597, 1002, 1282, 1652, 2030, 2282, 2614, 2831, 3355, 3867, 4453, 4771, 5218, 5741]","[55, 559, 649, 739, 962, 1289, 1379, 1767, 1902, 2384, 2618, 2930, 3364, 3765, 4160]",7313,6179,4062,5741,4160,-1778,-134,2628,-2461,-539,-2284,15,radiant
7625161613,15,10,96,123,86,"[0, 285, 722, 1053, 1470, 1937, 2447, 3215, 3570, 4080, 4512, 4970, 5569, 6230, 6648]","[0, 214, 373, 703, 1028, 1314, 1549, 1814, 2205, 2600, 2886, 3268, 3712, 4601, 5052]","[0, 314, 634, 871, 1246, 1443, 1926, 2323, 2499, 3059, 3465, 3817, 4212, 4567, 5099]","[0, 501, 591, 838, 1017, 1107, 1385, 1752, 1842, 1980, 2114, 2577, 2744, 3370, 3637]","[0, 233, 368, 635, 864, 1073, 1391, 1778, 2112, 2393, 2529, 3016, 3224, 3654, 4096]",6648,5052,5099,3637,4096,54,90,19,9,5,"[0, 280, 442, 794, 1004, 1362, 1700, 2006, 2471, 2928, 3417, 3582, 4189, 4848, 5520]","[0, 293, 645, 934, 1502, 1951, 2790, 3154, 3421, 3970, 4276, 4447, 4993, 5334, 5577]","[0, 209, 447, 916, 1162, 1890, 2182, 2547, 2939, 3267, 3827, 4042, 4469, 4601, 4957]","[0, 219, 355, 571, 661, 938, 1090, 1769, 2160, 2634, 2831, 2957, 3047, 3187, 4138]","[0, 170, 260, 492, 582, 748, 1016, 1106, 1196, 1416, 1733, 1861, 2182, 2276, 2635]",5520,5577,4957,4138,2635,1128,-525,142,-501,1461,1705,15,dire
7625218507,61,20,36,33,58,"[0, 169, 443, 674, 801, 1020, 1504, 1960, 2050, 2565, 2877, 3206, 4027, 4825, 5466]","[0, 328, 647, 1051, 1340, 1876, 2082, 2218, 2513, 3460, 4087, 4708, 5361, 5634, 5974]","[0, 290, 649, 897, 1033, 1245, 1612, 1953, 2418, 3007, 3743, 4605, 5339, 6124, 6901]","[0, 169, 259, 369, 478, 624, 925, 1102, 1324, 2335, 2673, 3249, 4115, 4319, 4556]","[0, 169, 259, 365, 494, 641, 854, 1039, 1129, 1417, 1767, 2089, 2811, 3210, 3477]",5466,5974,6901,4556,3477,10,126,49,71,79,"[0, 586, 983, 1236, 1555, 1979, 2491, 2617, 3072, 3541, 4055, 4539, 5330, 5913, 7090]","[0, 272, 467, 622, 1035, 1322, 1679, 2052, 2398, 2899, 3346, 3805, 4108, 4345, 4723]","[0, 169, 502, 910, 1106, 1442, 1765, 1963, 2674, 3315, 3868, 3958, 4557, 5188, 5446]","[0, 235, 377, 515, 605, 784, 1037, 1369, 1631, 2233, 2485, 2666, 2915, 3013, 3365]","[0, 169, 279, 399, 528, 790, 1131, 1710, 1935, 2467, 2602, 2728, 2818, 2971, 3260]",7090,4723,5446,3365,3260,-1624,1251,1455,1191,217,2490,15,dire
7625316506,73,10,37,104,112,"[0, 508, 1167, 1530, 2013, 2426, 3130, 3494, 4197, 4547, 5334, 6112, 6643, 7907, 8572]","[0, 312, 621, 942, 1254, 1740, 1987, 2296, 2422, 2761, 3140, 3543, 4064, 4471, 4821]","[0, 195, 285, 537, 707, 893, 983, 1140, 1397, 1684, 2215, 2428, 2622, 2860, 3554]","[0, 273, 864, 1241, 1879, 2169, 2572, 3165, 3788, 4381, 5115, 5556, 6468, 6768, 7013]","[0, 195, 353, 443, 1089, 1365, 1455, 1641, 2048, 2372, 2642, 2907, 3150, 3399, 3605]",8572,4821,3554,7013,3605,1,106,29,123,71,"[64, 317, 598, 961, 1186, 1683, 1968, 2292, 2956, 3321, 3707, 4197, 4944, 5604, 6924]","[64, 349, 670, 1158, 1482, 1810, 2270, 2699, 3264, 3619, 4189, 4452, 5063, 5425, 5786]","[64, 234, 545, 1099, 1504, 1801, 2287, 3044, 3810, 4423, 4820, 5541, 5974, 6453, 7061]","[332, 505, 625, 915, 1005, 1219, 1527, 1907, 2204, 2548, 2907, 3193, 3501, 3997, 4716]","[64, 234, 354, 479, 569, 1009, 1406, 1852, 2055, 2240, 2330, 2420, 2929, 3221, 4182]",6924,5786,7061,4716,4182,1648,-965,-3507,2297,-577,-1104,15,radiant
7625543012,13,78,32,19,65,"[0, 212, 528, 929, 1210, 1664, 1996, 2443, 3001, 3343, 3973, 4696, 5213, 5558, 6206]","[0, 241, 401, 650, 774, 1137, 1379, 1881, 2435, 2779, 3246, 3978, 4431, 4979, 5548]","[0, 253, 554, 922, 1210, 1537, 1863, 2170, 2438, 2683, 3350, 3609, 3757, 4492, 5282]","[0, 215, 330, 420, 510, 679, 821, 1392, 1945, 2122, 2324, 2743, 2881, 3118, 3521]","[0, 270, 385, 519, 609, 844, 1052, 1363, 1785, 2010, 2228, 2812, 2902, 3087, 3591]",6206,5548,5282,3521,3591,48,23,60,79,5,"[0, 243, 475, 719, 1425, 1745, 2067, 2387, 2601, 3128, 3704, 3839, 4400, 4991, 5777]","[0, 243, 654, 1107, 1559, 1979, 2559, 3313, 4364, 4795, 5198, 5543, 6338, 6765, 7087]","[0, 292, 543, 702, 918, 1215, 1747, 2143, 2625, 2864, 3544, 4016, 4270, 4555, 4900]","[0, 169, 259, 349, 439, 564, 768, 948, 1128, 1264, 1737, 2201, 2610, 3021, 3419]","[0, 169, 355, 445, 651, 758, 848, 1111, 1336, 1463, 1688, 1823, 2146, 2377, 2623]",5777,7087,4900,3419,2623,429,-1539,382,102,968,342,15,radiant
7625796211,44,126,97,9,85,"[0, 336, 610, 1009, 1172, 1750, 2201, 2503, 3003, 3506, 3998, 4481, 4935, 5375, 6095]","[0, 249, 454, 629, 854, 1140, 1386, 1607, 1901, 2250, 2800, 3331, 3896, 4298, 4615]","[0, 327, 492, 790, 998, 1160, 1296, 1592, 1765, 2039, 2383, 2929, 3413, 4358, 5140]","[0, 301, 443, 533, 713, 803, 1305, 1405, 1544, 1709, 2015, 2151, 2407, 2648, 2802]","[0, 249, 391, 564, 654, 993, 1083, 1173, 1263, 1414, 1603, 1738, 2091, 2583, 2822]",6095,4615,5140,2802,2822,109,35,104,110,86,"[0, 138, 495, 912, 1201, 1483, 1928, 2499, 2885, 3488, 4117, 4553, 5170, 5806, 6316]","[0, 127, 376, 734, 1110, 1274, 1626, 2234, 2630, 3077, 3856, 4362, 5128, 5672, 6424]","[0, 210, 389, 735, 987, 1279, 1992, 2466, 2748, 3240, 3523, 3965, 4440, 4909, 5476]","[0, 89, 229, 367, 497, 587, 1041, 1224, 1367, 1482, 1738, 2198, 2727, 3084, 3277]","[0, 89, 312, 402, 604, 783, 967, 1102, 1370, 1575, 2016, 2296, 2682, 3085, 3606]",6316,6424,5476,3277,3606,-221,-1809,-336,-475,-784,-3625,15,dire
7625873218,17,129,93,9,5,"[0, 320, 646, 1097, 1438, 1647, 1975, 2508, 3062, 3430, 3953, 4081, 4847, 4980, 5492]","[0, 203, 503, 872, 1118, 1491, 1997, 2169, 2804, 3395, 3735, 4155, 4515, 4902, 5190]","[0, 204, 531, 945, 1154, 1607, 1736, 2134, 2325, 2595, 3135, 3449, 4128, 4277, 4876]","[0, 182, 319, 558, 697, 831, 1180, 1930, 2065, 2308, 2490, 2677, 3806, 4050, 4144]","[0, 130, 220, 393, 567, 704, 794, 1098, 1273, 1516, 1651, 1787, 2372, 2467, 2561]",5492,5190,4876,4144,2561,48,55,23,65,20,"[0, 253, 664, 1047, 1507, 1737, 2437, 3134, 3426, 4378, 5184, 5829, 6810, 7922, 8608]","[328, 610, 1216, 1585, 2067, 2557, 3307, 4099, 4537, 5600, 6196, 6889, 7570, 8036, 8425]","[0, 332, 687, 1139, 1497, 2045, 2828, 3274, 3794, 4524, 5202, 5530, 6568, 7194, 7705]","[60, 270, 581, 750, 1311, 1636, 1977, 2336, 2557, 3304, 3780, 4396, 4919, 5555, 5740]","[60, 270, 394, 567, 972, 1106, 1380, 1548, 1687, 2015, 2487, 3142, 3618, 4112, 4394]",8608,8425,7705,5740,4394,-3116,-3235,-2829,-1596,-1833,-12609,15,dire
7626063506,73,97,13,21,5,"[0, 327, 775, 1083, 1562, 1945, 2363, 2563, 3513, 4008, 4685, 5303, 5727, 6379, 6774]","[0, 326, 536, 869, 1260, 1511, 1958, 2494, 2952, 3529, 4011, 4539, 5038, 5833, 6531]","[0, 367, 731, 1098, 1526, 1906, 2502, 2923, 3508, 3850, 4521, 4895, 5515, 6126, 6871]","[0, 170, 351, 657, 821, 962, 1161, 1407, 1602, 1906, 2292, 3032, 3338, 3487, 3582]","[0, 170, 602, 692, 856, 946, 1036, 1129, 1255, 1390, 1575, 1925, 2031, 2180, 2461]",6774,6531,6871,3582,2461,48,25,120,68,64,"[0, 244, 409, 743, 1249, 1776, 2278, 2730, 3315, 3847, 4415, 5233, 5762, 6452, 7259]","[0, 279, 616, 1034, 1359, 1693, 2034, 2545, 3021, 3812, 4800, 5278, 5747, 6176, 6520]","[0, 242, 532, 1019, 1588, 2004, 2582, 2965, 3569, 4079, 4577, 4787, 5300, 5862, 6321]","[0, 170, 260, 350, 533, 668, 877, 1029, 1227, 1363, 1583, 2059, 2149, 2389, 3023]","[0, 170, 260, 508, 668, 758, 938, 1074, 1298, 1485, 1682, 1957, 2047, 2142, 2568]",7259,6520,6321,3023,2568,-485,11,550,559,-107,528,15,dire
7626216408,85,10,23,71,72,"[0, 285, 654, 977, 1878, 2228, 2844, 3339, 3976, 4705, 5429, 6115, 6695, 7021, 7724]","[0, 324, 689, 1035, 1334, 1708, 2150, 2780, 3475, 3786, 4341, 4938, 5335, 5980, 6212]","[0, 329, 773, 1115, 1484, 1974, 2335, 2832, 3661, 4214, 4840, 5302, 6012, 6475, 7101]","[0, 169, 259, 349, 439, 726, 1005, 1233, 1579, 1793, 2093, 2330, 2420, 2608, 3104]","[0, 169, 259, 349, 642, 750, 1155, 1335, 1770, 2172, 2676, 3038, 3280, 3429, 3675]",7724,6212,7101,3104,3675,11,84,70,39,5,"[0, 318, 643, 1063, 1486, 1907, 2388, 3102, 3660, 4103, 4486, 4958, 5930, 6458, 7002]","[0, 278, 733, 1137, 1559, 1960, 2258, 2707, 2997, 3413, 4354, 4481, 6066, 6847, 7876]","[0, 246, 485, 1037, 1201, 1438, 1647, 1847, 2169, 2394, 2802, 3129, 3858, 4467, 5133]","[0, 169, 358, 584, 814, 1072, 1843, 2013, 2186, 2461, 2718, 3057, 3790, 4409, 4504]","[0, 169, 259, 402, 492, 706, 878, 1048, 1144, 1234, 1430, 1536, 1722, 2271, 2366]",7002,7876,5133,4504,2366,722,-1664,1968,-1400,1309,935,15,dire
7627919905,48,106,60,26,45,"[0, 282, 483, 682, 1078, 1260, 1774, 2301, 2755, 3124, 3666, 4228, 4953, 5767, 6616]","[0, 251, 651, 1046, 1487, 1857, 2235, 2992, 3458, 3983, 4814, 5036, 5790, 6381, 6861]","[0, 170, 407, 614, 900, 1041, 1296, 1470, 1665, 2137, 2938, 3385, 3728, 4276, 4531]","[0, 170, 260, 395, 485, 575, 791, 1052, 1330, 1548, 1978, 2521, 2695, 2924, 3019]","[0, 170, 260, 350, 488, 616, 909, 1147, 1493, 1664, 2056, 2218, 2568, 2859, 3010]",6616,6861,4531,3019,3010,35,120,96,86,5,"[326, 568, 882, 1167, 1459, 2331, 2715, 3238, 3797, 4275, 4732, 4945, 5609, 6453, 7254]","[58, 304, 625, 914, 1292, 1708, 2379, 2634, 3357, 3905, 4664, 5219, 5872, 6653, 7397]","[58, 228, 556, 999, 1512, 1877, 2043, 2263, 2841, 3456, 4274, 5221, 5631, 6139, 6878]","[58, 228, 318, 666, 1026, 1304, 1480, 1721, 1811, 2057, 2327, 2471, 2561, 2885, 3497]","[58, 228, 318, 671, 846, 1107, 1246, 1457, 1547, 1727, 1997, 2210, 2446, 2826, 3089]",7254,7397,6878,3497,3089,-638,-536,-2347,-478,-79,-4078,15,dire
7627936702,94,137,13,66,86,"[0, 180, 529, 667, 1197, 1563, 1978, 2454, 2962, 3555, 4321, 4809, 5641, 6490, 6755]","[0, 209, 563, 896, 1456, 1795, 2152, 2527, 2669, 3108, 3529, 4056, 4217, 4546, 4716]","[0, 164, 356, 568, 905, 1114, 1369, 1581, 1671, 1945, 2399, 2843, 3189, 3443, 3761]","[0, 90, 242, 399, 570, 678, 925, 1222, 1390, 1540, 1968, 2298, 2563, 2862, 3057]","[0, 129, 244, 334, 584, 674, 764, 973, 1063, 1372, 1462, 1644, 1866, 2044, 2264]",6755,4716,3761,3057,2264,18,120,96,9,112,"[59, 347, 869, 1282, 1650, 2055, 2379, 2909, 3886, 4526, 5209, 6597, 7385, 8347, 9843]","[59, 436, 758, 1436, 1923, 2409, 2941, 3403, 3950, 4576, 5075, 5710, 6684, 7260, 8202]","[59, 380, 582, 1047, 1533, 1934, 2418, 2970, 3525, 4151, 4951, 5616, 6437, 7655, 8270]","[427, 722, 914, 1243, 1541, 1661, 1958, 2157, 2546, 3026, 3415, 3834, 4195, 4721, 5123]","[59, 309, 587, 725, 941, 1046, 1176, 1357, 1692, 1887, 2349, 2595, 3004, 3506, 3962]",9843,8202,8270,5123,3962,-3088,-3486,-4509,-2066,-1698,-14847,15,dire
7628014111,120,41,29,53,121,"[325, 682, 1010, 1348, 1632, 2328, 3264, 3839, 4222, 4636, 5449, 5895, 6228, 7350, 7900]","[121, 401, 635, 814, 1267, 1818, 2346, 2754, 3288, 3710, 4171, 4509, 4846, 5444, 6758]","[121, 447, 782, 1088, 1440, 2117, 2535, 3139, 3890, 4637, 4900, 5608, 6275, 6653, 7014]","[254, 463, 553, 643, 766, 979, 1069, 1271, 1528, 1815, 2339, 2542, 2708, 3394, 3832]","[121, 380, 516, 643, 867, 1217, 1353, 1704, 2139, 2567, 2867, 3101, 3544, 3922, 4107]",7900,6758,7014,3832,4107,70,106,129,105,21,"[75, 239, 526, 927, 1208, 1659, 2174, 3038, 3264, 3828, 4311, 4852, 5114, 5629, 6164]","[208, 374, 590, 770, 1023, 1227, 1394, 1928, 2242, 2658, 3128, 3342, 3962, 4331, 4696]","[75, 239, 759, 1140, 1442, 1676, 1972, 2497, 2831, 3254, 3757, 3939, 4392, 4761, 5176]","[75, 204, 294, 429, 602, 774, 875, 1506, 1998, 2134, 2501, 2726, 2816, 3663, 4014]","[75, 204, 382, 472, 602, 692, 870, 1173, 1439, 1529, 1757, 2006, 2115, 2570, 2919]",6164,4696,5176,4014,2919,1736,2062,1838,-182,1188,6642,15,radiant
7628030316,95,98,106,53,86,"[0, 194, 469, 825, 1227, 1391, 1652, 2069, 2496, 2947, 3302, 3683, 4348, 5168, 5635]","[0, 265, 473, 1030, 1353, 1992, 2396, 2900, 3432, 3853, 4204, 4953, 5455, 6085, 6883]","[0, 271, 526, 776, 1234, 1644, 2099, 2585, 3036, 3776, 4075, 4330, 4826, 5489, 5940]","[0, 194, 284, 418, 508, 641, 731, 953, 1043, 1433, 1534, 1668, 2073, 2337, 2531]","[0, 242, 332, 455, 639, 904, 994, 1216, 1306, 1396, 1544, 1704, 1848, 2195, 2388]",5635,6883,5940,2531,2388,54,129,47,123,105,"[0, 169, 671, 922, 1286, 1450, 1904, 2240, 2577, 3137, 3663, 4259, 4769, 5624, 6007]","[0, 250, 584, 887, 1329, 1624, 1871, 2345, 2711, 2972, 3377, 3729, 4187, 4455, 4780]","[0, 249, 412, 643, 1135, 1532, 1817, 2202, 2565, 2950, 3123, 3881, 4292, 4724, 5070]","[0, 169, 309, 480, 650, 1005, 1095, 1568, 1702, 2197, 2332, 2553, 2757, 3071, 3348]","[0, 169, 330, 499, 728, 818, 991, 1291, 1381, 1775, 2037, 2316, 2797, 3368, 3549]",6007,4780,5070,3348,3549,-372,2103,870,-817,-1161,623,15,radiant
7628117703,48,22,129,45,79,"[0, 300, 545, 859, 1181, 1522, 1898, 2107, 2302, 2649, 2999, 3641, 4143, 4776, 5337]","[0, 573, 911, 1281, 1601, 1926, 2618, 3205, 3587, 3973, 4106, 4534, 5054, 5666, 5887]","[0, 226, 462, 874, 1170, 1451, 1659, 1868, 2452, 2790, 3126, 3471, 3561, 3957, 4103]","[0, 190, 280, 445, 582, 690, 869, 1107, 1197, 1373, 1463, 1610, 1898, 2648, 2743]","[0, 190, 280, 446, 552, 688, 908, 1043, 1180, 1362, 1719, 2136, 2357, 2452, 2547]",5337,5887,4103,2743,2547,54,96,107,138,9,"[0, 247, 597, 1048, 1370, 1788, 2168, 2648, 2924, 3367, 4278, 4826, 5367, 6237, 6848]","[0, 210, 478, 752, 1206, 1871, 2238, 2738, 3570, 4032, 4439, 4796, 5626, 6260, 6565]","[0, 249, 535, 846, 1137, 1507, 1962, 2492, 2949, 3679, 4204, 4818, 5289, 5894, 6152]","[0, 212, 352, 442, 646, 1045, 1214, 1574, 1972, 2407, 2878, 3541, 3862, 4595, 5218]","[0, 212, 302, 652, 806, 957, 1047, 1519, 1746, 2042, 2459, 2747, 3156, 4194, 4442]",6848,6565,6152,5218,4442,-1511,-678,-2049,-2475,-1895,-8608,15,dire
7629210704,123,12,100,47,121,"[0, 235, 524, 878, 1048, 1392, 1741, 2157, 2596, 2936, 3506, 4116, 4555, 4863, 5596]","[0, 167, 419, 803, 1478, 1765, 2228, 2777, 3162, 3721, 4468, 4945, 5519, 6197, 7179]","[0, 200, 290, 492, 582, 936, 1026, 1244, 1750, 2418, 2972, 3554, 3766, 4331, 4664]","[0, 200, 399, 707, 995, 1843, 2088, 2619, 2852, 3179, 3619, 3972, 4569, 5138, 5476]","[0, 468, 645, 800, 1336, 1426, 2007, 2181, 2321, 2775, 3345, 3610, 3968, 4117, 4452]",5596,7179,4664,5476,4452,129,49,13,58,109,"[0, 444, 875, 1273, 1756, 1966, 2415, 2874, 3546, 3877, 4687, 5162, 5342, 6183, 6781]","[0, 209, 550, 862, 1157, 1617, 2145, 2647, 3007, 3378, 4001, 4127, 4906, 5395, 5746]","[0, 319, 712, 1056, 1594, 2048, 2416, 2749, 3377, 4033, 4357, 4845, 5270, 5664, 6171]","[100, 414, 539, 629, 823, 957, 1093, 1284, 1628, 1962, 2169, 2583, 3084, 3365, 3545]","[0, 276, 401, 696, 873, 1037, 1229, 1329, 1797, 1931, 2101, 2323, 2623, 3433, 3639]",6781,5746,6171,3545,3639,-1185,1433,-1507,1931,813,1485,15,dire
7629309712,18,65,47,79,19,"[0, 275, 645, 780, 1025, 1309, 1803, 2140, 2593, 3308, 3797, 4508, 5191, 5804, 6996]","[0, 275, 546, 883, 1164, 1492, 2044, 2441, 3122, 3787, 4259, 4713, 5144, 5563, 6123]","[0, 170, 397, 691, 922, 1202, 1666, 2053, 2247, 2827, 3210, 3671, 3977, 4363, 4971]","[0, 170, 325, 454, 562, 699, 836, 971, 1061, 1358, 1724, 1869, 2292, 2694, 3483]","[0, 170, 285, 421, 556, 706, 796, 1017, 1107, 1619, 1754, 2057, 2147, 2385, 2719]",6996,6123,4971,3483,2719,95,25,23,9,105,"[0, 619, 929, 1255, 1525, 1936, 2217, 2538, 3062, 3445, 4007, 4483, 4976, 5808, 6265]","[0, 320, 563, 857, 1096, 1716, 2133, 2681, 3277, 3449, 3959, 4515, 5217, 5767, 6489]","[0, 170, 323, 572, 815, 1169, 1469, 1840, 2368, 2477, 2861, 3281, 4005, 4382, 4774]","[0, 235, 421, 511, 644, 883, 1095, 1251, 1769, 1955, 2077, 2221, 2482, 3089, 3526]","[0, 235, 325, 676, 766, 942, 1032, 1122, 1379, 1868, 2085, 2229, 2354, 2753, 2923]",6265,6489,4774,3526,2923,731,-366,197,-43,-204,315,15,radiant
7629815312,46,96,126,110,105,"[0, 299, 667, 1076, 1406, 1801, 2239, 2764, 3197, 3637, 4327, 4946, 5638, 6280, 6887]","[0, 372, 643, 1337, 1610, 2168, 2646, 2813, 3276, 3647, 4103, 4545, 5504, 5915, 6497]","[0, 400, 866, 1241, 1582, 1945, 2373, 2665, 3231, 3746, 4281, 4453, 4939, 5426, 5863]","[0, 250, 340, 512, 855, 945, 1240, 1330, 1420, 1709, 1940, 2157, 2617, 2883, 3470]","[0, 250, 340, 506, 616, 771, 861, 1240, 1426, 1669, 1901, 1991, 2253, 2516, 2744]",6887,6497,5863,3470,2744,10,135,13,58,79,"[0, 127, 413, 736, 1246, 1725, 2054, 2731, 3126, 3636, 4343, 5050, 6373, 7177, 7918]","[0, 176, 510, 800, 1176, 1679, 1978, 2738, 3042, 3610, 3984, 4699, 5557, 6031, 7042]","[0, 251, 491, 962, 1335, 1655, 2284, 2672, 3178, 3356, 3674, 4186, 4552, 5288, 6254]","[0, 90, 180, 274, 404, 534, 780, 1294, 1389, 1816, 2083, 2629, 3116, 3419, 3829]","[0, 90, 180, 270, 400, 742, 832, 1221, 1311, 1451, 1646, 2088, 2813, 3052, 3363]",7918,7042,6254,3829,3363,-1031,-545,-391,-359,-619,-2945,15,dire
7629875506,76,78,41,65,20,"[0, 287, 503, 667, 976, 1378, 1865, 2339, 2821, 3271, 3651, 3741, 4120, 4469, 4942]","[0, 251, 886, 1120, 1410, 1611, 2088, 2212, 2862, 3375, 3947, 4412, 4858, 5257, 5817]","[0, 283, 449, 725, 1000, 1280, 1527, 1732, 1971, 2442, 2714, 2899, 3480, 3821, 4254]","[0, 170, 333, 423, 559, 660, 1355, 1445, 1794, 2114, 2305, 2576, 2845, 3435, 3886]","[0, 170, 304, 515, 605, 695, 913, 1244, 1334, 1529, 1665, 1886, 2248, 2928, 3057]",4942,5817,4254,3886,3057,48,22,98,5,21,"[0, 170, 473, 706, 866, 1302, 1774, 2086, 2389, 2891, 3199, 3742, 4356, 4698, 5368]","[0, 322, 650, 897, 1360, 1904, 2283, 2696, 3663, 4233, 4794, 5865, 6463, 7328, 7936]","[0, 208, 537, 904, 1308, 1743, 2167, 2494, 2858, 3479, 4068, 4590, 5078, 5927, 6562]","[0, 170, 310, 619, 886, 1024, 1286, 1530, 1736, 1951, 2086, 2739, 3032, 3630, 3879]","[0, 170, 260, 398, 609, 843, 1080, 1170, 1387, 1566, 1777, 2279, 2523, 2725, 2938]",5368,7936,6562,3879,2938,-426,-2119,-2308,7,119,-4727,15,dire
7629969007,39,18,98,119,20,"[0, 327, 655, 1068, 1912, 2330, 2761, 3548, 4082, 4627, 5425, 5894, 6336, 7337, 8355]","[0, 321, 523, 851, 981, 1276, 1653, 2128, 2661, 3028, 3517, 4016, 4496, 5133, 5924]","[0, 295, 547, 808, 1232, 1407, 1617, 1707, 1937, 2027, 2586, 2748, 3490, 3665, 4347]","[0, 170, 299, 436, 629, 753, 1081, 1248, 1478, 1568, 1748, 1838, 2228, 2483, 2883]","[0, 170, 260, 395, 525, 662, 867, 1001, 1252, 1342, 1613, 1872, 2038, 2251, 2704]",8355,5924,4347,2883,2704,48,60,74,21,5,"[0, 242, 559, 850, 1180, 1425, 1728, 2108, 2459, 2834, 3455, 4674, 5256, 5942, 6503]","[0, 206, 448, 731, 1191, 1392, 1801, 2154, 2871, 3049, 3975, 4298, 5276, 5873, 6405]","[0, 282, 495, 622, 952, 1206, 1426, 1516, 1606, 1915, 2130, 2347, 2977, 3623, 4037]","[0, 170, 303, 393, 899, 1333, 1698, 2440, 3082, 3363, 3818, 4324, 4506, 4996, 5340]","[0, 170, 260, 367, 559, 993, 1175, 1677, 1961, 2734, 2914, 3263, 3400, 3785, 3880]",6503,6405,4037,5340,3880,1852,-481,310,-2457,-1176,-1952,15,dire
7630006507,54,69,106,79,5,"[0, 205, 717, 1082, 1557, 1789, 2338, 3048, 3440, 3885, 4288, 4950, 5750, 6418, 6814]","[0, 275, 597, 842, 1561, 1852, 2468, 2835, 3249, 3795, 4383, 4980, 5660, 6243, 6905]","[0, 295, 661, 1000, 1326, 1735, 2268, 2557, 3056, 3146, 3685, 3946, 4210, 4698, 4792]","[0, 213, 527, 617, 854, 944, 1386, 1476, 1809, 1899, 1989, 2219, 2527, 2704, 3141]","[0, 169, 382, 472, 647, 737, 930, 1133, 1223, 1362, 1452, 1633, 1960, 2231, 2487]",6814,6905,4792,3141,2487,113,13,23,62,21,"[0, 207, 513, 865, 1225, 1518, 1906, 2451, 2763, 3399, 4001, 4352, 4876, 5415, 6168]","[0, 257, 513, 880, 1293, 1713, 2063, 2558, 3163, 3873, 4391, 4815, 5426, 5830, 6482]","[0, 169, 549, 888, 1337, 1873, 2081, 2393, 2847, 3022, 3338, 4002, 4615, 5043, 5683]","[0, 169, 660, 792, 1228, 1758, 1905, 2090, 2225, 2496, 2676, 2766, 3047, 3188, 3640]","[0, 169, 360, 693, 943, 1033, 1482, 1827, 1962, 2374, 2652, 2776, 3029, 3234, 3860]",6168,6482,5683,3640,3860,646,423,-891,-499,-1373,-1694,15,dire
7630218506,18,74,61,52,91,"[0, 256, 629, 929, 1295, 1585, 1986, 2392, 2873, 3179, 3954, 4424, 4909, 5662, 6407]","[0, 209, 569, 901, 1180, 1396, 1679, 2058, 2573, 3208, 3691, 4073, 4389, 4839, 5078]","[0, 245, 511, 674, 1070, 1424, 1682, 2164, 2336, 2655, 3162, 4164, 4689, 5266, 5991]","[0, 170, 260, 350, 460, 595, 705, 1041, 1300, 1390, 1695, 2023, 2728, 3171, 3371]","[0, 170, 260, 350, 574, 746, 910, 1246, 1422, 1759, 1983, 2196, 2522, 2815, 3142]",6407,5078,5991,3371,3142,21,2,56,79,100,"[0, 332, 691, 1146, 1564, 1935, 2256, 2692, 2991, 3576, 4004, 4671, 4928, 5415, 5977]","[0, 240, 624, 934, 1274, 1527, 1730, 2481, 3134, 3586, 4292, 4852, 5520, 5877, 6188]","[0, 170, 404, 656, 873, 1605, 1817, 2252, 2540, 3068, 3659, 3803, 4245, 4700, 5111]","[0, 170, 336, 426, 565, 720, 847, 1135, 1353, 1845, 2070, 2523, 2757, 3135, 3343]","[0, 170, 298, 435, 525, 685, 832, 1060, 1198, 1473, 1828, 1981, 2161, 2291, 2499]",5977,6188,5111,3343,2499,430,-1110,880,28,643,871,15,dire
7630324414,89,23,22,121,33,"[0, 291, 602, 840, 1335, 1617, 1955, 2364, 2567, 2822, 3232, 3577, 4033, 4430, 5067]","[0, 239, 502, 742, 959, 1210, 1618, 1843, 2014, 2327, 2629, 2719, 2858, 3224, 3616]","[0, 216, 391, 550, 691, 855, 945, 1202, 1338, 1428, 1638, 1796, 1886, 2040, 2189]","[0, 170, 367, 457, 547, 687, 823, 962, 1052, 1159, 1249, 1339, 1429, 1583, 1732]","[0, 170, 260, 350, 440, 530, 620, 886, 1066, 1156, 1246, 1336, 1426, 1605, 1754]",5067,3616,2189,1732,1754,46,41,2,25,26,"[0, 249, 659, 1402, 2009, 2455, 3177, 3992, 4625, 5795, 6666, 7368, 8273, 9342, 9943]","[0, 241, 544, 748, 1095, 1342, 1749, 2140, 2758, 3429, 3822, 4321, 4803, 5527, 5926]","[0, 170, 437, 806, 1300, 1657, 2212, 2633, 3187, 3547, 4136, 4673, 5124, 5660, 6180]","[0, 184, 274, 401, 590, 726, 982, 1125, 1343, 1793, 2086, 2364, 2607, 2846, 2982]","[0, 170, 310, 555, 685, 775, 1033, 1204, 1585, 1941, 2121, 2511, 2647, 2855, 3193]",9943,5926,6180,2982,3193,-4876,-2310,-3991,-1250,-1439,-13866,15,dire
7630340902,113,109,49,84,57,"[0, 205, 605, 936, 1234, 1460, 1630, 1833, 2109, 2688, 3137, 3227, 3912, 4427, 4536]","[0, 249, 522, 648, 934, 1101, 1344, 1788, 1976, 2501, 2963, 3303, 4153, 4560, 4708]","[0, 202, 465, 745, 1108, 1362, 1782, 1947, 2227, 2528, 2703, 3125, 3455, 3604, 3699]","[0, 129, 258, 396, 532, 622, 843, 1016, 1154, 1380, 1470, 1560, 1650, 1889, 1984]","[0, 129, 325, 430, 565, 655, 833, 923, 1013, 1344, 1434, 1573, 1800, 1949, 2078]",4536,4708,3699,1984,2078,41,74,81,26,20,"[0, 245, 483, 681, 1042, 1416, 1580, 1982, 2343, 2884, 3422, 3993, 4406, 4963, 5292]","[331, 663, 944, 1312, 1537, 1834, 2182, 2652, 3056, 3448, 4063, 4806, 5220, 5869, 6425]","[63, 307, 508, 949, 1079, 1670, 2080, 2329, 2627, 2796, 3421, 4248, 4625, 4720, 5360]","[63, 375, 465, 599, 695, 879, 1013, 1103, 1193, 1362, 1728, 2026, 2245, 2568, 2834]","[63, 272, 362, 452, 542, 891, 981, 1140, 1275, 1492, 1771, 2074, 2182, 2614, 2830]",5292,6425,5360,2834,2830,-756,-1717,-1661,-850,-752,-5736,15,dire
7630469716,18,13,31,96,26,"[0, 584, 817, 1308, 1509, 1836, 2374, 2770, 3059, 3840, 4527, 5100, 6056, 6764, 7479]","[0, 287, 567, 823, 965, 1370, 1684, 2013, 2435, 3145, 3723, 3948, 4740, 5349, 6495]","[0, 234, 324, 414, 550, 658, 831, 1061, 1391, 1740, 1972, 2584, 2835, 3187, 3541]","[0, 346, 484, 689, 1190, 1350, 1640, 2184, 2508, 2750, 3248, 3510, 3808, 4075, 4506]","[0, 234, 324, 626, 831, 970, 1105, 1240, 1330, 1677, 1856, 2081, 2368, 2808, 3206]",7479,6495,3541,4506,3206,52,44,137,121,20,"[0, 209, 582, 767, 1139, 1433, 1969, 2402, 3014, 3318, 3614, 4100, 4357, 4613, 4949]","[0, 170, 481, 1218, 1508, 1818, 2152, 2433, 2963, 3391, 3837, 4465, 4811, 5729, 6167]","[0, 206, 405, 572, 815, 941, 1215, 1563, 2069, 2192, 2370, 2551, 3083, 3225, 3854]","[0, 270, 360, 560, 650, 740, 830, 1010, 1406, 1496, 1679, 1833, 2063, 2292, 2386]","[0, 170, 260, 518, 608, 709, 799, 993, 1228, 1414, 1525, 1654, 2064, 2159, 2253]",4949,6167,3854,2386,2253,2530,328,-313,2120,953,5618,15,dire
7630544602,56,29,126,37,123,"[0, 240, 852, 1184, 1458, 1818, 2047, 2421, 2585, 3064, 3665, 4204, 4410, 5307, 5823]","[0, 246, 565, 797, 1006, 1578, 1973, 2345, 2737, 3305, 3902, 4578, 5037, 5552, 6043]","[0, 257, 527, 865, 1325, 1771, 2233, 2670, 3035, 3290, 3784, 4744, 5138, 5820, 6383]","[0, 169, 406, 521, 646, 871, 1036, 1259, 1349, 1544, 1797, 2516, 2739, 3362, 3766]","[0, 221, 311, 448, 573, 727, 945, 1170, 1305, 1819, 2032, 2612, 2834, 3291, 3431]",5823,6043,6383,3766,3431,44,69,22,19,109,"[0, 208, 535, 697, 1306, 1622, 1932, 2396, 2960, 3145, 3616, 3792, 4389, 4759, 5238]","[0, 207, 481, 811, 1111, 1353, 1518, 1897, 2564, 2974, 3384, 3597, 4051, 4416, 4944]","[0, 257, 575, 987, 1326, 1753, 2049, 2895, 3333, 4040, 4830, 5178, 5529, 6043, 6791]","[0, 169, 262, 372, 462, 659, 783, 1170, 1364, 1684, 1990, 2358, 2592, 2871, 3179]","[0, 169, 259, 437, 613, 743, 1132, 1387, 1709, 1921, 2270, 2728, 2957, 3236, 3774]",5238,4944,6791,3179,3774,585,1099,-408,587,-343,1520,15,radiant
7630871702,41,97,13,9,79,"[0, 287, 533, 975, 1232, 1430, 1848, 2129, 2527, 2827, 3374, 3718, 4194, 4656, 4784]","[0, 198, 480, 738, 1109, 1436, 1919, 2363, 2863, 3454, 4069, 4551, 5344, 5684, 6075]","[0, 216, 378, 704, 1069, 1360, 1640, 1915, 2207, 2724, 3104, 3551, 3743, 4362, 4745]","[0, 130, 255, 345, 687, 827, 961, 1338, 1428, 1650, 1828, 1985, 2120, 2534, 2923]","[0, 130, 220, 398, 573, 782, 1005, 1095, 1315, 1513, 1691, 1872, 2187, 2436, 2530]",4784,6075,4745,2923,2530,1,52,135,45,138,"[0, 277, 597, 925, 1405, 1650, 1929, 2634, 2964, 3425, 4171, 4614, 5133, 5699, 6457]","[0, 397, 764, 1127, 1576, 1794, 2298, 2938, 3457, 3668, 4341, 5082, 5721, 6166, 6889]","[0, 277, 442, 696, 990, 1363, 1488, 1989, 2398, 2763, 3598, 4014, 4734, 5047, 5416]","[0, 545, 635, 725, 855, 945, 1035, 1260, 1350, 1440, 1737, 2002, 2549, 2644, 2922]","[0, 277, 367, 595, 770, 860, 950, 1470, 1560, 1662, 2236, 2425, 2650, 2923, 3193]",6457,6889,5416,2922,3193,-1673,-814,-671,1,-663,-3820,15,dire
7631006203,73,114,56,123,64,"[0, 414, 878, 1473, 1977, 2157, 2695, 3159, 3672, 4132, 4887, 5451, 6203, 8408, 9476]","[0, 367, 632, 1040, 1517, 1980, 2355, 3300, 3672, 4493, 4889, 5467, 6554, 7170, 7428]","[0, 280, 571, 892, 1232, 1476, 1847, 2423, 2684, 3418, 4186, 4542, 4962, 5513, 5868]","[0, 210, 407, 611, 976, 1066, 1156, 1617, 1887, 2176, 2356, 2585, 3059, 3604, 4109]","[0, 253, 668, 758, 1046, 1254, 1390, 1615, 1705, 2053, 2395, 2653, 2780, 3079, 3367]",9476,7428,5868,4109,3367,25,69,135,65,71,"[0, 130, 417, 694, 975, 1575, 2016, 2303, 2965, 3155, 3537, 4050, 4477, 5217, 5516]","[0, 203, 376, 688, 1140, 1675, 2051, 2440, 2895, 3420, 3629, 4134, 4552, 5260, 6026]","[0, 168, 380, 598, 799, 1389, 1832, 1995, 2176, 2554, 2775, 2865, 3530, 4486, 4749]","[0, 130, 220, 310, 488, 775, 1219, 1828, 1963, 2053, 2452, 3015, 3234, 3975, 4404]","[0, 130, 220, 354, 867, 1104, 1291, 1507, 1807, 2111, 2368, 2576, 2880, 3860, 4373]",5516,6026,4749,4404,4373,3960,1402,1119,-295,-1006,5180,15,radiant
7631360009,25,96,126,5,72,"[0, 313, 767, 1020, 1547, 2036, 2596, 2875, 3087, 3340, 3945, 4991, 6205, 7060, 8469]","[0, 215, 538, 901, 1439, 1808, 2363, 2832, 3350, 3881, 4360, 4829, 5442, 6102, 6475]","[0, 357, 573, 949, 1389, 2019, 2590, 2970, 3842, 4634, 5212, 5696, 6289, 7039, 7705]","[0, 235, 393, 522, 739, 869, 999, 1227, 1602, 1766, 2076, 2211, 2684, 3049, 3689]","[0, 503, 608, 715, 873, 1082, 1453, 1775, 1997, 2366, 2786, 3012, 3589, 4220, 4510]",8469,6475,7705,3689,4510,10,98,90,86,83,"[0, 204, 469, 673, 976, 1298, 1630, 2039, 2411, 2777, 3073, 3653, 4374, 4771, 5334]","[0, 241, 515, 832, 1084, 1309, 1486, 2160, 2738, 3347, 3824, 4433, 5575, 6026, 6597]","[0, 282, 604, 953, 1121, 1432, 1753, 2075, 2165, 2873, 3473, 3914, 4538, 4850, 5351]","[0, 170, 260, 510, 874, 1071, 1397, 1701, 1916, 2256, 2391, 2865, 3096, 3642, 3772]","[0, 170, 275, 446, 619, 840, 930, 1399, 1614, 1793, 1928, 2215, 2457, 2605, 2737]",5334,6597,5351,3772,2737,3135,-122,2354,-83,1773,7057,15,radiant
7631440012,53,23,38,65,9,"[0, 257, 516, 898, 1336, 1568, 2014, 2432, 2603, 3163, 3437, 4086, 4561, 5391, 6479]","[0, 333, 643, 967, 1459, 1870, 2287, 2470, 2771, 3411, 3826, 4150, 4955, 5434, 5957]","[0, 296, 445, 750, 1211, 1576, 1858, 2228, 2480, 3004, 3427, 3988, 4412, 5072, 5506]","[0, 553, 668, 758, 940, 1049, 1264, 1399, 1489, 1817, 2159, 2285, 2772, 2942, 3315]","[0, 285, 459, 637, 874, 1226, 1568, 2013, 2103, 2273, 2515, 2605, 2889, 3104, 3368]",6479,5957,5506,3315,3368,18,15,137,19,121,"[0, 205, 697, 863, 1151, 1661, 2172, 2664, 3394, 3737, 4510, 5189, 6013, 7579, 8232]","[0, 209, 530, 792, 956, 1540, 2027, 2282, 2823, 3305, 3749, 3962, 4539, 4891, 5300]","[0, 298, 733, 990, 1365, 1650, 2307, 2823, 3550, 3865, 4414, 5353, 5908, 6325, 6854]","[0, 170, 306, 396, 519, 751, 1063, 1198, 1943, 2033, 2537, 2855, 2945, 3715, 4176]","[0, 170, 421, 562, 680, 810, 1063, 1486, 1722, 1857, 2158, 2570, 3090, 3768, 3958]",8232,5300,6854,4176,3958,-1753,657,-1348,-861,-590,-3895,15,dire
7631492612,89,15,49,79,105,"[60, 267, 593, 1026, 1430, 1849, 2168, 2586, 3071, 3567, 4217, 4976, 5301, 5825, 6776]","[60, 226, 458, 1000, 1230, 1867, 2355, 2626, 3044, 3730, 4301, 5054, 5617, 6369, 7026]","[60, 264, 515, 789, 1197, 1602, 2033, 2533, 3102, 3615, 4293, 4907, 5522, 6286, 6822]","[328, 458, 565, 808, 938, 1195, 1394, 2104, 2239, 2418, 2843, 3077, 3168, 3519, 3841]","[60, 190, 329, 419, 567, 840, 1101, 1191, 1326, 1597, 1927, 2188, 2286, 2537, 2842]",6776,7026,6822,3841,2842,72,17,129,9,5,"[0, 297, 460, 1005, 1449, 1761, 2182, 2607, 2985, 3456, 4403, 4934, 5559, 6119, 6923]","[2, 367, 815, 1026, 1409, 1693, 2083, 2506, 3062, 3435, 3765, 4197, 4668, 5232, 5663]","[0, 289, 529, 816, 1157, 1574, 1961, 2471, 2919, 3359, 3855, 4066, 4401, 4941, 5262]","[0, 216, 312, 438, 528, 793, 1130, 1360, 1450, 1588, 1858, 2007, 2469, 2942, 3153]","[0, 210, 300, 578, 821, 1108, 1276, 1711, 1801, 1903, 2139, 2366, 2656, 2805, 3018]",6923,5663,5262,3153,3018,-147,1363,1560,688,-176,3288,15,radiant
7631686902,35,2,41,86,111,"[0, 288, 562, 975, 1391, 1776, 1911, 2298, 2425, 2764, 3187, 3790, 4638, 5555, 6006]","[0, 246, 528, 855, 1137, 1766, 2035, 2510, 2901, 3249, 3806, 4271, 4942, 5437, 5854]","[0, 317, 478, 804, 968, 1296, 1657, 1827, 1962, 2180, 2677, 3391, 3638, 4159, 4679]","[0, 210, 300, 486, 622, 760, 913, 1179, 1269, 2091, 2455, 2748, 3293, 3540, 4037]","[0, 210, 300, 438, 528, 726, 861, 1078, 1445, 1959, 2133, 2267, 2712, 2908, 3291]",6006,5854,4679,4037,3291,46,25,43,71,50,"[0, 249, 563, 1019, 1233, 1614, 2000, 2414, 2953, 3599, 4431, 5046, 5536, 6479, 7165]","[0, 253, 553, 1002, 1457, 1726, 2156, 2698, 3023, 3607, 3965, 4736, 5300, 6256, 6956]","[0, 215, 579, 866, 1316, 1769, 2184, 2585, 2961, 3498, 4571, 5064, 5664, 5978, 6504]","[0, 130, 220, 345, 435, 525, 874, 1035, 1207, 1548, 1992, 2089, 2179, 2631, 2779]","[0, 130, 571, 665, 755, 892, 1065, 1202, 1339, 1519, 1789, 1977, 2067, 2298, 2446]",7165,6956,6504,2779,2446,-1159,-1102,-1825,1258,845,-1983,15,radiant
7631800401,52,55,41,65,79,"[0, 251, 536, 867, 1124, 1416, 1833, 2164, 3074, 3356, 3589, 4273, 4699, 5708, 5998]","[0, 246, 607, 852, 1216, 1583, 2112, 2402, 2962, 3458, 3593, 4241, 4604, 5072, 5399]","[0, 170, 477, 799, 1041, 1303, 1546, 1922, 2087, 2401, 2873, 3380, 3810, 4426, 4702]","[0, 170, 260, 416, 550, 719, 989, 1124, 1492, 1842, 2078, 2503, 2775, 3430, 3626]","[0, 217, 307, 448, 582, 737, 1156, 1477, 2015, 2435, 2616, 2796, 3184, 3621, 3848]",5998,5399,4702,3626,3848,25,18,129,5,110,"[0, 360, 715, 967, 1743, 2118, 2541, 3189, 3781, 4687, 5257, 5869, 6480, 7203, 8269]","[0, 273, 479, 926, 1204, 1646, 1902, 2309, 2853, 3488, 3984, 4730, 5117, 5744, 6241]","[0, 252, 562, 805, 1172, 1711, 2171, 2610, 3016, 3732, 3867, 4256, 4998, 5516, 6428]","[0, 170, 310, 446, 576, 767, 935, 1481, 1634, 2093, 2354, 2909, 3158, 3307, 4264]","[0, 170, 260, 350, 480, 659, 1033, 1168, 1258, 1584, 1855, 1989, 2200, 2553, 3014]",8269,6241,6428,4264,3014,-2271,-842,-1726,-638,834,-4643,15,dire
7632006113,18,52,33,3,19,"[0, 242, 506, 908, 1161, 1488, 1656, 1879, 2279, 2874, 3370, 3886, 4674, 5435, 5868]","[0, 331, 626, 1031, 1482, 1904, 2315, 2657, 2901, 4162, 4731, 5155, 5516, 5786, 6304]","[0, 288, 566, 973, 1577, 1856, 2519, 3019, 3153, 4027, 4657, 5263, 5447, 5966, 6402]","[0, 170, 260, 350, 504, 629, 764, 876, 1208, 1636, 2156, 2585, 2696, 2857, 3140]","[0, 170, 260, 394, 642, 816, 1083, 1268, 1358, 1943, 2168, 2627, 2717, 2878, 3025]",5868,6304,6402,3140,3025,82,54,49,121,109,"[0, 316, 685, 1060, 1723, 2028, 2615, 3054, 3874, 4528, 4899, 5680, 6566, 7475, 8132]","[0, 242, 537, 860, 1227, 1543, 2166, 2517, 2860, 3284, 3740, 3940, 4560, 5103, 5680]","[0, 242, 479, 884, 1207, 1620, 1831, 2096, 2566, 2816, 3145, 3480, 4019, 4658, 5127]","[0, 170, 311, 565, 788, 962, 1147, 1282, 1645, 1735, 2057, 2147, 2311, 2584, 2878]","[0, 170, 305, 395, 604, 743, 873, 1032, 1222, 1583, 1673, 1763, 1900, 2207, 2337]",8132,5680,5127,2878,2337,-2264,624,1275,262,688,585,15,radiant
7632105811,126,15,43,21,100,"[0, 289, 523, 745, 1145, 1402, 1769, 2245, 2943, 3344, 3653, 4050, 4537, 5519, 6194]","[0, 208, 473, 816, 1446, 2016, 2572, 3208, 3584, 4227, 4809, 5286, 5857, 6242, 7125]","[0, 416, 751, 1257, 1434, 1921, 2353, 2863, 3373, 3906, 4426, 4806, 5662, 6164, 6815]","[0, 244, 334, 505, 595, 732, 1097, 1425, 1641, 1788, 2143, 2561, 2771, 3437, 3803]","[100, 270, 395, 529, 691, 901, 1071, 1347, 1481, 1652, 1845, 2196, 2502, 2910, 3193]",6194,7125,6815,3803,3193,25,52,96,90,5,"[62, 388, 542, 869, 1130, 1258, 1504, 2179, 2651, 3075, 3661, 4245, 4588, 5131, 5686]","[330, 623, 978, 1272, 1644, 2053, 2505, 2640, 3191, 3519, 4117, 5287, 5743, 6240, 6849]","[62, 232, 622, 855, 1450, 1586, 1710, 1845, 2157, 2445, 2625, 2760, 3328, 3681, 3922]","[162, 332, 447, 584, 847, 937, 1108, 1243, 1333, 1423, 1656, 1887, 2138, 2527, 2806]","[62, 232, 347, 482, 572, 662, 786, 1145, 1235, 1325, 1544, 1756, 2007, 2323, 2554]",5686,6849,3922,2806,2554,508,276,2893,997,639,5313,15,dire
7632110508,48,128,38,86,112,"[335, 650, 1101, 1394, 1521, 1884, 2009, 2508, 2816, 3182, 3829, 3977, 4966, 5639, 6157]","[0, 313, 602, 941, 1401, 2025, 2427, 2852, 3513, 4258, 4870, 5336, 6455, 7243, 7676]","[0, 307, 543, 669, 969, 1266, 1689, 2057, 2617, 2949, 3457, 3849, 4370, 5122, 5783]","[67, 262, 384, 474, 614, 811, 901, 991, 1432, 1921, 2179, 2437, 2664, 3023, 3118]","[67, 262, 423, 559, 687, 881, 971, 1106, 1382, 1895, 2121, 2295, 2575, 2813, 2908]",6157,7676,5783,3118,2908,82,98,126,58,110,"[0, 241, 544, 828, 1039, 1256, 1875, 2319, 2480, 2871, 3402, 3983, 4559, 5162, 5823]","[0, 266, 390, 707, 952, 1440, 2095, 2456, 2877, 3426, 4172, 4719, 5447, 6094, 6344]","[0, 264, 539, 856, 1097, 1559, 2354, 2739, 2878, 3247, 3640, 4121, 4538, 4860, 5406]","[0, 298, 388, 528, 701, 1141, 1495, 1665, 1871, 2043, 2445, 2562, 2908, 3462, 3808]","[0, 195, 285, 375, 465, 555, 756, 913, 1003, 1261, 1660, 1970, 2406, 2554, 2804]",5823,6344,5406,3808,2804,334,1332,377,-690,104,1457,15,radiant
7632217207,73,97,77,86,121,"[0, 395, 735, 1165, 1548, 1845, 2062, 2423, 2991, 3684, 4655, 5235, 5599, 6027, 6507]","[0, 359, 609, 1152, 1721, 2121, 3040, 3578, 4339, 4851, 5198, 5878, 6563, 7056, 7735]","[0, 205, 478, 757, 927, 1326, 1766, 2044, 2327, 2971, 3388, 3543, 4167, 5013, 5449]","[0, 504, 809, 1022, 1192, 1357, 1955, 2090, 2228, 2508, 2771, 3024, 3366, 3552, 3824]","[0, 236, 393, 793, 963, 1128, 1365, 1865, 1955, 2135, 2270, 2562, 2697, 2846, 3026]",6507,7735,5449,3824,3026,38,76,129,21,103,"[0, 282, 521, 723, 968, 1343, 1625, 2155, 2559, 3618, 4024, 5010, 5862, 6495, 7263]","[0, 268, 583, 874, 1327, 1734, 1892, 2250, 2672, 3017, 3390, 3958, 4390, 4798, 5409]","[0, 205, 411, 748, 1100, 1463, 1690, 1780, 1965, 2502, 2905, 3278, 3486, 4241, 4580]","[21, 190, 575, 710, 866, 1035, 1167, 1257, 1347, 1561, 1744, 2452, 2993, 3547, 3935]","[0, 190, 492, 582, 795, 890, 990, 1106, 1240, 1538, 1673, 1818, 2062, 2296, 2778]",7263,5409,4580,3935,2778,-756,2326,869,-111,248,2576,15,dire
7632230602,73,98,60,79,119,"[0, 250, 662, 987, 1210, 1494, 2024, 2609, 3138, 3433, 4146, 4895, 5399, 6136, 6736]","[0, 281, 567, 726, 1090, 1314, 1492, 2108, 2512, 2926, 3559, 4531, 5122, 5430, 5524]","[0, 281, 530, 735, 1145, 1344, 2063, 2187, 2505, 2863, 3743, 4156, 4246, 4564, 4960]","[0, 170, 260, 399, 489, 614, 740, 1004, 1109, 1727, 2362, 2452, 2664, 3033, 3248]","[0, 170, 260, 350, 485, 616, 844, 968, 1338, 1542, 2216, 2306, 2631, 3233, 3448]",6736,5524,4960,3248,3448,114,49,21,75,136,"[0, 209, 490, 871, 1231, 1559, 1935, 2445, 2893, 3521, 3901, 4262, 5001, 5485, 6175]","[0, 291, 527, 742, 1065, 1411, 1842, 2356, 3038, 3411, 3956, 4160, 4835, 5412, 6031]","[0, 170, 309, 399, 978, 1068, 1421, 1601, 1802, 2217, 2352, 2746, 3049, 3873, 4303]","[0, 205, 370, 774, 1310, 1753, 1879, 2752, 3025, 3260, 3473, 3804, 4274, 4644, 5025]","[0, 170, 260, 385, 589, 723, 813, 1209, 1299, 1389, 1524, 1614, 1905, 2161, 2334]",6175,6031,4303,5025,2334,561,-507,657,-1777,1114,48,15,radiant
7632248708,120,54,123,129,9,"[0, 254, 620, 862, 1226, 1560, 1846, 2136, 2360, 2987, 3605, 3927, 4158, 4686, 5230]","[0, 205, 353, 630, 882, 972, 1097, 1337, 1598, 1923, 2530, 2935, 3492, 3815, 4541]","[0, 170, 260, 728, 934, 1143, 1336, 1471, 1561, 1721, 1905, 2032, 2215, 2443, 2612]","[0, 290, 698, 1090, 1347, 1609, 2076, 2751, 3213, 3713, 4508, 5069, 5531, 6088, 6527]","[0, 272, 435, 577, 730, 893, 1304, 1629, 1719, 2076, 2509, 2912, 3121, 3317, 3664]",5230,4541,2612,6527,3664,94,137,28,119,5,"[0, 218, 416, 659, 1130, 1371, 1792, 2046, 2540, 3056, 3518, 3961, 4614, 5225, 5926]","[0, 281, 564, 859, 1194, 1630, 2139, 2348, 2783, 3080, 3170, 3582, 4063, 4338, 5293]","[0, 170, 410, 680, 970, 1593, 1810, 2234, 2730, 3388, 3905, 4473, 4692, 5169, 5636]","[0, 170, 310, 443, 533, 934, 1118, 1253, 1392, 1531, 1621, 1909, 2256, 2405, 2872]","[0, 204, 294, 384, 490, 600, 820, 1081, 1286, 1376, 1481, 1692, 2161, 2455, 2878]",5926,5293,5636,2872,2878,-696,-752,-3024,3655,786,-31,15,dire
7632386819,48,106,60,65,66,"[0, 320, 525, 750, 1233, 1571, 2107, 2529, 2921, 3367, 4063, 4702, 5096, 5731, 6225]","[0, 282, 615, 1000, 1412, 1761, 2167, 2580, 3076, 3579, 4022, 4621, 5091, 5330, 6113]","[0, 241, 550, 893, 1135, 1647, 2158, 2537, 3059, 3507, 3849, 4544, 5010, 5654, 6011]","[0, 194, 284, 439, 1238, 1373, 1954, 2044, 2334, 3147, 3285, 3763, 4238, 4698, 5234]","[0, 194, 284, 472, 648, 1015, 1448, 1759, 1950, 2658, 2989, 3373, 3654, 4100, 4710]",6225,6113,6011,5234,4710,90,18,108,5,112,"[0, 326, 615, 1023, 1354, 1827, 2310, 2647, 3010, 3491, 3806, 4317, 4598, 4901, 5500]","[0, 252, 606, 840, 1031, 1325, 1731, 2266, 2710, 3274, 3835, 4160, 4673, 4999, 5744]","[0, 239, 509, 707, 918, 1357, 1624, 1962, 2618, 3215, 3498, 4380, 4799, 4979, 5495]","[0, 169, 259, 406, 746, 881, 1011, 1192, 1402, 1698, 1881, 2422, 2987, 3295, 3588]","[0, 169, 259, 349, 486, 622, 923, 1107, 1295, 1509, 1652, 2012, 2254, 2394, 2664]",5500,5744,5495,3588,2664,725,369,516,1646,2046,5302,15,radiant
7632461419,1,95,69,110,20,"[0, 295, 564, 950, 1359, 1752, 2289, 2904, 3201, 3722, 4305, 4713, 5253, 5828, 6258]","[0, 365, 651, 1155, 1455, 1946, 2496, 2876, 3562, 4007, 4248, 4780, 5297, 5567, 6028]","[0, 244, 581, 899, 1102, 1420, 1773, 2306, 2555, 2963, 3295, 3545, 3975, 4277, 4572]","[0, 210, 300, 523, 613, 1024, 1190, 1415, 1561, 1817, 2112, 2204, 2816, 2911, 3219]","[0, 210, 351, 518, 668, 876, 1106, 1350, 1484, 1728, 1998, 2089, 2384, 2479, 2744]",6258,6028,4572,3219,2744,94,90,97,65,19,"[0, 576, 816, 1223, 1665, 2043, 2581, 3322, 3736, 4121, 4684, 5397, 6073, 7041, 7910]","[0, 310, 729, 977, 1318, 1521, 2272, 2969, 3489, 4248, 4853, 5557, 5737, 6648, 7097]","[0, 164, 435, 813, 1046, 1332, 1704, 1995, 2529, 2858, 3530, 4128, 4755, 5418, 5750]","[0, 199, 314, 457, 596, 748, 1155, 1459, 1549, 1960, 2205, 2584, 2764, 3435, 4034]","[0, 199, 349, 556, 694, 824, 1075, 1334, 1424, 1595, 2108, 2279, 2459, 2978, 3198]",7910,7097,5750,4034,3198,-1652,-1069,-1178,-815,-454,-5168,15,dire
7632470313,90,14,15,86,51,"[0, 259, 549, 910, 1323, 1610, 2066, 2529, 3009, 3577, 4032, 4391, 5133, 5686, 6170]","[0, 243, 595, 905, 1144, 1393, 1703, 1958, 2368, 2872, 3381, 3749, 4038, 4479, 4676]","[0, 256, 578, 870, 1074, 1376, 1684, 1934, 2320, 3047, 3572, 4212, 4683, 5168, 5359]","[0, 170, 325, 499, 855, 1026, 1414, 1504, 1594, 1684, 2064, 2952, 3042, 3136, 3646]","[0, 170, 260, 385, 495, 845, 1171, 1312, 1504, 1726, 1861, 2113, 2203, 2341, 2486]",6170,4676,5359,3646,2486,48,21,49,79,83,"[0, 208, 332, 630, 969, 1288, 1527, 2145, 2741, 3302, 3918, 4363, 4915, 5650, 6327]","[0, 323, 725, 1023, 1400, 1817, 2257, 2536, 2960, 3630, 4133, 4711, 5286, 5745, 6173]","[0, 214, 522, 808, 1215, 1472, 1934, 2340, 2699, 2984, 3328, 4072, 4391, 5037, 5553]","[0, 170, 260, 350, 485, 823, 1211, 1472, 1701, 1974, 2456, 2769, 2859, 3287, 3822]","[0, 170, 260, 694, 784, 874, 964, 1160, 1369, 1592, 1953, 2133, 2223, 2485, 2634]",6327,6173,5553,3822,2634,-157,-1497,-194,-176,-148,-2172,15,radiant
7632526519,25,18,96,123,5,"[0, 630, 914, 1199, 1656, 1984, 2385, 3030, 3471, 3947, 4489, 4618, 5087, 5236, 5946]","[0, 272, 509, 797, 1003, 1291, 1728, 2264, 2534, 2986, 3445, 4131, 4992, 5483, 5945]","[0, 164, 485, 649, 1106, 1304, 1657, 2377, 2708, 3470, 3605, 4061, 4521, 4869, 5127]","[0, 129, 219, 309, 530, 733, 868, 1066, 1156, 1392, 1735, 1950, 2229, 2707, 2899]","[0, 252, 386, 476, 601, 973, 1271, 1406, 1496, 1586, 1735, 1949, 2039, 2357, 2454]",5946,5945,5127,2899,2454,10,52,23,79,85,"[0, 209, 334, 673, 871, 1247, 1656, 2102, 2556, 2718, 3466, 3868, 4530, 5322, 5962]","[0, 330, 683, 1029, 1244, 1492, 1927, 2435, 3155, 3564, 4399, 4828, 5600, 6441, 7032]","[0, 248, 518, 791, 1253, 1850, 2065, 2483, 2850, 3581, 4308, 4855, 5361, 5859, 6395]","[0, 209, 335, 638, 1038, 1267, 1582, 1717, 1937, 2274, 2586, 2958, 3531, 3732, 4138]","[0, 209, 299, 435, 525, 664, 845, 980, 1070, 1160, 1385, 1831, 2128, 2362, 2536]",5962,7032,6395,4138,2536,-16,-1087,-1268,-1239,-82,-3692,15,radiant
7632649002,41,19,137,121,110,"[0, 242, 541, 753, 1131, 1401, 1741, 2066, 2469, 2822, 3439, 3718, 3808, 4098, 4560]","[0, 329, 665, 1003, 1429, 1808, 2272, 2581, 3004, 3561, 4063, 4694, 4836, 5138, 5754]","[0, 250, 607, 977, 1266, 1469, 1760, 2409, 3041, 3390, 3969, 4511, 4601, 4895, 5929]","[0, 170, 260, 368, 498, 637, 771, 1139, 1322, 1506, 1839, 2172, 2262, 2474, 3213]","[0, 170, 694, 829, 959, 1049, 1215, 1311, 1447, 1659, 2142, 2442, 2532, 2855, 3275]",4560,5754,5929,3213,3275,70,129,13,9,79,"[0, 240, 515, 924, 1233, 1623, 2173, 2605, 2825, 3060, 3408, 3949, 4825, 5216, 5906]","[0, 207, 592, 943, 1275, 1787, 2078, 2336, 2795, 3297, 3721, 4268, 4923, 5155, 5655]","[0, 170, 437, 809, 1102, 1442, 1683, 2181, 2664, 3250, 3717, 4022, 4534, 4952, 5325]","[0, 170, 260, 615, 745, 996, 1166, 1301, 1436, 1806, 2046, 2136, 3096, 3327, 3755]","[0, 170, 260, 352, 538, 773, 1010, 1425, 1565, 1763, 1961, 2234, 2999, 3094, 3296]",5906,5655,5325,3755,3296,-1346,99,604,-542,-21,-1206,15,radiant
7632714910,52,54,96,79,105,"[0, 288, 562, 989, 1321, 1641, 2052, 2599, 3189, 3654, 4091, 4573, 5326, 6268, 6768]","[0, 293, 516, 869, 1268, 1794, 2208, 2740, 3150, 3677, 4077, 4574, 5224, 5846, 6512]","[0, 242, 484, 863, 1588, 1838, 2213, 2492, 2966, 3365, 4005, 4768, 5356, 5988, 6137]","[0, 170, 592, 798, 954, 1303, 1442, 1667, 2011, 2468, 2647, 2872, 3161, 3459, 3726]","[0, 170, 260, 429, 750, 880, 1059, 1333, 1611, 1748, 2087, 2177, 2408, 2777, 2932]",6768,6512,6137,3726,2932,46,120,129,45,138,"[0, 209, 528, 725, 1061, 1532, 1883, 2425, 2822, 3759, 4258, 4882, 5862, 6598, 7322]","[0, 327, 726, 1078, 1411, 1710, 2118, 2730, 3267, 3767, 4378, 4892, 5395, 5995, 6790]","[0, 172, 424, 869, 1032, 1262, 1637, 1924, 2295, 2419, 2676, 3187, 3649, 4031, 4616]","[0, 170, 305, 604, 745, 882, 1133, 1298, 1388, 1623, 1840, 2236, 2509, 2845, 3226]","[0, 170, 483, 729, 819, 1018, 1108, 1239, 1420, 1609, 1790, 2012, 2315, 2463, 2741]",7322,6790,4616,3226,2741,-554,-278,1521,500,191,1380,15,radiant
7632820016,18,25,137,121,19,"[0, 284, 616, 936, 1297, 1932, 2332, 2751, 3498, 4051, 4834, 5534, 6281, 7001, 7653]","[0, 282, 593, 997, 1278, 1756, 1976, 2753, 3216, 3634, 4377, 4675, 5392, 5622, 6556]","[0, 210, 408, 706, 831, 1090, 1376, 1972, 2533, 2921, 3493, 3922, 4669, 5399, 5761]","[0, 210, 300, 561, 696, 934, 1081, 1284, 1546, 1770, 2170, 2400, 2629, 2855, 3244]","[0, 253, 343, 599, 689, 859, 949, 1039, 1129, 1219, 1784, 2080, 2402, 2676, 3165]",7653,6556,5761,3244,3165,109,13,129,65,85,"[0, 213, 526, 770, 1195, 1689, 2016, 2415, 2797, 3196, 3487, 3913, 4266, 4630, 5358]","[0, 252, 495, 747, 1080, 1442, 1680, 2403, 2860, 3339, 3654, 3994, 4447, 5031, 5694]","[0, 254, 538, 800, 1130, 1533, 1897, 2462, 3181, 3391, 4107, 4418, 5042, 5936, 6529]","[0, 130, 240, 330, 464, 650, 740, 1016, 1333, 1578, 2137, 2372, 2730, 3210, 3359]","[0, 130, 220, 367, 457, 672, 762, 1030, 1287, 1559, 2162, 2352, 2555, 3033, 3275]",5358,5694,6529,3359,3275,2295,862,-768,-115,-110,2164,15,radiant
7632828213,21,78,23,5,86,"[0, 260, 588, 920, 1243, 1613, 2039, 2516, 2952, 3637, 4218, 4844, 5336, 5974, 6808]","[0, 174, 493, 762, 1110, 1418, 1757, 2152, 2671, 2989, 3430, 3901, 4316, 4683, 5045]","[0, 292, 623, 993, 1328, 1785, 2176, 2997, 3881, 4799, 5502, 6210, 6756, 7497, 7901]","[0, 170, 476, 611, 830, 1024, 1114, 1339, 1499, 1683, 1920, 2214, 2539, 3105, 3586]","[0, 218, 308, 398, 539, 692, 782, 1127, 1287, 1455, 1771, 2000, 2582, 2834, 3054]",6808,5045,7901,3586,3054,89,52,97,119,51,"[0, 224, 587, 948, 1241, 1520, 1833, 2352, 2767, 3150, 3658, 4295, 4844, 5446, 6172]","[0, 262, 595, 1032, 1297, 1640, 2016, 2491, 3043, 3506, 3952, 4217, 4868, 5489, 6086]","[0, 287, 534, 934, 1259, 1472, 1788, 2148, 2514, 2962, 3350, 3693, 4458, 4811, 5313]","[0, 420, 510, 814, 991, 1081, 1171, 1261, 1540, 1824, 2197, 2287, 2574, 2815, 3098]","[0, 492, 582, 737, 867, 1070, 1160, 1566, 1912, 2002, 2265, 2390, 2844, 3140, 3453]",6172,6086,5313,3098,3453,636,-1041,2588,488,-399,2272,15,radiant
7632884911,73,129,28,100,105,"[0, 490, 800, 1001, 1533, 1671, 1882, 2175, 2584, 3056, 3772, 4399, 4892, 5829, 6403]","[0, 647, 1039, 1338, 1673, 2070, 2600, 2926, 3464, 4290, 4502, 4993, 5437, 5803, 6192]","[0, 170, 451, 576, 949, 1173, 1461, 1875, 2418, 2685, 3174, 3632, 4095, 4259, 4742]","[0, 282, 402, 699, 789, 879, 1300, 1658, 2106, 2491, 2670, 2934, 3378, 3666, 4188]","[0, 360, 480, 720, 858, 984, 1249, 1463, 1782, 2030, 2287, 2727, 2854, 3269, 3498]",6403,6192,4742,4188,3498,23,13,19,45,123,"[0, 241, 566, 878, 1247, 1613, 2250, 2693, 2832, 3166, 3396, 4367, 5405, 6199, 6515]","[0, 253, 526, 801, 1127, 1572, 1928, 2378, 2708, 3345, 3756, 4183, 5167, 5766, 6344]","[0, 244, 577, 894, 1321, 1521, 1902, 2301, 2807, 3136, 3591, 4314, 5030, 5643, 6235]","[0, 170, 260, 424, 603, 810, 1072, 1334, 1680, 2104, 2194, 2387, 2753, 3119, 3231]","[0, 170, 260, 419, 703, 904, 1370, 1629, 1854, 2100, 2190, 2633, 2889, 3328, 3423]",6515,6344,6235,3231,3423,-112,-152,-1493,957,75,-725,15,dire
7632939802,41,120,137,9,66,"[0, 292, 574, 929, 1256, 1571, 1894, 2410, 2611, 2929, 3338, 3884, 4486, 4836, 5590]","[0, 330, 639, 1097, 1499, 1824, 2331, 2926, 3492, 4037, 4309, 5136, 5451, 6054, 7039]","[0, 206, 470, 860, 1136, 1498, 1744, 2299, 2654, 3520, 4029, 4577, 5206, 5775, 6461]","[0, 221, 337, 472, 602, 903, 1094, 1184, 1274, 1511, 1732, 1876, 2056, 2252, 2720]","[0, 204, 312, 494, 682, 873, 1040, 1265, 1546, 1887, 2116, 2366, 2672, 2913, 3514]",5590,7039,6461,2720,3514,13,18,19,37,20,"[0, 296, 468, 803, 1093, 1453, 1734, 2203, 3052, 3850, 4524, 5095, 5515, 6142, 6584]","[0, 204, 378, 761, 958, 1444, 1804, 2426, 2850, 3322, 3628, 4484, 5159, 5794, 5978]","[0, 242, 562, 788, 1118, 1521, 1864, 2521, 2927, 3263, 3718, 4305, 4685, 5054, 5361]","[0, 169, 259, 349, 439, 625, 729, 954, 1044, 1467, 1651, 1959, 2099, 2349, 2968]","[0, 169, 259, 349, 563, 698, 834, 1059, 1305, 1562, 2041, 2532, 2806, 3321, 3590]",6584,5978,5361,2968,3590,-994,1061,1100,-248,-76,843,15,radiant
7633038512,109,7,76,50,121,"[0, 286, 604, 962, 1363, 1682, 1991, 2321, 2824, 3107, 3744, 4168, 4942, 5633, 6076]","[0, 236, 603, 1050, 1465, 1847, 2189, 2525, 3361, 3677, 4387, 4769, 5207, 5485, 6054]","[0, 205, 531, 900, 1158, 1399, 1658, 2046, 2304, 2727, 3191, 3527, 3956, 4288, 4683]","[0, 130, 220, 354, 492, 582, 893, 983, 1073, 1199, 1506, 1692, 1782, 2096, 2333]","[0, 173, 263, 435, 545, 635, 725, 862, 952, 1042, 1312, 1491, 1581, 1729, 2036]",6076,6054,4683,2333,2036,120,59,70,86,5,"[0, 363, 809, 1140, 1560, 2052, 2674, 3328, 3963, 4420, 5173, 6014, 6660, 6909, 7497]","[0, 299, 668, 1087, 1295, 2093, 2472, 3081, 3505, 4211, 4994, 5510, 6005, 6505, 7363]","[0, 283, 621, 941, 1287, 1643, 2108, 2409, 2840, 3040, 3435, 3823, 4395, 4954, 5436]","[0, 210, 300, 436, 880, 1095, 1288, 1498, 1718, 1946, 2160, 2380, 2550, 2856, 3167]","[0, 210, 326, 526, 616, 751, 912, 1092, 1485, 1585, 2107, 2197, 2287, 2381, 2616]",7497,7363,5436,3167,2616,-1421,-1309,-753,-834,-580,-4897,15,dire
7633069015,11,16,109,14,5,"[0, 369, 721, 1132, 1609, 2174, 2805, 2975, 3781, 4242, 4842, 5756, 6365, 7236, 7763]","[0, 282, 632, 909, 1482, 1884, 2213, 2680, 3185, 3736, 4153, 4491, 5021, 5627, 6279]","[0, 285, 520, 817, 1067, 1606, 1856, 2196, 2304, 2623, 2957, 3699, 4194, 4766, 5250]","[0, 169, 303, 393, 601, 1003, 1093, 1311, 1448, 1779, 2080, 2654, 2791, 3231, 3939]","[0, 169, 259, 538, 655, 1065, 1224, 1378, 1468, 1558, 2041, 2432, 2571, 3171, 3365]",7763,6279,5250,3939,3365,106,97,40,71,87,"[0, 292, 620, 1211, 1559, 2114, 2638, 3174, 3604, 3964, 4530, 4926, 5478, 6112, 6764]","[0, 328, 567, 879, 1279, 1775, 2516, 3357, 3926, 4157, 4677, 5312, 5813, 6337, 7198]","[0, 244, 609, 897, 1111, 1512, 1945, 2383, 2693, 3049, 3449, 3649, 3791, 4285, 4938]","[0, 169, 259, 849, 1014, 1144, 1503, 1796, 2432, 2632, 3000, 3387, 3603, 3771, 4396]","[0, 169, 259, 394, 484, 659, 815, 1035, 1125, 1261, 1415, 1613, 1703, 1798, 2321]",6764,7198,4938,4396,2321,999,-919,312,-457,1044,979,15,radiant
7633207514,73,22,15,112,65,"[0, 365, 672, 980, 1348, 1726, 2223, 2737, 3466, 4390, 5072, 5874, 6249, 7010, 8533]","[0, 444, 774, 1018, 1427, 1752, 2045, 2772, 3307, 3959, 4522, 5036, 5303, 6266, 6899]","[0, 573, 825, 1086, 1423, 1703, 2218, 2516, 2820, 3148, 3530, 4111, 4449, 4992, 5624]","[0, 209, 299, 389, 528, 618, 870, 960, 1050, 1337, 1594, 1860, 2110, 2509, 2748]","[0, 266, 356, 490, 702, 1000, 1540, 1691, 1839, 2326, 2804, 3117, 3299, 4001, 4345]",8533,6899,5624,2748,4345,10,137,79,54,83,"[0, 230, 444, 813, 1062, 1285, 1418, 1821, 2239, 2689, 3058, 3491, 3947, 4081, 4895]","[0, 206, 366, 737, 999, 1520, 1936, 2198, 2757, 3028, 3423, 4148, 4869, 5448, 6079]","[0, 154, 244, 421, 511, 781, 871, 1028, 1229, 1484, 1877, 2263, 2353, 2617, 2983]","[0, 239, 561, 809, 1102, 1430, 1805, 2292, 2711, 3089, 3448, 3668, 4146, 4410, 4688]","[0, 154, 244, 382, 472, 562, 652, 925, 1015, 1411, 1546, 1776, 1866, 1961, 3043]",4895,6079,2983,4688,3043,3638,820,2641,-1940,1302,6461,15,dire
7633242208,73,15,102,14,53,"[0, 334, 554, 1172, 1542, 2168, 2347, 2866, 3691, 4222, 4593, 5565, 6147, 7081, 8771]","[0, 329, 692, 1072, 1438, 1908, 2307, 3067, 3632, 4136, 4808, 5595, 6232, 6919, 7663]","[0, 253, 616, 959, 1179, 1599, 2228, 2435, 2708, 3054, 3453, 4386, 5019, 5765, 6331]","[0, 170, 260, 581, 913, 1052, 1142, 1232, 1703, 1793, 2353, 2713, 2903, 3238, 3609]","[0, 170, 260, 395, 522, 657, 863, 953, 1230, 1320, 1658, 2248, 2480, 2713, 3006]",8771,7663,6331,3609,3006,114,104,74,110,84,"[0, 255, 651, 1242, 1855, 2295, 3005, 3507, 4007, 4659, 5208, 5700, 6279, 6749, 7101]","[0, 288, 621, 831, 1372, 1625, 2172, 2524, 2975, 3452, 3680, 3770, 3955, 4661, 5172]","[0, 206, 428, 872, 1242, 1485, 2005, 2449, 2848, 3525, 3984, 4545, 5138, 5233, 5864]","[0, 170, 285, 375, 849, 986, 1377, 1543, 2595, 3123, 3258, 3525, 3906, 4086, 4394]","[0, 170, 636, 918, 1103, 1267, 1502, 1592, 1765, 2083, 2239, 2447, 2708, 2917, 3209]",7101,5172,5864,4394,3209,1670,2491,467,-785,-203,3640,15,radiant
7633305505,13,10,137,110,31,"[1, 276, 610, 1177, 1697, 2109, 2542, 3064, 3661, 4186, 4663, 5476, 5780, 6134, 6916]","[1, 282, 574, 878, 1169, 1553, 2243, 2614, 2779, 3141, 3666, 4130, 4668, 5130, 5637]","[1, 233, 524, 984, 1284, 1666, 2075, 2762, 3196, 3612, 3803, 4665, 5067, 5831, 6182]","[1, 196, 286, 445, 570, 660, 1107, 1571, 1661, 1917, 2007, 2268, 2530, 2818, 2993]","[1, 196, 286, 445, 535, 661, 851, 1187, 1277, 1367, 1502, 1682, 1910, 2059, 2521]",6916,5637,6182,2993,2521,48,90,15,66,19,"[1, 206, 490, 931, 1296, 1627, 1944, 2190, 2447, 3055, 3626, 4256, 5099, 5815, 6460]","[1, 375, 766, 1162, 1546, 1887, 2269, 2946, 3496, 3997, 4523, 5079, 5665, 6212, 6516]","[1, 207, 417, 705, 1365, 1680, 1960, 2219, 2382, 2776, 3166, 3598, 4365, 4883, 5526]","[1, 171, 261, 429, 640, 765, 970, 1472, 1635, 2022, 2380, 2783, 3241, 3585, 3870]","[1, 171, 345, 523, 816, 986, 1285, 1478, 1928, 2232, 2551, 2785, 3081, 3255, 3350]",6460,6516,5526,3870,3350,456,-879,656,-877,-829,-1473,15,dire
7633369014,25,28,69,2,5,"[0, 373, 822, 1236, 1645, 2176, 2699, 3286, 3705, 4169, 4818, 5393, 6268, 6973, 8203]","[0, 298, 628, 966, 1369, 1583, 2378, 2534, 3291, 3556, 4112, 4704, 4990, 5421, 6096]","[0, 254, 344, 454, 856, 1073, 1182, 1391, 1602, 1732, 1934, 2244, 2682, 2817, 3128]","[0, 204, 416, 708, 978, 1395, 1673, 2020, 2479, 2828, 3218, 3787, 4579, 4997, 5360]","[0, 170, 260, 396, 534, 643, 1013, 1186, 1463, 1596, 2081, 2351, 2441, 2579, 2981]",8203,6096,3128,5360,2981,98,54,39,123,87,"[0, 284, 672, 1079, 1900, 2107, 2272, 3134, 3334, 3996, 4182, 4801, 5903, 6488, 6842]","[0, 170, 513, 991, 1405, 1656, 2091, 2604, 2989, 3354, 3671, 4105, 4512, 4921, 5687]","[0, 289, 699, 1208, 1563, 2075, 2789, 3253, 3891, 4351, 4780, 5605, 6161, 6699, 7441]","[0, 170, 260, 380, 515, 805, 983, 1853, 1943, 2352, 2594, 2731, 3319, 3795, 4100]","[0, 170, 260, 426, 516, 640, 793, 1145, 1284, 1621, 1756, 1989, 2392, 2719, 2904]",6842,5687,7441,4100,2904,1361,409,-4313,1260,77,-1206,15,radiant
7633391901,72,126,38,5,9,"[0, 283, 520, 890, 1141, 1623, 2085, 2400, 2918, 3428, 4224, 4314, 4810, 5502, 5878]","[0, 329, 736, 990, 1324, 1663, 2127, 2413, 2978, 3259, 3653, 4237, 4327, 5145, 5670]","[0, 206, 477, 678, 768, 1110, 1354, 1444, 1757, 1931, 2250, 2626, 2897, 3301, 3859]","[0, 170, 367, 457, 673, 1074, 1164, 1254, 1530, 1803, 2455, 2724, 3450, 3730, 3879]","[0, 170, 354, 535, 668, 867, 957, 1091, 1360, 1450, 1825, 2045, 2726, 2929, 3159]",5878,5670,3859,3879,3159,95,13,96,114,3,"[0, 255, 638, 1189, 1694, 2070, 2577, 3218, 3423, 4064, 4653, 5347, 6040, 6697, 7345]","[0, 324, 783, 1204, 1719, 2178, 2756, 3236, 3903, 4344, 4851, 5714, 6157, 6783, 7392]","[0, 170, 384, 625, 1063, 1487, 1936, 2505, 2758, 3234, 3941, 4503, 4867, 5494, 6183]","[0, 170, 320, 810, 1142, 1392, 1702, 1932, 2102, 2460, 2640, 2983, 3200, 3348, 3685]","[0, 196, 346, 471, 654, 936, 1514, 1744, 1914, 2092, 2278, 2590, 2807, 3286, 3471]",7345,7392,6183,3685,3471,-1467,-1722,-2324,194,-312,-5631,15,dire
7633546718,10,43,2,27,85,"[0, 292, 644, 963, 1275, 1776, 2068, 2440, 2920, 3351, 3573, 4041, 4613, 5257, 5684]","[0, 255, 611, 900, 1157, 1572, 2023, 2720, 2935, 3347, 3859, 4121, 4528, 5104, 5487]","[0, 247, 493, 1148, 1433, 1934, 2316, 2760, 3232, 4010, 4856, 5266, 5562, 6259, 6551]","[0, 170, 280, 521, 739, 1079, 1214, 1881, 2016, 2149, 2393, 2483, 2711, 3110, 3350]","[0, 170, 260, 350, 650, 899, 1034, 1322, 1457, 1600, 1961, 2051, 2224, 2496, 2708]",5684,5487,6551,3350,2708,72,137,69,19,121,"[0, 245, 539, 1174, 1535, 2378, 2755, 3243, 3824, 4353, 4751, 5465, 6171, 6786, 7396]","[0, 294, 528, 773, 1085, 1383, 1720, 2138, 2589, 2952, 3492, 4346, 4542, 5122, 6019]","[0, 170, 399, 637, 916, 1294, 1866, 2335, 2907, 3344, 4012, 4621, 5344, 6127, 6746]","[0, 208, 346, 436, 526, 697, 863, 1079, 1214, 1849, 2361, 2545, 2635, 2784, 3102]","[0, 215, 305, 530, 729, 1043, 1393, 1618, 1802, 2019, 2350, 2534, 2672, 2857, 3163]",7396,6019,6746,3102,3163,-1712,-532,-195,248,-455,-2646,15,dire
7633731105,43,123,28,51,37,"[0, 279, 443, 604, 981, 1177, 1522, 1984, 2314, 2721, 3370, 3724, 4422, 5193, 5427]","[0, 316, 563, 941, 1583, 2189, 2593, 3321, 4063, 4901, 5424, 5904, 6965, 7510, 8010]","[0, 321, 593, 874, 1268, 1756, 1882, 2516, 2703, 3241, 4027, 4546, 5262, 6048, 6591]","[0, 209, 346, 509, 643, 852, 1265, 1490, 1580, 1917, 2258, 2776, 3215, 3579, 3674]","[0, 259, 387, 477, 567, 701, 791, 1059, 1149, 1329, 1727, 2045, 2539, 3097, 3403]",5427,8010,6591,3674,3403,52,74,14,90,26,"[0, 163, 392, 920, 1134, 1424, 1952, 2343, 2629, 3007, 3327, 3968, 4554, 5578, 6028]","[0, 256, 488, 868, 1115, 1205, 1345, 1685, 1813, 2004, 2242, 2396, 2486, 3847, 4199]","[0, 89, 430, 689, 1103, 1381, 2063, 2350, 2710, 2946, 3209, 3299, 3764, 4114, 4409]","[0, 191, 349, 549, 684, 794, 947, 1127, 1217, 1307, 1397, 1504, 1628, 2176, 2271]","[0, 95, 213, 337, 489, 633, 1081, 1261, 1351, 1441, 1567, 1660, 1835, 2352, 2447]",6028,4199,4409,2271,2447,-601,3811,2182,1403,956,7751,15,radiant
7633732214,48,114,86,29,109,"[0, 279, 544, 958, 1205, 1697, 1982, 2532, 3278, 3897, 4583, 5130, 6075, 7008, 7869]","[0, 353, 734, 998, 1412, 1746, 2444, 2934, 3604, 4020, 4581, 5033, 5714, 6015, 6381]","[0, 290, 380, 550, 750, 1204, 1789, 1981, 2385, 2607, 2898, 3057, 3660, 4063, 4195]","[0, 327, 527, 927, 1358, 1483, 1922, 2345, 2607, 3243, 3842, 4146, 4731, 5371, 5849]","[0, 244, 334, 454, 591, 681, 771, 995, 1375, 1779, 2157, 2616, 2928, 3299, 3716]",7869,6381,4195,5849,3716,10,69,106,19,9,"[0, 205, 438, 727, 974, 1395, 1726, 1888, 2486, 2971, 3290, 3909, 4625, 5117, 5641]","[0, 243, 457, 734, 1139, 1556, 2293, 2734, 3322, 3751, 4139, 4660, 5282, 5687, 6251]","[0, 323, 483, 680, 975, 1256, 1391, 1602, 1813, 2148, 2664, 2958, 3060, 3671, 3976]","[0, 169, 306, 426, 650, 839, 1103, 1193, 1677, 1924, 2345, 2541, 2665, 3253, 3557]","[0, 220, 358, 478, 703, 809, 944, 1130, 1622, 1987, 2122, 2344, 2434, 2816, 2990]",5641,6251,3976,3557,2990,2228,130,219,2292,726,5595,15,dire
7633793219,48,35,129,85,86,"[0, 246, 491, 893, 1141, 1572, 1908, 2550, 2979, 3357, 3757, 4255, 4435, 5126, 5762]","[0, 200, 533, 935, 1341, 1787, 2351, 3132, 3475, 4146, 4891, 5240, 6024, 6486, 7048]","[0, 216, 419, 809, 979, 1590, 1719, 1979, 2285, 2588, 3031, 3942, 4208, 4590, 5086]","[0, 129, 219, 339, 429, 977, 1280, 1939, 2146, 2410, 2777, 3363, 3794, 4159, 4459]","[0, 167, 304, 468, 603, 733, 857, 1364, 1534, 1664, 2057, 2147, 2373, 2724, 2819]",5762,7048,5086,4459,2819,54,13,55,64,19,"[0, 253, 629, 900, 1285, 1574, 2015, 2576, 2951, 3398, 3998, 4613, 5484, 6321, 6923]","[0, 327, 454, 799, 1018, 1195, 1501, 1909, 2248, 2913, 3497, 4141, 4369, 5103, 5949]","[0, 281, 478, 673, 1023, 1421, 1819, 2265, 2515, 2985, 3511, 3896, 4155, 5037, 5601]","[0, 209, 299, 389, 578, 668, 804, 1479, 1606, 1696, 2040, 2214, 2304, 2806, 3276]","[0, 209, 299, 389, 526, 616, 706, 914, 1004, 1201, 1395, 1519, 2096, 2562, 2775]",6923,5949,5601,3276,2775,-1161,1099,-515,1183,44,650,15,dire
7633814106,18,137,98,5,27,"[61, 338, 802, 1218, 1763, 2129, 2297, 2693, 3138, 3782, 4344, 4981, 5675, 6468, 7221]","[61, 342, 727, 1127, 1374, 1816, 2144, 2491, 2702, 3260, 3810, 4213, 5032, 5628, 6252]","[61, 343, 616, 846, 1212, 1536, 1790, 2148, 2540, 2973, 3880, 4494, 5137, 5634, 6159]","[329, 538, 752, 926, 1117, 1252, 1342, 1480, 1570, 2059, 2620, 2754, 2944, 3270, 3541]","[61, 270, 360, 495, 660, 750, 840, 964, 1054, 1262, 1650, 1740, 2061, 2347, 2615]",7221,6252,6159,3541,2615,94,82,23,72,65,"[0, 129, 429, 806, 1163, 1609, 2168, 2540, 3140, 3556, 4170, 4926, 5604, 6515, 7219]","[0, 324, 569, 984, 1476, 1856, 2473, 3234, 3706, 4278, 4793, 4992, 5970, 7483, 8423]","[0, 163, 348, 828, 1033, 1337, 1810, 1945, 2850, 3106, 3657, 4089, 4729, 5417, 6033]","[0, 129, 219, 358, 502, 637, 1180, 1315, 1569, 1659, 1794, 2103, 2462, 3054, 3196]","[0, 129, 219, 309, 439, 619, 1058, 1286, 1495, 1842, 2295, 2639, 2950, 3384, 3610]",7219,8423,6033,3196,3610,2,-2171,126,345,-995,-2693,15,radiant
7633956117,70,96,23,31,123,"[0, 362, 569, 1042, 1264, 1949, 2268, 2527, 2845, 3242, 3792, 4291, 4435, 4853, 5373]","[0, 253, 489, 735, 1118, 1377, 1549, 1932, 2183, 2664, 2858, 3213, 3431, 3786, 4127]","[0, 169, 371, 622, 855, 1030, 1268, 1489, 1844, 2142, 2512, 2883, 3436, 3795, 4223]","[0, 233, 337, 574, 984, 1500, 1639, 1729, 1819, 2018, 2445, 2888, 3186, 3281, 3500]","[0, 130, 220, 310, 420, 590, 680, 770, 860, 1040, 1302, 1609, 1753, 1884, 2028]",5373,4127,4223,3500,2028,54,36,29,79,9,"[56, 338, 500, 731, 1433, 1759, 2107, 2341, 2950, 3463, 4171, 4729, 5345, 6110, 7245]","[56, 350, 687, 1096, 1489, 2491, 2870, 3163, 3630, 4389, 4872, 5315, 6017, 6726, 7450]","[56, 301, 550, 959, 1528, 1685, 2136, 2607, 3149, 3550, 3928, 4236, 5173, 5866, 6490]","[324, 534, 624, 762, 929, 1135, 1512, 1720, 2096, 2364, 2581, 2671, 3064, 3321, 3735]","[56, 311, 556, 742, 941, 1162, 1315, 1530, 1792, 2044, 2395, 2485, 2976, 3328, 3792]",7245,7450,6490,3735,3792,-1872,-3323,-2267,-235,-1764,-9461,15,dire
7634024715,94,17,29,27,66,"[0, 243, 539, 889, 1138, 1579, 2192, 2523, 2936, 3379, 4414, 4805, 5374, 5832, 6347]","[0, 375, 745, 909, 1238, 1583, 1824, 2368, 2900, 3499, 4182, 5008, 5364, 5806, 6327]","[0, 295, 579, 784, 1149, 1470, 1747, 1949, 2280, 2779, 3408, 4077, 4167, 4507, 5070]","[0, 170, 260, 350, 489, 628, 752, 842, 978, 1113, 1485, 1828, 2188, 2283, 2669]","[0, 170, 278, 368, 495, 629, 798, 1073, 1308, 1518, 1871, 2211, 2358, 2685, 2982]",6347,6327,5070,2669,2982,18,137,69,65,62,"[0, 245, 492, 807, 1174, 1456, 2155, 2514, 3142, 3705, 4238, 4785, 5640, 6397, 7398]","[0, 250, 612, 1277, 1689, 2056, 2628, 2969, 3318, 3683, 4225, 4621, 5299, 6069, 6939]","[0, 208, 602, 806, 989, 1448, 1598, 1868, 2276, 2639, 3405, 3896, 4555, 5226, 5973]","[0, 170, 308, 518, 693, 823, 1069, 1159, 1375, 1465, 1770, 2145, 2279, 2892, 3175]","[0, 170, 260, 475, 666, 796, 1157, 1535, 1743, 1938, 2416, 2705, 3040, 3461, 3841]",7398,6939,5973,3175,3841,-1051,-612,-903,-506,-859,-3931,15,radiant
7634079912,94,38,74,105,5,"[0, 242, 479, 727, 1053, 1346, 1833, 2214, 2674, 3140, 3469, 3893, 4411, 5196, 5793]","[0, 191, 519, 814, 1158, 1748, 2095, 2541, 2789, 3283, 3625, 4144, 5065, 5443, 6505]","[0, 276, 482, 743, 1157, 1502, 1838, 2299, 2838, 3637, 3888, 4137, 4590, 5090, 5614]","[0, 154, 244, 334, 469, 672, 808, 988, 1078, 1266, 1687, 1890, 2292, 2545, 2693]","[0, 154, 244, 383, 519, 703, 793, 973, 1237, 1642, 1751, 2070, 2244, 2497, 2645]",5793,6505,5614,2693,2645,10,98,55,19,45,"[0, 245, 553, 935, 1262, 1593, 2021, 2489, 2954, 3367, 3835, 4475, 5288, 6248, 6787]","[0, 332, 654, 1046, 1536, 1828, 2285, 3071, 3593, 4135, 4718, 5474, 5806, 6245, 6774]","[0, 209, 445, 744, 1168, 1593, 1953, 2531, 2754, 3280, 3952, 4497, 5168, 6048, 6495]","[0, 312, 402, 604, 770, 1163, 1298, 1668, 1843, 2196, 2430, 2785, 3214, 3781, 3923]","[0, 209, 299, 469, 589, 789, 971, 1186, 1392, 1747, 1966, 2274, 2513, 3012, 3110]",6787,6774,6495,3923,3110,-994,-269,-881,-1230,-465,-3839,15,dire
