match_id,rad_pos1,rad_pos2,rad_pos3,rad_pos4,rad_pos5,rad_pos1_gold,rad_pos2_gold,rad_pos3_gold,rad_pos4_gold,rad_pos5_gold,rad_pos1_last_gold,rad_pos2_last_gold,rad_pos3_last_gold,rad_pos4_last_gold,rad_pos5_last_gold,dire_pos1,dire_pos2,dire_pos3,dire_pos4,dire_pos5,dire_pos1_gold,dire_pos2_gold,dire_pos3_gold,dire_pos4_gold,dire_pos5_gold,dire_pos1_last_gold,dire_pos2_last_gold,dire_pos3_last_gold,dire_pos4_last_gold,dire_pos5_last_gold,pos1_diff,pos2_diff,pos3_diff,pos4_diff,pos5_diff,team_diff,minute,winner
7517420109,80,70,23,63,100,"[0, 245, 482, 901, 1226, 1720, 2196, 2613, 3126, 3656, 4014, 4528, 4977, 5336, 5917, 6395, 6848, 7327, 8373, 9297, 10054, 10486, 11137, 11806, 12258, 13003, 13464, 14271, 14624, 15204, 16381, 18066, 19380, 19777, 21881]","[0, 243, 397, 859, 1111, 1554, 2117, 2596, 3049, 3540, 4104, 4610, 5209, 5650, 6235, 6793, 7770, 8486, 9295, 10298, 10943, 11802, 12722, 13446, 14602, 15606, 16768, 17948, 18379, 19010, 20085, 20475, 21378, 22290, 22390]","[0, 244, 633, 916, 1375, 1957, 2416, 2835, 3416, 3789, 4416, 4825, 5508, 6145, 6524, 6690, 7507, 8147, 9165, 9953, 11042, 11517, 12034, 12808, 13348, 13837, 13932, 14948, 15537, 15842, 17179, 18609, 19678, 20461, 20561]","[0, 216, 331, 513, 649, 779, 914, 1004, 1219, 1309, 1756, 2115, 2559, 2654, 2798, 2893, 3194, 3554, 3854, 4275, 4622, 4716, 5056, 5330, 5425, 5519, 5908, 6349, 6625, 6852, 7452, 8080, 8524, 8796, 9727]","[0, 170, 331, 421, 511, 885, 1020, 1110, 1408, 1498, 1643, 1842, 2223, 2488, 2628, 2760, 2900, 3449, 3749, 4039, 4386, 4528, 4740, 4873, 5000, 5293, 5426, 6189, 6285, 6428, 7507, 7897, 8637, 8809, 9308]",21881,22390,20561,9727,9308,2,25,17,45,110,"[0, 209, 581, 1066, 1871, 2316, 3128, 3595, 4274, 4660, 5366, 6146, 6956, 8281, 9055, 10054, 10649, 11486, 12422, 12984, 13647, 14371, 14628, 15214, 16040, 17042, 17702, 17988, 18976, 19709, 20091, 20191, 21677, 23252, 24070]","[0, 170, 410, 740, 1025, 1332, 1593, 1938, 2183, 2739, 3308, 3845, 4458, 5380, 6276, 6947, 7714, 8515, 9174, 10029, 11021, 11688, 12988, 13825, 14583, 15598, 16771, 18200, 19295, 20270, 20949, 21049, 21528, 23569, 24706]","[0, 313, 606, 767, 1056, 1285, 1531, 1977, 2372, 2805, 3283, 3798, 4333, 4945, 5429, 5994, 6894, 7373, 8178, 8491, 8979, 9774, 10318, 10974, 11650, 12444, 13442, 14205, 14984, 15431, 16954, 17054, 17990, 18225, 18483]","[0, 170, 260, 350, 549, 639, 774, 1002, 1223, 1387, 1738, 2038, 2151, 2682, 2866, 3249, 3682, 4207, 4419, 4725, 5357, 5526, 5982, 6224, 6504, 7371, 7757, 8423, 9014, 9569, 9740, 10339, 10676, 11049, 11444]","[0, 270, 411, 501, 591, 681, 816, 996, 1086, 1424, 1728, 2084, 2222, 2614, 2798, 3738, 3975, 4389, 4758, 5093, 5492, 5769, 6060, 6227, 6634, 7233, 7544, 7974, 8427, 8651, 9311, 9411, 9957, 11393, 11630]",24070,24706,18483,11444,11630,-2189,-2316,2078,-1717,-2322,-6466,35,radiant
7517480603,1,33,11,100,30,"[0, 242, 587, 827, 1334, 1784, 2217, 3051, 3456, 3867, 4618, 5183, 5810, 6431, 7209, 7788, 8620, 8968, 9737, 10920, 12297, 12981, 13531, 14827, 15643, 16167, 16920, 18399, 20572, 21251, 22850, 24482, 27592, 29849, 31297]","[0, 244, 898, 1268, 1718, 2173, 2632, 3024, 3418, 4234, 4879, 5331, 5828, 6160, 6843, 7419, 7960, 8999, 9427, 10380, 10677, 11496, 11630, 12029, 12443, 12647, 12955, 13696, 14972, 15468, 16501, 16761, 17736, 18713, 19355]","[0, 289, 454, 837, 1306, 1601, 1904, 2157, 2694, 3889, 4419, 4813, 5453, 5963, 6734, 7084, 7453, 7891, 8342, 8728, 9100, 9660, 10544, 10991, 11205, 11405, 11690, 12105, 13097, 13644, 14505, 15146, 16130, 16900, 18152]","[0, 169, 325, 415, 535, 670, 805, 895, 985, 1325, 1588, 1754, 1998, 2093, 2371, 2676, 3150, 3630, 3850, 4523, 5313, 5761, 6177, 6536, 6881, 6976, 7166, 7306, 7994, 8225, 9260, 9486, 10801, 11724, 12004]","[0, 169, 259, 349, 518, 652, 834, 1089, 1179, 1314, 1854, 2238, 2433, 2566, 2771, 3040, 3553, 3648, 3792, 4131, 4673, 5087, 5182, 5612, 6157, 6439, 6609, 6837, 7199, 7639, 7810, 8304, 9492, 10692, 11047]",31297,19355,18152,12004,11047,44,19,57,21,5,"[0, 242, 515, 1000, 1337, 1662, 2086, 2452, 2711, 3036, 3574, 4068, 4617, 5042, 5637, 6121, 6842, 7882, 8718, 9586, 10694, 11102, 12188, 12963, 14956, 15816, 16879, 18687, 18783, 19405, 20743, 20843, 21472, 22301, 22491]","[0, 278, 550, 1004, 1410, 1826, 2182, 2642, 2732, 2945, 3557, 3979, 4783, 5253, 5659, 7164, 8498, 8941, 9198, 9738, 10283, 11605, 12211, 12305, 13340, 13883, 14997, 16133, 16351, 16447, 17367, 17831, 18170, 19126, 20170]","[0, 204, 490, 765, 1059, 1351, 1713, 1803, 2490, 2866, 3172, 3426, 3859, 4598, 5180, 6259, 6417, 7581, 8030, 8326, 8645, 9519, 10034, 10968, 11270, 11698, 12162, 13035, 13131, 13682, 14086, 14186, 15191, 15843, 16585]","[0, 169, 398, 488, 625, 759, 945, 1035, 1125, 1476, 1746, 1836, 2072, 2644, 3095, 3335, 4037, 4686, 4866, 5023, 5911, 6632, 7078, 7621, 8060, 8920, 9728, 10183, 10834, 11575, 11902, 12362, 12462, 12562, 12752]","[0, 169, 259, 395, 533, 623, 773, 923, 1049, 1139, 1409, 1499, 1700, 2073, 2296, 2444, 2602, 2945, 3084, 3241, 3883, 4092, 4259, 4504, 4659, 4826, 5187, 5566, 5678, 5774, 5870, 5970, 6281, 6789, 6979]",22491,20170,16585,12752,6979,8806,-815,1567,-748,4068,12878,35,radiant
7517586007,46,42,97,50,86,"[0, 205, 463, 746, 1132, 1436, 2130, 2573, 2948, 3718, 4211, 4888, 5658, 5752, 6468, 7653, 7962, 8641, 9989, 10785, 11520, 12630, 13511, 14759, 16136, 16632, 16727, 17468, 18039, 20325, 21075, 23489, 24481, 26132, 26232]","[0, 223, 526, 1060, 1398, 1820, 2422, 2597, 2906, 3324, 4037, 4355, 4829, 5488, 5912, 6451, 6889, 7340, 7845, 8196, 8663, 9504, 10346, 11098, 11884, 12808, 14042, 14511, 14742, 15813, 16284, 17176, 17473, 18581, 18859]","[0, 173, 500, 818, 981, 1405, 2047, 2400, 3229, 3728, 4450, 5242, 5604, 6033, 6536, 6949, 7519, 7787, 8474, 8632, 8857, 9215, 9420, 9830, 10160, 10595, 11193, 11803, 12175, 12849, 13080, 13179, 13819, 14399, 14557]","[0, 356, 689, 992, 1130, 1548, 2128, 2339, 2584, 2825, 3064, 3265, 3628, 3722, 3871, 4317, 4574, 4977, 5189, 5554, 5648, 5851, 6684, 7020, 7353, 7590, 7685, 7908, 8139, 9130, 9442, 10443, 11360, 11936, 12036]","[0, 169, 259, 395, 564, 762, 947, 1134, 1378, 1859, 2279, 2417, 2653, 2803, 3133, 3612, 3933, 4247, 5069, 5461, 5590, 5948, 6392, 6559, 6729, 6997, 7092, 7315, 7613, 7828, 8111, 8400, 9411, 9991, 10334]",26232,18859,14557,12036,10334,22,29,71,14,26,"[0, 405, 687, 1095, 1538, 1792, 2021, 2651, 3174, 3539, 4088, 4354, 4744, 5525, 5875, 6498, 7168, 7451, 8231, 9421, 10273, 11154, 11705, 11890, 13081, 14731, 15465, 16647, 17217, 18901, 19800, 20403, 20503, 21127, 21407]","[0, 616, 865, 1199, 1661, 1957, 2278, 3006, 3441, 3621, 4143, 4233, 5369, 6024, 6695, 7327, 7713, 8214, 8568, 9047, 9958, 10423, 11081, 11266, 11864, 12787, 13927, 14103, 14620, 15242, 15387, 16266, 16366, 17530, 18782]","[0, 210, 348, 487, 912, 1193, 1328, 1756, 2342, 2564, 3228, 3370, 4225, 5159, 5732, 5917, 6359, 7046, 7750, 8069, 8949, 9666, 10105, 10542, 10836, 11865, 12137, 13036, 13527, 13762, 14430, 15462, 15793, 15893, 16740]","[0, 328, 526, 798, 1306, 1670, 1985, 2415, 2915, 3466, 3978, 4317, 5107, 6027, 6306, 6600, 7171, 7393, 7739, 8646, 8842, 9686, 9893, 10254, 10790, 11585, 11862, 12262, 13044, 13461, 13821, 14403, 14547, 15426, 16772]","[0, 268, 358, 587, 762, 852, 1072, 1388, 1478, 1568, 1703, 1793, 2059, 2606, 2701, 3094, 3298, 3393, 3955, 4607, 4800, 5283, 5520, 6003, 6245, 6743, 7093, 7282, 7734, 8151, 8247, 9079, 9566, 10157, 12200]",21407,18782,16740,16772,12200,4825,77,-2183,-4736,-1866,-3883,35,radiant
7519118314,53,10,20,136,51,"[0, 250, 378, 653, 1061, 1371, 1809, 2009, 2504, 2909, 3633, 4609, 4871, 5506, 5910, 6332, 7103, 7803, 8659, 9407, 9838, 11044, 11523, 11715, 12567, 13391, 14057, 15242, 16241, 16513, 17260, 17937, 19153, 20266, 20814]","[0, 291, 568, 865, 1278, 1721, 2135, 2419, 3015, 3438, 4120, 4761, 5247, 5897, 6445, 6612, 7935, 8931, 9392, 9549, 10334, 11280, 11561, 11731, 12167, 12576, 12973, 13642, 13879, 13975, 14885, 15881, 16802, 17746, 18014]","[0, 239, 368, 723, 1136, 1958, 2287, 2538, 3248, 3515, 3823, 4397, 4870, 5478, 5961, 6191, 6754, 7282, 7930, 8087, 8638, 8993, 9271, 9365, 9795, 10082, 10339, 10532, 11089, 12082, 12632, 13205, 13738, 14549, 14897]","[0, 230, 320, 410, 592, 859, 1012, 1102, 1603, 1783, 2109, 2537, 2786, 3051, 3146, 3240, 3791, 4138, 4634, 4791, 5175, 5531, 5698, 5792, 6069, 6436, 6603, 6845, 7223, 7992, 8410, 8731, 9157, 9585, 9711]","[0, 429, 519, 624, 762, 892, 982, 1072, 1236, 1656, 1881, 2214, 2304, 2681, 2776, 2870, 3208, 3616, 4115, 4272, 4455, 4846, 5160, 5329, 5499, 5836, 6078, 6398, 6840, 7221, 7914, 8362, 8717, 8966, 9141]",20814,18014,14897,9711,9141,48,80,23,112,83,"[0, 209, 450, 657, 851, 1013, 1223, 1708, 1934, 2239, 2655, 2993, 3380, 3974, 4735, 5564, 6105, 6408, 7106, 7887, 8457, 8990, 9649, 10800, 11510, 12298, 13270, 14103, 14996, 15425, 16191, 16647, 17721, 18979, 19631]","[0, 283, 519, 754, 1151, 1543, 1895, 2243, 2471, 2818, 3231, 3726, 4054, 4594, 5065, 5638, 6187, 6778, 7387, 8250, 8376, 8549, 9108, 10143, 10589, 11168, 11726, 12299, 13283, 15128, 15587, 16314, 16757, 16857, 16957]","[0, 243, 515, 768, 1050, 1339, 1854, 2438, 2895, 3453, 4263, 4923, 5538, 6159, 6548, 7133, 7828, 8157, 8839, 9794, 10298, 10774, 11284, 12328, 12771, 13037, 13311, 13792, 14613, 16071, 16388, 16668, 17214, 17396, 17788]","[0, 209, 299, 471, 611, 763, 932, 1022, 1418, 1508, 1839, 2087, 2177, 2794, 2969, 3316, 3411, 3601, 3913, 4647, 5162, 5438, 5706, 6496, 7122, 7716, 8266, 8871, 9312, 9408, 9727, 10007, 10668, 10825, 11054]","[0, 209, 299, 441, 561, 688, 813, 1142, 1232, 1358, 1794, 2004, 2094, 2382, 2571, 2869, 2964, 3225, 3949, 4357, 4482, 4829, 5377, 6060, 6276, 6654, 6977, 7283, 7735, 8399, 8570, 8908, 9414, 9514, 9683]",19631,16957,17788,11054,9683,1183,1057,-2891,-1343,-542,-2536,35,dire
7519190619,65,113,47,136,66,"[0, 367, 695, 1355, 1741, 2154, 3095, 3759, 4336, 4917, 5553, 5973, 7249, 7556, 7968, 8907, 9894, 11184, 11892, 12930, 13503, 14853, 16146, 16958, 17945, 18644, 19619, 20767, 21373, 23177, 24350, 25521, 26651, 28415, 29773]","[0, 257, 541, 791, 1054, 1182, 1545, 2124, 2725, 2992, 3558, 3796, 4198, 4834, 5496, 6057, 7042, 7513, 8285, 8630, 9420, 10255, 11054, 11956, 12819, 13227, 14128, 14678, 14994, 15455, 16166, 17660, 18414, 19614, 20672]","[0, 205, 366, 647, 948, 1287, 1615, 2027, 2209, 2570, 3050, 3459, 3929, 4644, 5062, 5532, 5924, 6435, 6615, 7178, 7454, 7849, 8160, 8422, 9466, 9633, 10055, 10721, 11143, 12063, 12394, 12693, 12989, 13517, 14368]","[0, 170, 260, 578, 668, 805, 940, 1286, 1527, 1769, 1938, 2112, 2413, 2810, 3396, 3887, 4595, 4780, 5350, 5828, 6005, 6494, 6724, 7094, 7330, 7497, 9119, 9568, 9800, 11286, 11789, 12407, 12576, 12676, 13112]","[0, 170, 260, 370, 512, 693, 1174, 1497, 1682, 1968, 2240, 2458, 2724, 3386, 3834, 4240, 4776, 5537, 5667, 6189, 6340, 6925, 7314, 7556, 8024, 8324, 9067, 9435, 9763, 10455, 10784, 11069, 11265, 11725, 12210]",29773,20672,14368,13112,12210,109,93,96,5,85,"[0, 469, 711, 1275, 1481, 1923, 2123, 2462, 2891, 3159, 3483, 4039, 4646, 5022, 5497, 6006, 7084, 7564, 8026, 8592, 9548, 10315, 11388, 12268, 12872, 13744, 13839, 14595, 15820, 17238, 18342, 19468, 20614, 21640, 23455]","[0, 609, 1014, 1215, 1632, 1990, 2300, 2845, 3345, 3861, 4237, 4810, 5302, 6828, 7575, 7983, 8611, 9302, 10115, 10914, 11501, 12022, 12622, 13082, 13487, 14403, 14898, 15642, 16025, 16776, 17194, 17865, 18554, 18919, 19590]","[0, 307, 468, 876, 1052, 1582, 1792, 2065, 2529, 2917, 3119, 3439, 4085, 4584, 5104, 5684, 6009, 6813, 7103, 7756, 8610, 8999, 9369, 9551, 9717, 10069, 10475, 11326, 11502, 11691, 11868, 12625, 13540, 14011, 14800]","[0, 299, 435, 634, 724, 921, 1100, 1253, 1588, 1678, 1860, 2003, 2349, 2978, 3127, 3779, 4083, 4571, 4856, 5076, 5667, 5810, 6499, 6776, 7102, 7658, 7753, 8159, 8537, 8707, 9292, 10275, 10735, 10835, 11369]","[0, 299, 389, 885, 1011, 1187, 1326, 1507, 1695, 1913, 2003, 2201, 2474, 2900, 3135, 3320, 3748, 4068, 4494, 4905, 5152, 5471, 6081, 6381, 6560, 6979, 7132, 7545, 7721, 8230, 8506, 8786, 9308, 9408, 9598]",23455,19590,14800,11369,9598,6318,1082,-432,1743,2612,11323,35,radiant
7519467519,21,25,14,121,51,"[0, 301, 705, 916, 1252, 1578, 2003, 2335, 2977, 3493, 3838, 4013, 4879, 5524, 6118, 6590, 7846, 8222, 9055, 10383, 10778, 11174, 11875, 12959, 13735, 14622, 15414, 16428, 18382, 19368, 19950, 20678, 21569, 22934, 24588]","[0, 298, 493, 827, 1281, 1661, 2384, 2567, 3026, 3377, 4206, 4296, 5116, 5564, 6051, 6615, 7976, 8691, 9148, 9805, 11217, 11365, 11756, 12613, 13513, 14310, 15169, 15373, 16221, 16522, 16916, 17480, 18530, 20170, 21041]","[0, 337, 780, 952, 1288, 1680, 2225, 2803, 3279, 3575, 4197, 4301, 4769, 5223, 5575, 6335, 6917, 7584, 8081, 8593, 9050, 9506, 9601, 10193, 10726, 11170, 11712, 12273, 13056, 13152, 14251, 14848, 15698, 16935, 17335]","[0, 210, 578, 929, 1063, 1318, 1474, 1732, 1867, 2146, 2715, 2805, 3130, 3403, 3634, 3729, 4540, 4770, 5357, 5863, 6321, 6671, 7092, 8328, 8989, 9544, 9907, 10552, 12006, 12177, 12508, 12788, 13573, 15233, 16050]","[0, 210, 300, 390, 480, 570, 705, 840, 982, 1072, 1481, 1692, 1920, 2205, 2390, 2720, 3373, 3603, 3887, 4156, 4842, 4937, 5032, 5752, 6029, 6306, 6638, 7067, 7619, 7715, 8013, 8874, 9084, 10665, 11065]",24588,21041,17335,16050,11065,94,69,80,66,5,"[0, 285, 605, 1052, 1246, 1693, 2027, 2352, 2780, 3079, 3369, 3959, 4339, 5244, 5777, 6410, 6623, 7243, 7802, 8198, 8676, 9279, 9796, 10671, 11195, 11675, 12941, 14021, 14502, 15257, 16684, 16784, 17178, 17810, 19459]","[0, 239, 453, 1023, 1553, 2039, 2275, 2597, 3300, 3805, 4350, 5233, 6016, 6578, 7138, 8108, 8362, 8520, 8816, 9678, 10360, 10455, 10982, 11236, 11460, 12064, 13012, 13715, 13821, 15282, 15825, 16195, 16455, 16611, 17830]","[0, 234, 488, 690, 900, 1274, 1664, 2319, 2692, 3074, 3164, 3891, 4179, 4739, 5496, 5777, 5916, 6193, 6804, 7706, 8063, 8158, 8876, 9450, 10377, 11045, 12015, 12499, 13219, 13617, 14578, 15251, 15386, 15506, 16064]","[0, 199, 289, 443, 552, 751, 958, 1143, 1381, 1624, 1844, 2163, 2481, 2913, 3478, 3857, 4019, 4655, 5235, 5935, 6395, 6784, 7373, 7874, 8119, 8479, 9052, 9146, 9627, 10090, 10186, 10558, 10678, 10812, 11514]","[0, 467, 601, 850, 1076, 1335, 1480, 1697, 2107, 2234, 2756, 3376, 3476, 4103, 4450, 4791, 4885, 5043, 5249, 5700, 6060, 6155, 7049, 7143, 7238, 7567, 7792, 8009, 8928, 9024, 9120, 9220, 9320, 9420, 10129]",19459,17830,16064,11514,10129,5129,3211,1271,4536,936,15083,35,radiant
7519553415,59,76,23,112,20,"[0, 290, 470, 689, 1074, 1586, 2107, 2402, 2791, 3365, 3926, 4456, 4991, 6026, 6844, 7553, 8575, 9614, 10156, 10763, 11306, 11821, 12908, 13444, 13656, 14735, 15221, 16414, 17315, 18626, 18722, 19018, 19318, 20377, 22913]","[0, 209, 467, 841, 1322, 1611, 1967, 2348, 2607, 3097, 3600, 4240, 4749, 5115, 5882, 6443, 7427, 8508, 9242, 9878, 10201, 10831, 11575, 11892, 12711, 12932, 13767, 14780, 15590, 16410, 16954, 17708, 18346, 19296, 19396]","[0, 335, 534, 926, 1211, 1374, 2168, 2378, 3006, 3281, 3605, 4027, 4369, 4865, 5374, 6366, 6895, 7623, 7963, 8057, 8718, 9587, 10338, 11015, 11110, 11742, 12017, 12186, 12883, 13729, 13934, 14352, 14590, 14845, 15951]","[0, 170, 260, 398, 488, 773, 1001, 1164, 1374, 1630, 1950, 2511, 2713, 2979, 3130, 3346, 3922, 4424, 4575, 5085, 5233, 5645, 6093, 6291, 6490, 6920, 7074, 7586, 8035, 8705, 8801, 9326, 9899, 10299, 10937]","[0, 170, 260, 350, 456, 634, 797, 920, 1169, 1779, 1914, 2182, 2272, 2598, 2891, 3082, 3343, 3878, 4057, 4241, 4337, 4664, 5320, 5574, 5958, 6495, 6673, 7221, 8092, 8419, 8515, 8844, 9285, 9656, 10296]",22913,19396,15951,10937,10296,53,106,96,51,5,"[0, 219, 500, 1047, 1425, 1829, 2159, 2350, 2630, 3380, 3821, 4146, 5262, 6071, 6729, 7132, 8120, 8215, 9429, 11706, 12541, 13699, 14251, 15915, 16832, 18140, 18788, 19540, 19741, 21327, 22355, 23537, 24657, 25803, 27188]","[0, 204, 567, 812, 1022, 1301, 1609, 1750, 2673, 2975, 3194, 3581, 3773, 4259, 4649, 4832, 5214, 5309, 6327, 6944, 7240, 8038, 8774, 10096, 10812, 11335, 12023, 12720, 12921, 13614, 14166, 14662, 15151, 15965, 17841]","[0, 206, 529, 978, 1299, 1874, 2217, 2354, 2813, 3155, 3596, 4300, 4970, 5332, 5579, 5927, 6302, 6397, 7289, 8035, 9123, 9572, 10137, 10775, 11300, 11605, 11910, 12491, 12797, 13686, 14387, 14697, 15076, 15996, 17508]","[0, 270, 360, 461, 708, 798, 933, 1200, 1416, 1701, 1879, 2075, 2317, 2504, 2835, 3177, 3763, 3858, 4239, 5045, 5449, 5944, 6329, 7210, 7472, 8289, 8656, 9139, 9826, 10665, 10761, 11529, 11629, 12105, 12330]","[0, 170, 260, 423, 559, 1015, 1443, 1533, 1917, 2142, 2277, 2453, 2543, 2692, 2822, 3170, 3662, 3860, 4540, 4992, 5369, 5773, 6188, 6716, 7047, 7498, 7857, 8137, 8769, 9785, 9953, 10362, 10658, 11315, 11589]",27188,17841,17508,12330,11589,-4275,1555,-1557,-1393,-1293,-6963,35,dire
7519735705,10,39,129,79,83,"[0, 288, 573, 892, 1347, 1620, 2031, 2445, 2706, 3241, 3697, 4533, 4659, 5096, 5433, 5985, 6846, 7696, 8434, 8910, 9488, 9887, 11118, 12156, 12772, 13410, 14358, 14617, 15520, 15661, 15879, 16312, 17657, 19679, 20688]","[0, 290, 543, 797, 1243, 1586, 1919, 2595, 3248, 3692, 4439, 5001, 5091, 5615, 5823, 6149, 6946, 7339, 7905, 8241, 8954, 9458, 9909, 10189, 10639, 11095, 11706, 12226, 12643, 13167, 13822, 14784, 15508, 16275, 17242]","[0, 258, 642, 923, 1335, 1683, 1975, 2391, 2791, 3201, 3558, 4108, 4375, 4739, 4884, 5257, 5763, 5969, 6316, 6603, 6968, 7726, 8094, 8224, 8647, 9080, 10018, 10453, 11034, 11202, 11665, 11765, 12239, 13783, 14578]","[0, 170, 260, 398, 534, 624, 714, 976, 1131, 1269, 1775, 1952, 2277, 2846, 3740, 3935, 4084, 4259, 4811, 4906, 5271, 5544, 5851, 6021, 6422, 6889, 7184, 7425, 7727, 7959, 8252, 8427, 8844, 9601, 10079]","[0, 272, 362, 452, 542, 749, 927, 1151, 1275, 1365, 1455, 1678, 1768, 1907, 2084, 2179, 2488, 2740, 3076, 3171, 3411, 3987, 4154, 4249, 4482, 4625, 4810, 4904, 5382, 5478, 5696, 6065, 6304, 7177, 7869]",20688,17242,14578,10079,7869,113,22,104,86,102,"[0, 260, 505, 883, 1292, 1416, 1883, 2294, 2674, 3092, 3345, 3806, 4842, 5510, 6546, 7155, 7801, 8798, 9474, 10467, 10984, 11770, 12381, 12850, 13911, 14321, 15228, 15791, 16619, 17676, 18463, 19298, 20794, 22303, 23301]","[0, 295, 700, 1023, 1324, 1707, 2149, 2413, 2753, 3045, 3620, 4325, 5623, 6062, 7154, 7558, 8240, 8754, 9144, 9912, 10162, 10737, 11451, 12141, 12835, 13402, 14366, 14872, 15504, 15710, 16647, 17360, 17920, 18373, 18473]","[0, 208, 455, 703, 1033, 1370, 1747, 2063, 2476, 2669, 3145, 3421, 3980, 4798, 5356, 5741, 6112, 6938, 7388, 8117, 8356, 8887, 9170, 9487, 9825, 10313, 10574, 11012, 11576, 12003, 12523, 13300, 13951, 14196, 14382]","[0, 170, 309, 399, 600, 739, 913, 1094, 1231, 1391, 1481, 1822, 2174, 2485, 3002, 3258, 3550, 3834, 4122, 4614, 5099, 5413, 5795, 6242, 6560, 7114, 7483, 7932, 8893, 9257, 9622, 10578, 11399, 11697, 12066]","[0, 170, 262, 398, 576, 701, 1149, 1239, 1329, 1453, 1543, 1633, 2142, 2465, 3137, 3322, 3655, 3956, 4085, 4561, 4789, 4956, 5263, 5430, 5812, 6085, 6289, 6599, 7078, 7404, 7645, 7901, 8291, 8536, 8636]",23301,18473,14382,12066,8636,-2613,-1231,196,-1987,-767,-6402,35,radiant
7520505806,10,120,78,51,26,"[0, 248, 375, 738, 942, 1352, 1647, 2032, 2227, 2944, 3458, 3985, 4924, 5332, 5806, 6261, 6906, 7917, 8646, 9381, 9813, 10610, 11576, 12424, 13149, 13910, 14907, 15569, 16845, 17601, 18558, 18658, 19515, 19856, 21337]","[0, 282, 677, 999, 1374, 2096, 2344, 2577, 3225, 3747, 4608, 4942, 5860, 5991, 6784, 7426, 7760, 8718, 9297, 9966, 11323, 11669, 12244, 12786, 13521, 13998, 14724, 15156, 15871, 16322, 16785, 17195, 18269, 18666, 19761]","[0, 318, 593, 910, 1221, 1555, 1933, 2435, 2952, 3398, 4018, 4519, 4910, 5213, 5990, 6331, 7060, 7700, 8170, 8785, 9044, 9139, 9485, 9725, 10132, 10608, 10933, 11463, 11799, 12081, 12490, 12590, 13274, 13568, 14193]","[0, 210, 348, 484, 574, 774, 864, 1099, 1334, 1606, 2163, 2541, 2922, 3017, 3522, 3662, 4229, 4773, 5040, 5744, 6186, 6356, 6634, 6961, 7445, 7687, 7857, 8333, 8741, 9127, 9516, 9705, 9895, 10072, 10932]","[0, 210, 350, 488, 651, 839, 1022, 1451, 1671, 1943, 2078, 2172, 2424, 2721, 3103, 3333, 3880, 4392, 4831, 5340, 5565, 5660, 5872, 6076, 6470, 6728, 6872, 7150, 7481, 7577, 7694, 7794, 8084, 8184, 8809]",21337,19761,14193,10932,8809,13,41,71,20,68,"[0, 239, 558, 932, 1354, 1630, 2079, 2930, 3395, 3706, 4048, 4497, 5023, 6242, 6408, 7112, 7877, 8133, 8828, 9406, 10055, 10754, 11328, 12218, 12913, 13433, 14111, 14918, 15512, 16148, 16528, 18222, 19102, 19771, 20557]","[0, 164, 444, 684, 853, 1213, 1444, 1900, 2189, 2608, 3177, 4023, 4548, 4923, 5572, 6284, 6942, 7488, 8045, 8560, 8783, 9512, 10156, 10806, 11688, 12201, 12904, 13211, 13882, 14097, 14555, 15902, 16830, 17213, 17702]","[0, 164, 397, 595, 1083, 1250, 1830, 2274, 2613, 2779, 2956, 3385, 3693, 4152, 4617, 5183, 5430, 5920, 6510, 7491, 7834, 8628, 9661, 10306, 11168, 11739, 12118, 12561, 12836, 13146, 14163, 15139, 16047, 17174, 17274]","[0, 130, 402, 492, 746, 870, 1008, 1439, 1750, 1840, 2017, 2161, 2299, 3013, 3526, 3927, 4150, 4335, 4539, 4724, 5015, 5992, 6306, 6610, 6878, 7120, 7372, 7626, 7797, 7968, 8139, 8878, 9340, 9734, 10440]","[0, 130, 220, 310, 445, 535, 640, 805, 985, 1075, 1252, 1576, 1846, 2198, 2458, 2810, 3147, 3332, 3597, 3867, 3961, 4238, 4477, 4706, 4801, 4968, 5063, 5607, 5703, 5834, 5930, 6734, 6912, 7453, 8241]",20557,17702,17274,10440,8241,780,2059,-3081,492,568,818,35,dire
7520694012,81,52,135,20,75,"[0, 328, 652, 1122, 1471, 2040, 2542, 2867, 3411, 3865, 4310, 4715, 5108, 5669, 6187, 6967, 7549, 8308, 9274, 9885, 10585, 11298, 12652, 12992, 13187, 14017, 14331, 14789, 15404, 15647, 15922, 16409, 17002, 17286, 17422]","[0, 331, 718, 1117, 1497, 1815, 2278, 2847, 3517, 4059, 4784, 5120, 5956, 6383, 6774, 7130, 7609, 8154, 8737, 9245, 9744, 10038, 11120, 11476, 11642, 12181, 12735, 13398, 13701, 14116, 14533, 15911, 16011, 16781, 17387]","[0, 292, 495, 789, 1283, 1576, 2238, 2647, 2981, 3621, 4172, 4634, 4949, 5343, 5638, 6154, 6761, 7532, 7983, 8626, 9169, 9612, 10275, 10814, 11268, 11812, 12541, 12748, 12989, 13085, 13387, 14612, 14712, 15381, 15515]","[0, 170, 364, 532, 670, 936, 1300, 1613, 2050, 2287, 2754, 2933, 3509, 3642, 4280, 4375, 4684, 5241, 5523, 5872, 6496, 6696, 7287, 7512, 7678, 7968, 8394, 9202, 9685, 9996, 10137, 10407, 10734, 11149, 11301]","[0, 170, 297, 387, 523, 706, 1040, 1175, 1400, 1619, 1913, 2003, 2676, 3007, 3274, 3609, 3848, 4214, 4496, 5100, 5304, 5714, 6262, 6523, 6796, 7404, 8220, 8315, 8572, 8799, 8945, 9313, 9496, 10044, 10261]",17422,17387,15515,11301,10261,18,42,97,9,101,"[0, 252, 1000, 1394, 1774, 2141, 2423, 2921, 3232, 3776, 4227, 4792, 5522, 6277, 6889, 7794, 8696, 9762, 11034, 11864, 12877, 13533, 14095, 15747, 16177, 16777, 17605, 18020, 20300, 20986, 21512, 23476, 24775, 27116, 28297]","[0, 205, 476, 636, 998, 1207, 1583, 1800, 1924, 2014, 2493, 2915, 3278, 3823, 4307, 4824, 5405, 6153, 6740, 7237, 7805, 8147, 9066, 9842, 10966, 11534, 12031, 12689, 13876, 14743, 15527, 16855, 17615, 18997, 19402]","[0, 279, 442, 721, 1092, 1409, 1851, 2106, 2420, 2944, 3196, 4051, 4452, 5369, 5841, 6376, 6879, 7510, 8134, 8841, 9834, 10437, 10793, 11500, 11837, 12552, 13050, 13199, 14377, 14971, 15068, 15432, 15862, 16357, 16567]","[0, 170, 395, 566, 924, 1379, 1558, 1817, 1971, 2425, 2578, 2858, 3139, 3347, 3610, 3936, 4218, 4670, 4950, 5265, 5640, 5738, 5989, 6597, 7249, 7530, 8015, 8134, 9165, 9367, 9464, 10526, 10826, 11941, 12289]","[0, 170, 364, 454, 814, 904, 1034, 1124, 1752, 2061, 2299, 2479, 2623, 2916, 3367, 3555, 3712, 4071, 4337, 4558, 4832, 5212, 5642, 6389, 6693, 7014, 7495, 7779, 8829, 9081, 9287, 9782, 10345, 11358, 12105]",28297,19402,16567,12289,12105,-10875,-2015,-1052,-988,-1844,-16774,35,dire
7520723202,76,28,71,58,40,"[0, 169, 560, 877, 1075, 1486, 1824, 2340, 2805, 3206, 3808, 4311, 4809, 5331, 5689, 6204, 6935, 7892, 8745, 9303, 10273, 11093, 11687, 11781, 12289, 13133, 14402, 15223, 16041, 16322, 16676, 18854, 20652, 21701, 23476]","[0, 215, 574, 947, 1164, 1652, 2014, 2378, 2739, 3517, 4119, 4508, 5488, 6413, 6834, 7364, 7728, 8093, 8863, 9010, 9278, 10460, 11022, 11389, 11885, 11980, 12891, 13381, 13558, 13925, 14616, 14716, 16065, 17057, 18748]","[100, 299, 603, 864, 1144, 1369, 1672, 2012, 2363, 2920, 3558, 4197, 5027, 5759, 6052, 6610, 7532, 8321, 8812, 9386, 10027, 10632, 11559, 12274, 12440, 13078, 13478, 14274, 14826, 15320, 16313, 16413, 17702, 18169, 18525]","[78, 207, 297, 400, 501, 666, 813, 1409, 1577, 1667, 1941, 2646, 3171, 3851, 4253, 4408, 4841, 5099, 5574, 5781, 6079, 6514, 6895, 7083, 7245, 7722, 8203, 9370, 9775, 9960, 10648, 13241, 13431, 14540, 16123]","[211, 340, 430, 566, 656, 910, 1102, 1272, 1491, 1834, 2358, 2768, 3063, 3726, 4062, 4157, 4314, 4913, 5221, 5316, 5489, 5825, 6226, 6427, 6952, 7080, 7338, 7752, 7929, 8025, 8121, 8929, 9139, 10147, 11160]",23476,18748,18525,16123,11160,10,98,61,79,136,"[62, 271, 509, 819, 1159, 1646, 2238, 2697, 3196, 3536, 3795, 4075, 4514, 5185, 6106, 6477, 7097, 7653, 8162, 8762, 9646, 10453, 11599, 12180, 13021, 14286, 15056, 16859, 17696, 19427, 20973, 23729, 23829, 24464, 24621]","[330, 695, 982, 1393, 1719, 1929, 2436, 2896, 3320, 4060, 4655, 5410, 6237, 6600, 7252, 8106, 8899, 9621, 10473, 11150, 12015, 12868, 13954, 14735, 15786, 17321, 18036, 18723, 18819, 19416, 20640, 22118, 22218, 22624, 22724]","[62, 271, 622, 910, 1228, 1380, 1673, 1838, 2038, 2202, 2414, 2758, 3119, 3451, 4012, 4677, 5329, 6160, 6979, 7683, 8591, 8971, 9429, 10052, 10891, 12203, 12935, 13964, 14159, 15264, 16901, 18016, 18116, 18817, 18917]","[162, 416, 506, 677, 767, 897, 1049, 1236, 1407, 1785, 1905, 2103, 2694, 2989, 3119, 3456, 3814, 4350, 4968, 5126, 5799, 5966, 6771, 7000, 7438, 8173, 8268, 8867, 9325, 10113, 10912, 11924, 12200, 12916, 13016]","[62, 271, 361, 500, 594, 795, 978, 1068, 1158, 1248, 1592, 1812, 2095, 2513, 2784, 2879, 3036, 3221, 3586, 3744, 4172, 4438, 5093, 5482, 6198, 6728, 6823, 7200, 7437, 8153, 9112, 10125, 10225, 10723, 10823]",24621,22724,18917,13016,10823,-1145,-3976,-392,3107,337,-2069,35,dire
7520855809,98,21,96,121,112,"[0, 331, 648, 1142, 1475, 1776, 2314, 2722, 3284, 3586, 4122, 4623, 5076, 5378, 5685, 6449, 6997, 7369, 8177, 9094, 9281, 9816, 10528, 11150, 12435, 13000, 14158, 15032, 15483, 15667, 16253, 16649, 17310, 19048, 19742]","[0, 257, 593, 878, 1228, 1811, 2184, 2606, 2909, 3499, 3751, 4383, 4851, 5061, 5782, 6237, 6512, 6860, 7479, 8258, 8731, 9380, 10059, 10248, 10553, 10772, 11448, 11689, 12490, 12661, 13238, 13698, 14098, 16091, 16679]","[0, 205, 333, 622, 1103, 1324, 1414, 1825, 2145, 2482, 3105, 3406, 3619, 3887, 4421, 5082, 5529, 5998, 6451, 7004, 7435, 7640, 8111, 8680, 9166, 9951, 10045, 10401, 11167, 11714, 12539, 12639, 13077, 13806, 14576]","[0, 218, 308, 398, 567, 703, 835, 925, 1015, 1239, 1491, 1873, 1963, 2093, 2260, 2647, 2833, 2966, 3476, 4060, 4448, 4668, 5186, 5356, 5924, 6296, 6611, 6927, 7364, 7535, 7706, 8069, 8428, 9431, 9776]","[0, 169, 259, 349, 519, 649, 775, 984, 1074, 1164, 1416, 1588, 1810, 1932, 2536, 2720, 2906, 3333, 3760, 3973, 4235, 4510, 4811, 5032, 5320, 5529, 5769, 6010, 7132, 7228, 7324, 7957, 8667, 9396, 9496]",19742,16679,14576,9776,9496,47,61,129,91,26,"[0, 297, 531, 914, 1373, 2018, 2591, 3113, 3702, 4114, 5165, 5584, 6330, 7637, 8241, 9022, 9815, 11084, 11749, 12586, 12807, 13496, 14794, 15880, 16894, 17879, 19178, 19990, 21005, 22183, 22865, 23726, 25172, 25805, 26085]","[0, 169, 414, 816, 1036, 1455, 1747, 2299, 2838, 3384, 3865, 4430, 4861, 5614, 6254, 6575, 7638, 8375, 9051, 10294, 10818, 12154, 12841, 13243, 13940, 14309, 15080, 15986, 16520, 16791, 17427, 19062, 20200, 20481, 21058]","[0, 169, 499, 756, 1343, 1516, 1848, 2052, 2577, 2956, 3436, 3853, 4019, 4878, 5271, 5891, 6121, 6895, 7196, 8011, 8743, 9098, 10157, 10362, 11104, 11480, 11793, 12162, 12535, 13504, 13938, 15116, 16229, 17449, 18709]","[0, 169, 259, 396, 612, 799, 951, 1180, 1363, 1557, 1943, 2131, 2480, 3248, 3404, 3588, 3822, 4349, 4443, 4960, 5256, 5612, 6156, 6937, 7261, 7620, 7924, 8219, 8608, 8854, 9187, 9929, 10709, 10974, 11478]","[0, 169, 277, 415, 576, 666, 764, 944, 1153, 1243, 1489, 1677, 1767, 2281, 2505, 2789, 3020, 3334, 3482, 4271, 4492, 4896, 5269, 5454, 5698, 6150, 6336, 6431, 7072, 7378, 7774, 7985, 8475, 8665, 8945]",26085,21058,18709,11478,8945,-6343,-4379,-4133,-1702,551,-16006,35,dire
7521011714,10,102,59,112,66,"[0, 242, 531, 864, 1188, 1516, 1887, 2300, 2724, 3094, 3641, 4185, 4716, 5603, 6421, 6980, 7562, 8111, 8673, 9100, 9216, 9617, 11300, 11973, 12594, 13359, 13714, 15525, 15621, 16110, 16941, 18329, 18739, 19329, 20693]","[0, 254, 522, 1001, 1351, 1479, 1940, 2262, 2648, 2809, 3334, 3730, 4308, 4728, 5442, 5878, 6108, 6529, 6820, 7277, 7743, 8080, 8899, 9549, 10168, 10650, 11318, 11682, 12403, 13175, 13816, 15186, 16146, 16838, 17872]","[0, 313, 566, 859, 1376, 1836, 2334, 2945, 3246, 3711, 3963, 4635, 5243, 5576, 5848, 6111, 6953, 7160, 7662, 7948, 8173, 8795, 9090, 9316, 9464, 9997, 10789, 11049, 11329, 12678, 13239, 14106, 14817, 14917, 15307]","[0, 207, 297, 818, 1026, 1116, 1297, 1432, 1699, 1835, 2269, 2749, 3062, 3450, 3729, 4032, 4308, 4499, 4801, 4896, 5121, 5372, 5830, 6013, 6448, 6705, 7137, 7415, 8091, 8660, 9184, 10508, 11201, 11790, 12836]","[0, 272, 362, 499, 633, 821, 942, 1178, 1473, 1640, 1974, 2425, 2899, 3071, 3447, 3646, 3876, 4175, 4493, 4733, 5009, 5371, 5877, 6281, 6682, 6841, 7130, 7900, 8391, 8945, 9364, 10152, 10383, 10914, 11602]",20693,17872,15307,12836,11602,44,17,43,71,5,"[0, 205, 630, 921, 1201, 1414, 1577, 1913, 2336, 2865, 3343, 3784, 4330, 4808, 5195, 5696, 6279, 7380, 7959, 8775, 9820, 10594, 11580, 11990, 12924, 13950, 14882, 16314, 16729, 17286, 17762, 18769, 19438, 19849, 20696]","[0, 327, 534, 965, 1215, 1398, 1738, 2000, 2878, 3053, 3538, 4129, 4673, 4994, 5570, 6178, 7053, 8002, 8945, 10509, 11243, 11752, 12318, 12865, 13310, 14010, 14628, 16004, 16511, 16799, 17555, 17992, 18092, 19134, 19234]","[0, 208, 543, 866, 1161, 1439, 1775, 2138, 2818, 3294, 4162, 4676, 5384, 5976, 6682, 7226, 7775, 9022, 9528, 10231, 11296, 11943, 12604, 13490, 14171, 14543, 15005, 15617, 16474, 16570, 16703, 17290, 17598, 18150, 18686]","[0, 170, 365, 542, 769, 859, 962, 1100, 1508, 1873, 2243, 2382, 2582, 2903, 3185, 3431, 3752, 4191, 4491, 5316, 5618, 6102, 6439, 7098, 7448, 8139, 8334, 9078, 9830, 9926, 10326, 10635, 11180, 11331, 11871]","[0, 170, 260, 574, 704, 840, 992, 1131, 1266, 1458, 1835, 1925, 2149, 2930, 3078, 3413, 3748, 4316, 4410, 4568, 5072, 5417, 5749, 6236, 6331, 6569, 6664, 7099, 7611, 8196, 8292, 9049, 9467, 10083, 10588]",20696,19234,18686,11871,10588,-3,-1362,-3379,965,1014,-2765,35,radiant
7521225303,46,49,76,58,26,"[368, 681, 858, 1228, 1579, 1976, 2422, 2675, 3301, 3852, 4455, 5006, 5747, 6165, 6953, 7396, 8201, 8789, 9451, 9898, 10552, 11295, 12256, 12771, 13651, 14162, 14352, 15069, 15579, 16309, 17177, 18258, 19249, 19792, 20349]","[283, 620, 863, 1278, 1488, 1689, 1906, 2355, 2795, 3223, 3899, 4198, 4619, 5196, 5291, 5946, 6597, 7305, 7959, 8878, 9354, 9819, 10359, 11179, 11982, 12470, 13299, 13395, 13741, 14313, 14507, 15170, 15712, 16143, 16714]","[288, 580, 995, 1374, 1730, 2292, 2865, 3138, 3568, 3795, 4149, 4593, 5076, 5332, 5828, 6645, 6921, 7105, 7345, 8106, 8365, 8657, 9201, 9575, 10020, 10218, 10531, 11124, 11220, 11350, 11781, 11971, 12254, 12626, 13671]","[210, 300, 508, 659, 836, 943, 1237, 1468, 1595, 2014, 2228, 2428, 2614, 2725, 2930, 3545, 3767, 4235, 4732, 5208, 5459, 5942, 6387, 6528, 6856, 6951, 7046, 7433, 7691, 8335, 8586, 9062, 9537, 9637, 10153]","[254, 344, 451, 631, 721, 811, 991, 1402, 1536, 1626, 1960, 2280, 2492, 2987, 3290, 3725, 3864, 4764, 5221, 5507, 5737, 5831, 6125, 6265, 6612, 6754, 6849, 7105, 7201, 7457, 7763, 7972, 8161, 8469, 8974]",20349,16714,13671,10153,8974,82,14,69,63,123,"[274, 562, 809, 1103, 1578, 2235, 2540, 3309, 3822, 4471, 5134, 5624, 6209, 7343, 8294, 9156, 10070, 10430, 11184, 11659, 12389, 13155, 14087, 15299, 16117, 17070, 18626, 20078, 20708, 21719, 22273, 23329, 24625, 25055, 25695]","[130, 544, 862, 1095, 1462, 1807, 2462, 2841, 3608, 4177, 4725, 5283, 5824, 6290, 6748, 7482, 8827, 9313, 10402, 11121, 11216, 12197, 13120, 13604, 14783, 15729, 16919, 18119, 19015, 19720, 20896, 22299, 23029, 24270, 24925]","[202, 530, 903, 1131, 1782, 2003, 2663, 3298, 3588, 4350, 4845, 5891, 6481, 7264, 7867, 8695, 9108, 9671, 10749, 11109, 11589, 12272, 12959, 13290, 13925, 14548, 15273, 15859, 16211, 16644, 17478, 18239, 19007, 19527, 20310]","[166, 256, 879, 969, 1186, 1276, 1448, 1647, 1821, 2204, 2316, 2406, 2677, 3205, 3567, 3799, 4021, 4275, 4740, 5423, 5821, 6321, 6887, 7143, 7713, 8127, 9229, 9916, 10464, 10770, 11488, 11838, 11998, 12444, 12803]","[181, 271, 413, 599, 867, 1225, 1360, 1614, 1788, 2035, 2125, 2394, 2794, 3148, 3412, 3631, 3913, 4171, 4653, 5330, 5515, 5957, 6319, 6653, 7116, 7567, 8168, 8578, 8831, 9052, 9353, 10134, 10234, 10931, 11121]",25695,24925,20310,12803,11121,-5346,-8211,-6639,-2650,-2147,-24993,35,dire
7521480417,12,107,21,85,138,"[0, 281, 630, 988, 1483, 1718, 1981, 2071, 2224, 2581, 2769, 3497, 4065, 4595, 5251, 5805, 6428, 7439, 8103, 8565, 8891, 9518, 10204, 10976, 11553, 12148, 12898, 14008, 14610, 14944, 16684, 17908, 18439, 19312, 20317]","[0, 319, 602, 1087, 1448, 1720, 2083, 2483, 2861, 3150, 3361, 3800, 4104, 4532, 5545, 6078, 6873, 7316, 8049, 8443, 9509, 10039, 10609, 11341, 12214, 13177, 13839, 15007, 15637, 16013, 16529, 17218, 18420, 19170, 20043]","[0, 282, 615, 1019, 1485, 1781, 2206, 2964, 3455, 4059, 4488, 5235, 5764, 6372, 7425, 7602, 8604, 9093, 9842, 9937, 10374, 10641, 11054, 11629, 12079, 12208, 12324, 12852, 12970, 13201, 13401, 14394, 15321, 15516, 16607]","[0, 170, 260, 397, 532, 628, 763, 952, 1170, 1471, 1787, 2209, 2299, 2533, 2903, 2998, 3189, 3962, 4153, 4421, 4788, 5407, 5682, 6026, 6509, 6949, 7565, 8232, 8513, 8979, 9634, 10407, 11042, 11526, 11961]","[0, 170, 304, 439, 575, 665, 800, 890, 1141, 1346, 1531, 1999, 2089, 2284, 2941, 3206, 3855, 4607, 4959, 5054, 5211, 5600, 5844, 6157, 6493, 6677, 6867, 7184, 7390, 7928, 8444, 9055, 9532, 9632, 10273]",20317,20043,16607,11961,10273,10,129,137,26,100,"[0, 285, 589, 871, 1395, 1609, 2078, 2609, 2952, 3503, 4137, 4505, 5043, 5563, 6187, 7078, 7771, 8490, 9184, 10056, 10627, 11593, 12371, 13200, 13931, 14708, 15386, 16554, 17379, 18064, 19896, 20702, 21156, 21662, 22123]","[0, 240, 562, 824, 1144, 1468, 1938, 2369, 2622, 3151, 3703, 4308, 4864, 5257, 5538, 6015, 6365, 6771, 7465, 8737, 9516, 9745, 10290, 10930, 11250, 11819, 12360, 12544, 12988, 13904, 14193, 14396, 15347, 15707, 16345]","[0, 170, 420, 741, 996, 1408, 1858, 2717, 3361, 3629, 4248, 4338, 4967, 5489, 6273, 6755, 7181, 7646, 8029, 9306, 9636, 10351, 11436, 11997, 12212, 12838, 13608, 13930, 14216, 14559, 14808, 15626, 16714, 16937, 17037]","[0, 170, 619, 709, 858, 992, 1082, 1513, 1675, 1765, 2023, 2113, 2220, 2413, 2692, 3047, 3292, 3515, 3735, 4239, 4686, 5030, 5354, 5524, 6031, 6273, 6565, 6824, 7275, 7624, 7795, 7970, 8356, 8768, 8958]","[0, 170, 260, 350, 572, 676, 766, 946, 1104, 1251, 1431, 1728, 1818, 2217, 2447, 2640, 2797, 3007, 3156, 3628, 3722, 3892, 4307, 4611, 5090, 5350, 5675, 5997, 6380, 6476, 7048, 7148, 7338, 7597, 7697]",22123,16345,17037,8958,7697,-1806,3698,-430,3003,2576,7041,35,dire
7522292402,1,35,14,22,64,"[0, 286, 662, 1088, 1419, 1782, 2178, 2672, 3693, 4237, 4688, 5139, 5611, 6536, 7296, 7809, 8592, 9207, 10574, 10976, 11609, 12560, 13347, 14064, 15219, 16187, 17118, 17935, 18138, 18608, 19028, 20546, 20890, 22158, 22410]","[0, 360, 770, 1170, 1570, 2010, 2478, 2990, 3470, 4110, 4633, 5258, 5725, 6471, 7252, 8035, 8784, 9293, 9920, 10718, 11678, 12445, 13299, 14191, 15109, 16251, 16577, 16745, 17145, 17241, 17795, 18606, 19106, 20047, 20220]","[0, 331, 638, 967, 1413, 1835, 2257, 2620, 2981, 3548, 4024, 4187, 4703, 5467, 6091, 6545, 7221, 7839, 8327, 9074, 9439, 10162, 11730, 12131, 12639, 13014, 13954, 14632, 14867, 14963, 16078, 17248, 17721, 17821, 17921]","[0, 210, 330, 475, 748, 949, 1086, 1242, 1528, 1752, 1971, 2477, 2629, 3112, 3387, 3904, 4062, 4203, 4380, 4750, 5206, 5668, 6062, 6456, 7588, 7960, 9161, 9325, 9503, 9906, 10105, 10371, 11214, 11861, 12035]","[0, 210, 300, 492, 601, 754, 864, 954, 1044, 1273, 1497, 1622, 1712, 1997, 2200, 2591, 2749, 2843, 3408, 3677, 4024, 4328, 4756, 5126, 5471, 5713, 6604, 6989, 7209, 7380, 7708, 8405, 8870, 9045, 9220]",22410,20220,17921,12035,9220,44,11,129,84,86,"[0, 167, 535, 862, 1190, 1486, 1950, 2325, 2747, 3027, 3439, 4058, 4715, 5362, 5908, 6773, 7482, 8255, 8942, 9713, 10471, 11354, 12114, 13043, 13938, 14641, 15358, 15453, 17057, 18152, 18920, 20678, 20868, 22184, 23706]","[0, 286, 617, 1062, 1452, 1951, 2521, 3074, 3877, 4620, 5175, 5727, 6455, 7273, 7948, 8043, 8780, 9507, 10221, 11118, 11680, 12231, 13609, 14594, 15557, 16085, 16820, 16988, 18303, 19505, 20537, 21284, 22852, 23336, 24680]","[0, 203, 444, 802, 1178, 1622, 1903, 2547, 2916, 3237, 3604, 4137, 4761, 5217, 5690, 6351, 6606, 7256, 7712, 7981, 8280, 8973, 9739, 9962, 10091, 10186, 10979, 11380, 12061, 13047, 13378, 13765, 14183, 14283, 15205]","[0, 130, 220, 366, 502, 592, 729, 897, 1032, 1122, 1212, 1348, 1600, 1694, 1872, 2119, 2214, 2462, 2845, 3045, 3444, 3907, 4154, 4659, 4753, 5257, 5352, 5757, 6774, 7164, 7839, 8045, 9197, 9297, 9917]","[0, 130, 220, 310, 400, 490, 580, 764, 928, 1103, 1275, 1742, 1994, 2170, 2265, 2601, 2944, 3334, 4135, 4230, 4658, 4753, 4848, 5033, 5310, 5405, 6578, 6673, 7310, 7658, 7989, 8089, 8760, 8860, 9541]",23706,24680,15205,9917,9541,-1296,-4460,2716,2118,-321,-1243,35,radiant
7522384400,95,137,110,97,101,"[0, 262, 575, 803, 1278, 1877, 2253, 2433, 2907, 3359, 3874, 4400, 4978, 5459, 5858, 5952, 6967, 7938, 8930, 9582, 10243, 11650, 12628, 13587, 14921, 15748, 16477, 17593, 18767, 19643, 21057, 22546, 23305, 24216, 25202]","[0, 158, 317, 558, 801, 1069, 1438, 1892, 2661, 2838, 3312, 3501, 3591, 4391, 5209, 5389, 6617, 7085, 7820, 8585, 8849, 9479, 10296, 10792, 11226, 11507, 12280, 12667, 13349, 13742, 15122, 15899, 16466, 16808, 17303]","[0, 434, 524, 614, 783, 1179, 1364, 1746, 1836, 2051, 2322, 2558, 2806, 3301, 3666, 4018, 4949, 5306, 6002, 6183, 6370, 6911, 7410, 7851, 8378, 9072, 9428, 9897, 10554, 10746, 12070, 12799, 13068, 13710, 14658]","[0, 169, 520, 819, 1477, 1768, 2135, 2453, 2852, 3219, 3473, 3775, 4091, 4807, 5258, 5352, 6582, 6852, 7037, 7840, 8187, 8825, 9226, 9995, 10425, 11098, 11192, 11772, 12228, 12469, 13591, 14281, 14516, 14850, 15165]","[0, 311, 401, 491, 850, 1168, 1393, 1573, 1849, 2074, 2345, 2789, 2924, 3317, 3446, 3540, 4526, 4711, 4896, 5227, 5322, 6051, 6452, 7106, 7201, 7600, 7694, 7789, 8245, 8437, 8874, 9771, 10006, 10106, 10601]",25202,17303,14658,15165,10601,25,28,135,86,26,"[381, 673, 968, 1446, 1728, 2117, 2523, 3134, 3503, 4097, 4389, 4867, 5373, 5678, 6271, 7202, 7440, 8159, 9114, 9581, 10060, 10229, 10786, 11519, 12025, 13183, 13899, 14427, 15430, 15995, 16091, 17169, 18513, 19472, 20325]","[246, 565, 850, 1227, 1471, 1969, 2365, 2924, 3419, 3972, 4692, 5245, 5937, 6415, 7266, 8316, 8484, 8685, 9796, 10246, 10884, 11434, 12165, 12259, 12728, 13560, 14343, 14784, 15226, 15446, 15542, 15920, 17315, 18373, 19227]","[113, 356, 609, 847, 1025, 1199, 1475, 1982, 2397, 3013, 3442, 3962, 4664, 5199, 5627, 6598, 7126, 7384, 7869, 8418, 8892, 9198, 10059, 10391, 10678, 11290, 12032, 12412, 12752, 12903, 12999, 13308, 14121, 14739, 15246]","[113, 322, 412, 589, 679, 851, 976, 1503, 2322, 2535, 2888, 3126, 3306, 3800, 4168, 4531, 4726, 4971, 5500, 5594, 5794, 5889, 6522, 6973, 7469, 7975, 8204, 8639, 8998, 9266, 9399, 9721, 9995, 10809, 11305]","[113, 322, 412, 635, 770, 860, 950, 1220, 1518, 1733, 1978, 2305, 2541, 2744, 3250, 3794, 3986, 4128, 4738, 4832, 5032, 5152, 5610, 5763, 6014, 6432, 6682, 6852, 7133, 7304, 7475, 7905, 8229, 8985, 9823]",20325,19227,15246,11305,9823,4877,-1924,-588,3860,778,7003,35,radiant
7522545002,93,47,110,20,14,"[0, 243, 708, 1421, 1631, 2209, 2632, 2874, 3125, 3502, 3997, 5016, 5342, 6086, 6824, 7451, 7929, 9009, 9928, 10791, 11395, 11894, 12126, 12922, 13555, 14274, 14619, 15114, 16413, 16509, 17651, 18948, 20357, 21197, 22574]","[0, 583, 819, 1080, 1411, 1647, 1811, 2015, 2563, 2927, 3354, 3698, 4228, 4688, 5081, 5321, 5660, 5966, 6366, 6672, 7025, 7120, 7340, 7732, 8198, 8583, 8723, 8817, 9660, 9931, 10272, 10760, 12030, 12757, 12947]","[0, 170, 369, 459, 549, 639, 831, 921, 1101, 1514, 2538, 2899, 3034, 3335, 3883, 4064, 4537, 4833, 5371, 5730, 5913, 6199, 6328, 6718, 6915, 7100, 7394, 7624, 9191, 9590, 10033, 10690, 11410, 12206, 12396]","[0, 277, 690, 1059, 1257, 1458, 1548, 1757, 2143, 2347, 2714, 2980, 3382, 3796, 3977, 4172, 4623, 4992, 5302, 5629, 5905, 6000, 6190, 6565, 6846, 7031, 7126, 7370, 8223, 8747, 9177, 9867, 10657, 10847, 11252]","[0, 239, 532, 874, 1035, 1222, 1395, 1485, 1795, 1984, 2361, 2541, 3148, 3351, 3646, 4186, 4491, 4649, 5003, 5206, 5405, 5506, 5685, 6319, 6414, 6599, 7114, 7375, 8017, 8288, 8384, 8754, 9946, 10635, 10825]",22574,12947,12396,11252,10825,25,29,70,27,121,"[0, 222, 592, 924, 1316, 1813, 2531, 3073, 3755, 4175, 4419, 4763, 5279, 5664, 6673, 6842, 7766, 8162, 8739, 9472, 9766, 10896, 12774, 13467, 14280, 14843, 16347, 17127, 18401, 19889, 20326, 21322, 22369, 23494, 24469]","[0, 241, 478, 1014, 1311, 1514, 1812, 2490, 3043, 3714, 4319, 4556, 4923, 5495, 5886, 6297, 6928, 8345, 9021, 9449, 9965, 10493, 11025, 11682, 12424, 12993, 13980, 14383, 14891, 15194, 15631, 16204, 16466, 17062, 17252]","[0, 244, 668, 871, 1281, 1516, 1985, 2253, 2795, 2968, 3218, 3523, 4220, 4809, 5432, 5798, 6387, 6769, 7273, 7811, 8487, 9518, 9865, 10366, 10914, 11200, 12465, 12813, 13170, 13459, 13799, 14121, 14381, 14662, 15024]","[0, 272, 379, 560, 690, 780, 915, 1054, 1198, 1329, 1554, 1644, 1778, 2016, 2692, 2794, 2928, 4044, 4145, 4460, 4844, 5814, 6166, 6526, 6790, 7078, 7653, 7933, 8318, 8414, 8559, 8818, 9055, 9380, 9629]","[0, 170, 462, 768, 943, 1072, 1345, 1505, 1731, 1857, 2082, 2172, 2409, 2656, 3108, 3340, 3679, 4410, 4666, 5351, 5665, 6195, 6475, 6617, 6847, 7052, 7582, 7877, 8466, 8820, 9100, 9485, 9781, 9904, 10185]",24469,17252,15024,9629,10185,-1895,-4305,-2628,1623,640,-6565,35,dire
7522558918,39,21,15,100,20,"[330, 578, 827, 1078, 1586, 2128, 2703, 3475, 4134, 4722, 5958, 6448, 7200, 7999, 8698, 9522, 10103, 10849, 11199, 11860, 12615, 13714, 14201, 15083, 15249, 16055, 17092, 17761, 18510, 19118, 19996, 20720, 21728, 22878, 23505]","[62, 389, 938, 1234, 1805, 2182, 2506, 3101, 3841, 4517, 5242, 5884, 6064, 7163, 8056, 8363, 9138, 9681, 9952, 10173, 10423, 12008, 12747, 12946, 13509, 14394, 15756, 16704, 17369, 18252, 18490, 19071, 19487, 20377, 21262]","[62, 392, 775, 984, 1510, 1854, 2119, 2598, 3015, 3745, 4238, 5597, 6010, 6896, 7270, 7829, 8529, 8948, 9568, 10392, 10984, 11265, 11857, 12516, 13265, 13662, 14741, 15610, 15706, 16374, 16953, 17188, 18080, 19823, 20193]","[62, 272, 423, 513, 681, 851, 941, 1381, 1597, 1745, 2174, 2354, 2534, 3160, 3507, 3719, 4183, 4977, 5072, 5293, 5522, 5985, 6400, 6777, 6943, 7139, 7758, 8355, 8598, 8886, 9524, 9795, 9985, 10612, 11057]","[62, 272, 362, 486, 647, 1020, 1110, 1270, 1415, 1641, 1876, 2121, 2446, 3026, 3337, 3757, 3961, 4480, 4623, 4844, 5073, 5440, 5764, 5911, 6077, 6502, 7168, 7717, 7962, 8250, 8441, 8676, 8905, 9049, 9419]",23505,21262,20193,11057,9419,90,102,29,112,121,"[0, 312, 596, 855, 1028, 1290, 1747, 2088, 2419, 2672, 2925, 3015, 3789, 4084, 4464, 4948, 5372, 6951, 8236, 8948, 9143, 9495, 9791, 10373, 11992, 12778, 12873, 13375, 14057, 14646, 15280, 15796, 16276, 16985, 19481]","[0, 193, 513, 972, 1311, 1593, 1844, 2204, 2342, 2611, 3139, 3575, 4242, 4951, 5142, 5695, 5894, 6278, 7535, 8168, 8532, 9391, 9671, 10330, 11162, 11987, 12082, 12177, 13632, 14147, 15467, 16417, 17339, 19163, 19353]","[0, 155, 436, 732, 1012, 1272, 1362, 1542, 1677, 1767, 2140, 2419, 2806, 3163, 3386, 3615, 3973, 4717, 5529, 5960, 6231, 6656, 7055, 8104, 8699, 9312, 9407, 9588, 9954, 10050, 10146, 10775, 11094, 12060, 13961]","[0, 155, 245, 335, 425, 515, 605, 785, 875, 965, 1182, 1571, 1661, 1966, 2061, 2290, 2471, 3130, 4740, 5278, 5428, 5919, 6067, 6652, 7472, 7754, 7924, 8146, 8920, 9091, 10054, 10794, 10969, 11354, 11619]","[0, 155, 291, 451, 649, 874, 1013, 1278, 1554, 1726, 2116, 2378, 2821, 2996, 3146, 3428, 3557, 3983, 4757, 4915, 5279, 5499, 5858, 6230, 6678, 7033, 7128, 7428, 8309, 8533, 9048, 9449, 9549, 10023, 10600]",19481,19353,13961,11619,10600,4024,1909,6232,-562,-1181,10422,35,radiant
7522585414,65,48,23,58,112,"[0, 295, 466, 957, 1255, 1782, 2334, 2918, 3661, 4163, 4726, 5616, 6331, 6688, 7566, 7711, 8611, 9283, 10609, 11295, 12299, 13392, 13486, 14456, 14942, 16482, 16751, 17731, 18797, 20072, 20982, 21613, 22838, 23891, 24806]","[0, 322, 566, 817, 1210, 1385, 1674, 1800, 2036, 2308, 2890, 3386, 4076, 4605, 5356, 5931, 6717, 7281, 8067, 8806, 9966, 10602, 11316, 12273, 12893, 13988, 14082, 14425, 14969, 15969, 16926, 17556, 18545, 18645, 19365]","[0, 254, 447, 696, 977, 1477, 2034, 2218, 2845, 3157, 3429, 3846, 4282, 4559, 5211, 5716, 6195, 6738, 7159, 7830, 8503, 8890, 10119, 10516, 10995, 11434, 11528, 11638, 12230, 12705, 13206, 13482, 14745, 14845, 15224]","[0, 169, 363, 536, 889, 1026, 1436, 1777, 1903, 1993, 2253, 2347, 2840, 2935, 3097, 3321, 3639, 3759, 4818, 5223, 6187, 6511, 7076, 7473, 7598, 8152, 8674, 8995, 9149, 9420, 10050, 10460, 11040, 11140, 11490]","[0, 169, 294, 384, 518, 741, 1003, 1187, 1389, 1838, 2235, 2502, 2706, 2801, 3160, 3341, 3637, 3779, 4627, 4933, 5686, 5883, 6762, 7522, 7617, 7800, 8069, 8439, 8535, 8829, 9384, 9835, 10607, 10707, 10807]",24806,19365,15224,11490,10807,54,21,20,136,45,"[0, 251, 566, 911, 1186, 1585, 2022, 2530, 3008, 3431, 3925, 4346, 4778, 5047, 5863, 6273, 7081, 7597, 8025, 8883, 9616, 10318, 11055, 11550, 12306, 13697, 14719, 15742, 16439, 17321, 17577, 18650, 19635, 19870, 21164]","[0, 303, 702, 1026, 1358, 1814, 2360, 2766, 3353, 4114, 4672, 5256, 5756, 6184, 7049, 7860, 8540, 9214, 9418, 10013, 10307, 10554, 11948, 12152, 12778, 13651, 14412, 15071, 15908, 16543, 17100, 17290, 18808, 19472, 20007]","[0, 542, 791, 1313, 1713, 2108, 2522, 3206, 3931, 4681, 5175, 5524, 5823, 6215, 6666, 7007, 7469, 7850, 8267, 8894, 9303, 9648, 10171, 10811, 11237, 12411, 13132, 13890, 14980, 15224, 15320, 15886, 17075, 17615, 18136]","[0, 238, 328, 519, 1195, 1367, 2048, 2235, 2588, 2901, 3219, 3367, 4023, 4234, 4472, 4567, 5608, 5752, 5846, 6067, 6242, 6367, 6533, 6737, 6832, 7564, 7997, 9204, 9543, 9639, 9773, 9963, 10752, 10987, 11383]","[0, 169, 309, 429, 519, 653, 872, 996, 1131, 1303, 1647, 1945, 2295, 2768, 3006, 3421, 4020, 4423, 4627, 5448, 5804, 5899, 6065, 6160, 6366, 6828, 7143, 7734, 8175, 8346, 8799, 9100, 10520, 10912, 11192]",21164,20007,18136,11383,11192,3642,-642,-2912,107,-385,-190,35,dire
7522659008,25,74,23,102,45,"[0, 284, 679, 1093, 1541, 2179, 2470, 2946, 3516, 3944, 5308, 5961, 6622, 7458, 8703, 9659, 10252, 10678, 11199, 11703, 12077, 12793, 14278, 15086, 15859, 16889, 17794, 18222, 18987, 19646, 20451, 22311, 22411, 22703, 23526]","[0, 169, 366, 728, 1002, 1457, 1781, 2225, 2641, 3007, 3695, 4319, 4914, 5286, 5886, 6422, 6580, 7306, 8476, 8704, 9697, 10417, 10943, 12312, 12767, 13330, 13870, 14135, 14849, 15331, 15795, 16492, 17297, 18395, 19581]","[0, 244, 585, 1148, 1276, 1705, 1839, 2043, 2391, 2597, 2948, 3338, 3517, 4105, 4729, 5374, 5996, 6176, 6489, 6813, 7108, 7604, 8130, 8449, 9101, 9614, 10141, 10236, 10362, 10801, 11098, 12941, 13041, 13370, 13825]","[0, 169, 284, 422, 530, 926, 1071, 1249, 1347, 1519, 2147, 2417, 2575, 2775, 3245, 3578, 3825, 3920, 4114, 4208, 4420, 4866, 5842, 6130, 6711, 7149, 7338, 7508, 7679, 8023, 8352, 9202, 9377, 9529, 9882]","[0, 219, 334, 569, 721, 873, 963, 1444, 1534, 1671, 2187, 2608, 2794, 2889, 3391, 3718, 3973, 4235, 4429, 4549, 4819, 5084, 5962, 6129, 6333, 6500, 6705, 6898, 6994, 7531, 7762, 8459, 8615, 8946, 9299]",23526,19581,13825,9882,9299,52,76,14,71,79,"[58, 349, 725, 1098, 1467, 1882, 2228, 2781, 3214, 3422, 3588, 4348, 4609, 5717, 6397, 7246, 8394, 9753, 10048, 11186, 12127, 12638, 13112, 14169, 14962, 15620, 16652, 17187, 18224, 19235, 19488, 20832, 22341, 23245, 24482]","[326, 533, 893, 1179, 1481, 1853, 2172, 2699, 3154, 3833, 4067, 4365, 4833, 5232, 6000, 6664, 7626, 8690, 9310, 10635, 11680, 12594, 12770, 13310, 13946, 14864, 15827, 16321, 17504, 17856, 18308, 18527, 19273, 20170, 21117]","[58, 227, 395, 707, 1158, 1322, 1537, 2317, 2653, 2861, 3196, 3750, 4219, 4562, 4949, 5276, 5869, 6908, 7273, 8266, 8944, 9344, 9536, 9997, 10216, 10537, 10874, 11080, 11438, 11993, 12089, 12422, 13441, 14300, 14847]","[58, 227, 317, 407, 581, 711, 849, 1087, 1286, 1483, 1814, 2112, 2448, 2723, 2818, 3020, 3742, 4264, 4359, 5162, 5659, 5926, 6073, 6321, 6750, 7363, 7875, 8079, 8580, 8917, 9033, 9983, 11275, 12038, 12365]","[58, 227, 317, 407, 584, 714, 823, 1148, 1283, 1373, 1463, 1679, 2016, 2586, 2964, 3166, 3690, 3878, 4141, 4827, 5385, 5692, 6045, 6495, 6738, 7091, 8020, 8239, 9009, 9261, 9389, 9722, 10550, 10987, 11177]",24482,21117,14847,12365,11177,-956,-1536,-1022,-2483,-1878,-7875,35,radiant
7522961618,25,95,104,128,51,"[0, 204, 539, 783, 1242, 1610, 1936, 2581, 2882, 3342, 4334, 4652, 5043, 5902, 6823, 7088, 8223, 8929, 9971, 10477, 11049, 11584, 12286, 12656, 13281, 14900, 15423, 15919, 16677, 18451, 19216, 19623, 20317, 20588, 21005]","[0, 285, 488, 816, 1187, 1518, 2078, 2474, 2932, 3480, 3660, 4132, 4641, 5026, 5671, 6289, 7147, 7856, 8362, 9145, 9813, 10771, 11458, 12263, 12415, 13010, 13565, 13772, 14052, 15000, 15423, 16261, 16361, 17385, 18476]","[0, 295, 424, 879, 1155, 1281, 1571, 1698, 1833, 2213, 2491, 2791, 3174, 3555, 3918, 4086, 4785, 5550, 6734, 7080, 7174, 7449, 7697, 7909, 8085, 8677, 8862, 9048, 9476, 9827, 10092, 10423, 10523, 11001, 11440]","[0, 169, 276, 366, 536, 715, 850, 940, 1075, 1630, 2009, 2201, 2291, 2657, 3169, 3264, 4027, 4408, 4612, 4852, 4946, 5461, 5730, 5941, 6035, 6921, 7016, 7213, 7309, 7747, 7843, 8184, 8595, 8949, 9362]","[0, 169, 259, 349, 538, 719, 898, 988, 1123, 1561, 1741, 2064, 2154, 2458, 3149, 3254, 3541, 3965, 4368, 4680, 4774, 5321, 5416, 5622, 5821, 6321, 6416, 6510, 6651, 7142, 7238, 7338, 7438, 7538, 7818]",21005,18476,11440,9362,7818,10,74,129,85,121,"[0, 253, 690, 1216, 1806, 2644, 3167, 3734, 4436, 4720, 5396, 6009, 6547, 6921, 7499, 8184, 8485, 8751, 9550, 10369, 11230, 13009, 13884, 15443, 16702, 17562, 18142, 19552, 20734, 21517, 22361, 23916, 24323, 25157, 25984]","[0, 240, 376, 703, 993, 1289, 1611, 1953, 2494, 2906, 3295, 3842, 4409, 4953, 5260, 5908, 6357, 6515, 7367, 8220, 8623, 9457, 10225, 10666, 11766, 12293, 13077, 13927, 14667, 15396, 16353, 17032, 17588, 18816, 19672]","[0, 203, 516, 759, 1094, 1307, 1681, 1987, 2411, 2890, 3769, 4277, 4747, 5274, 5631, 5993, 6499, 6859, 7462, 7759, 8649, 8910, 9656, 10507, 11188, 12258, 12633, 13124, 13821, 14160, 14505, 15111, 15211, 15729, 16091]","[0, 169, 259, 422, 681, 980, 1074, 1276, 1456, 1657, 2022, 2285, 2528, 2773, 2922, 3092, 3582, 3864, 4164, 4407, 4780, 5093, 5378, 6299, 6833, 7672, 8014, 8453, 8969, 9237, 9412, 9869, 10328, 10603, 10793]","[0, 169, 259, 349, 487, 577, 667, 864, 1044, 1201, 1626, 1855, 2053, 2495, 2819, 3002, 3303, 3500, 3970, 4206, 4426, 4859, 5155, 5601, 6143, 6970, 7202, 7747, 8181, 8495, 8788, 9338, 9752, 10248, 10513]",25984,19672,16091,10793,10513,-4979,-1196,-4651,-1431,-2695,-14952,35,dire
7523717218,48,74,129,96,26,"[0, 252, 566, 880, 1161, 1521, 2010, 2518, 2987, 3526, 4069, 4698, 5344, 6018, 6815, 7404, 8184, 9544, 10428, 11761, 12524, 14011, 14550, 15470, 16012, 16959, 18048, 19005, 20223, 21880, 22581, 23572, 24764, 25039, 26074]","[0, 245, 536, 898, 1629, 2009, 2726, 3271, 3415, 3695, 4125, 4314, 4737, 5235, 5527, 6132, 6473, 6928, 7587, 8061, 8617, 9352, 9597, 10052, 10487, 11205, 11877, 12223, 12783, 13503, 13636, 14420, 15309, 16183, 16684]","[0, 285, 592, 831, 1254, 1434, 1673, 2131, 2447, 2905, 3190, 3705, 4118, 4649, 4919, 5203, 5827, 6520, 6775, 7157, 7474, 8019, 8272, 8434, 8690, 9104, 10193, 10619, 11100, 11952, 12289, 12590, 13078, 13656, 14042]","[0, 170, 260, 395, 525, 664, 992, 1417, 1507, 1597, 1918, 2342, 2559, 2980, 3413, 3987, 4245, 4645, 4982, 5364, 5661, 6340, 6567, 6918, 7084, 7896, 8652, 8793, 9472, 10017, 10166, 10266, 10714, 10923, 11203]","[0, 170, 260, 350, 528, 618, 754, 1071, 1330, 1549, 1684, 1873, 2139, 2317, 2507, 2983, 3562, 4054, 4246, 4628, 4798, 5088, 5258, 5578, 5854, 6256, 6812, 7110, 7445, 8037, 8167, 8329, 8780, 9000, 9324]",26074,16684,14042,11203,9324,46,17,69,20,45,"[0, 256, 525, 936, 1266, 1663, 2064, 2414, 2940, 3520, 4225, 4824, 5244, 6138, 6875, 7648, 8438, 8984, 9739, 11409, 12236, 12731, 13111, 13785, 14810, 15463, 16377, 17110, 17843, 18463, 19929, 20571, 22754, 23303, 24046]","[0, 355, 559, 848, 1081, 1304, 1745, 1997, 2468, 3057, 3412, 3930, 4286, 4848, 5706, 6296, 6638, 7415, 7807, 8635, 9305, 10335, 11253, 12035, 12509, 13201, 13296, 13726, 14632, 14818, 15854, 16628, 17123, 17426, 18219]","[0, 170, 402, 529, 973, 1295, 1618, 1960, 2095, 2377, 2759, 3195, 3550, 4133, 4572, 5086, 5636, 5977, 6774, 7593, 8073, 8419, 8788, 9567, 10045, 10557, 11273, 11956, 12779, 13326, 14208, 14962, 16986, 17708, 18141]","[0, 170, 260, 471, 787, 927, 1027, 1248, 1657, 2015, 2251, 2462, 3056, 3361, 3745, 4248, 4710, 4950, 5173, 6122, 6291, 6477, 6822, 7217, 7672, 7998, 8201, 8522, 8804, 9239, 9934, 10034, 11975, 12165, 12529]","[0, 259, 400, 577, 770, 956, 1046, 1136, 1348, 1571, 1708, 2043, 2312, 2661, 2939, 3251, 3439, 3623, 4223, 5044, 5139, 5431, 5526, 5765, 6314, 6879, 7273, 7812, 8147, 8639, 9853, 10127, 10922, 11190, 11944]",24046,18219,18141,12529,11944,2028,-1535,-4099,-1326,-2620,-7552,35,radiant
7523787713,78,41,76,105,110,"[229, 566, 805, 1289, 1604, 1778, 2081, 2334, 2598, 2932, 3398, 3901, 4355, 4449, 4715, 5260, 5913, 6311, 6814, 7443, 7952, 8118, 8801, 9323, 9597, 10335, 10875, 11734, 12632, 13134, 13847, 14350, 14726, 15883, 16487]","[168, 576, 824, 1310, 1552, 2062, 2616, 3070, 3593, 3909, 4188, 4619, 4942, 5236, 5616, 6024, 6496, 7071, 7398, 7912, 8502, 9190, 10101, 10563, 10995, 12172, 13223, 13945, 14993, 15465, 15987, 17027, 18386, 19098, 19616]","[300, 461, 840, 1156, 1448, 2000, 2259, 2682, 3091, 3510, 3978, 4305, 4740, 5139, 5566, 5796, 6228, 6731, 7096, 7675, 8039, 9042, 9412, 9876, 9970, 10609, 11405, 11778, 12283, 12838, 13569, 14260, 15079, 15715, 16457]","[193, 283, 420, 796, 886, 1072, 1532, 1693, 1938, 2028, 2212, 2302, 2450, 2556, 2675, 2981, 3116, 3578, 3723, 4040, 4766, 5188, 5549, 5927, 6096, 6706, 7387, 7779, 7950, 8668, 8941, 9451, 10011, 10557, 10866]","[461, 551, 641, 820, 910, 1000, 1348, 1748, 1838, 1984, 2210, 2554, 2974, 3323, 3589, 4324, 4654, 5090, 5504, 5973, 6339, 6679, 7309, 7776, 8031, 8689, 9755, 10260, 11641, 11995, 12170, 12552, 13058, 13806, 14340]",16487,19616,16457,10866,14340,10,120,129,128,51,"[245, 556, 1046, 1565, 1959, 2460, 2977, 3559, 4032, 4579, 5262, 5832, 6561, 7257, 7778, 8824, 9592, 10279, 10761, 11599, 12363, 12809, 13536, 14408, 15145, 15961, 16137, 17174, 18083, 19099, 19528, 19972, 20468, 21602, 22612]","[291, 580, 929, 1252, 1574, 1827, 2136, 2620, 3096, 3662, 4313, 4706, 5314, 6155, 6818, 7427, 8042, 8885, 9640, 10597, 11141, 12089, 12527, 13347, 14180, 14801, 15697, 16418, 17104, 17794, 18368, 19977, 20740, 21618, 21808]","[248, 549, 812, 1049, 1338, 1647, 1943, 2340, 2559, 2990, 3295, 3851, 4239, 4768, 5580, 6336, 7010, 7637, 7982, 8535, 8888, 9708, 10201, 10835, 11398, 11810, 12131, 12840, 13551, 13647, 13843, 14404, 14889, 15282, 15951]","[210, 325, 450, 580, 736, 874, 1058, 1193, 1283, 1556, 1695, 2075, 2387, 2717, 3203, 4185, 4739, 5063, 5911, 6523, 7176, 7547, 7824, 8600, 9324, 10126, 10782, 11141, 11354, 11753, 12016, 12555, 13053, 13445, 13929]","[210, 325, 415, 591, 711, 817, 1174, 1309, 1399, 1740, 1874, 2284, 2615, 3034, 3399, 3780, 4238, 4737, 5341, 5589, 6247, 6476, 6829, 7303, 8141, 8674, 9182, 9564, 10065, 10771, 11223, 11882, 12154, 12482, 13076]",22612,21808,15951,13929,13076,-6125,-2192,506,-3063,1264,-9610,35,dire
7524037914,46,14,92,5,51,"[0, 206, 655, 1007, 1422, 1923, 2351, 2812, 3369, 3772, 4385, 4975, 5155, 5614, 6003, 6605, 7641, 8273, 8720, 9131, 9545, 10253, 11250, 11815, 12432, 13040, 13348, 14440, 15374, 16125, 16481, 18138, 18481, 18864, 19808]","[0, 218, 466, 678, 1140, 1676, 1964, 2217, 2656, 3121, 3304, 4429, 4940, 5589, 6420, 6769, 7088, 7856, 8578, 9040, 9513, 10232, 11169, 11798, 12345, 12772, 13420, 13780, 15177, 15354, 16058, 17073, 17460, 18113, 18759]","[0, 169, 464, 677, 1224, 1348, 1628, 1885, 2045, 2542, 2863, 3339, 3519, 4073, 4549, 5142, 5847, 6639, 7267, 7905, 8114, 8717, 9370, 9895, 10402, 10593, 11304, 11891, 13207, 14686, 15230, 15990, 16626, 16760, 17323]","[0, 130, 597, 743, 911, 1531, 1634, 1859, 2059, 2327, 2519, 3288, 3647, 3795, 4247, 4472, 4996, 5492, 5943, 6038, 6547, 7182, 7495, 7774, 7868, 8326, 10120, 10763, 11367, 12576, 12842, 13490, 13590, 13734, 14085]","[0, 130, 245, 412, 660, 750, 840, 1166, 1256, 1435, 1580, 1760, 1940, 2223, 2667, 2762, 3117, 3323, 3555, 3839, 4048, 4801, 5016, 5583, 6111, 6206, 7029, 7204, 7928, 8319, 8415, 8514, 8901, 9045, 9442]",19808,18759,17323,14085,9442,10,74,96,86,45,"[0, 210, 421, 775, 997, 1697, 1976, 2345, 2818, 3327, 3747, 3996, 4729, 5649, 6608, 7312, 8148, 8712, 9028, 9767, 10922, 11518, 12558, 13259, 14971, 16198, 16965, 18160, 19404, 19500, 20262, 20612, 21788, 23269, 23954]","[0, 210, 461, 791, 1122, 1338, 1667, 2080, 2456, 2920, 3350, 3695, 4303, 4791, 5624, 5964, 6803, 7658, 8249, 8793, 9608, 10671, 11540, 12015, 13514, 14506, 14916, 15747, 16811, 17592, 18407, 18726, 20142, 21729, 22740]","[0, 333, 574, 907, 1405, 1833, 2314, 2828, 3334, 3668, 4365, 4515, 4988, 5669, 6648, 7042, 7409, 8278, 8982, 9357, 9623, 10363, 10722, 10917, 11303, 12268, 12620, 13677, 14042, 14502, 14849, 14948, 16282, 17226, 18031]","[0, 210, 300, 450, 606, 831, 921, 1168, 1303, 1626, 1908, 1998, 2579, 3101, 3997, 4320, 4726, 5125, 5781, 5970, 6361, 7056, 7412, 7553, 8656, 9043, 9739, 10114, 10809, 10980, 11739, 12113, 12865, 13554, 14335]","[0, 210, 362, 709, 940, 1110, 1262, 1557, 1692, 1858, 2197, 2287, 2608, 3011, 3960, 4236, 4707, 4881, 5236, 5713, 7025, 7213, 7666, 7836, 9227, 9701, 10152, 10686, 10968, 11139, 11614, 11788, 12876, 13612, 14283]",23954,22740,18031,14335,14283,-4146,-3981,-708,-250,-4841,-13926,35,dire
7524401509,13,10,138,30,100,"[0, 239, 415, 728, 818, 1088, 1300, 1644, 2175, 2557, 3052, 3738, 4271, 4786, 5548, 6110, 6680, 7288, 7621, 8169, 9685, 11411, 11577, 12344, 13047, 14170, 16053, 16938, 17522, 17854, 18520, 19983, 20441, 21485, 21851]","[0, 234, 523, 613, 1017, 1282, 1728, 2019, 2530, 2916, 3399, 3890, 4556, 5102, 5438, 5863, 6567, 7206, 7485, 8889, 9633, 9974, 10712, 11431, 12388, 13177, 14033, 14840, 15017, 15636, 16137, 16814, 16914, 17394, 17749]","[0, 338, 428, 565, 702, 837, 976, 1439, 1619, 1877, 2217, 3122, 3277, 3472, 3615, 3709, 4067, 4225, 4357, 4667, 5136, 5453, 6250, 6994, 7377, 7778, 8912, 9184, 10354, 10686, 11835, 12487, 12587, 12822, 13216]","[0, 205, 295, 385, 520, 728, 862, 952, 1181, 1330, 1500, 1798, 1979, 2176, 2319, 2430, 3334, 3492, 3586, 4233, 4385, 5435, 5820, 6558, 6757, 7156, 7899, 8257, 8668, 9075, 9381, 9602, 10196, 10468, 10610]","[0, 359, 567, 796, 1080, 1384, 1667, 2032, 2318, 2690, 3041, 3509, 4001, 4150, 4612, 5074, 5283, 5735, 5994, 6287, 6790, 7107, 7424, 7519, 8142, 8746, 9482, 10176, 10599, 11224, 11418, 11812, 12073, 12308, 12901]",21851,17749,13216,10610,12901,1,25,21,112,20,"[60, 308, 617, 973, 1441, 1682, 1932, 2216, 2564, 3253, 3725, 4428, 4983, 5690, 6254, 6719, 7783, 8712, 9511, 10152, 11513, 12799, 13099, 14139, 15065, 16329, 17442, 17537, 17970, 19225, 19895, 21110, 22862, 24019, 24889]","[328, 857, 1185, 1514, 1960, 2460, 3157, 3612, 3937, 4598, 5103, 5433, 6110, 6702, 7348, 7913, 9119, 9789, 10497, 11946, 12371, 13285, 13778, 14787, 15090, 15860, 16449, 17216, 18243, 20029, 20964, 22219, 23620, 24620, 25362]","[60, 306, 592, 1235, 1637, 1897, 2379, 2905, 3275, 3655, 3985, 4174, 5046, 5428, 5707, 6240, 6753, 7376, 8129, 8619, 9202, 10052, 10360, 11153, 11712, 12167, 12261, 12489, 12905, 13924, 14509, 15276, 15992, 16603, 17410]","[60, 269, 359, 449, 873, 963, 1102, 1240, 1449, 1687, 1860, 1987, 2410, 2622, 3171, 3390, 3900, 4074, 4433, 4846, 4977, 5515, 5609, 6030, 6338, 6982, 7076, 7171, 7648, 8797, 9418, 9971, 10598, 10925, 11137]","[0, 255, 345, 435, 606, 793, 983, 1481, 1571, 1735, 1871, 1961, 2337, 2477, 2626, 2845, 3196, 3370, 3600, 3829, 4003, 4098, 4341, 4602, 4781, 5164, 5306, 5482, 5898, 6302, 6677, 6997, 7509, 8086, 8322]",24889,25362,17410,11137,8322,-3038,-7613,-4194,-527,4579,-10793,35,radiant
7525812113,35,22,69,83,26,"[0, 208, 388, 858, 1260, 1546, 2180, 2386, 2739, 3098, 3792, 4121, 4492, 4729, 5484, 5886, 6674, 7433, 8361, 9356, 9805, 9996, 10671, 11316, 11598, 12178, 12662, 13105, 13686, 14270, 14644, 15463, 16115, 16927, 17564]","[0, 326, 679, 1083, 1538, 2046, 2544, 2911, 3389, 3980, 4616, 4876, 5365, 5863, 6438, 7032, 7980, 8313, 8838, 9163, 9491, 9979, 10578, 11061, 11490, 11965, 12320, 12511, 12755, 13137, 13388, 14769, 15262, 15558, 15658]","[0, 274, 712, 1208, 1407, 1810, 2057, 2541, 3142, 3704, 4458, 4765, 5312, 5987, 6602, 7218, 7836, 8253, 8868, 9439, 9603, 10219, 10776, 11282, 11446, 11809, 12686, 13206, 13721, 14165, 14655, 15306, 15972, 16280, 16941]","[0, 170, 260, 396, 507, 641, 853, 989, 1513, 1980, 2160, 2250, 2340, 2990, 3198, 3467, 3861, 4176, 4361, 4456, 4550, 4645, 5065, 5553, 5647, 5869, 6201, 6296, 6484, 6580, 6714, 7053, 7153, 7404, 7504]","[0, 170, 351, 529, 619, 803, 1013, 1103, 1332, 1634, 1814, 1904, 2023, 2342, 2624, 2808, 3154, 3339, 3624, 3719, 3813, 4149, 4406, 4501, 4595, 4690, 4785, 4880, 5103, 5373, 5545, 6078, 6262, 6758, 6858]",17564,15658,16941,7504,6858,6,90,135,136,20,"[330, 577, 894, 1123, 1528, 1728, 2308, 2597, 2915, 3309, 3811, 4502, 5106, 5677, 6245, 6811, 7413, 8004, 8793, 9605, 10286, 10965, 11614, 12581, 13367, 14226, 15059, 16212, 17084, 17925, 18786, 20021, 21099, 22476, 23383]","[0, 290, 607, 1023, 1383, 1979, 2507, 3123, 3213, 3664, 4259, 4933, 5608, 6004, 6383, 7149, 8343, 9174, 9704, 10132, 10777, 11478, 12237, 12741, 13221, 13847, 14657, 15031, 15900, 16614, 17028, 17742, 18731, 19325, 19802]","[62, 343, 699, 898, 1185, 1517, 1855, 2670, 3117, 3455, 3688, 4544, 5009, 5769, 6426, 6952, 7767, 8314, 9004, 9503, 10645, 11181, 11398, 12066, 13143, 13911, 14397, 15733, 15978, 16534, 17226, 17900, 18399, 19148, 19676]","[62, 232, 533, 658, 748, 838, 1019, 1146, 1526, 1741, 2011, 2308, 2466, 3099, 3481, 3652, 4180, 4799, 5238, 5748, 6177, 6272, 6625, 6810, 7495, 8257, 8679, 9011, 9188, 9497, 9879, 10183, 10493, 10981, 11439]","[62, 276, 576, 666, 820, 957, 1141, 1608, 1742, 1922, 2204, 2534, 2624, 3071, 3195, 3407, 3635, 3793, 3976, 4297, 4726, 4821, 4988, 5173, 5721, 6136, 6356, 6686, 6863, 6959, 7103, 7202, 7392, 7821, 8101]",23383,19802,19676,11439,8101,-5819,-4144,-2735,-3935,-1243,-17876,35,dire
7525933503,109,65,137,121,26,"[334, 1033, 1391, 1824, 2211, 2689, 2964, 3317, 3676, 3925, 4922, 5089, 5829, 6394, 7270, 7853, 8805, 9435, 10147, 11291, 11958, 12770, 13369, 14458, 15396, 16300, 17530, 18494, 18678, 19798, 21640, 22791, 23935, 24232, 25377]","[258, 466, 771, 1021, 1233, 1719, 2014, 2596, 3110, 3468, 3958, 4465, 5636, 6260, 6632, 6938, 7489, 8667, 8761, 9859, 10228, 10977, 11071, 11548, 12565, 13080, 13365, 13667, 13763, 14380, 14732, 15020, 15574, 15674, 15874]","[170, 478, 709, 1051, 1228, 1690, 1780, 2371, 2778, 3301, 3775, 4368, 4670, 5443, 5869, 6073, 6351, 7361, 7574, 8295, 8822, 9206, 9300, 9395, 9888, 10199, 10951, 11703, 12282, 12624, 13083, 13618, 13725, 14122, 14222]","[213, 350, 651, 837, 927, 1141, 1231, 1519, 1609, 1893, 2303, 2393, 2629, 2862, 3053, 3185, 3456, 3925, 4044, 4674, 4769, 5255, 5349, 5470, 5852, 6047, 6645, 6847, 6943, 7525, 7915, 8204, 8304, 8453, 8773]","[170, 342, 583, 738, 866, 956, 1285, 1568, 1658, 1748, 2032, 2122, 2217, 2539, 2730, 2825, 3046, 3471, 3739, 4113, 4391, 4692, 4786, 4881, 5177, 5321, 6312, 6477, 6573, 6918, 7270, 7396, 7496, 7831, 8051]",25377,15874,14222,8773,8051,39,21,69,20,119,"[287, 609, 991, 1443, 2231, 2675, 3316, 3738, 4037, 4693, 5168, 5488, 6074, 6815, 7427, 8027, 8479, 9276, 9954, 11009, 12092, 12796, 13745, 14361, 15660, 16481, 16974, 17611, 19395, 19839, 20774, 20874, 21105, 22312, 23146]","[257, 620, 1291, 1658, 2097, 2378, 2880, 3166, 3663, 4354, 5316, 5876, 6609, 7124, 7723, 8310, 8803, 9519, 10012, 10677, 11638, 12285, 13084, 13604, 14489, 15526, 16148, 16619, 18034, 18487, 18867, 19546, 19792, 20944, 21740]","[280, 523, 850, 1291, 1572, 1837, 2430, 3101, 3595, 4317, 4723, 5224, 5932, 6597, 7519, 8114, 8828, 9694, 10271, 10610, 11108, 11696, 12365, 12868, 13675, 14981, 15304, 15676, 16653, 17351, 18793, 19343, 19858, 20473, 21322]","[170, 260, 427, 576, 905, 1234, 1589, 1811, 1981, 2336, 2906, 3584, 3823, 3983, 4354, 4628, 4726, 4896, 5053, 5367, 5793, 6035, 7117, 7726, 8150, 8484, 8825, 9273, 10062, 10323, 10813, 10980, 11107, 11949, 12693]","[170, 299, 389, 531, 821, 931, 1159, 1294, 1458, 2053, 2382, 2608, 2852, 3116, 3426, 3744, 3854, 4609, 4908, 5105, 5716, 5984, 6337, 6654, 7071, 7659, 8329, 8731, 9613, 9857, 10259, 10419, 10521, 10906, 11395]",23146,21740,21322,12693,11395,2231,-5866,-7100,-3920,-3344,-17999,35,dire
7526050917,46,98,120,79,83,"[0, 170, 364, 454, 820, 1141, 1388, 1716, 2046, 2479, 2932, 3287, 3876, 4381, 5219, 6014, 7039, 7515, 8813, 9176, 9804, 10233, 11229, 11652, 12573, 13710, 14181, 14804, 16758, 17561, 18427, 19036, 19790, 20340, 21385]","[0, 170, 449, 693, 817, 1316, 1753, 2121, 2484, 3106, 3861, 4257, 4621, 5222, 6277, 6833, 7451, 8340, 8987, 9298, 10020, 10606, 11642, 12277, 12989, 13681, 14417, 15323, 15729, 16761, 17169, 17269, 17369, 17490, 18222]","[0, 298, 628, 1043, 1443, 1985, 2351, 2736, 3143, 3938, 4909, 5171, 5814, 6368, 6722, 7027, 7529, 8289, 8910, 9611, 9895, 10501, 11174, 11568, 11895, 12521, 12759, 13144, 13550, 14438, 14718, 14929, 15623, 15984, 16495]","[0, 170, 260, 397, 487, 577, 940, 1030, 1120, 1532, 2017, 2391, 2685, 2928, 3413, 3755, 3913, 4183, 4450, 4738, 4908, 5167, 5521, 5936, 6357, 6997, 7167, 7632, 8113, 8628, 9037, 9244, 9701, 9876, 10097]","[0, 170, 310, 434, 524, 659, 749, 887, 1154, 1289, 1698, 1827, 1917, 2016, 2288, 2383, 2699, 3217, 3755, 3978, 4073, 4257, 4492, 4587, 4681, 4920, 5051, 5236, 5636, 5965, 6061, 6278, 6410, 6544, 6841]",21385,18222,16495,10097,6841,48,21,96,65,85,"[0, 254, 598, 899, 1562, 1806, 2053, 2347, 2660, 3074, 3326, 3971, 4581, 5372, 6264, 6853, 7670, 8504, 10032, 11141, 12277, 13116, 14354, 15437, 15531, 16279, 17495, 19010, 21159, 22662, 23649, 24986, 26499, 27247, 27524]","[0, 204, 557, 844, 1259, 1621, 2072, 2493, 2989, 3161, 3827, 4715, 5254, 5949, 6765, 7337, 7783, 8663, 9556, 10198, 10714, 12010, 12658, 13865, 14472, 15005, 15732, 17097, 18736, 18832, 19009, 19488, 20334, 20847, 21130]","[0, 289, 559, 826, 1240, 1413, 2003, 2567, 3088, 3658, 3998, 4709, 5287, 6066, 6329, 6752, 7529, 7881, 8812, 9422, 9811, 10728, 11255, 12192, 12940, 13320, 13747, 14551, 15630, 15798, 16102, 16513, 17162, 17722, 17937]","[0, 170, 285, 802, 1062, 1222, 1434, 1758, 1992, 2439, 2745, 3280, 3723, 3979, 4467, 4562, 5335, 5593, 6375, 7162, 7676, 8139, 8378, 9426, 9716, 9946, 10334, 11278, 12234, 12446, 12623, 13202, 13670, 14018, 14208]","[0, 170, 285, 375, 553, 643, 885, 1199, 1334, 1481, 1918, 2413, 2604, 2907, 3417, 3512, 3670, 3936, 5263, 5810, 5905, 6274, 6513, 7470, 7564, 8190, 8403, 9277, 10227, 10440, 10617, 10949, 11756, 12481, 12789]",27524,21130,17937,14208,12789,-6139,-2908,-1442,-4111,-5948,-20548,35,dire
7526071203,54,74,96,101,83,"[0, 205, 492, 979, 1393, 1620, 2442, 2809, 3107, 3294, 3879, 4549, 5160, 5757, 6076, 6749, 7464, 8183, 9139, 9923, 10676, 11438, 11756, 11941, 12619, 13221, 13715, 15345, 16468, 17072, 17846, 18929, 19342, 20070, 20170]","[0, 175, 495, 788, 1164, 1415, 1865, 2320, 2899, 3206, 3699, 4092, 4533, 4926, 5403, 5843, 6260, 6431, 6745, 7628, 8263, 8910, 9075, 9523, 9868, 10516, 11129, 12868, 13610, 14696, 15060, 15679, 16565, 16702, 16802]","[0, 166, 349, 599, 847, 1060, 1333, 1606, 1696, 1951, 2311, 2578, 2865, 3307, 3800, 4145, 4602, 4796, 4997, 5786, 6314, 6408, 6748, 6950, 7154, 7405, 7862, 8456, 8552, 8865, 9120, 9303, 9403, 10012, 10112]","[0, 130, 220, 549, 639, 749, 1099, 1189, 1323, 1458, 1698, 2264, 2354, 2502, 2806, 2931, 3469, 3563, 3877, 4210, 4632, 4886, 5028, 5213, 5307, 5580, 5775, 6489, 7119, 7269, 7463, 7609, 7709, 7826, 7980]","[0, 164, 254, 393, 483, 619, 977, 1111, 1201, 1384, 1568, 1850, 1940, 2088, 2273, 2413, 2767, 2918, 3232, 3442, 3663, 3757, 3852, 4037, 4131, 4344, 4539, 5281, 5809, 5905, 6039, 6185, 6315, 6500, 6600]",20170,16802,10112,7980,6600,107,102,14,105,27,"[0, 293, 493, 834, 1330, 1689, 2339, 2858, 3538, 3928, 4393, 4939, 5416, 5698, 6406, 6931, 7173, 8023, 8938, 9478, 9949, 10656, 11099, 12111, 12499, 13475, 13994, 14225, 14810, 15279, 16000, 16230, 16804, 18070, 19280]","[0, 291, 614, 866, 1288, 1573, 1958, 2574, 3024, 3404, 3856, 4279, 4751, 5337, 5954, 6587, 6926, 7750, 8418, 9011, 9559, 10707, 11262, 11766, 12126, 12846, 13578, 13971, 14618, 15335, 16070, 16430, 17518, 18233, 18837]","[0, 210, 451, 616, 937, 1253, 1580, 1844, 2233, 2585, 2853, 3293, 3744, 4330, 4841, 5539, 6111, 6503, 7054, 7561, 8094, 8672, 8955, 9503, 9934, 10442, 11057, 11278, 11702, 12063, 12450, 12550, 13071, 13554, 14091]","[100, 310, 739, 829, 1002, 1254, 1402, 1582, 1909, 2126, 2419, 2604, 2804, 3044, 3335, 3622, 3940, 4328, 4891, 5151, 5294, 6011, 6329, 6917, 7146, 7618, 7928, 8558, 8955, 9207, 9412, 9811, 10665, 10936, 11472]","[0, 210, 404, 538, 668, 856, 1188, 1495, 1679, 1902, 2130, 2315, 2452, 2649, 3025, 3378, 3536, 3803, 4189, 4576, 4772, 5200, 5439, 5716, 6217, 6576, 6804, 7247, 7343, 7520, 7697, 8144, 8510, 8923, 9295]",19280,18837,14091,11472,9295,890,-2035,-3979,-3492,-2695,-11311,35,dire
7526305209,89,96,76,105,68,"[0, 204, 438, 756, 1089, 1559, 1923, 2254, 2719, 3326, 3853, 4252, 5169, 5822, 6517, 6879, 8164, 9182, 10186, 11124, 11730, 12723, 13738, 14594, 15391, 15972, 16689, 18503, 19954, 20706, 21661, 23525, 25082, 25851, 26479]","[0, 335, 554, 907, 1285, 1572, 2007, 2337, 2924, 3481, 3680, 4179, 4597, 5212, 5532, 6312, 6742, 7135, 7632, 8419, 9000, 9095, 9929, 10458, 10734, 11054, 11418, 12151, 12898, 13296, 13452, 14421, 15685, 15891, 16564]","[0, 242, 534, 831, 1175, 1494, 1711, 1919, 2339, 2846, 3215, 3711, 3853, 4507, 5004, 5540, 6317, 6499, 6891, 7235, 8157, 8536, 9253, 9529, 10153, 10473, 10568, 10863, 11543, 11952, 12328, 13082, 14339, 14772, 15452]","[0, 170, 260, 691, 826, 963, 1101, 1428, 1636, 1816, 1906, 2050, 2222, 2416, 2513, 2779, 3421, 3536, 3771, 4314, 4766, 4936, 5178, 5789, 6334, 6950, 7281, 7540, 8270, 8748, 8919, 9510, 10130, 10365, 10696]","[0, 170, 260, 399, 489, 656, 934, 1215, 1350, 1530, 1649, 1895, 2114, 2312, 2407, 2823, 3194, 3294, 3477, 3849, 4262, 4357, 4616, 4970, 5246, 5819, 5950, 6454, 6806, 7037, 7349, 7865, 8739, 8839, 9134]",26479,16564,15452,10696,9134,41,43,106,26,110,"[0, 170, 384, 667, 961, 1361, 1779, 2141, 2404, 2591, 3103, 3589, 4051, 4488, 5142, 5693, 6799, 7116, 7651, 8130, 8719, 8978, 9672, 10196, 10406, 11219, 11314, 12535, 13468, 14245, 14943, 15746, 16218, 16540, 17059]","[0, 242, 578, 895, 1224, 1557, 1870, 2402, 2819, 3228, 3780, 4546, 4989, 5613, 6202, 6795, 7402, 8036, 8454, 9208, 9544, 10852, 11534, 11628, 11894, 12646, 13390, 14705, 15195, 15838, 16365, 16799, 17410, 17786, 18428]","[0, 325, 636, 886, 1221, 1625, 1940, 2509, 2806, 3271, 3536, 3979, 4945, 5313, 5831, 6177, 7246, 8011, 8812, 9249, 9433, 9901, 10606, 11246, 11511, 11923, 12755, 13617, 14115, 14292, 14657, 15268, 15977, 16825, 17869]","[0, 174, 266, 360, 542, 638, 996, 1243, 1345, 1575, 1710, 2140, 2498, 2701, 2982, 3178, 3879, 4113, 4256, 4510, 4734, 4999, 5493, 5871, 6069, 6410, 6747, 7744, 8077, 8329, 8536, 8911, 9290, 9855, 10356]","[0, 170, 260, 350, 498, 607, 955, 1351, 1441, 1579, 1763, 2167, 2442, 2842, 3444, 3609, 4202, 4679, 4820, 5207, 5371, 6083, 6635, 6945, 7040, 7396, 7650, 8118, 8376, 8613, 9019, 9368, 9468, 9568, 9703]",17059,18428,17869,10356,9703,9420,-1864,-2417,340,-569,4910,35,radiant
7527329500,46,102,21,26,14,"[599, 1041, 1555, 2028, 2547, 2926, 3661, 4162, 4874, 5229, 6112, 6854, 7128, 8038, 8809, 9484, 9974, 10480, 11308, 12092, 12961, 13759, 14710, 15365, 15709, 16455, 17081, 17763, 18181, 19535, 20487, 21300, 22387, 22487, 22587]","[484, 776, 1057, 1338, 1780, 2347, 2603, 3033, 3922, 4501, 4902, 5508, 5803, 6647, 7251, 7812, 8733, 9394, 9488, 10370, 11216, 11840, 12357, 12763, 13352, 13840, 14546, 14801, 15429, 17236, 18450, 19128, 19637, 19783, 19883]","[760, 1041, 1305, 1991, 2437, 2942, 3393, 3925, 4563, 4751, 5345, 6114, 6679, 7393, 8150, 8819, 9382, 10289, 11222, 11632, 11837, 11951, 12608, 13389, 13532, 14066, 14752, 15046, 15311, 16188, 16423, 17437, 18237, 18517, 19106]","[307, 397, 613, 783, 1094, 1229, 1337, 1496, 1631, 1921, 2510, 2860, 2955, 3310, 3730, 4371, 4619, 5472, 5566, 5868, 6073, 6167, 6854, 7118, 7213, 7766, 8024, 8120, 8347, 9228, 9562, 9662, 9852, 9952, 10212]","[1111, 1311, 1401, 1616, 1770, 1905, 2011, 2364, 2590, 2815, 3145, 3397, 3540, 3991, 4447, 4875, 5123, 5338, 5691, 5993, 6198, 6292, 6660, 7061, 7156, 7596, 7854, 7950, 8192, 8623, 8903, 9194, 9384, 9484, 9584]",22587,19883,19106,10212,9584,95,13,97,20,86,"[628, 873, 1263, 1626, 1966, 2232, 2653, 3124, 3736, 4041, 4638, 5252, 5721, 6193, 6860, 7557, 7987, 8787, 9202, 9895, 10602, 11992, 12555, 13277, 15119, 15929, 17267, 19163, 20023, 21519, 22346, 22978, 24121, 26289, 27209]","[588, 959, 1335, 1743, 1923, 2337, 2632, 2886, 3654, 4148, 4793, 5317, 5698, 5834, 6370, 6806, 6929, 7790, 7884, 8190, 8762, 9575, 10196, 10485, 11544, 12290, 12804, 14217, 14961, 15490, 16720, 17563, 18087, 19567, 20130]","[539, 740, 1148, 1332, 1741, 1927, 2098, 2390, 3074, 3250, 3621, 4122, 4391, 4650, 5409, 5548, 5643, 6184, 6278, 6693, 7259, 8055, 8150, 8747, 10093, 10947, 11213, 11494, 11846, 12527, 12837, 13388, 13488, 14986, 15577]","[470, 605, 735, 957, 1187, 1370, 1560, 1734, 2182, 2272, 2647, 2836, 2931, 3108, 3265, 3406, 3671, 4388, 4630, 4831, 4998, 5577, 5954, 6158, 7022, 7256, 7723, 9036, 9222, 9769, 10079, 10179, 10513, 11355, 11609]","[567, 657, 994, 1372, 1509, 1599, 1689, 1824, 2040, 2410, 2698, 2847, 2965, 3292, 3518, 3738, 3833, 5386, 5510, 5766, 6169, 6388, 6640, 7239, 8103, 8287, 8803, 9542, 9860, 10183, 10591, 10691, 10791, 11325, 11535]",27209,20130,15577,11609,11535,-4622,-247,3529,-1397,-1951,-4688,35,radiant
7527537810,53,49,23,79,136,"[239, 671, 1124, 1355, 1481, 2019, 2455, 3009, 3310, 3728, 4021, 4389, 5309, 5926, 6396, 7185, 7757, 8657, 9453, 10132, 11381, 12083, 13207, 14401, 15257, 16665, 18354, 19549, 19924, 21898, 22868, 23648, 24394, 25640, 27676]","[244, 527, 858, 1259, 1516, 2085, 2762, 3408, 3834, 4459, 4935, 5275, 5755, 6013, 6627, 7731, 7999, 8516, 8766, 9304, 9804, 10521, 11189, 11897, 12259, 13276, 14247, 15245, 15957, 17022, 17747, 18724, 19174, 19958, 21287]","[291, 961, 1241, 1540, 1877, 2409, 2825, 3276, 3733, 4546, 5080, 5701, 6315, 7146, 7597, 8478, 8766, 9377, 9969, 10778, 11210, 11642, 12096, 12530, 13188, 13509, 14041, 14702, 14798, 15544, 16501, 16601, 16972, 17461, 18380]","[170, 327, 434, 764, 854, 1070, 1303, 1528, 1698, 2013, 2103, 2473, 3083, 3884, 4150, 4609, 4794, 4889, 5046, 5315, 5410, 5649, 5857, 6336, 6503, 6827, 7747, 7924, 8020, 8660, 9156, 9256, 9491, 10000, 10873]","[170, 326, 465, 623, 796, 1043, 1168, 1546, 1862, 2125, 2439, 2642, 2862, 3234, 3585, 4214, 4487, 4613, 4943, 5118, 5213, 5452, 5873, 6158, 6351, 6674, 7408, 7660, 7831, 8152, 8617, 8792, 9621, 10184, 11021]",27676,21287,18380,10873,11021,25,106,129,21,102,"[204, 447, 666, 1012, 1291, 1663, 1982, 2490, 2665, 3201, 3850, 4261, 4759, 5551, 6183, 6992, 7423, 8333, 9122, 9909, 10852, 11330, 12114, 13153, 14367, 15443, 15538, 16085, 17235, 17800, 18230, 18931, 20196, 21205, 21437]","[242, 478, 814, 1063, 1349, 1633, 2142, 2627, 3200, 3510, 3980, 4662, 4986, 5339, 5860, 6980, 7986, 8672, 9153, 9647, 9832, 10599, 11222, 11905, 12506, 13471, 13832, 14579, 14917, 15136, 16164, 16524, 17633, 18379, 18704]","[253, 497, 757, 1326, 1600, 2095, 2519, 2792, 3501, 4093, 4545, 5005, 5398, 5631, 5993, 6844, 7644, 8198, 8924, 9672, 9902, 10781, 10921, 11016, 11586, 12202, 12297, 13218, 13508, 13727, 14184, 14284, 15007, 15973, 16073]","[170, 260, 350, 484, 889, 1108, 1292, 1715, 2288, 2561, 2800, 3007, 3340, 3542, 3658, 4381, 4958, 5264, 5771, 6238, 6423, 6653, 6843, 7024, 7615, 8009, 8104, 8281, 8574, 8670, 9046, 9146, 9403, 9888, 9988]","[170, 260, 405, 509, 686, 821, 956, 1176, 1268, 1487, 1679, 2004, 2099, 2248, 2349, 2891, 3270, 3677, 4092, 4233, 4462, 4692, 5021, 5116, 5512, 5925, 6020, 6246, 6452, 6724, 7151, 7251, 7351, 7839, 7939]",21437,18704,16073,9988,7939,6239,2583,2307,885,3082,15096,35,radiant
7528383718,46,32,98,45,20,"[0, 313, 608, 859, 1165, 1567, 1856, 2155, 2542, 2808, 3265, 3783, 4422, 5390, 6041, 6573, 7471, 8687, 9659, 10552, 11325, 11562, 12119, 12890, 14243, 14986, 15623, 15852, 16029, 16590, 16944, 17416, 17516, 17872, 18556]","[0, 645, 938, 1229, 1559, 1891, 2504, 3057, 3791, 4092, 4638, 4854, 5117, 5821, 6323, 6525, 7483, 7578, 7673, 7992, 9457, 10000, 10835, 11446, 11929, 12801, 13371, 13600, 14298, 15114, 15937, 16127, 16654, 17063, 17846]","[0, 244, 597, 1062, 1330, 1801, 2089, 2434, 2866, 3072, 3902, 4542, 4722, 5407, 6033, 6384, 7133, 7434, 8073, 8689, 8980, 9234, 10095, 10636, 11781, 13021, 13866, 14386, 14922, 15400, 15496, 15890, 16228, 16455, 16851]","[0, 772, 923, 1061, 1151, 1281, 1371, 1586, 1765, 1855, 2310, 2454, 2834, 3357, 3685, 3888, 4281, 4425, 4607, 4701, 5006, 5465, 6198, 6474, 7074, 7553, 7910, 8147, 8554, 8815, 8995, 9391, 9665, 9883, 9983]","[0, 302, 392, 539, 712, 893, 1113, 1203, 1642, 1814, 1949, 2262, 2442, 2735, 2958, 3276, 3853, 4350, 4800, 4923, 5103, 5274, 5582, 6079, 6843, 7407, 7670, 7899, 8223, 8319, 8415, 8605, 8905, 9005, 9138]",18556,17846,16851,9983,9138,25,13,60,53,87,"[0, 437, 798, 1158, 1572, 1942, 2361, 2875, 3180, 3922, 4445, 4835, 5627, 5935, 6598, 7555, 7936, 8421, 9201, 10174, 10907, 11868, 12752, 13574, 14526, 14713, 15345, 16278, 17337, 17712, 18237, 19957, 21138, 22411, 24017]","[0, 249, 457, 948, 1316, 1569, 2203, 2840, 3390, 3892, 4203, 4540, 5376, 5762, 6480, 6885, 7322, 8757, 9219, 10120, 10541, 11577, 12612, 13427, 13908, 14003, 15153, 15893, 16620, 17447, 18474, 19710, 20589, 21573, 22250]","[0, 392, 553, 975, 1365, 1613, 1903, 2729, 3229, 3913, 4532, 4902, 5617, 6206, 6509, 7500, 8124, 8433, 8786, 9284, 9868, 10202, 10508, 10746, 10968, 11480, 11990, 13336, 13904, 14418, 14845, 15534, 16335, 17548, 17913]","[0, 321, 514, 867, 957, 1082, 1295, 1871, 2006, 2704, 3540, 4194, 5140, 5235, 5445, 6080, 6657, 7060, 7282, 8138, 8854, 9258, 9667, 9886, 10419, 10514, 10690, 11986, 12769, 12999, 13534, 14880, 15470, 16646, 17060]","[0, 454, 544, 784, 874, 1003, 1216, 1487, 1622, 1965, 2189, 2366, 2868, 2963, 3058, 3916, 4260, 5049, 5144, 5847, 6440, 6581, 6953, 7594, 7940, 8035, 8330, 9444, 9757, 9892, 10238, 10727, 11871, 12576, 12851]",24017,22250,17913,17060,12851,-5461,-4404,-1062,-7077,-3713,-21717,35,dire
7528465311,71,104,91,20,86,"[0, 264, 505, 631, 914, 1264, 1510, 1813, 2733, 2929, 3675, 4248, 4995, 5668, 6169, 6746, 7234, 7979, 8965, 9556, 9957, 10544, 11360, 11770, 12451, 12925, 13293, 13673, 14618, 15009, 15478, 16076, 16176, 17776, 17966]","[0, 300, 612, 1037, 1410, 1953, 2534, 3041, 3482, 4043, 4562, 5125, 6275, 6845, 7320, 7503, 7975, 8528, 9493, 10050, 11088, 11480, 12237, 12331, 12436, 12997, 13263, 14013, 15467, 15563, 15815, 16562, 16662, 17344, 17534]","[0, 229, 404, 532, 736, 1182, 1317, 1771, 2152, 2408, 2759, 3330, 3698, 4241, 4778, 4992, 5335, 5716, 6109, 6626, 7173, 7910, 8401, 8889, 9059, 9627, 10154, 11007, 11613, 12141, 12676, 12981, 13816, 14915, 15173]","[0, 316, 724, 1096, 1507, 1833, 2165, 2504, 2953, 3394, 3904, 4473, 4792, 5223, 6039, 6333, 7047, 7653, 8291, 8744, 8965, 9204, 9888, 9982, 10077, 10570, 11037, 11343, 12125, 12754, 13085, 13550, 13650, 14627, 14817]","[0, 569, 694, 931, 1069, 1286, 1644, 2295, 2385, 2573, 3190, 3442, 4148, 4646, 4831, 5006, 5404, 5653, 6048, 6352, 7460, 7647, 7960, 8054, 8329, 8424, 8680, 8775, 9160, 9256, 9659, 9759, 10391, 10753, 11143]",17966,17534,15173,14817,11143,18,106,96,101,121,"[0, 231, 620, 919, 1173, 1824, 1914, 2506, 3087, 3618, 4403, 4884, 5652, 5747, 6169, 6756, 7869, 8773, 9379, 10253, 10996, 11527, 12055, 12736, 14224, 15200, 16823, 17339, 18103, 18850, 19240, 20619, 21323, 23105, 24199]","[0, 356, 570, 867, 1240, 1557, 1877, 2275, 2565, 2830, 3249, 3541, 3849, 4224, 4716, 4810, 5091, 5473, 6116, 6559, 7690, 7967, 9029, 9195, 10159, 10660, 11473, 12054, 12770, 13586, 13940, 15368, 15960, 17404, 18290]","[0, 230, 438, 956, 1413, 1616, 1939, 2436, 2889, 2979, 3069, 3594, 4013, 4322, 4881, 5425, 6030, 6516, 6859, 7434, 7842, 8292, 9494, 10023, 11228, 11564, 12486, 13126, 13955, 14218, 14621, 16396, 16804, 17606, 18066]","[0, 272, 362, 604, 795, 885, 975, 1200, 1449, 1584, 1674, 1819, 2041, 2173, 2422, 2894, 3339, 3686, 3819, 4507, 5033, 5211, 6321, 6548, 7261, 7442, 8510, 8605, 8760, 9045, 9540, 9835, 10138, 11195, 12079]","[0, 405, 495, 585, 675, 902, 992, 1126, 1261, 1351, 1441, 1721, 1943, 2098, 2259, 2528, 2793, 3523, 3673, 4495, 4920, 5195, 7000, 7166, 7825, 8010, 8671, 8805, 9791, 9968, 10064, 10362, 10687, 11099, 11379]",24199,18290,18066,12079,11379,-6233,-756,-2893,2738,-236,-7380,35,dire
7529139904,114,80,129,128,64,"[0, 245, 590, 870, 1155, 1744, 2240, 2702, 3175, 3391, 3757, 4434, 5186, 5551, 6257, 6760, 7374, 8116, 8615, 9325, 9737, 10397, 10865, 10959, 11519, 12070, 12515, 13109, 14090, 14837, 15914, 17498, 18150, 18876, 20043]","[2, 320, 733, 1139, 1585, 2137, 2784, 3594, 4031, 4403, 4974, 5368, 5709, 6564, 7428, 7894, 8249, 9073, 9730, 10475, 10993, 11834, 12266, 13109, 13663, 14334, 14670, 15715, 16224, 16704, 17398, 18354, 18633, 19213, 19551]","[0, 245, 567, 829, 1011, 1383, 1994, 2506, 3061, 3441, 3952, 4865, 5329, 6027, 6627, 7346, 8019, 8929, 9216, 9504, 9864, 10345, 11005, 11605, 12284, 12976, 13324, 13499, 14157, 14898, 15381, 16402, 16886, 17898, 18524]","[0, 247, 374, 472, 648, 1006, 1134, 1642, 1744, 2035, 2499, 2892, 3439, 3795, 4142, 4360, 4558, 5332, 6083, 6223, 6454, 6902, 7293, 8130, 8800, 9118, 9533, 9734, 10119, 10559, 10832, 11538, 11930, 12220, 12524]","[0, 245, 335, 425, 556, 694, 861, 1161, 1293, 1383, 1891, 2554, 2829, 3215, 3488, 3788, 3973, 4178, 4497, 4800, 4997, 5392, 5869, 6454, 6944, 7541, 7683, 7882, 8229, 8591, 9029, 9816, 9916, 10111, 10581]",20043,19551,18524,12524,10581,89,13,29,72,62,"[0, 170, 547, 795, 1438, 1930, 2229, 2634, 3047, 3308, 4125, 5138, 5643, 6375, 6829, 7629, 8592, 9087, 9952, 11049, 11576, 12333, 13322, 14057, 14745, 15460, 16264, 17053, 18117, 18416, 18760, 18860, 20274, 21653, 22596]","[0, 170, 443, 638, 851, 1021, 1272, 1528, 1900, 2351, 2610, 2750, 3451, 3802, 3993, 4560, 5459, 5995, 7358, 8077, 8742, 9125, 9975, 11103, 11779, 12483, 13015, 13643, 14102, 15085, 15699, 16418, 17825, 18509, 19497]","[0, 253, 378, 746, 963, 1180, 1270, 1654, 2041, 2587, 3229, 3899, 4457, 5109, 5543, 6182, 6759, 7217, 8165, 8881, 9539, 9801, 10544, 10894, 11235, 11621, 11997, 12582, 12950, 13582, 13963, 14063, 15170, 16047, 16544]","[0, 170, 260, 350, 480, 570, 660, 795, 1097, 1277, 1502, 1642, 1931, 2073, 2253, 2471, 2771, 3186, 4249, 4986, 5103, 5198, 5483, 6038, 6205, 6517, 6612, 6969, 7175, 7624, 7991, 8151, 8845, 9062, 9670]","[0, 170, 312, 430, 1011, 1236, 1326, 1473, 1802, 1982, 2265, 2405, 2495, 2602, 2934, 3148, 3368, 3589, 4441, 4923, 5022, 5117, 5386, 5746, 5988, 6314, 6484, 6665, 6967, 7312, 7483, 7658, 8013, 8188, 8591]",22596,19497,16544,9670,8591,-2553,54,1980,2854,1990,4325,35,radiant
7529241517,89,49,43,110,100,"[521, 871, 1276, 1751, 2167, 2517, 3020, 3681, 4289, 5019, 5845, 6770, 7526, 8136, 8784, 9591, 10400, 11237, 11816, 12926, 13815, 14880, 15742, 15874, 16903, 17380, 18398, 18624, 18754, 19849, 20370, 21317, 22147, 22829, 23284]","[703, 957, 1490, 1902, 2362, 2918, 3568, 4061, 4837, 5128, 5835, 6406, 6604, 7293, 8119, 8792, 9406, 10373, 11182, 11367, 12290, 12748, 13204, 13752, 14343, 14512, 15400, 16396, 16986, 17246, 17346, 17897, 18942, 19355, 20119]","[520, 721, 966, 1425, 1975, 2462, 3119, 3649, 4095, 4801, 5321, 5829, 6244, 6666, 7519, 8108, 8824, 9649, 10367, 10552, 11596, 12434, 13137, 13232, 13901, 14368, 14760, 15450, 15981, 16121, 16500, 17399, 18125, 18512, 18757]","[289, 727, 884, 1309, 1443, 1578, 1758, 1985, 2475, 2761, 2952, 3287, 3614, 3891, 4384, 4617, 4846, 5347, 5759, 6043, 6482, 6868, 6963, 7308, 7403, 7583, 8050, 8229, 8527, 8804, 9021, 9155, 9513, 9845, 10050]","[353, 443, 570, 720, 883, 1018, 1214, 1394, 1740, 1999, 2243, 2446, 2541, 2636, 3038, 3249, 3778, 4035, 4317, 4538, 5376, 5652, 5965, 6060, 6155, 6249, 6452, 6899, 7148, 7248, 7348, 7601, 7983, 8169, 8316]",23284,20119,18757,10050,8316,109,106,28,105,68,"[531, 779, 1202, 1329, 1627, 2081, 2377, 2648, 3330, 3673, 4355, 4947, 5411, 6037, 6739, 7488, 8050, 8843, 9906, 11240, 11904, 12464, 13526, 14585, 15623, 16325, 17559, 18452, 19450, 20479, 21412, 22684, 24080, 25003, 26236]","[476, 690, 1087, 1380, 1627, 2095, 2453, 2837, 3577, 3836, 4322, 4794, 5771, 5866, 6680, 7070, 7268, 8163, 8939, 10028, 10737, 11641, 12470, 13249, 13972, 14253, 15040, 16148, 17177, 17743, 18874, 19776, 20740, 21241, 22242]","[491, 786, 1072, 1326, 1789, 2194, 2458, 3089, 3564, 4195, 4720, 5241, 5628, 6463, 6710, 7386, 7735, 8240, 8629, 9159, 9576, 10376, 11028, 11514, 11984, 12395, 12719, 13563, 14100, 14502, 15356, 16023, 16742, 17493, 18312]","[286, 412, 560, 689, 824, 1270, 1417, 1553, 1735, 2097, 2261, 2729, 3226, 3321, 4064, 4237, 4501, 4823, 5227, 5419, 6211, 6350, 7093, 7707, 8087, 8462, 8894, 9218, 9470, 9839, 10497, 10706, 11187, 11287, 11423]","[259, 395, 571, 706, 841, 1106, 1447, 1588, 1901, 2025, 2439, 2817, 3431, 3802, 4114, 4286, 4736, 5030, 5934, 6416, 6767, 6861, 7636, 7803, 8057, 8329, 8737, 9107, 9475, 9755, 10533, 10864, 11164, 11309, 11635]",26236,22242,18312,11423,11635,-2952,-2123,445,-1373,-3319,-9322,35,dire
7529378713,76,53,43,85,19,"[0, 546, 794, 1324, 1862, 2355, 3005, 3385, 4131, 4686, 5365, 6208, 6874, 7433, 7736, 7831, 8132, 8459, 9881, 10562, 11149, 11854, 12968, 13723, 14469, 15453, 16104, 17584, 18184, 19057, 20171, 20872, 22299, 23638, 25034]","[0, 267, 466, 848, 1223, 1431, 1823, 2347, 2506, 3282, 3834, 4477, 4695, 4976, 5562, 6117, 7026, 7423, 8517, 9071, 9629, 9985, 10345, 11479, 11672, 12326, 12863, 14386, 14982, 15566, 16241, 17271, 17371, 18170, 19074]","[0, 210, 426, 553, 844, 1007, 1505, 1789, 2391, 3005, 3444, 3920, 4234, 4638, 5162, 5582, 6000, 6133, 6976, 7731, 8173, 8716, 9116, 9886, 10330, 10613, 11304, 12039, 12419, 13040, 13662, 13762, 13885, 14254, 15197]","[0, 195, 285, 538, 814, 950, 1182, 1678, 1946, 2236, 2627, 2918, 3098, 3646, 3798, 4049, 4282, 5030, 5782, 6229, 6473, 6751, 6953, 7171, 7546, 7775, 8351, 8824, 9041, 9227, 9543, 9827, 10044, 10349, 10854]","[0, 195, 285, 375, 465, 555, 955, 1115, 1274, 1510, 1906, 2122, 2302, 2538, 2633, 2728, 2823, 2917, 3397, 3862, 3994, 4237, 4332, 4581, 4911, 5119, 5442, 5932, 6109, 6736, 7101, 7201, 7409, 8000, 8608]",25034,19074,15197,10854,8608,80,23,112,31,26,"[0, 322, 627, 915, 1005, 1305, 1441, 2108, 2915, 3063, 3275, 4015, 4331, 4822, 5493, 6638, 7586, 8712, 8807, 9296, 10218, 11333, 11666, 12356, 13173, 14179, 15056, 15605, 16575, 16974, 17616, 18577, 19808, 20694, 20794]","[0, 248, 520, 647, 857, 1082, 1299, 1529, 1829, 2288, 2459, 2624, 2920, 3537, 3898, 4670, 5300, 6047, 6688, 6873, 7325, 7898, 8554, 8893, 9526, 10123, 10613, 10708, 11044, 11345, 11765, 12512, 13135, 13647, 14134]","[0, 400, 572, 1018, 1399, 1730, 2214, 2596, 3181, 3446, 3721, 3940, 4629, 5413, 5834, 6405, 7082, 8051, 8146, 8668, 9039, 9766, 10414, 10937, 11330, 11992, 12516, 12765, 13013, 13228, 13453, 14873, 15764, 16329, 16872]","[0, 311, 401, 491, 619, 709, 1098, 1278, 1458, 1548, 1939, 2356, 2446, 2714, 2982, 3933, 4389, 5230, 5325, 5461, 5733, 6326, 6493, 7026, 7449, 7615, 8133, 8382, 8803, 9422, 10272, 11470, 12534, 12992, 13092]","[0, 210, 345, 435, 567, 657, 747, 927, 1107, 1197, 1552, 1957, 2189, 2386, 2806, 3441, 3689, 4815, 4910, 5096, 5274, 5522, 5689, 5991, 6272, 6613, 6852, 7080, 7447, 7662, 7895, 8741, 9429, 9899, 10168]",20794,14134,16872,13092,10168,4240,4940,-1675,-2238,-1560,3707,35,dire
7529403415,25,95,69,5,20,"[0, 370, 694, 958, 1216, 1507, 1975, 2421, 3165, 3781, 4406, 4632, 5160, 5697, 6257, 6672, 7582, 8023, 8286, 8479, 8781, 9318, 9994, 10479, 12272, 12844, 13729, 13985, 14370, 14680, 15442, 15955, 16777, 18013, 18429]","[0, 239, 527, 909, 1243, 1442, 1963, 2416, 2924, 3224, 3682, 3848, 4540, 5370, 5773, 6325, 6974, 7619, 8483, 9258, 10040, 11359, 11453, 12403, 14041, 14135, 14748, 15255, 15936, 16032, 16819, 17039, 18005, 18592, 19384]","[0, 333, 611, 972, 1427, 1737, 2013, 2500, 2747, 3027, 3399, 3985, 4625, 5118, 5639, 5965, 6571, 7294, 7706, 8051, 8306, 8777, 8871, 9048, 10047, 10547, 11276, 11706, 11846, 12102, 12773, 13033, 13448, 13811, 14504]","[0, 170, 260, 394, 550, 640, 744, 1132, 1270, 1424, 2039, 2129, 2500, 3065, 3249, 3344, 3911, 4135, 4229, 4590, 4782, 5059, 5153, 5454, 6292, 6386, 6810, 7176, 7272, 7407, 8129, 8229, 8818, 9357, 9457]","[0, 170, 260, 409, 568, 706, 836, 981, 1071, 1161, 1542, 1681, 2335, 2753, 3046, 3141, 3651, 3817, 3911, 4151, 4408, 4542, 4670, 4810, 5420, 5514, 5754, 5849, 5945, 6041, 6404, 6504, 6878, 6978, 7078]",18429,19384,14504,9457,7078,32,55,74,121,71,"[0, 170, 693, 838, 1199, 1567, 2384, 2513, 2944, 3420, 4027, 4535, 4834, 5204, 5605, 6062, 6593, 7171, 8230, 9377, 10072, 11452, 11998, 13004, 13535, 13845, 14397, 14818, 16046, 16765, 17536, 19116, 20058, 21003, 22367]","[0, 207, 568, 803, 1089, 1558, 1813, 1903, 2196, 2511, 2935, 3602, 4239, 5286, 5662, 6622, 6899, 7435, 8489, 9239, 10212, 11144, 12007, 12393, 13657, 14137, 14694, 15002, 15877, 16412, 16640, 16740, 17388, 17668, 18174]","[0, 206, 422, 512, 882, 1125, 1626, 1856, 2116, 2242, 2801, 3238, 3603, 4044, 4525, 4952, 5246, 5682, 6499, 7379, 7869, 8083, 8956, 9649, 10147, 10985, 11519, 12034, 12682, 13244, 13861, 14302, 15028, 15764, 16270]","[0, 170, 337, 427, 578, 734, 1032, 1316, 1503, 1747, 2130, 2539, 2674, 3266, 3777, 4390, 4587, 4886, 6151, 6634, 7025, 7939, 8283, 8669, 9071, 9717, 9984, 10223, 11350, 11943, 12372, 12702, 13176, 13574, 14080]","[0, 219, 347, 437, 527, 773, 953, 1080, 1170, 1427, 1607, 2317, 2407, 2991, 3340, 3656, 3940, 4183, 4919, 5792, 6258, 6464, 7048, 7618, 8587, 9058, 9485, 10006, 10619, 11688, 11872, 12549, 12866, 13421, 13965]",22367,18174,16270,14080,13965,-3938,1210,-1766,-4623,-6887,-16004,35,dire
7529493512,32,82,78,71,58,"[0, 285, 492, 973, 1330, 1459, 1798, 2127, 2445, 2831, 3367, 3794, 4420, 5010, 5105, 6390, 6574, 6731, 7403, 8558, 9257, 10558, 10725, 11097, 11383, 12305, 13208, 13796, 14621, 15298, 15708, 16373, 17569, 18189, 18498]","[0, 245, 485, 768, 1054, 1370, 1734, 2270, 2688, 3035, 3413, 3728, 4000, 4874, 5818, 6563, 7383, 7953, 8326, 8948, 9809, 10871, 11632, 12235, 12330, 13301, 13772, 14255, 14537, 15183, 16431, 17434, 18440, 18775, 19351]","[0, 279, 538, 890, 1275, 1495, 1829, 1953, 2264, 2848, 3623, 3838, 4149, 4533, 4873, 5680, 6021, 6293, 6819, 7345, 7766, 8622, 8878, 9108, 9377, 9739, 10249, 11190, 12168, 12731, 13698, 14211, 15093, 15328, 15428]","[0, 170, 260, 396, 486, 820, 943, 1071, 1290, 1641, 2048, 2263, 2398, 2666, 3094, 3881, 3976, 4752, 5169, 5792, 6105, 6312, 6606, 6836, 7542, 7889, 8416, 8754, 9254, 9688, 10610, 10820, 11395, 11630, 11730]","[0, 272, 362, 501, 658, 748, 877, 967, 1086, 1221, 1612, 1827, 2039, 2447, 2790, 3029, 3216, 3495, 4160, 4857, 5153, 5761, 5928, 6513, 6787, 7297, 7563, 7698, 7875, 8349, 8722, 9601, 10394, 10629, 10729]",18498,19351,15428,11730,10729,17,14,21,51,20,"[57, 379, 746, 1119, 1612, 1894, 2358, 2968, 3447, 3752, 4415, 5140, 5777, 6308, 6995, 7507, 8371, 8739, 9742, 9999, 10411, 11550, 12210, 13347, 14023, 14641, 15422, 15784, 16702, 17062, 17750, 18475, 18575, 19800, 20542]","[57, 266, 557, 754, 1290, 1590, 2038, 2651, 3115, 3360, 3808, 4118, 4742, 5256, 5712, 6092, 7054, 7574, 8006, 8935, 9822, 10761, 11137, 12309, 12872, 13763, 14442, 14819, 15995, 16639, 17754, 18364, 18651, 19958, 20894]","[57, 266, 1048, 1295, 1579, 1979, 2321, 2886, 3268, 3686, 4531, 5263, 5852, 6298, 6890, 7154, 7991, 8544, 8639, 8797, 9877, 10738, 11202, 12094, 12578, 13099, 13755, 14330, 15382, 15622, 16448, 16548, 16858, 18386, 18800]","[57, 227, 443, 581, 804, 1160, 1295, 1474, 1738, 2455, 2806, 3093, 3312, 3521, 3956, 4051, 4381, 4882, 5025, 5327, 5788, 5882, 6233, 6762, 7133, 7739, 7834, 8131, 8623, 8945, 9544, 10507, 10628, 11560, 11786]","[325, 495, 585, 692, 833, 1000, 1169, 1645, 1870, 2183, 2807, 2966, 3393, 3696, 3888, 3983, 4434, 4662, 4757, 5096, 5330, 5572, 5739, 6663, 6950, 7492, 7738, 8035, 8544, 8761, 9010, 9676, 9776, 10198, 10867]",20542,20894,18800,11786,10867,-2044,-1543,-3372,-56,-138,-7153,35,dire
7529570918,25,98,114,112,86,"[615, 1015, 1475, 2087, 2518, 2732, 3391, 3988, 4513, 5090, 5459, 6109, 6648, 7383, 8035, 9125, 9782, 10517, 11497, 12091, 12418, 12967, 13613, 14546, 15575, 16131, 16227, 17704, 17800, 18051, 18523, 19574, 19764, 20623, 21354]","[606, 938, 1256, 2001, 2412, 2921, 3605, 4217, 4384, 5205, 5785, 6162, 6558, 7223, 7849, 8433, 8924, 9620, 10173, 10728, 11561, 11656, 12513, 12843, 13273, 13743, 14161, 14845, 15047, 15244, 15678, 16223, 17825, 18268, 18638]","[766, 1061, 1595, 1832, 2355, 2779, 2920, 3447, 3652, 4111, 4601, 5007, 5377, 5604, 6198, 6531, 6749, 7785, 8123, 8637, 8827, 9730, 10320, 10873, 11468, 12374, 12767, 13987, 14706, 14919, 15303, 15514, 15704, 16162, 16683]","[629, 742, 880, 970, 1118, 1208, 1298, 1552, 1687, 2053, 2143, 2408, 2804, 3438, 3686, 3830, 4138, 4510, 4605, 4800, 5177, 5403, 5719, 6020, 6312, 6592, 6755, 7071, 7220, 7320, 7420, 7921, 8111, 8468, 8632]","[332, 506, 616, 927, 1017, 1107, 1242, 1545, 2002, 2342, 2432, 2694, 3181, 3523, 4121, 4466, 4684, 5028, 5169, 5436, 5646, 5741, 5931, 6332, 6474, 6679, 6775, 6926, 7141, 7404, 7731, 7831, 8138, 8373, 8510]",21354,18638,16683,8632,8510,56,43,60,26,83,"[525, 736, 1151, 1453, 1704, 2133, 2876, 3256, 4200, 4744, 5200, 5651, 6100, 6560, 7236, 7805, 8429, 9126, 10092, 10550, 10977, 11909, 12693, 13395, 14066, 15021, 15922, 16691, 17593, 18515, 19056, 20233, 20695, 21754, 22918]","[614, 790, 1244, 1901, 2277, 3244, 3787, 4385, 5096, 5604, 6113, 6356, 6863, 7516, 8272, 8882, 9990, 10211, 10571, 10668, 11555, 12237, 12687, 13334, 13891, 14640, 15067, 16095, 16571, 16966, 17066, 18115, 18215, 18738, 19202]","[456, 830, 1043, 1508, 1681, 2089, 2521, 2938, 3858, 4235, 4647, 5182, 5738, 6293, 6870, 7110, 8169, 8787, 9369, 9876, 10254, 10696, 10974, 11495, 11934, 12807, 13878, 14379, 15222, 15750, 16305, 17410, 17908, 18403, 18885]","[260, 350, 440, 625, 760, 1530, 2017, 2269, 2404, 2548, 2815, 2972, 3117, 3387, 3675, 3911, 4609, 4830, 4925, 5071, 5449, 5767, 6010, 6252, 6622, 7201, 7534, 7918, 8079, 8269, 8596, 9240, 9340, 9620, 9744]","[260, 350, 440, 530, 665, 885, 1244, 1334, 1712, 1856, 2068, 2385, 2491, 2763, 2984, 3085, 3578, 3799, 3894, 3996, 4379, 4913, 5278, 5445, 5539, 5828, 6086, 6410, 6506, 6696, 6796, 7384, 7484, 7844, 8017]",22918,19202,18885,9744,8017,-1564,-564,-2202,-1112,493,-4949,35,radiant
7529662500,12,106,96,86,45,"[1420, 1622, 1950, 2223, 2681, 2942, 3614, 3999, 4742, 5234, 6398, 7235, 7653, 8355, 9717, 10687, 11664, 12586, 13725, 14799, 15685, 16833, 18350, 19448, 20498, 21839, 22825, 24682, 25986, 26902, 28543, 29427, 30346, 30974, 31662]","[1493, 1935, 2189, 2431, 2588, 2852, 3185, 3649, 4076, 4419, 4902, 6007, 6284, 7203, 8139, 9025, 9665, 10079, 11461, 11974, 12893, 13674, 14368, 14864, 15855, 16201, 16667, 17513, 18178, 19338, 20459, 21130, 21918, 22473, 23019]","[1535, 1742, 2148, 2684, 3083, 3471, 4014, 4408, 4800, 4993, 5404, 5866, 6170, 6620, 7385, 7871, 8217, 8705, 10002, 10187, 10520, 11293, 11882, 12213, 12534, 12790, 13048, 13491, 13737, 14207, 14714, 15659, 16353, 16628, 17229]","[715, 1077, 1212, 1387, 1654, 1744, 2024, 2149, 2288, 2646, 3090, 3317, 3768, 4211, 4413, 5165, 5506, 5938, 6484, 6702, 7006, 7715, 8427, 9292, 9737, 10281, 10766, 11146, 11321, 11837, 12394, 12624, 13094, 13253, 13858]","[765, 963, 1098, 1318, 1467, 1557, 1737, 1827, 1922, 2251, 2667, 2960, 3129, 3679, 3973, 4795, 5019, 5467, 6298, 6586, 6890, 7387, 7708, 8215, 8752, 9004, 9381, 9771, 9950, 10174, 10773, 11223, 11613, 12141, 12639]",31662,23019,17229,13858,12639,41,47,33,19,26,"[1323, 1581, 1840, 1970, 2493, 3054, 3236, 3952, 4407, 4844, 5238, 5779, 6366, 7067, 7696, 8452, 9019, 9390, 9623, 10603, 11282, 12223, 13046, 13142, 13724, 14113, 14250, 14980, 15482, 15672, 15772, 16541, 17137, 18263, 21673]","[1576, 1889, 2726, 3206, 4015, 4449, 4947, 5383, 6079, 6398, 6628, 7072, 7672, 8289, 8457, 8552, 8948, 9114, 9555, 10226, 10914, 11625, 12164, 12861, 13224, 13648, 14445, 15376, 15722, 15986, 16086, 16710, 17323, 17700, 18554]","[1988, 2493, 2783, 3191, 3434, 4480, 4668, 5576, 6102, 6692, 6984, 7351, 7821, 8508, 8758, 9122, 9369, 9535, 9936, 10373, 10772, 11151, 11406, 11907, 12196, 12526, 12626, 12939, 13248, 13769, 14207, 14691, 14973, 15182, 16138]","[803, 1057, 1237, 1373, 1463, 1815, 1905, 2426, 2608, 2743, 3008, 3292, 3671, 4019, 4177, 4273, 4580, 4784, 4954, 5249, 5706, 6118, 6336, 6507, 6688, 6969, 7182, 7357, 7941, 8179, 8731, 9150, 9650, 10111, 10556]","[829, 1188, 1368, 1458, 1682, 2034, 2124, 2507, 2656, 2923, 3265, 3549, 3689, 3835, 4023, 4510, 4605, 4966, 5189, 5648, 5981, 6076, 6196, 6440, 6755, 6895, 7005, 7125, 7225, 7463, 7831, 8002, 8146, 8276, 8653]",21673,18554,16138,10556,8653,9989,4465,1091,3302,3986,22833,35,radiant
7529668400,15,21,59,19,91,"[0, 205, 452, 746, 1088, 1288, 1629, 1997, 2087, 2448, 2880, 3385, 4182, 4812, 5327, 5871, 6745, 7302, 8128, 8912, 9340, 10170, 10649, 11054, 11544, 12008, 12439, 12961, 13162, 14824, 15792, 16378, 16763, 17589, 17862]","[0, 170, 607, 930, 1452, 1750, 1879, 2304, 2710, 3178, 3714, 3889, 4446, 5265, 5624, 6057, 6385, 6974, 7616, 8049, 8587, 9328, 10198, 10999, 11561, 12348, 12820, 13919, 14385, 15051, 15541, 16804, 17318, 17773, 17873]","[0, 258, 633, 980, 1270, 1725, 2378, 2714, 3160, 3681, 4769, 5336, 6187, 6949, 7514, 7921, 8186, 8542, 9389, 9698, 10327, 10479, 11115, 11606, 12062, 12586, 12769, 13373, 13469, 14077, 14498, 14988, 15534, 16144, 16244]","[0, 270, 432, 552, 745, 993, 1163, 1336, 1594, 1761, 2362, 2665, 3043, 3594, 3894, 4590, 4753, 4848, 5443, 5549, 5803, 6343, 6581, 7104, 7203, 7298, 7392, 7750, 8091, 8387, 8869, 9359, 9583, 10126, 10518]","[0, 170, 260, 380, 604, 779, 891, 1088, 1227, 1394, 1697, 1835, 2252, 2491, 2640, 2781, 2988, 3083, 3502, 3596, 3840, 4183, 4349, 4531, 4651, 4794, 4888, 4983, 5126, 5584, 5729, 5829, 6053, 6303, 6403]",17862,17873,16244,10518,6403,1,43,74,51,45,"[0, 582, 1009, 1238, 1528, 2106, 2524, 3039, 3393, 3636, 4085, 4438, 4615, 5284, 5808, 6869, 7901, 8606, 9647, 11049, 11920, 12947, 13702, 14799, 15676, 16791, 17890, 19152, 20312, 21149, 22047, 23330, 24381, 26150, 27914]","[0, 256, 634, 848, 1141, 1541, 2089, 2282, 2634, 3441, 3913, 4686, 5123, 5933, 6386, 6759, 7446, 7718, 8484, 9738, 10432, 10938, 11355, 11906, 12114, 12627, 13379, 14150, 15070, 15571, 15667, 16326, 16728, 17993, 19123]","[0, 256, 463, 674, 764, 961, 1097, 1392, 1738, 2064, 2315, 2664, 3081, 3753, 4136, 4704, 5119, 5710, 5805, 6622, 7358, 7963, 8551, 9404, 9703, 10606, 11396, 11998, 12498, 12999, 13924, 14734, 15397, 16353, 17665]","[0, 170, 285, 375, 510, 630, 1111, 1201, 1438, 1733, 1963, 2268, 2428, 2755, 3002, 3521, 3799, 4145, 4395, 5246, 5482, 5884, 6191, 6383, 6828, 7297, 7767, 8088, 8514, 9288, 9384, 9917, 10088, 10476, 11320]","[0, 239, 354, 444, 621, 859, 993, 1083, 1320, 1483, 1620, 1909, 2048, 2331, 2470, 2830, 3084, 3597, 3692, 4309, 4545, 4916, 5082, 5288, 5496, 5820, 6108, 6557, 6897, 7822, 8314, 8637, 8878, 9368, 10088]",27914,19123,17665,11320,10088,-10052,-1250,-1421,-802,-3685,-17210,35,dire
7529670117,41,13,69,86,3,"[446, 648, 975, 1247, 1898, 2297, 2721, 2977, 3625, 4122, 4493, 5013, 5437, 6193, 6936, 7545, 8181, 8951, 9492, 10325, 11506, 12347, 13308, 14115, 15060, 16468, 16918, 17847, 19090, 20940, 21995, 22718, 24766, 25261, 26192]","[657, 1027, 1478, 1892, 2376, 3172, 3262, 3519, 3991, 4290, 5016, 5165, 5683, 6231, 6561, 6719, 6956, 7340, 7711, 8322, 9016, 9629, 9998, 11203, 11763, 12883, 13640, 14132, 15129, 16631, 17863, 18936, 19812, 20242, 20869]","[628, 957, 1367, 1659, 1914, 2288, 2634, 2803, 3238, 3563, 4267, 4932, 5442, 5794, 6422, 7258, 8032, 8398, 8689, 9443, 10043, 10581, 11095, 11687, 11993, 13613, 14401, 14849, 15226, 15871, 16927, 17511, 18449, 19068, 19444]","[334, 441, 575, 749, 919, 1227, 1317, 1444, 1579, 2213, 2303, 2452, 2945, 3544, 4256, 4389, 4939, 5216, 5504, 5757, 6302, 6723, 7325, 7702, 7871, 8754, 9097, 9297, 9574, 10166, 10466, 11060, 11250, 11384, 11546]","[260, 456, 563, 720, 941, 1256, 1346, 1680, 2052, 2222, 2312, 2507, 2843, 3073, 3459, 3554, 3648, 4326, 4421, 4786, 5024, 5119, 5336, 5638, 5988, 6709, 6880, 7051, 7953, 8817, 9166, 9827, 10346, 10503, 10603]",26192,20869,19444,11546,10603,114,90,129,20,26,"[524, 853, 1027, 1455, 1867, 2293, 2593, 3133, 3729, 4383, 4939, 5642, 6384, 7137, 7340, 7950, 8504, 9210, 9468, 10168, 11068, 12008, 12776, 13787, 14668, 15288, 16165, 17078, 18123, 18977, 19077, 19457, 19647, 19882, 21085]","[625, 951, 1408, 1864, 2484, 3020, 3661, 4379, 5020, 5538, 6048, 6866, 7235, 7542, 8161, 9228, 9426, 9851, 10419, 11060, 11930, 12336, 12784, 13427, 13878, 14245, 14956, 15645, 16295, 16642, 17044, 18139, 18329, 18603, 19234]","[472, 790, 952, 1371, 1658, 2118, 2288, 2923, 3170, 3695, 4232, 5050, 5515, 5914, 6425, 6778, 7240, 7646, 7943, 8765, 9463, 10204, 11218, 12154, 12612, 13561, 14141, 14948, 15634, 16134, 16234, 16931, 17448, 18091, 18648]","[375, 596, 760, 944, 1116, 1302, 1514, 1910, 2045, 2567, 2808, 3278, 3526, 3979, 4429, 4954, 5048, 5827, 5956, 6104, 6390, 6615, 6904, 7236, 7528, 7803, 8320, 8722, 9170, 9570, 9901, 10001, 10363, 10598, 10698]","[260, 350, 440, 929, 1066, 1156, 1246, 1548, 1792, 1929, 2263, 2881, 3177, 3302, 3705, 3952, 4046, 4600, 4695, 4790, 4956, 5051, 5146, 5403, 5634, 6001, 6259, 6539, 6878, 7068, 7168, 7268, 7458, 7693, 7793]",21085,19234,18648,10698,7793,5107,1635,796,848,2810,11196,35,radiant
7530098507,48,106,65,58,136,"[0, 253, 536, 781, 1249, 1574, 2104, 2479, 3161, 3656, 4270, 4798, 5321, 6166, 7054, 7725, 8590, 9120, 10194, 11578, 12731, 13001, 13520, 14118, 15383, 16207, 16861, 17113, 17561, 18150, 19141, 19538, 20512, 21223, 21933]","[0, 354, 614, 976, 1352, 1612, 1869, 2300, 2754, 3400, 3826, 4460, 4846, 5288, 5868, 6219, 6844, 7012, 7663, 8154, 8616, 9392, 10093, 10188, 10765, 10931, 11137, 11416, 11632, 12087, 12714, 13327, 14260, 14927, 15429]","[0, 205, 530, 899, 1461, 1649, 2336, 2833, 3206, 3919, 4210, 4651, 5151, 5652, 6533, 6999, 7412, 8058, 8514, 8762, 9377, 9471, 10187, 10898, 11363, 12072, 12391, 12486, 12582, 13205, 13483, 13673, 14539, 15151, 15902]","[0, 170, 260, 389, 519, 639, 759, 894, 1076, 1543, 1767, 2029, 2326, 2615, 2896, 3081, 3620, 3714, 4173, 4400, 4973, 5337, 5539, 5847, 6138, 6628, 6805, 6900, 7019, 7516, 7833, 8075, 8230, 8478, 8619]","[0, 170, 294, 431, 629, 958, 1166, 1426, 1621, 2006, 2141, 2366, 2661, 2909, 3093, 3188, 3395, 3857, 4087, 4505, 4815, 4928, 5407, 5502, 5737, 6088, 6241, 6336, 6640, 7397, 7493, 7683, 7783, 7883, 7983]",21933,15429,15902,8619,7983,10,96,17,66,86,"[0, 255, 494, 792, 1172, 1527, 2068, 2483, 2931, 3251, 3907, 4496, 4826, 5430, 6216, 6898, 7524, 8532, 9289, 10438, 11355, 12571, 13586, 14860, 15733, 16591, 17872, 18409, 19050, 20063, 21070, 22364, 23276, 24097, 24806]","[0, 245, 482, 705, 1109, 1473, 1671, 2170, 2630, 3060, 3605, 4156, 4758, 5199, 5707, 6100, 6325, 7141, 7778, 8629, 8724, 9100, 9635, 10369, 11033, 11349, 12086, 12353, 12559, 13037, 13814, 14145, 14436, 14970, 15723]","[0, 222, 568, 778, 1158, 1248, 1682, 1998, 2296, 2386, 2825, 3513, 4121, 4590, 5199, 5903, 6090, 7165, 7904, 8503, 9087, 9465, 9937, 10532, 10942, 11216, 11788, 12075, 12281, 12735, 13070, 13787, 14478, 14691, 15295]","[0, 204, 294, 428, 615, 750, 858, 1018, 1241, 1359, 1799, 2167, 2467, 2881, 2976, 3342, 3598, 4070, 4416, 4855, 5172, 5582, 6060, 6286, 6647, 7085, 7439, 7534, 7883, 8321, 8751, 9304, 9600, 10259, 10742]","[0, 170, 305, 412, 772, 956, 1132, 1222, 1571, 1862, 2192, 2537, 2734, 3139, 3426, 3697, 4316, 4718, 5080, 5828, 6123, 6467, 6972, 7208, 7303, 7612, 8590, 8903, 9318, 9605, 10041, 10534, 10634, 10796, 11020]",24806,15723,15295,10742,11020,-2873,-294,607,-2123,-3037,-7720,35,dire
7530159016,41,53,129,97,105,"[326, 530, 728, 1040, 1304, 1818, 2098, 2233, 2532, 3121, 3569, 4017, 4737, 5068, 5710, 6268, 6735, 7456, 7771, 7954, 8459, 9258, 9353, 9592, 10324, 10912, 11412, 11975, 12749, 13555, 14451, 15475, 16542, 17391, 18056]","[251, 341, 431, 818, 993, 1739, 1950, 2108, 2485, 3121, 3542, 4156, 4641, 4813, 5847, 6068, 7133, 7706, 8180, 8574, 8942, 9612, 9868, 10396, 11109, 11576, 12380, 13065, 13473, 13871, 14217, 15151, 16517, 17789, 18064]","[511, 762, 1079, 1361, 1562, 1757, 2228, 2515, 3302, 3823, 4251, 4689, 5627, 5829, 6063, 6715, 7421, 7622, 7945, 8173, 8937, 9660, 10132, 10418, 11295, 11954, 12357, 13176, 13513, 13865, 14719, 15570, 16104, 16775, 17597]","[242, 419, 675, 924, 1415, 2106, 2233, 2695, 3000, 3448, 3963, 4380, 5014, 5146, 5802, 6215, 6566, 7118, 7460, 7678, 8104, 8712, 8963, 9445, 9993, 10168, 10550, 11101, 11662, 12107, 13133, 14212, 14819, 15009, 15637]","[169, 259, 366, 500, 753, 1147, 1711, 1846, 2329, 2721, 2857, 2996, 3372, 3467, 4121, 4342, 4602, 4865, 5022, 5117, 5280, 5742, 5993, 6232, 6533, 7139, 7398, 7575, 7716, 7861, 8235, 8575, 9113, 9303, 9828]",18056,18064,17597,15637,9828,25,36,96,100,20,"[264, 652, 1165, 1427, 1811, 2361, 3418, 4010, 4312, 5098, 5439, 6270, 6896, 7946, 8876, 9732, 10515, 11509, 13336, 14319, 15122, 16204, 17785, 19043, 19945, 20949, 21815, 22958, 23776, 24581, 25238, 26096, 27260, 28501, 30431]","[571, 934, 1275, 1652, 2019, 2477, 2853, 3481, 3938, 4758, 5362, 5982, 6617, 7798, 8168, 9296, 9901, 10687, 11210, 11995, 12620, 13270, 14243, 14930, 15817, 16348, 17135, 18063, 18931, 19621, 20291, 21378, 21717, 22162, 22909]","[304, 554, 918, 1184, 1669, 1840, 2113, 2772, 3076, 3613, 3823, 4236, 4890, 5342, 5700, 6555, 6997, 7464, 8294, 8774, 9513, 10163, 10998, 11363, 11732, 12450, 13026, 13575, 14003, 14364, 14602, 15009, 15432, 15622, 16129]","[229, 423, 592, 1015, 1190, 1699, 2135, 2834, 3015, 3335, 3426, 3561, 3826, 4132, 4689, 5210, 5447, 5883, 6476, 7022, 7189, 7529, 8358, 8674, 9069, 9541, 9708, 9965, 10279, 10569, 10759, 10994, 11553, 11743, 12133]","[229, 319, 457, 593, 777, 867, 957, 1195, 1358, 1956, 2159, 2310, 2597, 2798, 3021, 3542, 3976, 4212, 4804, 5173, 5533, 5950, 6153, 6438, 6760, 7190, 7334, 7515, 7893, 8150, 8340, 8812, 9177, 9641, 10058]",30431,22909,16129,12133,10058,-12375,-4845,1468,3504,-230,-12478,35,dire
7530463515,114,74,104,84,7,"[0, 253, 417, 837, 1175, 1626, 1955, 2529, 2765, 3298, 3834, 4307, 4861, 5449, 5918, 6831, 7461, 8179, 8652, 9710, 10137, 10505, 11511, 12517, 12900, 13771, 15634, 16609, 17710, 18437, 19316, 19691, 21728, 22608, 22708]","[0, 239, 513, 835, 1164, 1501, 1664, 2075, 2563, 3178, 3858, 4882, 5358, 6076, 6935, 7705, 8492, 9476, 9793, 10520, 11384, 11973, 12673, 13272, 14381, 15481, 15866, 16759, 17295, 17704, 18285, 18498, 19717, 20930, 21373]","[0, 330, 492, 760, 1262, 1729, 1979, 2112, 2883, 3170, 3552, 3984, 4506, 5399, 5693, 6482, 6985, 7589, 8432, 9176, 9859, 10444, 10979, 11145, 11572, 12427, 14285, 14490, 15111, 15642, 16002, 16186, 16437, 17112, 17688]","[0, 208, 385, 521, 660, 798, 936, 1070, 1256, 1395, 1563, 1761, 1895, 2147, 2522, 2964, 3095, 3619, 4157, 5313, 6065, 6394, 7106, 7347, 8077, 8967, 9322, 9922, 10093, 10579, 11376, 11496, 11747, 12737, 12837]","[0, 169, 259, 349, 484, 619, 709, 799, 1027, 1162, 1371, 1613, 1747, 2012, 2324, 2617, 2779, 3155, 3510, 3799, 4184, 4663, 4758, 4932, 5204, 5481, 6320, 6731, 6956, 7214, 7391, 7535, 7996, 8803, 8959]",22708,21373,17688,12837,8959,1,19,53,96,5,"[0, 207, 640, 1050, 1497, 1987, 2416, 2872, 3208, 3756, 4030, 4377, 4856, 5326, 5819, 6303, 6811, 7239, 7997, 8863, 9902, 10627, 11376, 12535, 13313, 14329, 15133, 15330, 16644, 17501, 18328, 20194, 20980, 22691, 24606]","[0, 335, 627, 955, 1327, 1677, 2355, 2704, 3050, 3563, 4202, 4292, 4883, 5453, 5796, 6269, 6839, 7190, 7663, 8204, 8917, 9012, 10345, 10944, 11379, 11673, 12841, 12936, 14827, 15406, 16055, 17465, 17868, 19212, 20373]","[0, 219, 309, 443, 633, 780, 1007, 1097, 1232, 1412, 1749, 2154, 2588, 3125, 3625, 3969, 4337, 4816, 5748, 6390, 6883, 7927, 9526, 9830, 10213, 10682, 12277, 12430, 13827, 14590, 15213, 16145, 16388, 16909, 17894]","[0, 241, 483, 925, 1194, 1440, 1907, 2110, 2660, 3152, 3653, 3898, 4522, 4793, 5225, 5713, 5871, 6592, 7579, 8082, 8508, 8966, 9438, 10082, 10267, 10498, 11098, 11482, 12658, 13131, 13388, 14634, 14798, 15319, 16261]","[0, 169, 285, 461, 551, 687, 866, 1056, 1267, 1447, 1582, 1719, 1986, 2155, 2250, 2344, 2502, 2597, 3172, 3446, 3849, 3944, 4450, 4618, 4957, 5104, 5643, 5738, 6696, 6963, 7172, 7837, 8052, 8152, 8858]",24606,20373,17894,16261,8858,-1898,1000,-206,-3424,101,-4427,35,dire
7530650619,120,41,78,68,123,"[0, 350, 640, 891, 1222, 1501, 1753, 2257, 2887, 3257, 3975, 4841, 5670, 6447, 7570, 8087, 8758, 9223, 9717, 10416, 11395, 12343, 13134, 13603, 14039, 14930, 15514, 16462, 17138, 18010, 19053, 19413, 19513, 20673, 21852]","[0, 350, 549, 797, 1106, 1514, 1821, 2204, 2576, 2892, 3230, 3740, 4327, 5039, 5582, 5775, 6338, 6888, 7616, 8159, 8835, 9604, 10328, 11061, 11613, 12672, 12930, 13302, 14194, 14685, 15165, 15525, 16128, 17354, 18386]","[0, 232, 510, 745, 983, 1371, 1703, 2103, 2481, 2983, 3204, 3736, 4264, 4764, 5370, 5464, 5760, 5855, 6236, 6524, 6887, 7182, 7707, 8338, 8521, 8965, 9336, 9827, 10272, 11345, 11994, 12547, 12942, 13778, 14331]","[0, 195, 285, 375, 549, 684, 819, 1190, 1390, 1652, 1885, 2203, 2546, 2875, 3236, 3389, 4098, 4394, 4979, 5177, 5748, 5926, 6335, 6781, 6912, 7079, 7173, 7645, 8343, 8520, 8918, 9382, 9717, 10235, 10671]","[0, 195, 285, 499, 731, 966, 1101, 1613, 2116, 2246, 2475, 2747, 3042, 3387, 3821, 4094, 4517, 4686, 5016, 5282, 5435, 5583, 6215, 6685, 6955, 7255, 7524, 7895, 8340, 8829, 8925, 9191, 9542, 10180, 10672]",21852,18386,14331,10671,10672,25,18,29,66,20,"[61, 308, 640, 1095, 1426, 1820, 2146, 2541, 2958, 3318, 3807, 4386, 4998, 5599, 6038, 6401, 6505, 7367, 8078, 8712, 9246, 9993, 10487, 10977, 11685, 12407, 13394, 13932, 14572, 15174, 16078, 18408, 19540, 20104, 21511]","[329, 535, 853, 1256, 1631, 1959, 2499, 2913, 3466, 3920, 4507, 5466, 6185, 6788, 7147, 7998, 8340, 9171, 9703, 10324, 10832, 11680, 12058, 12748, 12907, 13958, 14676, 15039, 15399, 15576, 16112, 17829, 18457, 19176, 19774]","[61, 459, 706, 1162, 1430, 1928, 2289, 2699, 3252, 3534, 4300, 4957, 5311, 5755, 6277, 6772, 7146, 7436, 8112, 8754, 9123, 9427, 9948, 10792, 11252, 11932, 12349, 12794, 13375, 13711, 14061, 14911, 15222, 15322, 15943]","[61, 290, 380, 564, 654, 857, 1099, 1632, 2192, 2342, 2637, 3007, 3172, 3431, 4048, 4799, 5268, 5558, 6171, 6788, 7117, 7368, 7908, 8347, 8617, 9197, 9600, 9879, 10214, 10741, 11115, 12121, 12515, 12813, 13530]","[61, 290, 380, 470, 560, 666, 756, 923, 1221, 1311, 1446, 1774, 2105, 2411, 2506, 3162, 3257, 3583, 4298, 4544, 4947, 5218, 5562, 5815, 5910, 6232, 6510, 6811, 7025, 7207, 7454, 7554, 8058, 8158, 8789]",21511,19774,15943,13530,8789,341,-1388,-1612,-2859,1883,-3635,35,dire
7530728311,48,39,96,79,26,"[0, 245, 442, 929, 1259, 1582, 2034, 2633, 3089, 3490, 3937, 4704, 5377, 5943, 6720, 7553, 9016, 9734, 10241, 10735, 11873, 12683, 13139, 13981, 14781, 15772, 16701, 17272, 17536, 18115, 19019, 19295, 19740, 20153, 20693]","[0, 244, 468, 783, 1061, 1375, 1906, 2041, 2564, 2914, 3499, 3932, 4442, 4681, 5175, 6198, 6939, 7370, 8259, 8705, 9264, 10384, 11325, 12260, 13192, 14013, 14736, 15183, 15718, 15814, 16567, 16757, 17446, 18071, 19372]","[0, 163, 443, 852, 1364, 1690, 2070, 2318, 2934, 3402, 4002, 4533, 5018, 5540, 5727, 6321, 7045, 7453, 7880, 8211, 8441, 9068, 9305, 9658, 10020, 10620, 10923, 11110, 11495, 11591, 12078, 12541, 12690, 12988, 13451]","[0, 129, 219, 346, 537, 627, 855, 983, 1118, 1263, 1398, 1673, 1801, 2075, 2456, 3016, 3562, 3847, 3942, 4374, 4743, 5421, 5769, 6311, 6406, 6770, 7011, 7344, 7971, 8067, 8531, 8721, 8865, 9551, 10100]","[0, 129, 219, 433, 572, 696, 921, 1288, 1519, 1664, 1799, 1916, 2373, 2507, 2846, 3395, 4221, 4355, 4596, 5046, 5452, 5763, 5857, 6072, 6543, 7170, 7374, 7469, 7646, 7787, 7956, 8183, 8617, 8925, 9152]",20693,19372,13451,10100,9152,8,17,98,121,45,"[0, 281, 518, 756, 1165, 1486, 1935, 2406, 2776, 3214, 3990, 4382, 4836, 5463, 6036, 6848, 7676, 8548, 9340, 10309, 11093, 11531, 11685, 12380, 12965, 13132, 14361, 15258, 16471, 17573, 18729, 19918, 20341, 20879, 21644]","[0, 325, 548, 913, 1087, 1254, 1555, 2016, 2582, 2772, 3373, 3885, 4446, 4862, 5290, 5715, 6374, 7085, 7742, 8193, 8402, 8569, 9485, 10207, 10933, 11414, 12229, 13009, 13618, 14164, 14838, 16142, 16453, 16829, 18344]","[0, 248, 573, 882, 1264, 1462, 1720, 1985, 2336, 2710, 3117, 3689, 3860, 4365, 4741, 5039, 5569, 6663, 7366, 8005, 8269, 8670, 9125, 9951, 10124, 10852, 11651, 12210, 12961, 13994, 14689, 15977, 16296, 17032, 17132]","[0, 209, 421, 553, 727, 908, 998, 1542, 1838, 2051, 2445, 2814, 3176, 3501, 3695, 3986, 4285, 4735, 5120, 5411, 5569, 6036, 6139, 6532, 6633, 6831, 7468, 7719, 8182, 8827, 9226, 9997, 10256, 10833, 11631]","[0, 209, 379, 856, 1141, 1283, 1373, 1594, 1767, 2021, 2427, 2521, 3012, 3590, 3760, 4276, 4587, 4920, 5261, 5427, 5585, 5824, 5920, 6305, 6625, 7142, 7478, 7690, 8185, 8974, 9187, 9879, 10302, 10657, 10945]",21644,18344,17132,11631,10945,-951,1028,-3681,-1531,-1793,-6928,35,dire
7530771503,38,61,129,90,65,"[1805, 2075, 2680, 3134, 3998, 4309, 5008, 5616, 6158, 6533, 7643, 8297, 8946, 9107, 9633, 10580, 11262, 12108, 13275, 14376, 15055, 15775, 16928, 17973, 19388, 19565, 20264, 21055, 21498, 22408, 23132, 23684, 24886, 25855, 26459]","[1022, 1417, 1666, 1974, 2314, 2953, 3704, 4132, 4887, 5565, 6345, 7147, 8428, 9041, 9862, 10721, 11375, 11738, 12386, 12981, 13593, 13996, 14555, 15178, 16543, 16850, 17623, 18294, 18586, 18964, 19505, 19989, 21007, 22138, 22921]","[1559, 2104, 2378, 2811, 3529, 3707, 4646, 5229, 5745, 6315, 6743, 7192, 7776, 8250, 8753, 9323, 9951, 10410, 11045, 11668, 12136, 12932, 13511, 14305, 15637, 16356, 17253, 17799, 18367, 19282, 20299, 20871, 22821, 23629, 24183]","[797, 905, 1211, 1436, 1743, 2013, 2302, 2392, 2700, 3189, 3524, 3830, 4455, 4614, 5208, 5989, 6214, 6581, 7184, 7583, 8023, 8686, 9300, 10326, 11321, 11878, 12770, 13219, 13394, 13632, 14023, 14185, 15358, 15839, 15984]","[541, 717, 1039, 1174, 1395, 1485, 1832, 2004, 2518, 2827, 3379, 3784, 4148, 4249, 4617, 5044, 5341, 5481, 6060, 6460, 6662, 7156, 7608, 7973, 8954, 9644, 10150, 10865, 11105, 11385, 11880, 11980, 12942, 13306, 13406]",26459,22921,24183,15984,13406,48,22,78,119,66,"[1530, 1820, 2395, 2835, 3292, 3819, 4269, 5002, 5607, 6032, 6641, 7314, 7967, 8761, 9541, 10699, 11257, 11954, 12970, 13690, 13937, 14231, 14977, 15280, 15763, 16974, 17804, 18822, 19346, 19623, 19745, 19970, 20070, 20931, 21223]","[1603, 1935, 2517, 3050, 3721, 4165, 4851, 5432, 5868, 6284, 6802, 7204, 8079, 9086, 9861, 10545, 11108, 11304, 12102, 12565, 13313, 14021, 14783, 15130, 15226, 16028, 16617, 16848, 17126, 17274, 17821, 18794, 19600, 20241, 20877]","[1153, 1385, 1676, 2099, 2254, 2671, 3327, 3748, 4367, 4676, 5164, 6007, 6408, 7232, 7895, 8200, 8660, 9231, 9526, 10343, 10971, 11286, 11933, 12075, 12174, 13258, 13657, 13757, 14346, 14924, 15753, 16608, 16976, 17632, 17874]","[502, 774, 904, 1040, 1181, 1278, 1529, 1999, 2285, 2490, 3155, 3379, 3556, 4073, 4231, 4417, 4586, 4777, 5054, 5358, 5537, 5914, 6129, 6298, 6469, 6961, 7286, 7445, 7675, 7775, 8041, 8408, 8717, 8941, 9150]","[753, 942, 1183, 1315, 1686, 2025, 2422, 2760, 2985, 3313, 3537, 4093, 4560, 4871, 5345, 5851, 6163, 6315, 6682, 7065, 7780, 8375, 8769, 8927, 9084, 9858, 10061, 10356, 10493, 10674, 10869, 11188, 11438, 11581, 11681]",21223,20877,17874,9150,11681,5236,2044,6309,6834,1725,22148,35,radiant
7531040410,73,106,33,86,19,"[413, 839, 1110, 1671, 1885, 2457, 3252, 4049, 4580, 5259, 6157, 6788, 7445, 7957, 8805, 10156, 11119, 12194, 13566, 14673, 15985, 17342, 17757, 18110, 19767, 20480, 21303, 22719, 23608, 24452, 25589, 26762, 27726, 28285, 28934]","[284, 697, 1061, 1468, 1949, 2252, 2844, 3380, 4060, 4311, 4491, 4657, 5294, 5868, 6498, 7023, 7422, 7775, 9111, 9614, 9888, 10744, 11650, 12645, 13403, 14169, 14840, 15545, 16235, 16812, 17465, 18751, 19626, 20609, 21409]","[285, 673, 1019, 1335, 1656, 2159, 2605, 2933, 3308, 3899, 4953, 5274, 5923, 6259, 6651, 7266, 7870, 8197, 8871, 9586, 10553, 11367, 11916, 13073, 13605, 14414, 14850, 15370, 16061, 16788, 17664, 18390, 18885, 19304, 19822]","[209, 299, 433, 612, 726, 863, 1124, 1214, 1405, 1495, 1796, 2202, 2504, 2668, 2949, 3236, 3585, 3679, 4088, 4311, 4625, 5285, 5503, 5931, 6173, 6587, 6838, 7300, 7901, 8177, 8733, 9486, 9722, 10114, 10567]","[209, 299, 437, 618, 812, 1176, 1356, 1446, 1593, 1683, 1999, 2354, 2812, 3314, 3744, 4299, 4485, 4579, 5035, 5220, 5538, 6068, 6163, 6412, 6579, 7151, 7358, 7535, 7879, 8165, 8892, 9612, 9958, 10259, 10359]",28934,21409,19822,10567,10359,89,23,21,26,68,"[164, 483, 759, 961, 1129, 1536, 1797, 2192, 2582, 3106, 3552, 4149, 4953, 5552, 6214, 6976, 8077, 8673, 9723, 10575, 12133, 13227, 14253, 15071, 15799, 16976, 17509, 18821, 19362, 19850, 21241, 22274, 22860, 24253, 24692]","[179, 469, 770, 980, 1177, 1482, 2156, 2537, 3077, 3964, 4484, 5034, 5419, 5817, 6508, 7453, 8035, 8898, 9421, 10287, 10870, 11292, 11598, 12239, 12623, 13397, 14077, 14855, 15143, 15739, 15981, 16081, 16390, 16706, 16986]","[314, 583, 832, 1300, 1465, 1867, 2290, 2663, 3192, 4097, 5022, 5480, 6005, 6475, 7065, 7619, 8307, 8798, 8893, 9064, 9577, 10135, 10809, 11568, 12114, 12920, 13200, 13666, 14191, 14552, 15112, 15352, 15452, 15835, 16234]","[129, 219, 676, 1001, 1103, 1193, 1404, 1539, 1731, 2219, 2470, 3004, 3506, 3615, 3811, 4102, 4359, 4903, 4998, 5093, 5350, 5522, 5934, 6801, 7138, 7445, 7540, 8031, 8237, 8710, 8900, 9000, 9100, 9347, 9447]","[129, 219, 374, 464, 554, 704, 828, 1012, 1138, 1407, 1497, 1858, 2054, 2384, 2539, 2992, 3647, 3991, 4258, 4537, 4949, 5043, 5261, 5682, 5777, 6042, 6137, 6323, 6529, 6793, 6983, 7192, 7646, 8078, 8178]",24692,16986,16234,9447,8178,4242,4423,3588,1120,2181,15554,35,radiant
7531077704,95,106,98,121,103,"[236, 563, 1000, 1368, 1728, 2302, 2665, 3236, 3864, 4624, 5065, 5847, 6420, 7380, 8044, 8677, 9719, 10491, 11044, 11941, 12883, 13547, 14876, 15663, 16540, 17300, 18647, 19957, 20405, 21846, 22699, 23957, 24500, 25429, 26368]","[281, 629, 1085, 1247, 1417, 1705, 1892, 2250, 2746, 3455, 4038, 4551, 5098, 5659, 5985, 6400, 6849, 7720, 8089, 8928, 9192, 10412, 11300, 12332, 12773, 13381, 14611, 15396, 15622, 16083, 17243, 17765, 18307, 19000, 19432]","[278, 565, 1060, 1361, 1718, 1965, 2349, 2742, 3306, 4330, 4857, 5390, 5930, 6220, 6640, 6950, 7342, 7727, 8151, 8831, 9356, 10037, 10263, 10844, 11251, 11706, 12104, 12661, 12757, 12955, 13145, 13650, 14065, 14479, 15071]","[504, 594, 804, 1016, 1180, 1355, 1664, 2012, 2157, 2808, 3018, 3198, 3626, 3872, 4089, 4560, 4901, 5320, 5478, 5904, 6000, 6301, 6465, 6745, 7097, 7391, 8335, 8832, 9187, 9660, 10028, 10604, 10839, 11245, 11676]","[236, 329, 433, 539, 629, 719, 854, 1035, 1307, 1901, 2143, 2372, 2643, 2796, 2972, 3187, 3557, 3866, 4024, 4452, 4548, 4849, 5398, 5798, 6075, 6294, 6669, 7091, 7297, 7393, 7540, 7730, 7965, 8345, 8715]",26368,19432,15071,11676,8715,114,53,62,129,45,"[170, 507, 828, 1205, 1578, 2113, 2367, 2806, 3014, 3339, 4019, 4414, 4952, 5303, 6222, 6610, 7146, 7630, 7968, 8480, 9131, 9387, 9897, 10400, 11018, 11560, 12390, 12826, 13239, 13758, 14996, 15576, 16080, 16727, 16872]","[286, 419, 549, 724, 863, 1063, 1364, 1680, 1891, 2427, 2650, 2854, 3456, 3722, 4172, 4485, 4888, 5040, 5548, 5835, 6089, 6975, 7272, 7867, 8307, 8788, 9590, 9971, 10547, 10643, 11539, 12637, 12874, 13543, 14522]","[302, 745, 1214, 1722, 2121, 2724, 3250, 3430, 3710, 4466, 4768, 5033, 5230, 5521, 5830, 6145, 6550, 6705, 6901, 7344, 7855, 8417, 9062, 9183, 9595, 9845, 10515, 10983, 11188, 11284, 11925, 12717, 13129, 13265, 13473]","[170, 523, 827, 1084, 1284, 1904, 2240, 2651, 2891, 3130, 3220, 3630, 3976, 4361, 4813, 5385, 6370, 6520, 6678, 7036, 7279, 7848, 8118, 8487, 9014, 9193, 9663, 10097, 10441, 10537, 10724, 11079, 11637, 11737, 11884]","[208, 298, 388, 581, 719, 1263, 1443, 1533, 1682, 2091, 2181, 2488, 2583, 2677, 2772, 2930, 3452, 3877, 4035, 4176, 4462, 4800, 5030, 5266, 5701, 5868, 6042, 6219, 6528, 6624, 7159, 7349, 7535, 7635, 7779]",16872,14522,13473,11884,7779,9496,4910,1598,-208,936,16732,35,radiant
7531515518,4,102,19,105,45,"[275, 627, 871, 1416, 1726, 2252, 2757, 3151, 3637, 4146, 4789, 5554, 6367, 6932, 7626, 8437, 9220, 9861, 11149, 12183, 13178, 14319, 15274, 15987, 16740, 17850, 19188, 19909, 20731, 21695, 22089, 22376, 23334, 23786, 24504]","[355, 711, 836, 1198, 1518, 1794, 2215, 2772, 3293, 3778, 4546, 5121, 5669, 6198, 6950, 7356, 7895, 7990, 8377, 9132, 9663, 10194, 11199, 11610, 12147, 12909, 13188, 13565, 14725, 15445, 15545, 16332, 16784, 17304, 17456]","[345, 677, 1015, 1315, 1615, 1943, 2423, 2660, 3031, 3317, 3734, 4220, 4577, 5038, 5420, 6268, 6474, 6686, 7193, 7767, 8262, 8889, 9615, 10002, 10362, 10950, 11333, 11961, 12681, 13373, 13997, 14154, 15006, 15661, 16012]","[195, 285, 375, 531, 946, 1088, 1702, 1866, 2234, 2416, 3132, 3436, 3855, 4127, 4225, 4729, 4870, 4965, 5958, 6388, 6605, 7109, 7777, 8220, 8915, 9473, 9892, 10144, 10778, 11399, 11770, 12088, 12436, 12694, 12975]","[195, 285, 375, 510, 632, 767, 1301, 1391, 1644, 1994, 2505, 2799, 2995, 3347, 3724, 4070, 4389, 4531, 4688, 4820, 4915, 5248, 5706, 5801, 5896, 6321, 6474, 7024, 7723, 8228, 8488, 8754, 8989, 9268, 9826]",24504,17456,16012,12975,9826,73,21,13,65,100,"[430, 724, 966, 1302, 1786, 2280, 2504, 3042, 3447, 4021, 4781, 5780, 6551, 7524, 8325, 9210, 10800, 11579, 12507, 12728, 13735, 15604, 16653, 17583, 18361, 19354, 19893, 20741, 20977, 21461, 22784, 23383, 24571, 25678, 26922]","[170, 530, 943, 1361, 1723, 2202, 2579, 2875, 3038, 3885, 4290, 4798, 5514, 6077, 6483, 7247, 7535, 8327, 8822, 9274, 9595, 10363, 11229, 11976, 12629, 13377, 13925, 14553, 14649, 14745, 16110, 16468, 17166, 17910, 18330]","[289, 517, 829, 1112, 1482, 1743, 2270, 2525, 2912, 3262, 3769, 4025, 4405, 4729, 5212, 5388, 5999, 6975, 7460, 8096, 8800, 9522, 9827, 10334, 10975, 11604, 12193, 12704, 13017, 13113, 14032, 14249, 15235, 15734, 16164]","[170, 285, 490, 658, 1205, 1295, 1471, 1576, 1693, 1936, 2413, 2768, 2971, 3448, 3542, 4314, 4472, 4896, 5382, 5615, 6025, 6516, 6685, 7034, 7727, 8365, 8534, 8948, 9119, 9520, 10178, 10383, 11059, 11385, 11988]","[170, 285, 405, 621, 751, 841, 978, 1113, 1203, 1429, 1631, 2034, 2403, 2766, 3131, 3562, 3779, 4083, 4445, 4669, 5017, 5567, 5770, 6189, 6387, 6749, 7338, 7931, 8102, 8239, 9201, 9498, 9763, 10346, 11130]",26922,18330,16164,11988,11130,-2418,-874,-152,987,-1304,-3761,35,radiant
7531673702,95,69,106,121,79,"[0, 343, 708, 959, 1286, 1570, 2027, 2521, 3121, 3784, 4280, 4767, 5642, 6301, 6845, 7211, 8349, 9115, 9394, 9823, 10406, 11070, 11935, 12540, 14356, 15330, 16388, 17153, 18093, 18942, 19991, 21146, 21849, 22559, 24063]","[0, 328, 704, 987, 1393, 1750, 2456, 2705, 3369, 3966, 4498, 5056, 5796, 6135, 6792, 7290, 7698, 8621, 9521, 10305, 10588, 10843, 11038, 11777, 12334, 12662, 13027, 13417, 13829, 14286, 14522, 15145, 15281, 15541, 16306]","[0, 205, 600, 852, 1251, 1628, 1835, 2497, 2998, 3178, 3925, 4277, 4811, 5277, 5567, 6035, 6283, 6676, 7372, 7788, 8071, 8166, 8782, 9703, 10307, 10763, 11197, 11921, 12456, 12929, 13708, 14407, 14825, 14975, 16501]","[0, 170, 360, 450, 587, 778, 1029, 1274, 1858, 2200, 3094, 3544, 3724, 3873, 4412, 4851, 5222, 5679, 6203, 6474, 6859, 7169, 7383, 8230, 8708, 9060, 9387, 9748, 10123, 10650, 11190, 11688, 12073, 12478, 13549]","[0, 505, 662, 833, 977, 1088, 1407, 1846, 2169, 2383, 3263, 3481, 3752, 3948, 4344, 4822, 5252, 5485, 5764, 5928, 6402, 6497, 6652, 7500, 7978, 8330, 8783, 9410, 9740, 10154, 10406, 11141, 11461, 11576, 12064]",24063,16306,16501,13549,12064,25,67,104,26,83,"[0, 328, 558, 803, 1234, 1665, 2034, 2532, 2965, 3876, 3976, 4544, 5103, 5566, 5957, 6492, 7241, 7607, 8415, 9797, 10106, 11427, 12013, 12831, 13100, 13371, 14123, 14853, 15844, 16328, 17101, 17767, 18729, 19643, 20556]","[0, 240, 567, 894, 1144, 1557, 1897, 2280, 2534, 3064, 3202, 3421, 4058, 4153, 5694, 6229, 6799, 7495, 7829, 8489, 8977, 10545, 11296, 12120, 13325, 14132, 14688, 15446, 16125, 16802, 17235, 17653, 17920, 18632, 19362]","[0, 170, 481, 698, 1003, 1294, 1655, 2005, 2219, 2610, 2773, 3368, 3745, 4432, 5510, 5604, 6405, 6500, 7342, 7907, 8151, 9211, 9306, 9482, 10059, 10548, 10831, 11396, 11668, 11764, 12131, 12486, 13081, 13733, 14494]","[0, 170, 728, 856, 946, 1076, 1166, 1344, 1488, 1840, 1930, 2199, 2397, 2629, 3476, 3570, 4299, 4394, 4690, 5646, 6235, 6854, 6949, 7115, 7658, 7753, 7929, 8505, 8922, 9338, 9671, 9771, 10099, 10365, 11096]","[0, 170, 260, 407, 497, 760, 898, 1027, 1117, 1454, 1544, 1814, 2095, 2190, 3107, 3252, 3678, 4009, 4230, 5085, 5398, 6387, 6779, 6945, 7040, 7303, 7587, 7758, 8197, 8368, 8634, 8893, 9068, 9320, 9495]",20556,19362,14494,11096,9495,3507,-3056,2007,2453,2569,7480,35,radiant
7531926406,46,13,121,71,5,"[0, 325, 650, 1073, 1355, 1783, 2182, 2864, 3280, 3940, 4798, 5248, 5875, 6566, 7369, 8226, 8987, 10323, 11312, 12309, 13643, 16356, 17780, 18871, 20141, 20774, 21381, 21476, 22368, 22524, 22620, 22900, 23543, 24517, 24861]","[0, 328, 698, 1147, 1517, 1892, 2562, 3076, 3721, 4269, 4760, 5174, 5889, 6107, 6691, 7637, 7940, 8485, 9100, 9505, 10376, 11051, 12571, 12885, 13106, 14142, 16016, 16111, 16361, 16457, 16786, 18347, 19736, 21169, 21365]","[0, 169, 259, 779, 943, 1152, 1298, 1434, 1669, 2061, 2151, 2343, 2687, 2782, 3047, 3231, 3528, 3910, 4122, 4366, 4792, 5498, 6207, 6592, 7170, 8851, 9387, 9734, 9905, 10076, 10305, 10948, 11717, 12766, 12941]","[0, 278, 513, 940, 1127, 1693, 1978, 2197, 3018, 3561, 3889, 4153, 4794, 5052, 5238, 5422, 5517, 5963, 6344, 7080, 7826, 8577, 9338, 9602, 9837, 10927, 11774, 12323, 12553, 12649, 12745, 13364, 14414, 14984, 15084]","[0, 169, 293, 435, 525, 646, 741, 831, 941, 1072, 1206, 1385, 2091, 2226, 2442, 2795, 2897, 3201, 3296, 3611, 4095, 4331, 4965, 5651, 5807, 6606, 7252, 7347, 7672, 7768, 7864, 8432, 9060, 9593, 9693]",24861,21365,12941,15084,9693,4,106,55,86,83,"[0, 296, 649, 1098, 1746, 2066, 2563, 3566, 4046, 4364, 5257, 6243, 6805, 7447, 7988, 9062, 10141, 11361, 12292, 13006, 13580, 13675, 14033, 15357, 15654, 15953, 17626, 18904, 21335, 22629, 23294, 24835, 24935, 26139, 28254]","[0, 326, 776, 1119, 1581, 1990, 2479, 3311, 3827, 4297, 4937, 5338, 5855, 6412, 7195, 8297, 9420, 9758, 10427, 10969, 11282, 11740, 11883, 12321, 13177, 13455, 13716, 14815, 16368, 17222, 17643, 18260, 18624, 19617, 20481]","[0, 245, 476, 681, 1160, 1487, 1733, 2118, 2422, 2512, 2852, 3114, 3489, 3798, 4603, 5155, 5634, 6506, 6901, 7335, 7522, 7732, 8384, 8515, 10189, 10284, 11622, 12013, 13801, 15036, 15326, 16750, 16860, 17603, 19546]","[0, 169, 307, 444, 625, 822, 912, 1344, 1434, 1681, 1975, 2323, 2577, 2901, 3070, 3425, 3832, 4336, 4431, 4612, 4996, 5091, 5242, 5917, 6475, 6570, 6664, 7055, 7899, 8195, 8416, 9117, 9217, 9437, 9912]","[0, 169, 259, 349, 577, 667, 757, 1309, 1518, 1608, 1925, 2198, 2288, 2484, 2602, 2696, 2980, 3318, 3413, 3507, 3636, 3889, 3984, 4285, 4931, 5026, 5721, 5816, 6074, 6370, 6591, 7387, 7487, 7871, 7971]",28254,20481,19546,9912,7971,-3393,884,-6605,5172,1722,-2220,35,dire
7532057903,54,11,104,19,84,"[0, 244, 611, 1018, 1382, 1908, 2320, 2587, 3232, 3762, 4315, 4801, 5126, 5785, 6354, 6910, 7539, 8233, 8896, 9479, 11551, 13290, 13566, 14296, 14569, 16080, 16174, 17528, 18163, 19014, 19352, 19644, 20563, 20663, 21152]","[0, 252, 619, 863, 1231, 1487, 1822, 2068, 2520, 2955, 3297, 3839, 3953, 4518, 4960, 5480, 6187, 6750, 7330, 7714, 8412, 9037, 9474, 9793, 10426, 10759, 11109, 12487, 12854, 13782, 14040, 14317, 14879, 14979, 15621]","[0, 336, 700, 1014, 1389, 1668, 1908, 2260, 2732, 3274, 3618, 3973, 4253, 4870, 5136, 5454, 6104, 6479, 7315, 7759, 8712, 9088, 9584, 9903, 10259, 11097, 11191, 12490, 12725, 13311, 14357, 14649, 15085, 15185, 15539]","[0, 209, 299, 457, 589, 679, 769, 859, 949, 1129, 1256, 1346, 1651, 1848, 2063, 2242, 2620, 2970, 3164, 3632, 4592, 4805, 4899, 5218, 5698, 6488, 6981, 8020, 8116, 8634, 8892, 9469, 9704, 9804, 10348]","[0, 209, 299, 457, 563, 1083, 1221, 1311, 1401, 1654, 1761, 1944, 2034, 2363, 2458, 2635, 2990, 3230, 3406, 4037, 4267, 4891, 4985, 5561, 5700, 6123, 6403, 7096, 7192, 7346, 7652, 8005, 8413, 8513, 8762]",21152,15621,15539,10348,8762,48,22,14,114,20,"[0, 310, 593, 984, 1294, 1845, 2433, 3047, 3526, 4176, 5107, 5698, 6499, 7246, 8012, 8882, 10085, 10627, 11365, 12650, 14042, 15551, 16693, 17787, 19539, 21079, 21902, 22561, 22787, 24240, 24336, 25343, 27516, 29145, 30195]","[0, 275, 691, 1070, 1516, 1898, 2272, 2911, 3554, 4300, 4992, 5337, 5717, 6536, 7352, 7993, 8607, 9610, 9866, 11099, 11778, 12581, 13357, 14396, 15262, 16094, 16188, 16716, 17367, 18194, 19067, 20717, 21717, 22480, 23364]","[0, 229, 594, 927, 1378, 1659, 1942, 2218, 2663, 2982, 3305, 3816, 4185, 4908, 5431, 5995, 6701, 7255, 7814, 8272, 8628, 9104, 9700, 10918, 11587, 11682, 12109, 12542, 12833, 13378, 13537, 14120, 14492, 15268, 15660]","[0, 154, 244, 334, 627, 765, 900, 1035, 1125, 1320, 1663, 1753, 1843, 2100, 2195, 2497, 2813, 3053, 3195, 3506, 3980, 4237, 4503, 4974, 5371, 5665, 5759, 5967, 6248, 6746, 7094, 7558, 8398, 9477, 9799]","[0, 154, 294, 431, 561, 746, 885, 1020, 1110, 1244, 1592, 1825, 1959, 2216, 2311, 2561, 3028, 3433, 3742, 4149, 4505, 4762, 4928, 5148, 5545, 5640, 5734, 5876, 5972, 6313, 6409, 7119, 8335, 8915, 9174]",30195,23364,15660,9799,9174,-9043,-7743,-121,549,-412,-16770,35,dire
7532211815,11,17,60,19,102,"[0, 256, 622, 840, 1190, 1461, 1771, 1990, 2355, 2760, 3023, 3543, 3980, 4581, 5283, 6137, 6691, 7230, 8161, 9335, 10037, 10655, 11337, 12262, 13024, 13857, 14441, 14642, 15097, 16028, 16124, 17045, 17871, 18563, 19746]","[0, 290, 666, 956, 1349, 1773, 2077, 2431, 2934, 3670, 4176, 4653, 4856, 5464, 6090, 7073, 7496, 8021, 9142, 9756, 10273, 11668, 12399, 13322, 13888, 14527, 15509, 15638, 16481, 17719, 18286, 19761, 20178, 21184, 21535]","[0, 244, 384, 680, 933, 1100, 1344, 1672, 1874, 2211, 2375, 3245, 3736, 4081, 4383, 4844, 5302, 5576, 6078, 6577, 7311, 8434, 8876, 9200, 9638, 10379, 11042, 11265, 11442, 12033, 12169, 13430, 14361, 15001, 15616]","[0, 170, 298, 418, 548, 678, 768, 1093, 1183, 1468, 1558, 1981, 2071, 2265, 2364, 2745, 2962, 3448, 3684, 3842, 4155, 5386, 5967, 6062, 6157, 6526, 6816, 7045, 7222, 7857, 7953, 8476, 9646, 10212, 10687]","[0, 170, 260, 380, 549, 679, 791, 881, 991, 1276, 1366, 1720, 1962, 2156, 2416, 2877, 3002, 3264, 3766, 3924, 4109, 4910, 5149, 5276, 5446, 5744, 6353, 6523, 6984, 7473, 7644, 8242, 8978, 9263, 9827]",19746,21535,15616,10687,9827,76,21,23,79,58,"[60, 303, 521, 882, 1222, 1483, 1857, 2273, 2841, 3214, 4268, 4556, 5180, 5782, 6447, 7122, 7823, 8710, 9863, 10627, 11882, 12467, 13166, 14149, 14631, 14929, 15718, 16028, 16996, 18180, 18276, 19233, 19333, 20092, 20192]","[328, 569, 850, 1190, 1595, 2049, 2401, 2866, 3394, 3529, 4255, 5186, 5990, 6730, 7218, 7391, 7721, 8300, 8723, 9525, 9933, 10027, 11088, 11588, 11966, 12413, 13448, 14600, 15976, 16783, 17340, 17819, 17919, 19023, 19257]","[60, 267, 553, 1019, 1318, 1591, 2017, 2369, 2782, 3228, 3756, 4336, 4910, 5847, 6472, 7160, 7622, 8573, 9111, 9774, 10795, 11049, 11660, 11954, 12502, 12900, 13515, 14322, 15086, 15788, 15968, 16243, 16343, 16499, 16599]","[60, 230, 320, 457, 577, 1104, 1414, 1549, 1729, 1999, 2089, 2377, 2718, 2921, 3316, 3924, 4082, 4288, 4445, 4738, 5018, 5112, 5311, 5406, 5501, 5686, 6204, 6577, 7031, 7387, 7591, 8015, 8115, 8215, 8315]","[60, 230, 320, 455, 575, 665, 873, 1008, 1143, 1278, 1532, 1858, 2077, 2427, 2770, 2956, 3397, 3556, 4047, 4340, 4691, 4785, 4946, 5333, 5544, 5729, 6122, 6816, 7499, 8084, 8180, 8481, 8581, 8681, 9016]",20192,19257,16599,8315,9016,-446,2278,-983,2372,811,4032,35,radiant
7532381012,113,120,97,128,45,"[0, 291, 797, 926, 1335, 1676, 2008, 2213, 2468, 2634, 2899, 3194, 3936, 4110, 4700, 4894, 5396, 6220, 6712, 7850, 8706, 9845, 10512, 11401, 12067, 12710, 13519, 14428, 15082, 16026, 16454, 17327, 17768, 19058, 20084]","[0, 222, 434, 801, 1185, 1444, 1688, 2045, 2495, 3139, 3229, 3627, 4254, 4550, 4726, 5039, 5419, 6518, 7019, 7606, 7763, 8794, 9524, 9866, 10486, 11076, 11431, 11719, 12407, 13038, 13434, 13753, 14683, 15394, 16304]","[0, 243, 449, 809, 1042, 1530, 1928, 2224, 2433, 2756, 3157, 3473, 4098, 4755, 4984, 5544, 5791, 6853, 7338, 8472, 9394, 9855, 10216, 10559, 11285, 12126, 12306, 12842, 12938, 13463, 13763, 13862, 14433, 15626, 16176]","[0, 170, 335, 459, 764, 873, 1044, 1219, 1344, 1565, 1655, 1745, 2344, 2779, 2874, 3053, 3183, 3968, 4144, 4615, 4872, 5256, 5453, 6034, 6128, 6439, 6534, 6888, 7059, 7479, 7650, 7824, 8140, 8559, 9094]","[0, 170, 304, 693, 783, 943, 1053, 1143, 1320, 1665, 1920, 2059, 2413, 2579, 2791, 3091, 3200, 3864, 4098, 4412, 4774, 5395, 5490, 5788, 5882, 6426, 6521, 6668, 6764, 6941, 7037, 7180, 7280, 7560, 7907]",20084,16304,16176,9094,7907,106,69,93,66,110,"[0, 254, 764, 988, 1402, 1821, 2343, 2725, 3210, 3546, 3960, 4373, 5263, 5636, 6076, 6513, 7541, 7962, 8551, 9207, 9477, 9970, 10630, 11307, 12044, 12465, 13337, 14262, 15254, 16060, 16875, 17592, 18929, 19712, 20033]","[0, 170, 755, 953, 1390, 1759, 2226, 2782, 3353, 3963, 4853, 5129, 5698, 6243, 6915, 7373, 8044, 8778, 9188, 9740, 10643, 11019, 11375, 11944, 12433, 12740, 13403, 14122, 14921, 15588, 16104, 16903, 17644, 18949, 19417]","[0, 242, 494, 694, 902, 1145, 1636, 1973, 2575, 3003, 3516, 4008, 4367, 5189, 5639, 6171, 6446, 7354, 7882, 8491, 9187, 9561, 10464, 10812, 11713, 12232, 12652, 13027, 14143, 14766, 15857, 16661, 17103, 17594, 17919]","[0, 170, 294, 384, 585, 742, 944, 1227, 1510, 1798, 2042, 2528, 2789, 3107, 3519, 3997, 4470, 5178, 5668, 6162, 6357, 7176, 7487, 7672, 8140, 8561, 9055, 9515, 10139, 10356, 10939, 11698, 11971, 12304, 12568]","[0, 170, 340, 430, 608, 738, 828, 963, 1191, 1351, 1908, 2033, 2251, 2658, 2902, 3153, 3643, 4142, 4769, 5454, 5887, 6246, 6691, 7009, 7528, 7770, 8033, 8371, 8696, 8916, 9133, 9942, 10161, 10675, 10850]",20033,19417,17919,12568,10850,51,-3113,-1743,-3474,-2943,-11222,35,dire
7532553807,10,126,98,86,72,"[0, 205, 523, 731, 1136, 1295, 1706, 1948, 2316, 2665, 3202, 3776, 4430, 4822, 5398, 5770, 6327, 6786, 7655, 8023, 8597, 8997, 9516, 9922, 10413, 11272, 11942, 12643, 13398, 13847, 15016, 16197, 16880, 18193, 18806]","[0, 280, 497, 823, 1237, 1652, 1941, 2578, 3289, 3663, 4235, 4909, 5544, 6153, 6803, 7628, 7945, 8773, 9275, 9755, 10336, 10554, 11176, 11876, 11971, 12698, 13345, 13976, 14823, 15469, 16222, 17506, 18073, 19079, 19952]","[0, 167, 569, 1093, 1414, 1592, 1995, 2338, 2863, 3273, 3663, 4016, 4645, 4949, 5854, 6218, 6899, 7530, 7934, 8322, 9196, 9740, 10711, 11678, 11889, 12315, 12928, 13878, 14326, 15123, 15604, 16691, 16971, 17887, 18871]","[0, 130, 270, 439, 613, 703, 793, 921, 1011, 1231, 1502, 1787, 2044, 2609, 3075, 3345, 3968, 4425, 4519, 4702, 5448, 5977, 6228, 6669, 7112, 7759, 8324, 8600, 9131, 9227, 9506, 10015, 10156, 10763, 11234]","[0, 130, 220, 330, 509, 636, 726, 912, 1180, 1315, 1786, 1930, 2512, 2812, 3722, 3951, 4465, 5369, 5568, 5751, 6184, 6583, 6799, 7310, 7405, 8159, 8402, 8497, 8925, 9235, 9740, 10350, 10527, 11460, 11695]",18806,19952,18871,11234,11695,4,13,112,19,26,"[0, 244, 485, 728, 1173, 1591, 2021, 2396, 2676, 3069, 3464, 3997, 4483, 5040, 5399, 5904, 6528, 7123, 7713, 8938, 9402, 9751, 10007, 10819, 12323, 13029, 13569, 14731, 15491, 16688, 17097, 17849, 18889, 19176, 19366]","[0, 289, 644, 1032, 1274, 1693, 2095, 2384, 2671, 3047, 3485, 3753, 4159, 4834, 4928, 5405, 5605, 6107, 6324, 7449, 8153, 9065, 9845, 10135, 11047, 11142, 11640, 12388, 13271, 13957, 14405, 14505, 14666, 15033, 15869]","[0, 210, 498, 770, 1061, 1416, 1791, 2155, 2646, 2974, 3354, 3444, 3627, 4075, 4611, 5031, 5513, 5732, 6412, 7310, 7884, 8118, 8826, 8993, 9907, 10757, 11109, 11768, 12292, 13194, 13644, 14252, 14511, 14803, 14993]","[0, 210, 300, 390, 607, 932, 1067, 1202, 1571, 1915, 2333, 2506, 2632, 3335, 3466, 4350, 4514, 4824, 5566, 6270, 6365, 6734, 7133, 8112, 8663, 9231, 9572, 10225, 10492, 11207, 11303, 11862, 12353, 12640, 12830]","[100, 310, 442, 583, 708, 1105, 1244, 1430, 1619, 1781, 2144, 2488, 2578, 2781, 3172, 3671, 4255, 4626, 4995, 5449, 5544, 5893, 6093, 6598, 7054, 7558, 7652, 8001, 8268, 8451, 8547, 8647, 8803, 8950, 9248]",19366,15869,14993,12830,9248,-560,4083,3878,-1596,2447,8252,35,radiant
7532722008,63,114,96,110,26,"[674, 1124, 1604, 1943, 2350, 2871, 3477, 3727, 4649, 4977, 5157, 5443, 6303, 6956, 7624, 8319, 8649, 9589, 10330, 11206, 11638, 12317, 12918, 13676, 14892, 15487, 16445, 17319, 18441, 20758, 21984, 23576, 24429, 25171, 26081]","[730, 1032, 1445, 1778, 2623, 3144, 3620, 3887, 4239, 4803, 5251, 5551, 5979, 6701, 6967, 7508, 7931, 8498, 9090, 9562, 9759, 10429, 11214, 11767, 12429, 12779, 13619, 14398, 14858, 15694, 16404, 17114, 17453, 18125, 19257]","[709, 942, 1261, 1544, 2013, 2525, 2952, 3388, 3931, 4440, 5060, 5498, 5764, 6353, 6800, 7057, 7683, 8569, 8752, 9220, 9408, 9985, 10748, 11429, 11523, 12042, 12574, 13614, 13903, 15444, 15987, 16424, 16763, 17449, 18169]","[324, 482, 833, 972, 1107, 1356, 1526, 1661, 1987, 2077, 2556, 2835, 2990, 3481, 3710, 3805, 4063, 4315, 4626, 4870, 4964, 5230, 5610, 5973, 6067, 6207, 6653, 7013, 7199, 8032, 8462, 9127, 9612, 10294, 10976]","[530, 681, 815, 905, 1181, 1552, 1709, 1967, 2195, 2523, 2703, 2843, 2937, 3542, 3818, 3913, 4171, 4493, 4588, 4683, 4777, 4959, 5296, 5463, 5601, 5696, 6319, 6496, 6682, 7332, 7779, 8035, 8665, 9109, 9308]",26081,19257,18169,10976,9308,106,54,69,86,58,"[915, 1085, 1329, 1732, 2029, 2516, 2860, 3364, 3781, 4362, 4680, 5544, 6200, 6506, 7385, 8395, 9182, 9599, 9894, 10524, 10913, 11485, 12257, 13067, 13774, 14413, 15125, 15807, 16067, 16639, 16829, 17277, 17805, 18100, 18896]","[559, 996, 1402, 1806, 2214, 2567, 3379, 3844, 4461, 5174, 5625, 6736, 7320, 7884, 8290, 8984, 9784, 10486, 11164, 11830, 12127, 13278, 13508, 14161, 15099, 15785, 16256, 16884, 17575, 17918, 18406, 18795, 18942, 19514, 19614]","[508, 598, 926, 1122, 1488, 2083, 2487, 2975, 3301, 3834, 4304, 4827, 5764, 6211, 6821, 7672, 8337, 9390, 9814, 10144, 10551, 11178, 11462, 12073, 12899, 13326, 13744, 13932, 14307, 14696, 14956, 15216, 15364, 15659, 16015]","[336, 537, 742, 916, 1128, 1313, 1529, 1759, 1992, 2178, 2745, 3136, 3452, 3636, 4084, 4422, 4895, 5191, 5361, 5583, 6041, 6588, 6930, 7536, 7961, 8131, 8464, 8731, 9340, 9882, 10119, 10395, 10495, 10891, 10991]","[350, 458, 629, 768, 858, 1061, 1280, 1509, 1724, 1947, 2392, 3047, 3318, 3696, 4018, 4356, 4673, 5050, 5524, 5748, 6761, 7177, 7568, 8004, 8546, 8737, 8995, 9342, 9716, 10093, 10638, 10814, 10962, 11293, 11431]",18896,19614,16015,10991,11431,7185,-357,2154,-15,-2123,6844,35,radiant
7532848119,14,74,15,5,100,"[62, 267, 549, 836, 1252, 1732, 2253, 2807, 3152, 3622, 4104, 4641, 5244, 5501, 5768, 6416, 7279, 7638, 7733, 9000, 9466, 10148, 10728, 11056, 11190, 11741, 12645, 13124, 13220, 13938, 14548, 14781, 15056, 15920, 16833]","[62, 264, 471, 838, 1177, 1551, 2036, 2463, 2942, 3330, 3604, 4041, 4737, 4832, 5062, 5686, 6381, 7207, 7762, 8456, 8822, 9492, 9857, 10130, 10225, 10722, 11076, 11255, 11689, 12265, 12874, 13925, 14340, 14946, 15645]","[62, 191, 426, 705, 1163, 1322, 1571, 1774, 2260, 2783, 3159, 3706, 4248, 4796, 5052, 5454, 5964, 6507, 7045, 7793, 8240, 8911, 9319, 9681, 9776, 10428, 10522, 11062, 11892, 12118, 12214, 12867, 13500, 14321, 14807]","[430, 604, 714, 804, 980, 1156, 1347, 1654, 2029, 2119, 2209, 2346, 2608, 2796, 3199, 3331, 3677, 4206, 4301, 4730, 5254, 5421, 5588, 5682, 5946, 6041, 6135, 6279, 6375, 6471, 6713, 6813, 6952, 7349, 7716]","[62, 243, 333, 423, 650, 740, 875, 1010, 1332, 1422, 1512, 1744, 1926, 2021, 2236, 2330, 2488, 2736, 3017, 3605, 4157, 4324, 4491, 4585, 4824, 5041, 5135, 5384, 5480, 5576, 5672, 5772, 5872, 5972, 6162]",16833,15645,14807,7716,6162,120,41,137,64,26,"[0, 291, 622, 1001, 1486, 1906, 2393, 2788, 3320, 3718, 4618, 5204, 5792, 6752, 7108, 7938, 8485, 9628, 10586, 10743, 11786, 12408, 12782, 13765, 14983, 15659, 16740, 17714, 18086, 19215, 19791, 20828, 21656, 22320, 23266]","[0, 254, 485, 729, 1044, 1320, 1609, 2018, 2622, 3119, 3781, 4335, 4859, 6024, 6119, 6492, 7470, 7855, 8225, 8849, 9747, 10858, 11031, 11383, 12431, 13167, 14444, 15206, 15710, 16683, 17544, 18368, 18959, 19754, 20351]","[0, 243, 454, 725, 1009, 1294, 1498, 1830, 2170, 2956, 3562, 3962, 4230, 4687, 4890, 5628, 6277, 6969, 7759, 8566, 9113, 9823, 10035, 10772, 11732, 12511, 12992, 13354, 13616, 14655, 15382, 15820, 16413, 17193, 18191]","[0, 209, 338, 465, 595, 746, 962, 1097, 1417, 1586, 2131, 2620, 2744, 3180, 3721, 4024, 4417, 5004, 5563, 5755, 6227, 6428, 6674, 7236, 7822, 8379, 9041, 9924, 10464, 11163, 11527, 12205, 13063, 13408, 14382]","[100, 309, 435, 759, 889, 979, 1195, 1330, 1802, 2262, 2617, 2901, 3103, 3624, 3758, 4089, 4394, 4819, 5108, 5265, 5759, 5854, 5949, 6301, 6955, 7266, 7666, 7894, 7990, 8600, 8777, 9279, 9490, 9779, 10263]",23266,20351,18191,14382,10263,-6433,-4706,-3384,-6666,-4101,-25290,35,dire
7532959919,48,120,60,26,91,"[0, 174, 424, 757, 1040, 1555, 1766, 2741, 3284, 3704, 4193, 4894, 5501, 6127, 6336, 6943, 7546, 7830, 8574, 9363, 10268, 11001, 11732, 13036, 14334, 14904, 15695, 16466, 17112, 17808, 18875, 20118, 21289, 22257, 23248]","[0, 200, 489, 823, 1223, 1399, 1602, 2205, 2597, 3213, 3753, 4034, 4825, 5149, 5244, 6002, 6557, 7179, 7843, 8204, 8841, 9345, 9776, 10430, 11089, 11329, 12152, 12464, 13142, 13802, 14374, 15007, 15568, 16554, 16773]","[0, 166, 444, 702, 878, 1124, 1408, 2046, 2328, 2662, 3148, 3431, 3932, 4279, 4456, 5383, 5862, 6245, 6801, 7282, 8015, 8210, 8611, 9352, 9734, 10271, 10366, 10677, 11102, 11328, 11621, 11941, 12339, 12619, 12719]","[0, 130, 566, 852, 942, 1032, 1122, 1675, 1765, 1940, 2154, 2244, 2616, 2809, 2904, 3133, 3291, 3737, 3970, 4086, 4287, 4382, 4549, 5105, 5255, 5350, 5479, 6074, 6499, 6725, 6914, 7234, 7491, 7957, 8062]","[0, 130, 220, 310, 400, 535, 625, 1352, 1571, 1706, 2038, 2128, 2680, 2873, 2968, 3153, 3311, 3495, 3680, 3775, 3932, 4027, 4194, 4693, 4832, 4976, 5115, 5502, 6002, 6596, 6767, 6942, 7117, 7472, 7642]",23248,16773,12719,8062,7642,72,74,55,112,19,"[0, 334, 948, 1226, 1596, 1892, 2451, 2588, 3043, 3558, 4120, 4883, 5302, 5902, 7222, 7793, 8819, 9417, 10272, 10951, 12081, 12688, 13225, 13908, 15043, 15631, 16353, 17271, 18050, 18680, 19386, 20287, 21020, 21600, 25083]","[0, 328, 687, 970, 1377, 1706, 1987, 2077, 2375, 2465, 2635, 2939, 3188, 3486, 4306, 4464, 4897, 5163, 5526, 5867, 6503, 7034, 7984, 8494, 9003, 9841, 10138, 10998, 12582, 13162, 14173, 14756, 15839, 16638, 18402]","[0, 244, 497, 822, 1044, 1259, 1487, 1777, 2042, 2435, 3011, 3357, 3898, 4353, 5323, 6087, 6791, 7585, 8056, 8599, 9014, 9300, 9857, 10276, 10578, 10935, 11185, 11552, 12611, 13457, 13803, 14585, 15216, 15528, 16792]","[0, 210, 369, 666, 756, 894, 1194, 1284, 1541, 1762, 1932, 2116, 2406, 2747, 3840, 3935, 4634, 4852, 5117, 5212, 5513, 5689, 6096, 6428, 6597, 6934, 7313, 7655, 8288, 8621, 8792, 9057, 9232, 9525, 10643]","[0, 210, 300, 435, 525, 698, 849, 939, 1029, 1200, 1456, 1546, 1690, 1937, 2489, 2801, 3118, 3466, 3709, 3804, 4071, 4166, 4498, 4755, 4849, 5016, 5321, 5588, 6607, 6990, 7086, 7385, 7763, 7998, 8736]",25083,18402,16792,10643,8736,-1835,-1629,-4073,-2581,-1094,-11212,35,dire
7532985414,10,25,137,100,26,"[285, 575, 883, 1134, 1340, 1694, 2194, 2612, 3220, 3551, 4067, 4505, 4845, 5061, 5412, 5900, 6081, 6370, 6977, 7624, 8684, 8974, 9442, 9678, 9959, 11352, 12279, 13139, 14197, 14959, 15715, 16779, 17828, 19377, 20191]","[152, 565, 861, 1321, 1960, 2646, 3166, 3974, 4239, 4417, 5512, 5868, 5958, 6481, 7161, 7512, 7937, 8287, 8750, 9327, 11050, 11508, 11953, 12313, 12902, 13567, 14343, 14868, 15467, 15742, 16303, 16493, 17297, 17925, 18605]","[285, 563, 800, 967, 1446, 1844, 2246, 2618, 3045, 3423, 3608, 4377, 4774, 5213, 5654, 6262, 6655, 6859, 7869, 8418, 9346, 9765, 10150, 10632, 11261, 12181, 12937, 13031, 13321, 14168, 14761, 14951, 15433, 16036, 16291]","[106, 316, 450, 540, 753, 892, 1022, 1173, 1358, 1448, 1858, 2037, 2447, 2590, 2685, 2869, 3120, 3381, 3743, 4040, 4408, 4821, 4916, 5387, 5704, 6182, 6406, 6569, 6746, 7021, 7117, 7307, 7407, 7832, 8560]","[420, 630, 816, 906, 1054, 1192, 1564, 1715, 2062, 2152, 2562, 2875, 2965, 3060, 3332, 3427, 4012, 4107, 4400, 4919, 6457, 6731, 6901, 7142, 7498, 8052, 8393, 8562, 8807, 9107, 9371, 9622, 9926, 10359, 10875]",20191,18605,16291,8560,10875,96,54,19,65,5,"[0, 282, 590, 876, 1540, 1982, 2337, 2743, 3082, 3996, 4588, 5129, 6140, 6868, 7537, 7967, 9409, 9613, 9944, 10554, 10766, 11831, 12425, 12950, 13626, 13970, 14756, 15436, 15969, 17228, 17852, 18571, 19205, 19844, 20586]","[0, 314, 517, 772, 1072, 1400, 1689, 2049, 2504, 3153, 3744, 4107, 4671, 5305, 6113, 6873, 8124, 8675, 9211, 9962, 10771, 10866, 11402, 12039, 12803, 12970, 13065, 13835, 14469, 15932, 16567, 17162, 18061, 18653, 19598]","[0, 155, 403, 844, 1094, 1305, 1605, 1909, 2488, 2960, 3371, 3774, 4356, 5629, 5959, 6354, 7015, 7475, 7942, 8906, 9246, 9759, 10137, 11440, 12062, 12533, 13049, 13583, 13820, 14092, 14298, 14691, 15284, 15856, 16870]","[0, 155, 245, 384, 831, 1088, 1178, 1303, 1924, 2753, 3334, 3789, 4174, 4712, 5259, 5444, 6369, 7269, 7567, 8284, 8769, 8992, 9280, 9693, 10217, 10880, 11824, 12247, 12746, 13711, 13917, 14318, 14737, 15495, 16436]","[0, 155, 288, 484, 661, 786, 1262, 1352, 1654, 2357, 2651, 2741, 3107, 3876, 4327, 4512, 5363, 5585, 5776, 6028, 6231, 6515, 6682, 7036, 7241, 7457, 7673, 7974, 8217, 8767, 9204, 9475, 9827, 10609, 10891]",20586,19598,16870,16436,10891,-395,-993,-579,-7876,-16,-9859,35,radiant
7533042916,10,74,47,96,20,"[0, 249, 494, 1105, 1502, 2176, 2846, 3442, 4117, 4820, 5316, 6080, 6900, 7384, 8199, 8915, 9619, 10344, 10941, 12002, 12710, 13328, 14728, 15549, 17048, 18645, 19810, 21106, 21938, 22286, 23284, 23912, 24641, 26239, 27354]","[0, 258, 635, 885, 1307, 1397, 1888, 2177, 2517, 2933, 3334, 3772, 4233, 4482, 4721, 5195, 5689, 5875, 6417, 7002, 7265, 7558, 8520, 9010, 9504, 10357, 10803, 11629, 12654, 12830, 13267, 14188, 14629, 15395, 15889]","[0, 286, 451, 857, 1225, 2021, 2520, 2966, 3378, 3681, 4029, 4512, 5127, 5465, 6058, 6499, 7128, 7741, 8132, 8591, 9009, 9450, 10000, 10412, 11083, 11589, 11864, 12441, 13400, 13496, 13850, 14247, 14768, 15204, 15666]","[0, 205, 340, 478, 568, 842, 1011, 1101, 1238, 1534, 1738, 2185, 2486, 2581, 2865, 3365, 3690, 4271, 4366, 4622, 4717, 4862, 5338, 5542, 5898, 6487, 6692, 7272, 7760, 7856, 7998, 8229, 8579, 8802, 9154]","[0, 169, 259, 424, 558, 831, 1008, 1194, 1435, 1802, 2427, 2672, 3075, 3334, 3620, 3854, 4174, 4385, 4527, 4793, 5092, 5237, 5875, 6173, 6704, 7071, 7510, 7909, 8086, 8394, 8534, 8771, 9006, 9282, 9704]",27354,15889,15666,9154,9704,46,22,69,72,121,"[0, 169, 333, 594, 918, 1008, 1607, 2013, 2405, 2866, 3265, 3682, 4438, 5572, 6459, 8057, 8941, 9797, 10558, 11340, 12093, 13028, 14273, 14761, 15467, 16474, 17295, 18244, 19332, 20735, 21470, 22247, 23208, 24340, 25275]","[0, 291, 593, 874, 1166, 1646, 2126, 2975, 3225, 3518, 4271, 4620, 5142, 6144, 6239, 7131, 7656, 8064, 8365, 9167, 9446, 9968, 10707, 11096, 11369, 11690, 11908, 12823, 13453, 14221, 14600, 15156, 16377, 16606, 17634]","[0, 206, 480, 793, 963, 1480, 1599, 1779, 2292, 2543, 2721, 3065, 4048, 4723, 5150, 5735, 6400, 7258, 7831, 8226, 9052, 9794, 10553, 10670, 11108, 11576, 11955, 12280, 12940, 13677, 13943, 14433, 15421, 16102, 16587]","[0, 169, 346, 436, 606, 969, 1500, 1789, 1951, 2041, 2247, 2542, 3011, 3519, 3813, 4270, 4439, 5043, 5278, 5752, 6200, 6513, 6942, 7169, 7495, 7665, 8084, 8654, 8906, 9168, 9699, 9976, 10742, 10842, 11122]","[0, 215, 348, 654, 869, 1089, 1179, 1359, 1521, 1764, 2081, 2256, 2396, 3186, 3375, 3896, 4107, 4483, 4578, 4860, 5018, 5218, 5524, 5618, 5827, 5922, 6062, 6350, 6571, 6933, 7044, 7234, 7534, 7751, 8100]",25275,17634,16587,11122,8100,2079,-1745,-921,-1968,1604,-951,35,radiant
7533154518,73,120,78,69,72,"[0, 712, 1045, 1268, 1741, 2110, 2332, 2957, 3506, 4216, 4753, 5421, 6092, 7140, 8272, 9388, 10768, 12083, 13284, 14609, 15957, 17409, 18533, 19567, 20582, 21011, 21839, 23211, 24797, 26097, 26973, 29244, 30970, 31979, 33671]","[0, 291, 584, 927, 1340, 1637, 1999, 2230, 2489, 3075, 3357, 3774, 4480, 4710, 5222, 5889, 6236, 6856, 7330, 7840, 8408, 8630, 9251, 10195, 10511, 11189, 11626, 11877, 12459, 12630, 13247, 13983, 14222, 14436, 14708]","[0, 170, 335, 539, 791, 1180, 1598, 1733, 2086, 2788, 3290, 3914, 4264, 4981, 5612, 5813, 6285, 6823, 7711, 8401, 8815, 9234, 9970, 10276, 10759, 11498, 11888, 12159, 12737, 13225, 13717, 14944, 15310, 15410, 15642]","[0, 170, 260, 375, 621, 1011, 1195, 1330, 1459, 1639, 2231, 2589, 3154, 3283, 3412, 3793, 3966, 4470, 4804, 5278, 5588, 5912, 6280, 6731, 7121, 7659, 8181, 8470, 9285, 9398, 9804, 10698, 10888, 10988, 11178]","[0, 236, 326, 452, 542, 678, 814, 960, 1050, 1273, 1492, 1740, 2263, 2357, 2595, 3076, 3234, 3328, 3423, 4003, 4175, 4349, 4726, 5149, 5599, 6144, 6551, 6721, 7250, 7421, 7890, 8251, 8707, 8849, 9039]",33671,14708,15642,11178,9039,109,39,112,26,19,"[0, 663, 878, 1198, 1477, 1876, 2242, 2528, 3032, 3259, 3619, 3959, 4931, 5401, 6113, 6804, 7619, 8340, 9085, 9638, 11020, 11799, 12664, 13829, 14714, 16546, 17663, 18568, 19392, 20400, 21206, 22445, 23419, 24143, 25093]","[0, 324, 558, 930, 1380, 1673, 2040, 2454, 3167, 3630, 4104, 4538, 5119, 5304, 6132, 6541, 7318, 8188, 8837, 9912, 10587, 11287, 12123, 12706, 13203, 14681, 15622, 16325, 17325, 18156, 18818, 20205, 21861, 22669, 24228]","[0, 221, 382, 725, 888, 1192, 1917, 2131, 2690, 3089, 3672, 4699, 5178, 6309, 6770, 7055, 7347, 8019, 8492, 9061, 9690, 10208, 10856, 11736, 12032, 12787, 13390, 14201, 14898, 15291, 15796, 16113, 16806, 17240, 17565]","[0, 326, 454, 703, 793, 1016, 1151, 1324, 1504, 1674, 1924, 2081, 2261, 2998, 3501, 3689, 3935, 4121, 4492, 4863, 5340, 5799, 6041, 6245, 6606, 7532, 7851, 8064, 8691, 9117, 9518, 9693, 10113, 11060, 11402]","[0, 170, 260, 400, 527, 651, 1130, 1460, 1640, 1902, 2306, 2476, 2755, 2849, 3434, 3790, 4015, 4109, 4467, 4830, 5245, 5736, 6366, 6668, 6881, 8215, 8841, 9196, 9612, 9986, 10278, 10378, 10966, 11233, 11646]",25093,24228,17565,11402,11646,8578,-9520,-1923,-224,-2607,-5696,35,dire
7533231811,10,96,11,136,26,"[1, 130, 554, 846, 1368, 1813, 2150, 2843, 3319, 3885, 4333, 4817, 5526, 6130, 6643, 7306, 7923, 8407, 9102, 9923, 10708, 11596, 12380, 12902, 13117, 13452, 14138, 14538, 15041, 15939, 16527, 17724, 18460, 19016, 20931]","[1, 180, 604, 918, 1589, 2068, 2421, 3239, 3932, 4357, 5013, 5518, 6393, 6716, 7104, 7645, 8568, 9079, 9770, 10033, 10636, 11111, 11854, 12512, 13164, 13846, 14344, 15439, 16259, 16889, 17626, 18895, 19489, 20563, 21950]","[1, 247, 582, 784, 1065, 1773, 1988, 2236, 2819, 3573, 3993, 4606, 5134, 5332, 5856, 6417, 6747, 7107, 7690, 8673, 9278, 9911, 10826, 11310, 11494, 13046, 14122, 14253, 14876, 15717, 16537, 17246, 18387, 19440, 20158]","[1, 130, 560, 686, 1077, 1494, 1684, 1855, 2032, 2122, 2395, 2531, 2711, 2806, 2954, 3049, 3383, 3976, 4333, 4858, 5092, 5371, 5707, 5802, 6416, 7222, 7362, 7717, 7911, 8097, 8881, 8981, 9297, 9397, 9677]","[1, 130, 265, 373, 669, 848, 1188, 1415, 1734, 1908, 2078, 2218, 2997, 3313, 3498, 3878, 3972, 4148, 4346, 4702, 4945, 5172, 5542, 5804, 5942, 6511, 6727, 7027, 7123, 7309, 8131, 8649, 8886, 9093, 9650]",20931,21950,20158,9677,9650,106,41,19,90,86,"[1, 377, 575, 1180, 1566, 1948, 2545, 2789, 3174, 3388, 3779, 4129, 4521, 5201, 5706, 6536, 7219, 7845, 8470, 9156, 9695, 10468, 11218, 12059, 12461, 13393, 14051, 14749, 15789, 16600, 17213, 17840, 18535, 18976, 19458]","[1, 210, 458, 783, 1123, 1676, 1838, 2413, 2614, 2986, 3316, 3883, 4088, 4614, 5333, 6052, 6690, 7510, 8462, 9157, 9969, 10792, 12097, 12764, 13430, 14727, 15413, 16308, 18045, 18662, 19230, 20092, 20553, 21304, 22076]","[1, 244, 485, 655, 988, 1214, 1782, 1989, 2238, 2373, 2542, 2753, 3084, 3558, 3972, 4268, 4825, 5229, 5862, 6352, 6955, 7516, 8109, 9085, 9689, 10515, 11241, 11881, 12791, 13325, 13880, 15035, 15783, 16762, 17217]","[1, 210, 300, 390, 480, 760, 1014, 1149, 1367, 1715, 1901, 2744, 3422, 3867, 4177, 4734, 5505, 5868, 6359, 6807, 7198, 7509, 8043, 9034, 9595, 10800, 11065, 11839, 13105, 13902, 14104, 14730, 15674, 16046, 16774]","[1, 249, 383, 518, 682, 1074, 1732, 1954, 2044, 2170, 2552, 2642, 2886, 3071, 3464, 3950, 4216, 4469, 4937, 5305, 5718, 5917, 6501, 6994, 7599, 8270, 8925, 9370, 9827, 10055, 10513, 10793, 11003, 11103, 11203]",19458,22076,17217,16774,11203,1473,-126,2941,-7097,-1553,-4362,35,radiant
7533433505,48,43,23,96,119,"[78, 372, 730, 1007, 1486, 1787, 2080, 2547, 2936, 3640, 4003, 4508, 5114, 5708, 5920, 6799, 7679, 8706, 9690, 10944, 11705, 12754, 13763, 14828, 16052, 17077, 18442, 19070, 20181, 21414, 23105, 25194, 25294, 25830, 27212]","[78, 372, 759, 1105, 1345, 1637, 1990, 2252, 2680, 3175, 3737, 4114, 4623, 5176, 5524, 6196, 6881, 7039, 7275, 8495, 9018, 9432, 10255, 10769, 11310, 11753, 12732, 13274, 13975, 14399, 15188, 16264, 16989, 17434, 19254]","[211, 450, 681, 1051, 1355, 1565, 2156, 2583, 3268, 3699, 4302, 5277, 5535, 6025, 6445, 7049, 7887, 8274, 8910, 9751, 10505, 10942, 11321, 11649, 12121, 12772, 13578, 13777, 14766, 15217, 15969, 16671, 17409, 18031, 19014]","[78, 248, 363, 453, 543, 673, 809, 994, 1238, 1645, 2247, 2617, 2707, 3162, 3390, 3699, 4021, 4666, 4868, 5214, 5662, 6340, 6751, 7224, 7838, 8272, 8748, 9180, 9467, 9945, 10846, 11517, 11745, 12223, 13381]","[78, 348, 463, 598, 704, 834, 942, 1129, 1606, 1900, 2156, 2423, 2513, 3046, 3735, 4014, 4284, 5106, 5226, 5823, 6174, 6473, 6714, 6884, 7054, 7614, 8102, 8950, 9882, 10181, 10646, 11349, 11449, 11660, 12541]",27212,19254,19014,13381,12541,25,21,129,26,136,"[308, 515, 760, 1030, 1281, 1657, 2126, 2413, 2967, 3428, 3730, 4242, 5189, 5820, 6953, 7444, 8160, 9035, 9667, 10565, 11162, 11645, 12254, 13046, 14084, 14773, 16067, 16766, 17709, 18465, 18755, 21520, 22546, 23820, 25292]","[308, 566, 763, 1331, 1624, 1943, 2394, 2941, 3150, 3675, 4226, 4536, 5104, 5696, 6469, 7069, 7414, 7932, 8842, 9572, 10193, 10505, 11116, 11706, 12583, 12873, 13437, 13872, 14103, 14315, 14789, 16490, 16996, 17614, 18391]","[116, 397, 557, 967, 1247, 1584, 2217, 2723, 3479, 3871, 4494, 5050, 5459, 5554, 5923, 6250, 6981, 8299, 9007, 9584, 10103, 10592, 11314, 11674, 12389, 13488, 14103, 14419, 14515, 15234, 15774, 15874, 16282, 16798, 17319]","[443, 613, 754, 1131, 1221, 1396, 1608, 1760, 1959, 2505, 2761, 2906, 3121, 3263, 3877, 4329, 4580, 5152, 5416, 5692, 5910, 6346, 6619, 6804, 7659, 8436, 8531, 8626, 8899, 9271, 9398, 9498, 9756, 10333, 10675]","[175, 345, 435, 525, 615, 705, 906, 1058, 1192, 1365, 1500, 1590, 1956, 2145, 2491, 2640, 2877, 3461, 3834, 4199, 4329, 4424, 4653, 4860, 5258, 5352, 5521, 5797, 6076, 6266, 6362, 7389, 7624, 7880, 8532]",25292,18391,17319,10675,8532,1920,863,1695,2706,4009,11193,35,radiant
7533473919,35,76,23,19,20,"[0, 354, 632, 1068, 1385, 1638, 2092, 2621, 2940, 3296, 3436, 4247, 4537, 4984, 5382, 5977, 6532, 7077, 7421, 7882, 8325, 8936, 10013, 10462, 10591, 11242, 11542, 12694, 13454, 14927, 15990, 16306, 16653, 16753, 20763]","[0, 350, 632, 810, 1265, 1589, 1811, 2033, 2410, 3169, 3633, 4158, 4596, 5021, 5471, 6170, 6891, 7493, 8123, 8590, 9226, 10025, 10880, 11752, 11940, 12034, 12277, 12372, 13204, 14566, 15067, 16088, 16579, 16924, 17024]","[0, 285, 522, 955, 1321, 1615, 1898, 2216, 2870, 3389, 3586, 4216, 4804, 5241, 5513, 5733, 6235, 6941, 7426, 8325, 8875, 9152, 10037, 10351, 10616, 10710, 11077, 11466, 11857, 12539, 13064, 13598, 14745, 14891, 14991]","[100, 509, 599, 689, 874, 1013, 1148, 1306, 1539, 1853, 2011, 2332, 3027, 3397, 3491, 3737, 3878, 4419, 4514, 4904, 5377, 5571, 5816, 6039, 6134, 6313, 6743, 7044, 7770, 8452, 8934, 9107, 9702, 9930, 10534]","[0, 276, 366, 500, 651, 824, 914, 1004, 1094, 1360, 1450, 1726, 2010, 2276, 2419, 2845, 3100, 3634, 3729, 3997, 4205, 4444, 4736, 4951, 5046, 5140, 5402, 5497, 5755, 6437, 6962, 7098, 7212, 7312, 8448]",20763,17024,14991,10534,8448,8,69,47,112,83,"[0, 723, 957, 1203, 1544, 1952, 2557, 2823, 3241, 3844, 4284, 4614, 5213, 5995, 6577, 7129, 7804, 8958, 9751, 10404, 11292, 12006, 12487, 13562, 14347, 14945, 16108, 16676, 17660, 18241, 19015, 20245, 21254, 22170, 23080]","[0, 381, 677, 1042, 1407, 1718, 2017, 2728, 3103, 3667, 4166, 4625, 5355, 6110, 6827, 7042, 7478, 7933, 8435, 8702, 9679, 10196, 10696, 11401, 13094, 13850, 15437, 16260, 16845, 17394, 17731, 19077, 20323, 21126, 22686]","[0, 423, 676, 1120, 1330, 1605, 1920, 2051, 2401, 2511, 3170, 3999, 4863, 5498, 5962, 6307, 7159, 7394, 7910, 8160, 8773, 9476, 10071, 10550, 11143, 12374, 13282, 14480, 15149, 16161, 16726, 17006, 17928, 18450, 19608]","[0, 270, 398, 533, 706, 796, 936, 1152, 1287, 1545, 1635, 1844, 2358, 2586, 2900, 2995, 3216, 3603, 3777, 3958, 4852, 5082, 5512, 6050, 6819, 7481, 8489, 8781, 9351, 10220, 10951, 12083, 12443, 13536, 14463]","[0, 198, 288, 378, 534, 677, 945, 1053, 1188, 1314, 1708, 1871, 2377, 2653, 2837, 2950, 3171, 3465, 3599, 3694, 3905, 4109, 4276, 4569, 5106, 5565, 5660, 6016, 6282, 6668, 6764, 7044, 7453, 7553, 8257]",23080,22686,19608,14463,8257,-2317,-5662,-4617,-3929,191,-16334,35,dire
7533525210,8,23,90,112,66,"[0, 250, 456, 616, 846, 1043, 1422, 1913, 2319, 2790, 3192, 3785, 4151, 4672, 4928, 5700, 6066, 6563, 6952, 7707, 8086, 8364, 9008, 9630, 10283, 10915, 11778, 12251, 12817, 13283, 14968, 15395, 16004, 17013, 18256]","[0, 203, 403, 748, 1076, 1450, 1613, 1877, 2334, 2781, 3193, 3283, 3572, 4295, 4720, 5403, 5625, 6020, 6527, 6899, 7340, 7772, 8309, 8844, 9481, 10232, 10842, 11376, 11859, 12239, 13123, 13526, 13924, 14631, 15210]","[0, 216, 388, 698, 989, 1360, 1709, 1889, 2317, 2491, 2982, 3162, 3506, 4110, 4525, 5189, 5482, 5667, 6103, 6558, 6959, 7301, 7887, 8442, 8784, 9102, 9254, 9798, 10257, 10585, 11052, 11535, 11942, 12252, 12829]","[0, 129, 219, 357, 477, 615, 705, 885, 975, 1065, 1229, 1407, 1727, 1970, 2358, 2795, 2889, 3197, 3504, 3781, 4041, 4531, 4996, 5351, 5724, 6266, 6609, 6810, 7067, 7163, 8085, 8710, 8983, 9083, 9692]","[0, 129, 219, 414, 573, 714, 924, 1285, 1446, 1612, 1833, 2098, 2654, 2850, 3123, 3314, 3568, 3876, 4093, 4552, 4828, 5248, 5808, 6429, 6804, 7560, 7730, 8210, 8588, 8782, 9249, 9644, 10003, 10201, 10583]",18256,15210,12829,9692,10583,21,59,60,111,20,"[0, 296, 665, 1047, 1525, 1868, 2246, 2811, 3249, 3960, 4867, 5128, 6172, 6639, 6931, 7286, 8322, 9449, 10308, 11255, 11877, 12709, 13227, 13918, 14143, 14725, 15206, 16353, 17002, 17702, 18355, 19286, 19779, 20199, 20892]","[0, 299, 651, 999, 1179, 1468, 2062, 2600, 2999, 3524, 4229, 4689, 4857, 5060, 5750, 6632, 7125, 7689, 8230, 9344, 10011, 10994, 11718, 12189, 12580, 13104, 13743, 14949, 15586, 16197, 16374, 16960, 17975, 18645, 19184]","[0, 245, 484, 823, 1035, 1335, 1678, 2174, 2614, 3250, 3882, 4308, 4960, 5299, 5734, 5977, 6406, 7278, 7655, 8338, 8853, 9326, 9761, 10101, 10302, 10898, 11263, 12165, 12676, 13389, 14022, 14609, 15243, 15688, 16268]","[0, 209, 632, 805, 895, 1029, 1190, 1486, 1625, 1853, 2115, 2205, 2610, 2961, 3393, 3726, 3883, 4464, 4804, 5115, 5676, 5930, 6146, 6375, 6516, 6788, 7123, 7936, 8142, 8393, 8787, 9148, 9594, 9829, 10390]","[0, 209, 351, 489, 579, 719, 809, 1158, 1248, 1576, 1832, 2035, 2474, 2768, 3073, 3233, 3583, 3852, 3995, 4340, 4514, 4766, 5025, 5254, 5349, 5596, 5865, 6604, 6810, 6946, 7158, 7465, 7779, 8014, 8204]",20892,19184,16268,10390,8204,-2636,-3974,-3439,-698,2379,-8368,35,dire
7534334312,70,39,97,51,5,"[0, 286, 536, 744, 1400, 2153, 2402, 3083, 3458, 3968, 4430, 5065, 5540, 6090, 7470, 8384, 9232, 10280, 11297, 12185, 12375, 13375, 13961, 14056, 14632, 15253, 15348, 16058, 16624, 17289, 17928, 18499, 20033, 21159, 22125]","[0, 361, 648, 991, 1448, 1725, 2213, 2935, 3270, 3509, 4025, 4343, 4663, 5236, 6154, 6508, 7173, 7764, 8341, 9053, 9604, 10313, 11094, 11579, 12259, 12634, 13184, 14143, 15042, 15927, 16832, 17589, 19758, 20293, 21197]","[0, 291, 574, 807, 1152, 1392, 1482, 1823, 2193, 2732, 2950, 3410, 3979, 4385, 4948, 5428, 6234, 6846, 7247, 7991, 8763, 9544, 10276, 10371, 10667, 11226, 11647, 11929, 12271, 13168, 13619, 14016, 14981, 15568, 16320]","[0, 210, 300, 602, 772, 862, 952, 1303, 1443, 1697, 2021, 2111, 2255, 2404, 3061, 3619, 3867, 4179, 4575, 4733, 4940, 5244, 5411, 5506, 6112, 6206, 6453, 6910, 7225, 7472, 7749, 8150, 9676, 10057, 10607]","[0, 210, 300, 390, 701, 887, 1016, 1230, 1370, 1731, 1867, 2077, 2221, 2411, 2796, 3065, 3313, 3543, 3742, 3900, 4090, 4847, 5014, 5234, 5373, 5467, 5562, 5912, 6298, 6509, 6822, 7333, 8164, 8752, 9077]",22125,21197,16320,10607,9077,10,137,92,110,65,"[0, 174, 504, 817, 1273, 1554, 2084, 2578, 3034, 3650, 4286, 4695, 5347, 5904, 6706, 7945, 8622, 9495, 10175, 10951, 11729, 12150, 13225, 14609, 15432, 15987, 16498, 17879, 18779, 20337, 21593, 21984, 22441, 22541, 23548]","[0, 293, 589, 883, 1047, 1386, 1756, 2558, 2848, 3215, 3420, 3830, 4535, 5206, 5653, 6130, 6875, 7048, 7445, 8030, 8496, 8892, 9289, 10085, 10993, 11087, 11972, 12157, 13028, 13752, 14595, 15042, 15246, 15850, 16474]","[0, 504, 832, 1153, 1534, 1770, 1980, 2260, 2667, 2757, 3103, 3547, 4213, 4732, 5095, 5544, 6208, 6559, 6840, 7529, 7713, 7958, 8287, 9204, 9717, 9893, 10428, 11100, 11664, 12340, 13104, 13758, 13956, 14056, 14443]","[0, 230, 366, 456, 635, 760, 850, 1420, 1544, 1722, 1879, 2049, 2298, 2494, 2729, 3316, 3930, 4257, 4418, 5098, 5720, 6048, 6479, 7223, 7926, 8095, 8517, 9303, 9802, 10439, 11014, 11114, 11221, 11396, 11848]","[0, 200, 290, 380, 704, 829, 1091, 1410, 1579, 1835, 2313, 2648, 2847, 3545, 3992, 4312, 4733, 5038, 5249, 5821, 6207, 6301, 6468, 7059, 7735, 7829, 8356, 8792, 8969, 9599, 10485, 10585, 10685, 10785, 10885]",23548,16474,14443,11848,10885,-1423,4723,1877,-1241,-1808,2128,35,radiant
7534419016,10,14,98,31,121,"[0, 170, 520, 863, 1224, 1392, 1861, 2261, 2616, 3085, 3781, 4431, 4897, 5644, 6512, 7055, 7528, 8084, 9116, 9464, 9684, 10207, 11294, 11710, 13124, 14386, 15217, 16232, 16701, 17224, 18019, 19531, 20788, 21858, 23399]","[0, 551, 925, 1351, 1913, 2121, 2443, 2986, 3434, 3897, 4717, 5500, 5808, 6258, 6761, 7301, 8082, 9079, 9982, 10854, 10949, 11725, 12439, 13557, 14786, 15198, 16646, 17162, 17770, 18673, 18959, 19140, 19994, 21769, 23487]","[0, 318, 649, 1135, 1423, 1850, 2106, 2553, 3266, 3433, 4277, 4796, 5435, 5881, 6314, 6589, 7269, 7510, 7980, 8277, 9343, 9836, 10945, 11801, 12800, 13320, 13612, 14398, 14934, 15277, 15559, 15912, 16589, 17735, 19213]","[0, 246, 387, 497, 700, 1023, 1113, 1203, 1328, 1508, 1817, 2084, 2879, 3098, 3689, 3942, 4347, 4530, 5099, 5557, 5887, 6099, 6371, 6600, 7096, 7427, 7917, 8405, 8615, 8786, 9125, 9656, 10176, 10692, 12059]","[0, 170, 260, 394, 567, 657, 894, 984, 1340, 1464, 1994, 2434, 2636, 2993, 3389, 3742, 4152, 4291, 4543, 4845, 5281, 5376, 6136, 6560, 6849, 7088, 7382, 8056, 8359, 8455, 8707, 9179, 9868, 10407, 11461]",23399,23487,19213,12059,11461,13,56,77,112,19,"[0, 278, 585, 914, 1081, 1382, 2050, 2576, 3553, 4230, 4540, 5133, 5223, 5852, 6222, 6976, 7753, 8126, 8740, 9720, 10148, 10925, 11422, 11778, 12496, 14062, 14832, 15037, 15908, 16682, 18306, 18987, 19544, 19644, 19744]","[0, 205, 450, 731, 937, 1520, 1727, 2524, 2884, 3226, 3633, 4057, 4682, 5056, 5435, 6081, 6737, 7105, 7685, 8079, 8422, 8751, 9854, 10001, 10944, 11344, 12323, 12538, 12827, 14175, 15401, 16479, 17169, 17269, 17427]","[0, 246, 411, 696, 1085, 1610, 1846, 2426, 2717, 3061, 3232, 3765, 4050, 4626, 4937, 5522, 6098, 6629, 7710, 8509, 9255, 10068, 10593, 11088, 11585, 11785, 12585, 13557, 14020, 14685, 15820, 16905, 17080, 17405, 17505]","[0, 170, 260, 350, 535, 674, 876, 1193, 1494, 1761, 1906, 2191, 2327, 2575, 2971, 3167, 3467, 3923, 4742, 5723, 6046, 6141, 6719, 6814, 7311, 7857, 8161, 8474, 8824, 9120, 9989, 10808, 10968, 11068, 11168]","[0, 254, 380, 517, 612, 1027, 1158, 1551, 1829, 1999, 2180, 2389, 2479, 2574, 2899, 3085, 3435, 3987, 4429, 4586, 5088, 5183, 5349, 5444, 6249, 6448, 6542, 6999, 7257, 7744, 8932, 9938, 10276, 10619, 10719]",19744,17427,17505,11168,10719,3655,6060,1708,891,742,13056,35,radiant
7535023015,82,13,69,53,26,"[0, 295, 491, 770, 1181, 1437, 1685, 2093, 2571, 3153, 3821, 4110, 4441, 5008, 5691, 6011, 7076, 7674, 8419, 8989, 9657, 10328, 11110, 11885, 13137, 13770, 14160, 14500, 15315, 16466, 17170, 17991, 19038, 20336, 21389]","[0, 369, 656, 1039, 1443, 1927, 2367, 2870, 3538, 3833, 4541, 4823, 5343, 6183, 6834, 7574, 7844, 8617, 9220, 9740, 10134, 10636, 11673, 12732, 13417, 14346, 14831, 15455, 16632, 17165, 17888, 18396, 20580, 21181, 22399]","[0, 369, 691, 856, 1352, 1937, 2536, 3348, 3686, 4128, 4656, 5184, 5683, 6260, 6782, 7402, 8045, 8707, 9448, 9896, 10456, 10835, 11548, 12316, 13189, 13675, 14159, 14792, 15934, 16792, 17133, 18264, 19522, 20082, 20886]","[0, 209, 299, 389, 528, 739, 935, 1137, 1248, 1357, 1686, 1886, 2317, 2891, 3176, 3475, 4003, 4276, 4573, 4848, 5354, 5996, 6292, 6591, 7682, 8288, 8488, 8766, 9891, 10182, 10653, 11430, 12337, 13013, 13939]","[0, 209, 314, 404, 575, 749, 908, 1268, 1358, 1448, 1803, 1991, 2745, 3590, 3794, 4017, 4176, 4424, 4587, 4967, 5137, 5375, 5707, 6242, 6754, 7204, 7374, 7543, 8240, 8606, 9017, 9633, 10079, 10377, 10699]",21389,22399,20886,13939,10699,10,96,23,86,83,"[0, 89, 367, 655, 1028, 1226, 1467, 1656, 2383, 2746, 3052, 3642, 4192, 4852, 5158, 5773, 6459, 7827, 8661, 9600, 10335, 10884, 11051, 11782, 12559, 13188, 14426, 15138, 15405, 15761, 16692, 17458, 17558, 18530, 18975]","[0, 165, 504, 831, 1473, 1853, 2186, 2733, 3288, 3771, 4417, 4760, 5537, 6212, 6598, 7156, 7713, 8262, 9117, 9853, 10516, 10755, 11971, 12795, 13460, 13824, 14985, 15747, 16109, 16919, 17296, 17876, 18628, 18908, 19616]","[0, 280, 720, 944, 1490, 1850, 2393, 2823, 3471, 3889, 4290, 4792, 5260, 5889, 6661, 7394, 7966, 8395, 9076, 9773, 10576, 10879, 11599, 12182, 12779, 13133, 13858, 14205, 14823, 15322, 15531, 16363, 16463, 16911, 17512]","[0, 89, 179, 289, 493, 633, 723, 849, 939, 1226, 1716, 1992, 2271, 2719, 2943, 3297, 4028, 4527, 4921, 5155, 5590, 6060, 6442, 6604, 6820, 7120, 7772, 7942, 8113, 8445, 8715, 8909, 9340, 9516, 9769]","[0, 89, 179, 331, 481, 635, 725, 894, 1110, 1520, 1837, 1962, 2285, 2488, 2712, 2945, 3204, 3456, 3734, 4245, 4756, 5011, 5257, 5426, 5718, 5960, 6531, 6738, 6909, 7080, 7467, 8267, 8489, 8664, 8899]",18975,19616,17512,9769,8899,2414,2783,3374,4170,1800,14541,35,radiant
7535030019,53,106,61,123,100,"[0, 253, 533, 976, 1162, 1382, 1666, 2111, 2596, 3101, 3841, 4382, 5048, 5561, 6230, 6727, 7406, 7831, 9114, 9902, 10945, 11620, 13398, 14199, 15587, 15826, 17068, 17845, 18046, 18936, 19158, 19875, 20947, 21553, 22487]","[0, 245, 539, 992, 1368, 1771, 2046, 2554, 2991, 3332, 4314, 4829, 5171, 5680, 6133, 6608, 6766, 7082, 8046, 8763, 9449, 9785, 10599, 11496, 11949, 12635, 13008, 13666, 14412, 14997, 15691, 16409, 17386, 18348, 19004]","[0, 204, 364, 591, 1045, 1367, 1649, 1868, 2296, 2920, 3943, 4770, 5281, 6026, 6373, 6965, 7322, 7972, 8349, 8717, 9201, 9777, 10564, 10986, 11530, 12091, 12553, 13147, 13640, 14055, 14352, 14843, 15141, 15241, 15812]","[0, 170, 304, 394, 573, 703, 793, 996, 1216, 1306, 1646, 2147, 2333, 2542, 2689, 2784, 2942, 3269, 4235, 4802, 5155, 5346, 6077, 6506, 6976, 7282, 7554, 7759, 8324, 8621, 8974, 9297, 9540, 10017, 10728]","[0, 170, 260, 610, 735, 990, 1096, 1299, 1517, 1607, 2014, 2391, 2571, 3056, 3165, 3418, 3736, 3831, 4425, 4693, 5078, 5237, 5466, 5738, 6015, 6254, 6466, 6671, 6963, 7352, 7863, 8186, 8376, 8639, 8829]",22487,19004,15812,10728,8829,41,69,74,128,65,"[0, 208, 745, 1070, 1198, 1605, 1959, 2328, 2772, 2996, 3238, 3510, 3783, 4251, 4802, 5210, 5909, 6845, 7148, 7921, 8730, 9687, 9853, 10470, 11173, 11943, 12433, 14059, 14877, 15649, 16689, 17374, 18367, 19710, 20603]","[0, 214, 459, 795, 1153, 1613, 1897, 2445, 3141, 3470, 3987, 4408, 4943, 5299, 6095, 6469, 7126, 7805, 8500, 8767, 9599, 10339, 11076, 11439, 12000, 12544, 12856, 13739, 14585, 15037, 15695, 16247, 17297, 18629, 18795]","[0, 242, 450, 694, 1073, 1455, 1817, 2215, 2504, 2749, 2971, 3189, 3633, 4030, 4348, 4706, 5149, 5703, 5980, 6369, 7184, 7802, 8001, 8348, 9292, 9884, 10382, 11347, 11838, 12269, 12905, 13210, 14077, 14674, 15048]","[0, 170, 297, 454, 588, 1001, 1091, 1301, 1503, 1593, 1813, 2177, 2366, 2562, 3063, 3198, 3896, 4288, 5062, 5384, 6115, 6633, 6919, 7096, 7697, 8115, 8248, 9388, 9710, 10285, 11058, 11457, 12064, 12364, 12673]","[0, 170, 336, 442, 558, 769, 859, 1226, 1381, 1537, 1766, 2024, 2293, 2489, 2948, 3251, 3786, 4377, 4653, 5141, 5582, 6022, 6831, 6926, 7400, 7495, 7589, 8165, 8630, 8726, 9303, 10167, 10402, 10702, 11268]",20603,18795,15048,12673,11268,1884,209,764,-1945,-2439,-1527,35,dire
7535205409,60,17,123,20,19,"[0, 206, 524, 854, 1215, 1700, 2218, 2915, 3455, 3878, 4348, 5004, 5680, 6224, 6872, 7343, 7918, 8678, 9775, 10540, 11712, 12329, 13137, 13751, 14006, 14520, 15371, 16097, 16479, 17499, 18536, 18636, 19091, 19969, 20674]","[0, 316, 687, 1020, 1344, 1512, 2086, 2486, 2833, 3629, 4174, 4806, 5149, 5614, 5903, 6734, 7153, 8050, 8391, 9236, 9785, 10753, 10920, 11590, 12153, 12443, 12702, 13552, 14042, 14444, 15190, 15290, 15890, 16745, 17834]","[0, 246, 502, 898, 988, 1394, 1706, 2085, 2729, 2819, 3197, 3646, 4267, 4682, 4814, 5269, 5593, 5902, 6322, 6716, 7132, 7939, 8106, 8837, 9396, 9567, 10339, 11183, 12499, 13603, 13970, 14354, 15171, 16006, 16759]","[0, 169, 259, 756, 976, 1268, 1412, 1737, 2047, 2276, 2482, 2647, 3078, 3281, 3376, 3580, 4068, 4316, 4501, 4992, 5089, 5543, 5748, 6197, 6478, 6573, 6753, 7286, 7876, 8181, 8748, 8927, 9281, 9924, 10148]","[0, 169, 259, 396, 486, 624, 759, 985, 1194, 1421, 1627, 1901, 2512, 2837, 2932, 3050, 3208, 3627, 4080, 4483, 4587, 4958, 5125, 5399, 5494, 5589, 5769, 6059, 6549, 6990, 7323, 7423, 7751, 8031, 8221]",20674,17834,16759,10148,8221,46,21,78,100,121,"[0, 241, 511, 842, 1260, 1956, 2247, 2663, 3225, 3488, 4241, 5286, 6328, 6772, 7763, 8582, 9317, 10249, 11124, 11738, 13001, 13479, 14919, 16076, 16861, 17770, 19045, 20023, 21348, 22649, 24951, 26041, 26940, 27742, 28928]","[0, 250, 567, 733, 995, 1453, 1864, 2211, 2675, 3310, 3823, 4432, 4522, 4873, 5477, 6177, 7106, 8202, 8889, 9333, 9716, 10800, 11529, 11794, 12383, 13282, 13981, 14732, 15190, 15837, 16015, 16683, 17406, 18005, 18776]","[0, 291, 566, 841, 1078, 1504, 1955, 2097, 2404, 2692, 3246, 3611, 3776, 4396, 5249, 5911, 6295, 6908, 7719, 8090, 8483, 8943, 9580, 10070, 11061, 11662, 12301, 12943, 13261, 14044, 14996, 16275, 16766, 17089, 17811]","[0, 169, 259, 349, 439, 797, 931, 1021, 1111, 1376, 1595, 1868, 2200, 2607, 3000, 3180, 3560, 3931, 4243, 4400, 4972, 5188, 5704, 5798, 6223, 6854, 7059, 7703, 8047, 8618, 9609, 10189, 10379, 10614, 11131]","[0, 169, 259, 397, 487, 808, 979, 1140, 1230, 1404, 1494, 1858, 2251, 2525, 2914, 3330, 3676, 3861, 4211, 4422, 4815, 5134, 5532, 5800, 6080, 6583, 6908, 7667, 8315, 8724, 8977, 9562, 10012, 10361, 10876]",28928,18776,17811,11131,10876,-8254,-942,-1052,-983,-2655,-13886,35,dire
7535209904,25,22,23,112,83,"[0, 387, 722, 1300, 1584, 2167, 2968, 3270, 3641, 3930, 4208, 4724, 5657, 6228, 6634, 7089, 7825, 8160, 8836, 8931, 9796, 10555, 10920, 11951, 12531, 12709, 13577, 13672, 14539, 15021, 15688, 17642, 18613, 20316, 21533]","[0, 281, 608, 952, 1194, 1524, 2025, 2354, 2495, 2806, 3236, 3652, 4065, 5215, 5680, 5800, 6611, 7098, 7576, 7671, 8171, 8711, 8932, 9124, 9410, 9804, 10891, 11417, 11680, 11968, 12471, 14263, 14659, 15512, 15612]","[0, 265, 546, 845, 1148, 1521, 1821, 2195, 2614, 3094, 3692, 4241, 5114, 5618, 6035, 6958, 7472, 7833, 8511, 9358, 9632, 10243, 10675, 10905, 11322, 11417, 12047, 12142, 12500, 12772, 13021, 14362, 14924, 15851, 16401]","[0, 265, 355, 445, 535, 714, 889, 979, 1231, 1577, 1759, 2223, 2812, 3503, 3866, 4132, 4428, 4621, 4865, 5160, 5383, 5512, 5606, 5826, 6215, 6310, 6873, 7263, 7526, 7622, 7991, 8864, 9481, 10344, 11002]","[0, 499, 603, 805, 895, 1069, 1591, 1730, 1925, 2056, 2146, 2282, 2372, 3018, 3149, 3787, 3945, 4148, 4318, 4488, 4962, 5132, 5499, 5873, 6115, 6358, 7033, 7410, 7958, 8139, 8254, 9264, 9364, 10217, 10704]",21533,15612,16401,11002,10704,46,14,98,121,3,"[0, 324, 702, 1063, 1513, 1793, 2471, 3000, 3547, 4307, 5279, 6076, 6729, 6986, 7437, 8589, 9412, 10389, 11035, 12387, 13577, 14251, 14647, 15278, 16110, 17201, 18044, 19240, 19710, 20406, 21330, 22194, 22294, 23395, 24250]","[0, 204, 481, 716, 1116, 1253, 1569, 2118, 2504, 3150, 3688, 4139, 4806, 5336, 5917, 6841, 7571, 8083, 8386, 9285, 10126, 10674, 11165, 11583, 12174, 13263, 13788, 14122, 14428, 14961, 15911, 16353, 16939, 17848, 18464]","[0, 279, 656, 922, 1414, 1713, 2077, 2250, 2537, 2816, 3107, 3742, 4067, 4680, 5398, 5926, 6755, 8015, 8562, 9094, 9832, 10748, 11781, 12452, 12985, 14358, 14853, 15432, 16000, 16573, 17558, 18252, 18352, 19294, 19641]","[0, 169, 259, 349, 439, 529, 723, 958, 1097, 1395, 2100, 2394, 2624, 2791, 3016, 3201, 3713, 4099, 4358, 4933, 5368, 5860, 6089, 6274, 6764, 7717, 8085, 8924, 9173, 9562, 10196, 10797, 10897, 11350, 11540]","[0, 169, 259, 349, 751, 868, 1318, 1536, 1626, 1828, 2044, 2185, 2473, 2640, 3118, 3864, 4508, 5162, 5336, 5954, 6475, 6853, 7082, 7729, 8410, 9404, 9653, 9902, 10273, 10498, 11018, 11716, 12140, 13075, 13335]",24250,18464,19641,11540,13335,-2717,-2852,-3240,-538,-2631,-11978,35,dire
7535614616,6,49,29,100,31,"[0, 663, 1026, 1573, 1844, 2405, 2615, 2967, 3392, 3544, 4025, 4420, 4896, 5348, 5733, 6266, 6671, 7196, 8480, 9435, 10415, 11422, 12660, 13324, 14249, 14958, 15647, 16295, 16945, 17492, 18065, 19021, 19923, 20746, 20894]","[0, 315, 789, 1123, 1558, 1933, 2417, 2870, 3410, 4167, 4685, 5092, 5439, 5825, 6288, 6503, 6661, 7524, 8214, 8793, 9672, 10324, 10518, 11119, 11489, 12019, 12737, 13132, 13309, 13528, 13793, 14537, 14952, 15692, 16511]","[0, 235, 452, 742, 914, 1285, 1733, 1913, 2682, 3051, 3452, 3889, 4601, 5189, 5513, 6162, 6499, 6899, 7555, 8333, 8770, 9305, 9800, 10610, 11040, 11649, 11837, 12074, 12446, 12726, 13535, 14232, 15195, 15884, 16287]","[0, 235, 390, 579, 699, 950, 1074, 1254, 1567, 2095, 2376, 2529, 3083, 3658, 4088, 4224, 4382, 4612, 5210, 5488, 6183, 6570, 6766, 7100, 7267, 7785, 7956, 8291, 8514, 8733, 8836, 9134, 9693, 10175, 10275]","[0, 235, 325, 431, 551, 641, 814, 994, 1275, 1500, 1963, 2053, 2316, 2702, 3011, 3109, 3290, 3566, 3833, 4339, 4733, 5183, 5377, 5704, 5995, 6161, 6271, 6511, 6688, 7144, 7255, 7750, 8032, 8257, 8357]",20894,16511,16287,10275,8357,113,63,22,2,102,"[0, 326, 526, 817, 1382, 1582, 2099, 2472, 2800, 3427, 4198, 4558, 5439, 5805, 6697, 6975, 7533, 8495, 8916, 9600, 10092, 10934, 11705, 12749, 13672, 14537, 15343, 16260, 16724, 18162, 19264, 19868, 20552, 21322, 22812]","[0, 170, 382, 607, 842, 1754, 2063, 2153, 2288, 2690, 3100, 3290, 3435, 3584, 3872, 4215, 4760, 5286, 5555, 6416, 6565, 7143, 7237, 7476, 8101, 8474, 9544, 9783, 10359, 11533, 12389, 12987, 13619, 13976, 15089]","[0, 284, 576, 913, 1252, 1705, 2024, 2598, 3082, 3566, 3964, 4268, 4549, 4734, 5113, 5470, 6014, 6675, 6922, 8050, 8145, 8573, 8769, 9300, 9797, 10500, 11398, 11911, 12254, 14106, 14892, 15304, 15893, 16658, 17162]","[0, 207, 297, 461, 733, 1065, 1569, 1897, 2426, 2754, 3172, 3495, 3822, 4058, 4380, 4729, 5245, 5890, 6324, 6833, 7004, 7337, 7527, 7902, 8262, 8625, 9218, 9516, 9817, 10393, 11282, 11753, 12136, 12413, 12954]","[0, 170, 260, 350, 567, 657, 841, 1064, 1199, 1470, 1832, 1922, 2058, 2395, 2590, 2685, 2819, 2977, 3071, 3273, 3368, 3623, 3717, 3881, 4123, 4364, 4644, 4892, 5312, 6096, 6564, 6924, 7324, 7651, 8215]",22812,15089,17162,12954,8215,-1918,1422,-875,-2679,142,-3908,35,dire
7535724706,70,86,97,138,110,"[249, 522, 882, 1171, 1572, 1808, 2212, 2302, 2648, 3090, 3408, 3791, 4439, 5386, 6057, 7036, 7470, 8119, 8901, 10191, 11169, 11967, 12563, 13520, 14609, 15700, 16942, 17907, 18686, 19760, 20736, 21906, 22471, 22844, 25019]","[328, 573, 896, 1295, 1753, 2162, 2500, 2926, 3220, 3710, 4358, 4538, 4803, 5328, 5866, 6544, 6995, 7399, 7575, 7831, 8394, 9145, 9384, 9912, 10587, 11343, 11946, 12510, 12701, 13124, 13850, 14207, 15017, 15746, 16470]","[169, 440, 696, 1195, 1670, 2162, 2762, 3369, 3929, 4480, 5108, 5698, 6562, 7040, 7777, 8174, 8386, 8711, 8869, 9590, 10081, 10530, 11066, 11701, 12074, 12595, 12785, 13149, 13664, 14087, 14899, 15154, 15364, 15673, 16583]","[169, 302, 392, 575, 768, 1111, 1436, 1657, 1747, 1972, 2126, 2306, 2510, 2687, 3008, 3525, 4134, 4507, 4745, 4839, 5112, 5680, 5987, 6082, 6819, 7317, 7611, 8455, 8761, 9497, 10070, 10561, 10862, 10962, 11900]","[169, 259, 431, 521, 747, 1034, 1460, 1550, 1680, 1952, 2270, 2678, 3034, 3153, 3533, 3979, 4727, 5082, 5631, 6105, 6468, 7331, 7699, 8069, 8605, 8843, 9258, 9524, 9943, 10428, 11301, 11735, 11987, 12126, 13240]",25019,16470,16583,11900,13240,113,56,98,105,100,"[296, 586, 955, 1321, 1720, 2019, 2280, 2605, 3019, 3222, 4025, 4827, 5258, 5632, 5917, 6400, 7531, 7979, 8756, 9180, 9712, 9968, 10309, 11115, 12156, 13314, 14352, 15395, 16013, 16335, 16530, 18036, 18456, 19367, 20701]","[169, 373, 623, 914, 1337, 1523, 1973, 2377, 2664, 3032, 3577, 4500, 4997, 5588, 5953, 6277, 7039, 7502, 8208, 8802, 9415, 10039, 10357, 10888, 11325, 12062, 12765, 13415, 14024, 14201, 14615, 15259, 15438, 16308, 16569]","[207, 495, 779, 1049, 1249, 1661, 1857, 2487, 2629, 2998, 3707, 4359, 5070, 5294, 6082, 6602, 7211, 7890, 8373, 8781, 9476, 9904, 10204, 10866, 11273, 11817, 12881, 13799, 14251, 14455, 14943, 15528, 15628, 16583, 16773]","[169, 259, 431, 591, 681, 771, 906, 1317, 1568, 1834, 2077, 2626, 2874, 3047, 3180, 3382, 4037, 4411, 4833, 5173, 5365, 5559, 6055, 6614, 6933, 7346, 7798, 8925, 9279, 9491, 9711, 9811, 9941, 10415, 11412]","[169, 259, 394, 591, 681, 832, 967, 1158, 1417, 1507, 1697, 2173, 2345, 2440, 2535, 2741, 3357, 3452, 3710, 3804, 4098, 4193, 4394, 4624, 4829, 5407, 5783, 6261, 6513, 6609, 7102, 7299, 7399, 7820, 8045]",20701,16569,16773,11412,8045,4318,-99,-190,488,5195,9712,35,radiant
7535725505,41,82,49,58,26,"[0, 239, 487, 929, 1099, 1430, 1597, 2203, 2564, 2776, 3038, 3459, 4103, 4867, 5376, 6136, 7264, 7858, 8767, 9168, 9983, 10657, 11128, 12354, 13029, 14021, 14116, 14504, 15157, 17146, 18331, 19843, 19943, 20635, 20908]","[0, 273, 434, 731, 1013, 1402, 1617, 2057, 2442, 2723, 3603, 3787, 4701, 5214, 6059, 7181, 7276, 9428, 10212, 10307, 10876, 11065, 13166, 13872, 13967, 14924, 15019, 15812, 15908, 17483, 18498, 18825, 18925, 19388, 19488]","[0, 130, 398, 670, 891, 1292, 1937, 2310, 2517, 2971, 3413, 3659, 3964, 4503, 5034, 5433, 6132, 7388, 7630, 8139, 8402, 9009, 9104, 9554, 10109, 10203, 10810, 10905, 11554, 12703, 13421, 14497, 15830, 16380, 16765]","[0, 130, 220, 350, 486, 610, 735, 1041, 1453, 1543, 1823, 1913, 2214, 2345, 2560, 3110, 3389, 4164, 4582, 4716, 4848, 5937, 6857, 8061, 8156, 8441, 8761, 9088, 9184, 10181, 10800, 12836, 12936, 13269, 13369]","[0, 130, 220, 350, 547, 686, 939, 1119, 1334, 1424, 1700, 1790, 2361, 2672, 2998, 3140, 3454, 3774, 4016, 4481, 4614, 4803, 5536, 5721, 5816, 5910, 6206, 6533, 6678, 7501, 7936, 8334, 8983, 9083, 9183]",20908,19488,16765,13369,9183,53,98,113,96,9,"[100, 604, 694, 1010, 1347, 1652, 1829, 2031, 2348, 2809, 3495, 4050, 4791, 5117, 5542, 6097, 6760, 7365, 7585, 8660, 9282, 10675, 10956, 12280, 13482, 14448, 15067, 16580, 17776, 18520, 19109, 20008, 20535, 22344, 23032]","[0, 218, 501, 897, 1263, 1679, 2197, 2684, 3102, 3657, 4352, 4889, 5322, 5834, 6253, 6882, 8173, 8962, 9768, 9987, 10812, 11460, 12066, 13033, 13522, 15052, 15848, 16948, 17366, 17926, 18594, 19055, 19659, 20773, 21863]","[0, 310, 607, 903, 1385, 1541, 1791, 2297, 3129, 3505, 4058, 4725, 5592, 5914, 6450, 6553, 6828, 7138, 8230, 9094, 9633, 10256, 10947, 11780, 12215, 13223, 14060, 15872, 16566, 16856, 17587, 18404, 18504, 19439, 20336]","[0, 204, 420, 836, 983, 1704, 2149, 2606, 3096, 3313, 4074, 4578, 4885, 5217, 5787, 6153, 6556, 6761, 7691, 8516, 9121, 9637, 10194, 11131, 11504, 12092, 12693, 13494, 13969, 14285, 14740, 16946, 17046, 17326, 17954]","[0, 170, 260, 380, 527, 815, 905, 1100, 1754, 2096, 2380, 2976, 3400, 3653, 3848, 4231, 4591, 4791, 5520, 5705, 6106, 6794, 7075, 7891, 8058, 8610, 8896, 9746, 10034, 10349, 10752, 11566, 11666, 12291, 13112]",23032,21863,20336,17954,13112,-2124,-2375,-3571,-4585,-3929,-16584,35,dire
7535755508,6,59,96,5,58,"[0, 290, 782, 1063, 1455, 1865, 2420, 2852, 3283, 3636, 3897, 4240, 4665, 5086, 5745, 6272, 7041, 7788, 8797, 9784, 10487, 11437, 11827, 12639, 13242, 13777, 14886, 15545, 16285, 16960, 17791, 18910, 20818, 21628, 22217]","[0, 283, 598, 968, 1270, 1588, 2098, 2276, 2577, 3055, 3631, 4252, 4807, 5800, 6300, 7088, 7800, 8224, 9189, 10226, 10922, 11429, 11887, 12241, 12903, 13254, 14061, 14155, 14467, 15107, 16167, 16755, 17225, 17551, 18045]","[0, 321, 677, 806, 1204, 1713, 2045, 2290, 2579, 2873, 3249, 3592, 4012, 4366, 4608, 5458, 5950, 6678, 7287, 8165, 8507, 9019, 9241, 9446, 10084, 10660, 10998, 11421, 12179, 12486, 13014, 13781, 15326, 15516, 15816]","[0, 169, 520, 651, 741, 871, 1412, 1502, 1592, 1729, 2025, 2303, 2593, 2742, 3004, 3371, 4011, 4679, 5261, 6402, 6840, 7464, 7714, 7883, 8608, 8891, 9304, 9904, 10386, 10706, 11260, 12313, 13847, 14062, 14528]","[0, 169, 341, 478, 623, 770, 1424, 1528, 1674, 1817, 2012, 2244, 2943, 3276, 3539, 3809, 4098, 4472, 4993, 5399, 5878, 6436, 6598, 6692, 7368, 8142, 8525, 8962, 9926, 10385, 10744, 10999, 12086, 12529, 13297]",22217,18045,15816,14528,13297,10,106,86,97,119,"[0, 204, 446, 621, 1035, 1280, 1577, 2083, 2476, 2769, 3259, 3842, 4360, 5066, 5947, 6258, 7028, 7271, 7727, 8595, 9185, 9488, 10798, 11228, 12231, 13348, 13743, 14590, 15554, 16601, 17333, 18360, 18941, 21011, 22188]","[0, 243, 495, 672, 796, 1450, 1575, 1789, 2279, 2536, 2912, 3297, 3552, 4052, 4553, 4858, 5279, 5473, 5939, 6389, 6564, 6888, 8684, 8994, 9179, 10189, 10930, 11264, 11829, 12693, 13231, 14086, 14186, 15520, 16332]","[0, 344, 632, 786, 924, 1446, 1634, 1769, 2001, 2180, 2621, 2928, 3422, 3625, 4208, 4722, 5013, 5421, 5775, 6090, 6352, 6627, 8530, 8969, 9339, 10225, 10503, 11312, 11973, 12150, 12305, 12921, 13494, 14160, 14588]","[0, 509, 758, 1040, 1375, 1615, 1744, 2122, 2301, 2775, 3576, 3922, 4302, 4630, 5111, 5304, 5595, 5860, 5955, 6107, 6331, 6426, 6810, 7705, 8502, 8781, 8876, 9186, 9676, 9887, 10171, 10483, 10827, 11141, 11533]","[0, 169, 323, 413, 570, 962, 1299, 1468, 1558, 1740, 2099, 2258, 2716, 3026, 3200, 3565, 4079, 4237, 4359, 4454, 4774, 4869, 5840, 6150, 6374, 6877, 6972, 7157, 7300, 7477, 8082, 8720, 8820, 9247, 9347]",22188,16332,14588,11533,9347,29,1713,1228,2995,3950,9915,35,radiant
7535757511,95,2,19,14,31,"[0, 208, 495, 804, 1278, 1603, 1764, 2027, 2884, 3301, 3738, 3908, 4375, 4860, 5159, 5629, 6080, 6550, 6950, 7258, 7874, 8525, 9216, 9753, 10400, 10662, 11440, 12031, 12528, 13112, 13233, 13524, 14196, 14666, 15447]","[0, 281, 615, 911, 1250, 1525, 1888, 2023, 2458, 2862, 3395, 3519, 3812, 4500, 5138, 6062, 6400, 6816, 7172, 7540, 8207, 8453, 9086, 9550, 9792, 10256, 11088, 11445, 11622, 11870, 12688, 12788, 13080, 13252, 13352]","[0, 398, 647, 958, 1408, 1809, 2370, 2701, 3297, 3978, 4579, 4849, 5038, 5553, 6291, 7492, 7959, 8054, 8400, 9254, 9700, 9851, 10124, 10369, 11116, 11542, 12016, 12201, 12454, 12550, 12916, 13073, 13380, 13817, 14294]","[0, 242, 332, 504, 803, 933, 1098, 1327, 1526, 1752, 2016, 2243, 2636, 2926, 3671, 4082, 4457, 4682, 4889, 5107, 5293, 5852, 6600, 7166, 7584, 7959, 8174, 8768, 8945, 9255, 9533, 10011, 10390, 10523, 10623]","[100, 475, 803, 931, 1061, 1191, 1552, 2011, 2146, 2326, 2634, 2724, 2814, 3058, 3569, 3756, 3936, 4031, 4303, 4674, 5186, 5298, 5643, 5738, 6258, 6353, 6512, 6697, 6874, 7234, 7330, 7430, 7530, 7630, 8124]",15447,13352,14294,10623,8124,10,63,96,114,20,"[0, 296, 872, 1131, 1526, 1966, 2344, 2905, 3406, 3860, 4243, 4834, 5362, 5889, 6626, 7263, 7797, 8461, 9080, 11317, 11811, 12953, 13764, 14876, 16122, 16842, 17460, 18430, 19706, 20493, 20756, 21680, 22819, 23797, 24384]","[0, 296, 466, 648, 774, 864, 1066, 1205, 1295, 1385, 1759, 2245, 2384, 2741, 3129, 3369, 3730, 4085, 4313, 5192, 5879, 6476, 6705, 7303, 7990, 8524, 8643, 9566, 10641, 11318, 12047, 12437, 13418, 13821, 14751]","[0, 368, 606, 1013, 1190, 1476, 1871, 2508, 2764, 3213, 3565, 3968, 4381, 4957, 5750, 6063, 6825, 7092, 7407, 7926, 8314, 8750, 8979, 9400, 9862, 10286, 10431, 10851, 11807, 12493, 12968, 13206, 13842, 14207, 15045]","[0, 762, 1016, 1320, 1668, 2127, 2534, 2997, 3365, 3613, 3978, 4297, 4827, 5378, 5824, 6139, 6433, 6690, 6991, 7324, 7927, 8390, 8708, 9097, 9789, 10287, 10598, 10925, 11863, 12425, 12718, 13066, 13807, 14254, 14905]","[0, 429, 588, 796, 886, 1025, 1203, 1337, 1461, 1599, 1792, 2284, 2421, 2653, 2986, 3263, 3421, 3682, 3777, 4770, 5110, 5430, 5734, 6152, 6640, 7027, 7196, 7647, 8206, 8665, 8863, 9115, 9751, 10199, 10904]",24384,14751,15045,14905,10904,-8937,-1399,-751,-4282,-2780,-18149,35,dire
7535992313,95,21,98,75,83,"[64, 442, 605, 1007, 1329, 1670, 2058, 2265, 2676, 3056, 3603, 4195, 4616, 4764, 5595, 6121, 6924, 7747, 7842, 8381, 9162, 10658, 11008, 11671, 12467, 13230, 13993, 14351, 14615, 15353, 15663, 16526, 17470, 17902, 19250]","[332, 999, 1209, 1571, 1866, 2280, 2612, 3366, 3591, 3860, 4462, 4872, 5621, 6060, 6844, 7236, 8118, 8499, 8962, 9493, 9752, 10758, 11278, 11999, 12650, 13126, 13882, 14698, 14875, 15522, 16059, 16925, 17433, 17722, 17936]","[64, 315, 586, 818, 1286, 1831, 2136, 2731, 3058, 3708, 4300, 4954, 5342, 5526, 6474, 6759, 7221, 7401, 7736, 8102, 8700, 9095, 9456, 9811, 10383, 10984, 11557, 11806, 12016, 12247, 12641, 12921, 13308, 14046, 14922]","[64, 315, 423, 513, 712, 818, 1830, 2003, 2140, 2522, 2857, 3229, 3468, 3663, 3917, 4167, 4891, 5320, 5548, 5861, 6101, 6717, 6812, 7112, 7472, 7711, 7947, 8103, 8280, 8689, 8785, 9109, 9209, 9428, 9528]","[64, 315, 405, 495, 702, 1373, 1508, 1643, 1861, 2281, 2582, 2945, 3184, 3332, 3693, 3933, 4392, 4486, 4671, 5258, 5637, 6003, 6143, 6443, 6840, 7079, 7220, 7354, 7566, 8136, 8449, 8952, 9073, 9173, 9882]",19250,17936,14922,9528,9882,41,59,96,111,20,"[0, 204, 449, 611, 739, 926, 1332, 1725, 1984, 2397, 2663, 3102, 3472, 4563, 4852, 5482, 6087, 7172, 7933, 8806, 9747, 9842, 11016, 11798, 12608, 13439, 14605, 15311, 16243, 17081, 17950, 18764, 19259, 20232, 21564]","[0, 278, 489, 750, 1040, 1204, 1543, 1813, 2215, 2536, 2839, 3263, 3896, 4815, 5140, 5360, 5941, 6826, 7514, 8144, 9167, 9262, 10394, 10732, 11216, 11675, 11907, 12405, 12892, 13530, 14172, 14479, 15035, 15293, 16841]","[0, 254, 582, 1161, 1471, 1644, 2091, 2965, 3306, 3561, 3964, 4345, 4792, 5337, 5540, 5635, 6249, 6667, 7085, 7537, 8097, 8629, 9538, 9688, 10221, 10438, 10863, 11202, 11490, 11969, 12412, 12686, 13033, 13293, 14321]","[0, 170, 356, 446, 536, 626, 1121, 1325, 1462, 1607, 1966, 2197, 2373, 2919, 3363, 3685, 3951, 4562, 5045, 5428, 5964, 6634, 7195, 7420, 7853, 8339, 8739, 9004, 9503, 9982, 10475, 10575, 10724, 11285, 12484]","[0, 387, 477, 699, 835, 925, 1182, 1452, 1673, 1808, 2140, 2230, 2320, 2684, 2779, 2874, 3140, 3538, 3990, 4187, 4573, 4668, 5276, 5426, 5592, 5806, 5991, 6131, 6393, 6878, 6986, 7086, 7230, 7764, 9198]",21564,16841,14321,12484,9198,-2314,1095,601,-2956,684,-2890,35,radiant
7535996813,21,80,137,105,26,"[298, 574, 831, 1314, 1694, 2216, 2520, 3312, 3763, 4427, 5185, 5451, 5931, 6479, 7079, 7720, 8979, 10272, 10908, 11609, 12394, 13749, 14541, 15262, 16091, 17250, 17900, 18700, 19142, 20145, 20950, 21684, 22426, 23370, 23470]","[334, 582, 856, 1259, 1662, 1786, 2318, 2889, 3387, 4157, 4918, 5520, 6142, 6589, 7159, 7458, 7899, 8145, 8303, 8658, 9327, 10202, 10974, 11380, 12461, 13167, 13418, 13986, 14586, 15655, 16241, 16810, 17552, 18508, 18608]","[371, 660, 997, 1337, 1862, 2025, 2151, 2616, 3028, 3545, 4252, 4815, 5322, 5727, 6090, 6481, 6709, 7446, 8327, 9157, 9411, 9862, 10067, 10471, 11514, 11906, 12607, 13406, 13682, 14235, 14983, 15255, 15864, 16812, 16912]","[210, 300, 390, 520, 694, 784, 874, 1224, 1362, 1923, 2454, 2563, 3056, 3405, 3744, 3955, 4434, 5633, 5897, 6358, 6527, 6859, 7139, 7511, 7987, 8769, 9559, 10279, 10548, 10941, 11333, 11660, 11886, 12506, 12642]","[210, 382, 472, 648, 738, 1160, 1524, 1707, 1846, 2150, 2593, 2813, 3301, 3487, 3665, 3963, 4724, 5308, 5606, 5931, 6025, 6549, 6875, 7045, 7715, 8226, 8493, 8959, 9297, 9765, 10030, 10191, 10381, 10980, 11080]",23470,18608,16912,12642,11080,41,19,38,53,20,"[511, 760, 1403, 1711, 2167, 2746, 3005, 3445, 3699, 3965, 4368, 4732, 5206, 5539, 5997, 6708, 7082, 7670, 8326, 8885, 9511, 10141, 11118, 11659, 12174, 12786, 13828, 14073, 14627, 15294, 16027, 16887, 17375, 18084, 20911]","[204, 506, 932, 1310, 1653, 2101, 2458, 2871, 3172, 3564, 3906, 4473, 5070, 5410, 6168, 6634, 6987, 7724, 8118, 8540, 8972, 9496, 10423, 10940, 11275, 11801, 12319, 12593, 12830, 13184, 13797, 14574, 15180, 15407, 16951]","[204, 480, 693, 941, 1071, 1161, 1587, 1847, 2096, 2977, 3617, 3996, 4443, 5347, 6094, 6644, 7700, 8105, 8466, 9063, 9636, 10130, 11322, 11923, 12649, 13136, 14164, 14260, 14573, 15142, 15643, 15743, 15924, 16154, 17333]","[204, 332, 503, 638, 1041, 1292, 1500, 1873, 2002, 2226, 2417, 2723, 3032, 3455, 3932, 4364, 4549, 5197, 5726, 6171, 6565, 7321, 8156, 8799, 9272, 9528, 10304, 10479, 11114, 12018, 12343, 12870, 13409, 14161, 15231]","[204, 346, 605, 780, 1148, 1384, 1592, 1806, 1896, 2075, 2436, 2628, 2826, 3090, 3762, 4247, 5762, 6374, 6532, 6717, 6825, 7071, 7462, 8042, 8842, 9178, 9273, 9422, 9805, 10259, 10623, 10783, 10979, 11079, 11345]",20911,16951,17333,15231,11345,2559,1657,-421,-2589,-265,941,35,dire
7536605901,10,71,120,110,121,"[0, 130, 369, 816, 1226, 1585, 1920, 2362, 2746, 3295, 3715, 4334, 4700, 5292, 5769, 6338, 7231, 7943, 8833, 9900, 10292, 10901, 11887, 12634, 13064, 13924, 14669, 14763, 15301, 15916, 16519, 17584, 18345, 18938, 19422]","[0, 164, 516, 796, 1101, 1544, 1806, 2331, 3058, 3476, 3883, 4708, 5478, 6054, 6864, 7402, 8372, 8675, 9073, 9772, 10315, 10482, 11456, 12123, 12302, 12795, 13622, 13784, 14359, 14740, 15570, 16118, 16842, 16942, 17431]","[0, 296, 494, 940, 1336, 1741, 2011, 2500, 2986, 3558, 4051, 4424, 5233, 5896, 6322, 6633, 7359, 7642, 8206, 9098, 9193, 9660, 10267, 10779, 11568, 11898, 12153, 12671, 13371, 13721, 13817, 14181, 14712, 15274, 15552]","[0, 168, 258, 415, 641, 798, 888, 1205, 1339, 1474, 1702, 1868, 2396, 2725, 2846, 3074, 4286, 4748, 5015, 5323, 5569, 5736, 5865, 5959, 6054, 6221, 7153, 7435, 7821, 7917, 8124, 8434, 8948, 9177, 9277]","[0, 175, 602, 692, 937, 1122, 1388, 1556, 1869, 2032, 2200, 2466, 2667, 3089, 3259, 3502, 3935, 4133, 4551, 5228, 5474, 5641, 5839, 6139, 6684, 6911, 7392, 7486, 8025, 8228, 8324, 8992, 9252, 9466, 9639]",19422,17431,15552,9277,9639,89,106,97,105,75,"[0, 209, 566, 1050, 1386, 1748, 2039, 2538, 2791, 3087, 3762, 4244, 5024, 6073, 7018, 7340, 8410, 9387, 10603, 11383, 11613, 12843, 14416, 15627, 16487, 17868, 18608, 19600, 21528, 22505, 23610, 25302, 27290, 28427, 30662]","[0, 328, 681, 1007, 1368, 1723, 1930, 2668, 3058, 3830, 4396, 4732, 5311, 5758, 6395, 7000, 7427, 8091, 8300, 9205, 9746, 10877, 11281, 11738, 12333, 12760, 13455, 15258, 15598, 16312, 16738, 17316, 17818, 18125, 18748]","[0, 209, 556, 799, 1245, 1637, 2047, 2445, 2864, 3444, 3959, 4380, 4922, 5180, 6249, 6836, 8042, 8200, 8488, 9446, 10210, 10377, 11073, 11693, 12333, 12930, 13427, 14346, 15082, 15564, 15940, 17241, 17912, 18591, 19093]","[0, 170, 260, 416, 506, 661, 796, 961, 1096, 1596, 1776, 2293, 2548, 2762, 3173, 3585, 4361, 4605, 4893, 5096, 5744, 6056, 6477, 6902, 7741, 8029, 8435, 9608, 9949, 10304, 10510, 10700, 11201, 11914, 12583]","[0, 170, 305, 441, 629, 759, 951, 1244, 1397, 1646, 2028, 2278, 2491, 2705, 2911, 3405, 3981, 4139, 4432, 4783, 5169, 5600, 5932, 6190, 6375, 6614, 6981, 7089, 7456, 7977, 8798, 9063, 9348, 9957, 10654]",30662,18748,19093,12583,10654,-11240,-1317,-3541,-3306,-1015,-20419,35,dire
7536677705,113,22,96,65,105,"[73, 237, 645, 817, 1189, 1548, 1960, 2368, 2672, 3075, 3953, 4442, 4900, 5522, 6135, 6948, 7696, 8310, 8911, 10263, 11091, 11588, 12789, 13848, 15032, 15828, 17063, 17850, 18711, 18807, 20328, 21733, 22623, 23909, 25376]","[73, 326, 719, 1125, 1390, 1800, 2373, 2730, 3237, 3697, 4331, 4849, 5336, 6039, 6297, 6943, 7283, 7632, 8087, 8984, 9374, 9768, 10595, 11000, 11900, 12707, 13196, 13372, 13792, 13983, 14957, 15484, 16846, 17161, 18101]","[73, 285, 566, 1009, 1431, 1796, 2130, 2385, 2763, 3014, 3475, 3950, 4410, 5409, 5962, 6676, 7092, 7729, 8045, 8659, 9189, 9715, 9953, 10138, 10676, 10770, 10994, 11420, 12069, 12165, 13202, 13868, 14983, 15434, 16216]","[73, 203, 293, 531, 848, 958, 1369, 1836, 2249, 2546, 3061, 3800, 4340, 4903, 5217, 5815, 6110, 6448, 7197, 7645, 7740, 7835, 8368, 8736, 9199, 9293, 9388, 9844, 10458, 10554, 11022, 11335, 12469, 13262, 13773]","[206, 336, 441, 531, 666, 756, 1174, 2005, 2193, 2705, 3606, 3732, 4070, 4450, 4838, 5289, 6066, 6211, 6417, 6733, 7489, 7584, 7812, 7997, 8284, 8878, 9045, 9717, 10057, 10153, 10721, 11131, 11618, 12079, 12379]",25376,18101,16216,13773,12379,94,106,69,58,121,"[174, 420, 627, 966, 1287, 1735, 2096, 2474, 3039, 3507, 4174, 4545, 5188, 5790, 6421, 7081, 7831, 8291, 8644, 9565, 10607, 11261, 12368, 12882, 14199, 15194, 16994, 17787, 19006, 19710, 20590, 21912, 22966, 23066, 23735]","[307, 703, 951, 1246, 1646, 2059, 2592, 2917, 3091, 3447, 3582, 3965, 4636, 4839, 5525, 5922, 6509, 6961, 7717, 8123, 8959, 9499, 10715, 11442, 12295, 13341, 14100, 15021, 16245, 17018, 17641, 18663, 19029, 19870, 20445]","[174, 420, 774, 1168, 1581, 1973, 2430, 3191, 3576, 3992, 4204, 4843, 5252, 5785, 6170, 6643, 7311, 7718, 8011, 8602, 9048, 9552, 10258, 10886, 11215, 11951, 13231, 13706, 14830, 15599, 16379, 16781, 17209, 17885, 18510]","[442, 652, 742, 832, 1074, 1288, 1607, 1852, 2099, 2508, 2680, 3104, 3518, 3721, 3990, 4349, 4834, 5495, 5686, 5893, 6306, 6493, 7074, 7321, 7721, 8454, 8804, 9082, 9585, 10043, 10324, 10656, 10818, 10972, 11230]","[307, 517, 607, 745, 870, 1125, 1287, 1754, 2059, 2219, 2393, 2800, 2980, 3183, 3377, 3500, 3681, 4313, 4407, 4647, 4829, 4924, 5937, 6032, 6171, 6409, 7004, 7234, 7876, 8252, 8474, 8844, 8944, 9044, 9378]",23735,20445,18510,11230,9378,1641,-2344,-2294,2543,3001,2547,35,radiant
7537775002,41,39,97,123,20,"[326, 613, 928, 1248, 1470, 1882, 2043, 2507, 3040, 3662, 4018, 4648, 4929, 5257, 5772, 6265, 7282, 8159, 8728, 9259, 9769, 10154, 10497, 11106, 12274, 12673, 13748, 14739, 15542, 16124, 17308, 18605, 19948, 20672, 21695]","[58, 336, 744, 1038, 1524, 1778, 2190, 2679, 3054, 3533, 4003, 4687, 5126, 5740, 6257, 6500, 7840, 8608, 8855, 9802, 10495, 10917, 11940, 13226, 13818, 14514, 15000, 15693, 16295, 16748, 17024, 17848, 18975, 19604, 20301]","[58, 277, 514, 802, 1048, 1576, 1915, 2294, 2709, 3250, 3518, 4109, 4683, 5256, 5533, 5770, 6334, 6772, 7077, 7926, 8267, 8554, 8723, 9302, 9607, 10445, 11258, 12084, 12794, 12965, 13987, 15048, 15434, 15814, 16442]","[58, 188, 278, 398, 524, 742, 832, 1121, 1331, 1599, 1866, 2192, 2743, 3389, 3992, 4265, 5143, 5454, 5715, 6366, 6728, 7185, 7438, 8477, 9042, 9321, 9834, 10537, 10917, 11238, 12169, 12944, 13209, 13678, 14122]","[58, 188, 314, 473, 603, 893, 1018, 1223, 1470, 1871, 2213, 2612, 2792, 3293, 3473, 3657, 4180, 4491, 4683, 4985, 5155, 5325, 5494, 6791, 7155, 7325, 7604, 7982, 8437, 8736, 8922, 9689, 10073, 10299, 10985]",21695,20301,16442,14122,10985,82,74,129,65,105,"[0, 255, 662, 999, 1385, 1754, 2282, 2780, 3467, 4162, 4559, 4827, 5641, 5958, 6867, 7657, 8591, 9193, 9774, 10006, 11384, 12546, 13089, 13529, 14123, 15224, 16092, 16669, 17519, 17836, 18170, 18435, 18625, 18725, 19654]","[0, 256, 540, 875, 1142, 1559, 1972, 2410, 2904, 3391, 3721, 4080, 4465, 4941, 5679, 5988, 6173, 6339, 6472, 7659, 8279, 8663, 9551, 9762, 10125, 10875, 11636, 12396, 13257, 13880, 14189, 14796, 16058, 16901, 17866]","[0, 260, 532, 914, 1307, 1504, 2000, 2346, 2807, 2984, 3241, 3818, 4448, 4977, 5304, 6201, 6386, 7043, 7651, 8140, 8995, 9683, 9934, 10145, 10776, 11087, 11620, 11906, 12108, 12378, 13210, 13697, 14197, 14693, 14982]","[100, 310, 400, 490, 775, 985, 1075, 1367, 1654, 1744, 1995, 2304, 2520, 2836, 3124, 3564, 3912, 4007, 4537, 5026, 5625, 6180, 6598, 6864, 7309, 8020, 8613, 8863, 9248, 9697, 10054, 10285, 10827, 11220, 11542]","[0, 210, 300, 498, 618, 743, 927, 1093, 1276, 1568, 1865, 2096, 2560, 2747, 3246, 3533, 3816, 3911, 4052, 4941, 5883, 6769, 7020, 7231, 7398, 7637, 7812, 8273, 9157, 9556, 9652, 10154, 10622, 11260, 11450]",19654,17866,14982,11542,11450,2041,2435,1460,2580,-465,8051,35,radiant
7537910800,73,120,129,53,79,"[1, 388, 662, 1059, 1328, 1719, 2161, 2928, 3255, 4180, 4807, 5642, 6241, 7749, 8689, 8972, 10258, 11023, 11885, 13207, 14539, 15717, 16338, 17103, 17948, 18965, 19728, 20996, 21928, 22803, 23919, 24834, 25846, 26639, 27087]","[1, 242, 484, 650, 965, 1368, 1574, 2400, 2646, 3201, 3695, 4168, 4952, 5108, 5552, 6356, 7699, 8548, 9306, 10044, 10565, 10864, 11677, 12446, 12914, 13654, 14310, 15102, 15900, 16558, 17105, 17853, 18615, 19226, 20077]","[1, 258, 437, 918, 1391, 1809, 2425, 2841, 3292, 3613, 4098, 4250, 4874, 5500, 5801, 6365, 7498, 8261, 8875, 9451, 10092, 11338, 11862, 12480, 13007, 13536, 14270, 14834, 15364, 16258, 16859, 17636, 18521, 19701, 20080]","[1, 323, 413, 582, 672, 880, 1086, 1266, 1489, 1734, 2054, 2224, 2603, 2934, 3085, 3363, 4201, 4893, 5123, 5610, 5977, 6161, 6684, 7424, 8052, 8664, 8981, 9618, 10261, 10942, 11638, 12176, 12907, 13772, 14238]","[1, 491, 581, 701, 829, 1145, 1516, 1696, 1803, 2141, 2505, 2885, 3222, 3426, 3799, 4054, 4601, 5225, 5542, 5947, 6479, 6884, 7389, 7816, 8029, 8582, 9100, 9490, 9880, 10635, 11098, 11618, 12273, 12649, 13087]",27087,20077,20080,14238,13087,47,41,55,51,110,"[1, 256, 544, 804, 1161, 1554, 2242, 2413, 2897, 3529, 3928, 4235, 4837, 5290, 5689, 6051, 6353, 7033, 7278, 7676, 8335, 9066, 9645, 10266, 10439, 10678, 11324, 11807, 12140, 12547, 13115, 13391, 14110, 14595, 15384]","[1, 171, 387, 595, 978, 1189, 1524, 1820, 2188, 2406, 2918, 3417, 3962, 4391, 5125, 5620, 6116, 6432, 6809, 7491, 8481, 8576, 9036, 9720, 10105, 11068, 11634, 12284, 12631, 13652, 14518, 15259, 15702, 16705, 17428]","[1, 171, 368, 527, 1033, 1418, 1733, 2257, 2814, 3363, 3837, 4407, 4980, 5380, 6017, 6619, 6981, 7380, 7774, 8224, 9195, 9290, 9902, 10497, 10683, 11322, 11664, 11972, 12204, 12598, 13086, 13853, 14799, 15419, 15639]","[1, 216, 306, 396, 526, 633, 829, 1045, 1329, 1552, 1687, 2026, 2116, 2412, 2967, 3291, 3439, 3534, 3744, 4109, 4854, 4949, 5354, 5521, 5860, 6551, 6823, 6918, 7105, 7201, 7461, 8011, 8146, 8502, 8636]","[1, 171, 261, 399, 573, 663, 1026, 1161, 1268, 1366, 1501, 1711, 2014, 2254, 2698, 2809, 3188, 3572, 3908, 4003, 4590, 4964, 5287, 5884, 6317, 6484, 7032, 7127, 7223, 7319, 8024, 8214, 8508, 8839, 8975]",15384,17428,15639,8636,8975,11703,2649,4441,5602,4112,28507,35,radiant
7538469504,10,106,78,75,26,"[0, 167, 499, 917, 1286, 1568, 2081, 2542, 3020, 3445, 3877, 4586, 5247, 5735, 6468, 7061, 7612, 8098, 9224, 9894, 10971, 11752, 12256, 13099, 13816, 14811, 15753, 16989, 18519, 19288, 20107, 20717, 22064, 22608, 23391]","[0, 168, 451, 814, 983, 1149, 1351, 1656, 1908, 2282, 2631, 2911, 3603, 4041, 4423, 4690, 4918, 5750, 6259, 6768, 7131, 7479, 7772, 8402, 8989, 9084, 10031, 10709, 11514, 12105, 13188, 13887, 15061, 16037, 16227]","[0, 167, 576, 825, 1085, 1415, 1787, 2097, 2389, 2964, 3574, 3955, 4171, 4473, 4760, 5068, 5491, 5755, 6295, 6618, 6987, 7283, 7610, 8463, 8682, 9063, 9205, 10024, 10525, 11026, 11658, 11896, 12492, 12929, 13495]","[0, 129, 219, 309, 399, 489, 579, 821, 926, 1166, 1382, 1771, 2005, 2222, 2600, 2695, 3060, 3423, 3783, 4326, 4680, 4976, 5303, 5727, 5893, 6191, 6375, 7103, 7474, 7811, 8246, 8596, 9167, 9417, 9768]","[0, 129, 276, 366, 456, 546, 636, 861, 1046, 1320, 1620, 1800, 2271, 2779, 2955, 3101, 3243, 3522, 3830, 4409, 4642, 5118, 5360, 5720, 5925, 6095, 6412, 7222, 7726, 7978, 8239, 8448, 8800, 8975, 9165]",23391,16227,13495,9768,9165,41,49,102,58,110,"[0, 209, 372, 576, 851, 1474, 1794, 2102, 2622, 3257, 3571, 3938, 4343, 5040, 5582, 5935, 6273, 7128, 7659, 8417, 9449, 10002, 11371, 12333, 13471, 14289, 15012, 15842, 16568, 17111, 17997, 18511, 19499, 20418, 21094]","[0, 335, 664, 911, 1378, 1595, 2093, 2584, 2963, 3334, 3943, 4260, 4592, 5329, 6094, 6647, 6865, 7212, 7925, 8231, 9090, 9417, 10579, 11516, 12396, 13394, 14081, 14626, 14803, 15852, 16253, 16725, 18156, 19033, 19960]","[0, 295, 494, 656, 897, 1458, 1690, 2239, 2662, 3129, 3552, 4194, 4663, 5092, 5632, 6021, 6390, 6933, 7412, 8080, 8559, 8886, 10364, 10854, 11616, 12353, 12987, 13739, 13916, 14691, 15310, 15683, 16385, 17086, 17646]","[0, 209, 299, 407, 514, 664, 819, 1221, 1311, 1762, 2139, 2527, 2712, 3029, 3161, 3410, 3613, 3857, 4216, 4498, 4834, 5453, 5977, 6492, 6957, 7769, 8221, 8812, 9294, 9828, 10334, 10599, 11147, 11846, 12212]","[0, 258, 348, 438, 567, 742, 832, 1311, 1401, 1718, 1908, 2302, 2743, 3033, 3220, 3472, 3629, 3834, 4073, 4325, 4674, 4904, 5276, 5504, 5790, 6361, 6947, 7274, 7517, 8023, 8277, 8377, 8741, 8841, 9260]",21094,19960,17646,12212,9260,2297,-3733,-4151,-2444,-95,-8126,35,dire
7538527908,89,46,23,26,105,"[0, 208, 660, 1101, 1419, 1837, 2266, 2737, 3189, 3769, 4193, 4373, 4962, 5666, 6079, 6855, 7582, 7874, 8496, 9404, 10360, 11189, 12966, 14279, 14557, 15087, 16036, 16932, 17878, 19077, 20007, 21730, 23128, 24490, 26301]","[0, 204, 406, 607, 731, 1003, 1364, 1794, 2008, 2471, 2976, 3542, 4063, 4824, 5571, 6311, 7258, 8084, 8809, 9465, 10098, 10193, 11380, 12104, 12867, 13494, 14189, 14989, 15647, 16457, 17181, 17281, 18106, 18813, 18913]","[0, 242, 653, 908, 1153, 1572, 1930, 2055, 2688, 2932, 3742, 4032, 4960, 5089, 5645, 6178, 6642, 7085, 7866, 8096, 8941, 9353, 10450, 11073, 11568, 12262, 12918, 13350, 13620, 14170, 14615, 14960, 15732, 16177, 16277]","[0, 169, 259, 396, 766, 926, 1155, 1371, 1507, 1861, 2053, 2195, 2453, 2548, 2643, 2997, 3454, 3549, 3734, 3964, 4058, 4153, 4730, 5049, 5143, 5928, 6059, 6240, 6944, 7385, 7830, 7930, 8408, 8618, 8932]","[0, 169, 259, 349, 439, 564, 793, 883, 1057, 1316, 1637, 1799, 2057, 2187, 2436, 2531, 2688, 2864, 3457, 3687, 3781, 4045, 4762, 4998, 5092, 5318, 5413, 5507, 5717, 6320, 6841, 6941, 7330, 7540, 7640]",26301,18913,16277,8932,7640,41,22,96,123,20,"[0, 171, 470, 748, 1248, 1628, 1879, 2290, 2724, 3411, 3885, 4417, 4849, 5481, 6292, 6895, 7816, 8738, 9617, 10435, 11300, 12532, 13339, 14043, 15584, 16164, 16730, 17565, 18015, 18561, 20376, 21177, 22190, 22649, 24537]","[2, 246, 615, 1379, 1667, 2084, 2441, 3041, 3730, 4342, 4955, 5414, 6075, 6263, 6873, 7685, 8298, 9062, 9889, 10565, 11517, 12348, 12928, 13762, 14677, 15380, 16339, 17094, 17865, 18726, 18912, 19312, 20796, 21434, 22858]","[0, 277, 554, 919, 1417, 1739, 2686, 3220, 3830, 4581, 4974, 5602, 6194, 6560, 6991, 7581, 8083, 8723, 9690, 10292, 11135, 11787, 11882, 12078, 12754, 13192, 14141, 14579, 14768, 14864, 15666, 16198, 16901, 17215, 18373]","[0, 169, 259, 396, 828, 918, 1384, 1655, 2125, 2583, 2743, 2921, 3234, 3533, 3968, 4254, 4430, 4802, 5492, 5928, 6299, 6547, 6642, 7385, 7881, 8139, 8531, 8635, 9340, 9562, 10706, 11483, 11871, 12557, 13626]","[2, 173, 297, 425, 585, 793, 1063, 1288, 1585, 2089, 2268, 2405, 2577, 2770, 2969, 3178, 3436, 3720, 4088, 4345, 4750, 5119, 5259, 5354, 5731, 5898, 6278, 6372, 6493, 6589, 7496, 7846, 8126, 8307, 8822]",24537,22858,18373,13626,8822,1764,-3945,-2096,-4694,-1182,-10153,35,dire
7538558409,138,29,19,64,45,"[0, 361, 601, 889, 1271, 1676, 1940, 2185, 2312, 2882, 3203, 3402, 4167, 4719, 5148, 5679, 6413, 6962, 7694, 7789, 8609, 9642, 11398, 11633, 12122, 12984, 13392, 14146, 14883, 15443, 16727, 17244, 17934, 18551, 18690]","[0, 454, 793, 990, 1524, 2073, 2613, 3207, 3588, 4065, 4665, 5273, 5616, 6135, 6617, 7531, 8003, 8371, 9064, 9340, 10047, 10332, 10553, 11447, 12235, 13173, 13268, 14027, 14123, 15268, 15712, 16854, 17163, 17527, 18048]","[0, 328, 659, 858, 1149, 1520, 1854, 2231, 2676, 3120, 3739, 4537, 4872, 5110, 5851, 6517, 6611, 7309, 7687, 7959, 8926, 9667, 10454, 11373, 12115, 12581, 12676, 13127, 13512, 14050, 14494, 14803, 15511, 15654, 17073]","[0, 287, 380, 470, 845, 1059, 1280, 1460, 1801, 2286, 2511, 3446, 3580, 3969, 4538, 5091, 5497, 6311, 6523, 6654, 6990, 7133, 7228, 7322, 7527, 7812, 7907, 8237, 8488, 8813, 9331, 10678, 11196, 11296, 11817]","[0, 210, 316, 406, 594, 775, 865, 1045, 1221, 1603, 2179, 2619, 2821, 3001, 3406, 3766, 3983, 4778, 5043, 5138, 6027, 6170, 6410, 7236, 7637, 8093, 8188, 8494, 8590, 9145, 9396, 9913, 10013, 10461, 10982]",18690,18048,17073,11817,10982,74,129,6,53,103,"[0, 166, 408, 846, 1125, 1532, 1890, 2285, 2587, 2888, 3049, 3283, 3658, 4087, 4721, 4816, 5700, 6280, 8390, 9171, 9617, 10753, 11578, 11842, 12975, 13436, 15418, 16255, 16695, 17746, 18629, 19207, 20132, 21094, 22731]","[0, 470, 630, 1001, 1295, 1421, 2137, 2709, 3183, 3463, 3955, 4620, 5243, 5624, 6431, 6736, 7143, 7398, 8317, 8933, 9282, 9827, 10323, 11107, 11979, 12596, 13428, 14085, 14763, 16403, 16849, 17427, 18376, 19394, 20563]","[0, 323, 691, 884, 1166, 1319, 1721, 1919, 2158, 2248, 2502, 2646, 3025, 3368, 3805, 4008, 4506, 4761, 5518, 6208, 6693, 7102, 7527, 8043, 8547, 9426, 9906, 11065, 12030, 12370, 13562, 14433, 15476, 16749, 18193]","[0, 202, 311, 431, 617, 955, 1277, 1552, 1732, 1872, 2604, 3115, 3465, 3865, 4159, 4920, 5014, 5374, 5885, 6954, 7224, 7962, 8960, 9224, 10021, 11300, 11959, 12493, 13148, 13592, 14227, 15109, 16387, 17007, 17399]","[0, 202, 292, 459, 549, 639, 1110, 1293, 1512, 1685, 1976, 2362, 2542, 2750, 2969, 3064, 3460, 3698, 4557, 5250, 5475, 6323, 6865, 7129, 7805, 8044, 8787, 9274, 9896, 10479, 10925, 11295, 11395, 11710, 12234]",22731,20563,18193,17399,12234,-4041,-2515,-1120,-5582,-1252,-14510,35,dire
7538571609,25,90,105,137,121,"[656, 1108, 1482, 1814, 1939, 2309, 2660, 3102, 3443, 3635, 4197, 4623, 5165, 5937, 6366, 6881, 8195, 8912, 9512, 10206, 10301, 11177, 11908, 12809, 13559, 13948, 14552, 15502, 15619, 15992, 17136, 18030, 18850, 20147, 21585]","[611, 858, 1228, 1600, 1777, 2041, 2775, 3245, 3475, 3655, 3896, 4670, 5034, 5705, 5905, 6240, 7367, 8014, 8516, 9079, 9744, 10270, 10744, 11444, 11914, 12178, 12410, 12668, 13375, 14055, 16393, 17030, 18026, 18162, 18951]","[639, 912, 1047, 1338, 1597, 1836, 2253, 2428, 2731, 2821, 3412, 3620, 4363, 4641, 5437, 5532, 6210, 6895, 7010, 7662, 8034, 8735, 9116, 9286, 9546, 9715, 9886, 10263, 11022, 11915, 14669, 14958, 15255, 15495, 16505]","[651, 1203, 1642, 1919, 2486, 3318, 3599, 4310, 4713, 4905, 5520, 5615, 6025, 6629, 7217, 7530, 8391, 8860, 8955, 9050, 9367, 9644, 9997, 10092, 10277, 10371, 10467, 10774, 10870, 11325, 11989, 12624, 12904, 13143, 13875]","[421, 719, 934, 1602, 2007, 2589, 2679, 2987, 3217, 3590, 3734, 4093, 4378, 4608, 4703, 5102, 6177, 6761, 6856, 6997, 7092, 7446, 7613, 7708, 7893, 7987, 8083, 8390, 8520, 8825, 9489, 9589, 10466, 11182, 11646]",21585,18951,16505,13875,11646,113,69,114,112,5,"[691, 1034, 1438, 1977, 2617, 3010, 3355, 3844, 4606, 5478, 5813, 6725, 7558, 8143, 9148, 9823, 10478, 11305, 12042, 13611, 14224, 14994, 15922, 16729, 17736, 18791, 19285, 20245, 21502, 22684, 23860, 23960, 25399, 25771, 26656]","[564, 885, 1144, 1781, 2289, 2608, 3379, 3946, 4694, 5089, 5707, 6312, 6627, 6948, 7528, 8333, 8758, 8931, 9488, 10274, 11045, 11442, 12040, 13308, 14223, 14855, 15147, 15748, 16513, 17297, 18489, 18936, 19510, 20125, 20835]","[578, 1079, 1367, 1966, 2198, 2596, 2903, 3098, 3451, 3905, 4210, 4622, 5082, 5400, 5648, 6268, 6363, 7071, 7248, 7886, 8373, 8885, 9136, 9586, 10490, 11167, 11308, 12032, 12482, 12939, 13284, 13384, 14351, 14461, 15073]","[360, 499, 589, 865, 1098, 1645, 1861, 2080, 2690, 3118, 3376, 3753, 4025, 4270, 4637, 4777, 5015, 5488, 5632, 7292, 7818, 8516, 9009, 9683, 10458, 11410, 11725, 12066, 12476, 13144, 13851, 13951, 14616, 14716, 14996]","[259, 469, 783, 1013, 1236, 1558, 1812, 1992, 2646, 2894, 3183, 3436, 3718, 3812, 4469, 4564, 4839, 5190, 5468, 5949, 6149, 6450, 6655, 7205, 7727, 8174, 8314, 8655, 9063, 9804, 10343, 10566, 10701, 11197, 12079]",26656,20835,15073,14996,12079,-5071,-1884,1432,-1121,-433,-7077,35,dire
7538639606,41,15,23,19,65,"[874, 1306, 1651, 2127, 2529, 2814, 3213, 3570, 4058, 4549, 4875, 5372, 5953, 6548, 7108, 7812, 9025, 9717, 10289, 10789, 11173, 12103, 13001, 13492, 13889, 14485, 15722, 16517, 18101, 18663, 19355, 20679, 21019, 21691, 21791]","[711, 934, 1333, 1554, 1920, 2338, 2896, 3352, 3770, 4365, 5107, 5662, 6481, 7238, 7500, 8325, 9284, 9814, 10493, 11092, 11632, 12052, 12653, 13398, 14204, 14677, 15895, 16596, 17775, 17965, 18775, 19266, 20150, 20710, 21532]","[1049, 1382, 1743, 2463, 2708, 3317, 3722, 4086, 4781, 5296, 5689, 6134, 6530, 6980, 7565, 7891, 8584, 8914, 9561, 9804, 10302, 10892, 11842, 12372, 13322, 14337, 15153, 15617, 16745, 17317, 18271, 18875, 19265, 20103, 20480]","[455, 692, 828, 918, 1089, 1179, 1324, 1420, 1596, 1849, 2276, 2625, 2779, 2874, 2968, 3232, 3814, 4296, 4476, 4678, 4951, 5237, 5650, 5831, 6243, 6420, 7168, 7285, 7813, 8324, 9006, 9196, 9541, 9775, 9875]","[460, 683, 1086, 1205, 1593, 1683, 1896, 2385, 2606, 2973, 3258, 3645, 3807, 4182, 4511, 5058, 5751, 6183, 6372, 6726, 7008, 7149, 7592, 7742, 7949, 8126, 8611, 8992, 9371, 9752, 9987, 10605, 10705, 11093, 11193]",21791,21532,20480,9875,11193,109,53,129,74,20,"[1257, 1467, 1825, 2667, 3178, 3661, 4031, 4838, 5514, 6062, 7086, 7716, 8603, 9428, 9821, 10626, 11575, 12613, 13591, 14390, 15181, 15999, 17474, 18721, 19631, 20352, 20565, 21460, 22050, 22348, 23291, 24492, 25897, 26816, 27710]","[641, 766, 1135, 1626, 2040, 2328, 2477, 3117, 3655, 3889, 4673, 5135, 5971, 6573, 7330, 7425, 7785, 8111, 8697, 9406, 9793, 10328, 10957, 11704, 11940, 12618, 13167, 13360, 14600, 15424, 16041, 16652, 17200, 18244, 19106]","[741, 1072, 1434, 1844, 2338, 2740, 3283, 3835, 4250, 5029, 5633, 6352, 6528, 6997, 7999, 8176, 8402, 9054, 9765, 10159, 10826, 11362, 12185, 12661, 12937, 13530, 14007, 14663, 15508, 16237, 16848, 17038, 17340, 18622, 19534]","[864, 1159, 1489, 1828, 2039, 2410, 2864, 3328, 3628, 3817, 4358, 4797, 5097, 5647, 5899, 6262, 6593, 6863, 7493, 7723, 8025, 8282, 8603, 8698, 8793, 9414, 9820, 10134, 10521, 11188, 11378, 11924, 12179, 12785, 13582]","[543, 704, 794, 1133, 1344, 1434, 1524, 1819, 1909, 2408, 2821, 2978, 3223, 3707, 3801, 3896, 4054, 4332, 4791, 5021, 5116, 5387, 5664, 5917, 6012, 6279, 6492, 6842, 7229, 7630, 7934, 8442, 8589, 8996, 9563]",27710,19106,19534,13582,9563,-5919,2426,946,-3707,1630,-4624,35,radiant
7538821104,76,137,29,114,102,"[0, 298, 512, 762, 1173, 1583, 1940, 2550, 2927, 3438, 3837, 4126, 4501, 5044, 5305, 5913, 6438, 7052, 7848, 8373, 8703, 9199, 9601, 9939, 10629, 11188, 11758, 13097, 13705, 14178, 14979, 15433, 16945, 17606, 18773]","[0, 283, 696, 873, 1229, 1409, 1620, 2066, 2746, 3095, 3849, 4298, 4828, 5278, 5373, 5796, 6571, 7106, 7625, 8503, 9195, 9994, 10089, 10286, 10913, 11517, 12280, 13888, 14065, 14504, 14836, 14936, 16182, 16788, 17722]","[0, 205, 499, 784, 1281, 1511, 1793, 2248, 2806, 3103, 3556, 3821, 4362, 4480, 4670, 4959, 5311, 5525, 5986, 6364, 6739, 7091, 7285, 7485, 7834, 8370, 8754, 9897, 10198, 10340, 10792, 10892, 11567, 11958, 12360]","[0, 170, 471, 803, 981, 1196, 1286, 1625, 1850, 1985, 2180, 2270, 2414, 2588, 2810, 3319, 3574, 4140, 4830, 4987, 5521, 5688, 5895, 5989, 6293, 6519, 6733, 7819, 8663, 9085, 9401, 9832, 10736, 11275, 11375]","[0, 170, 260, 350, 480, 649, 776, 1011, 1282, 1554, 1889, 2229, 2448, 2543, 2725, 2960, 3461, 3675, 3918, 4075, 4349, 4701, 4942, 5036, 5235, 5528, 5761, 6437, 6662, 6973, 7069, 7204, 8182, 8372, 9015]",18773,17722,12360,11375,9015,56,98,15,68,112,"[0, 349, 676, 1116, 1524, 1979, 2297, 2784, 3138, 3877, 4187, 4634, 5201, 6286, 6954, 7851, 8290, 9097, 9647, 10177, 10991, 11515, 12334, 13495, 14165, 14698, 15859, 16203, 16475, 17299, 17732, 18542, 19888, 20392, 21744]","[0, 505, 753, 1276, 1732, 2093, 2761, 3168, 3914, 4342, 4432, 5110, 5721, 6661, 7881, 8285, 8927, 9172, 9800, 10387, 11036, 12360, 12993, 13899, 14610, 16064, 16667, 17175, 17973, 18590, 19084, 19720, 20378, 21002, 21734]","[0, 205, 446, 766, 1011, 1336, 1638, 1911, 2209, 2430, 2882, 3299, 3827, 4372, 4942, 5397, 5906, 6458, 6998, 7619, 8642, 9839, 10620, 11454, 12196, 13091, 13986, 14208, 14715, 15374, 16103, 17136, 17589, 18866, 19732]","[0, 170, 260, 380, 519, 609, 747, 874, 964, 1054, 1369, 1505, 1773, 2362, 2793, 3189, 3346, 3569, 3794, 3888, 4371, 4989, 5281, 5817, 6056, 6496, 6806, 7104, 7319, 8082, 8291, 9063, 9514, 9704, 10183]","[0, 311, 401, 521, 611, 878, 1047, 1137, 1423, 1513, 1603, 2107, 2336, 2735, 3175, 3430, 4125, 4294, 4434, 4528, 4916, 5617, 5822, 6207, 6446, 6676, 7108, 7328, 7543, 7943, 8190, 8706, 9156, 9479, 10036]",21744,21734,19732,10183,10036,-2971,-4012,-7372,1192,-1021,-14184,35,dire
7538889304,98,21,46,53,110,"[0, 211, 533, 968, 1139, 1500, 1891, 2317, 2682, 3178, 3630, 4091, 4634, 5374, 5933, 6521, 7305, 7938, 8548, 9796, 10928, 11601, 12283, 12988, 13622, 13896, 15039, 15781, 16839, 17333, 18058, 19308, 20283, 21016, 21297]","[0, 329, 652, 972, 1316, 1749, 2206, 2674, 2936, 3546, 3927, 4406, 4999, 5684, 6074, 6546, 7061, 7599, 8451, 9330, 10109, 11041, 11226, 12484, 13492, 13805, 14565, 15340, 15981, 16533, 17549, 18204, 18853, 19660, 20726]","[0, 632, 950, 1373, 1829, 2196, 2743, 3243, 3765, 4311, 4943, 5033, 5866, 6595, 7181, 7648, 8148, 8386, 8481, 9493, 10340, 10768, 11725, 12439, 12767, 12862, 13394, 14254, 15155, 15765, 16561, 17589, 18382, 19330, 20059]","[0, 205, 347, 730, 854, 1081, 1264, 1562, 1922, 2081, 2171, 2671, 2874, 3350, 3651, 3898, 4310, 4691, 5001, 5833, 6540, 6919, 7587, 8018, 8759, 9071, 9786, 10087, 10661, 11153, 11312, 11675, 12253, 12624, 13072]","[0, 205, 295, 443, 669, 877, 1012, 1147, 1417, 1576, 1694, 1857, 2057, 2459, 2657, 2881, 3140, 3378, 3941, 4586, 4963, 5102, 5721, 6044, 6563, 6716, 7248, 7431, 7848, 7980, 8343, 8619, 8932, 9488, 9900]",21297,20726,20059,13072,9900,54,23,112,66,20,"[0, 284, 448, 721, 1037, 1366, 1765, 2295, 2699, 3105, 3614, 4360, 4837, 5401, 6114, 6791, 7627, 8473, 9351, 9702, 10671, 11174, 11450, 12548, 13159, 13367, 14377, 15587, 16239, 16859, 17857, 19261, 19907, 21015, 22013]","[0, 319, 671, 1002, 1217, 1580, 1973, 2452, 2889, 3388, 3925, 4548, 5105, 5724, 6147, 6795, 7398, 7900, 8188, 8798, 8892, 9414, 9700, 10105, 10686, 10781, 11869, 12482, 12844, 13182, 13528, 14196, 15052, 15234, 15632]","[0, 210, 444, 680, 971, 1184, 1486, 1656, 1988, 2795, 3299, 3389, 3856, 4408, 4915, 5446, 5837, 6098, 6631, 7068, 7221, 7833, 8193, 8821, 9217, 9478, 10106, 10950, 11419, 11808, 12246, 12946, 13556, 13882, 14374]","[0, 249, 367, 457, 547, 891, 1072, 1232, 1347, 1629, 2062, 2782, 3137, 3706, 4107, 4628, 5075, 5523, 5886, 6342, 6584, 7290, 7480, 7626, 7984, 8361, 9557, 10214, 10311, 10871, 11192, 11772, 12094, 12194, 12490]","[0, 210, 397, 487, 994, 1151, 1286, 1421, 1511, 1891, 2116, 2503, 2618, 2795, 3025, 3357, 3539, 3869, 4226, 4321, 4415, 4759, 4949, 5094, 5188, 5283, 5698, 5977, 6074, 6251, 6437, 6671, 6881, 6981, 7171]",22013,15632,14374,12490,7171,-716,5094,5685,582,2729,13374,35,radiant
7539188102,25,65,62,51,20,"[259, 496, 904, 1397, 1903, 2434, 2942, 3267, 3580, 3937, 4586, 5539, 6261, 6930, 7447, 8736, 9369, 10085, 10547, 11414, 11509, 12188, 12492, 13520, 13730, 13825, 14693, 15952, 16492, 17243, 18190, 19359, 21083, 21675, 23733]","[250, 483, 764, 932, 1314, 1728, 1863, 2438, 2746, 3609, 4267, 5084, 5695, 6210, 6903, 7787, 8257, 8781, 9144, 9698, 9922, 10570, 10982, 11944, 12601, 13393, 13924, 14596, 14822, 15443, 16075, 16314, 17890, 18924, 19556]","[249, 599, 897, 1344, 1688, 2134, 2410, 2954, 3445, 3778, 4292, 4928, 5289, 5780, 6165, 6915, 7154, 7285, 7415, 7528, 7939, 8320, 8552, 9025, 9600, 9729, 10014, 10624, 10830, 11432, 11748, 12018, 13112, 13510, 14396]","[170, 309, 748, 838, 992, 1204, 1387, 1560, 1770, 2118, 2362, 2615, 2854, 3021, 3370, 4043, 4238, 4459, 4579, 4788, 4982, 5261, 5657, 5827, 6639, 6943, 7112, 7358, 7619, 7983, 8348, 8665, 9343, 9658, 10526]","[170, 306, 449, 634, 771, 861, 996, 1144, 1281, 1524, 2006, 2366, 3083, 3461, 3758, 4134, 4369, 4775, 4888, 5367, 5537, 6100, 6305, 6493, 6828, 6998, 7216, 7684, 7855, 8107, 8357, 8552, 9258, 9648, 10230]",23733,19556,14396,10526,10230,67,98,106,79,72,"[241, 473, 769, 979, 1344, 1652, 2258, 2597, 3212, 3624, 4140, 4608, 4940, 5626, 6041, 6416, 7463, 8137, 8968, 9602, 10508, 11442, 12631, 12771, 13645, 14612, 15257, 16498, 16984, 17639, 18480, 19661, 20726, 21586, 22430]","[248, 452, 597, 1026, 1210, 1630, 2171, 2574, 2858, 3870, 4226, 4645, 5614, 6149, 6572, 7689, 8453, 9059, 10323, 10829, 12110, 12746, 13374, 14252, 15218, 16253, 16979, 17464, 18063, 18679, 19508, 20376, 21039, 21961, 22267]","[278, 565, 848, 1472, 1959, 2289, 2743, 3125, 4013, 4382, 4858, 5179, 5608, 5789, 6169, 6802, 7844, 8180, 8860, 9434, 10115, 11019, 11401, 11695, 12406, 13010, 13329, 13678, 13924, 14618, 15472, 16243, 16426, 16526, 17171]","[170, 260, 350, 440, 570, 660, 1123, 1231, 1391, 1661, 2312, 3003, 3250, 3621, 3994, 4713, 5115, 5655, 6636, 6946, 7424, 7828, 8329, 8499, 8939, 9190, 9613, 10274, 10543, 11062, 11519, 11958, 12133, 12651, 13098]","[170, 260, 397, 487, 695, 785, 1121, 1245, 1462, 1732, 1950, 2040, 2362, 2495, 2662, 2896, 3683, 4078, 4736, 5160, 5914, 6318, 7126, 7400, 7961, 8573, 9188, 9734, 10041, 10346, 10775, 11214, 11405, 11697, 12003]",22430,22267,17171,13098,12003,1303,-2711,-2775,-2572,-1773,-8528,35,dire
7539531110,25,15,28,20,100,"[0, 243, 651, 977, 1228, 1804, 2327, 2765, 3279, 3700, 4208, 4634, 5305, 5990, 6748, 7570, 8245, 9544, 10201, 10941, 12222, 13014, 14597, 14970, 15622, 16647, 17371, 17892, 18112, 18436, 19016, 19309, 19409, 21994, 23045]","[0, 211, 458, 704, 935, 1321, 1837, 2284, 3141, 3541, 4164, 4452, 5040, 5689, 6131, 6842, 7561, 8241, 8691, 9210, 9926, 10212, 10848, 11396, 12168, 12502, 12900, 13720, 14149, 14559, 14700, 14919, 15435, 16857, 17234]","[0, 277, 570, 936, 1352, 1870, 2122, 2822, 3057, 3756, 4360, 4700, 5234, 5704, 6147, 6633, 6890, 7314, 7798, 8190, 9000, 9574, 10044, 10777, 11446, 11888, 12576, 12996, 13284, 13455, 13855, 14015, 14115, 14422, 14718]","[0, 130, 676, 810, 900, 1254, 1455, 1545, 1707, 1918, 2098, 2188, 2393, 2890, 3148, 3362, 3779, 4248, 4784, 5149, 5788, 5903, 6447, 6675, 7279, 7536, 7742, 8009, 8440, 8658, 8967, 9103, 9203, 10499, 10996]","[0, 130, 220, 310, 400, 525, 749, 883, 1143, 1471, 1651, 1780, 2015, 2164, 2387, 2533, 2914, 3312, 3592, 4175, 4559, 4670, 4909, 5136, 5478, 5573, 5749, 5924, 6106, 6323, 6419, 6519, 6703, 7427, 7851]",23045,17234,14718,10996,7851,95,38,106,69,110,"[0, 290, 560, 950, 1079, 1277, 1599, 1959, 2049, 2586, 3087, 3774, 4402, 5052, 5616, 6607, 7518, 8307, 8949, 9625, 10335, 11372, 12339, 13110, 14313, 15119, 16315, 17024, 18189, 18786, 20193, 22162, 24186, 25537, 26531]","[0, 244, 410, 799, 1177, 1314, 1632, 2026, 2567, 2970, 3832, 4380, 4834, 5235, 5762, 6299, 6827, 7133, 7486, 8170, 8939, 9382, 9972, 10523, 11084, 11745, 12146, 12389, 12725, 13155, 13741, 14949, 16330, 17235, 17748]","[0, 286, 558, 994, 1317, 1514, 1919, 2337, 2972, 3062, 3678, 4140, 4382, 4751, 5212, 5756, 6291, 6582, 6862, 7649, 8455, 9065, 9644, 10131, 10812, 11231, 11756, 12255, 12586, 13033, 13829, 14803, 16113, 17059, 17769]","[100, 310, 450, 588, 678, 838, 991, 1197, 1337, 1473, 1884, 2129, 2418, 2624, 2782, 3277, 3932, 4047, 4292, 4572, 4912, 5106, 5550, 5879, 6145, 6605, 6910, 7239, 7635, 8842, 9493, 10538, 11882, 12522, 12852]","[0, 210, 336, 426, 562, 652, 823, 1003, 1183, 1273, 1850, 2042, 2539, 2738, 2833, 3230, 3922, 4216, 4733, 5219, 5404, 5499, 5875, 6269, 6445, 6679, 7060, 7433, 7765, 7981, 8784, 9982, 11621, 12381, 12661]",26531,17748,17769,12852,12661,-3486,-514,-3051,-1856,-4810,-13717,35,dire
7539558016,109,69,106,105,20,"[282, 605, 1152, 1450, 1865, 2364, 2730, 3244, 3633, 4113, 4703, 5246, 6083, 6857, 7332, 8309, 8840, 9422, 10311, 11206, 12095, 13032, 14031, 14773, 16569, 17660, 19113, 20079, 20545, 21138, 22102, 22202, 23716, 24596, 26474]","[241, 519, 728, 1039, 1242, 1672, 2197, 2776, 3217, 3679, 4215, 5004, 6003, 6428, 6924, 7748, 8237, 9216, 9777, 10409, 11359, 12311, 13029, 13429, 14239, 15396, 16106, 16464, 17183, 17341, 18106, 19266, 20327, 21268, 22920]","[248, 603, 970, 1292, 1544, 1933, 2280, 2731, 3185, 3607, 4072, 4566, 5126, 5722, 6427, 7485, 8044, 8649, 9309, 10105, 10596, 11187, 11620, 12461, 13078, 13708, 14458, 14936, 15550, 15646, 16010, 17654, 18397, 19331, 20368]","[207, 297, 387, 517, 607, 914, 1356, 1446, 1536, 1789, 1963, 2131, 2577, 2967, 3105, 3403, 3815, 4280, 4670, 5045, 5367, 5828, 6069, 6509, 7155, 7437, 7738, 7909, 8488, 8659, 9039, 9543, 10285, 10834, 11224]","[219, 309, 708, 910, 1046, 1276, 1415, 1522, 1612, 1918, 2149, 2482, 2848, 3029, 3268, 3528, 3704, 3799, 4219, 4467, 4661, 4802, 4968, 5124, 5497, 5788, 6199, 6340, 6582, 6749, 7113, 7213, 7486, 7676, 8428]",26474,22920,20368,11224,8428,94,120,28,65,110,"[219, 505, 916, 1318, 1684, 2062, 2705, 3266, 3910, 4400, 5296, 5944, 6620, 7446, 8000, 8815, 9859, 10674, 11101, 11517, 12137, 12868, 13680, 14499, 15310, 15917, 17149, 18201, 19444, 20481, 22219, 23169, 23738, 25206, 26167]","[219, 452, 785, 1166, 1422, 1828, 2364, 2702, 2965, 3333, 3691, 4174, 4323, 5239, 5914, 6543, 7146, 7811, 8066, 8828, 9111, 9741, 10109, 10877, 11268, 11918, 12503, 12929, 14625, 15884, 16544, 16998, 17764, 18099, 18564]","[281, 371, 721, 980, 1226, 1443, 1820, 2042, 2276, 2795, 3191, 3870, 4410, 5034, 5519, 5839, 6159, 6683, 7116, 7397, 7844, 8392, 8736, 9227, 9683, 10017, 10192, 10591, 11702, 12522, 13597, 13863, 14313, 14548, 15151]","[169, 259, 525, 690, 815, 949, 1084, 1421, 1511, 1601, 1896, 2203, 2451, 2712, 2883, 3545, 4116, 4783, 5319, 5574, 6006, 6395, 6763, 7184, 7694, 7971, 8308, 8658, 9859, 10118, 10552, 10788, 11255, 11626, 12318]","[169, 274, 444, 857, 991, 1081, 1459, 1594, 1684, 1823, 2117, 2347, 2888, 3197, 3410, 3677, 3965, 4347, 4580, 4837, 5279, 5758, 5932, 6117, 6212, 6525, 6700, 6967, 7832, 8266, 9043, 9143, 9243, 9478, 10000]",26167,18564,15151,12318,10000,307,4356,5217,-1094,-1572,7214,35,radiant
7540018616,10,120,60,21,102,"[526, 733, 1003, 1254, 1838, 2348, 2911, 3261, 3858, 4265, 4895, 5551, 5950, 6221, 6586, 7242, 7829, 8292, 8881, 9609, 10471, 11141, 12223, 12816, 13344, 14886, 15577, 15819, 16158, 16392, 16902, 17002, 17454, 17923, 18513]","[465, 769, 1015, 1518, 1679, 1990, 2434, 2726, 3391, 3747, 3977, 4545, 4640, 4992, 5649, 6258, 6629, 7536, 8499, 9128, 9800, 9894, 10450, 11160, 11657, 12583, 13453, 14362, 14668, 15092, 15382, 15975, 16890, 17224, 17759]","[408, 695, 785, 1084, 1595, 1964, 2737, 3020, 3619, 3923, 4172, 4715, 5161, 5386, 5618, 5964, 6423, 7021, 7793, 8062, 8866, 9209, 9864, 10267, 10716, 11692, 12182, 12839, 12935, 13035, 13292, 13466, 14321, 14578, 14990]","[262, 352, 442, 532, 972, 1107, 1304, 1464, 1835, 1925, 2223, 2561, 2656, 2804, 3087, 3354, 3763, 4128, 4571, 4791, 5229, 5611, 6216, 6958, 7088, 7927, 8263, 8359, 8611, 8931, 9188, 9434, 9754, 9902, 10231]","[323, 448, 577, 751, 841, 976, 1173, 1398, 1977, 2067, 2304, 2529, 2624, 2893, 2988, 3083, 3178, 3335, 3959, 4099, 4356, 4499, 5181, 5884, 5979, 6570, 6804, 6900, 7032, 7168, 7875, 7975, 8222, 8665, 8765]",18513,17759,14990,10231,8765,49,6,96,65,86,"[693, 1101, 1571, 1854, 2364, 3028, 3554, 3975, 4308, 4675, 5500, 6041, 6722, 6989, 8174, 8577, 9604, 10251, 11004, 11547, 12341, 13292, 13913, 14008, 15560, 15827, 16509, 17559, 18406, 19883, 21024, 21849, 22899, 24042, 25402]","[504, 628, 1288, 1871, 2189, 2435, 2762, 3243, 3885, 4462, 5289, 5811, 6554, 7127, 7925, 8832, 9609, 10420, 11128, 11888, 12980, 13678, 14011, 14875, 15875, 16276, 16879, 18071, 18870, 19455, 20374, 21187, 22358, 22859, 25011]","[553, 960, 1197, 1601, 1822, 2311, 2922, 3555, 3855, 4287, 4864, 5392, 5817, 6168, 7005, 7495, 8003, 8700, 9424, 10112, 10736, 11897, 12324, 12788, 13348, 13442, 13915, 14604, 15262, 15893, 16885, 17796, 18313, 18737, 20055]","[299, 433, 912, 1217, 1569, 1762, 1852, 2117, 2343, 2792, 3327, 3863, 4569, 5039, 5618, 6274, 6707, 7115, 7320, 7803, 8267, 8550, 8710, 8853, 9228, 9322, 9709, 10445, 10918, 11603, 12214, 12624, 13074, 13692, 14863]","[331, 467, 692, 871, 1006, 1264, 1354, 1604, 1992, 2281, 2659, 3321, 3963, 4322, 4765, 4904, 5189, 5436, 5682, 5812, 6459, 6703, 6970, 7160, 7658, 7771, 7948, 8493, 8971, 9406, 10018, 10532, 11064, 11499, 11844]",25402,25011,20055,14863,11844,-6889,-7252,-5065,-4632,-3079,-26917,35,dire
7540116814,70,21,96,53,26,"[624, 752, 1079, 1537, 1984, 2418, 3111, 3370, 3830, 4345, 4799, 5247, 5924, 6179, 6875, 7831, 8354, 8623, 9397, 10306, 11204, 11834, 12596, 13278, 14186, 15019, 15624, 16918, 17569, 18025, 18603, 20560, 21536, 21833, 22718]","[664, 911, 1245, 1696, 2194, 2701, 3378, 3468, 4140, 4959, 5274, 5907, 6293, 6719, 7477, 7656, 8081, 8616, 9081, 9605, 10328, 11088, 11337, 11909, 12739, 13321, 14268, 14894, 15205, 15849, 16231, 16444, 17126, 17226, 17646]","[839, 1072, 1432, 1813, 2239, 2704, 3048, 3309, 3812, 4467, 4937, 5534, 5928, 6360, 7159, 7618, 8169, 8586, 9653, 10213, 10914, 11171, 11511, 12091, 12333, 12428, 12836, 13422, 14279, 14822, 15453, 17092, 17619, 17719, 18017]","[387, 523, 673, 921, 1011, 1300, 1574, 1740, 2017, 2485, 2710, 2978, 3807, 4043, 4724, 4864, 5453, 5548, 6331, 6614, 7307, 7770, 8217, 8494, 8625, 9280, 10270, 10969, 11200, 11788, 12494, 12978, 13965, 14065, 14363]","[694, 927, 1017, 1196, 1286, 1636, 1909, 2171, 2655, 2858, 2948, 3144, 3569, 4012, 4387, 4591, 4803, 4898, 5303, 5889, 6307, 6780, 6950, 7120, 7289, 7459, 7942, 8223, 8529, 8884, 9374, 10283, 10635, 10810, 11183]",22718,17646,18017,14363,11183,41,120,14,119,20,"[577, 912, 1235, 1402, 1897, 2361, 2769, 3449, 3668, 4050, 4325, 4711, 5198, 5599, 5884, 6780, 7209, 8086, 9153, 9413, 10685, 11573, 12162, 12772, 13811, 15128, 16103, 16595, 16733, 17491, 19211, 19495, 19595, 22053, 23208]","[1093, 1344, 1754, 2081, 2398, 3059, 3536, 4254, 4849, 5521, 5718, 6210, 6736, 7270, 8066, 8630, 9676, 10065, 10640, 11341, 12221, 12757, 13522, 13782, 14473, 15450, 16419, 16784, 17550, 17775, 18904, 19327, 20021, 22092, 23293]","[474, 919, 1208, 1684, 1842, 2003, 2244, 2431, 2785, 3133, 3658, 3875, 4702, 5430, 6230, 6451, 6783, 7609, 8356, 8502, 9202, 9297, 9943, 10154, 11070, 12148, 12615, 12870, 12969, 13069, 13725, 13825, 13925, 15371, 16422]","[598, 766, 856, 946, 1036, 1248, 1699, 1871, 2184, 2477, 2686, 3007, 3773, 3921, 4252, 4392, 4924, 5368, 5463, 5671, 6060, 6234, 6494, 6861, 7403, 7809, 8323, 8653, 8909, 9084, 10155, 10312, 10724, 12042, 12823]","[465, 631, 982, 1105, 1195, 1484, 1771, 2002, 2230, 2477, 2663, 2913, 3277, 3471, 3765, 4072, 4431, 4661, 5060, 5355, 5873, 6087, 6372, 6797, 7307, 8021, 8404, 8561, 9046, 9221, 9782, 9957, 10130, 11354, 11826]",23208,23293,16422,12823,11826,-490,-5647,1595,1540,-643,-3645,35,dire
7540691210,73,61,23,112,65,"[0, 302, 841, 1107, 1453, 1792, 2302, 2870, 3006, 3154, 3630, 4319, 5064, 5993, 6877, 7776, 8778, 9770, 11252, 12540, 13536, 14671, 16076, 18086, 19465, 21500, 22715, 23846, 25253, 26570, 27397, 28212, 29607, 29927, 31501]","[0, 213, 362, 652, 742, 1056, 1363, 1934, 2489, 2919, 3527, 4373, 5154, 5897, 6236, 6709, 7563, 8510, 8605, 9251, 10853, 11837, 13592, 14279, 15357, 16243, 17060, 17645, 18791, 19622, 20172, 20952, 21142, 21440, 22903]","[0, 288, 669, 950, 1198, 1541, 1934, 2588, 2914, 3331, 3672, 4054, 4625, 5320, 6002, 6097, 6581, 7362, 7648, 8328, 8791, 8969, 9539, 9872, 10577, 11386, 11891, 12760, 13221, 13712, 14059, 14666, 14856, 14956, 16474]","[0, 129, 376, 702, 886, 1072, 1438, 1637, 1764, 2537, 2717, 3053, 3276, 3533, 3770, 3963, 4508, 4859, 5008, 5508, 5971, 6354, 6924, 7073, 7243, 7982, 8280, 8531, 8783, 9358, 9688, 9950, 10308, 11033, 11871]","[0, 129, 244, 378, 468, 654, 863, 1043, 1182, 1491, 1821, 2072, 2197, 2454, 2749, 3044, 3524, 3993, 4301, 4867, 5330, 5519, 6111, 6205, 6839, 7528, 7703, 8129, 8570, 9234, 9376, 10009, 10433, 10533, 11436]",31501,22903,16474,11871,11436,53,135,69,26,20,"[0, 291, 555, 965, 1448, 2207, 2603, 3048, 3907, 4396, 5135, 5528, 5939, 6535, 7099, 7541, 8496, 9473, 10323, 10885, 11909, 12008, 13019, 13747, 14520, 14980, 15787, 16753, 17289, 17972, 18720, 19550, 20545, 21411, 21844]","[0, 372, 688, 989, 1405, 1818, 2382, 2683, 3199, 3597, 4549, 5215, 5896, 6438, 6982, 7382, 8038, 8699, 9363, 10047, 10493, 11318, 11791, 12187, 12832, 13502, 14142, 15182, 15767, 16354, 16614, 17477, 18653, 19093, 19331]","[0, 314, 810, 1115, 1493, 2104, 2536, 2969, 3457, 3735, 4708, 5092, 5383, 5998, 6690, 6997, 7621, 8395, 9069, 9248, 10378, 10842, 11930, 12431, 12812, 13067, 13274, 13679, 13907, 14222, 14682, 16428, 17215, 17730, 18068]","[0, 209, 715, 892, 1056, 1267, 1402, 1538, 1858, 2012, 2580, 2670, 2760, 3054, 3207, 3355, 3673, 3774, 4112, 4242, 4876, 4973, 5324, 5437, 5916, 6011, 6117, 6851, 6947, 7043, 7139, 7572, 8010, 8110, 8210]","[0, 209, 324, 447, 665, 962, 1184, 1399, 1723, 1985, 2636, 2930, 3097, 3534, 3689, 3999, 4379, 4480, 4692, 4786, 5147, 5312, 5407, 5535, 5923, 6018, 6157, 6652, 6783, 7047, 7304, 7627, 8065, 8244, 8344]",21844,19331,18068,8210,8344,9657,3572,-1594,3661,3092,18388,35,radiant
7540902013,72,108,106,20,26,"[0, 580, 908, 1309, 1725, 2168, 2796, 3207, 4013, 4515, 4991, 5982, 6454, 7199, 7968, 8660, 9293, 10027, 10780, 10874, 11765, 12747, 13442, 14347, 15167, 15709, 16810, 17950, 18573, 19286, 20194, 20998, 21613, 23508, 24232]","[0, 220, 537, 855, 1236, 1656, 1980, 2565, 3312, 3889, 4147, 4674, 4899, 5533, 6081, 6448, 6898, 7489, 7669, 7889, 8115, 8876, 9454, 9841, 10301, 10396, 10724, 11249, 11875, 12314, 12581, 13174, 13458, 14735, 15695]","[0, 241, 526, 973, 1262, 1607, 2160, 2639, 3144, 3496, 3881, 4398, 4692, 5325, 5884, 6289, 6943, 7301, 7396, 7747, 8226, 8672, 9133, 9425, 10144, 10325, 10703, 11020, 11116, 11670, 12441, 13000, 13398, 14283, 14642]","[0, 239, 346, 480, 618, 769, 925, 1098, 1445, 1660, 1800, 2355, 2867, 3090, 3559, 3750, 3996, 4140, 4284, 4378, 4733, 4990, 5304, 5399, 6014, 6388, 6526, 6674, 6936, 7245, 7375, 7613, 7723, 8352, 8773]","[0, 169, 356, 446, 581, 716, 1020, 1223, 1565, 1705, 1910, 2246, 2551, 2793, 3084, 3503, 3852, 3993, 4116, 4226, 4321, 4506, 4672, 4878, 5742, 5837, 5966, 6135, 6249, 6345, 6441, 6631, 6731, 7326, 7685]",24232,15695,14642,8773,7685,23,25,69,83,121,"[0, 290, 628, 1020, 1316, 1834, 2304, 2758, 3496, 3950, 4757, 5253, 6005, 6455, 7031, 7584, 8362, 8970, 9600, 10519, 11488, 12076, 12666, 13770, 14436, 14864, 15703, 16251, 16835, 17478, 17902, 18221, 18631, 19991, 20604]","[0, 217, 648, 776, 900, 1272, 1689, 1929, 2131, 2384, 2904, 3310, 3918, 4414, 5101, 5688, 6276, 6840, 7204, 8597, 9257, 9648, 10132, 10847, 11869, 13449, 13712, 14346, 14973, 15515, 15854, 16867, 17184, 18062, 18517]","[0, 169, 474, 845, 1025, 1233, 1363, 1662, 1880, 2669, 3224, 3493, 4019, 4355, 4980, 5587, 6765, 7203, 7322, 8275, 8871, 9360, 9749, 9981, 10726, 11475, 12124, 12494, 13046, 13494, 13848, 14315, 14586, 15543, 16218]","[0, 169, 289, 379, 488, 703, 793, 1100, 1488, 1775, 2269, 2413, 2963, 3260, 3570, 3664, 4228, 4372, 4637, 5350, 5580, 5764, 5993, 6206, 6867, 7617, 7711, 7842, 8019, 8409, 8505, 8740, 8942, 9649, 9948]","[0, 169, 289, 596, 738, 955, 1235, 1370, 1597, 1886, 2264, 2437, 2846, 3131, 3392, 3658, 3906, 4046, 4207, 5037, 5483, 5848, 6077, 6244, 6496, 7056, 7196, 7433, 7682, 7896, 7992, 8227, 8750, 9642, 10050]",20604,18517,16218,9948,10050,3628,-2822,-1576,-1175,-2365,-4310,35,dire
7540945015,46,32,129,20,21,"[286, 538, 839, 1264, 1655, 2031, 2241, 3223, 3752, 4452, 5047, 5787, 6824, 7491, 8019, 8427, 10023, 10793, 11678, 12298, 13148, 14754, 15670, 16649, 17532, 18824, 19287, 19987, 20083, 21352, 22143, 23085, 24057, 24744, 25516]","[332, 847, 1130, 1423, 1791, 2173, 2618, 2915, 3236, 3763, 4096, 4535, 4997, 5309, 5991, 6462, 7466, 8199, 8842, 9876, 10048, 10741, 11546, 12136, 12603, 13124, 13716, 14839, 15357, 16270, 17083, 17877, 18460, 19131, 19535]","[246, 455, 621, 783, 1075, 1476, 1861, 2182, 2462, 2972, 3457, 3916, 4588, 5300, 5395, 5610, 6240, 6713, 7114, 7426, 7560, 8224, 9070, 9616, 9782, 10877, 11526, 11837, 12234, 12501, 12691, 12791, 13133, 13497, 13696]","[310, 841, 993, 1169, 1295, 1433, 1603, 1870, 2148, 2411, 2663, 2790, 3159, 3539, 3790, 3885, 4848, 4942, 5343, 5598, 5768, 6695, 7248, 7575, 7899, 8956, 9244, 9626, 10156, 10728, 11105, 11249, 11349, 11504, 11653]","[260, 393, 535, 625, 762, 852, 988, 1170, 1296, 1386, 1853, 2067, 2448, 2722, 3307, 3591, 4075, 4169, 4570, 4960, 5075, 6688, 7251, 7504, 7711, 8301, 8769, 9433, 9576, 9843, 10306, 11082, 11407, 11507, 11678]",25516,19535,13696,11653,11678,10,23,112,58,100,"[285, 520, 849, 1376, 1718, 2134, 2532, 3076, 3738, 4373, 4779, 5218, 5930, 6462, 7470, 8642, 8957, 9915, 10840, 11896, 13000, 13715, 14333, 14946, 15766, 16148, 16855, 18332, 18995, 20204, 21266, 23077, 24366, 24742, 25502]","[168, 487, 812, 1246, 1537, 2007, 2439, 3025, 3470, 4161, 4750, 5355, 5546, 6383, 7343, 8127, 8222, 8847, 9333, 9850, 10480, 10983, 11078, 11260, 11533, 11740, 12441, 12938, 13338, 14212, 14975, 15701, 16470, 16570, 16832]","[201, 397, 666, 831, 1327, 1738, 1980, 2435, 2653, 3005, 3528, 3919, 4259, 4701, 5123, 5512, 5663, 6091, 6785, 6880, 7366, 8224, 8723, 9000, 9377, 9472, 9772, 9868, 10212, 11115, 11639, 12242, 12768, 13115, 13585]","[130, 268, 388, 612, 781, 883, 1106, 1353, 1570, 1965, 2315, 2607, 2716, 2869, 3224, 3613, 3708, 3993, 4560, 4975, 5769, 6025, 6370, 6488, 6908, 7395, 7908, 8409, 8788, 9504, 10314, 10874, 11207, 11522, 11851]","[130, 220, 443, 573, 703, 793, 1181, 1271, 1659, 2201, 2726, 2870, 3164, 3426, 3848, 4237, 4332, 4552, 4861, 5283, 5783, 6039, 6134, 6359, 6525, 6620, 6940, 7733, 7829, 8420, 8879, 9298, 9580, 9680, 9870]",25502,16832,13585,11851,9870,14,2703,111,-198,1808,4438,35,radiant
7541057003,73,19,129,123,105,"[60, 445, 821, 995, 1665, 2324, 3031, 3575, 4042, 4854, 5605, 6350, 7115, 8577, 9998, 11307, 12602, 12885, 13748, 14837, 15582, 16605, 17597, 18688, 19475, 20375, 21535, 22557, 23747, 24668, 25985, 27404, 28641, 31348, 32503]","[58, 304, 594, 1000, 1497, 1886, 2219, 2806, 3211, 3790, 4592, 5063, 5660, 6252, 6828, 7052, 7531, 8309, 9331, 9786, 10010, 10285, 10641, 11335, 11685, 13282, 13678, 14710, 15450, 15546, 16796, 17195, 17712, 19494, 19958]","[58, 301, 623, 938, 1186, 1484, 1862, 2118, 2779, 2988, 3385, 3908, 4072, 4468, 5048, 5142, 5733, 6635, 7177, 8193, 8417, 8957, 9484, 9909, 10503, 11124, 11833, 12455, 12805, 12901, 13378, 14225, 15225, 16978, 17777]","[58, 271, 552, 686, 829, 919, 1130, 1306, 1494, 1703, 2109, 2335, 2870, 3238, 3955, 4289, 4691, 5223, 5691, 6260, 6879, 7076, 7504, 7909, 8416, 9013, 9311, 10360, 10700, 10956, 11588, 12728, 13543, 15107, 16214]","[426, 596, 878, 1019, 1149, 1362, 1790, 2130, 2448, 2670, 2934, 3281, 3405, 3545, 4263, 4440, 4856, 5079, 5513, 6360, 6455, 6550, 6677, 7590, 7801, 8465, 9416, 9749, 10109, 10387, 11234, 11708, 12008, 13163, 13925]",32503,19958,17777,16214,13925,10,96,53,106,72,"[0, 208, 483, 801, 1115, 1397, 2062, 2509, 2834, 3152, 3844, 4252, 4776, 5693, 6688, 7560, 8455, 9188, 9644, 9863, 10679, 10930, 11705, 12175, 13031, 13236, 13331, 13425, 13856, 15490, 15884, 16257, 16752, 16890, 16990]","[0, 170, 369, 725, 1244, 1603, 1927, 2134, 2738, 3122, 3778, 4050, 4671, 5311, 5685, 6168, 7006, 7327, 7996, 8274, 8730, 9003, 9868, 10447, 10752, 11415, 12083, 12498, 12761, 13821, 13917, 14290, 14748, 14848, 16191]","[0, 170, 296, 672, 1076, 1447, 1537, 1939, 2313, 2458, 3052, 3188, 3973, 4754, 5163, 5603, 6217, 6487, 7163, 7971, 8710, 8898, 9488, 9728, 10114, 10613, 11009, 11430, 11830, 13416, 13982, 14172, 14764, 14864, 16167]","[0, 244, 494, 899, 1271, 1722, 2055, 2289, 2957, 3202, 3636, 4146, 4533, 5079, 5626, 5985, 6605, 6700, 7014, 7376, 8203, 8431, 8794, 9093, 9343, 9741, 9969, 10430, 10564, 11602, 11895, 12529, 13028, 13128, 13286]","[0, 213, 303, 526, 663, 786, 984, 1074, 1283, 1693, 2044, 2339, 2596, 2889, 3334, 3822, 4702, 4941, 5114, 5208, 6171, 6657, 7098, 7327, 7859, 8263, 8579, 8785, 9088, 9966, 10540, 10913, 11013, 11113, 12634]",16990,16191,16167,13286,12634,15513,3767,1610,2928,1291,25109,35,radiant
7541497612,48,120,15,100,26,"[1, 296, 533, 1069, 1659, 1907, 2405, 2918, 3350, 3921, 4555, 4940, 5828, 6561, 7331, 7846, 8531, 9174, 10110, 11499, 12136, 13108, 14002, 15206, 16207, 16920, 18298, 19046, 20577, 21857, 22949, 23732, 24562, 25244, 26982]","[1, 255, 544, 802, 1289, 1787, 2045, 2723, 3115, 3697, 4207, 4560, 5402, 5929, 6794, 7294, 8281, 8804, 9607, 10620, 11130, 11973, 12633, 13590, 14224, 14506, 15560, 15990, 17182, 18068, 18868, 19964, 20568, 21101, 22139]","[1, 290, 534, 973, 1450, 1697, 2384, 2869, 3438, 3712, 4615, 5005, 5390, 5801, 6412, 7018, 7624, 8137, 8592, 9454, 9916, 10644, 11165, 12056, 12533, 12943, 14038, 14720, 15885, 16859, 17058, 17734, 17969, 18525, 19306]","[1, 171, 261, 424, 648, 784, 1053, 1262, 1442, 1532, 1994, 2123, 2495, 2917, 3214, 3466, 4006, 4379, 4697, 5025, 5299, 5429, 5706, 6496, 6748, 7069, 7553, 7764, 8396, 9188, 9700, 10426, 10661, 11334, 12038]","[1, 171, 261, 644, 818, 908, 1090, 1452, 1542, 1709, 2013, 2268, 2571, 2737, 3240, 3494, 4070, 4491, 4990, 5889, 6118, 6257, 6534, 6945, 7149, 7244, 7420, 7515, 7611, 8158, 8517, 8797, 9032, 9626, 10208]",26982,22139,19306,12038,10208,95,106,20,86,40,"[1, 288, 529, 1031, 1403, 1613, 1943, 2278, 2640, 3307, 4017, 4669, 5889, 6457, 7326, 8438, 9421, 10113, 11530, 12259, 12785, 13817, 14452, 15331, 15737, 16381, 17074, 17430, 17526, 17622, 17883, 17983, 18083, 18349, 18449]","[1, 368, 704, 1073, 1478, 1860, 2381, 2806, 3138, 3440, 3919, 4404, 4938, 5477, 5785, 6228, 6385, 6838, 7434, 7631, 7964, 8581, 9006, 9405, 9970, 10101, 10780, 11422, 12043, 12260, 13057, 13589, 14100, 14542, 14698]","[1, 207, 443, 745, 1023, 1268, 1531, 1750, 2344, 2934, 3473, 3941, 4132, 4744, 5033, 5466, 6022, 6732, 7105, 7348, 7790, 8404, 9103, 9296, 9521, 9616, 10173, 10566, 10771, 11270, 11743, 12039, 12293, 12393, 12493]","[1, 171, 296, 823, 913, 1003, 1093, 1228, 1374, 1650, 2099, 2323, 2773, 3019, 3345, 3718, 3971, 4066, 4259, 4454, 4643, 4944, 5479, 5808, 6066, 6330, 6837, 7051, 7222, 7623, 8052, 8280, 8616, 8791, 8991]","[1, 171, 261, 506, 613, 703, 793, 1024, 1291, 1531, 1846, 2207, 2620, 2850, 3047, 3222, 3613, 3708, 3803, 3961, 4440, 4719, 5144, 5430, 5524, 5710, 6135, 6230, 6562, 6817, 7179, 7334, 7459, 8003, 8268]",18449,14698,12493,8991,8268,8533,7441,6813,3047,1940,27774,35,radiant
7541527708,48,28,135,110,20,"[0, 168, 616, 1012, 1347, 1675, 1915, 2399, 2663, 3082, 3381, 3819, 4524, 5101, 5724, 6337, 6749, 7697, 8468, 9587, 10507, 11589, 12896, 13569, 14207, 15785, 16644, 17385, 18378, 18863, 19539, 20580, 21867, 23083, 23784]","[0, 214, 498, 856, 1156, 1428, 1909, 2380, 2877, 3471, 4091, 4401, 4974, 5524, 5811, 6377, 6852, 7455, 8470, 9035, 9986, 10562, 11211, 11631, 12418, 13134, 13521, 14061, 14568, 15439, 16274, 17685, 18507, 18607, 19345]","[0, 208, 458, 735, 1027, 1237, 1364, 1870, 2068, 2745, 3205, 4055, 4696, 5315, 5619, 6176, 6756, 7428, 7949, 8350, 9671, 10165, 10449, 10944, 11759, 12687, 13230, 14236, 14850, 15036, 15672, 16583, 17417, 17517, 17756]","[0, 129, 219, 339, 526, 637, 817, 997, 1181, 1361, 1778, 2175, 2869, 3389, 3598, 4015, 4196, 4426, 4758, 5374, 5683, 5945, 6639, 7250, 7724, 8109, 8403, 8774, 8951, 9203, 9566, 10428, 11019, 11364, 12120]","[0, 175, 265, 418, 916, 1288, 1479, 1659, 1890, 2070, 2391, 2960, 3121, 3270, 3365, 3459, 3658, 3951, 4344, 4934, 5442, 5582, 5814, 6487, 6885, 7294, 7389, 7861, 8482, 9028, 9541, 10413, 10962, 11331, 11537]",23784,19345,17756,12120,11537,95,69,25,19,31,"[0, 255, 683, 944, 1176, 1615, 1892, 2291, 2652, 3032, 3670, 4077, 4507, 4889, 5393, 5955, 6736, 7138, 7925, 8522, 9281, 10051, 10826, 11792, 12652, 13455, 14009, 14604, 15570, 16621, 17358, 18225, 20451, 20551, 21604]","[0, 278, 625, 1082, 1406, 2260, 2628, 3126, 3769, 4459, 5024, 5659, 6172, 6940, 7539, 8509, 9553, 10287, 10866, 11596, 12298, 13052, 13938, 14755, 15439, 16292, 17219, 17843, 18274, 19177, 20159, 20854, 22455, 23282, 24132]","[0, 368, 714, 1119, 1487, 1857, 2378, 2924, 3424, 4047, 4547, 4956, 5659, 6085, 6929, 7707, 8160, 8673, 9620, 9942, 10313, 10778, 11758, 12223, 12526, 13053, 13255, 13581, 14254, 15065, 15476, 15576, 16295, 17125, 17921]","[0, 209, 299, 407, 591, 959, 1178, 1456, 1546, 1726, 1906, 2084, 2283, 2432, 2727, 2978, 3469, 3992, 4271, 4687, 5014, 5474, 6342, 6817, 6999, 7313, 7634, 8049, 8448, 9305, 9586, 9693, 10872, 11060, 11250]","[100, 309, 439, 529, 667, 860, 1187, 1429, 1638, 1894, 2093, 2255, 2639, 2881, 2976, 3299, 3520, 3690, 3863, 4192, 4400, 4929, 5651, 6051, 6196, 6435, 6888, 7117, 7438, 7702, 7908, 8008, 9735, 9835, 10258]",21604,24132,17921,11250,10258,2180,-4787,-165,870,1279,-623,35,dire
7541784709,38,21,137,65,83,"[0, 168, 471, 772, 1554, 1987, 2387, 2738, 3333, 3929, 4251, 4609, 4984, 5666, 6252, 6939, 7898, 8535, 9243, 9879, 10481, 11068, 11603, 12716, 13755, 14521, 15478, 16787, 17038, 17429, 17789, 18237, 18397, 18880, 19165]","[0, 243, 533, 750, 1096, 1335, 1785, 2126, 2783, 3331, 3674, 4207, 4599, 5326, 5727, 6320, 7081, 7786, 8380, 8984, 9497, 10015, 10991, 11854, 12647, 13782, 14858, 16472, 17080, 17531, 18082, 18596, 19102, 19394, 20727]","[0, 198, 518, 886, 1016, 1263, 1752, 1967, 2482, 2899, 3754, 4660, 5222, 5861, 6512, 7076, 7365, 7996, 8756, 9239, 9592, 9710, 10351, 10747, 11265, 12260, 12825, 13713, 14089, 14185, 14488, 15168, 15622, 16397, 16809]","[0, 130, 220, 310, 558, 648, 1087, 1310, 1706, 1870, 2314, 2667, 3127, 3626, 4199, 4506, 4995, 5153, 5337, 5908, 6580, 6724, 7055, 7443, 8017, 8556, 9117, 10258, 10509, 10650, 10930, 11120, 11220, 11514, 11704]","[0, 130, 220, 414, 544, 634, 807, 942, 1591, 1807, 2070, 2328, 2551, 2718, 3252, 3393, 3609, 3814, 4004, 4286, 4556, 4651, 4858, 5197, 5561, 6029, 6617, 7484, 7735, 7879, 8431, 8703, 8803, 9494, 9684]",19165,20727,16809,11704,9684,41,15,96,20,87,"[0, 245, 447, 766, 1016, 1258, 1616, 2017, 2262, 2631, 2990, 3382, 3748, 4178, 4789, 5165, 5634, 5974, 6446, 6768, 7246, 7828, 8287, 9007, 9762, 9857, 10515, 11306, 12858, 13415, 14920, 15795, 16090, 17224, 17920]","[0, 329, 641, 1003, 1425, 1882, 2184, 3083, 3501, 4149, 4325, 4572, 4833, 5595, 6019, 6630, 7183, 8078, 8744, 9652, 10480, 11055, 11844, 12527, 13097, 13598, 14059, 14568, 14907, 15552, 16679, 17017, 17195, 18119, 18309]","[0, 210, 406, 582, 906, 1193, 1602, 1985, 2208, 2647, 3063, 3607, 3913, 4392, 4953, 5476, 6313, 6550, 7080, 7811, 8275, 8988, 9718, 10568, 10945, 11290, 11801, 12888, 13498, 13698, 14512, 14984, 15676, 16768, 17600]","[0, 259, 435, 602, 822, 947, 1161, 1520, 1656, 1830, 2100, 2298, 2803, 3038, 3223, 3318, 4031, 4260, 4575, 5395, 5744, 6071, 6324, 6565, 6760, 6930, 7263, 7476, 7890, 8061, 8602, 9004, 9179, 9354, 10461]","[0, 247, 371, 461, 691, 816, 1068, 1434, 1568, 1742, 2071, 2546, 2636, 2903, 3297, 3392, 3745, 4191, 4470, 5037, 5270, 5672, 5914, 6297, 6604, 6830, 7259, 8517, 9539, 9996, 10607, 10883, 10983, 11083, 11432]",17920,18309,17600,10461,11432,1245,2418,-791,1243,-1748,2367,35,dire
7541933305,10,23,47,45,19,"[0, 252, 637, 1020, 1387, 1819, 2243, 2647, 3265, 3732, 4194, 5087, 5616, 6053, 6696, 7314, 8006, 8592, 8989, 9930, 10331, 11064, 12511, 13405, 13793, 14795, 15469, 16106, 16884, 17718, 18552, 19022, 20035, 20659, 23382]","[0, 288, 680, 1080, 1378, 1999, 2323, 2803, 3352, 4003, 4389, 4832, 5264, 5397, 5914, 6467, 7378, 7561, 8104, 8685, 9457, 9978, 11545, 11959, 12730, 13276, 14140, 14864, 15563, 15856, 16434, 17077, 17925, 18515, 19698]","[0, 429, 668, 955, 1121, 1583, 1960, 2087, 2321, 2710, 2963, 3274, 3449, 4026, 4245, 4384, 4862, 5539, 5762, 6325, 6828, 7499, 8438, 9298, 9784, 10316, 10776, 11063, 11875, 12326, 12668, 13202, 13302, 13828, 14918]","[100, 270, 385, 566, 885, 1103, 1193, 1407, 1542, 2035, 2170, 2451, 2587, 2693, 2834, 2953, 3303, 3496, 3640, 4216, 4489, 4584, 5331, 5745, 6385, 6480, 6919, 7374, 7552, 7648, 7744, 7843, 7975, 8254, 9614]","[0, 261, 415, 505, 812, 1236, 1462, 1552, 1774, 2151, 2286, 2666, 2860, 2960, 3100, 3194, 3664, 3887, 4148, 4639, 4819, 5021, 5847, 6411, 6641, 6904, 7144, 7508, 7686, 7799, 7940, 8039, 8139, 8656, 9551]",23382,19698,14918,9614,9551,12,74,96,65,20,"[60, 288, 776, 987, 1491, 1795, 2212, 2715, 3160, 3735, 4368, 4830, 5607, 6342, 7141, 7767, 8404, 9275, 10069, 10570, 11564, 12247, 12882, 13338, 13994, 15274, 15928, 16488, 17415, 18274, 19572, 20945, 22260, 23105, 24285]","[328, 593, 864, 1068, 1403, 1528, 1723, 1982, 2361, 2733, 3281, 3850, 4160, 4649, 5435, 6016, 6536, 7060, 8050, 8666, 9201, 10115, 10705, 10951, 11046, 11715, 12430, 12524, 13477, 13925, 14936, 16345, 16942, 17386, 18221]","[60, 420, 851, 1149, 1513, 1960, 2327, 2712, 2959, 3831, 4852, 5333, 6042, 6369, 6851, 7311, 7863, 8885, 9485, 9833, 10277, 11041, 11324, 11418, 12069, 12503, 13754, 14032, 14454, 14569, 15399, 16424, 16806, 17032, 17609]","[60, 345, 500, 590, 778, 933, 1368, 1629, 1875, 2061, 2451, 2641, 2949, 3533, 3959, 4112, 4698, 5566, 6346, 6763, 7172, 7394, 7654, 7806, 8084, 8306, 8805, 9096, 9513, 9609, 10088, 10686, 11338, 11553, 12130]","[60, 528, 721, 811, 1020, 1154, 1614, 1749, 1839, 1977, 2121, 2285, 2375, 2685, 2879, 2973, 3339, 3805, 4388, 4637, 5045, 5177, 5419, 5661, 5925, 6459, 6884, 7259, 7684, 7780, 8672, 9550, 9650, 9860, 10035]",24285,18221,17609,12130,10035,-903,1477,-2691,-2516,-484,-5117,35,dire
7544133504,114,14,106,85,86,"[0, 170, 454, 875, 1111, 1402, 1756, 2504, 2691, 3214, 3768, 4204, 4487, 4905, 5491, 5995, 6421, 6624, 7187, 7707, 8419, 9243, 11025, 12249, 13719, 14163, 14257, 14810, 15526, 16418, 16757, 18084, 18184, 18284, 18474]","[0, 248, 489, 935, 1436, 1676, 2235, 2890, 3543, 3890, 4417, 5001, 5405, 5799, 6347, 7062, 7744, 8324, 9148, 9701, 10408, 10712, 11285, 11857, 12546, 13121, 13495, 13880, 14126, 14612, 15351, 15451, 16401, 17801, 18272]","[0, 287, 650, 995, 1232, 1513, 1726, 2104, 2829, 3213, 4065, 4486, 5107, 5641, 5947, 6822, 7421, 7516, 7873, 8069, 8645, 9310, 9978, 10946, 11439, 11903, 12621, 12806, 13913, 15247, 15586, 16180, 16280, 17118, 17589]","[0, 257, 717, 982, 1072, 1243, 1614, 1937, 2107, 2345, 2636, 3102, 3801, 4447, 4881, 5583, 5982, 6237, 6386, 6723, 7296, 7493, 8645, 8966, 9061, 9693, 10348, 10533, 10741, 11407, 11887, 13742, 13912, 14711, 15874]","[0, 468, 558, 748, 916, 1052, 1802, 2281, 2545, 2843, 3044, 3313, 3747, 4318, 4599, 5018, 5176, 5443, 5636, 6101, 6743, 6901, 7698, 8447, 9464, 10013, 10107, 10729, 11078, 11564, 12260, 13060, 13160, 14160, 14921]",18474,18272,17589,15874,14921,17,102,69,26,100,"[0, 242, 599, 1059, 1497, 1899, 2149, 2563, 2993, 3342, 3942, 4565, 5074, 5624, 6020, 6614, 7179, 8853, 10193, 11108, 12063, 12796, 13606, 14698, 14793, 15019, 17526, 18410, 18877, 21117, 21267, 23361, 23551, 24202, 25033]","[0, 206, 610, 931, 1333, 1749, 1985, 2313, 2727, 3318, 4117, 4670, 5525, 6137, 6774, 7252, 7994, 8782, 9677, 10587, 11305, 11832, 12254, 13221, 13721, 13897, 15258, 16537, 17564, 17813, 18532, 20187, 21340, 21999, 22940]","[0, 354, 614, 946, 1596, 2037, 3066, 3245, 3653, 4040, 5183, 5877, 6567, 7159, 7724, 8662, 9330, 10541, 11481, 11900, 12525, 12684, 13473, 14320, 15887, 16326, 17485, 17923, 18404, 18804, 19338, 21337, 22198, 23070, 23776]","[0, 230, 320, 458, 715, 925, 1281, 1407, 1542, 1677, 1971, 2234, 2848, 2943, 3038, 3429, 3524, 3980, 4505, 4890, 5264, 5541, 5990, 6303, 6398, 6541, 7075, 7170, 7538, 7938, 8139, 9566, 9790, 10486, 10696]","[0, 498, 588, 727, 873, 1016, 1447, 1537, 1673, 2050, 2356, 2446, 2761, 2856, 2951, 3295, 3390, 4080, 4603, 5188, 5283, 5378, 5606, 5964, 6059, 6154, 6498, 7220, 7541, 8837, 8933, 9233, 9423, 10002, 10212]",25033,22940,23776,10696,10212,-6559,-4668,-6187,5178,4709,-7527,35,dire
7544499316,10,13,69,40,123,"[0, 170, 486, 1029, 1386, 1613, 2060, 2717, 3215, 3805, 4372, 4881, 5541, 5956, 6752, 7358, 8149, 8942, 9508, 10351, 11408, 11937, 12827, 14049, 14934, 16409, 17770, 19130, 20198, 20294, 21226, 21455, 22168, 23335, 24151]","[0, 253, 465, 860, 1175, 1529, 1906, 2346, 2680, 3141, 3407, 3987, 4415, 4510, 5203, 5849, 6701, 6927, 7175, 7783, 8342, 8839, 9481, 9831, 10708, 11272, 12027, 12658, 13054, 13150, 13909, 14282, 14986, 15551, 16580]","[0, 204, 592, 759, 1005, 1193, 1560, 1738, 1950, 2288, 2761, 3141, 3644, 4195, 5432, 6096, 7207, 8446, 8949, 9559, 10566, 11509, 11960, 13171, 14066, 14611, 15325, 15796, 16087, 16544, 17271, 17660, 17760, 17930, 19261]","[0, 514, 604, 694, 830, 929, 1126, 1342, 1432, 1522, 1657, 1747, 1947, 2042, 2196, 2356, 2827, 3542, 3932, 4026, 4201, 4642, 5307, 5922, 6017, 6516, 6895, 7513, 8094, 8554, 9389, 9923, 10479, 10762, 11492]","[100, 316, 625, 715, 854, 1022, 1312, 1402, 1492, 1705, 2050, 2474, 2654, 2749, 2938, 3098, 3597, 4161, 4300, 4679, 5106, 5461, 6334, 6931, 7286, 8063, 8446, 8835, 9341, 9602, 9698, 10164, 10453, 10578, 11338]",24151,16580,19261,11492,11338,42,20,53,32,21,"[0, 241, 486, 724, 1157, 1433, 1800, 2332, 2606, 2990, 3437, 3806, 4218, 4907, 5317, 5969, 6416, 7071, 7600, 8127, 8730, 9537, 10115, 10670, 11052, 11851, 12207, 12476, 13238, 13789, 14103, 14728, 15891, 16431, 17584]","[0, 250, 564, 951, 1235, 1690, 2138, 2592, 2930, 3164, 3697, 3948, 4151, 4661, 5317, 5758, 6830, 7125, 7473, 7879, 8212, 8397, 8932, 9489, 10298, 10919, 11381, 11843, 13231, 14702, 14888, 15665, 16244, 16869, 17678]","[0, 170, 260, 444, 1026, 1165, 1414, 1641, 1852, 2181, 2801, 3062, 3288, 3527, 3886, 4138, 4977, 5072, 5830, 6922, 7143, 7349, 7903, 8230, 8993, 9546, 9787, 10144, 10798, 11427, 11685, 11990, 12570, 12810, 14089]","[0, 257, 781, 1140, 1513, 1793, 2195, 2617, 3144, 3737, 4410, 4846, 5201, 5578, 5673, 6076, 6741, 6836, 7082, 7586, 7996, 8522, 8844, 9047, 9378, 9642, 9737, 10280, 10724, 11677, 11863, 12881, 13427, 13605, 13839]","[0, 170, 260, 350, 533, 756, 930, 1210, 1474, 1692, 2042, 2284, 2395, 2931, 3026, 3234, 4299, 4394, 4740, 5136, 5570, 5737, 6370, 6858, 7198, 7564, 7659, 7976, 8709, 9239, 9492, 10246, 10779, 10923, 11523]",17584,17678,14089,13839,11523,6567,-1098,5172,-2347,-185,8109,35,dire
7545474417,13,93,80,62,31,"[0, 240, 561, 848, 1250, 1551, 1893, 2186, 2582, 3165, 3603, 4433, 4794, 5829, 5924, 6708, 7129, 7644, 8404, 9556, 10209, 10774, 11577, 11838, 13237, 13442, 14812, 15508, 16990, 17086, 17632, 20573, 22376, 23979, 25142]","[0, 291, 550, 1016, 1386, 1834, 2084, 2464, 2925, 3450, 3897, 4501, 4914, 5406, 5970, 7330, 7942, 8611, 9170, 9996, 10577, 11176, 11570, 12036, 12447, 12724, 13681, 13954, 14893, 14989, 15432, 16641, 17608, 18053, 19534]","[0, 296, 607, 955, 1151, 1426, 2272, 2454, 3469, 3888, 4164, 4979, 5800, 6291, 6589, 7196, 7907, 8149, 8537, 9388, 10069, 10164, 10569, 10921, 11453, 11805, 12390, 13094, 13769, 13865, 13961, 15246, 16054, 16712, 17641]","[100, 269, 384, 504, 664, 799, 934, 1140, 1673, 2002, 2287, 2734, 3343, 3998, 4093, 4957, 5052, 5313, 5590, 6042, 6307, 6411, 6513, 6985, 7329, 7555, 7650, 7744, 8031, 8127, 8223, 9330, 9546, 9991, 10451]","[0, 169, 284, 449, 654, 837, 1210, 1394, 2145, 2421, 2511, 3084, 3395, 3711, 3806, 4227, 4357, 4816, 5037, 5486, 5700, 5795, 6129, 6393, 7190, 7476, 8158, 8252, 8624, 8821, 9008, 9498, 9688, 10133, 10729]",25142,19534,17641,10451,10729,48,21,76,74,26,"[0, 208, 447, 741, 1224, 1751, 2605, 3211, 3545, 3732, 4246, 4762, 5474, 6170, 6854, 8236, 9638, 11032, 12254, 12964, 13122, 14525, 15544, 16139, 17218, 18288, 19242, 20151, 21175, 23269, 24598, 26366, 26466, 27252, 28258]","[0, 280, 594, 950, 1397, 1627, 2249, 2509, 2599, 3335, 3831, 4253, 4343, 5141, 5440, 6041, 6486, 7433, 7905, 8328, 8943, 9185, 9559, 9947, 10179, 10833, 11668, 12183, 12616, 13545, 14107, 14749, 15228, 16125, 16620]","[0, 203, 403, 731, 988, 1378, 1782, 2254, 2690, 2890, 3016, 3243, 3724, 4741, 5093, 5303, 5915, 6749, 7309, 7766, 8740, 9494, 10422, 10815, 11816, 12687, 12863, 13450, 14006, 14961, 15663, 16133, 16233, 16333, 16528]","[0, 169, 296, 386, 538, 958, 1251, 1402, 1826, 1992, 2277, 2470, 2599, 3730, 4102, 4484, 5117, 5859, 6103, 6846, 7304, 7793, 8352, 8519, 8795, 9541, 10098, 10786, 11393, 11968, 13011, 13484, 13643, 14097, 14197]","[0, 169, 601, 735, 912, 1135, 1364, 1499, 1589, 1975, 2358, 2732, 3069, 3540, 3635, 3902, 4303, 4848, 5196, 5448, 5964, 6059, 6611, 6705, 6910, 7402, 7857, 8217, 8429, 9193, 9817, 10242, 10342, 10442, 10777]",28258,16620,16528,14197,10777,-3116,2914,1113,-3746,-48,-2883,35,dire
7545622003,74,78,41,105,50,"[0, 386, 514, 1001, 1170, 1387, 1678, 2176, 2266, 2565, 3277, 3568, 3862, 4814, 5115, 5519, 6913, 7575, 8328, 8894, 8988, 9646, 10461, 10555, 11593, 11886, 12324, 13067, 14188, 14560, 15441, 15884, 17115, 17434, 17534]","[0, 309, 748, 1314, 1533, 1820, 2035, 2425, 2878, 3559, 3948, 4373, 4597, 5177, 5486, 5668, 6523, 6819, 7413, 7737, 8027, 8839, 9632, 10421, 11040, 11135, 11429, 12278, 12922, 13468, 13819, 14569, 14707, 15167, 15343]","[0, 229, 487, 772, 1026, 1116, 1343, 1574, 1664, 1912, 2342, 2645, 2904, 3167, 3416, 3686, 4450, 4705, 4959, 5654, 5748, 6090, 6654, 6748, 7127, 7732, 8020, 8448, 8827, 8923, 9254, 10078, 10178, 10555, 10690]","[0, 497, 661, 825, 915, 1005, 1095, 1272, 1362, 1542, 1778, 1868, 1981, 2228, 2514, 2609, 3370, 3708, 3803, 4115, 4209, 4693, 4974, 5068, 5253, 5397, 5492, 5602, 6199, 6626, 7023, 7411, 8115, 8254, 8493]","[0, 229, 353, 526, 633, 723, 813, 990, 1080, 1260, 1680, 1911, 2141, 2425, 2896, 3148, 3633, 3728, 3823, 3992, 4086, 4384, 4906, 5260, 5860, 5955, 6121, 6215, 6601, 6971, 7302, 7446, 7546, 7646, 7746]",17534,15343,10690,8493,7746,2,46,43,123,53,"[0, 243, 850, 1275, 1685, 2665, 3039, 3526, 4259, 4974, 5227, 5728, 6358, 7326, 8289, 8877, 9034, 9665, 10299, 10546, 11105, 11772, 11909, 12832, 13651, 14246, 15193, 15634, 16417, 17747, 18598, 19492, 20258, 21645, 22634]","[0, 205, 400, 694, 975, 1370, 1752, 2357, 2808, 3234, 4181, 4681, 5237, 5826, 6241, 6771, 7538, 8225, 8873, 9689, 10101, 10268, 10583, 11391, 12088, 12990, 13837, 14918, 15779, 15956, 16660, 17891, 19320, 19557, 20547]","[0, 241, 456, 761, 1136, 1702, 2065, 2553, 3504, 3975, 4411, 4916, 5046, 5307, 5899, 6457, 6790, 7418, 7814, 8174, 8966, 9659, 9895, 10730, 11346, 11955, 12374, 13069, 13992, 14832, 15492, 16626, 17845, 18331, 19215]","[100, 316, 627, 828, 1135, 1407, 1617, 1912, 2204, 2482, 2764, 2854, 2963, 3788, 4102, 4386, 4960, 5567, 5817, 6059, 6841, 7914, 8387, 9112, 9503, 9708, 9984, 10264, 10814, 11454, 11656, 12378, 13074, 14028, 14546]","[0, 208, 314, 420, 577, 753, 890, 1067, 1452, 1632, 1865, 2110, 2200, 2833, 3361, 3510, 3714, 3993, 4202, 4691, 5108, 5724, 6109, 6598, 7338, 7984, 8435, 8645, 9561, 9949, 10162, 11070, 11906, 12755, 13362]",22634,20547,19215,14546,13362,-5100,-5204,-8525,-6053,-5616,-30498,35,dire
7545626504,46,21,41,14,64,"[54, 275, 588, 1068, 1377, 1863, 2504, 3209, 4353, 5179, 5889, 6633, 7155, 7958, 9003, 9346, 10051, 10699, 11746, 12497, 13429, 14136, 14916, 15468, 16043, 16684, 18213, 18607, 19602, 20610, 21460, 22275, 24269, 25902, 26762]","[54, 450, 711, 1119, 1748, 2069, 2597, 2838, 3323, 3778, 4641, 5340, 5600, 6205, 6579, 6975, 7236, 8090, 9477, 10137, 10342, 10758, 11559, 12267, 12623, 13365, 14128, 14586, 15015, 15528, 15832, 16484, 17447, 18107, 18207]","[54, 297, 463, 870, 1194, 1444, 1779, 2003, 2721, 3234, 3656, 4082, 4524, 5186, 5618, 6073, 6645, 7164, 7376, 8328, 9033, 9534, 10294, 10499, 11019, 11529, 12084, 12531, 12830, 13231, 13798, 14285, 15368, 16152, 16854]","[54, 281, 405, 655, 858, 948, 1375, 1681, 2285, 2587, 3128, 3218, 3400, 3744, 3941, 4640, 5011, 5254, 5827, 6215, 6420, 6710, 6986, 7153, 7248, 7566, 7872, 8328, 9155, 9457, 9601, 9911, 11191, 11885, 11985]","[322, 491, 581, 820, 990, 1098, 1188, 1472, 1832, 2080, 2841, 3067, 3307, 4037, 4187, 4612, 5141, 5299, 6075, 6813, 7194, 7539, 8185, 8452, 8547, 8642, 8736, 8831, 9256, 9700, 9879, 10113, 11585, 12125, 12225]",26762,18207,16854,11985,12225,42,29,53,106,26,"[0, 242, 494, 793, 958, 1293, 1531, 2181, 2411, 2501, 2781, 3173, 3633, 3994, 4534, 5130, 5548, 6049, 6342, 6785, 7420, 7851, 8487, 9531, 10167, 11183, 11948, 12732, 13289, 14381, 15149, 15979, 16416, 17740, 18941]","[0, 243, 525, 778, 986, 1481, 1764, 2236, 2326, 2580, 3225, 3901, 4356, 4590, 5807, 6437, 6819, 7227, 7674, 7768, 8057, 8333, 8732, 9511, 10087, 10587, 11113, 11306, 12010, 12964, 13580, 14303, 14746, 16125, 16759]","[0, 213, 303, 672, 919, 1272, 1413, 1956, 2046, 2270, 2942, 3557, 4047, 4335, 4932, 5539, 6318, 6889, 7115, 7538, 7965, 8550, 8978, 9373, 9673, 9937, 10112, 10460, 10729, 11748, 12031, 12544, 12644, 14690, 15080]","[0, 279, 586, 758, 1032, 1352, 1550, 1899, 2028, 2380, 2737, 3204, 3373, 3767, 4191, 4842, 5799, 6488, 6714, 7079, 7248, 7742, 8517, 9645, 10185, 10531, 10706, 11157, 11476, 12576, 12919, 13857, 13957, 14115, 14536]","[0, 169, 259, 671, 786, 921, 1011, 1339, 1429, 1519, 1748, 2089, 2321, 2461, 2885, 3399, 3546, 4042, 4268, 4362, 4457, 4600, 4865, 5175, 5526, 5763, 6013, 6208, 6545, 7064, 7355, 7778, 7953, 9097, 9232]",18941,16759,15080,14536,9232,7821,1448,1774,-2551,2993,11485,35,radiant
7545665209,138,60,74,85,51,"[119, 363, 671, 951, 1493, 1939, 2117, 2620, 3051, 3509, 3933, 4447, 4727, 5237, 6280, 6811, 7604, 7918, 8831, 9426, 9908, 10171, 10730, 11560, 12157, 12841, 13649, 14458, 14635, 15222, 16420, 16699, 17248, 17430, 18402]","[119, 369, 709, 1062, 1264, 1633, 1961, 2286, 2632, 2761, 3191, 3583, 3673, 3767, 4575, 5216, 5431, 5870, 6076, 6591, 7287, 7444, 7888, 9195, 9667, 9762, 10235, 10923, 11664, 11823, 12079, 12330, 13090, 13405, 14050]","[252, 461, 691, 854, 1175, 1776, 2088, 2764, 3120, 3294, 3435, 3878, 4372, 4599, 5347, 5644, 6597, 7746, 8161, 8753, 9112, 9335, 9575, 10264, 10546, 10835, 11291, 11568, 11811, 12115, 12813, 13542, 13913, 14506, 15204]","[387, 557, 782, 872, 1116, 1206, 1418, 1881, 2033, 2234, 2324, 2579, 2669, 2901, 3512, 3690, 4553, 4857, 5234, 5468, 5826, 5921, 6164, 7310, 7494, 8091, 8332, 8813, 8990, 9352, 9770, 10349, 10449, 10648, 10958]","[59, 229, 349, 486, 593, 749, 879, 1014, 1104, 1194, 1284, 1472, 1766, 1971, 2423, 2563, 2975, 3479, 3733, 4128, 4360, 4455, 4698, 5290, 5669, 5764, 6153, 6970, 7261, 7357, 7919, 8278, 8661, 8761, 8970]",18402,14050,15204,10958,8970,123,76,19,86,97,"[72, 240, 590, 909, 1199, 1409, 1823, 2907, 3519, 4102, 4922, 5327, 6016, 6762, 7015, 7924, 8503, 10063, 10738, 11497, 12112, 13153, 14458, 14829, 15130, 16494, 17216, 19059, 19436, 20495, 21059, 21269, 21558, 22617, 22954]","[72, 275, 631, 880, 1355, 1676, 2075, 2299, 2801, 3447, 4322, 4592, 5175, 5976, 6251, 6678, 7278, 7822, 8338, 9226, 10376, 11124, 11405, 12002, 12948, 13842, 14825, 14920, 15767, 16884, 17638, 19556, 20542, 21950, 22390]","[72, 202, 327, 462, 679, 809, 899, 989, 1213, 1474, 1875, 1965, 2609, 2971, 3269, 4032, 4410, 4908, 5003, 5365, 5915, 6762, 7342, 7586, 7851, 8471, 9079, 9728, 10145, 11075, 11427, 12345, 12945, 13708, 14343]","[205, 335, 460, 550, 720, 907, 1033, 1677, 1942, 2175, 2814, 2904, 3249, 4043, 4176, 4513, 5586, 6017, 6112, 6337, 6917, 7586, 8046, 8285, 8522, 9012, 9807, 10295, 10959, 11772, 12350, 12957, 13057, 13591, 13931]","[72, 236, 646, 812, 1119, 1249, 1571, 1735, 1870, 2026, 2465, 2876, 3225, 3834, 4016, 4344, 4679, 4773, 5108, 5550, 5981, 6630, 7176, 7610, 7704, 8091, 8377, 9358, 9589, 9795, 10217, 10520, 10862, 11514, 12081]",22954,22390,14343,13931,12081,-4552,-8340,861,-2973,-3111,-18115,35,dire
7545688814,48,13,53,79,20,"[0, 323, 688, 975, 1248, 1540, 2265, 3029, 3580, 3707, 4379, 5037, 5626, 6609, 7058, 8242, 9279, 10526, 11599, 12505, 13429, 14138, 15278, 16524, 17551, 18445, 19440, 20777, 21599, 22660, 23703, 25022, 26041, 27469, 28578]","[0, 261, 500, 720, 1083, 1380, 1953, 2557, 2776, 3027, 3750, 4187, 4844, 5380, 5987, 6731, 7425, 8287, 8565, 8936, 9030, 9591, 10167, 10461, 11044, 11919, 12427, 12760, 13340, 13768, 13995, 14762, 15745, 17007, 17626]","[0, 333, 700, 1109, 1360, 1938, 2222, 2706, 2998, 3623, 4156, 4510, 5058, 5897, 6057, 6780, 7601, 8660, 9005, 9511, 9777, 10074, 10542, 10803, 11054, 12552, 13047, 13576, 14219, 15236, 15627, 16349, 17091, 17664, 17996]","[0, 311, 401, 491, 629, 767, 1066, 1301, 1700, 2022, 2332, 3156, 3274, 3821, 3916, 4446, 4985, 5780, 6134, 6292, 6386, 6596, 6988, 7159, 7418, 8481, 9134, 9310, 9614, 10498, 10709, 10898, 11047, 11792, 12074]","[0, 210, 317, 452, 542, 1024, 1236, 1677, 2038, 2208, 2344, 2831, 2921, 3282, 3377, 3752, 4058, 4518, 4796, 5070, 5164, 5540, 5932, 6079, 6434, 6943, 7196, 7420, 7597, 8096, 8192, 8381, 8481, 9226, 9416]",28578,17626,17996,12074,9416,44,17,14,128,37,"[0, 239, 525, 903, 1110, 1446, 1812, 1947, 2765, 2903, 3390, 3536, 3936, 4223, 4580, 4913, 5457, 6108, 6944, 7877, 9171, 10082, 10693, 11515, 11958, 12672, 13751, 14582, 15163, 16450, 17474, 18242, 19194, 20317, 21335]","[0, 213, 521, 707, 1155, 1525, 1756, 2266, 2951, 3133, 3718, 4072, 4464, 4891, 5299, 5556, 5983, 6156, 6735, 7405, 8110, 8393, 9269, 9808, 10414, 10616, 10923, 11439, 12115, 12904, 13354, 13642, 14786, 14886, 15287]","[0, 166, 488, 689, 896, 1409, 2056, 2477, 2901, 3669, 4070, 4421, 4766, 5536, 5939, 6034, 6662, 6757, 7050, 7458, 8383, 8666, 8833, 9081, 9370, 9576, 10105, 10726, 10940, 11287, 11540, 11766, 11961, 12498, 12598]","[0, 230, 320, 410, 547, 810, 900, 1157, 1410, 1755, 2330, 2521, 2657, 3279, 3459, 3782, 4023, 4301, 4660, 5266, 6193, 6671, 6894, 7278, 7372, 7469, 7676, 7927, 8023, 8462, 8776, 9049, 9233, 10071, 10171]","[0, 130, 220, 781, 871, 1041, 1131, 1266, 1814, 1942, 2463, 2639, 2819, 2958, 3227, 3430, 3587, 3809, 3941, 4519, 5291, 5386, 5553, 6096, 6300, 6395, 6544, 7084, 7421, 7860, 8170, 8269, 8797, 9394, 9679]",21335,15287,12598,10171,9679,7243,2339,5398,1903,-263,16620,35,radiant
7545749916,48,54,21,86,14,"[0, 243, 773, 1270, 1519, 1964, 2811, 2984, 3230, 3462, 3898, 4665, 5323, 5869, 6391, 6958, 7757, 9020, 9559, 10801, 11346, 12208, 12928, 13839, 14127, 14728, 15527, 16239, 17097, 18039, 18725, 20089, 21309, 21520, 22804]","[0, 170, 425, 707, 987, 1394, 1685, 2201, 2442, 2739, 3204, 3697, 4078, 4476, 5139, 5674, 6289, 7029, 7405, 8256, 8745, 9634, 10090, 10620, 11308, 11895, 12071, 13291, 13844, 14408, 15180, 16994, 18496, 18596, 18966]","[0, 251, 549, 973, 1296, 1700, 2196, 2771, 3110, 3759, 4756, 4926, 5673, 6116, 6897, 7292, 8466, 8713, 8978, 9863, 10547, 11034, 11362, 11807, 12035, 12582, 13390, 14063, 14741, 15572, 15951, 16980, 17496, 17691, 18368]","[0, 170, 260, 397, 696, 884, 974, 1242, 1387, 1562, 2204, 2958, 3378, 3806, 4367, 5072, 5470, 6010, 6514, 7425, 7848, 8386, 8892, 9848, 10358, 10453, 10705, 11204, 11628, 12194, 12886, 13787, 15085, 15501, 15967]","[0, 170, 328, 765, 855, 1050, 1433, 1662, 1925, 2157, 2544, 2714, 3261, 3673, 4177, 4614, 5596, 6113, 6583, 7075, 7473, 7956, 8198, 8485, 9350, 9750, 10050, 10845, 10982, 11444, 12184, 13297, 14084, 14545, 15003]",22804,18966,18368,15967,15003,120,25,98,103,26,"[0, 313, 513, 1003, 1333, 1655, 1994, 2354, 2787, 3459, 4369, 4858, 5364, 5899, 6644, 8074, 8169, 9156, 10176, 10761, 11073, 11345, 12132, 12862, 14174, 15754, 16431, 17140, 17766, 18511, 19277, 19377, 20341, 21567, 22024]","[0, 261, 464, 919, 1460, 1974, 2184, 2840, 3195, 4289, 4658, 5590, 6546, 6711, 7398, 8306, 8594, 8921, 9488, 10525, 11278, 11746, 12478, 13306, 14681, 15569, 16718, 16813, 17315, 18092, 18355, 18705, 19591, 20475, 21152]","[0, 170, 329, 678, 963, 1313, 1701, 2038, 2360, 2797, 3078, 3294, 3384, 3629, 4093, 4732, 5303, 5958, 6730, 7014, 7393, 7725, 8419, 8817, 8911, 9950, 10759, 11362, 12059, 12620, 12891, 13158, 13964, 14328, 14724]","[0, 170, 260, 394, 484, 649, 739, 1213, 1303, 1618, 1806, 2084, 2340, 2520, 2869, 3351, 3446, 3944, 4270, 4602, 4770, 5271, 5366, 5609, 6109, 6875, 7275, 7602, 8251, 8467, 8878, 8978, 10191, 10381, 10511]","[0, 170, 260, 350, 529, 742, 832, 1060, 1197, 1430, 1877, 2204, 2521, 2669, 2866, 3129, 3224, 3650, 3835, 4119, 4258, 4352, 4447, 4587, 5214, 5795, 6171, 6455, 6667, 6896, 6992, 7140, 8087, 8321, 8466]",22024,21152,14724,10511,8466,780,-2186,3644,5456,6537,14231,35,radiant
7545850405,69,14,22,123,20,"[215, 537, 627, 947, 1447, 1636, 2032, 2615, 2918, 3900, 4427, 5473, 6590, 7281, 8271, 8982, 9644, 10594, 11250, 12516, 13326, 14555, 15981, 16833, 17451, 18233, 18839, 19955, 21283, 21947, 22994, 25520, 26026, 26825, 28161]","[277, 581, 1012, 1413, 1925, 2448, 2985, 3602, 4233, 4860, 5523, 6197, 6836, 7492, 8033, 8399, 9550, 9838, 10377, 11193, 11812, 12561, 13695, 14584, 15229, 16280, 16947, 17381, 18377, 19418, 20155, 20910, 21545, 22020, 23199]","[348, 704, 994, 1383, 1775, 2222, 2576, 3239, 3763, 4095, 5011, 5480, 5677, 6511, 7048, 7417, 8209, 8466, 9209, 9989, 10989, 11459, 12395, 13088, 13437, 15054, 15661, 16295, 16472, 16888, 17242, 19048, 19638, 20192, 21607]","[348, 652, 742, 928, 1304, 1572, 1797, 2091, 2284, 2644, 2824, 3347, 4054, 4617, 4819, 4968, 5986, 6243, 6722, 7749, 8339, 8604, 9214, 9309, 9879, 10212, 10948, 11673, 11850, 12260, 12813, 14048, 14886, 15547, 16192]","[215, 785, 1095, 1276, 1515, 1693, 1899, 2059, 2194, 2329, 2674, 2898, 3275, 3598, 3800, 3949, 4433, 4718, 4924, 5407, 5738, 5898, 6739, 6991, 7221, 7705, 7881, 8057, 8234, 8598, 8851, 9506, 9717, 9871, 10474]",28161,23199,21607,16192,10474,109,106,97,19,26,"[186, 470, 1058, 1282, 2111, 2400, 2685, 2986, 3275, 3530, 3772, 4029, 4653, 5124, 5665, 6484, 6999, 7425, 8091, 8460, 8641, 9462, 10300, 11154, 11465, 12043, 12833, 14281, 15512, 16050, 17604, 17704, 18320, 19218, 19525]","[454, 767, 1051, 1375, 1626, 2265, 2587, 3257, 3840, 4145, 4617, 4941, 5641, 5860, 6240, 7182, 7660, 8154, 8611, 9307, 10501, 10767, 11493, 11751, 12802, 13011, 13106, 14026, 15477, 15573, 16766, 16866, 17556, 18363, 18695]","[250, 494, 777, 1013, 1312, 1479, 1894, 2066, 2506, 2842, 3259, 3688, 4191, 4660, 4873, 5327, 5857, 6329, 6801, 7248, 7793, 7990, 8278, 8501, 9190, 9284, 9727, 10695, 11349, 11643, 12298, 12903, 13148, 13436, 13693]","[319, 603, 693, 783, 873, 1003, 1236, 1371, 1573, 1663, 1753, 1887, 2270, 2644, 2857, 3601, 3798, 4222, 4560, 4845, 5364, 5458, 5746, 5931, 6407, 6692, 7388, 8053, 8856, 9335, 9792, 10215, 11225, 11578, 12129]","[186, 559, 733, 823, 1116, 1249, 1339, 1590, 1806, 1981, 2117, 2253, 2909, 3124, 3518, 3938, 4376, 4495, 4818, 5367, 5667, 5765, 6247, 6507, 6811, 7275, 7445, 8209, 8569, 8886, 9861, 10072, 10453, 10684, 11269]",19525,18695,13693,12129,11269,8636,4504,7914,4063,-795,24322,35,radiant
7546267004,74,38,70,21,26,"[0, 295, 577, 946, 1271, 1647, 1935, 2341, 2790, 3630, 3882, 4243, 4872, 5477, 6178, 6568, 6961, 7420, 8507, 8941, 9335, 9975, 10603, 11309, 12135, 12726, 13033, 14085, 14383, 15061, 15801, 16011, 16981, 18118, 18900]","[0, 283, 518, 879, 1187, 1553, 1853, 2020, 2195, 3011, 3443, 4052, 4453, 5412, 6108, 6904, 7580, 8574, 9486, 10550, 11330, 11864, 12234, 12989, 13518, 14260, 14830, 15395, 15659, 16314, 17460, 17881, 18222, 19928, 20124]","[0, 209, 523, 768, 1091, 1425, 1620, 2131, 2582, 3015, 3383, 3473, 3686, 4350, 4801, 5352, 6004, 7068, 8095, 8700, 9288, 10239, 10939, 11033, 11760, 12186, 12581, 13447, 13995, 15092, 15904, 16609, 17283, 17640, 17846]","[0, 209, 299, 483, 635, 802, 969, 1143, 1279, 1612, 1968, 2058, 2260, 2497, 2988, 3165, 3434, 3857, 4271, 4671, 5101, 5697, 5867, 6675, 7281, 7802, 8047, 8538, 8965, 9484, 9963, 10220, 10320, 10859, 11108]","[0, 209, 341, 431, 541, 675, 765, 855, 990, 1584, 1764, 1996, 2198, 2533, 2747, 2842, 3300, 3501, 4009, 4341, 4600, 5011, 5144, 5497, 5853, 6146, 6328, 6796, 6892, 7240, 8120, 8399, 8499, 8954, 9167]",18900,20124,17846,11108,9167,25,102,32,58,3,"[0, 234, 569, 952, 1283, 1606, 1978, 2470, 2900, 3128, 3595, 4186, 4779, 6388, 7149, 7776, 8500, 9036, 9669, 10351, 11010, 12158, 13019, 14411, 15595, 16155, 16680, 17968, 18602, 19308, 19627, 20283, 21355, 23392, 25105]","[0, 220, 485, 885, 1230, 1393, 1837, 2051, 2461, 2717, 3269, 3618, 4481, 4962, 5197, 5780, 6239, 6783, 6878, 7120, 7777, 8233, 8591, 9107, 9485, 10120, 10525, 11246, 11691, 12361, 12553, 12846, 13107, 13883, 14516]","[0, 168, 330, 457, 744, 962, 1496, 1670, 2197, 2373, 2542, 2893, 3218, 3865, 4047, 4593, 5200, 5682, 5840, 6164, 6933, 7525, 7779, 8373, 8468, 8755, 9076, 9378, 9729, 10159, 10695, 11010, 11271, 11976, 12672]","[0, 129, 219, 309, 399, 489, 734, 869, 1049, 1186, 1487, 1631, 1923, 2171, 2353, 2806, 3035, 3449, 3882, 4039, 4224, 4611, 4706, 5032, 5127, 5466, 5769, 6436, 6876, 7276, 7372, 7562, 7823, 8328, 8810]","[0, 129, 219, 354, 559, 649, 1196, 1368, 1458, 1548, 1956, 2100, 2667, 2835, 3017, 3365, 3568, 3815, 3910, 4232, 4477, 4677, 4772, 5098, 5193, 5288, 5498, 5592, 6056, 6242, 6338, 6528, 6628, 7308, 7743]",25105,14516,12672,8810,7743,-6205,5608,5174,2298,1424,8299,35,radiant
7546556801,98,43,109,83,112,"[0, 283, 840, 1087, 1629, 1940, 2105, 2595, 3009, 3669, 4224, 4850, 5667, 5851, 6379, 7285, 8364, 8817, 9589, 9923, 10813, 12211, 13032, 13424, 14802, 15864, 17443, 18138, 18553, 19172, 19714, 21498, 22022, 22901, 23636]","[0, 232, 442, 862, 1189, 1564, 1945, 2834, 3082, 3262, 3757, 4312, 4824, 5738, 6231, 6916, 7767, 8578, 9325, 9521, 10238, 11244, 12402, 13101, 14261, 15537, 16379, 17517, 18078, 18544, 18640, 20237, 20809, 21752, 23141]","[0, 209, 514, 796, 1371, 1671, 1798, 2428, 2819, 3419, 3893, 4471, 4850, 5144, 5609, 6351, 7053, 7718, 8498, 9205, 9839, 10897, 11524, 12625, 13406, 13722, 14374, 15755, 17075, 17791, 17999, 18793, 18893, 20162, 21365]","[0, 129, 219, 309, 470, 560, 650, 1098, 1188, 1501, 1684, 2023, 2191, 2883, 3023, 3386, 4080, 4289, 4384, 4479, 4732, 5107, 5459, 5816, 6257, 6594, 7415, 7954, 8254, 8425, 8642, 9372, 9927, 10412, 10882]","[0, 129, 314, 404, 583, 673, 763, 1089, 1226, 1406, 1718, 2200, 2290, 2580, 2720, 3083, 3530, 3688, 3969, 4064, 4293, 4866, 5143, 5381, 5835, 6040, 6503, 6967, 7144, 7339, 7435, 7876, 7976, 8461, 9293]",23636,23141,21365,10882,9293,72,60,36,91,121,"[0, 320, 758, 1048, 1380, 1669, 2140, 2737, 3005, 3694, 4087, 4868, 5543, 6727, 7316, 8234, 8645, 9257, 9806, 10296, 11489, 12835, 13494, 14211, 15650, 15852, 17078, 17416, 17998, 19474, 19939, 21013, 21113, 22003, 22406]","[0, 246, 564, 809, 984, 1357, 1812, 2243, 2741, 3403, 3857, 4086, 4803, 5361, 5957, 6297, 6930, 7348, 7957, 8275, 8785, 9441, 9536, 9790, 10328, 10423, 11228, 11517, 11993, 13995, 14449, 14578, 15054, 16473, 16573]","[0, 366, 723, 1103, 1398, 1488, 1700, 1912, 2549, 3088, 3583, 3980, 4335, 4967, 5520, 6142, 6648, 6980, 7806, 8368, 8936, 9343, 9727, 10724, 11425, 11653, 11748, 12392, 12650, 13933, 14357, 15282, 15382, 16173, 16397]","[0, 209, 533, 671, 801, 891, 1207, 1400, 1675, 2394, 2508, 2693, 2961, 3503, 3770, 3918, 4012, 4192, 4425, 4864, 5093, 5622, 5717, 5891, 6433, 6741, 6836, 6930, 7188, 7665, 7761, 7861, 8666, 9137, 9237]","[0, 209, 299, 426, 556, 693, 1088, 1253, 1520, 1841, 2015, 2105, 2323, 2585, 2888, 3065, 3214, 3355, 3689, 3847, 4118, 4520, 4663, 4757, 5323, 5418, 5513, 5639, 5897, 6759, 6881, 7482, 7582, 8011, 8111]",22406,16573,16397,9237,8111,1230,6568,4968,1645,1182,15593,35,radiant
7546718402,89,102,137,26,45,"[0, 251, 418, 777, 1100, 1441, 1696, 2044, 2369, 2871, 3318, 3754, 4183, 5016, 5732, 6477, 7470, 8424, 9536, 10613, 11370, 12017, 13173, 14042, 14863, 15669, 17282, 18079, 19807, 20849, 22029, 23012, 23202, 24130, 24783]","[0, 212, 488, 903, 1359, 1814, 2413, 2858, 3308, 4075, 4531, 4984, 5623, 6244, 6721, 7078, 7341, 8483, 9006, 9710, 10256, 10759, 11587, 12218, 12407, 12923, 13596, 14244, 14924, 15311, 15936, 16535, 16725, 17153, 17548]","[0, 249, 611, 1023, 1404, 2006, 2454, 2856, 3285, 3636, 3981, 4564, 5214, 5720, 6387, 6925, 7455, 8051, 8634, 8953, 9454, 10040, 10910, 11527, 11775, 12715, 13534, 13739, 14263, 14730, 15191, 15381, 15852, 16754, 17184]","[0, 130, 432, 649, 779, 886, 1041, 1221, 1442, 1855, 1990, 2098, 2505, 2957, 3051, 3286, 3572, 3836, 4026, 4268, 4498, 5237, 5612, 5782, 5877, 6237, 6854, 6949, 7445, 7620, 7908, 8098, 8406, 8568, 8758]","[0, 130, 220, 401, 563, 698, 788, 1013, 1305, 1523, 1704, 2109, 2328, 2835, 3128, 3288, 3383, 3642, 3905, 4147, 4377, 4607, 4994, 5236, 5553, 5829, 6380, 6475, 6978, 7157, 7366, 7556, 7841, 8147, 8337]",24783,17548,17184,8758,8337,39,93,129,123,119,"[0, 305, 594, 1054, 1406, 1652, 2104, 2637, 3064, 3409, 3971, 4454, 5080, 5746, 6419, 7018, 7746, 8423, 9121, 9453, 10564, 11394, 12302, 12709, 13357, 14041, 14433, 15163, 15427, 15950, 16645, 17694, 18479, 18934, 20351]","[0, 280, 408, 698, 879, 1083, 1435, 1709, 1983, 2235, 2708, 3219, 3486, 4086, 4806, 5402, 5894, 6461, 7479, 8223, 8823, 9379, 10006, 10511, 11200, 11917, 12260, 12954, 13094, 13810, 14300, 15115, 16021, 16706, 17991]","[0, 569, 732, 1085, 1371, 1664, 2440, 2775, 3409, 3892, 4272, 4727, 5240, 5766, 6025, 7167, 8086, 8488, 9552, 10041, 10830, 11351, 11806, 12144, 12823, 13153, 13248, 13764, 14187, 14688, 15358, 16155, 16574, 16920, 17686]","[0, 265, 406, 496, 626, 716, 938, 1111, 1363, 1721, 2088, 2203, 2293, 2499, 2639, 3308, 3865, 4263, 4528, 5018, 5604, 5752, 6364, 6839, 7073, 7816, 8196, 8563, 8863, 9209, 9920, 10624, 11145, 11843, 13222]","[0, 265, 391, 562, 692, 782, 872, 996, 1086, 1285, 1475, 1650, 1871, 2014, 2261, 2661, 3054, 3251, 3697, 3792, 4296, 4391, 4648, 4743, 4945, 5218, 5313, 5525, 5667, 5763, 6197, 7333, 7792, 7892, 8802]",20351,17991,17686,13222,8802,4432,-443,-502,-4464,-465,-1442,35,dire
7546973501,94,43,7,83,100,"[604, 816, 1397, 1840, 2344, 2683, 3277, 3753, 4231, 4823, 5427, 6173, 7307, 7845, 8888, 9686, 10594, 11232, 12085, 12569, 13648, 15219, 16457, 17683, 18506, 20017, 21287, 22402, 22833, 24121, 25640, 26135, 26235, 27026, 28422]","[619, 867, 1126, 1299, 1515, 1959, 2481, 2999, 3782, 4282, 4867, 5528, 6491, 6806, 7529, 7786, 8522, 8991, 9414, 10391, 10780, 11526, 12126, 12588, 13058, 13702, 14168, 14862, 15401, 16374, 16966, 17303, 17818, 18321, 19042]","[536, 842, 1173, 1512, 2052, 2552, 3120, 3690, 4330, 4916, 5416, 5872, 6231, 6620, 7339, 7721, 7864, 8502, 9065, 9488, 9877, 10541, 11216, 11656, 12396, 12956, 13670, 14078, 14452, 15644, 16182, 16708, 16808, 16998, 17595]","[285, 375, 545, 635, 770, 1183, 1870, 2036, 2306, 2741, 3104, 3253, 3685, 4174, 4888, 5065, 5204, 5498, 5704, 5799, 6381, 6762, 6928, 7205, 7545, 7790, 8304, 8640, 8959, 9633, 10175, 10470, 10859, 11049, 11443]","[321, 411, 515, 605, 895, 1243, 1464, 1871, 2189, 2822, 3068, 3217, 3565, 3732, 4078, 4444, 4539, 4796, 5146, 5241, 5594, 5975, 6402, 6887, 7227, 7541, 8007, 8306, 8703, 9094, 9439, 10029, 10444, 10634, 10980]",28422,19042,17595,11443,10980,48,13,102,20,103,"[589, 924, 1275, 1600, 2022, 2262, 2664, 2968, 3324, 3414, 3971, 4166, 4916, 5813, 6620, 7213, 7762, 8590, 9569, 10328, 11061, 11526, 12794, 13674, 14976, 16026, 17035, 17434, 18448, 19044, 19144, 20726, 21961, 22538, 23243]","[453, 664, 995, 1365, 1857, 2185, 2785, 3048, 3301, 3513, 3866, 4313, 5398, 6002, 6648, 7103, 7622, 8264, 9089, 9304, 9399, 9922, 10514, 11034, 11512, 12335, 12849, 12945, 13125, 13534, 14691, 16005, 16618, 17177, 17586]","[901, 1134, 1366, 1627, 1944, 2358, 2587, 3090, 3319, 3627, 4208, 4761, 5131, 5457, 5944, 6811, 7281, 7548, 7997, 8380, 8475, 8699, 9317, 10108, 10907, 11174, 11645, 11957, 12393, 12707, 13061, 13910, 14100, 14200, 14863]","[370, 685, 818, 908, 1143, 1356, 1880, 1970, 2060, 2150, 2303, 2398, 2783, 2917, 3429, 3952, 4047, 4253, 4623, 4798, 4937, 5278, 5743, 5876, 6043, 6219, 6600, 6731, 7066, 7543, 7643, 8610, 9002, 9137, 9285]","[322, 412, 522, 646, 1038, 1414, 1718, 1808, 1898, 1988, 2078, 2211, 2547, 2849, 3173, 3434, 3578, 3770, 4154, 4249, 4392, 4652, 5073, 5168, 5263, 5439, 5706, 5802, 6185, 6725, 6825, 7015, 7322, 7660, 7853]",23243,17586,14863,9285,7853,5179,1456,2732,2158,3127,14652,35,radiant
7547188716,61,41,14,47,31,"[403, 858, 1023, 1467, 1716, 2166, 2419, 2934, 3253, 3601, 3914, 4631, 5423, 6361, 7045, 7573, 8125, 9114, 9582, 10488, 11167, 11477, 12583, 13835, 14597, 15857, 16468, 17066, 17444, 18113, 18888, 20142, 20709, 21390, 21718]","[498, 817, 1322, 1887, 2233, 2608, 3214, 4032, 4616, 5273, 5808, 6162, 6435, 7039, 7648, 8337, 8688, 9386, 9747, 10492, 10745, 11427, 12196, 13079, 13899, 14815, 15387, 15524, 16128, 16750, 17877, 19170, 19401, 20760, 21281]","[360, 450, 581, 795, 1236, 1549, 1954, 2245, 2629, 3329, 3765, 4324, 5417, 5825, 6272, 7069, 7658, 8451, 8763, 9320, 10268, 10712, 11117, 11708, 12233, 13442, 14059, 14572, 15089, 15769, 16654, 18391, 19119, 19520, 19620]","[405, 654, 783, 1113, 1323, 1774, 1864, 2270, 2479, 2839, 3195, 3593, 4055, 4573, 4923, 5215, 5735, 6168, 6464, 7285, 7865, 8554, 9052, 9955, 10370, 11097, 11553, 11854, 12030, 12316, 12613, 13043, 13143, 13831, 13931]","[259, 349, 485, 648, 1073, 1293, 1460, 1790, 1969, 2357, 2588, 3061, 3246, 3448, 3734, 4050, 4234, 4419, 4824, 5581, 5901, 6258, 6509, 7357, 7451, 8431, 8608, 8752, 9236, 9813, 10734, 11054, 11399, 11882, 11982]",21718,21281,19620,13931,11982,10,23,99,30,105,"[613, 860, 1154, 1480, 1827, 2227, 2667, 2837, 3196, 3593, 3930, 4464, 5218, 5758, 6289, 6875, 7380, 8265, 8938, 10578, 11231, 12010, 12728, 13904, 14503, 14598, 15322, 16740, 17786, 18662, 19469, 20564, 20664, 21887, 23261]","[648, 863, 1160, 1523, 1822, 2337, 2754, 3254, 3825, 4292, 4613, 4956, 6282, 6376, 6945, 7202, 7931, 8725, 9084, 9627, 10167, 10801, 11388, 11725, 11944, 12222, 12490, 13075, 13551, 14012, 14237, 15317, 15507, 16444, 16764]","[538, 949, 1217, 1561, 2000, 2286, 2792, 3000, 3246, 3573, 3840, 4445, 4757, 5031, 5591, 5899, 6466, 6780, 7126, 7221, 7977, 8486, 8793, 9345, 9493, 9588, 10119, 10958, 11577, 12239, 12473, 13508, 13797, 14603, 15475]","[259, 349, 439, 573, 908, 998, 1265, 1355, 1535, 1662, 1770, 2120, 2963, 3057, 3314, 3951, 4188, 4563, 4761, 4856, 5699, 5794, 6171, 6454, 6548, 6643, 6820, 7327, 7955, 8235, 8460, 9444, 9544, 10327, 10837]","[259, 394, 531, 665, 803, 942, 1125, 1215, 1400, 1525, 1696, 2031, 2266, 2490, 2703, 2941, 3144, 3632, 3882, 4016, 4333, 4428, 4718, 5219, 5486, 5781, 5958, 6421, 6812, 7116, 7341, 8318, 8418, 9210, 9592]",23261,16764,15475,10837,9592,-1543,4517,4145,3094,2390,12603,35,radiant
7547237916,109,69,120,53,100,"[604, 999, 1863, 2190, 2452, 2848, 3046, 3649, 4291, 4729, 6122, 6638, 7237, 7816, 8546, 9582, 10689, 10931, 11853, 13126, 13612, 14589, 15496, 16518, 17167, 17543, 17923, 18813, 19602, 20911, 21653, 23097, 23455, 24126, 25511]","[418, 716, 1009, 1150, 1585, 2070, 2572, 3198, 3881, 4430, 4912, 6037, 6605, 7535, 8448, 8811, 9390, 10112, 11048, 11899, 12697, 13323, 13954, 14311, 14868, 15469, 15837, 17031, 17594, 18250, 18670, 19091, 19397, 20812, 21373]","[530, 907, 1348, 1795, 2485, 2942, 3568, 3912, 4648, 5199, 5671, 6439, 6794, 7704, 8008, 8626, 9539, 10156, 10582, 11551, 12351, 12446, 13254, 13605, 14274, 14553, 14649, 15190, 15591, 15902, 16094, 16304, 16404, 17989, 18224]","[318, 473, 934, 1024, 1257, 1748, 2031, 2364, 2949, 3228, 3370, 3696, 4175, 5027, 5438, 5817, 6535, 6736, 7146, 7552, 8048, 8401, 8496, 9219, 9851, 9946, 10042, 11105, 11361, 11711, 12084, 12437, 12537, 13497, 13732]","[300, 436, 614, 704, 1426, 1692, 1911, 2001, 2371, 2551, 2760, 3118, 3364, 4025, 4183, 4350, 4718, 5094, 5509, 5711, 6176, 6506, 6814, 7165, 7410, 7709, 7805, 8429, 8573, 8787, 8887, 9097, 9243, 9546, 9781]",25511,21373,18224,13732,9781,138,43,88,14,91,"[902, 1385, 1775, 2375, 2705, 3031, 3376, 3685, 4062, 4507, 4979, 5110, 5545, 5792, 6399, 7389, 8030, 8562, 9128, 10380, 11402, 12279, 13081, 14095, 15915, 17130, 18107, 18688, 18784, 20323, 22083, 23399, 25661, 25761, 25960]","[502, 715, 959, 1433, 2314, 2797, 3413, 3746, 4080, 4505, 5255, 5708, 6117, 6537, 6680, 7549, 8526, 9014, 9535, 10318, 10818, 11416, 11790, 12453, 13165, 13901, 14595, 15499, 15709, 16681, 17011, 18046, 19075, 19510, 20195]","[577, 886, 1220, 1397, 1902, 2416, 2623, 3149, 3828, 4253, 4437, 4950, 5195, 5745, 5840, 6544, 6876, 7953, 8277, 8914, 9596, 10150, 10834, 11111, 11681, 12899, 13497, 14015, 14173, 14363, 15136, 16029, 16993, 17579, 18218]","[397, 487, 577, 794, 1108, 1198, 1411, 1598, 1953, 2133, 2417, 2681, 2989, 3198, 3293, 3751, 4856, 5104, 5283, 5757, 6221, 6505, 6686, 6781, 7444, 8641, 8977, 9662, 9795, 10111, 10579, 11367, 12348, 12448, 12747]","[290, 442, 576, 1022, 1382, 1726, 1816, 2004, 2303, 2483, 2767, 3004, 3306, 3515, 3681, 4100, 4194, 4289, 4472, 5014, 5527, 5622, 5717, 6077, 6717, 7130, 7336, 7675, 7771, 8077, 8814, 9463, 10496, 10596, 10915]",25960,20195,18218,12747,10915,-449,1178,6,985,-1134,586,35,radiant
7547312807,89,106,16,105,45,"[243, 530, 934, 1145, 1540, 1906, 2322, 2834, 3322, 3931, 4566, 5685, 6367, 6560, 7320, 8272, 9619, 10627, 11786, 12102, 12737, 13621, 14849, 14980, 16283, 17337, 17611, 18629, 19410, 21452, 22519, 23421, 24412, 24690, 26464]","[243, 412, 700, 1139, 1949, 2288, 2496, 2924, 3727, 4192, 4787, 5138, 5882, 6227, 6633, 6867, 7636, 8116, 8756, 8851, 9465, 10243, 10600, 10695, 11181, 11379, 12003, 12493, 12987, 13816, 14382, 15125, 15826, 16764, 18209]","[170, 442, 655, 866, 1080, 1334, 1579, 1706, 1983, 2238, 2328, 3010, 3697, 4099, 4616, 5010, 5825, 6323, 6838, 7188, 7526, 7985, 8759, 8854, 9118, 9321, 9999, 10404, 10648, 11238, 12205, 12721, 13676, 14034, 15546]","[170, 309, 399, 489, 690, 1161, 1508, 1719, 2206, 2876, 3147, 3746, 4241, 4336, 4542, 4664, 5569, 6133, 6584, 7025, 7439, 8000, 8469, 8922, 9053, 9346, 9478, 10260, 10583, 11055, 11533, 11823, 12033, 12528, 14385]","[170, 260, 350, 440, 882, 1018, 1150, 1261, 1583, 2133, 2556, 2849, 3501, 3748, 4100, 4195, 4867, 5167, 5532, 5627, 5908, 6564, 7178, 7416, 8362, 8788, 9166, 9582, 9984, 10856, 11183, 11702, 12157, 12722, 13917]",26464,18209,15546,14385,13917,102,11,80,88,64,"[389, 750, 984, 1550, 1831, 2527, 3077, 3454, 3907, 4388, 5220, 5496, 6249, 7259, 7952, 8712, 9285, 10041, 10795, 11886, 13164, 13975, 14844, 16104, 17446, 18437, 19131, 20295, 21435, 21873, 22601, 23805, 24989, 25649, 25749]","[464, 749, 998, 1505, 1843, 2470, 3394, 4036, 4304, 4894, 5330, 5887, 6144, 6994, 7667, 8464, 9040, 9577, 10130, 11636, 12309, 12592, 13469, 13774, 14325, 15229, 15701, 16600, 17019, 17987, 18791, 19411, 19905, 20698, 20869]","[208, 453, 701, 951, 1165, 1614, 1924, 2153, 2761, 3094, 3664, 4098, 4505, 5398, 5958, 6643, 7057, 7505, 8049, 8759, 9229, 9339, 10708, 10803, 11862, 12294, 13247, 13597, 13939, 14465, 14946, 15525, 16143, 16778, 16982]","[232, 322, 509, 685, 793, 928, 1572, 1771, 1906, 2068, 2248, 2422, 2625, 2973, 3067, 3325, 3743, 3951, 4159, 4947, 5117, 5287, 5711, 5902, 6400, 6746, 7234, 7711, 8028, 8658, 9188, 9667, 9947, 10107, 10282]","[500, 590, 717, 885, 975, 1234, 1459, 1664, 1754, 1939, 2164, 2335, 2691, 3034, 3128, 3572, 3728, 3883, 4125, 4515, 4610, 4754, 5265, 5770, 6311, 6406, 7185, 7549, 7969, 8269, 8609, 8852, 9258, 9426, 9704]",25749,20869,16982,10282,9704,715,-2660,-1436,4103,4213,4935,35,radiant
7547417213,10,106,69,86,121,"[260, 497, 820, 1139, 1501, 1805, 2120, 2426, 2696, 3240, 3689, 4253, 5118, 5720, 6548, 6706, 7670, 8610, 9061, 9984, 11150, 11526, 12295, 13547, 14808, 15657, 16375, 17043, 17734, 18598, 20180, 20852, 21707, 23079, 24335]","[293, 777, 1055, 1318, 1774, 2271, 2715, 3127, 3627, 4127, 4693, 4876, 6146, 6653, 7205, 7780, 8408, 9597, 10275, 10980, 11333, 12129, 12798, 13722, 14757, 15394, 16029, 16720, 17254, 17943, 18705, 19315, 19727, 20544, 21114]","[274, 580, 917, 1482, 1818, 2116, 2365, 2805, 3491, 4008, 4686, 4869, 5539, 5865, 6243, 6401, 6651, 7908, 8703, 9545, 10347, 11339, 12177, 13060, 13793, 14275, 15573, 15902, 16388, 17369, 18134, 18573, 18673, 19819, 20516]","[170, 642, 784, 988, 1118, 1358, 1618, 1708, 1962, 2127, 2299, 2671, 3381, 3524, 3882, 4174, 4453, 5152, 5579, 5786, 6180, 6409, 6878, 7219, 7615, 7900, 8290, 8467, 8943, 9262, 9506, 9696, 9870, 10427, 11159]","[170, 310, 400, 661, 1036, 1248, 1555, 1911, 2117, 2585, 2788, 2971, 3300, 3648, 3906, 4064, 4159, 4408, 4594, 4752, 5165, 5394, 5561, 5890, 6154, 6487, 6877, 7215, 7782, 8106, 8669, 8859, 8959, 10012, 10698]",24335,21114,20516,11159,10698,94,60,107,20,45,"[204, 506, 893, 1233, 1671, 2009, 2260, 2679, 3130, 3785, 4239, 4907, 5497, 6328, 6975, 7985, 8792, 9242, 9336, 10046, 11048, 11876, 12757, 13283, 14919, 16029, 16890, 17789, 19113, 20806, 21320, 22729, 23329, 23573, 24291]","[247, 621, 911, 1196, 1355, 1802, 2208, 2682, 3146, 3672, 4079, 5051, 5409, 5811, 6025, 6933, 7794, 8234, 8338, 8845, 9471, 9688, 10323, 10693, 11061, 11895, 13019, 13300, 13659, 13978, 14078, 14788, 15453, 16202, 16531]","[213, 461, 710, 1197, 1598, 1976, 2273, 2726, 3016, 3635, 3990, 4831, 5278, 5641, 6095, 6584, 7279, 7624, 7806, 8221, 8624, 9353, 10008, 10308, 11134, 11352, 11694, 12085, 12271, 12809, 12909, 13721, 14106, 14350, 15288]","[170, 260, 655, 785, 875, 1084, 1223, 1313, 1602, 2068, 2250, 3112, 3374, 3523, 3617, 4178, 4687, 5397, 5491, 5678, 5884, 6080, 6573, 6686, 6781, 6875, 7225, 7488, 7921, 8506, 8644, 9017, 9337, 9475, 9679]","[170, 260, 439, 613, 751, 905, 995, 1085, 1504, 1789, 1934, 2496, 2663, 2908, 3012, 3374, 4160, 4609, 4740, 4898, 5167, 5333, 5714, 5921, 6405, 6499, 6996, 7370, 7686, 7897, 7997, 8366, 8915, 9159, 9495]",24291,16531,15288,9679,9495,44,4583,5228,1480,1203,12538,35,radiant
7547652005,41,129,34,123,20,"[0, 169, 424, 798, 1118, 1609, 1922, 2339, 2849, 3283, 3865, 4505, 4825, 5307, 5822, 6193, 6648, 7272, 7760, 8960, 9337, 10076, 10767, 11284, 12770, 13721, 13816, 14734, 16128, 16764, 16860, 17431, 17995, 18690, 19713]","[0, 284, 573, 850, 1102, 1756, 2347, 2719, 3131, 3937, 4171, 4369, 4708, 5689, 5969, 6441, 6535, 7279, 7375, 7798, 8253, 8795, 9901, 10605, 11646, 11780, 11875, 12158, 13016, 13737, 13970, 14251, 14613, 14836, 15219]","[0, 205, 534, 898, 1151, 1498, 1622, 1712, 2146, 2420, 2698, 2827, 2953, 3434, 3588, 3822, 3952, 4387, 4972, 5689, 6312, 6881, 7618, 8253, 8970, 9653, 10017, 10562, 11378, 11648, 11797, 11932, 13482, 13702, 14109]","[0, 169, 341, 483, 573, 1004, 1166, 1256, 1346, 1653, 2362, 2499, 2672, 3032, 3127, 3869, 3999, 4486, 4941, 5403, 5772, 6342, 6722, 7123, 8328, 8651, 8746, 9232, 9545, 9703, 9831, 10069, 10259, 10649, 11290]","[0, 169, 331, 655, 856, 1270, 1360, 1532, 1656, 1746, 2154, 2244, 2669, 3029, 3124, 3549, 3643, 3935, 4210, 4609, 4836, 5110, 5687, 5854, 6974, 7148, 7243, 7337, 7514, 7610, 7740, 8061, 8251, 8351, 8451]",19713,15219,14109,11290,8451,54,106,28,86,65,"[0, 335, 537, 902, 1108, 1354, 1712, 2071, 2470, 2765, 3553, 4166, 4774, 5484, 5919, 6180, 6995, 7918, 8381, 8640, 9788, 10816, 11393, 12557, 12951, 14559, 15504, 16570, 17292, 18617, 20018, 20793, 21434, 22540, 24822]","[0, 282, 653, 1017, 1388, 1909, 2621, 3254, 3877, 4640, 5238, 6053, 6428, 6830, 7087, 7945, 8487, 9716, 10133, 10994, 11643, 12338, 12851, 14038, 14924, 15922, 16682, 17140, 17687, 18389, 19308, 19666, 20311, 21154, 22154]","[0, 208, 823, 1026, 1263, 1552, 1945, 2454, 3100, 3694, 4107, 4617, 5104, 5798, 6324, 7054, 7612, 8251, 9108, 9315, 9982, 10760, 11019, 11894, 12540, 13456, 14238, 15118, 15892, 16400, 17577, 18398, 18913, 19528, 20303]","[0, 169, 259, 349, 539, 715, 840, 1047, 1448, 1734, 2000, 2358, 2538, 2984, 3619, 3851, 4442, 5029, 5398, 5849, 6189, 6579, 6941, 7395, 7924, 8615, 9111, 9567, 9926, 10814, 12199, 12722, 13006, 13422, 14333]","[0, 204, 362, 531, 661, 858, 983, 1300, 1605, 2050, 2383, 2675, 3088, 3479, 3718, 4251, 4523, 5050, 5541, 6577, 7179, 7724, 8103, 8333, 8640, 8923, 9888, 10699, 11060, 11392, 12088, 12355, 12941, 13556, 14305]",24822,22154,20303,14333,14305,-5109,-6935,-6194,-3043,-5854,-27135,35,dire
7547992002,41,129,120,64,107,"[0, 330, 740, 1098, 1466, 1910, 2325, 2584, 3132, 3832, 4564, 4926, 5866, 6605, 7151, 7622, 8443, 9113, 9403, 10348, 10971, 11422, 12254, 13210, 14068, 15045, 15777, 16439, 17160, 17601, 18517, 19564, 22696, 23698, 24479]","[0, 204, 438, 713, 1452, 1770, 2022, 2375, 2708, 2946, 3502, 4019, 4385, 4951, 5342, 5648, 6118, 6537, 7077, 7668, 8092, 8289, 8883, 10112, 11403, 11991, 12196, 12701, 13071, 13466, 13783, 14924, 15880, 16665, 17085]","[0, 307, 510, 805, 1014, 1104, 1359, 1840, 2057, 2654, 3268, 4012, 4351, 5083, 5276, 5634, 6282, 6674, 7055, 7591, 8096, 8366, 9008, 9591, 10401, 11065, 11729, 12188, 12884, 13202, 13379, 14529, 15584, 16595, 17239]","[0, 170, 260, 505, 643, 782, 1178, 1313, 1542, 1808, 2168, 2422, 2637, 3088, 3237, 3591, 4200, 4426, 4521, 5102, 5414, 5714, 6243, 7089, 7571, 8102, 8594, 9006, 9572, 9803, 9987, 10305, 11299, 11905, 12307]","[0, 170, 260, 350, 641, 731, 866, 1004, 1139, 1643, 2052, 2243, 2423, 2780, 2929, 3023, 3181, 3276, 3371, 3528, 3671, 4046, 4387, 4850, 5513, 5948, 6233, 6517, 6907, 7138, 7539, 8053, 8742, 9160, 9350]",24479,17085,17239,12307,9350,36,6,99,86,20,"[0, 256, 525, 873, 1277, 1530, 2028, 2349, 2800, 3169, 3597, 3826, 4298, 5375, 5742, 6138, 6704, 7048, 7397, 8086, 8622, 9492, 9749, 9843, 9938, 10278, 10373, 11008, 12164, 12698, 13245, 13908, 14584, 14684, 15092]","[0, 222, 433, 667, 950, 1244, 1479, 1736, 2019, 2200, 2618, 2800, 3242, 3436, 3780, 4135, 4482, 5105, 5694, 6212, 6678, 7148, 7948, 8372, 8702, 9158, 9861, 10769, 11303, 12028, 12424, 12902, 13226, 14058, 14819]","[0, 170, 333, 593, 847, 937, 1162, 1289, 1424, 1584, 1674, 1937, 2063, 3070, 3243, 3522, 3800, 4262, 4652, 5099, 5399, 5766, 6187, 6448, 6743, 6838, 7274, 7595, 7890, 8194, 8353, 8502, 8707, 9021, 9296]","[0, 170, 260, 589, 679, 816, 1006, 1132, 1296, 1386, 1525, 1615, 1822, 2416, 2511, 2652, 2942, 3037, 3523, 3840, 3935, 4133, 4435, 4529, 4624, 4719, 4859, 5001, 5370, 5466, 5741, 5841, 6190, 6596, 6781]","[0, 170, 260, 350, 799, 936, 1077, 1198, 1306, 1479, 1656, 1746, 1881, 2176, 2271, 2409, 2727, 2822, 3007, 3164, 3420, 3567, 3915, 4009, 4297, 4392, 4535, 4629, 5047, 5234, 5386, 5532, 5856, 5956, 6212]",15092,14819,9296,6781,6212,9387,2266,7943,5526,3138,28260,35,radiant
7548094003,48,25,47,105,136,"[0, 284, 526, 954, 1284, 1667, 2078, 2478, 2986, 3416, 4000, 4751, 5355, 6147, 6912, 7349, 8430, 8797, 9468, 9661, 10166, 10647, 11291, 11913, 13098, 13419, 14196, 14698, 16071, 17205, 18235, 19231, 20600, 21409, 21509]","[0, 207, 547, 893, 1234, 1602, 2025, 2594, 3193, 3460, 4047, 4665, 5152, 5520, 5831, 6253, 7184, 8169, 8625, 9342, 10068, 11048, 11850, 12849, 13132, 13733, 14417, 15033, 15622, 16750, 17301, 17947, 18501, 18763, 20194]","[2, 206, 409, 663, 1004, 1129, 1483, 1702, 2040, 2400, 3104, 3609, 3908, 4103, 4323, 4684, 5259, 5717, 6106, 6615, 7333, 8254, 8716, 9126, 9623, 10072, 10759, 10898, 11396, 11985, 12406, 13189, 13547, 13903, 14049]","[0, 169, 295, 385, 700, 840, 1215, 1305, 1484, 1741, 2033, 2276, 2366, 2561, 2656, 2794, 3553, 3738, 3908, 4973, 5206, 5618, 5784, 6103, 6483, 6775, 7159, 7536, 7755, 9286, 9625, 9950, 10342, 10870, 11080]","[0, 169, 259, 527, 617, 862, 1045, 1163, 1345, 1449, 1690, 1933, 2067, 2282, 2377, 2941, 3099, 3359, 3523, 3618, 4453, 4847, 5106, 5414, 5559, 5654, 5796, 6143, 6239, 6425, 6521, 6711, 6945, 7045, 7145]",21509,20194,14049,11080,7145,114,106,123,96,79,"[60, 229, 790, 1113, 1399, 1827, 2332, 2947, 3289, 3759, 4304, 4923, 5545, 6208, 6542, 7127, 7516, 8126, 9152, 10179, 10932, 11798, 12548, 13148, 14113, 14994, 15441, 16715, 17781, 17958, 18901, 19984, 22108, 23290, 23757]","[328, 695, 1052, 1267, 1805, 2102, 2432, 3127, 3568, 4413, 5107, 5511, 6209, 7137, 7286, 7664, 8575, 9188, 9978, 10259, 10801, 11186, 12008, 12179, 13045, 13574, 14225, 14804, 15856, 16165, 16593, 17469, 18885, 20326, 20801]","[60, 229, 319, 644, 780, 1129, 1264, 1401, 1537, 2201, 2574, 2929, 3204, 3623, 4109, 4526, 5346, 5589, 6204, 6485, 7094, 7422, 7714, 7917, 8975, 9316, 9898, 10446, 11127, 11350, 11995, 12314, 12882, 14105, 14761]","[60, 302, 640, 1068, 1467, 1966, 2056, 2559, 3058, 3607, 4494, 4659, 5273, 5820, 6020, 6334, 6834, 7166, 7726, 8350, 8667, 9358, 9671, 9914, 10530, 10990, 11450, 12162, 12688, 13240, 13529, 13830, 14729, 15413, 16356]","[60, 229, 383, 526, 616, 805, 1015, 1298, 1447, 1964, 2559, 3010, 3190, 3439, 3639, 4064, 4402, 4831, 5211, 5702, 6488, 6655, 6891, 7115, 7431, 7829, 8179, 8355, 8781, 8958, 9153, 9343, 10511, 10841, 11076]",23757,20801,14761,16356,11076,-2248,-607,-712,-5276,-3931,-12774,35,dire
7548252414,67,22,2,40,20,"[0, 291, 700, 948, 1156, 1450, 1707, 2035, 2448, 2981, 3348, 3853, 4247, 4533, 4894, 5067, 5642, 6361, 6651, 7104, 8239, 8617, 9067, 9941, 10236, 11269, 11709, 12343, 13141, 14296, 15160, 15984, 16618, 17046, 17736]","[0, 219, 622, 1021, 1375, 1772, 2151, 3091, 3710, 4589, 5051, 6038, 6587, 7112, 7531, 7869, 8412, 9236, 9641, 10418, 11828, 12267, 12629, 12998, 13093, 13743, 14218, 14904, 15167, 15677, 16101, 16608, 17278, 18192, 18797]","[0, 205, 448, 831, 1235, 1491, 1780, 2272, 2657, 3677, 4111, 4647, 5279, 6037, 6949, 7381, 8181, 9513, 10362, 10622, 11773, 12145, 12882, 13306, 14065, 14539, 14634, 14968, 15168, 15734, 16179, 16955, 17235, 17735, 18004]","[0, 517, 632, 722, 904, 1004, 1141, 1415, 1505, 1845, 2067, 2389, 2908, 3034, 3444, 3640, 3944, 4587, 5079, 5514, 6035, 6419, 6852, 7396, 7888, 8334, 8477, 8816, 9040, 9445, 9805, 10297, 10912, 11430, 11620]","[0, 169, 284, 374, 464, 601, 691, 781, 919, 1309, 1444, 1604, 1920, 2191, 2338, 2433, 2771, 3600, 3981, 4138, 4412, 4670, 4765, 4968, 5193, 5470, 5565, 5794, 5890, 6459, 6882, 7182, 7664, 7810, 8206]",17736,18797,18004,11620,8206,8,97,43,27,121,"[0, 205, 472, 799, 1204, 1587, 1995, 2579, 3091, 3333, 3986, 4237, 4754, 5208, 5659, 6371, 7217, 7477, 8184, 9194, 9457, 9816, 10606, 10921, 11389, 12282, 12596, 13119, 13570, 14017, 14113, 14635, 15505, 16953, 17508]","[0, 216, 579, 938, 1354, 1928, 2276, 2569, 3113, 3619, 4346, 4686, 5284, 5962, 6471, 7163, 8063, 8295, 8912, 9323, 10288, 10832, 11445, 12011, 13251, 13529, 14376, 14636, 15777, 15873, 15969, 16362, 16462, 17204, 17691]","[0, 237, 486, 816, 1336, 1465, 1555, 1965, 2295, 2626, 3014, 3351, 3496, 3819, 4343, 4547, 5000, 5247, 5757, 6464, 6939, 7635, 8213, 8347, 9207, 9646, 9959, 10264, 10801, 11108, 11342, 12333, 12777, 13314, 13785]","[100, 269, 359, 449, 652, 817, 953, 1043, 1178, 1529, 1664, 1875, 2150, 2433, 2695, 2893, 3497, 3820, 4008, 4322, 4653, 5090, 5412, 5554, 6807, 7182, 7309, 7512, 7865, 8344, 8668, 8926, 9026, 9374, 9623]","[0, 169, 259, 397, 610, 775, 910, 1078, 1256, 1346, 1481, 1571, 1661, 2236, 2432, 2546, 2852, 3272, 3537, 3851, 4162, 4329, 4568, 4817, 5401, 5496, 5591, 5685, 5943, 6039, 6135, 6657, 6806, 7154, 7577]",17508,17691,13785,9623,7577,228,1106,4219,1997,629,8179,35,radiant
7548322301,10,98,21,100,84,"[0, 294, 709, 883, 1220, 1904, 2224, 2778, 3197, 3928, 4485, 5025, 5411, 6269, 6886, 7519, 8499, 8593, 9875, 10300, 11078, 11428, 12434, 13101, 13480, 13915, 14915, 15095, 15329, 16406, 17538, 18979, 19921, 20932, 22102]","[0, 250, 625, 1110, 1407, 1845, 2387, 2931, 3265, 3831, 4339, 5051, 5838, 6438, 6950, 7624, 8270, 8474, 9143, 9826, 10500, 11300, 11738, 12437, 13122, 13665, 14398, 14668, 15151, 16021, 17314, 19258, 19836, 20561, 21584]","[0, 241, 487, 881, 1186, 1641, 1919, 2149, 2779, 3569, 4024, 4487, 4608, 5139, 5534, 5742, 6870, 7322, 8008, 8502, 9210, 10444, 10964, 11494, 11813, 12421, 12784, 13098, 13686, 14349, 15160, 15758, 16588, 16957, 17308]","[100, 270, 360, 796, 886, 1235, 1325, 1829, 2140, 2461, 2686, 3382, 3674, 3822, 3917, 4012, 4512, 4650, 4803, 4898, 5265, 5761, 5946, 6041, 6783, 7121, 7618, 8004, 8248, 8711, 9145, 9634, 10461, 10987, 11425]","[0, 170, 260, 350, 489, 709, 799, 1080, 1260, 1462, 1687, 1905, 1995, 2188, 2299, 2394, 2993, 3133, 3273, 3493, 3588, 3714, 4119, 4289, 4459, 4906, 5223, 5478, 5649, 6328, 7051, 8169, 8819, 9104, 9369]",22102,21584,17308,11425,9369,82,22,102,58,5,"[0, 207, 468, 804, 1048, 1355, 1946, 2507, 2841, 3159, 3659, 4380, 5227, 5774, 6412, 7121, 8426, 9463, 10389, 11168, 11835, 12660, 13223, 14354, 15198, 16445, 17388, 19216, 20176, 20988, 21386, 21755, 22135, 23481, 24216]","[0, 357, 763, 1126, 1662, 2036, 3343, 3800, 4134, 5087, 5666, 6060, 7014, 7405, 7657, 8070, 8787, 9610, 10272, 11065, 11411, 12078, 12619, 12849, 13490, 14044, 14695, 15667, 16261, 16444, 16928, 17369, 18147, 18801, 19762]","[0, 170, 517, 826, 1041, 1466, 1915, 2207, 2728, 3047, 3343, 3892, 4262, 4850, 5257, 5724, 6566, 6965, 7359, 7759, 8212, 8584, 8850, 9178, 9590, 10124, 10534, 11623, 11927, 12262, 13254, 13444, 13940, 14261, 14873]","[0, 170, 285, 405, 495, 794, 1134, 1356, 1558, 1908, 2486, 2874, 3271, 3706, 3999, 4170, 4536, 4966, 5355, 5788, 5981, 6572, 6811, 7449, 7859, 8590, 8685, 9476, 9787, 9929, 10576, 11364, 11620, 11720, 13125]","[0, 170, 334, 499, 589, 725, 1080, 1260, 1423, 1513, 1787, 1963, 2358, 2602, 2798, 3148, 3562, 3836, 4097, 4567, 4782, 5110, 5429, 5659, 5927, 6547, 6917, 7661, 8128, 8224, 8596, 8965, 9207, 9447, 9799]",24216,19762,14873,13125,9799,-2114,1822,2435,-1700,-430,13,35,radiant
7548406310,106,69,93,123,31,"[329, 609, 1048, 1456, 1948, 2281, 2731, 2985, 3232, 3887, 4344, 4931, 5673, 6365, 7032, 7343, 7759, 8379, 9086, 10404, 10955, 11315, 12245, 12973, 13596, 14116, 15313, 16194, 16669, 17814, 18788, 20262, 21139, 22030, 24108]","[61, 347, 514, 932, 1233, 1551, 2020, 2429, 2828, 3670, 3891, 4252, 4893, 5627, 6319, 7340, 7963, 8505, 8706, 9478, 10276, 11013, 11731, 12339, 13101, 13618, 14996, 15648, 16231, 16767, 17590, 18552, 19141, 20091, 20734]","[61, 267, 511, 793, 1190, 1434, 1782, 2176, 2567, 3022, 3577, 4157, 4696, 5163, 5885, 6102, 6408, 7306, 7783, 8112, 9168, 9918, 10842, 11666, 12294, 12763, 13921, 14279, 14915, 15677, 16262, 16719, 17857, 18609, 19472]","[61, 230, 320, 455, 593, 683, 818, 908, 998, 1379, 1707, 2023, 2260, 2605, 3267, 3556, 4245, 4937, 5078, 5577, 5893, 6658, 7349, 7456, 7761, 7928, 8785, 8987, 9209, 9770, 10330, 10740, 11338, 12052, 12786]","[61, 230, 320, 649, 739, 921, 1179, 1435, 1525, 1889, 2069, 2257, 2446, 2816, 3520, 3941, 4162, 4325, 4466, 5014, 5211, 5618, 5886, 6081, 6286, 6528, 7046, 7821, 8082, 8363, 8725, 9187, 9563, 9973, 10708]",24108,20734,19472,12786,10708,94,120,53,97,105,"[0, 207, 540, 874, 1041, 1426, 1795, 2200, 2542, 2914, 3442, 4148, 4630, 5368, 5973, 6672, 7440, 7774, 8352, 8654, 9140, 9590, 10370, 11388, 12216, 13290, 14137, 14231, 15053, 15549, 16607, 17001, 18117, 18517, 18617]","[0, 324, 643, 1017, 1308, 1633, 2030, 2624, 3364, 3792, 4175, 4544, 5244, 5728, 6471, 7167, 7829, 8858, 9546, 10054, 10149, 10611, 11470, 11756, 12715, 13190, 13720, 14300, 14841, 15072, 15598, 15765, 16361, 16762, 17425]","[0, 169, 259, 568, 771, 968, 1320, 1823, 2044, 2367, 2540, 2748, 3054, 3213, 3641, 3894, 4102, 4622, 5074, 5504, 5863, 6596, 6913, 7081, 7276, 7803, 8525, 8962, 9353, 9584, 10211, 10311, 10907, 11637, 11799]","[0, 207, 463, 888, 1167, 1529, 1895, 2507, 2957, 3409, 3832, 3973, 4763, 5198, 5410, 5504, 5863, 6185, 6761, 7369, 7870, 8126, 8221, 8567, 8938, 9303, 9657, 9957, 10053, 10578, 10811, 10966, 11315, 11505, 11605]","[0, 169, 259, 651, 995, 1167, 1325, 1833, 2134, 2358, 2635, 2951, 3351, 3512, 3933, 4164, 4653, 4842, 5027, 5337, 5432, 5547, 5642, 5791, 6029, 6508, 6840, 6934, 7030, 7261, 7494, 7594, 7784, 8294, 8394]",18617,17425,11799,11605,8394,5491,3309,7673,1181,2314,19968,35,radiant
7548715213,89,128,2,71,105,"[1, 242, 514, 1008, 1399, 1773, 1972, 2387, 2714, 3304, 3920, 4291, 5080, 5769, 6556, 7375, 8347, 9458, 9838, 10831, 11618, 13101, 14026, 15726, 17008, 18137, 18547, 19234, 19671, 20228, 21205, 22389, 22489, 24722, 26928]","[1, 291, 659, 1002, 1495, 2196, 2681, 3250, 3726, 4534, 5047, 5479, 5822, 6748, 7637, 8214, 8308, 9319, 10052, 10320, 10838, 11741, 12486, 12932, 13098, 13458, 14398, 14695, 15653, 16539, 16765, 17962, 18709, 20598, 21872]","[1, 247, 513, 753, 1036, 1345, 1975, 2120, 2827, 3525, 4228, 4751, 5153, 5569, 6569, 7091, 7185, 8111, 8695, 9141, 9377, 10731, 11230, 12282, 13063, 13907, 14337, 15034, 15292, 15951, 16542, 17289, 17701, 18074, 18552]","[1, 171, 261, 351, 487, 678, 808, 1025, 1160, 1365, 1590, 1887, 2142, 2625, 2774, 3174, 3349, 3764, 4047, 4805, 4918, 5403, 6189, 6613, 7217, 7670, 8625, 9108, 10390, 11054, 11402, 11783, 12528, 13690, 15031]","[1, 171, 261, 785, 923, 1076, 1206, 1389, 1534, 2006, 2231, 2953, 3475, 3839, 4610, 5264, 5960, 6230, 6388, 6882, 7261, 7829, 8148, 8679, 8928, 9106, 9496, 10266, 11025, 11330, 11826, 12953, 14108, 14471, 14866]",26928,21872,18552,15031,14866,14,69,53,135,121,"[1, 196, 663, 906, 1268, 1686, 2099, 2575, 2820, 3102, 3286, 3715, 4724, 4872, 5107, 6119, 7291, 7795, 8746, 9383, 10236, 10716, 10883, 12358, 12452, 13112, 13676, 16353, 17000, 18500, 18701, 19033, 19566, 19802, 19902]","[3, 357, 601, 933, 1315, 1525, 1934, 2104, 2433, 2603, 3198, 3496, 4619, 5193, 5716, 6398, 7701, 8097, 8396, 8852, 9686, 10304, 10680, 11446, 11980, 12365, 13125, 14138, 14743, 15961, 16341, 16795, 17676, 17960, 18412]","[1, 196, 286, 376, 554, 684, 1105, 1292, 1768, 1858, 2179, 2420, 3063, 3211, 3357, 3569, 4236, 4634, 5179, 5555, 6566, 7197, 7364, 8619, 8713, 9012, 9413, 9679, 9779, 10663, 11079, 11536, 13642, 13742, 14199]","[1, 231, 360, 687, 854, 1354, 1778, 2154, 2639, 3062, 3513, 3819, 4010, 4158, 4253, 4698, 5209, 5534, 6334, 6743, 7111, 7505, 8111, 8566, 8768, 9141, 9483, 10483, 10579, 11182, 11447, 12664, 13486, 13674, 13824]","[1, 196, 286, 601, 731, 1184, 1605, 1792, 2052, 2177, 2435, 2572, 3087, 3235, 3330, 3561, 3992, 4213, 4714, 4935, 5343, 5810, 5977, 6144, 6238, 6622, 6925, 8682, 8999, 9345, 9575, 10348, 11190, 11334, 11434]",19902,18412,14199,13824,11434,7026,3460,4353,1207,3432,19478,35,radiant
7548737005,10,39,60,86,83,"[450, 700, 1185, 1573, 1785, 2417, 2673, 3498, 3829, 4782, 5899, 6475, 7008, 7574, 8117, 8948, 9896, 10863, 11436, 12404, 13483, 14258, 15013, 16228, 17000, 17960, 19827, 20535, 20631, 21224, 21938, 23127, 23996, 25472, 26498]","[749, 1132, 1543, 1972, 2285, 2582, 2967, 3542, 3913, 4790, 5267, 5415, 5783, 6149, 6591, 6786, 7243, 7589, 8478, 8816, 9737, 10258, 10746, 11196, 11912, 12273, 13314, 14160, 14765, 15990, 16875, 17697, 18066, 19170, 19369]","[560, 908, 1230, 1830, 2092, 2864, 3249, 3886, 4272, 4727, 5281, 5763, 6166, 6261, 6778, 6992, 7447, 8187, 8384, 8557, 9096, 9425, 9750, 10027, 10396, 10616, 11589, 12103, 12532, 13014, 13172, 13705, 14048, 14573, 15616]","[599, 739, 1008, 1185, 1327, 1676, 1766, 2035, 2170, 2673, 2990, 3138, 3371, 3639, 3979, 4516, 4974, 5742, 5836, 6100, 6401, 6889, 7043, 7652, 7963, 8118, 8878, 9254, 9510, 10031, 10348, 11448, 12448, 12886, 13313]","[261, 351, 536, 626, 716, 896, 1069, 1629, 1903, 2403, 2668, 3012, 3107, 3202, 3359, 3454, 3661, 3952, 4046, 4229, 4629, 4724, 4906, 5294, 5513, 5608, 6192, 6690, 6885, 7151, 7581, 7869, 8176, 8701, 9217]",26498,19369,15616,13313,9217,42,28,95,37,20,"[533, 928, 1295, 1697, 2113, 2928, 3303, 4068, 4511, 5142, 5621, 6484, 6835, 7624, 9028, 10024, 11140, 11922, 13272, 13738, 15123, 16675, 17693, 18527, 19618, 20126, 21100, 21735, 22770, 23616, 24995, 26221, 27027, 28484, 29541]","[695, 1317, 1568, 1941, 2297, 2387, 2642, 3445, 3923, 4175, 4812, 5656, 6388, 7023, 7501, 7726, 8589, 9213, 9588, 9758, 10175, 11154, 11622, 12461, 13248, 13954, 14394, 14490, 15172, 15419, 15900, 16117, 16792, 17818, 17918]","[575, 905, 1182, 1321, 1565, 1729, 1907, 2020, 2334, 2778, 2993, 3583, 3678, 4438, 5308, 5675, 6122, 6758, 7333, 7561, 8211, 8910, 9277, 10277, 10501, 11195, 11815, 12121, 12325, 13393, 13854, 14242, 14342, 14915, 15185]","[327, 969, 1152, 1472, 1713, 1803, 1941, 2569, 2801, 3102, 3192, 3796, 4111, 4444, 5233, 5434, 5667, 5825, 5919, 6014, 6636, 6913, 7007, 7568, 7663, 7758, 8060, 8213, 8403, 8758, 9273, 9473, 9641, 10685, 10859]","[327, 417, 547, 637, 825, 915, 1005, 1569, 1905, 2194, 2429, 2787, 3082, 3504, 3966, 4098, 4451, 4609, 4789, 4904, 5556, 5932, 6054, 6622, 6752, 6902, 7508, 7604, 7873, 8228, 8543, 8643, 8825, 10046, 10243]",29541,17918,15185,10859,10243,-3043,1451,431,2454,-1026,267,35,radiant
7548914808,10,39,80,91,84,"[0, 324, 633, 1101, 1478, 1987, 2504, 3079, 3810, 4418, 5160, 5908, 6531, 7247, 8092, 8668, 9481, 10107, 10835, 11558, 12463, 14506, 15672, 16726, 18524, 20081, 22907, 23756, 24690, 26179, 27020, 28657, 28757, 31659, 33538]","[0, 370, 743, 1060, 1392, 1812, 2183, 2716, 3492, 3918, 4452, 5114, 5629, 6345, 6736, 7167, 7901, 8694, 9478, 10108, 10629, 11137, 12736, 12921, 13333, 14329, 15646, 16172, 16818, 17287, 17977, 18691, 18852, 18952, 19944]","[0, 324, 669, 1110, 1520, 1988, 2331, 2979, 3741, 4045, 4596, 5503, 6461, 7268, 7362, 8009, 8329, 8840, 9674, 10119, 10767, 11295, 13066, 13251, 14323, 14772, 14948, 15337, 15599, 15695, 16108, 17186, 17525, 17625, 18548]","[0, 170, 260, 425, 561, 698, 837, 976, 1293, 1396, 1620, 1919, 2139, 2342, 2436, 2531, 2768, 2926, 3020, 3115, 3210, 3484, 3898, 4083, 4724, 5104, 5280, 5419, 5796, 5916, 6233, 6521, 6621, 7744, 8231]","[0, 170, 260, 428, 518, 655, 789, 879, 1198, 1288, 1516, 1817, 1907, 2464, 2558, 2701, 2796, 2999, 3093, 3188, 3327, 3422, 3788, 4007, 4254, 4677, 4853, 4948, 5224, 5320, 5416, 5516, 5703, 5803, 6027]",33538,19944,18548,8231,6027,114,109,28,86,64,"[0, 320, 729, 1059, 1470, 1892, 2301, 2897, 3630, 4150, 4717, 5139, 5746, 6445, 7138, 7779, 8981, 9855, 10360, 10957, 12067, 12872, 14297, 15794, 16809, 17626, 18389, 18565, 21003, 21906, 22908, 24872, 27513, 28271, 28371]","[0, 277, 675, 1049, 1357, 1574, 1934, 2245, 2658, 3043, 3455, 3830, 4522, 4988, 5611, 6269, 7745, 8557, 9287, 10281, 10872, 11760, 12035, 12923, 13659, 14192, 14287, 14919, 15383, 15759, 16992, 17593, 18983, 20243, 20403]","[0, 244, 639, 1059, 1436, 2038, 2524, 3019, 3512, 3962, 4474, 5035, 5558, 5989, 6791, 7429, 7685, 8576, 9247, 9625, 9927, 10471, 10670, 11335, 12286, 13318, 13738, 14478, 15588, 16104, 16459, 17091, 17281, 18090, 18190]","[0, 221, 311, 401, 542, 681, 816, 906, 1131, 1603, 1996, 2442, 2863, 3590, 3908, 4352, 4905, 5153, 5780, 6087, 6342, 6565, 7273, 8161, 8554, 8648, 8849, 9025, 9898, 10075, 11009, 11109, 12237, 12774, 13306]","[0, 170, 260, 350, 507, 597, 687, 813, 903, 1041, 1131, 1275, 1414, 1509, 1603, 1880, 2300, 2548, 2642, 2800, 3239, 3602, 3870, 4352, 4543, 4934, 5104, 5391, 5886, 6138, 7104, 7691, 8098, 8427, 8602]",28371,20403,18190,13306,8602,5167,-459,358,-5075,-2575,-2584,35,radiant
7548949810,8,76,107,64,9,"[283, 572, 770, 1272, 1722, 2168, 2519, 2758, 3267, 3687, 4328, 4693, 5303, 5951, 6395, 7017, 7368, 8419, 9064, 10041, 10444, 10672, 11212, 11689, 12392, 12821, 13468, 14287, 14728, 15004, 15670, 18448, 18779, 20276, 21485]","[248, 496, 994, 1328, 1795, 2075, 2728, 3216, 3581, 3934, 4388, 5209, 5541, 6310, 6713, 7180, 7359, 7911, 8403, 9400, 10080, 10540, 11542, 12569, 13634, 13897, 14477, 15683, 16312, 16408, 16508, 18222, 18322, 19397, 20701]","[241, 825, 1153, 1488, 2018, 2226, 2396, 2725, 3019, 3390, 4036, 4356, 4884, 5424, 6042, 6684, 7214, 8243, 8856, 9259, 9938, 10070, 10656, 11133, 11871, 12119, 12422, 13427, 13957, 14259, 14359, 15433, 15914, 16952, 17641]","[170, 396, 486, 679, 850, 1029, 1119, 1964, 2104, 2306, 2533, 2770, 2911, 3262, 3564, 3778, 3943, 4372, 4865, 5195, 5595, 5842, 6257, 6734, 7104, 7283, 7785, 8038, 8292, 8388, 8488, 9152, 9514, 10071, 10171]","[170, 336, 426, 556, 646, 781, 1298, 1388, 1557, 1681, 1976, 2379, 2474, 2845, 2939, 3390, 3580, 4168, 4439, 4662, 4892, 5289, 5384, 6082, 6339, 6487, 6688, 6992, 7169, 7284, 7422, 8033, 8133, 8458, 8558]",21485,20701,17641,10171,8558,54,13,102,33,128,"[615, 811, 1059, 1470, 1671, 2221, 2646, 3142, 3587, 3808, 4149, 4780, 5305, 5554, 6272, 6850, 7358, 7494, 8528, 8855, 9482, 11187, 11824, 12391, 12558, 13335, 13930, 14650, 15509, 16761, 17965, 18426, 18975, 19654, 19974]","[284, 488, 737, 1053, 1255, 1710, 2006, 2490, 2789, 3191, 3700, 3950, 4516, 5151, 5419, 5858, 6773, 7255, 7810, 8560, 9465, 10396, 10828, 11117, 11794, 12329, 12757, 13212, 13831, 14915, 15665, 16635, 16988, 17405, 17757]","[247, 529, 809, 1164, 1402, 2029, 2594, 3206, 3503, 4152, 4774, 4864, 5391, 5910, 6471, 7113, 7421, 8398, 9376, 9848, 10226, 10847, 11322, 11523, 11895, 12342, 12946, 13439, 13902, 14580, 15209, 16364, 16464, 16948, 17336]","[170, 260, 350, 520, 610, 1054, 1234, 1723, 1896, 2330, 2743, 2833, 3190, 3560, 3811, 4133, 4436, 4793, 5176, 5346, 5663, 5968, 6343, 6805, 7171, 7777, 8371, 9132, 9338, 9912, 10602, 11342, 11480, 12131, 12485]","[283, 373, 545, 690, 784, 1117, 1297, 1477, 1651, 1949, 2439, 2613, 2809, 3083, 3241, 3443, 3995, 4090, 4337, 4570, 4907, 5355, 5550, 5877, 6298, 6703, 7001, 7927, 8462, 8894, 9669, 10387, 10562, 10755, 11238]",19974,17757,17336,12485,11238,1511,2944,305,-2314,-2680,-234,35,radiant
7549153711,42,53,9,7,87,"[340, 631, 920, 1128, 1419, 1687, 2063, 2567, 3045, 3511, 4269, 4700, 5265, 6023, 6376, 7295, 8014, 8783, 10475, 11052, 12317, 13201, 14252, 15063, 16330, 17968, 19190, 20501, 22914, 24041, 25529, 26693, 27307, 27407, 28273]","[670, 1347, 1672, 2243, 2831, 3199, 3802, 4171, 4995, 5538, 6742, 7184, 7949, 8604, 9428, 10053, 10655, 11097, 11426, 12086, 12498, 12864, 13087, 13719, 14458, 15337, 16177, 16615, 17487, 18358, 19055, 19428, 20113, 21199, 21584]","[502, 654, 983, 1169, 1638, 1789, 1979, 2119, 2361, 2688, 3032, 3430, 3923, 4330, 4961, 5261, 5725, 5998, 7156, 7357, 7600, 8148, 8702, 9149, 9546, 10181, 11061, 11224, 12601, 12896, 13265, 13573, 13920, 14647, 15285]","[333, 460, 640, 863, 1296, 1506, 1599, 1689, 1896, 2416, 2637, 3077, 3564, 4098, 4543, 4753, 5266, 5462, 6182, 6377, 6780, 7124, 7294, 7776, 8440, 9022, 9945, 10116, 11170, 11435, 11882, 12057, 12477, 12942, 13565]","[578, 974, 1108, 1290, 1455, 1625, 2106, 2208, 2465, 2720, 3064, 3343, 4176, 4707, 5276, 5486, 5704, 5942, 6663, 6810, 7008, 7534, 7638, 7882, 7977, 8354, 8829, 9000, 9739, 9977, 10132, 10232, 10332, 10513, 10722]",28273,21584,15285,13565,10722,36,61,69,1,51,"[1026, 1431, 1816, 2114, 2362, 2967, 3410, 3713, 4281, 4963, 5623, 6057, 6444, 6539, 7241, 7956, 8557, 9291, 9946, 10773, 11352, 12162, 13336, 14361, 15179, 16330, 17326, 18060, 19003, 20752, 21710, 22692, 24903, 26098, 27702]","[702, 1030, 1328, 1768, 2208, 2779, 3165, 3740, 4709, 5559, 6454, 6933, 7088, 7434, 7977, 9303, 9868, 10299, 10625, 10993, 12182, 13511, 14100, 14762, 15313, 16038, 16964, 17300, 17566, 17756, 18394, 19568, 20964, 21737, 22218]","[490, 657, 933, 1063, 1605, 2452, 2772, 3217, 3856, 4427, 4805, 5526, 5760, 6339, 6972, 7542, 8012, 8701, 9255, 9735, 10253, 10756, 11481, 12305, 13439, 13694, 14628, 15320, 15576, 16450, 17238, 18055, 18709, 19509, 20126]","[322, 458, 806, 1027, 1199, 1425, 1515, 1962, 2394, 2874, 3184, 3390, 3485, 3618, 3776, 4115, 4913, 5349, 5721, 5912, 6280, 6894, 7363, 7661, 7953, 8048, 8546, 8788, 9029, 10113, 10323, 11259, 12795, 13449, 14006]","[260, 350, 488, 617, 792, 1082, 1218, 1398, 2137, 2526, 2796, 2982, 3077, 3172, 3503, 4212, 4761, 5093, 5188, 5287, 5526, 6036, 6432, 6941, 7654, 7749, 7926, 8236, 8332, 8957, 9334, 9882, 10284, 10579, 10860]",27702,22218,20126,14006,10860,571,-634,-4841,-441,-138,-5483,35,dire
7549213314,48,14,105,33,84,"[0, 257, 588, 1193, 1606, 1933, 2367, 2780, 3138, 3524, 4252, 4919, 5396, 5987, 6338, 7064, 7592, 8719, 9538, 10380, 11046, 11414, 12299, 12856, 13978, 15004, 16694, 17383, 18931, 19027, 20895, 21105, 22258, 24504, 26338]","[0, 311, 641, 1033, 1320, 1704, 2185, 2518, 3009, 3516, 4270, 4414, 5266, 5802, 5897, 6903, 7371, 8296, 8883, 9200, 9840, 10565, 10877, 11539, 12255, 12953, 14875, 16512, 17218, 17314, 17737, 18295, 19862, 20637, 21583]","[0, 169, 303, 610, 700, 790, 880, 1014, 1271, 1361, 1749, 2026, 3112, 3398, 4330, 5300, 6431, 6602, 6760, 6917, 7087, 8057, 8970, 10373, 11071, 11580, 13509, 13919, 14180, 14455, 14758, 15440, 15779, 16249, 17989]","[0, 244, 540, 858, 1174, 1379, 1605, 2037, 2199, 2447, 2818, 3274, 3609, 4090, 4326, 4870, 4999, 5442, 6002, 6179, 6565, 6933, 7497, 8201, 8434, 9185, 9940, 10526, 10812, 11244, 12813, 13023, 14184, 15034, 15134]","[0, 169, 259, 496, 630, 766, 900, 1160, 1420, 1555, 1997, 2224, 2454, 2657, 2904, 3199, 3909, 4413, 4571, 4873, 5545, 6509, 6604, 7565, 7945, 8278, 9072, 9944, 10719, 11268, 12234, 12897, 13483, 13953, 14540]",26338,21583,17989,15134,14540,76,55,46,83,26,"[0, 364, 725, 1181, 1637, 2058, 2507, 3048, 3558, 4295, 4875, 5426, 5961, 6621, 7643, 8301, 9003, 9098, 9765, 10808, 11296, 13485, 15080, 16319, 16414, 17276, 18407, 19069, 21318, 21414, 22047, 22147, 22961, 23061, 24548]","[0, 329, 704, 1085, 1355, 1954, 2602, 3115, 3393, 3823, 4423, 4641, 5677, 6594, 7772, 8346, 8963, 9252, 9512, 10511, 10941, 11694, 12377, 12947, 13533, 14097, 14701, 16092, 17548, 18272, 18998, 19593, 20251, 21393, 22246]","[0, 280, 643, 1406, 1777, 2212, 2823, 3331, 4061, 4780, 5208, 5553, 5777, 6910, 7752, 7953, 8639, 9207, 9759, 10948, 11389, 12863, 13280, 14051, 14788, 15438, 15710, 16555, 16891, 17386, 18379, 18479, 18639, 18739, 19477]","[0, 169, 277, 487, 606, 947, 1130, 1238, 1461, 1747, 1853, 2072, 2474, 2761, 3281, 3375, 3533, 3721, 3861, 4495, 4685, 5144, 5665, 6377, 6826, 7485, 7853, 8345, 8516, 9315, 9872, 10085, 10697, 10872, 11047]","[0, 169, 259, 360, 450, 633, 835, 974, 1077, 1479, 1613, 1758, 2321, 2604, 2993, 3135, 3293, 3816, 3963, 4190, 4314, 5047, 5418, 5713, 6033, 6272, 6740, 7325, 7421, 7702, 8008, 8245, 8800, 9278, 9760]",24548,22246,19477,11047,9760,1790,-663,-1488,4087,4780,8506,35,radiant
7549256701,36,120,28,83,121,"[0, 331, 658, 1074, 1415, 1660, 2150, 2493, 3183, 3397, 3952, 4394, 4745, 5230, 5775, 6051, 6590, 7396, 8098, 8681, 9894, 10184, 10507, 11033, 11241, 12047, 13843, 14557, 15058, 16434, 17117, 18242, 18342, 19644, 20891]","[0, 322, 730, 1097, 1437, 1685, 1894, 2265, 2614, 3435, 3840, 4412, 5009, 5742, 6277, 6444, 7150, 7780, 8107, 8450, 9151, 9674, 9997, 10336, 10903, 11718, 12600, 13279, 13375, 15838, 16747, 17258, 17975, 18926, 19622]","[0, 335, 499, 627, 952, 1261, 1691, 2059, 2451, 2721, 3201, 3877, 4342, 5105, 5527, 5694, 6211, 6909, 7434, 7815, 8605, 8764, 9422, 9681, 10946, 11489, 12380, 12982, 13650, 13927, 14489, 14785, 14885, 15622, 15908]","[0, 210, 405, 541, 631, 937, 1075, 1165, 1345, 1589, 2043, 2133, 2387, 2668, 2985, 3360, 3454, 3639, 3734, 4084, 4546, 4690, 5234, 5606, 6192, 6631, 6726, 6858, 7081, 8571, 9016, 9206, 9306, 9836, 9981]","[0, 210, 345, 435, 922, 1118, 1208, 1342, 1522, 1917, 2214, 2304, 2438, 2725, 3282, 3622, 3793, 3978, 4109, 4311, 4797, 4892, 5215, 5309, 5530, 5769, 6069, 6218, 6954, 7480, 8162, 8352, 8452, 9081, 9599]",20891,19622,15908,9981,9599,95,74,60,112,26,"[0, 255, 585, 913, 1305, 1694, 1979, 2573, 2927, 3262, 4012, 4433, 5117, 5855, 6449, 7606, 8280, 9172, 9777, 10500, 11258, 12606, 14690, 15354, 15912, 16806, 17760, 19334, 20341, 20763, 20859, 21603, 22510, 23412, 23978]","[0, 216, 458, 836, 1213, 1613, 2022, 2355, 2647, 2762, 3001, 3525, 4154, 4496, 5066, 6120, 6681, 7278, 7853, 8353, 8883, 9187, 10730, 11897, 12758, 13714, 14304, 14508, 14659, 14882, 15081, 16480, 16938, 17222, 17956]","[0, 178, 378, 662, 859, 1034, 1161, 1624, 2089, 2522, 3052, 3611, 3982, 4491, 4892, 5107, 5586, 6029, 6743, 7264, 7609, 7943, 8259, 8799, 9369, 9872, 10223, 10845, 11737, 11962, 12303, 12653, 13061, 13669, 14366]","[0, 130, 264, 354, 444, 534, 629, 854, 1006, 1096, 1556, 1734, 1978, 2127, 2435, 2831, 3193, 3856, 4404, 4871, 5028, 5575, 6510, 7019, 7738, 8204, 8406, 8826, 9174, 9396, 9552, 9756, 9969, 10571, 11033]","[0, 130, 220, 310, 400, 538, 628, 808, 898, 998, 1346, 1436, 1670, 1853, 2184, 2740, 3057, 3351, 3851, 4431, 4667, 4981, 5919, 6448, 6887, 7359, 7730, 8241, 8556, 9166, 9337, 9734, 10016, 10212, 10601]",23978,17956,14366,11033,10601,-3087,1666,1542,-1052,-1002,-1933,35,radiant
7549265807,28,92,21,51,5,"[0, 210, 668, 1005, 1326, 1719, 2032, 2615, 2982, 3523, 3854, 4212, 4933, 5534, 6102, 6604, 7296, 7881, 8450, 9011, 9342, 9629, 10608, 10904, 11917, 12340, 13490, 14376, 15156, 15919, 16015, 16491, 16974, 17633, 18806]","[0, 364, 682, 924, 1257, 1548, 1840, 2157, 2498, 3043, 3611, 4092, 4786, 5427, 5909, 6593, 6857, 7454, 8142, 9130, 9809, 10348, 11109, 11296, 11926, 13032, 13627, 14445, 15376, 15633, 16067, 16716, 17453, 18124, 18823]","[0, 360, 633, 912, 1134, 1632, 1968, 2459, 2986, 3307, 3877, 4385, 4815, 5611, 6033, 6514, 7123, 8048, 8635, 9665, 9960, 10174, 10773, 10903, 11938, 12778, 13395, 13939, 14668, 15244, 15873, 16754, 17349, 18607, 19786]","[0, 210, 300, 429, 519, 879, 1052, 1187, 1277, 1491, 1740, 1889, 2374, 2750, 3165, 3433, 3776, 3961, 4314, 4770, 4876, 5043, 5310, 5471, 5595, 5850, 6026, 6233, 6497, 6995, 7395, 7585, 7733, 8647, 9120]","[0, 210, 300, 454, 544, 674, 886, 1021, 1129, 1491, 1758, 2028, 2216, 2521, 2805, 3665, 3850, 4072, 4491, 5069, 5341, 5552, 5814, 5909, 6399, 6689, 6865, 7034, 7324, 7708, 7923, 8599, 8814, 9577, 9915]",18806,18823,19786,9120,9915,10,106,69,123,110,"[0, 169, 496, 817, 1133, 1378, 1867, 2391, 2833, 3299, 3820, 4314, 4894, 5386, 5886, 6600, 7036, 7637, 8460, 9290, 10240, 11483, 12441, 12698, 13282, 14290, 15139, 16166, 17001, 17964, 19167, 20546, 21128, 21627, 21726]","[0, 257, 559, 886, 1139, 1380, 1676, 1905, 2457, 2602, 2868, 3182, 3445, 3984, 4652, 4918, 5196, 5931, 6205, 6935, 7271, 8295, 8717, 9325, 9554, 10197, 10718, 11492, 12216, 12897, 13976, 14402, 14964, 15407, 15506]","[0, 205, 332, 529, 804, 1168, 1758, 2233, 2541, 2887, 3367, 3934, 4428, 4826, 5257, 6018, 6414, 7061, 7566, 7904, 8293, 9178, 9985, 10290, 10804, 11261, 11592, 12326, 12940, 13461, 14517, 15235, 15516, 16116, 16641]","[0, 178, 307, 469, 908, 1024, 1277, 1412, 1502, 1646, 1970, 2287, 2585, 2987, 3140, 3325, 3419, 3810, 4128, 4331, 4425, 4923, 5536, 5631, 6088, 6382, 6477, 6681, 6969, 7279, 7785, 7975, 8075, 8310, 8409]","[0, 174, 264, 414, 737, 870, 1101, 1308, 1482, 1621, 1796, 2180, 2402, 2741, 2957, 3142, 3345, 3618, 4011, 4262, 4477, 5198, 5556, 5651, 5914, 6113, 6208, 6491, 6779, 7199, 7295, 7660, 7884, 8119, 8278]",21726,15506,16641,8409,8278,-2920,3317,3145,711,1637,5890,35,radiant
7549315406,78,74,67,58,20,"[81, 287, 569, 1014, 1485, 1919, 2261, 2859, 3350, 4048, 4555, 5236, 5538, 5930, 6635, 7254, 7595, 8114, 8725, 9276, 10242, 10933, 11948, 12550, 13400, 14066, 14803, 15510, 16544, 17036, 17773, 18717, 19345, 20151, 21310]","[81, 210, 509, 755, 1063, 1365, 1635, 1770, 2237, 2583, 3009, 3394, 3520, 3920, 4979, 5387, 5614, 6282, 6937, 7346, 7980, 8371, 8995, 9514, 10101, 10650, 11590, 12385, 13701, 13996, 14588, 15612, 16250, 16709, 17687]","[81, 171, 442, 571, 904, 1076, 1241, 1733, 2180, 2449, 2824, 3180, 3484, 4210, 4816, 5265, 5795, 6552, 7081, 7615, 8158, 8597, 8853, 9143, 10077, 10551, 11347, 11552, 12302, 12990, 13393, 14583, 15154, 15849, 17007]","[81, 171, 261, 396, 486, 879, 1015, 1166, 1627, 1938, 2028, 2487, 2642, 3021, 3494, 3783, 4069, 4464, 4708, 5336, 5577, 5826, 5977, 6381, 6917, 7360, 7938, 8472, 9058, 9422, 9875, 10422, 10612, 10789, 11433]","[81, 171, 261, 351, 441, 531, 621, 846, 1457, 2049, 2438, 2711, 2846, 3186, 3598, 3783, 4337, 4578, 4673, 4984, 5115, 5372, 5576, 5885, 6348, 6555, 7002, 7628, 8471, 8777, 9324, 9646, 10063, 10238, 10861]",21310,17687,17007,11433,10861,80,92,21,100,103,"[1, 171, 490, 1461, 1945, 2437, 2870, 3152, 3572, 3982, 4549, 5056, 5289, 6519, 6906, 7443, 8779, 9478, 10076, 10527, 11392, 12469, 13119, 13582, 14946, 15451, 16053, 16740, 16888, 17165, 17716, 18291, 19115, 19951, 20283]","[1, 243, 445, 815, 1137, 1379, 1781, 2143, 2702, 3257, 3840, 4521, 5099, 6018, 6633, 7138, 7638, 8085, 8779, 9115, 9744, 10444, 10969, 11389, 12576, 13057, 13796, 14887, 15028, 15390, 15707, 16563, 17389, 18041, 18647]","[1, 247, 462, 902, 1133, 1302, 1585, 1868, 2295, 2601, 3308, 3744, 4650, 5410, 5559, 6130, 6820, 7520, 7833, 8317, 8632, 9212, 9539, 9877, 11602, 11973, 12217, 12697, 12793, 12889, 13367, 14376, 14764, 15112, 15635]","[1, 222, 312, 618, 807, 998, 1322, 1412, 1547, 2405, 2631, 3066, 3233, 3597, 3855, 3950, 4489, 4856, 5203, 5347, 5566, 6038, 6205, 6410, 7437, 7982, 8077, 8817, 9121, 9396, 9492, 9887, 10202, 10764, 11299]","[1, 171, 297, 434, 564, 694, 784, 874, 1009, 1315, 1621, 1788, 1956, 2531, 2680, 2883, 3305, 3463, 3693, 3896, 4167, 4520, 4687, 4892, 5218, 5629, 5724, 6598, 6733, 6829, 7221, 7616, 7716, 7860, 8119]",20283,18647,15635,11299,8119,1027,-960,1372,134,2742,4315,35,radiant
7549801106,106,21,88,128,26,"[543, 920, 1241, 1568, 1968, 2458, 3042, 3643, 4307, 4737, 5213, 5933, 6645, 7051, 7790, 8700, 9153, 9686, 10589, 11556, 12196, 12795, 13436, 14458, 15392, 15709, 16387, 17617, 18292, 19026, 19126, 19226, 20256, 21457, 22285]","[654, 871, 1274, 1673, 2010, 2405, 2847, 3163, 3427, 3691, 3824, 4341, 4896, 5544, 6201, 6415, 6786, 7467, 7834, 8514, 9269, 9851, 10755, 11544, 12041, 12589, 13062, 13499, 14544, 15197, 15603, 16180, 17211, 18471, 19244]","[497, 1239, 1865, 2268, 2567, 2902, 3267, 3752, 4281, 4559, 4702, 5520, 6340, 6657, 7113, 7532, 7743, 7965, 8811, 9390, 9556, 9815, 10000, 10635, 11103, 11270, 11800, 12381, 12867, 13214, 13455, 13737, 14055, 14660, 15294]","[266, 420, 628, 850, 1030, 1212, 1302, 1551, 2016, 2311, 2491, 3639, 3920, 4140, 4389, 4571, 5061, 5639, 5734, 6391, 6808, 6998, 7468, 7960, 8277, 8507, 8837, 9337, 9813, 10659, 10759, 10859, 11470, 12443, 12543]","[240, 330, 487, 651, 886, 1021, 1111, 1371, 1576, 1683, 1822, 2441, 2536, 2720, 3012, 3194, 3288, 3565, 3660, 4215, 4592, 5155, 5390, 5706, 6074, 6431, 6838, 7399, 7495, 8058, 8247, 8347, 8647, 9531, 9835]",22285,19244,15294,12543,9835,41,77,74,119,110,"[487, 797, 965, 1292, 1825, 2224, 2518, 2999, 3330, 3797, 4416, 5021, 5605, 6122, 6951, 7551, 9363, 10375, 10868, 11392, 12054, 12787, 13575, 14362, 15231, 15986, 16609, 17228, 17801, 18903, 19600, 20357, 20751, 21426, 22379]","[603, 845, 1135, 1452, 1711, 2421, 2695, 3123, 3591, 3999, 4279, 4726, 5148, 6103, 6661, 7524, 8632, 9428, 9914, 10154, 10729, 11280, 12170, 12795, 13398, 14020, 14693, 15016, 15503, 16891, 17973, 19198, 19785, 20763, 21451]","[547, 926, 1243, 1579, 2024, 2317, 2577, 2667, 3228, 3592, 4046, 4141, 5002, 5671, 6156, 6764, 7206, 7967, 8062, 8227, 8685, 8954, 9372, 9957, 10763, 11293, 11679, 12155, 12806, 13591, 14406, 15317, 15755, 16564, 16870]","[299, 389, 479, 569, 659, 889, 979, 1622, 1712, 2151, 2295, 2426, 2643, 2999, 3220, 3836, 4655, 4993, 5143, 5312, 5553, 5858, 6228, 6632, 6963, 7238, 7538, 7709, 8234, 8960, 9575, 9805, 10272, 10911, 11176]","[299, 389, 479, 569, 708, 890, 997, 1319, 1474, 1652, 1940, 2220, 2528, 2712, 3096, 3322, 4087, 4452, 4547, 5056, 5222, 5506, 5874, 6153, 6480, 6845, 7022, 7118, 7635, 8390, 9042, 9467, 9784, 10636, 10895]",22379,21451,16870,11176,10895,-94,-2207,-1576,1367,-1060,-3570,35,dire
7549846718,19,93,69,45,121,"[0, 359, 700, 1097, 1508, 1795, 2223, 2921, 3339, 4016, 4344, 4586, 5409, 5905, 6077, 6725, 7393, 7534, 8018, 8457, 8663, 9110, 9621, 10286, 10862, 11533, 11918, 12824, 13434, 13587, 14502, 15502, 16490, 16992, 17092]","[0, 204, 560, 924, 1175, 1389, 1680, 1924, 2184, 2566, 3065, 3751, 4131, 5054, 5432, 5938, 6673, 7199, 7688, 8516, 9075, 9642, 9737, 10243, 11185, 12012, 12840, 13224, 13496, 13706, 14017, 15426, 16091, 16731, 16991]","[0, 208, 375, 684, 895, 1207, 1612, 1936, 2425, 2705, 3236, 3722, 4346, 5029, 5201, 5471, 5949, 6554, 6960, 7802, 8278, 8827, 9082, 9841, 10161, 10635, 11090, 11780, 12134, 12230, 13014, 15109, 15685, 15863, 16123]","[0, 269, 405, 540, 718, 808, 1249, 1386, 1601, 1844, 2135, 2426, 2844, 3482, 3982, 4076, 4655, 4803, 5389, 5911, 6006, 6586, 6811, 7081, 7176, 7399, 7694, 7995, 8147, 8410, 8928, 9512, 10065, 10165, 10265]","[0, 218, 355, 567, 657, 794, 976, 1277, 1367, 1536, 1992, 2136, 2531, 2871, 3090, 3312, 3605, 3700, 3961, 4448, 4543, 4748, 4843, 5326, 5480, 5722, 6345, 6515, 6686, 6857, 7243, 7949, 8412, 8587, 8762]",17092,16991,16123,10265,8762,25,22,49,123,30,"[0, 280, 997, 1306, 1648, 1979, 2398, 2953, 3253, 3727, 3969, 4491, 4914, 5451, 6441, 6845, 7456, 8221, 8384, 9229, 10120, 10864, 11131, 11663, 12008, 12731, 13449, 14533, 15516, 16883, 17419, 17629, 17729, 18544, 19169]","[0, 241, 578, 964, 1375, 1788, 2276, 2696, 3065, 3915, 4139, 4827, 5130, 5562, 6485, 6832, 7334, 8064, 8383, 9333, 10176, 10752, 11125, 11724, 12538, 13440, 13730, 14355, 15072, 15678, 16176, 16582, 16682, 16865, 17343]","[0, 239, 509, 825, 1141, 1685, 2066, 2560, 3129, 3755, 4096, 4384, 4712, 5109, 5576, 5729, 6549, 6987, 7343, 7734, 8221, 8574, 9365, 11037, 11511, 12011, 12393, 12678, 13212, 13977, 14428, 14650, 15052, 15350, 15668]","[0, 169, 259, 349, 553, 996, 1086, 1266, 1356, 1611, 1766, 2215, 2667, 2762, 3152, 3283, 3776, 4116, 4523, 4904, 5232, 5618, 5713, 6935, 7507, 8010, 8337, 8576, 9189, 9825, 10076, 10618, 10718, 11085, 11365]","[0, 169, 546, 636, 775, 905, 1041, 1221, 1311, 1566, 1701, 2009, 2144, 2287, 2594, 2971, 3297, 3661, 3756, 4085, 4243, 4448, 4543, 4903, 5195, 5595, 5965, 6170, 6428, 6862, 7158, 7337, 7437, 7934, 8214]",19169,17343,15668,11365,8214,-2077,-352,455,-1100,548,-2526,35,dire
7549866219,19,128,69,51,79,"[0, 203, 487, 749, 1082, 1333, 1724, 2226, 2635, 3375, 3738, 4806, 5342, 6128, 6683, 7251, 8366, 9043, 9138, 9944, 10288, 10802, 12246, 13174, 13668, 14369, 14534, 15418, 15968, 16401, 16971, 17646, 18147, 19228, 20443]","[0, 239, 520, 1076, 1367, 1590, 1862, 2392, 2775, 3321, 3752, 4421, 5060, 5495, 6462, 7148, 7799, 8807, 9119, 9768, 10339, 11100, 11386, 12475, 12795, 13141, 13898, 14595, 15323, 15827, 16817, 17393, 18048, 18334, 19080]","[0, 253, 774, 1206, 1647, 1988, 2664, 3410, 4188, 4698, 5476, 6319, 7143, 7750, 8256, 8687, 9105, 9854, 10419, 11174, 11854, 12409, 13682, 14182, 14527, 14913, 15624, 16329, 16838, 18727, 19259, 20108, 20597, 21175, 21423]","[0, 202, 310, 734, 938, 1028, 1192, 1484, 1907, 2267, 2562, 2973, 3293, 3874, 4403, 4497, 4829, 5362, 5457, 5869, 6059, 6330, 7009, 7513, 7683, 8058, 8227, 8924, 9413, 9930, 10101, 10763, 11279, 11590, 12081]","[0, 169, 617, 1095, 1185, 1552, 1716, 2346, 2819, 2983, 3211, 3757, 4121, 4469, 4716, 4982, 5215, 5545, 5640, 6513, 6708, 6875, 7440, 7678, 7773, 8111, 8316, 8792, 9091, 9671, 9970, 10509, 10755, 10909, 11084]",20443,19080,21423,12081,11084,12,25,45,38,121,"[0, 358, 817, 907, 1285, 1632, 2372, 2576, 3151, 3640, 3959, 4414, 4897, 5221, 5580, 5938, 6587, 7132, 8703, 9223, 10207, 10850, 11017, 11697, 13008, 14158, 14554, 15357, 16086, 16774, 17236, 18052, 18452, 19333, 20531]","[0, 349, 718, 1047, 1455, 1905, 2378, 2859, 3258, 3676, 4285, 5061, 5151, 5474, 5959, 6380, 6835, 7020, 8042, 8833, 10000, 10215, 10809, 11501, 12335, 13070, 14536, 15311, 16116, 16340, 16770, 17226, 18220, 18829, 20104]","[0, 422, 512, 715, 853, 986, 1215, 1579, 1769, 1960, 2233, 2436, 2526, 3067, 3626, 4028, 4471, 5253, 6251, 6345, 7096, 7282, 7433, 7837, 8474, 8991, 9314, 9717, 10281, 10699, 10795, 10895, 11668, 11997, 12525]","[0, 323, 522, 886, 1174, 1410, 1902, 2148, 2506, 2647, 3125, 3475, 3604, 4075, 4676, 4818, 4976, 5434, 6535, 6708, 6991, 7314, 8548, 8848, 9459, 10402, 10925, 11677, 11977, 12453, 12549, 12649, 12864, 12964, 13718]","[0, 553, 770, 910, 1092, 1202, 1443, 1773, 1908, 1998, 2191, 2394, 2652, 2837, 3086, 3248, 3431, 3616, 4173, 4283, 4604, 4699, 4794, 5109, 5637, 6167, 6396, 6691, 6912, 7135, 7280, 7419, 7793, 8401, 8852]",20531,20104,12525,13718,8852,-88,-1024,8898,-1637,2232,8381,35,dire
7550266815,46,93,96,105,83,"[243, 606, 958, 1360, 1743, 2277, 2670, 3122, 3451, 4080, 4424, 5142, 6001, 6720, 7024, 7825, 8593, 9240, 9700, 10590, 11832, 12499, 13117, 14008, 14817, 16057, 16682, 17724, 18428, 19520, 20454, 21819, 22686, 23356, 24577]","[285, 589, 927, 1267, 1590, 2083, 2549, 2961, 3601, 4089, 4576, 5141, 6247, 6755, 6903, 7421, 8399, 8860, 9608, 10198, 10650, 11501, 12134, 12605, 13436, 14014, 14386, 15184, 16034, 16489, 17582, 18094, 18534, 18724, 19779]","[287, 495, 820, 1103, 1425, 2172, 2262, 2864, 3239, 3901, 4490, 5018, 5717, 6159, 6534, 6989, 7413, 7909, 9051, 9305, 9690, 10652, 11531, 12223, 12783, 13687, 14540, 15132, 15715, 16209, 16830, 17590, 18002, 18192, 19239]","[169, 259, 349, 483, 926, 1152, 1320, 1495, 1630, 2104, 2323, 2541, 2780, 2964, 3195, 4047, 4646, 5314, 5635, 6114, 6740, 6979, 7437, 7749, 7979, 8435, 8847, 9186, 9449, 9553, 9924, 10449, 10993, 11667, 12251]","[269, 359, 548, 674, 784, 919, 1009, 1401, 1581, 1884, 2064, 2154, 2497, 2708, 2904, 3541, 3864, 3959, 4643, 4997, 5274, 5691, 6468, 6848, 7113, 7579, 7779, 8174, 8380, 8476, 8711, 9063, 9163, 9353, 9937]",24577,19779,19239,12251,9937,15,41,13,53,19,"[203, 440, 756, 891, 1285, 1702, 2151, 2449, 2836, 3260, 3828, 4150, 4800, 5537, 6466, 6968, 7481, 8006, 8367, 8711, 9318, 10014, 10502, 10636, 11005, 11660, 12611, 13121, 13764, 14277, 15055, 16070, 16724, 17274, 17464]","[331, 533, 839, 1230, 1667, 1957, 2554, 2821, 3091, 3560, 4155, 4425, 4735, 5344, 6084, 6662, 7022, 7483, 8309, 8919, 9900, 10662, 11054, 11517, 12126, 13028, 13831, 14585, 14880, 15240, 15516, 16008, 17219, 17561, 17751]","[239, 488, 810, 1095, 1410, 1710, 2281, 2533, 2835, 3017, 3890, 4217, 4807, 5313, 6397, 6760, 7421, 7731, 8685, 9190, 9702, 10479, 11011, 11362, 12177, 13312, 14034, 14654, 15134, 15754, 15854, 16151, 16506, 16984, 17432]","[169, 259, 425, 562, 736, 965, 1322, 1412, 1541, 1795, 2191, 2499, 3084, 3445, 3985, 4143, 4496, 4693, 4912, 5007, 5268, 5671, 6152, 6351, 6686, 6971, 7304, 7643, 8214, 8457, 8601, 9200, 10006, 11165, 11430]","[169, 338, 543, 683, 920, 1055, 1280, 1459, 1549, 1664, 2060, 2150, 2476, 2877, 3348, 3593, 3851, 4194, 4838, 5019, 5114, 5281, 5561, 5771, 6210, 6394, 6525, 6751, 6872, 7182, 7282, 7603, 8083, 8320, 8510]",17464,17751,17432,11430,8510,7113,2028,1807,821,1427,13196,35,radiant
7550292203,13,41,43,100,75,"[0, 243, 601, 1021, 1383, 1826, 2350, 3026, 3540, 3993, 4625, 5314, 5859, 6177, 6738, 6994, 7486, 8160, 8619, 8902, 9682, 9849, 11013, 11466, 12324, 12588, 13473, 14216, 15060, 15846, 15942, 17255, 18959, 20168, 22690]","[0, 251, 497, 929, 1293, 1859, 2221, 2489, 2649, 3083, 3621, 4239, 4836, 5484, 5930, 6636, 7321, 7686, 8451, 9088, 10248, 10878, 12139, 13704, 14318, 14962, 15613, 16407, 17112, 17823, 18615, 18804, 20109, 21069, 22662]","[4, 264, 475, 792, 1103, 1513, 1942, 2580, 3678, 4123, 4528, 5213, 5585, 6210, 6611, 7049, 7900, 8309, 8916, 9473, 10212, 10768, 12265, 13031, 13541, 14042, 14569, 14904, 15048, 15682, 16173, 16952, 17451, 18178, 20022]","[0, 172, 266, 356, 701, 831, 1513, 1648, 1971, 2061, 2287, 2601, 3186, 3598, 4121, 4216, 4441, 4766, 4911, 5061, 5574, 5935, 6588, 7205, 7727, 8032, 8438, 8954, 9309, 9525, 9947, 10609, 11535, 12133, 13592]","[0, 170, 260, 488, 622, 837, 1371, 1583, 1907, 2066, 2341, 2877, 3106, 3344, 3638, 3975, 4353, 4511, 4606, 4996, 5622, 6169, 6970, 7487, 7748, 8234, 8439, 8725, 8867, 9015, 9111, 9427, 10620, 11370, 12839]",22690,22662,20022,13592,12839,89,90,129,110,123,"[58, 263, 539, 824, 1015, 1414, 1879, 2314, 2678, 3057, 3599, 4101, 4832, 5225, 5487, 6220, 6884, 7877, 8829, 9387, 10215, 11648, 12161, 12799, 13139, 14490, 15275, 15879, 17005, 18624, 19539, 20419, 21082, 21382, 22038]","[58, 468, 632, 1005, 1355, 1823, 2661, 3109, 3537, 3943, 4537, 4934, 5123, 5706, 6268, 7072, 7563, 8348, 9024, 9446, 9772, 10290, 10475, 10840, 11134, 11541, 12700, 12917, 13374, 14379, 14737, 15169, 15687, 15787, 15887]","[58, 313, 802, 1242, 1499, 1957, 2348, 2714, 3317, 3652, 3968, 4321, 4990, 5496, 5885, 6363, 6457, 6835, 7195, 7618, 7847, 8928, 9113, 9515, 10213, 10380, 11021, 11479, 12107, 12474, 12892, 13840, 13975, 14075, 14175]","[326, 496, 586, 723, 847, 982, 1163, 1310, 1577, 1744, 1934, 2273, 2476, 2746, 2979, 3525, 3653, 4240, 4809, 5250, 5538, 6233, 6493, 6961, 7621, 7960, 8476, 8646, 9016, 9302, 9563, 10025, 10352, 10452, 10552]","[58, 228, 381, 535, 625, 715, 943, 1159, 1434, 1524, 1832, 1982, 2220, 2512, 2924, 3176, 3289, 3864, 4181, 4742, 5082, 5419, 5604, 5749, 6090, 6360, 7137, 7839, 8579, 8914, 9657, 9756, 9856, 9956, 10056]",22038,15887,14175,10552,10056,652,6775,5847,3040,2783,19097,35,radiant
7550369811,10,17,29,110,123,"[671, 1378, 1840, 2098, 2428, 2884, 3056, 3396, 3729, 4309, 4694, 5641, 6123, 6437, 6963, 7794, 8338, 9622, 10419, 11198, 11867, 12991, 13606, 14540, 15546, 16440, 17203, 18669, 19039, 20012, 20810, 22168, 24347, 25911, 27312]","[560, 945, 1324, 1731, 2094, 2569, 2973, 3514, 4253, 4596, 4704, 5623, 5972, 6450, 7418, 8029, 8568, 9194, 9822, 10276, 10637, 11354, 11985, 12152, 12907, 14078, 14449, 15260, 15830, 16503, 17285, 17694, 18832, 19662, 20210]","[473, 883, 1086, 1211, 1475, 1865, 2081, 2409, 2920, 3304, 3757, 4269, 4875, 5266, 5538, 6704, 7512, 8071, 8750, 9190, 9826, 10293, 10886, 11466, 11815, 12191, 12639, 12735, 13143, 13840, 14262, 14656, 15874, 16644, 17507]","[284, 478, 701, 896, 986, 1169, 1358, 1557, 1948, 2076, 2295, 2715, 2810, 3389, 3571, 3970, 4592, 4827, 5115, 5255, 5511, 5965, 6060, 6227, 7098, 7510, 7937, 8373, 8971, 9071, 9719, 10191, 10476, 11270, 11709]","[319, 663, 793, 883, 1093, 1679, 2062, 2152, 2609, 2699, 2789, 3529, 3811, 4234, 4588, 5092, 5307, 5831, 6084, 6179, 6483, 6823, 7241, 7441, 8188, 8570, 8795, 8891, 9078, 9711, 10013, 10248, 11249, 11877, 12076]",27312,20210,17507,11709,12076,25,78,19,128,20,"[577, 938, 1376, 1930, 2671, 3323, 3972, 4220, 4704, 5116, 5705, 5800, 6706, 8631, 9213, 9862, 10672, 11409, 12206, 12948, 13645, 14450, 15462, 16618, 17565, 18351, 19725, 20787, 21519, 22429, 23673, 24613, 25096, 25292, 26042]","[606, 883, 1242, 1590, 1960, 2229, 2728, 3281, 3636, 4089, 4252, 4761, 5514, 6344, 7150, 7647, 8275, 8612, 8707, 9223, 9852, 10427, 10983, 11263, 11714, 12106, 12740, 13543, 14201, 15067, 15167, 15357, 15840, 15940, 16398]","[564, 806, 1133, 1469, 1814, 2076, 2369, 2992, 3583, 3932, 4248, 4541, 5068, 6115, 6654, 7106, 7772, 7930, 8396, 8728, 9334, 9888, 10462, 10673, 10826, 11486, 11902, 12799, 13239, 14355, 14455, 14763, 15508, 15608, 15708]","[259, 401, 714, 850, 985, 1170, 1830, 2337, 2764, 3265, 3747, 3903, 4188, 4464, 4777, 5093, 5187, 5629, 5855, 6069, 6298, 6535, 6870, 7125, 7321, 7768, 8474, 8837, 8933, 9358, 9458, 9648, 9898, 10122, 10431]","[294, 384, 520, 768, 1068, 1203, 1487, 1665, 1901, 2110, 2270, 2365, 2699, 3107, 3498, 3656, 3877, 4035, 4326, 4421, 4650, 4745, 4924, 5019, 5181, 5357, 6191, 6710, 6906, 7327, 7427, 7617, 7817, 7917, 8261]",26042,16398,15708,10431,8261,1270,3812,1799,1278,3815,11974,35,radiant
7550382805,48,106,80,123,20,"[869, 1203, 1697, 2055, 2444, 2803, 3217, 3385, 4166, 4759, 5598, 6305, 6818, 7684, 8366, 9177, 10060, 10913, 11870, 12760, 13495, 14231, 15167, 15893, 16976, 17903, 18681, 19998, 21605, 22073, 22416, 23395, 24226, 26280, 26705]","[922, 1264, 1508, 1891, 2432, 2890, 3224, 3650, 4197, 4402, 4892, 5324, 5650, 6279, 7065, 7753, 8211, 8575, 8843, 9188, 9652, 10575, 10831, 11141, 11647, 11743, 12609, 13135, 13762, 13896, 14562, 14806, 15826, 18238, 19041]","[888, 1178, 1505, 1628, 1991, 2655, 3032, 3603, 3842, 4282, 4776, 5005, 5379, 5667, 5913, 6378, 6915, 7413, 7976, 8604, 9244, 9570, 10206, 10738, 11475, 11617, 11867, 12190, 12776, 12951, 13088, 13188, 13417, 15777, 16787]","[479, 585, 803, 974, 1245, 1422, 1557, 1748, 1901, 2076, 2485, 2716, 2811, 3209, 3598, 3693, 3946, 4290, 4474, 4643, 5328, 5737, 5993, 6424, 7121, 7290, 7980, 8166, 8573, 8673, 8805, 8979, 9149, 10434, 10943]","[547, 779, 1033, 1162, 1252, 1462, 1597, 1954, 2044, 2187, 2585, 2963, 3086, 3333, 3458, 3553, 3709, 4019, 4497, 4592, 4712, 5038, 5328, 5472, 6269, 6414, 6856, 7042, 7403, 7503, 7674, 7804, 7904, 9180, 10013]",26705,19041,16787,10943,10013,46,63,33,136,83,"[800, 1127, 1464, 1986, 2473, 3102, 3775, 4386, 5212, 6033, 6769, 7763, 8279, 9216, 10344, 11391, 12550, 13508, 14747, 15561, 17206, 17731, 18764, 19649, 20217, 21105, 21505, 22344, 23341, 24457, 25064, 26129, 26559, 28009, 28109]","[799, 1253, 1468, 2101, 2489, 2891, 3295, 3556, 3831, 4812, 5330, 6401, 6859, 7544, 8091, 8883, 9612, 10171, 10694, 11807, 13009, 13627, 14162, 14798, 15525, 16387, 16973, 18029, 18890, 19547, 19763, 20467, 21045, 21684, 21784]","[1419, 1991, 2118, 2632, 3353, 3966, 4353, 5354, 5761, 6154, 6572, 6971, 7302, 7771, 8211, 8672, 9467, 9942, 10571, 10996, 11804, 12466, 13092, 13503, 13825, 14268, 14904, 15196, 15758, 16046, 16376, 16885, 17186, 17736, 17911]","[561, 768, 1105, 1265, 1538, 1832, 1994, 2216, 2351, 2692, 2919, 3405, 3605, 4159, 4517, 4860, 5283, 5601, 6263, 6562, 7563, 7783, 7877, 8229, 8405, 8911, 9142, 9238, 9659, 9810, 10011, 10436, 10639, 11197, 11506]","[443, 622, 801, 985, 1246, 1474, 1636, 1858, 2193, 2700, 3046, 3395, 3649, 4216, 4570, 4986, 5322, 5529, 5805, 6053, 6731, 7147, 7476, 7687, 8063, 8843, 9074, 9215, 9495, 9595, 9739, 10077, 10177, 10922, 11060]",28109,21784,17911,11506,11060,-1404,-2743,-1124,-563,-1047,-6881,35,radiant
7550385619,106,41,7,53,121,"[0, 539, 839, 1251, 1413, 1899, 2268, 2660, 3039, 3496, 3905, 4278, 4903, 5120, 5586, 6081, 6688, 7294, 7552, 8092, 8604, 8933, 9811, 10481, 11168, 12114, 12898, 13524, 14186, 15836, 16726, 17487, 17726, 18537, 18919]","[0, 278, 475, 726, 1008, 1291, 1604, 1894, 2234, 2399, 3166, 3588, 4161, 4660, 5205, 5676, 6325, 6911, 7452, 8025, 8323, 8786, 9541, 10272, 10704, 11128, 12209, 12976, 13560, 14387, 15062, 15905, 16565, 17505, 17765]","[0, 244, 474, 784, 1150, 1507, 1753, 2427, 2685, 3112, 3511, 4166, 4681, 5021, 5596, 6158, 7424, 8061, 8155, 8728, 9030, 9894, 10202, 10723, 11131, 11672, 12239, 12747, 13085, 14286, 14819, 16170, 16535, 17697, 18694]","[0, 271, 361, 734, 941, 1157, 1297, 1867, 2001, 2204, 2538, 2702, 3180, 3322, 3516, 3842, 4870, 5048, 5637, 5831, 5926, 6133, 6317, 6834, 7058, 7291, 8117, 8597, 8840, 9584, 10096, 10606, 10798, 11006, 11473]","[0, 315, 450, 773, 863, 1079, 1169, 1417, 1541, 2038, 2356, 2730, 3037, 3180, 3274, 3622, 4008, 4103, 4197, 4400, 4620, 4715, 4899, 5158, 5253, 5530, 6129, 6224, 6439, 7504, 7933, 8342, 8608, 9307, 9839]",18919,17765,18694,11473,9839,49,98,21,58,19,"[0, 202, 523, 837, 1244, 1608, 1909, 2409, 2942, 3236, 3508, 3901, 4565, 5284, 5874, 6376, 6773, 7461, 7851, 8583, 9666, 10230, 11102, 11364, 12201, 13146, 13555, 14504, 15033, 15270, 15636, 16469, 17091, 17823, 18996]","[0, 287, 531, 949, 1219, 1516, 1753, 1959, 2366, 2845, 3059, 3525, 4245, 4620, 4927, 5460, 6299, 6669, 7261, 8107, 8888, 9573, 9874, 10509, 11284, 11657, 12107, 12202, 12950, 13658, 14269, 15185, 15968, 17548, 18841]","[0, 248, 478, 725, 1234, 1438, 1775, 1981, 2770, 2958, 3338, 3866, 4152, 5046, 5493, 5923, 6864, 7646, 8288, 8718, 9716, 10242, 10703, 11524, 12252, 12811, 13609, 14197, 14714, 15282, 15438, 16036, 16396, 16831, 17224]","[0, 130, 263, 390, 525, 769, 859, 1004, 1215, 1420, 1591, 1718, 2344, 2786, 3080, 3422, 4028, 4248, 4595, 4944, 5200, 5463, 5778, 6682, 7383, 7794, 8148, 8514, 8892, 9727, 9862, 10291, 10557, 10657, 11095]","[0, 130, 269, 359, 604, 1011, 1220, 1402, 1664, 1876, 2252, 2352, 2532, 2825, 3205, 3514, 4105, 4400, 4584, 4742, 5229, 5324, 5684, 5944, 6221, 6426, 6914, 7009, 7186, 7407, 7661, 7897, 8284, 8974, 9299]",18996,18841,17224,11095,9299,-77,-1076,1470,378,540,1235,35,radiant
7550400712,138,137,101,29,31,"[205, 491, 889, 1186, 1407, 1910, 2105, 2594, 3163, 3505, 4443, 5033, 5466, 6047, 6463, 7714, 8486, 9191, 9894, 10259, 11109, 12319, 13183, 14729, 15631, 16422, 17203, 17984, 19005, 19511, 20674, 21432, 22167, 24125, 24687]","[424, 751, 1109, 1465, 1794, 2297, 2485, 2906, 3287, 3844, 4594, 4924, 5117, 5400, 6008, 6285, 6733, 7655, 7861, 8985, 9404, 10249, 10586, 11620, 12353, 13196, 13728, 14629, 15089, 16035, 16385, 16485, 16937, 17788, 17888]","[170, 594, 798, 972, 1062, 1484, 1981, 2237, 2363, 2989, 3154, 3968, 4366, 4746, 5332, 5665, 6252, 6549, 6785, 7455, 7843, 8710, 8932, 9318, 9559, 10153, 10850, 11930, 12612, 13527, 13846, 14604, 15041, 16280, 16797]","[290, 633, 801, 1155, 1531, 1827, 2088, 2484, 2822, 3527, 3838, 4256, 4734, 5181, 5734, 6199, 6902, 7088, 7554, 8373, 8853, 9578, 9941, 10543, 10638, 10948, 11279, 11879, 12425, 13166, 13276, 13499, 13830, 14724, 14942]","[170, 310, 446, 576, 666, 955, 1045, 1220, 1592, 1950, 2183, 2498, 2691, 2974, 3320, 3503, 3769, 4037, 4194, 4573, 4839, 5349, 5444, 5864, 5959, 6213, 6543, 7158, 7469, 7907, 8007, 8159, 8259, 9070, 9170]",24687,17888,16797,14942,9170,114,36,88,121,26,"[207, 409, 978, 1325, 1485, 2026, 2199, 2548, 2719, 2809, 3286, 3569, 4078, 4737, 5449, 5865, 6531, 7107, 7760, 7855, 8253, 9133, 9742, 10529, 10769, 11534, 12082, 12612, 13995, 14754, 16023, 16911, 17803, 18312, 18412]","[170, 445, 773, 1104, 1347, 1596, 1846, 2128, 2542, 2704, 3147, 3434, 3600, 3820, 4578, 5070, 5620, 6057, 6411, 6940, 7279, 7516, 7987, 8979, 9438, 9803, 10203, 10693, 11405, 12138, 13652, 14472, 14863, 15772, 16549]","[256, 589, 793, 1160, 1288, 1619, 1923, 2107, 2458, 2674, 3027, 3340, 4177, 4893, 5041, 5796, 6148, 6852, 7208, 7303, 7907, 8001, 8186, 8728, 8823, 9111, 9206, 9302, 9619, 10417, 11722, 11822, 12012, 12572, 12672]","[170, 260, 398, 533, 707, 933, 1023, 1477, 1733, 1823, 2278, 2368, 2463, 2682, 3079, 3300, 4030, 4360, 4721, 4816, 5160, 5514, 6194, 6736, 6831, 7018, 7113, 7453, 8152, 8569, 9211, 9557, 9932, 10338, 10551]","[170, 260, 528, 618, 708, 893, 1021, 1240, 1375, 1757, 2242, 2379, 2562, 2696, 3057, 3278, 3661, 4062, 4339, 4480, 4754, 4848, 5160, 5571, 5666, 5842, 6144, 6240, 7152, 7507, 7916, 8016, 8496, 8596, 8696]",18412,16549,12672,10551,8696,6275,1339,4125,4391,474,16604,35,radiant
7550636605,126,54,102,100,26,"[0, 294, 688, 1061, 1632, 2014, 2489, 2916, 3324, 3764, 4445, 4949, 5517, 5612, 6316, 6916, 7456, 7811, 8558, 9307, 10516, 11753, 13012, 13718, 14406, 15207, 16071, 16594, 17191, 18343, 19013, 20096, 20471, 20571, 22128]","[0, 244, 592, 982, 1375, 1877, 2314, 2756, 3267, 3759, 4260, 4824, 5280, 5849, 6343, 7027, 7664, 8350, 9345, 10185, 11073, 11874, 13106, 14030, 14900, 15534, 16740, 17578, 18514, 19111, 19877, 19977, 20171, 20780, 21951]","[0, 326, 619, 1500, 2000, 2690, 3175, 3630, 4220, 4708, 5662, 6068, 6603, 7088, 7641, 7918, 8165, 8545, 9319, 9975, 11139, 12580, 13514, 14004, 14745, 15408, 15884, 16871, 17769, 18274, 18505, 18605, 19558, 19770, 20540]","[0, 169, 259, 474, 690, 907, 1044, 1134, 1314, 1449, 1795, 1885, 1975, 2241, 2390, 2533, 2690, 2921, 3106, 3334, 3741, 4173, 4944, 5434, 5948, 6118, 6533, 6627, 6804, 6936, 7032, 7132, 7307, 7407, 8257]","[0, 169, 259, 364, 534, 789, 926, 1055, 1253, 1388, 1523, 1655, 1745, 1912, 2105, 2200, 2357, 2452, 2738, 3054, 3605, 4083, 4353, 4629, 4784, 4953, 5129, 5223, 5400, 5584, 5815, 5915, 6070, 6170, 6496]",22128,21951,20540,8257,6496,11,2,74,86,84,"[0, 292, 730, 982, 1446, 1625, 2066, 2436, 3152, 3625, 3953, 4119, 5031, 5644, 6202, 7916, 9145, 9989, 10618, 11302, 12015, 12110, 12205, 13035, 14195, 15156, 15920, 16690, 17380, 17867, 18768, 20155, 21645, 22912, 24983]","[0, 254, 491, 821, 1194, 1613, 2028, 2461, 3389, 4473, 4946, 5515, 6647, 7014, 7369, 8367, 9458, 9921, 10496, 11187, 11907, 12579, 12718, 12812, 13121, 13786, 14495, 15096, 15544, 16238, 17335, 18551, 19183, 19937, 20520]","[0, 257, 631, 757, 1434, 1860, 2058, 2447, 2798, 3368, 3707, 4140, 4746, 5147, 5705, 6472, 7634, 8104, 8546, 9267, 9669, 9856, 10265, 10609, 11490, 12432, 13090, 13780, 14431, 14827, 15870, 17079, 17662, 17956, 19330]","[0, 169, 311, 444, 534, 641, 776, 1166, 1511, 1786, 1921, 2184, 2681, 2944, 3318, 3736, 4471, 5138, 5645, 6306, 6662, 6832, 7097, 7536, 8122, 8609, 8889, 9400, 9857, 10718, 10889, 11675, 12142, 12792, 13959]","[0, 169, 259, 349, 484, 645, 735, 872, 1039, 1153, 1429, 1780, 1994, 2251, 2484, 3216, 3795, 3890, 3985, 4127, 4284, 4418, 4513, 4607, 4774, 4869, 5119, 5213, 5390, 5634, 5730, 6045, 6395, 6954, 7505]",24983,20520,19330,13959,7505,-2855,1431,1210,-5702,-1009,-6925,35,dire
7550680216,29,81,21,26,87,"[0, 239, 540, 839, 1243, 1488, 1866, 2208, 2691, 2820, 3549, 4047, 4756, 5458, 5857, 6397, 7076, 7617, 8617, 9774, 10314, 10959, 12174, 12774, 13572, 15087, 15398, 16450, 17505, 17897, 18410, 19257, 19915, 20358, 21108]","[0, 286, 415, 738, 1153, 1882, 2273, 2704, 3077, 3378, 4000, 4493, 5228, 5865, 6300, 6818, 7514, 8067, 9209, 10151, 11636, 12226, 14683, 15002, 15271, 16117, 16389, 17387, 18567, 18780, 19038, 19820, 20520, 20620, 20790]","[0, 243, 526, 873, 1203, 1535, 2017, 2485, 2815, 3271, 3676, 4038, 4674, 5169, 5706, 6511, 7247, 7567, 7909, 8840, 9747, 9989, 10205, 11002, 11889, 13090, 13385, 14530, 15032, 16039, 16475, 17692, 17918, 18018, 18118]","[0, 169, 259, 349, 488, 614, 807, 942, 1081, 1171, 1515, 1687, 1895, 2610, 2705, 2972, 3164, 3461, 3983, 4455, 5168, 5605, 6148, 6443, 7083, 7508, 7651, 8160, 8256, 8922, 9385, 9647, 10246, 10974, 11414]","[0, 169, 296, 433, 570, 790, 925, 1141, 1231, 1358, 1601, 1740, 2056, 2345, 2440, 2704, 2862, 3107, 3534, 3738, 4141, 4346, 5243, 5600, 6179, 6710, 6804, 7104, 7447, 7868, 8126, 8350, 8677, 8882, 9273]",21108,20790,18118,11414,9273,126,4,71,27,58,"[0, 252, 540, 912, 1411, 1712, 2080, 2465, 3065, 3706, 4089, 4527, 4975, 5918, 6411, 6664, 7565, 8489, 9258, 9578, 9865, 10420, 11747, 12369, 13278, 13821, 14547, 15476, 15572, 16442, 16954, 17295, 18872, 20908, 22095]","[0, 204, 434, 677, 1010, 1414, 1741, 2361, 2803, 3424, 3934, 4508, 4916, 5974, 6645, 7076, 8140, 8708, 9428, 9939, 10375, 10472, 10569, 11572, 12352, 12553, 13647, 14351, 14603, 15774, 16560, 16695, 17099, 18998, 20696]","[0, 169, 491, 820, 1176, 1458, 1776, 2232, 2643, 3030, 3502, 3906, 4458, 5022, 5171, 5744, 6200, 6666, 7250, 7855, 8848, 9033, 9611, 10672, 10962, 11330, 12414, 13144, 13288, 14308, 14743, 15681, 17112, 17982, 19946]","[0, 169, 259, 441, 571, 697, 836, 1016, 1228, 1363, 1498, 1716, 2354, 2602, 2964, 3216, 3524, 3756, 4281, 4680, 5033, 5130, 5656, 6924, 7871, 8057, 8578, 9264, 9360, 9909, 10230, 11039, 11611, 13451, 14287]","[0, 169, 259, 389, 556, 694, 931, 1352, 1502, 1891, 2097, 2386, 2590, 3146, 3594, 3883, 4407, 4935, 5331, 5488, 5731, 5912, 6167, 6602, 7228, 7609, 8452, 8883, 9027, 9820, 10369, 11046, 12289, 13188, 13964]",22095,20696,19946,14287,13964,-987,94,-1828,-2873,-4691,-10285,35,dire
7550704109,41,120,97,86,58,"[0, 279, 486, 843, 1131, 1369, 1698, 1959, 2431, 2904, 3331, 4145, 4620, 5365, 5981, 7035, 7730, 8730, 9338, 10098, 11162, 11917, 12381, 13598, 14385, 15560, 16383, 17369, 18594, 19232, 19863, 20604, 21449, 22898, 24322]","[0, 205, 499, 900, 1352, 1825, 2595, 2746, 3170, 3589, 4468, 4942, 5674, 6080, 6441, 6962, 8232, 8622, 8955, 10075, 11039, 11491, 12158, 12864, 13524, 13968, 14170, 14844, 15595, 16151, 16660, 16947, 18204, 18738, 20500]","[0, 285, 532, 1042, 1412, 1532, 2069, 2312, 2673, 3252, 3617, 4151, 4737, 5672, 6238, 6423, 7247, 7649, 8418, 9468, 9685, 10298, 10980, 11185, 11762, 12095, 12297, 12391, 12842, 13374, 13841, 14388, 15188, 15398, 16135]","[0, 170, 260, 432, 675, 765, 855, 1188, 1347, 1437, 1878, 2138, 2336, 2624, 3197, 3905, 4257, 4470, 4957, 5328, 6060, 6593, 6959, 7218, 7585, 8081, 8522, 8953, 9255, 9351, 9635, 10117, 11014, 11263, 12652]","[0, 170, 260, 463, 675, 841, 975, 1143, 1276, 1597, 1873, 2095, 2491, 2850, 2983, 3690, 4125, 4547, 5096, 5380, 5674, 6134, 6549, 7168, 7668, 8536, 8975, 9567, 9894, 10133, 10320, 10594, 11292, 11817, 12393]",24322,20500,16135,12652,12393,48,98,106,121,119,"[0, 206, 511, 844, 1212, 1513, 1891, 2147, 2697, 3198, 3709, 4318, 4919, 5593, 6240, 6545, 7189, 7990, 8730, 9627, 9721, 10495, 11237, 11873, 12767, 13433, 14515, 15734, 16277, 16600, 17078, 17475, 18543, 18960, 19211]","[0, 216, 455, 690, 937, 1298, 1707, 2122, 2593, 3128, 3714, 4173, 5061, 5497, 5967, 6424, 7416, 7829, 8142, 8733, 8911, 9156, 9751, 10704, 11631, 12328, 12579, 13581, 14382, 15680, 16303, 16982, 17812, 17996, 18881]","[0, 293, 627, 999, 1378, 1639, 1934, 2433, 2775, 3194, 3636, 4207, 4740, 5102, 5315, 5660, 6348, 6842, 7365, 8235, 8468, 8730, 9409, 9926, 10657, 11155, 12007, 12935, 13491, 13692, 14094, 14401, 15536, 15857, 16755]","[0, 170, 303, 393, 580, 670, 805, 941, 1089, 1333, 1502, 1804, 2300, 2536, 2631, 2863, 3083, 3854, 4011, 4426, 4629, 4799, 5041, 5451, 5854, 6809, 7634, 8123, 8419, 8971, 9142, 9539, 10353, 10499, 10641]","[0, 170, 260, 350, 440, 601, 736, 1031, 1166, 1390, 1559, 2020, 2399, 2700, 2901, 3187, 3514, 3610, 3955, 4640, 4887, 4982, 5334, 5674, 6095, 6497, 7030, 7392, 7569, 7962, 8103, 8203, 8393, 8537, 8775]",19211,18881,16755,10641,8775,5111,1619,-620,2011,3618,11739,35,radiant
7550728517,77,44,90,72,83,"[0, 289, 603, 880, 1253, 1785, 2209, 2732, 3155, 4325, 4874, 5614, 6533, 7176, 7561, 7835, 8131, 8885, 9465, 10047, 10887, 11776, 12993, 13820, 14578, 15048, 16016, 16913, 18165, 18513, 18641, 19353, 20573, 21997, 22960]","[0, 292, 728, 1157, 1484, 1899, 2359, 2865, 3322, 3850, 4265, 4928, 5464, 5869, 6532, 7044, 7549, 8459, 9350, 10368, 10866, 11070, 12015, 13200, 13747, 14206, 14900, 15166, 16013, 16190, 16456, 17961, 19616, 20487, 20729]","[0, 255, 541, 916, 1212, 1598, 1925, 2340, 2760, 3376, 4095, 4613, 5115, 5557, 6057, 6556, 7363, 8034, 8285, 8932, 9681, 10182, 11027, 11507, 12760, 13576, 14200, 14466, 15247, 15839, 16022, 16122, 16740, 17476, 17718]","[0, 170, 260, 425, 601, 1137, 1314, 1404, 1543, 1960, 2192, 2877, 3093, 3370, 3752, 4001, 4096, 4656, 5045, 5765, 6211, 6973, 7816, 8282, 8472, 8567, 9081, 9434, 10444, 10804, 10900, 12529, 13172, 14216, 15035]","[0, 170, 260, 398, 580, 719, 809, 946, 1083, 1403, 1575, 1969, 2130, 2366, 2461, 2790, 2885, 3042, 3235, 3690, 4161, 5161, 5816, 6268, 7549, 7791, 8196, 8553, 9129, 9435, 9567, 10302, 10947, 11689, 11924]",22960,20729,17718,15035,11924,48,14,43,45,5,"[0, 284, 557, 1020, 1485, 1909, 2448, 2958, 3607, 3832, 4317, 4930, 5434, 5830, 6737, 7526, 7984, 8842, 9925, 10573, 11528, 12822, 13012, 13920, 15378, 15473, 16463, 17867, 17997, 18561, 19933, 20711, 21438, 22444, 23337]","[0, 327, 660, 1073, 1493, 2044, 2873, 3326, 3999, 4443, 5140, 5650, 6123, 6640, 7156, 7424, 8479, 10038, 10591, 11381, 11586, 12574, 13089, 13444, 14369, 14464, 15281, 16045, 17747, 18737, 19938, 20770, 21197, 21540, 21875]","[0, 331, 656, 1019, 1399, 1761, 2361, 2939, 3573, 4654, 4998, 5552, 6043, 6615, 7114, 7601, 8457, 9401, 10001, 10511, 10872, 11222, 11964, 12377, 12636, 13662, 14773, 15539, 15671, 15914, 17512, 18263, 18700, 18890, 20261]","[0, 170, 260, 350, 484, 588, 678, 768, 993, 1308, 1398, 1629, 1756, 1850, 2035, 2130, 2679, 3622, 3948, 4089, 4539, 5107, 5521, 5802, 6400, 6737, 7249, 8163, 8608, 9035, 10214, 11000, 11190, 11334, 11933]","[0, 170, 260, 363, 498, 605, 695, 788, 1065, 1183, 1273, 1363, 1597, 1736, 1969, 2068, 2841, 2935, 3263, 3868, 4073, 4167, 4384, 4639, 5237, 5577, 6819, 7394, 7490, 7871, 8454, 8963, 9368, 9690, 10289]",23337,21875,20261,11933,10289,-377,-1146,-2543,3102,1635,671,35,dire
7552046611,56,51,55,105,86,"[0, 314, 710, 963, 1301, 1622, 2201, 2565, 3076, 3586, 4249, 5281, 5697, 6271, 6613, 7195, 8295, 8519, 9016, 9843, 10374, 10723, 12005, 12723, 13629, 14463, 14584, 15796, 16434, 18748, 19383, 19483, 19993, 20400, 21025]","[0, 581, 919, 1368, 1861, 2186, 2468, 3051, 3352, 3759, 4293, 4679, 5014, 5352, 5630, 5978, 6661, 7424, 8243, 8794, 9677, 9895, 10897, 11507, 11712, 12467, 12951, 14084, 14501, 15664, 16175, 16275, 16918, 17018, 18373]","[0, 199, 444, 733, 1097, 1422, 1907, 2565, 2854, 3496, 4087, 4470, 4807, 5000, 5866, 6085, 6927, 7294, 7820, 7951, 8341, 8436, 9614, 10131, 10578, 11221, 11515, 12342, 12755, 13583, 14229, 14634, 14734, 15380, 15480]","[0, 281, 574, 664, 842, 972, 1358, 1696, 1786, 2065, 2368, 2690, 3104, 3253, 3450, 4102, 4588, 4913, 5093, 5755, 5913, 6008, 6616, 6906, 7111, 7331, 7455, 8342, 8438, 9495, 10086, 10186, 10286, 10741, 11236]","[0, 281, 371, 461, 591, 721, 846, 1149, 1290, 1463, 1780, 2101, 2437, 2707, 3120, 3519, 4120, 4563, 4797, 5480, 5692, 5915, 6690, 7016, 7221, 8221, 8710, 9621, 9717, 10191, 10710, 10976, 11076, 11437, 11772]",21025,18373,15480,11236,11772,48,126,69,21,27,"[0, 363, 651, 1111, 1546, 1880, 2295, 2662, 3201, 3759, 4420, 4791, 5612, 6180, 6927, 7666, 8847, 9396, 10142, 11886, 13138, 14051, 14544, 14929, 16127, 17289, 18055, 18940, 19198, 19541, 21015, 22887, 23911, 25988, 26967]","[0, 246, 480, 885, 1293, 1644, 2123, 2530, 3145, 3683, 4038, 4642, 5627, 6588, 7102, 8253, 9197, 10020, 10495, 11707, 12373, 12468, 12653, 13383, 13478, 15482, 16211, 17213, 18241, 18992, 20063, 20897, 21966, 23128, 24751]","[0, 574, 772, 1092, 1353, 1527, 1759, 2229, 2823, 3187, 3705, 4248, 4907, 5524, 6062, 7213, 7952, 8893, 9167, 9871, 10435, 10690, 11547, 12355, 12450, 13250, 13452, 13949, 14513, 15269, 15918, 16929, 17503, 18253, 18598]","[0, 272, 382, 492, 626, 763, 957, 1131, 1467, 1728, 2085, 2268, 2755, 3199, 3607, 4294, 4710, 5112, 5849, 6148, 6600, 7122, 7680, 8025, 8238, 8736, 9199, 9646, 10407, 10709, 10880, 11617, 12192, 13627, 14018]","[0, 272, 574, 682, 772, 1115, 1205, 1343, 1665, 1929, 2019, 2109, 2308, 2501, 2695, 3085, 3443, 3929, 4061, 4887, 5222, 5446, 5631, 5824, 5963, 6851, 7201, 7782, 8312, 8655, 9232, 9934, 10270, 11397, 11920]",26967,24751,18598,14018,11920,-5942,-6378,-3118,-2782,-148,-18368,35,dire
7552136213,48,49,129,105,119,"[0, 210, 486, 1022, 1210, 1425, 1804, 2372, 2536, 2987, 3367, 3862, 4444, 5359, 6417, 7351, 8114, 9253, 10165, 10704, 10899, 11974, 12726, 12820, 13921, 14983, 15628, 17348, 18361, 19188, 20143, 21024, 21403, 21600, 21700]","[0, 373, 610, 1029, 1404, 1755, 2401, 2990, 3398, 3817, 4249, 4879, 5327, 6167, 6870, 7078, 8178, 8885, 9657, 10282, 10377, 11279, 11374, 12559, 13233, 13976, 14952, 15993, 17042, 17671, 18179, 18796, 19017, 19795, 19895]","[0, 246, 651, 1005, 1249, 1666, 2037, 2542, 2915, 3490, 3941, 4496, 5103, 5492, 6130, 6657, 6997, 7490, 7948, 8424, 8610, 9527, 9780, 9874, 10332, 10427, 11114, 11747, 12627, 12879, 13628, 13811, 14047, 14328, 14428]","[0, 330, 420, 713, 803, 893, 1321, 1703, 1963, 2148, 2529, 2761, 2905, 3179, 3777, 4269, 4409, 4623, 4959, 5458, 5789, 6310, 6544, 6746, 6964, 7663, 7917, 8263, 8440, 9020, 9500, 9887, 10296, 10396, 10666]","[0, 210, 351, 485, 575, 1040, 1215, 1535, 1625, 1805, 1996, 2119, 2594, 2849, 3198, 3462, 3807, 3902, 4392, 4524, 4754, 5312, 5500, 5669, 6173, 6343, 6715, 7656, 7908, 8006, 8126, 8249, 8349, 8630, 8730]",21700,19895,14428,10666,8730,41,25,97,26,45,"[0, 205, 565, 936, 1258, 1653, 1974, 2289, 2557, 3093, 3344, 3828, 4236, 4817, 5453, 6464, 7184, 8275, 8563, 9316, 9577, 10294, 11181, 12019, 12798, 14355, 15539, 16129, 17136, 17768, 19560, 20908, 21803, 23639, 24755]","[0, 354, 662, 988, 1316, 1698, 2034, 2383, 2833, 3350, 3779, 4516, 5061, 5658, 6392, 7508, 8044, 8424, 9016, 10289, 11395, 11685, 13201, 14685, 15282, 15959, 17136, 17585, 18400, 18946, 20445, 21347, 21907, 23620, 24913]","[0, 536, 798, 1117, 1553, 1917, 2308, 2838, 3136, 3555, 4095, 5020, 5683, 6380, 6920, 8318, 9090, 9801, 10420, 11255, 12018, 12113, 13352, 13790, 14064, 14647, 15617, 15881, 16058, 16268, 16364, 16727, 16827, 17433, 18028]","[0, 193, 319, 409, 625, 761, 851, 941, 1146, 1427, 1644, 1892, 2081, 2828, 3013, 3498, 3764, 3934, 4029, 4528, 5234, 5755, 6197, 6645, 6887, 7930, 8420, 8670, 9064, 9387, 9803, 10440, 10724, 11653, 12103]","[0, 239, 329, 467, 689, 1159, 1249, 1383, 1603, 2049, 2367, 2547, 2883, 3445, 3546, 4042, 4308, 4407, 4601, 4799, 5737, 5832, 6491, 6934, 7399, 7886, 8154, 8329, 8506, 8765, 9068, 9444, 9770, 10633, 11068]",24755,24913,18028,12103,11068,-3055,-5018,-3600,-1437,-2338,-15448,35,dire
7552190011,73,98,39,5,45,"[0, 335, 644, 1182, 1578, 1897, 2110, 2561, 3094, 3747, 4510, 5315, 5806, 6877, 8030, 8613, 9316, 10364, 11644, 12467, 12741, 13415, 14006, 14395, 14961, 15591, 16988, 17603, 18361, 18931, 20088, 20868, 22045, 22194, 23420]","[0, 292, 618, 951, 1208, 1572, 2221, 2784, 3339, 3815, 4381, 4834, 5405, 6176, 6839, 7362, 8066, 8792, 9249, 9988, 10638, 11384, 12321, 12722, 13143, 14362, 15282, 15896, 16646, 17058, 17657, 18479, 19052, 20231, 21249]","[0, 289, 521, 888, 1104, 1378, 1722, 2219, 2676, 3038, 3466, 3879, 4178, 4608, 4755, 5056, 5682, 6345, 6916, 7290, 7834, 8261, 8644, 9133, 10294, 11233, 11582, 11856, 11952, 12132, 12959, 13665, 14666, 15342, 16242]","[0, 169, 307, 443, 599, 725, 859, 1169, 1493, 1843, 1978, 2068, 2258, 2692, 2871, 2998, 3254, 3540, 3634, 3810, 3924, 4294, 4463, 4680, 5177, 5663, 5880, 6050, 6221, 6392, 7024, 7885, 8289, 8667, 9454]","[0, 169, 259, 445, 583, 759, 934, 1163, 1471, 1640, 1896, 2034, 2181, 2735, 3273, 3778, 3997, 4396, 4518, 4676, 5118, 5213, 5355, 5715, 6357, 6953, 7095, 7190, 7333, 7494, 7590, 7984, 8602, 8817, 9165]",23420,21249,16242,9454,9165,48,43,33,58,19,"[0, 204, 408, 734, 1172, 1655, 1978, 2386, 2766, 3382, 3943, 4846, 5532, 6415, 7014, 7766, 8511, 9483, 10044, 11243, 11744, 12484, 13424, 14528, 15257, 16218, 17116, 18132, 18926, 19635, 19841, 20250, 21566, 22840, 23664]","[0, 294, 651, 955, 1239, 1560, 1883, 2471, 2873, 3244, 3952, 4506, 4813, 5052, 5747, 6372, 7077, 7435, 8044, 8568, 9305, 9868, 10370, 10671, 11490, 12286, 12738, 13376, 13712, 14218, 14472, 15581, 16385, 16976, 17573]","[0, 169, 410, 741, 994, 1323, 2226, 2656, 3116, 3404, 3991, 4500, 4977, 5733, 6192, 6505, 7183, 7631, 7979, 8787, 9190, 9629, 10161, 10675, 10880, 11158, 11621, 11948, 12044, 12269, 12365, 12718, 13043, 13351, 13833]","[0, 169, 259, 349, 596, 783, 1100, 1557, 1922, 2027, 2209, 2519, 2648, 3062, 3546, 3868, 4322, 4417, 4681, 5145, 5458, 5725, 6181, 6515, 6767, 7045, 7205, 7665, 7851, 8709, 8846, 9211, 9536, 9636, 9816]","[0, 169, 259, 349, 555, 691, 931, 1178, 1344, 1434, 1687, 1867, 1957, 2223, 2590, 3089, 3756, 4205, 4490, 4672, 4991, 5369, 5610, 6151, 6477, 7241, 7410, 7624, 7843, 8122, 8508, 8877, 9119, 9219, 9319]",23664,17573,13833,9816,9319,-244,3676,2409,-362,-154,5325,35,dire
7552191700,15,106,97,110,51,"[253, 609, 906, 1072, 1366, 1661, 2165, 2549, 3034, 3626, 4297, 4870, 5555, 6524, 7003, 7818, 8324, 9189, 10049, 10910, 11711, 12716, 13740, 14181, 14935, 15630, 16795, 17355, 18476, 19303, 20419, 21897, 23425, 24472, 25741]","[331, 777, 953, 1334, 1568, 1974, 2398, 2648, 3065, 3544, 3883, 4220, 4467, 5153, 6134, 6802, 7916, 8212, 8743, 9635, 10462, 11220, 11838, 12642, 12889, 13278, 14608, 15217, 15643, 16928, 17662, 19124, 19949, 20682, 21693]","[205, 616, 796, 1162, 1581, 2154, 2621, 3206, 3745, 4312, 4534, 5149, 5873, 6278, 6712, 7288, 7993, 8668, 9419, 9978, 10697, 11513, 12147, 12948, 13532, 13660, 14965, 15276, 15665, 15922, 16592, 17811, 18653, 19185, 19616]","[176, 268, 380, 482, 703, 1262, 1442, 1599, 1823, 2080, 2246, 2440, 2905, 3397, 3752, 4209, 4519, 4649, 4898, 5201, 5600, 6120, 6467, 7129, 7444, 7681, 8644, 8815, 9229, 9791, 10108, 10781, 11578, 11948, 12409]","[515, 605, 741, 831, 921, 1011, 1191, 1301, 1499, 2002, 2496, 2729, 2824, 3424, 3616, 4043, 4544, 4745, 5063, 5351, 5605, 5918, 6231, 6700, 6942, 7111, 8549, 8765, 8984, 9155, 9687, 10296, 10915, 11169, 12109]",25741,21693,19616,12409,12109,89,17,137,86,65,"[204, 487, 727, 1121, 1332, 1648, 2127, 2570, 2988, 3398, 3934, 4462, 5275, 6290, 7041, 8109, 8831, 9991, 10814, 11565, 12255, 13245, 14318, 14936, 16606, 17520, 17615, 19025, 20004, 20970, 22314, 23377, 23954, 24598, 25469]","[326, 604, 1060, 1395, 1756, 1935, 2351, 2689, 3038, 3395, 3803, 4399, 5052, 5380, 5611, 6289, 6632, 7344, 7810, 8009, 8754, 9290, 9830, 10962, 11529, 11986, 12301, 13315, 13688, 14167, 14424, 14884, 14984, 15542, 16495]","[170, 489, 733, 1138, 1575, 1855, 2205, 2524, 2830, 3210, 3644, 4372, 5108, 5590, 6095, 6627, 6951, 7316, 7750, 8282, 8703, 9273, 9513, 9967, 10373, 10596, 10691, 11313, 11409, 11802, 12758, 13439, 13539, 14180, 15625]","[170, 308, 563, 951, 1206, 1341, 1494, 1661, 2096, 2225, 2520, 2749, 3459, 3644, 4184, 4473, 4658, 4867, 5348, 5784, 6156, 6542, 6774, 7319, 8005, 8174, 8344, 8860, 9368, 9634, 9809, 10304, 10479, 10887, 12037]","[170, 260, 350, 485, 605, 749, 886, 976, 1087, 1452, 1847, 2145, 2741, 2872, 3301, 3570, 3804, 4129, 4509, 5234, 5555, 5649, 5951, 6364, 7396, 7857, 7952, 8691, 9275, 9396, 9536, 9956, 10285, 10520, 11151]",25469,16495,15625,12037,11151,272,5198,3991,372,958,10791,35,radiant
7552353215,120,41,96,58,33,"[407, 617, 984, 1409, 1808, 1978, 2480, 3247, 3859, 4473, 4804, 5214, 6056, 6951, 7126, 7739, 8857, 9671, 10419, 10983, 11503, 11767, 12137, 12728, 13695, 14687, 15467, 16430, 17911, 18392, 19108, 20167, 20753, 21555, 22369]","[141, 351, 598, 930, 1055, 1473, 1599, 2305, 2867, 3203, 3791, 4217, 4769, 5080, 5417, 5659, 6251, 7029, 7668, 8298, 8883, 9398, 10232, 10942, 11159, 11865, 12879, 13200, 13427, 14125, 14707, 15255, 15669, 16377, 17071]","[141, 389, 729, 858, 1189, 1562, 1871, 2085, 2271, 2656, 2900, 2990, 3585, 3911, 4359, 4713, 6295, 6672, 6946, 7588, 8305, 9059, 9237, 9712, 10522, 10956, 11281, 11612, 12215, 12733, 13597, 14335, 14672, 14772, 15572]","[141, 351, 557, 647, 737, 907, 1030, 1506, 1596, 1804, 1943, 2175, 2501, 2848, 3183, 3278, 3535, 3983, 4114, 4854, 5906, 6369, 6618, 6897, 7729, 8751, 9424, 9689, 10766, 11323, 12090, 12778, 13227, 13563, 14073]","[141, 544, 678, 805, 926, 1155, 1288, 1925, 2173, 2596, 2804, 3042, 3813, 4078, 4247, 4342, 4994, 5667, 6160, 6439, 6677, 6861, 7157, 7418, 8417, 9717, 9932, 10330, 10606, 10926, 11240, 11827, 12179, 12279, 12753]",22369,17071,15572,14073,12753,137,21,92,14,71,"[122, 599, 935, 1263, 1682, 2478, 3104, 3736, 4154, 4482, 4893, 5643, 5733, 6392, 7534, 8096, 8336, 9045, 9539, 10185, 10816, 12019, 12907, 13425, 14033, 14127, 15325, 16005, 16791, 17382, 17975, 18550, 18650, 19194, 20184]","[122, 359, 644, 1039, 1424, 1802, 2162, 2521, 3459, 4025, 4557, 5176, 5645, 6165, 7138, 8018, 8176, 8552, 9139, 9937, 10591, 11617, 12381, 12699, 13098, 13647, 14561, 15463, 15857, 16857, 17357, 17647, 18322, 19023, 20040]","[523, 928, 1214, 1565, 1946, 2194, 2723, 3083, 3295, 3914, 4398, 5033, 5328, 5423, 5975, 6558, 7072, 7578, 7783, 8257, 8834, 9356, 9931, 10780, 11404, 11498, 12150, 12935, 13112, 13988, 14433, 14810, 15431, 15777, 16800]","[122, 292, 382, 687, 863, 1143, 1361, 1821, 2002, 2440, 2734, 2907, 2997, 3240, 3571, 4089, 4316, 4747, 5290, 5448, 5849, 6303, 7000, 7312, 7758, 8641, 8892, 9359, 9611, 9899, 10967, 11809, 12468, 12643, 13227]","[122, 403, 493, 583, 751, 986, 1116, 1333, 1753, 2065, 2870, 3097, 3344, 3581, 4245, 4557, 5087, 5957, 6356, 6580, 6852, 7466, 8167, 8449, 8728, 8822, 9692, 10394, 10571, 10836, 11411, 11701, 12375, 12807, 13612]",20184,20040,16800,13227,13612,2185,-2969,-1228,846,-859,-2025,35,radiant
7552498805,129,13,21,65,5,"[1818, 2015, 2604, 3010, 3732, 3913, 4450, 5697, 5792, 6333, 6817, 7619, 8316, 9265, 9845, 10667, 12020, 12480, 13024, 13369, 14107, 15053, 15755, 16255, 17038, 17603, 18504, 19001, 19555, 20804, 22102, 22795, 23730, 24641, 25213]","[1884, 2197, 2612, 3024, 3333, 4101, 4684, 5316, 5687, 6106, 6727, 7865, 9024, 9606, 10107, 11154, 12470, 13194, 13395, 14181, 14827, 15629, 16568, 17103, 17402, 18401, 18591, 18912, 19012, 20276, 21275, 21968, 22389, 22811, 23762]","[1642, 1852, 2066, 2407, 2911, 3079, 3333, 3710, 4159, 4575, 4984, 5515, 6820, 7331, 7919, 8695, 9774, 10333, 10428, 11457, 12169, 12973, 14069, 14165, 14803, 15166, 16219, 16768, 17465, 18608, 19853, 20500, 20600, 20700, 20998]","[986, 1147, 1639, 1869, 2388, 2730, 2855, 3328, 3620, 4218, 4594, 5322, 5949, 6484, 6904, 7337, 7658, 8341, 8815, 9235, 9844, 10106, 10433, 10838, 11245, 11751, 12425, 12687, 13204, 13956, 14317, 14793, 14893, 15024, 15454]","[1094, 1255, 1562, 1712, 2153, 2426, 2584, 2912, 3213, 3427, 3522, 3750, 4636, 4809, 4904, 5337, 5766, 5861, 5956, 6301, 6540, 6931, 7310, 7406, 7583, 7783, 8232, 8416, 8516, 10007, 10559, 11109, 11315, 11664, 11953]",25213,23762,20998,15454,11953,90,14,112,20,100,"[1707, 2481, 2866, 3415, 4186, 4948, 5293, 5504, 5920, 6674, 6977, 7319, 7572, 8051, 8439, 8787, 9343, 10172, 10939, 11659, 12270, 12784, 13642, 14594, 15127, 15689, 16750, 18229, 19060, 20141, 20414, 21937, 23176, 24039, 24768]","[1831, 2105, 2609, 2950, 3468, 4039, 4585, 5199, 5920, 6560, 7069, 7584, 8180, 8764, 9274, 9907, 10242, 11683, 12489, 13411, 14032, 14752, 15698, 17404, 17827, 18499, 19666, 20946, 21883, 23322, 23422, 24031, 24483, 24994, 25915]","[1002, 1306, 1979, 2269, 2790, 3327, 3847, 4204, 4837, 5748, 6226, 6448, 6739, 7304, 7624, 7852, 8187, 8682, 9192, 9722, 9919, 10494, 10907, 11003, 11617, 12113, 12601, 13147, 14105, 14437, 14537, 15331, 15753, 16138, 16627]","[977, 1244, 1538, 1871, 2411, 2838, 3089, 3224, 3940, 4417, 4791, 5047, 5142, 5569, 6036, 6130, 6646, 7831, 8246, 8449, 8756, 9500, 10028, 10457, 10761, 10904, 11483, 11938, 12597, 13104, 13427, 14121, 14459, 14921, 15372]","[879, 1252, 1499, 1676, 2455, 2851, 3044, 3179, 3515, 3848, 4250, 4610, 4705, 4800, 5021, 5115, 5450, 5859, 6116, 6511, 6606, 6982, 7241, 7862, 8039, 8216, 9079, 9476, 10056, 10470, 10570, 11330, 11529, 11803, 11903]",24768,25915,16627,15372,11903,445,-2153,4371,82,50,2795,35,radiant
7552578103,95,25,112,86,19,"[252, 671, 1006, 1440, 1715, 2129, 2747, 3419, 3986, 4384, 4736, 5299, 6079, 6274, 7302, 8171, 8799, 9553, 10350, 10773, 12029, 13390, 13924, 14490, 16223, 17067, 17813, 18839, 19672, 20944, 21997, 23304, 24808, 25833, 26619]","[333, 777, 1142, 1538, 1964, 2411, 2757, 3220, 4038, 4615, 5348, 5900, 7302, 8106, 8688, 8845, 9105, 9572, 10286, 11599, 12346, 13479, 14419, 15219, 16065, 17122, 17576, 18397, 18958, 19755, 20590, 21329, 22176, 23077, 24143]","[205, 551, 826, 1235, 1596, 1995, 2456, 2911, 3284, 3752, 4285, 4591, 5188, 5569, 5924, 6460, 6663, 6896, 7301, 7569, 8153, 8521, 9147, 9486, 10285, 10969, 11710, 12158, 12407, 12931, 13928, 14718, 15396, 16315, 16802]","[170, 695, 889, 1019, 1230, 1567, 1906, 2042, 2349, 2524, 2614, 2788, 3527, 3729, 4107, 4454, 4614, 5135, 5465, 6120, 6492, 6935, 7301, 7660, 8234, 8773, 9052, 9410, 9720, 10499, 11101, 11292, 11893, 12278, 12821]","[170, 514, 604, 810, 900, 1113, 1307, 1514, 2047, 2182, 2272, 2554, 3113, 3589, 3927, 4132, 4521, 4849, 5076, 5650, 5948, 6316, 6607, 6993, 7293, 7566, 7861, 8383, 8786, 9103, 9876, 10211, 11281, 11756, 11946]",26619,24143,16802,12821,11946,49,1,105,14,20,"[325, 645, 1057, 1467, 1870, 2237, 2540, 3073, 3396, 4002, 4493, 4963, 5384, 5713, 6363, 6742, 7478, 7991, 9189, 9982, 10167, 10435, 11341, 12188, 12699, 13625, 14517, 15281, 15883, 16079, 16178, 16941, 17744, 19355, 19750]","[241, 434, 722, 955, 1232, 1474, 1653, 1743, 1939, 2347, 2728, 3123, 3747, 4289, 4869, 5697, 6379, 7135, 7697, 8559, 9434, 10048, 10143, 10998, 11622, 12181, 12658, 13689, 14273, 15407, 16396, 17280, 17472, 17572, 18744]","[170, 260, 397, 636, 1232, 1406, 1541, 1670, 1760, 2250, 2674, 2954, 3049, 3731, 4296, 5041, 5535, 5889, 6073, 6539, 6996, 7238, 7599, 8060, 8755, 9006, 9175, 9787, 10032, 10800, 10911, 11371, 11674, 11984, 12255]","[208, 498, 800, 1212, 1786, 2036, 2372, 2571, 2826, 3137, 3620, 4118, 4213, 4770, 5052, 5349, 5614, 5968, 6643, 6930, 7203, 7601, 7874, 8160, 8887, 9463, 9812, 10258, 10770, 11221, 11431, 11633, 11733, 12079, 12279]","[256, 346, 436, 561, 735, 950, 1090, 1180, 1270, 1815, 2047, 2270, 2400, 2697, 3117, 3540, 4051, 4537, 5038, 5399, 5584, 5751, 5846, 5940, 6197, 6567, 6661, 7454, 7550, 7993, 8165, 8265, 8365, 9054, 9489]",19750,18744,12255,12279,9489,6869,5399,4547,542,2457,19814,35,radiant
7552578501,89,80,38,86,20,"[206, 452, 750, 960, 1171, 1579, 1985, 2563, 2936, 3508, 4220, 4971, 5947, 6638, 7501, 8371, 9776, 10732, 11433, 12643, 13233, 14164, 15046, 16729, 17785, 18913, 19999, 20997, 21901, 22583, 23189, 23489, 24230, 25412, 26237]","[300, 654, 1034, 1490, 1854, 2239, 2737, 3381, 4251, 4570, 5263, 5729, 6462, 7086, 7659, 8306, 8501, 8853, 9358, 10405, 10500, 10642, 10930, 11864, 12787, 13365, 13826, 15086, 15723, 16169, 16986, 17682, 18312, 18924, 19763]","[205, 369, 723, 1191, 1539, 2052, 2461, 2718, 3386, 3953, 4456, 4812, 5742, 6836, 7351, 7976, 8181, 8737, 9243, 9890, 10117, 10652, 11149, 12412, 13084, 13862, 14215, 14787, 14987, 15462, 16161, 16681, 16909, 17400, 17821]","[170, 304, 394, 976, 1141, 1648, 1965, 2271, 2631, 3263, 3587, 3785, 4692, 5092, 5486, 5927, 6092, 6528, 6930, 7434, 7529, 7624, 7830, 8580, 8926, 9378, 9519, 9998, 10094, 10438, 11114, 11477, 11977, 12454, 12743]","[170, 318, 425, 633, 769, 1214, 1374, 1594, 2054, 2439, 2597, 2893, 3654, 4362, 4668, 4889, 5054, 5437, 5666, 6237, 6332, 6665, 6971, 7803, 8246, 8514, 8806, 9514, 9610, 10471, 10906, 11319, 11682, 11907, 12309]",26237,19763,17821,12743,12309,41,137,92,26,19,"[205, 440, 601, 1039, 1478, 2030, 2377, 2676, 2934, 3551, 4053, 4722, 5289, 5486, 6000, 6539, 7387, 8234, 9129, 9224, 10901, 11632, 12593, 12842, 13541, 14130, 14473, 15166, 16053, 16828, 17941, 19697, 21502, 22144, 23230]","[201, 363, 568, 770, 1192, 1736, 2277, 2671, 2969, 3645, 4035, 4596, 5355, 5780, 6517, 7057, 8202, 8734, 9700, 10112, 10590, 11216, 11778, 12519, 12791, 13405, 13562, 14252, 14546, 14897, 15724, 16461, 17105, 18210, 18821]","[212, 529, 904, 1216, 1467, 2047, 2454, 3089, 3780, 4095, 4701, 4926, 5607, 5945, 6573, 7153, 8706, 9144, 9877, 10428, 11433, 12015, 12392, 12641, 13058, 13568, 13707, 14359, 14494, 14940, 15501, 16568, 17580, 17918, 18348]","[264, 354, 483, 688, 1196, 1425, 1560, 1780, 1960, 2197, 2703, 2848, 2943, 3038, 3223, 3380, 4167, 4392, 4781, 5304, 5971, 6816, 6985, 7347, 7964, 8351, 8578, 8866, 9148, 9657, 10126, 10850, 11402, 11592, 12065]","[232, 326, 460, 860, 950, 1294, 1514, 1787, 2025, 2294, 2565, 2828, 3099, 3241, 3620, 4227, 5049, 5144, 5807, 6349, 6875, 7428, 7725, 8413, 8717, 9069, 9367, 9544, 10291, 10912, 11012, 11202, 12076, 12311, 12665]",23230,18821,18348,12065,12665,3007,942,-527,678,-356,3744,35,dire
7552718510,48,65,112,19,91,"[0, 124, 425, 586, 787, 1103, 1545, 1964, 2377, 3051, 3791, 4656, 5270, 5990, 6328, 7211, 7956, 8741, 9874, 11028, 11990, 12912, 13657, 14625, 15791, 17085, 18946, 19969, 21306, 21988, 22799, 23913, 25313, 26635, 29205]","[0, 246, 565, 972, 1386, 1682, 2164, 2715, 3249, 4444, 4770, 5682, 6268, 6832, 7836, 8702, 9374, 9776, 11000, 11468, 12004, 12743, 12926, 13840, 14553, 15466, 15936, 16077, 16608, 17076, 17526, 18257, 19647, 20011, 21300]","[0, 158, 392, 673, 776, 1142, 1387, 1660, 1838, 2145, 2457, 2895, 3376, 3561, 3828, 4193, 5070, 5427, 5965, 6591, 7048, 7675, 8284, 8689, 8797, 9853, 10204, 11091, 11349, 12028, 12556, 13583, 14152, 14666, 15510]","[0, 90, 180, 270, 360, 702, 837, 1096, 1371, 1716, 2188, 2563, 2758, 3107, 3379, 3708, 4255, 4569, 5252, 5642, 5939, 6270, 6663, 6905, 7226, 8146, 8481, 8651, 8950, 9256, 9476, 9822, 10207, 10569, 11595]","[19, 211, 301, 408, 516, 665, 818, 953, 1301, 1537, 1755, 2079, 2179, 2322, 2625, 2855, 3194, 3351, 3850, 4078, 4384, 4780, 4947, 5114, 5208, 6060, 6396, 6491, 6958, 7189, 7285, 7711, 8021, 8380, 9371]",29205,21300,15510,11595,9371,98,25,33,7,20,"[0, 360, 725, 1094, 1224, 1520, 1798, 2193, 2778, 3371, 3998, 4442, 4765, 5282, 6149, 6320, 6690, 7372, 7854, 8796, 9424, 10288, 10887, 11679, 12260, 12873, 13043, 14082, 14834, 15586, 16472, 17724, 19030, 19536, 19636]","[0, 336, 566, 1004, 1429, 1682, 2384, 2984, 3392, 3814, 4181, 4602, 5002, 5577, 6285, 6697, 7776, 8442, 8816, 9572, 10356, 11318, 12066, 12749, 13203, 14014, 14109, 14814, 15666, 16301, 17111, 18036, 18136, 18832, 18932]","[0, 285, 694, 1045, 1416, 1794, 2125, 2577, 3029, 3398, 4187, 4300, 4702, 5249, 5753, 6056, 6306, 6812, 7084, 7565, 8008, 8505, 8717, 8948, 9369, 9775, 10129, 10809, 11146, 11518, 12078, 12702, 12968, 13244, 13418]","[0, 250, 340, 765, 940, 1074, 1164, 1254, 1414, 1549, 1971, 2061, 2562, 3007, 3726, 3999, 4215, 4358, 4453, 4674, 4769, 5168, 5380, 5739, 5837, 6249, 6665, 7294, 7657, 8007, 8411, 8970, 9587, 9687, 9999]","[0, 250, 469, 653, 901, 991, 1159, 1331, 1491, 1761, 1986, 2218, 2355, 2557, 2882, 3067, 3225, 3319, 3585, 3854, 4056, 4387, 4557, 4862, 5034, 5475, 5645, 5815, 6067, 6311, 6517, 6940, 7120, 7220, 7320]",19636,18932,13418,9999,7320,9569,2368,2092,1596,2051,17676,35,radiant
7552731302,17,56,96,123,83,"[0, 254, 528, 1027, 1559, 2260, 2597, 2906, 3427, 4083, 4787, 5245, 6127, 6787, 7378, 8002, 8968, 9498, 9807, 10317, 10885, 12185, 12580, 13163, 13974, 15191, 16044, 16742, 17344, 18031, 18595, 19172, 20551, 21566, 22388]","[0, 164, 431, 770, 1058, 1345, 2006, 2261, 2468, 3055, 3422, 3916, 4571, 4937, 5720, 6408, 7086, 8439, 9129, 9868, 10297, 11518, 12088, 13149, 13992, 14717, 15389, 15897, 16169, 16786, 17154, 18122, 19052, 19718, 20414]","[0, 164, 396, 676, 1336, 1937, 2316, 2564, 3111, 3794, 4292, 5164, 5491, 6143, 6826, 7048, 7774, 8508, 8968, 9526, 10096, 10936, 11485, 11905, 12566, 14199, 14604, 15044, 15390, 16197, 16403, 16981, 17790, 18360, 18550]","[0, 130, 220, 710, 966, 1152, 1434, 1524, 1708, 1832, 2372, 2606, 2928, 3556, 4035, 4130, 4698, 5477, 5742, 6066, 6435, 7373, 7630, 7813, 8237, 8925, 9695, 10443, 10539, 11058, 11430, 11835, 12110, 13002, 13369]","[0, 130, 220, 354, 484, 618, 846, 981, 1116, 1321, 1456, 1830, 1999, 2403, 2803, 3037, 3461, 3803, 3898, 4512, 4762, 5257, 5760, 5956, 6123, 7038, 7378, 7624, 7720, 7937, 8143, 8548, 8796, 9150, 9384]",22388,20414,18550,13369,9384,48,82,129,58,45,"[0, 282, 515, 838, 1324, 1414, 1718, 2274, 2722, 3257, 3831, 4280, 4945, 5867, 6171, 6777, 7610, 8563, 9659, 10590, 11406, 12436, 12835, 14356, 15490, 16264, 16548, 18502, 19912, 21068, 21782, 22645, 23887, 24498, 25034]","[0, 281, 574, 838, 1219, 1805, 2371, 2706, 3143, 3345, 3671, 3944, 4076, 4463, 4942, 5531, 5987, 6242, 6865, 7414, 8025, 8481, 8576, 9167, 9654, 10121, 10216, 10809, 11772, 12829, 13183, 14169, 14694, 14953, 16155]","[0, 249, 683, 1115, 1497, 1967, 2498, 2826, 3358, 3736, 4173, 4902, 5431, 5613, 5809, 6265, 6433, 7989, 8084, 8635, 9169, 9263, 9441, 9859, 10106, 10321, 10523, 10618, 11291, 12116, 12933, 13563, 14239, 14598, 14834]","[0, 210, 325, 415, 642, 735, 911, 1120, 1340, 1669, 2080, 2418, 2696, 3047, 3430, 3679, 3837, 4206, 4610, 4768, 5050, 5251, 5524, 5942, 6480, 7164, 7669, 8366, 9508, 10309, 10405, 11091, 11547, 11737, 12081]","[0, 210, 369, 507, 597, 795, 1048, 1226, 1546, 1869, 2104, 2328, 2454, 2602, 2934, 3391, 3601, 4178, 4800, 5152, 5562, 5955, 6117, 6552, 7008, 7174, 7317, 7953, 8558, 9098, 9194, 10035, 10490, 10659, 11178]",25034,16155,14834,12081,11178,-2646,4259,3716,1288,-1794,4823,35,dire
7552840615,72,114,97,105,65,"[383, 637, 917, 1242, 1623, 2163, 2609, 3193, 4116, 4607, 5255, 6090, 6744, 7047, 7591, 7916, 8729, 9773, 10536, 11104, 12952, 13700, 14501, 15495, 16030, 16362, 16964, 17653, 18224, 18516, 20676, 21889, 22711, 24021, 26430]","[228, 391, 654, 939, 1388, 1954, 2477, 2888, 3337, 3710, 4347, 4509, 5589, 6407, 6908, 7602, 8251, 8880, 9212, 9698, 10435, 11062, 11965, 12619, 13397, 13959, 14472, 15639, 16760, 17225, 17955, 18330, 19840, 21029, 22067]","[302, 550, 781, 1237, 1446, 1712, 2127, 2620, 3146, 3947, 4460, 5059, 5440, 6211, 6836, 7820, 8756, 9066, 9553, 10122, 11677, 12502, 12843, 13654, 14250, 14711, 15323, 15584, 16120, 16388, 18063, 18714, 19299, 19998, 20638]","[535, 625, 924, 1137, 1262, 1422, 1654, 1834, 2027, 2231, 2429, 2596, 2866, 3159, 3513, 4049, 4685, 5077, 5172, 5966, 7034, 7200, 7836, 8041, 8348, 9404, 10013, 10282, 10858, 11086, 12624, 13022, 13232, 13645, 14285]","[194, 302, 521, 667, 806, 1310, 1737, 2077, 2313, 2788, 3266, 3603, 3827, 4326, 4644, 4889, 5298, 5712, 6172, 6402, 6832, 7098, 7594, 8011, 8178, 9337, 9738, 9870, 10595, 10708, 11808, 12373, 12583, 12863, 13712]",26430,22067,20638,14285,13712,8,53,49,33,20,"[279, 592, 887, 1164, 1481, 1976, 2207, 2569, 3173, 3599, 3801, 4195, 4756, 5205, 5764, 6651, 7100, 7745, 8705, 9365, 10329, 10423, 11262, 11764, 12107, 13160, 13976, 15782, 16525, 16621, 17809, 17909, 18572, 19170, 19621]","[194, 284, 594, 724, 849, 939, 1105, 1296, 1699, 1917, 2042, 3134, 3482, 3631, 4778, 5357, 5988, 6500, 7300, 7725, 8957, 9051, 9551, 10094, 10444, 11576, 12592, 14308, 14485, 15084, 15918, 16237, 16976, 17338, 17847]","[230, 562, 847, 1168, 1363, 1570, 1877, 2447, 2915, 3947, 4554, 4956, 5105, 5603, 6145, 6878, 7300, 7431, 7560, 7979, 8854, 9338, 9828, 10349, 10744, 11882, 11977, 13215, 13897, 13993, 14672, 15219, 15677, 16323, 16754]","[266, 465, 1015, 1291, 1561, 1863, 2121, 2428, 2837, 3455, 3947, 4725, 5086, 5601, 6298, 6674, 6796, 7061, 7693, 8323, 8882, 9214, 9309, 9735, 9957, 10451, 10570, 11370, 11709, 12081, 12676, 13149, 13979, 14277, 14832]","[194, 284, 453, 605, 779, 931, 1021, 1385, 1565, 1888, 2126, 2478, 2665, 2814, 3342, 3590, 3724, 4064, 4421, 4671, 5167, 5437, 5607, 5849, 6019, 6967, 7274, 8402, 8703, 8799, 9416, 9532, 9797, 10006, 10216]",19621,17847,16754,14832,10216,6809,4220,3884,-547,3496,17862,35,radiant
7552909311,109,106,21,86,14,"[0, 206, 603, 854, 1273, 1648, 2277, 2678, 2940, 3180, 3591, 4020, 4720, 5527, 6327, 6817, 7911, 8362, 9328, 10332, 11835, 12886, 13987, 14980, 16071, 17242, 18717, 19269, 20204, 20495, 20931, 21031, 22189, 24123, 25160]","[0, 234, 435, 674, 919, 1385, 1806, 2119, 2574, 3075, 3424, 3907, 4403, 4826, 5251, 5839, 6234, 6744, 7575, 7857, 8557, 8902, 9416, 10010, 10863, 11380, 11634, 12141, 12879, 13482, 13756, 13856, 14376, 15599, 16124]","[0, 661, 991, 1409, 1740, 2111, 2401, 2831, 3151, 3753, 4094, 4608, 5256, 5574, 6279, 6899, 7354, 7951, 8273, 8577, 9122, 9559, 10100, 11125, 11950, 12507, 13403, 14009, 14507, 14677, 14951, 15294, 15651, 16233, 17088]","[0, 272, 780, 886, 1069, 1325, 1540, 1755, 1845, 2423, 2958, 3189, 3576, 4130, 4933, 5452, 5960, 6488, 6672, 6898, 7605, 7700, 8109, 9275, 9581, 9916, 10308, 10514, 10811, 10982, 11800, 12129, 12523, 12968, 13206]","[0, 234, 324, 414, 552, 742, 908, 1116, 1206, 1522, 1788, 2073, 2247, 2568, 2985, 3174, 3434, 4035, 4219, 4314, 4928, 5404, 5680, 6743, 6906, 7073, 7342, 7596, 8518, 8614, 8710, 8810, 8910, 9492, 9592]",25160,16124,17088,13206,9592,48,59,71,20,79,"[0, 329, 605, 1106, 1440, 1724, 2236, 2611, 2915, 3450, 3999, 4535, 5167, 5678, 6567, 7364, 8472, 9572, 10940, 11966, 12800, 13713, 14300, 15228, 15700, 16989, 17881, 18839, 20254, 21385, 22715, 23843, 24494, 25386, 26861]","[0, 208, 434, 797, 1052, 1394, 1831, 2779, 3220, 3624, 4604, 5534, 6264, 6828, 7383, 7963, 8240, 9213, 9868, 10622, 11240, 12284, 13340, 13847, 14129, 14918, 16463, 17368, 18732, 19494, 20980, 21978, 23173, 23488, 23858]","[0, 207, 422, 712, 921, 1287, 1850, 2183, 2901, 3232, 3663, 4127, 4703, 5066, 5160, 5693, 6173, 6946, 7416, 8003, 8187, 8810, 9034, 9566, 10059, 10400, 10732, 11062, 11481, 12045, 12760, 13853, 13953, 14713, 16015]","[0, 169, 560, 808, 1032, 1232, 1608, 1738, 1928, 2375, 2575, 3143, 3457, 4197, 4291, 4386, 4570, 5043, 5330, 5908, 6052, 6748, 7594, 7956, 8180, 8740, 9102, 9501, 10267, 10946, 11833, 12440, 12925, 13455, 14269]","[0, 169, 259, 423, 579, 669, 777, 1109, 1379, 1563, 2090, 2315, 2677, 3199, 3422, 3674, 3769, 4122, 4565, 5123, 5293, 5553, 6048, 6485, 6655, 7033, 7515, 7858, 8321, 8602, 9452, 10032, 10253, 10428, 11079]",26861,23858,16015,14269,11079,-1701,-7734,1073,-1063,-1487,-10912,35,dire
7553046702,126,93,28,121,26,"[593, 1036, 1327, 1824, 2246, 2624, 2997, 3211, 3403, 3674, 3933, 4199, 4930, 5196, 5394, 6960, 7415, 8016, 8626, 8941, 9207, 9991, 10560, 11533, 12279, 13798, 14790, 15353, 16347, 16628, 17237, 18257, 18847, 19132, 19232]","[533, 886, 1538, 1882, 2242, 2645, 2934, 3339, 3843, 4411, 4914, 5382, 5694, 6241, 7014, 7963, 8716, 9211, 9844, 10674, 11370, 11651, 12218, 12737, 13996, 15282, 15949, 16045, 16407, 16507, 16932, 17458, 17902, 18002, 18351]","[492, 740, 1034, 1202, 1410, 1624, 1750, 2085, 2528, 2814, 3269, 3529, 3952, 4274, 4559, 5008, 5444, 5602, 5874, 6129, 6370, 6805, 7070, 7398, 7625, 7911, 8493, 8851, 9128, 9414, 9807, 10092, 10422, 10522, 10622]","[260, 432, 748, 981, 1106, 1521, 1611, 1871, 2063, 2362, 2543, 2691, 3083, 3501, 3634, 3971, 4193, 4351, 4572, 4700, 4906, 5125, 5397, 5761, 5892, 5987, 6474, 6707, 7105, 7570, 7670, 8060, 8501, 8601, 9058]","[260, 368, 614, 790, 1047, 1182, 1272, 1362, 1554, 1698, 1941, 2172, 2419, 2514, 3156, 3723, 3933, 4156, 4428, 4522, 4728, 4823, 4918, 5246, 5625, 6186, 6525, 6621, 6717, 6842, 6942, 7042, 7287, 7387, 7487]",19232,18351,10622,9058,7487,44,96,74,45,20,"[612, 977, 1179, 1701, 2240, 2809, 3520, 3849, 4457, 4784, 5388, 5975, 6719, 7335, 8152, 8728, 9486, 10662, 11364, 12021, 12788, 13190, 13958, 14643, 15423, 16212, 17403, 18225, 19182, 20544, 21707, 22528, 23844, 25197, 27202]","[478, 1023, 1298, 1793, 2036, 2548, 3032, 3209, 3611, 4011, 4494, 5143, 5972, 6417, 7203, 7428, 7691, 8172, 8485, 8579, 9003, 9816, 9997, 10229, 10888, 11243, 12197, 12814, 13339, 13901, 14287, 14800, 15187, 15991, 16766]","[343, 620, 789, 955, 1185, 1552, 1783, 2207, 2658, 3006, 3311, 3879, 4418, 4722, 5055, 5242, 5838, 6186, 6814, 7081, 7787, 8175, 8726, 8964, 9331, 9553, 10182, 10278, 10687, 11741, 11994, 12657, 13270, 14596, 15597]","[260, 398, 498, 682, 971, 1277, 1714, 2097, 2586, 2751, 2841, 3438, 4120, 4215, 4538, 4993, 5370, 5765, 5860, 5954, 6205, 6419, 6625, 7064, 7294, 7590, 8457, 8553, 9302, 9428, 9618, 9808, 10117, 10744, 11980]","[260, 421, 511, 893, 1123, 1539, 1761, 1851, 2348, 2438, 2528, 2886, 3626, 3841, 4089, 4183, 4381, 4539, 4634, 4910, 5160, 5327, 5713, 6289, 6519, 6654, 7179, 7275, 7575, 7675, 7865, 8147, 8456, 9083, 9747]",27202,16766,15597,11980,9747,-7970,1585,-4975,-2922,-2260,-16542,35,dire
7553527512,13,42,2,86,85,"[0, 207, 456, 663, 1078, 1456, 1713, 1971, 2419, 2547, 2760, 2850, 4527, 5009, 5409, 6662, 7316, 8223, 8682, 8776, 9035, 9130, 9748, 10806, 12214, 12788, 13327, 14211, 14554, 16009, 16775, 18138, 18836, 19620, 19720]","[0, 294, 657, 1453, 1782, 2108, 2404, 2888, 3391, 3636, 4065, 4366, 5295, 5983, 6311, 7202, 7873, 8675, 9034, 9296, 9872, 10117, 10535, 11076, 11759, 12525, 13032, 13864, 14722, 16065, 16725, 17856, 19240, 19575, 19675]","[0, 206, 437, 753, 949, 1388, 1665, 1852, 2242, 2688, 3061, 3425, 3781, 4467, 4834, 5480, 6164, 6549, 6779, 6873, 7430, 7871, 8409, 10675, 11274, 12035, 12405, 13549, 13964, 14986, 15250, 15915, 16396, 17172, 17272]","[0, 170, 260, 366, 514, 692, 826, 1168, 1342, 1432, 1643, 2037, 2773, 3158, 3704, 4634, 4792, 5035, 5207, 5443, 6392, 6761, 7287, 8655, 9559, 10419, 10952, 11315, 11795, 12422, 12748, 13701, 14348, 15095, 15596]","[0, 170, 260, 528, 662, 839, 929, 1067, 1618, 1708, 1844, 1934, 2638, 2971, 3112, 3730, 4047, 4744, 4974, 5068, 5209, 5485, 5579, 6458, 7069, 7501, 7757, 8373, 8674, 10177, 10273, 10601, 11293, 11755, 11855]",19720,19675,17272,15596,11855,15,128,71,19,7,"[0, 292, 579, 914, 1411, 1884, 2357, 2773, 3557, 4379, 4923, 5466, 5967, 6849, 7585, 8098, 8702, 9302, 10484, 11635, 12763, 13225, 13515, 14480, 15000, 16280, 16843, 18839, 19859, 20634, 21274, 22362, 23084, 25982, 28862]","[0, 205, 412, 629, 997, 1175, 1533, 1861, 2266, 2681, 3060, 3445, 3762, 4285, 4715, 4809, 5402, 6040, 6890, 7490, 7912, 8431, 9460, 9869, 10105, 10459, 11246, 12020, 13200, 13489, 14274, 15090, 15550, 15955, 18601]","[0, 170, 260, 458, 748, 956, 1135, 1277, 1608, 2189, 2437, 3383, 3563, 4108, 4696, 5070, 5700, 6848, 7504, 7771, 8651, 9267, 9474, 10154, 10249, 10668, 11480, 12030, 12845, 13393, 13702, 14162, 14387, 15085, 17709]","[0, 329, 720, 1073, 1523, 1930, 2623, 3007, 3420, 4011, 4548, 4904, 5160, 5255, 5956, 6050, 6418, 7935, 9228, 9618, 10149, 10522, 11142, 11748, 11843, 12238, 12981, 13907, 14175, 15164, 15260, 15546, 16065, 16165, 17315]","[0, 170, 260, 350, 485, 625, 889, 1062, 1326, 1462, 1597, 1777, 2165, 2446, 2909, 3148, 3357, 3630, 4487, 4934, 5320, 5750, 6133, 6474, 6623, 7366, 7541, 7985, 8570, 9410, 9941, 10464, 10958, 12779, 13566]",28862,18601,17709,17315,13566,-9142,1074,-437,-1719,-1711,-11935,35,dire
7553532818,54,106,97,26,30,"[244, 570, 986, 1236, 1559, 2003, 2593, 3204, 3638, 4058, 4524, 5137, 5569, 6465, 7051, 7834, 8176, 8990, 9690, 10349, 10851, 11322, 11787, 12643, 13477, 14864, 15850, 17718, 18519, 19250, 19349, 19449, 20088, 20797, 21455]","[240, 450, 741, 1087, 1347, 1570, 2098, 2459, 2558, 3183, 3416, 3954, 4477, 5015, 5404, 5914, 6857, 7378, 8082, 8584, 9164, 9468, 10503, 11032, 11846, 12484, 12847, 13741, 15520, 15826, 16001, 16101, 17508, 18214, 19080]","[544, 840, 1044, 1669, 2107, 2681, 3018, 3260, 3640, 4326, 4853, 5241, 5812, 6111, 6663, 6920, 7349, 7826, 8900, 9183, 9481, 9576, 10224, 10390, 10945, 11257, 11385, 12401, 13216, 13718, 14008, 14539, 15606, 15999, 16172]","[277, 367, 457, 706, 823, 1034, 1286, 1376, 1466, 1913, 2003, 2264, 2461, 3408, 3730, 3824, 4171, 4313, 4634, 4963, 5094, 5217, 5652, 5897, 6439, 6735, 6829, 7251, 7649, 8100, 8348, 8607, 8903, 9159, 9471]","[170, 260, 365, 455, 545, 635, 887, 1117, 1207, 1388, 1478, 1693, 2231, 2872, 3082, 3358, 3939, 4119, 4277, 4461, 5087, 5218, 5355, 5860, 6117, 6520, 6818, 7549, 7921, 8017, 8116, 8216, 8386, 8898, 9210]",21455,19080,16172,9471,9210,73,49,96,58,112,"[337, 761, 1025, 1232, 1807, 2023, 2765, 3816, 4601, 5588, 6044, 7220, 8215, 9592, 10634, 11639, 12221, 12990, 13514, 14158, 15012, 16097, 17303, 17921, 19006, 19783, 20577, 21490, 21748, 21979, 22704, 23896, 25016, 25827, 27127]","[340, 662, 981, 1252, 1780, 2031, 2587, 3346, 4036, 4624, 4874, 4964, 5468, 6438, 6833, 7847, 8314, 8983, 9583, 10517, 11145, 11564, 12067, 12615, 12782, 13552, 14377, 15323, 16240, 17024, 18196, 19151, 19949, 20933, 21580]","[205, 567, 869, 1101, 1901, 2444, 2699, 3283, 3591, 4255, 4850, 5297, 6175, 6602, 7188, 7635, 7906, 8351, 8943, 9514, 9658, 9979, 11002, 11232, 12328, 12952, 13751, 14499, 14906, 15303, 17005, 17793, 17893, 18244, 19275]","[170, 260, 463, 571, 736, 955, 1110, 1637, 2102, 2505, 2655, 2782, 2942, 3451, 3809, 4410, 4617, 5123, 5605, 5834, 6159, 6693, 7262, 7444, 7729, 7908, 8525, 8831, 9008, 9457, 10283, 10910, 11155, 11785, 12230]","[170, 260, 350, 454, 824, 914, 1359, 1508, 1894, 2119, 2308, 2398, 2558, 2825, 3167, 3511, 3905, 4229, 4564, 4793, 5131, 5368, 6017, 6183, 6439, 6650, 7235, 7794, 7971, 8293, 8874, 9169, 9269, 9486, 10232]",27127,21580,19275,12230,10232,-5672,-2500,-3103,-2759,-1022,-15056,35,dire
7553654119,90,32,97,45,83,"[410, 738, 1073, 1460, 1828, 2350, 2942, 3416, 4021, 4318, 4949, 5523, 6341, 7435, 7873, 8286, 9052, 9750, 10886, 11319, 11821, 12272, 12790, 13593, 14622, 15966, 16494, 17221, 17592, 18360, 18752, 19647, 20379, 20974, 22020]","[144, 431, 628, 849, 1140, 1492, 1713, 2085, 2363, 2621, 3016, 3310, 3798, 4566, 4935, 5400, 5711, 6614, 7081, 7742, 8169, 8595, 8816, 9279, 9922, 10279, 10858, 12006, 12267, 12826, 12922, 13636, 14774, 15703, 16056]","[144, 350, 582, 732, 1320, 1582, 2111, 2860, 3294, 3818, 4324, 4782, 5705, 6345, 7065, 7591, 8739, 9343, 9911, 10447, 10811, 11520, 11702, 12311, 12840, 13081, 13730, 14449, 14816, 15187, 15283, 15653, 16047, 16454, 17100]","[144, 463, 553, 703, 793, 912, 1096, 1383, 1489, 1579, 1971, 2146, 2402, 2658, 2870, 3174, 3731, 4326, 4681, 4954, 5256, 5636, 5731, 5993, 6263, 6620, 7179, 7366, 7462, 7648, 7744, 8194, 8987, 9298, 9853]","[72, 242, 332, 532, 666, 756, 1024, 1199, 1336, 1426, 1562, 1768, 2002, 2491, 2679, 2939, 3424, 3983, 4494, 4767, 4861, 5064, 5246, 5341, 5611, 5995, 6274, 6369, 6465, 6651, 6747, 7163, 7578, 7678, 7868]",22020,16056,17100,9853,7868,120,21,51,23,112,"[119, 433, 803, 1048, 1638, 2094, 2586, 2879, 3517, 3973, 4588, 4906, 5611, 6112, 6725, 7247, 8092, 8464, 9323, 10094, 11590, 12556, 13689, 14240, 14754, 15123, 15909, 17102, 17788, 18215, 19420, 20106, 21293, 22007, 23034]","[119, 386, 754, 1171, 1597, 1910, 2270, 2574, 2748, 3309, 3733, 4047, 4666, 5212, 5614, 6078, 7154, 7371, 7933, 9118, 10011, 10268, 11947, 12699, 12906, 14021, 14363, 15124, 15859, 16413, 17675, 18720, 19205, 19658, 20247]","[119, 348, 438, 595, 760, 1060, 1158, 1280, 1428, 1518, 1792, 2005, 2272, 2508, 2603, 2907, 3313, 3407, 3666, 4216, 4755, 4850, 5793, 6510, 6713, 7694, 8199, 9310, 9697, 10331, 11666, 11971, 12448, 12548, 13193]","[252, 382, 764, 1120, 1475, 1761, 2109, 2593, 3290, 3737, 4147, 4634, 5372, 5886, 5981, 6867, 7275, 7538, 7827, 8673, 9256, 9827, 10613, 11241, 11435, 12096, 12878, 13769, 14176, 14362, 15500, 16057, 16413, 16627, 17275]","[387, 714, 804, 1005, 1180, 1305, 1444, 1582, 1845, 1956, 2400, 2572, 2817, 3291, 3482, 3850, 4374, 4484, 4890, 5487, 6227, 6390, 6996, 7252, 7530, 8895, 9363, 9825, 10419, 10724, 11801, 12441, 12943, 13043, 13906]",23034,20247,13193,17275,13906,-1014,-4191,3907,-7422,-6038,-14758,35,dire
7553708506,10,19,69,100,86,"[0, 478, 887, 1062, 1989, 2481, 2690, 2825, 3162, 3695, 4705, 5264, 5742, 6182, 6987, 8140, 8773, 9486, 10620, 11776, 12568, 13297, 14742, 15824, 16558, 17858, 18786, 19614, 21173, 22459, 22555, 23411, 24193, 24704, 25201]","[0, 248, 576, 957, 1295, 1716, 2190, 2532, 3252, 3506, 4243, 4455, 4712, 5175, 5657, 6538, 6912, 7213, 7952, 8773, 9119, 9402, 10413, 11101, 11674, 13272, 13583, 14046, 14907, 15864, 16509, 17801, 18535, 19331, 20585]","[0, 201, 291, 554, 885, 1075, 1906, 2085, 2331, 2561, 3035, 3491, 3906, 4133, 4761, 5247, 5697, 6220, 6818, 7128, 7382, 7690, 8211, 8600, 9283, 9693, 10442, 11106, 11718, 12277, 12821, 13742, 13976, 14492, 15169]","[0, 220, 310, 400, 759, 889, 1147, 1237, 1423, 1618, 2059, 2149, 2239, 2334, 2483, 3070, 3645, 4053, 4895, 5143, 5293, 5697, 5977, 6410, 6614, 7412, 7798, 8159, 8861, 9856, 10331, 10952, 11327, 11682, 12819]","[0, 174, 264, 354, 490, 620, 797, 887, 1368, 1748, 2163, 2253, 2392, 2523, 2824, 3242, 3575, 3670, 3925, 4408, 4517, 4823, 5073, 5304, 5623, 6498, 7007, 7351, 7960, 8708, 9009, 9891, 10352, 10900, 11282]",25201,20585,15169,12819,11282,52,6,71,85,26,"[328, 609, 861, 1367, 1786, 2201, 2330, 2625, 2977, 3790, 4540, 5158, 5669, 6315, 6627, 6807, 7310, 7773, 8739, 9478, 10205, 10716, 11407, 11919, 13231, 13416, 13793, 14359, 15485, 16661, 18123, 18552, 19928, 20717, 21715]","[60, 355, 708, 1039, 1270, 1697, 1945, 2408, 2730, 3206, 3766, 4311, 4845, 5450, 5856, 6135, 7121, 7590, 8245, 9055, 9766, 10250, 10930, 11616, 12419, 12672, 13336, 14059, 14884, 15325, 16067, 16625, 17290, 18326, 18856]","[60, 307, 795, 1119, 1379, 1731, 2218, 2554, 2798, 2888, 3028, 3458, 4059, 4627, 4769, 5109, 5876, 6200, 6706, 8376, 8747, 9251, 9493, 9931, 10441, 10739, 11486, 12103, 12447, 13340, 14472, 15276, 16066, 17678, 18330]","[60, 269, 359, 449, 838, 1036, 1351, 1593, 1756, 1925, 2177, 2503, 2682, 3175, 3270, 3503, 4100, 4413, 4626, 5073, 5528, 5623, 5804, 6195, 6858, 7043, 7505, 7841, 8110, 8433, 8529, 8873, 9349, 10069, 10349]","[60, 269, 423, 513, 647, 777, 867, 1266, 1401, 1625, 1854, 2123, 2298, 2800, 3024, 3119, 3744, 3948, 4221, 4881, 5160, 5255, 5536, 6239, 7023, 7208, 7438, 7892, 8149, 8544, 8683, 8901, 9388, 9488, 9970]",21715,18856,18330,10349,9970,3486,1729,-3161,2470,1312,5836,35,radiant
7554078113,89,19,14,128,26,"[364, 954, 1083, 1407, 1688, 2004, 2189, 2591, 2826, 3437, 3868, 4605, 5453, 6039, 6976, 8009, 8432, 9137, 9848, 10782, 11646, 12759, 13952, 15293, 16659, 17433, 19158, 20128, 20648, 21183, 22391, 24256, 24971, 25710, 26008]","[569, 830, 1126, 1491, 2267, 2760, 3172, 3735, 4654, 5351, 5841, 5971, 6616, 6710, 7312, 8165, 9019, 9516, 10102, 10197, 11002, 12472, 13006, 13370, 14027, 14379, 15569, 16846, 17105, 17578, 18132, 20143, 21102, 21649, 21947]","[365, 812, 1125, 1290, 1773, 2065, 2286, 2687, 3223, 3769, 4320, 5306, 5837, 6030, 6575, 6917, 7848, 8109, 8544, 8823, 9276, 10334, 10612, 11199, 12158, 12755, 13810, 14430, 14801, 15535, 15898, 16820, 17265, 17986, 18459]","[305, 440, 657, 747, 982, 1168, 1306, 1497, 1843, 2115, 2642, 2990, 3193, 3287, 3542, 3781, 4107, 4266, 4728, 4948, 5181, 5927, 6169, 6411, 7081, 7394, 8080, 8939, 9300, 9569, 9806, 10471, 10709, 11327, 12228]","[357, 609, 699, 789, 879, 1059, 1324, 1563, 1837, 2117, 2393, 2626, 2829, 2923, 3243, 3474, 3675, 3941, 4099, 4194, 4483, 4758, 4925, 5092, 5571, 5666, 6145, 6689, 6948, 7077, 7316, 7853, 8063, 8485, 8865]",26008,21947,18459,12228,8865,21,120,102,123,85,"[879, 1163, 1798, 2256, 2721, 3225, 3826, 4488, 5212, 5703, 6210, 6950, 7223, 7855, 8397, 9038, 9505, 9797, 10559, 10897, 11601, 12183, 12497, 12828, 13126, 13332, 13866, 14350, 15080, 15444, 15853, 17185, 17749, 18916, 19963]","[534, 696, 1032, 1419, 1543, 2360, 2909, 3423, 3894, 4594, 4842, 5516, 5965, 6659, 7709, 8569, 9162, 9605, 10310, 10850, 11432, 11527, 12133, 12546, 13168, 13797, 14118, 14380, 15583, 16136, 16479, 16952, 17443, 18745, 19515]","[509, 649, 1022, 1244, 1843, 2416, 2926, 3190, 3712, 4313, 4632, 5571, 6302, 6563, 7535, 8125, 8767, 9376, 9921, 10561, 11099, 11376, 11748, 12778, 13530, 14100, 14415, 15136, 17415, 18205, 18731, 18975, 19113, 20072, 20307]","[370, 460, 887, 1035, 1200, 1521, 1631, 1971, 2177, 2441, 2746, 3478, 3617, 3995, 4599, 4829, 4924, 5018, 5176, 5339, 5617, 5953, 6217, 6447, 6861, 6956, 7169, 7452, 8523, 8905, 9005, 9105, 9759, 10147, 11151]","[550, 739, 957, 1093, 1476, 1656, 1816, 2052, 2292, 2472, 2708, 3534, 3673, 4470, 4968, 5153, 5351, 5533, 5691, 5887, 6079, 6281, 6644, 7202, 7673, 7843, 8095, 8572, 8743, 9248, 9423, 9598, 9773, 11143, 11699]",19963,19515,20307,11151,11699,6045,2432,-1848,1077,-2834,4872,35,radiant
7554357902,1,120,92,19,66,"[63, 270, 520, 720, 1059, 1503, 2412, 2791, 3288, 3768, 4247, 4667, 5214, 5479, 6295, 7503, 8873, 9842, 11183, 11871, 12166, 12882, 13605, 14802, 15757, 16586, 16984, 17279, 18221, 19246, 20586, 21916, 22015, 23342, 24115]","[63, 269, 521, 1041, 1408, 1735, 2235, 2698, 3203, 3947, 4649, 4983, 5344, 6039, 7453, 7973, 9038, 9600, 10576, 11944, 12483, 12650, 13272, 13669, 14640, 15038, 15618, 16158, 17246, 18188, 18932, 19217, 19692, 21159, 22075]","[63, 271, 554, 923, 1297, 1650, 1740, 2279, 2727, 3443, 3756, 4144, 4641, 5191, 5963, 6489, 7108, 7465, 7886, 8345, 8762, 9429, 9990, 10552, 10993, 11438, 11632, 12680, 12990, 13429, 14114, 14782, 15191, 16407, 17367]","[63, 268, 358, 448, 627, 833, 1185, 1627, 1717, 2109, 2438, 2668, 2758, 2925, 3629, 3904, 4708, 5065, 5459, 6023, 6117, 6646, 6913, 7297, 7638, 7846, 8056, 8358, 9154, 9461, 10063, 10321, 10658, 12609, 13217]","[331, 501, 827, 917, 1246, 1574, 1896, 2149, 2352, 2803, 3154, 3513, 3806, 4124, 4698, 5294, 6018, 6375, 6802, 7142, 7285, 7688, 7978, 8363, 8532, 8747, 8908, 9088, 9798, 10171, 10775, 11190, 11585, 12446, 13005]",24115,22075,17367,13217,13005,48,53,90,97,100,"[0, 279, 631, 863, 1117, 1583, 1994, 2282, 2684, 2985, 3601, 4203, 4817, 5716, 6191, 7252, 7603, 9109, 10068, 11057, 11968, 13719, 14172, 14944, 15757, 16975, 18430, 20327, 20960, 21656, 22584, 23492, 23828, 24097, 25662]","[0, 170, 260, 648, 823, 993, 1110, 1250, 1447, 1537, 1738, 1981, 2108, 2459, 2554, 3726, 4132, 4651, 5429, 7046, 7495, 8094, 8526, 8913, 9778, 10491, 11162, 11854, 12468, 12564, 12962, 13775, 14455, 14600, 15271]","[0, 267, 566, 938, 1179, 1605, 1982, 2581, 3129, 3495, 3696, 4292, 4601, 5013, 5146, 5689, 5974, 6611, 6861, 7402, 8190, 8861, 9375, 9642, 10251, 11047, 11609, 12060, 12407, 12541, 13169, 13610, 13960, 14061, 14287]","[0, 331, 622, 1150, 1631, 1909, 2071, 2268, 2574, 2968, 3277, 3888, 4147, 4836, 5277, 5655, 5832, 6843, 7159, 7254, 8072, 8518, 8707, 9091, 9468, 10396, 10771, 11222, 11824, 12027, 12407, 12606, 12789, 12890, 13184]","[0, 170, 260, 385, 475, 720, 810, 900, 1097, 1321, 1522, 1712, 1955, 2457, 2562, 2902, 3042, 3832, 4307, 4609, 4950, 5965, 6060, 6190, 6759, 7232, 7591, 8156, 8362, 8539, 9045, 9145, 9244, 9423, 9788]",25662,15271,14287,13184,9788,-1547,6804,3080,33,3217,11587,35,radiant
7554721500,48,62,129,20,84,"[548, 952, 1196, 1602, 2024, 2438, 2770, 3254, 3893, 4604, 5240, 5989, 7239, 7770, 8368, 9443, 10901, 12711, 13938, 15306, 16250, 16984, 17842, 18441, 19826, 21129, 22121, 23236, 24768, 24868, 25348, 26076, 26999, 27860, 29266]","[754, 1095, 1499, 1829, 2082, 2547, 2907, 3444, 4279, 4480, 5070, 5549, 6022, 6354, 7196, 7587, 8247, 9405, 9739, 10240, 10407, 10869, 11074, 11367, 12911, 13345, 13755, 14121, 14697, 14957, 15094, 15266, 15783, 16170, 16617]","[491, 850, 1276, 1592, 1924, 2407, 2807, 3241, 3483, 4133, 4553, 5249, 5970, 6350, 6729, 7173, 7510, 8298, 8614, 8709, 9166, 9957, 10377, 11067, 12044, 12937, 13439, 13845, 14417, 14517, 15181, 15281, 15471, 15793, 15928]","[285, 375, 606, 696, 908, 1136, 1226, 1695, 2115, 2255, 2568, 2876, 3037, 3344, 3678, 3852, 4290, 4963, 5207, 5559, 5801, 6105, 6385, 6555, 7160, 7419, 7967, 8372, 9028, 9419, 9519, 9659, 9943, 10214, 10352]","[285, 393, 503, 709, 843, 1113, 1381, 2036, 2306, 2396, 2721, 3070, 3255, 3397, 3878, 4251, 4622, 5346, 5802, 6040, 6253, 6610, 6854, 6993, 7528, 7833, 8135, 8509, 9005, 9178, 9359, 9459, 9844, 9951, 10051]",29266,16617,15928,10352,10051,10,49,39,58,123,"[565, 816, 1111, 1502, 1975, 2230, 2701, 3293, 4005, 4674, 5002, 5762, 6359, 7154, 7772, 8576, 9427, 10010, 10658, 11367, 12432, 13354, 14236, 15145, 15509, 16336, 17091, 17865, 18469, 19483, 20482, 21011, 22335, 22789, 23653]","[472, 757, 1048, 1364, 1642, 2091, 2365, 2918, 3367, 3670, 4330, 4769, 5536, 6094, 7032, 7842, 8369, 8618, 9387, 10249, 11037, 12288, 12551, 13511, 13751, 13977, 15203, 16037, 16717, 17643, 18364, 18620, 19488, 20238, 20896]","[646, 965, 1410, 1707, 2188, 2609, 2978, 3670, 4158, 4582, 5060, 5471, 6066, 6886, 7258, 7571, 8000, 8729, 9227, 9763, 10933, 11842, 12542, 13182, 13482, 14375, 15145, 15241, 15902, 16880, 17313, 17535, 17939, 18129, 18561]","[260, 350, 597, 1078, 1322, 1546, 1695, 2246, 2426, 2619, 2743, 3027, 3122, 3478, 3795, 4337, 4667, 4916, 5308, 5548, 5869, 6321, 6615, 7040, 7508, 7815, 8073, 8462, 9270, 10272, 10587, 10809, 11282, 11472, 11688]","[359, 467, 603, 693, 783, 963, 1066, 1338, 1518, 1735, 2042, 2581, 2676, 2949, 3203, 3434, 3708, 4032, 4511, 4699, 4939, 5443, 5824, 6412, 6629, 7422, 7755, 8277, 8750, 9315, 9538, 9812, 10446, 10801, 10985]",23653,20896,18561,11688,10985,5613,-4279,-2633,-1336,-934,-3569,35,dire
7555041119,46,49,129,20,26,"[1100, 1463, 1834, 2287, 2870, 3353, 4073, 4608, 5128, 6264, 6955, 7410, 7604, 8523, 9317, 9929, 10692, 11809, 12802, 13584, 14289, 15193, 15751, 16595, 17127, 17898, 18185, 19371, 20080, 20597, 21042, 21633, 21733, 22017, 22994]","[1033, 1375, 1781, 2156, 2456, 2956, 3658, 4080, 4553, 4947, 5356, 5848, 6477, 7169, 7657, 8198, 9433, 10079, 10174, 10572, 11435, 12203, 12779, 13361, 13859, 14478, 15123, 15676, 16350, 16966, 17416, 17738, 18186, 19124, 19397]","[947, 1304, 1785, 2356, 2767, 3134, 3601, 4197, 4893, 5325, 5945, 6371, 6841, 7325, 8452, 8547, 9222, 9647, 10068, 10683, 11311, 11915, 12245, 12648, 13187, 13990, 14300, 14845, 15545, 15693, 16195, 16657, 17465, 17565, 18659]","[613, 837, 976, 1111, 1447, 1635, 1932, 2264, 2859, 3046, 3293, 3600, 3794, 4062, 4307, 4436, 5057, 5151, 5246, 5412, 5507, 5601, 5852, 5996, 6091, 6513, 6609, 6795, 7051, 7151, 7498, 7820, 7920, 8510, 8610]","[412, 549, 639, 823, 973, 1081, 1306, 1486, 1666, 1932, 2095, 2349, 2629, 3016, 3261, 3359, 3643, 4297, 4392, 4487, 4582, 4762, 4929, 5024, 5119, 5541, 5693, 5879, 6088, 6237, 6337, 6437, 6537, 6637, 6737]",22994,19397,18659,8610,6737,13,41,96,58,123,"[677, 982, 1232, 1694, 2035, 2493, 2989, 3264, 3931, 4528, 5043, 5947, 6676, 7429, 7853, 8423, 8943, 9672, 10569, 11418, 11870, 12469, 12861, 13924, 14688, 15548, 16093, 16807, 18694, 19506, 19667, 21680, 22948, 23674, 24859]","[790, 1071, 1732, 2112, 2447, 2816, 3181, 3509, 3972, 4420, 4900, 5420, 6296, 6835, 7601, 8669, 9536, 9980, 10491, 11314, 11923, 12298, 13197, 13467, 14200, 15023, 15698, 16370, 17861, 18073, 18525, 19518, 20687, 21096, 21760]","[785, 1232, 1510, 1928, 2343, 2843, 3172, 3709, 4369, 4831, 5366, 5979, 6552, 7223, 7616, 8162, 8532, 9070, 9866, 10434, 11107, 11526, 12041, 12611, 13302, 13884, 14165, 14561, 15548, 15743, 15890, 16713, 17221, 17612, 18080]","[433, 563, 778, 1188, 1368, 1597, 1687, 1899, 2117, 2284, 2516, 2992, 3132, 3701, 4020, 4757, 5009, 5245, 5407, 5824, 6438, 6807, 7175, 7753, 8072, 8408, 8764, 9435, 9833, 10466, 10713, 12296, 13073, 13531, 13755]","[350, 480, 570, 775, 1034, 1479, 1618, 1755, 2063, 2253, 2420, 2938, 3322, 4066, 4319, 4471, 4878, 4972, 5324, 5630, 5870, 6087, 6323, 6574, 6669, 7307, 7403, 7784, 8639, 9310, 9694, 10676, 11173, 11778, 12356]",24859,21760,18080,13755,12356,-1865,-2363,579,-5145,-5619,-14413,35,dire
7555172308,73,90,112,110,97,"[58, 649, 1043, 1412, 1758, 2061, 2670, 3270, 3843, 4562, 5151, 6151, 6790, 7777, 8799, 9817, 10807, 11146, 12656, 13718, 13827, 14784, 15157, 15396, 17095, 18543, 19017, 19112, 20750, 21796, 23517, 24569, 26409, 27727, 29349]","[58, 430, 631, 1099, 1398, 1658, 1926, 2913, 3366, 3887, 4221, 4692, 5405, 5988, 6276, 6920, 7575, 8398, 9073, 9532, 10088, 10840, 11007, 11749, 12516, 13118, 13377, 13917, 15266, 15885, 16670, 17718, 18391, 18793, 19472]","[58, 228, 318, 408, 542, 704, 1203, 1562, 2059, 2230, 2616, 2815, 3017, 3848, 4453, 5100, 5407, 5948, 6684, 7582, 7752, 8460, 9150, 9317, 9984, 10582, 10714, 10809, 11168, 11345, 12325, 12847, 13037, 13324, 14197]","[58, 294, 583, 876, 1172, 1329, 1671, 1984, 2109, 2236, 2616, 2706, 2796, 3194, 3788, 4160, 4836, 5286, 6179, 6852, 7097, 7441, 8072, 8929, 9678, 10280, 10598, 10768, 12108, 12613, 13337, 14050, 14545, 14855, 15433]","[326, 583, 822, 985, 1263, 1471, 1763, 2185, 2312, 2614, 2812, 3180, 3501, 3976, 4413, 5087, 5316, 5579, 6037, 6481, 6651, 6944, 7455, 8026, 8484, 9338, 9433, 10054, 10746, 11457, 12070, 12814, 13425, 13525, 15182]",29349,19472,14197,15433,15182,113,98,29,45,47,"[0, 283, 526, 906, 1201, 1530, 2089, 2385, 2924, 3712, 4229, 4883, 5450, 6138, 6675, 7144, 7624, 8497, 8865, 9314, 10046, 10842, 12004, 12466, 13034, 13479, 14946, 15957, 16187, 16443, 17003, 17193, 18221, 18712, 18972]","[154, 324, 645, 861, 1282, 1804, 2098, 2515, 2922, 3441, 4086, 4837, 5353, 6061, 6495, 6789, 6947, 7759, 7854, 8235, 9776, 10115, 10419, 11242, 11700, 12073, 13176, 13847, 14598, 15126, 15357, 16055, 16675, 16775, 16875]","[0, 598, 774, 1070, 1486, 1784, 2715, 2839, 3374, 3869, 4597, 5126, 6041, 6516, 6769, 7334, 7776, 8691, 9320, 9875, 10904, 11407, 12234, 12924, 13135, 13329, 14400, 14964, 15433, 15529, 15723, 15913, 16471, 16728, 17037]","[154, 324, 448, 586, 725, 965, 1233, 1367, 1457, 1593, 2122, 2457, 2754, 2902, 3507, 3662, 3820, 4474, 4768, 5227, 6896, 7089, 7427, 8077, 8171, 8266, 9727, 10522, 10896, 11355, 11523, 11766, 12533, 13077, 13177]","[0, 332, 422, 512, 602, 692, 1006, 1133, 1350, 1440, 1803, 2138, 2247, 2715, 3179, 3446, 3604, 3885, 3980, 4231, 4605, 4699, 5003, 5630, 5724, 5819, 7185, 7553, 7960, 8180, 8477, 8667, 9225, 9575, 9791]",18972,16875,17037,13177,9791,10377,2597,-2840,2256,5391,17781,35,radiant
7555291916,93,106,97,123,105,"[644, 982, 1422, 1665, 1917, 2476, 2795, 3059, 3641, 4191, 4871, 5420, 5901, 6550, 7337, 7943, 8761, 8867, 9014, 9649, 10981, 11606, 12161, 13075, 13434, 14020, 15479, 17631, 18395, 19052, 19370, 19470, 19948, 20048, 20406]","[775, 1176, 1560, 1813, 1940, 2555, 3050, 3446, 3658, 4202, 4949, 5629, 6353, 6866, 7690, 8728, 9171, 9669, 9940, 10564, 11106, 11960, 12794, 13771, 14112, 14825, 16122, 16987, 17083, 17819, 17919, 18302, 18538, 18638, 19848]","[469, 1035, 1445, 1861, 2369, 2940, 3465, 3986, 4652, 5161, 5475, 5883, 6509, 6935, 7543, 7993, 8522, 8625, 8719, 9163, 9547, 10119, 10813, 11754, 12460, 13138, 14088, 14793, 15361, 15551, 15651, 15751, 15941, 16041, 16141]","[373, 536, 898, 988, 1266, 1446, 1809, 1955, 2135, 2486, 2836, 3415, 3778, 3926, 4493, 4990, 5212, 5859, 5953, 6148, 6606, 6933, 7371, 7815, 8260, 8593, 8901, 9514, 9851, 10292, 11506, 12291, 12529, 12629, 12928]","[300, 463, 602, 778, 1156, 1336, 1560, 1650, 2078, 2306, 2539, 2720, 2929, 3024, 3488, 3673, 4041, 4375, 4469, 4810, 5324, 5552, 5991, 6593, 7084, 7383, 7975, 8775, 9085, 9529, 9629, 10054, 10290, 10427, 10636]",20406,19848,16141,12928,10636,73,120,137,58,86,"[595, 959, 1311, 1401, 1908, 2240, 2549, 2983, 3703, 4194, 4996, 5944, 6723, 7834, 9464, 10535, 11523, 12850, 14241, 15493, 16359, 16784, 17984, 19275, 20034, 20128, 20596, 20882, 22131, 23619, 24634, 25181, 25862, 26987, 27750]","[560, 902, 1286, 1856, 2493, 2856, 3211, 3679, 4265, 4409, 4923, 5467, 5562, 5868, 6648, 7141, 8327, 9019, 10592, 11215, 11820, 12302, 12765, 13282, 13377, 13976, 15156, 16244, 16592, 17245, 18752, 19328, 20563, 21425, 22762]","[392, 660, 1153, 1656, 1894, 2325, 2782, 3456, 3801, 4516, 5128, 5501, 6350, 6713, 7480, 8113, 8788, 9009, 9901, 10469, 11081, 11575, 12537, 13353, 13448, 14065, 14571, 15053, 15659, 16315, 17516, 18149, 19384, 20305, 21208]","[245, 644, 815, 1023, 1422, 1592, 1682, 2065, 2323, 2685, 2915, 3118, 3257, 3475, 4157, 4570, 4946, 5248, 5859, 6070, 6573, 6914, 7462, 7939, 8034, 8261, 8593, 8761, 9234, 9784, 10470, 10710, 11572, 12173, 12915]","[293, 466, 631, 943, 1078, 1213, 1303, 1776, 2006, 2245, 2604, 3089, 3267, 3667, 4143, 4398, 4611, 4832, 5457, 5764, 6104, 6199, 6443, 7040, 7180, 7274, 7652, 8134, 8230, 8670, 9202, 9407, 10088, 10969, 11406]",27750,22762,21208,12915,11406,-7344,-2914,-5067,13,-770,-16082,35,dire
7555314400,46,106,45,123,83,"[523, 734, 1059, 1430, 1846, 2342, 2706, 3376, 3981, 4652, 5226, 6079, 6533, 7500, 7844, 8182, 8629, 9418, 10452, 11327, 11933, 12323, 13379, 14080, 15186, 15890, 16230, 16795, 17554, 17992, 19240, 19890, 20755, 21402, 21502]","[514, 757, 1075, 1354, 1641, 1892, 2178, 2476, 2942, 3428, 3892, 4291, 4800, 5194, 5932, 6707, 7496, 7793, 8286, 8575, 9334, 9600, 9949, 10686, 11995, 12390, 12747, 13257, 13744, 14187, 14951, 15796, 15896, 16182, 16282]","[586, 1000, 1683, 1862, 2189, 2618, 3066, 3156, 3871, 4624, 5062, 5822, 6069, 6491, 6966, 7295, 8122, 8613, 9363, 10126, 10476, 10661, 11337, 12384, 12796, 13689, 14035, 14371, 15263, 15691, 16090, 16564, 16812, 17154, 17423]","[261, 367, 577, 667, 840, 930, 1020, 1287, 1637, 1926, 2016, 2478, 2574, 2846, 3347, 4123, 4767, 4925, 5177, 5541, 6016, 6201, 6410, 7032, 7836, 8012, 8108, 8727, 9312, 9547, 9801, 9991, 10138, 10369, 10762]","[261, 400, 534, 663, 838, 928, 1018, 1108, 1332, 1651, 1741, 2142, 2266, 2361, 2705, 3119, 3566, 3700, 3998, 4183, 4476, 4706, 4800, 5305, 5720, 5896, 5992, 6433, 6818, 7295, 7552, 7742, 7936, 8663, 8801]",21502,16282,17423,10762,8801,95,49,97,119,20,"[627, 945, 1458, 1930, 2384, 2913, 3196, 3946, 4356, 4850, 5419, 6029, 6679, 7320, 8137, 8664, 9347, 10237, 10924, 12071, 12579, 13325, 14240, 14811, 15279, 15995, 17033, 17798, 18902, 19926, 21007, 21537, 22342, 25261, 26638]","[547, 878, 1178, 1669, 2064, 2836, 3128, 3866, 4425, 5005, 5354, 5831, 6361, 6832, 7385, 7480, 7859, 8567, 8897, 10018, 10790, 11151, 12172, 12464, 12646, 13120, 13995, 14537, 15149, 16017, 16442, 16782, 17133, 18114, 19513]","[568, 888, 1179, 1469, 1655, 1825, 2466, 3085, 3747, 4329, 4814, 5123, 5422, 5813, 6218, 6313, 6512, 7086, 7722, 8091, 9107, 9462, 10120, 10395, 10515, 11257, 11726, 12170, 12530, 12899, 13574, 14006, 14154, 15219, 16441]","[261, 351, 490, 681, 822, 1035, 1242, 1577, 1807, 1954, 2044, 2256, 2867, 3144, 3414, 3509, 3948, 4440, 4831, 4951, 5214, 5504, 5715, 6407, 6807, 7451, 7889, 8272, 8525, 8715, 8903, 9003, 9284, 9966, 10595]","[261, 351, 535, 756, 1065, 1278, 1368, 1634, 1814, 1904, 2049, 2143, 2408, 2714, 3123, 3218, 3359, 3580, 4008, 4155, 4452, 4910, 5089, 5364, 5661, 5875, 6260, 6645, 7226, 7416, 7516, 7616, 7716, 8659, 9287]",26638,19513,16441,10595,9287,-5136,-3231,982,167,-486,-7704,35,dire
7555678503,48,106,98,86,100,"[621, 1067, 1312, 1574, 2056, 2210, 2560, 2995, 3296, 3748, 4281, 4819, 6030, 6953, 7735, 8296, 8966, 10071, 11031, 12022, 13122, 14174, 14583, 15615, 16604, 17529, 18914, 19418, 21303, 22459, 23010, 23873, 24874, 25998, 26873]","[538, 860, 1199, 1524, 1974, 2520, 3202, 3996, 4714, 4859, 5302, 5657, 6787, 7554, 8571, 9394, 10047, 10779, 11336, 12178, 13015, 13579, 14662, 14757, 15161, 15903, 16949, 17721, 18298, 19083, 19728, 20991, 21419, 22049, 22654]","[506, 763, 968, 1264, 1608, 1893, 2334, 2663, 3410, 3723, 4365, 5046, 5432, 5982, 6470, 6931, 7401, 7975, 8838, 9413, 10298, 10804, 11344, 11995, 12719, 12972, 14119, 14628, 14805, 15576, 16148, 17304, 17828, 18354, 18821]","[642, 783, 873, 1100, 1225, 1402, 1578, 2267, 2737, 2883, 3103, 3252, 4383, 4614, 5333, 5981, 6187, 6382, 6933, 7683, 7922, 8271, 8826, 9002, 9322, 9577, 10307, 10602, 11385, 11763, 11912, 12012, 12227, 12462, 12948]","[333, 468, 558, 695, 829, 1006, 1096, 1518, 2123, 2407, 2705, 3018, 3542, 4073, 4382, 4673, 4793, 5039, 5350, 5772, 6011, 6757, 7118, 7262, 7483, 7688, 8166, 8262, 8775, 9055, 9273, 9585, 9775, 10010, 10245]",26873,22654,18821,12948,10245,46,17,129,53,123,"[733, 1106, 1422, 1668, 2272, 2528, 3228, 3811, 4315, 4590, 5128, 5662, 6402, 6732, 8025, 8693, 9663, 10425, 11040, 11896, 12405, 13207, 14021, 16039, 17088, 17794, 18149, 19209, 20122, 20847, 21663, 21763, 22726, 23722, 24338]","[651, 1112, 1357, 1743, 2206, 2547, 2986, 3400, 3815, 3952, 4445, 5078, 5530, 5936, 6470, 7274, 7472, 8316, 8542, 9482, 10324, 10884, 11132, 11922, 12688, 13046, 13638, 13993, 14266, 14653, 14803, 15546, 16393, 17019, 17852]","[629, 874, 1398, 1731, 2159, 2537, 3023, 3416, 4014, 4454, 4714, 5367, 6558, 6652, 7082, 7586, 7681, 8383, 8841, 8981, 9516, 10125, 10489, 10959, 11381, 11873, 12422, 12697, 13229, 13532, 13969, 14665, 15653, 16553, 16740]","[511, 650, 757, 963, 1402, 1791, 2218, 2308, 2849, 2939, 3212, 3341, 3914, 4008, 4797, 5072, 5292, 5757, 5992, 6333, 6621, 6804, 6946, 7583, 8024, 8244, 9070, 9166, 9373, 9769, 10159, 10575, 11175, 11375, 11766]","[350, 440, 575, 795, 1089, 1179, 1368, 1503, 1761, 2077, 2218, 2413, 2894, 2988, 3446, 3765, 4119, 4322, 4492, 4895, 5168, 5623, 6042, 6876, 7313, 7679, 8189, 8619, 9212, 9565, 9665, 9765, 10350, 10591, 10737]",24338,17852,16740,11766,10737,2535,4802,2081,1182,-492,10108,35,radiant
7556191109,25,69,40,123,106,"[0, 167, 433, 562, 815, 1149, 1565, 1897, 2439, 2693, 3337, 3914, 4456, 4842, 5204, 6578, 7291, 8048, 8538, 8918, 9818, 11254, 11581, 11964, 12596, 13583, 13677, 14418, 15041, 16194, 16470, 17926, 18738, 19159, 19259]","[0, 198, 549, 844, 1519, 2119, 2787, 3032, 3425, 3682, 3995, 5039, 5319, 5956, 6520, 7364, 7765, 8536, 9391, 10035, 10645, 11417, 11817, 12072, 12474, 13201, 14261, 14648, 15212, 16224, 16599, 17630, 18511, 19016, 19947]","[0, 129, 219, 671, 800, 970, 1168, 1612, 1844, 2092, 2381, 2815, 3052, 3147, 3419, 3648, 4358, 4453, 4731, 5043, 5615, 6366, 6740, 6967, 7257, 7647, 8286, 8536, 9061, 9747, 10455, 11902, 12779, 12879, 14630]","[0, 129, 219, 356, 621, 891, 1194, 1497, 1587, 1888, 2245, 2482, 2572, 2702, 3171, 3824, 4491, 5032, 5171, 5426, 5946, 6362, 6630, 6725, 7217, 7599, 8414, 8761, 9164, 9884, 10462, 11989, 12736, 12836, 13754]","[0, 211, 426, 641, 838, 1046, 1218, 1699, 1931, 2478, 3134, 3371, 3902, 4093, 4365, 4864, 5344, 6044, 6344, 6615, 6746, 7560, 7963, 8058, 8174, 8431, 8687, 9030, 9568, 10325, 10739, 11611, 12450, 12823, 13789]",19259,19947,14630,13754,13789,63,98,96,101,85,"[114, 407, 607, 942, 1675, 2181, 2554, 3334, 3725, 4127, 4794, 5528, 6420, 7298, 7885, 8473, 8833, 9325, 10457, 10969, 12229, 13621, 14550, 15821, 16596, 17404, 18284, 18938, 19707, 20441, 21653, 22286, 22656, 23620, 25003]","[382, 794, 1033, 1540, 1864, 2517, 3177, 3520, 4218, 4971, 5563, 5897, 6523, 7183, 7906, 8143, 9000, 9230, 9805, 10288, 11140, 11546, 12004, 12766, 12994, 13462, 13955, 14587, 15380, 15664, 16666, 16876, 17331, 17726, 18890]","[114, 323, 526, 984, 1612, 1910, 2131, 2830, 3321, 3879, 4139, 4984, 5543, 6418, 6731, 7015, 7528, 8169, 8889, 9521, 10184, 11027, 11765, 12006, 12389, 12898, 14178, 14827, 15231, 15372, 15863, 16347, 16956, 17689, 18912]","[247, 503, 593, 976, 1115, 1205, 1295, 1794, 2470, 2760, 2967, 3799, 4284, 4739, 4951, 5453, 5659, 6163, 6783, 6926, 7449, 7904, 8678, 8948, 9425, 10104, 11268, 11564, 12315, 12967, 13329, 13429, 14542, 15740, 17361]","[114, 323, 413, 503, 746, 905, 1255, 1612, 1769, 1906, 2159, 2454, 2634, 3088, 3300, 3756, 3935, 4165, 4369, 4509, 5109, 5695, 6480, 6831, 7031, 7308, 8192, 8645, 8876, 9016, 9334, 9642, 10012, 10580, 11507]",25003,18890,18912,17361,11507,-5744,1057,-4282,-3607,2282,-10294,35,dire
7556255807,47,72,82,20,19,"[0, 239, 439, 810, 1451, 1625, 1981, 2071, 2641, 2981, 3191, 4186, 4645, 5166, 5261, 6312, 6918, 7445, 8053, 8148, 8840, 9288, 9948, 10646, 11404, 12254, 12930, 13707, 14136, 14466, 14643, 14805, 15733, 16924, 19618]","[0, 251, 517, 804, 1040, 1452, 1915, 2272, 2564, 2907, 3348, 4200, 4616, 5522, 5654, 6271, 6657, 7424, 8326, 8801, 9926, 10474, 10725, 11100, 12058, 12628, 13213, 14655, 15084, 15942, 16413, 16513, 16973, 17073, 19015]","[0, 245, 524, 650, 1086, 1212, 1506, 1977, 2136, 2392, 3112, 3655, 4173, 4565, 5007, 5520, 5780, 6687, 7472, 8149, 8508, 9173, 9424, 10048, 10393, 11308, 12832, 14117, 14955, 15074, 15251, 15471, 16387, 17309, 18806]","[0, 170, 275, 365, 500, 641, 750, 940, 1145, 1235, 1370, 2122, 2302, 2511, 2760, 3139, 3262, 3543, 3845, 3940, 4397, 4716, 5460, 5913, 6232, 6608, 6946, 7333, 7999, 8095, 8272, 8459, 9143, 9988, 11264]","[0, 170, 260, 350, 440, 530, 798, 924, 1051, 1180, 1315, 1867, 2047, 2526, 2709, 3104, 3415, 4108, 4652, 4747, 5290, 5609, 5704, 5889, 6169, 6630, 7293, 7690, 7866, 8097, 8274, 8374, 8834, 8934, 9762]",19618,19015,18806,11264,9762,106,95,28,27,79,"[331, 622, 1188, 1474, 1601, 1847, 2417, 3123, 3586, 4153, 4695, 4863, 5280, 5591, 6867, 7265, 7759, 9219, 9691, 10362, 10632, 10989, 13282, 14450, 15128, 16302, 17239, 18280, 19804, 21484, 23173, 24332, 24906, 26362, 26683]","[63, 315, 559, 970, 1394, 1780, 2193, 2534, 2646, 3078, 3689, 3874, 4333, 4796, 5602, 6314, 7114, 7939, 8383, 9093, 9549, 10162, 10569, 11030, 11457, 12546, 13244, 14583, 15300, 15742, 16629, 17103, 17725, 19055, 19549]","[63, 233, 544, 1057, 1183, 1430, 1770, 2198, 2733, 3045, 3419, 3931, 4467, 4723, 5480, 5985, 6214, 6991, 7295, 7773, 7868, 7962, 8290, 9107, 9810, 10397, 10784, 11358, 11627, 12606, 13979, 14324, 14602, 15084, 15364]","[63, 233, 388, 815, 1017, 1599, 1802, 2054, 2933, 3207, 3921, 4059, 4408, 5047, 5498, 5865, 5982, 6397, 6624, 7491, 7586, 7935, 8297, 8893, 9085, 9423, 9691, 10307, 11209, 11928, 13201, 13892, 14014, 14783, 14883]","[63, 233, 353, 457, 601, 731, 1175, 1427, 1748, 2024, 2404, 2781, 2984, 3303, 3642, 3875, 4171, 4588, 4683, 5224, 5319, 5913, 6967, 7563, 7792, 8250, 8491, 9457, 9913, 10837, 11724, 12164, 12442, 13463, 13704]",26683,19549,15364,14883,13704,-7065,-534,3442,-3619,-3942,-11718,35,radiant
7556413616,82,120,129,66,86,"[534, 739, 955, 1386, 1509, 2085, 2341, 2822, 3402, 3852, 4635, 5243, 5555, 6486, 7483, 8457, 9326, 9640, 10499, 11402, 12302, 13246, 14576, 15295, 16377, 16747, 17016, 18336, 19042, 19142, 19242, 20089, 21119, 22195, 22708]","[450, 777, 1139, 1427, 1805, 2221, 2618, 3165, 3630, 4333, 5054, 5578, 6208, 6502, 7178, 7680, 8474, 8850, 9482, 9887, 10767, 11879, 12577, 13144, 13319, 14204, 15163, 16109, 16329, 16936, 17224, 17866, 18482, 19513, 20073]","[616, 813, 1212, 1515, 1958, 2617, 3063, 3397, 4000, 4851, 5313, 6124, 7081, 7635, 8153, 8939, 9633, 9728, 10858, 11309, 11797, 12730, 13354, 14146, 14552, 14647, 15007, 15573, 16076, 16176, 16276, 16665, 16765, 18246, 19461]","[303, 461, 645, 844, 1015, 1341, 1639, 1846, 2190, 3100, 3377, 3685, 4283, 4555, 4973, 5265, 5673, 6060, 6404, 6842, 7245, 7883, 8417, 8837, 9298, 9572, 9963, 10395, 10566, 11127, 11302, 11705, 12089, 12771, 13095]","[312, 402, 596, 770, 860, 1040, 1548, 1706, 1932, 2258, 2542, 2735, 2977, 3532, 3878, 4110, 4522, 4849, 5178, 5445, 5997, 6678, 7149, 7481, 7962, 8132, 8536, 9000, 9356, 9585, 9819, 9957, 10057, 10499, 10709]",22708,20073,19461,13095,10709,73,47,97,105,7,"[507, 773, 1064, 1559, 2001, 2721, 2980, 3294, 3982, 4491, 5495, 6622, 7648, 8463, 9398, 10358, 11495, 12216, 13028, 14051, 15351, 16012, 17068, 17714, 19028, 19912, 20977, 22314, 23294, 24080, 24897, 25744, 26692, 27754, 28920]","[412, 757, 1094, 1417, 1794, 2267, 2646, 3131, 3655, 3962, 4408, 4897, 5418, 5997, 6837, 7581, 8400, 9122, 9785, 10611, 11584, 11889, 12173, 12328, 13576, 15061, 16073, 17295, 18730, 19773, 20241, 20924, 22467, 23146, 23246]","[605, 917, 1213, 1460, 1700, 2262, 2713, 3020, 3595, 4126, 4669, 5150, 5593, 5927, 6533, 7231, 8031, 8438, 9206, 9391, 9815, 10120, 10585, 11345, 12049, 13039, 13985, 14325, 15103, 15719, 15857, 16527, 17413, 17856, 18482]","[310, 400, 535, 625, 715, 865, 1025, 1236, 1584, 1820, 2127, 2501, 3484, 3758, 4195, 4364, 4900, 5270, 5462, 5722, 6221, 6428, 6637, 6807, 7477, 7886, 8363, 8526, 9182, 9482, 9677, 10243, 10566, 11307, 11494]","[341, 480, 619, 742, 832, 993, 1083, 1275, 1504, 1992, 2131, 2364, 2934, 3064, 3362, 3581, 3722, 4074, 4244, 4791, 5286, 5506, 5676, 6278, 6447, 7070, 7755, 7926, 8454, 8789, 8964, 9294, 9627, 9982, 10291]",28920,23246,18482,11494,10291,-6212,-3173,979,1601,418,-6387,35,dire
7556745318,6,53,29,49,86,"[80, 516, 747, 1043, 1614, 2070, 2635, 3028, 3399, 4182, 4474, 5485, 6167, 6626, 6988, 7607, 7989, 8103, 8860, 9629, 10135, 10546, 11688, 11947, 12608, 13330, 13715, 14396, 14739, 15456, 15788, 16675, 17395, 18487, 19299]","[80, 344, 536, 884, 1397, 1796, 2080, 2881, 3258, 3986, 4384, 4936, 5423, 5815, 6265, 6466, 6667, 6866, 7315, 8006, 8729, 9007, 9394, 9536, 9749, 10069, 10210, 11209, 11576, 12237, 12628, 13430, 13622, 14844, 14944]","[80, 319, 544, 814, 1144, 1623, 2042, 2576, 3074, 3254, 3912, 4672, 4919, 5481, 5786, 6075, 6274, 6809, 7388, 7815, 8085, 8389, 8529, 8692, 9109, 9359, 9872, 10638, 10734, 11091, 11612, 12169, 12984, 14055, 14155]","[80, 321, 662, 944, 1236, 1574, 1932, 2191, 2511, 3037, 3242, 3917, 4386, 4730, 5446, 5941, 6080, 6751, 7538, 8106, 8376, 8573, 8768, 8949, 9289, 9608, 9894, 10451, 10647, 11282, 12400, 12500, 12838, 13710, 14033]","[474, 644, 759, 947, 1128, 1296, 1501, 1991, 2208, 2501, 2716, 3929, 4493, 4716, 5181, 5275, 5612, 5707, 6257, 6572, 6712, 6940, 7035, 7189, 7374, 7469, 7672, 8149, 8301, 8921, 9017, 9117, 9291, 9618, 9718]",19299,14944,14155,14033,9718,98,93,22,64,2,"[354, 611, 889, 1346, 1704, 1994, 2556, 3330, 3671, 4644, 5056, 6839, 6965, 8356, 8809, 9499, 10674, 11220, 11702, 12343, 13622, 14430, 15431, 16174, 16476, 17059, 17874, 19105, 19469, 19968, 21033, 21415, 21653, 22329, 23021]","[110, 280, 521, 741, 1292, 1619, 1979, 2142, 2232, 2545, 2680, 3025, 3698, 4215, 4985, 5245, 6028, 6569, 7216, 7854, 8447, 9190, 10426, 11181, 12104, 12775, 13219, 14426, 14738, 15376, 15472, 16034, 16610, 17789, 18444]","[489, 659, 1258, 1348, 1538, 1790, 1880, 2067, 2393, 2590, 2986, 3622, 3835, 4069, 4807, 5349, 6241, 7123, 7698, 8187, 9383, 9836, 10352, 11162, 11534, 12398, 13048, 14924, 15229, 15816, 16184, 16650, 17818, 18534, 18943]","[487, 657, 747, 909, 1089, 1224, 1658, 1748, 1923, 2361, 2589, 3289, 3379, 3613, 3993, 4087, 4329, 4754, 5043, 5574, 6409, 6579, 6893, 7521, 8145, 8337, 8588, 9668, 9925, 10216, 10954, 11293, 11468, 12508, 12683]","[221, 391, 636, 833, 1091, 1226, 1316, 1720, 1853, 2044, 2401, 2882, 3057, 3323, 3726, 4504, 4948, 5514, 5770, 6407, 7353, 7615, 8080, 8803, 9277, 9388, 9931, 10970, 11174, 11752, 12879, 13231, 13442, 13984, 14084]",23021,18444,18943,12683,14084,-3722,-3500,-4788,1350,-4366,-15026,35,dire
7556977117,63,126,21,108,26,"[1, 242, 522, 961, 1378, 1680, 2364, 2538, 2799, 3094, 3500, 4155, 4597, 5791, 6152, 6499, 6912, 7160, 7526, 7936, 8201, 8658, 9193, 9380, 9837, 10344, 11133, 12294, 13052, 14025, 15367, 16062, 16594, 17469, 18463]","[1, 426, 589, 944, 1356, 1712, 2278, 2661, 3132, 3819, 4879, 5428, 6306, 6616, 7163, 7808, 7992, 9162, 9297, 9612, 9988, 10165, 10420, 11009, 11103, 11427, 11685, 12664, 13178, 13355, 14419, 14905, 15662, 16471, 17295]","[1, 215, 384, 521, 806, 997, 1380, 1552, 2063, 2188, 2635, 2821, 2911, 3560, 3992, 4651, 5310, 6520, 6971, 7257, 7585, 7818, 8020, 8653, 9227, 9679, 9842, 11558, 12316, 13015, 14584, 15047, 15432, 16125, 16634]","[1, 171, 370, 576, 976, 1264, 1700, 1838, 1980, 2107, 2332, 2871, 3158, 3576, 3935, 4330, 4890, 5781, 6105, 6485, 6678, 6942, 7204, 7709, 8015, 8203, 8298, 9171, 9348, 9663, 10365, 11358, 11940, 12494, 13065]","[1, 171, 597, 810, 938, 1044, 1332, 1422, 2106, 2215, 2621, 2711, 2801, 3308, 3493, 3889, 4073, 4836, 5123, 5281, 5375, 5470, 5565, 5660, 5754, 5849, 5983, 6963, 7140, 7317, 7633, 8026, 8126, 8316, 8510]",18463,17295,16634,13065,8510,70,71,22,20,75,"[1, 247, 547, 875, 1326, 1617, 1992, 2739, 3220, 3908, 4434, 4809, 5257, 5656, 6380, 7156, 8303, 8907, 9218, 10696, 11568, 12356, 13344, 14585, 15780, 16656, 18000, 18880, 18976, 19949, 20203, 20689, 21538, 22306, 23037]","[1, 171, 615, 823, 1146, 1345, 1674, 2006, 2241, 2877, 3054, 3887, 4315, 4573, 5164, 5387, 5846, 6329, 6914, 7573, 8248, 8744, 9001, 9686, 10295, 10975, 11952, 12507, 12673, 13241, 13519, 13931, 14732, 15581, 16075]","[1, 259, 573, 778, 1117, 1481, 1811, 2569, 2769, 3035, 3606, 4051, 4411, 4982, 5337, 5657, 5944, 7083, 7522, 8276, 8854, 9496, 9853, 10558, 10839, 11431, 11978, 12427, 12927, 13649, 13839, 13939, 14401, 14711, 15081]","[1, 171, 308, 398, 578, 708, 1340, 1611, 1701, 2028, 2254, 2490, 2669, 3249, 3398, 3597, 3972, 4956, 5396, 6046, 6256, 6530, 6810, 7310, 7523, 8102, 8581, 8913, 9084, 9635, 10038, 10213, 10388, 10753, 11055]","[1, 171, 567, 657, 831, 1000, 1122, 1412, 1878, 2000, 2177, 2591, 2681, 2939, 3088, 3287, 3709, 4178, 4273, 5042, 5254, 5416, 5707, 6132, 6506, 6855, 7452, 7708, 7804, 8051, 8486, 8586, 8686, 8945, 9180]",23037,16075,15081,11055,9180,-4574,1220,1553,2010,-670,-461,35,dire
7557160807,10,120,129,65,20,"[814, 1352, 1807, 2318, 2689, 3137, 3607, 4328, 4968, 5588, 6279, 6966, 7713, 8715, 9732, 10795, 11112, 12044, 12587, 13494, 14334, 15266, 16895, 18025, 18551, 19311, 20279, 21612, 21712, 22259, 23133, 24351, 25199, 26352, 27597]","[958, 1205, 1616, 1955, 2629, 3039, 3289, 3932, 4543, 4950, 5675, 6459, 6831, 7975, 8560, 9283, 9635, 10425, 10772, 11559, 12078, 12502, 13522, 14215, 14737, 15246, 15877, 16818, 16918, 17283, 17905, 18854, 19633, 20153, 20762]","[956, 1226, 1676, 2185, 2687, 3048, 3584, 4386, 4665, 5129, 5921, 6286, 6701, 7035, 8005, 8398, 8989, 9192, 9969, 10652, 11123, 11724, 12290, 12866, 13382, 13677, 14728, 15210, 15524, 16166, 17572, 18107, 18769, 19168, 19863]","[619, 714, 804, 1386, 1726, 1816, 2292, 2671, 3237, 3500, 4005, 4138, 4501, 5295, 5909, 6164, 6501, 6888, 7620, 8001, 8332, 8550, 9697, 10065, 10580, 10933, 11220, 11923, 12023, 12485, 13357, 13772, 13872, 14170, 14617]","[567, 704, 794, 1033, 1316, 1530, 1959, 2346, 2623, 2762, 3077, 3259, 3624, 4117, 4319, 4548, 4688, 4891, 4986, 5516, 5745, 5920, 6677, 7307, 7558, 7735, 8098, 8679, 8779, 8879, 9181, 9596, 9696, 9983, 10565]",27597,20762,19863,14617,10565,41,74,29,105,45,"[957, 1227, 1462, 1761, 2167, 2662, 2888, 3151, 3805, 4350, 4772, 5279, 5682, 6340, 6900, 7541, 8211, 8825, 9614, 10304, 11098, 11713, 12361, 12754, 13105, 14079, 14670, 16405, 18123, 18889, 19079, 19179, 20063, 20849, 21349]","[761, 974, 1268, 1611, 1925, 2519, 2927, 3375, 3949, 4057, 4364, 4734, 5284, 5587, 6357, 6831, 7259, 7688, 7945, 8911, 9568, 9996, 10718, 11151, 11317, 11413, 11864, 11995, 13290, 13742, 14279, 14967, 15578, 16144, 16461]","[1195, 1546, 2017, 2386, 2859, 3335, 3584, 4110, 4565, 5079, 5604, 6380, 6652, 7338, 7692, 8184, 8342, 8995, 9957, 10622, 11190, 11667, 12577, 12671, 12836, 13766, 13897, 14130, 15089, 15376, 15566, 16527, 16880, 17064, 17482]","[514, 650, 740, 925, 1015, 1278, 1715, 1941, 2312, 2446, 2727, 3091, 3286, 3444, 3683, 3843, 4223, 4448, 4787, 4954, 5092, 5187, 5658, 6018, 6113, 6763, 7055, 7151, 8993, 9143, 10012, 10284, 10541, 10962, 11062]","[623, 713, 908, 1043, 1133, 1313, 1403, 1638, 1938, 2421, 2608, 2855, 3089, 3247, 3468, 3612, 3819, 4280, 4582, 4895, 5224, 5548, 6056, 6150, 6245, 6524, 6721, 7186, 7990, 8090, 8280, 8478, 8816, 8916, 9063]",21349,16461,17482,11062,9063,6248,4301,2381,3555,1502,17987,35,radiant
7557552704,10,43,23,79,20,"[0, 166, 433, 558, 916, 1250, 1631, 2092, 2427, 2912, 3522, 3889, 4555, 5238, 5507, 6154, 6881, 7718, 8507, 9603, 10456, 10550, 11010, 11959, 12720, 13694, 14666, 15491, 16488, 17329, 18303, 19160, 20410, 21341, 21992]","[0, 254, 525, 817, 1125, 1502, 1834, 2324, 2658, 3456, 4245, 4701, 5508, 5946, 6825, 7579, 8038, 8689, 9858, 10791, 12079, 12173, 13816, 14344, 15151, 16018, 16694, 17054, 17532, 17740, 18217, 18984, 19694, 20307, 20673]","[0, 204, 576, 1017, 1406, 1571, 1849, 2257, 2589, 3200, 4005, 4538, 5064, 5766, 6628, 7128, 7594, 8385, 8792, 9373, 9947, 10144, 10867, 11328, 11689, 12177, 12598, 12737, 13284, 14023, 14399, 15167, 15586, 15872, 16603]","[0, 130, 245, 733, 868, 958, 1177, 1397, 1790, 2200, 2632, 2843, 3135, 3231, 3636, 3824, 4300, 4509, 4711, 5022, 5452, 5546, 6106, 6350, 6892, 7249, 7840, 8353, 8613, 9068, 9239, 9665, 10193, 10435, 10801]","[0, 130, 245, 335, 473, 563, 714, 804, 1032, 1284, 1599, 1761, 1930, 2175, 2598, 2729, 2896, 3083, 3408, 3719, 4017, 4111, 4278, 4807, 5154, 5568, 6093, 6234, 6419, 6608, 6704, 7501, 7817, 8007, 8605]",21992,20673,16603,10801,8605,78,6,98,64,21,"[0, 246, 499, 747, 1091, 1522, 1813, 2127, 2585, 3032, 3561, 3997, 4778, 5278, 5593, 6063, 6578, 6928, 7975, 8152, 8831, 9403, 10146, 10825, 11229, 12124, 12977, 13343, 14454, 14840, 15324, 15944, 17361, 17666, 18949]","[0, 247, 484, 684, 963, 1398, 2116, 2327, 2462, 2731, 3193, 3540, 4232, 4743, 4892, 5443, 6095, 6662, 7345, 7677, 8067, 8926, 9110, 9531, 10109, 10840, 11372, 11912, 12712, 13312, 14297, 14739, 15323, 15859, 17957]","[0, 367, 763, 1093, 1468, 1842, 2305, 2551, 3047, 3392, 3859, 4528, 4968, 5540, 5733, 6139, 6982, 7319, 7981, 8076, 8513, 8902, 9086, 9917, 10585, 11168, 12017, 12722, 13856, 14388, 15022, 15408, 16356, 17097, 18328]","[0, 357, 536, 626, 760, 1103, 1309, 1399, 1687, 1955, 2125, 2313, 2742, 2890, 3093, 3283, 3621, 3933, 4573, 4729, 4913, 5229, 5415, 5842, 6028, 6195, 6337, 6639, 7222, 7318, 7910, 8330, 8831, 8977, 10344]","[0, 210, 352, 489, 579, 937, 1121, 1379, 1734, 2081, 2216, 2365, 2788, 3094, 3559, 3717, 4026, 4183, 4560, 4907, 5241, 5557, 5748, 6060, 6573, 6904, 7300, 7533, 7973, 8264, 8576, 9034, 9936, 10085, 11200]",18949,17957,18328,10344,11200,3043,2716,-1725,457,-2595,1896,35,radiant
7557808608,10,39,96,123,66,"[419, 739, 1346, 1588, 2052, 2534, 3041, 3659, 4325, 4920, 5701, 6635, 6856, 7383, 8169, 8865, 9893, 10638, 11149, 11553, 12022, 12844, 14364, 15420, 16295, 17305, 17485, 18355, 19154, 20944, 22148, 23072, 24679, 25344, 26676]","[506, 791, 1318, 1747, 2098, 2417, 2726, 3265, 4186, 4551, 5192, 5719, 6103, 6696, 7550, 8585, 9282, 10215, 10842, 11148, 11313, 12319, 13067, 13475, 14430, 15254, 15688, 16503, 17477, 19219, 20008, 20822, 22199, 22756, 24379]","[396, 764, 1133, 1410, 1838, 2146, 2433, 2898, 3622, 4181, 4713, 5352, 5981, 6261, 6656, 7504, 7909, 8618, 8874, 9264, 10076, 10415, 11352, 12024, 12407, 12948, 13044, 13507, 14331, 15473, 16039, 16895, 17539, 17768, 19100]","[266, 453, 661, 773, 1025, 1475, 1612, 1877, 2331, 2529, 3069, 3481, 3871, 4132, 4427, 5020, 5444, 5855, 6075, 6528, 7253, 7573, 7667, 8194, 8633, 8901, 9127, 9294, 9666, 10577, 11066, 11303, 12124, 12743, 14159]","[258, 367, 674, 792, 917, 1269, 1480, 1684, 2234, 2732, 3069, 3582, 3801, 4061, 4608, 4896, 5301, 5830, 6132, 6485, 6757, 6990, 7551, 7791, 8042, 8391, 8649, 9038, 9328, 9937, 10670, 10880, 12024, 12346, 13524]",26676,24379,19100,14159,13524,95,13,128,53,19,"[558, 794, 1388, 1805, 2208, 2605, 2845, 3309, 3739, 4303, 4836, 5249, 5552, 6244, 6926, 7712, 7970, 8225, 8831, 9232, 10955, 11598, 12492, 13445, 14010, 14683, 15399, 16240, 16798, 16898, 17510, 18403, 19167, 19368, 20221]","[565, 872, 1206, 1539, 1950, 2305, 3004, 3298, 3472, 3953, 4372, 4751, 5566, 5876, 6296, 6391, 6877, 7254, 7945, 8356, 8927, 9633, 10068, 10524, 11678, 12201, 12639, 13447, 14217, 14698, 15124, 15734, 16445, 17254, 17452]","[639, 871, 1276, 1484, 1799, 2120, 2516, 3023, 3420, 3865, 4382, 4974, 5544, 5951, 6631, 6799, 7044, 7483, 8301, 8648, 9484, 9853, 10455, 10866, 11065, 11685, 12167, 12645, 12741, 12952, 13380, 13805, 13905, 14169, 14413]","[300, 395, 600, 735, 825, 1267, 1480, 1722, 1812, 2045, 2248, 2536, 2968, 3195, 3711, 3912, 4274, 4676, 5203, 5526, 6139, 6424, 7718, 7957, 8386, 9556, 10329, 10749, 10880, 10980, 11482, 11873, 12557, 12883, 13103]","[300, 390, 529, 619, 709, 879, 1107, 1332, 1422, 1980, 2070, 2255, 2620, 2875, 3032, 3446, 3600, 3792, 4050, 4145, 4831, 5176, 5455, 5694, 6207, 6558, 6965, 7343, 7618, 7718, 7975, 8476, 8625, 8814, 9310]",20221,17452,14413,13103,9310,6455,6927,4687,1056,4214,23339,35,radiant
7557812714,1,23,97,53,72,"[0, 248, 638, 885, 1271, 1627, 2358, 2935, 3290, 3665, 3951, 4347, 5120, 6188, 6761, 7432, 8547, 9466, 10201, 11098, 11545, 12516, 12904, 13646, 14484, 15230, 15947, 16722, 17018, 17498, 19624, 20859, 22726, 24255, 25237]","[0, 337, 616, 1071, 1729, 2066, 2679, 3227, 3660, 4255, 4858, 5157, 6423, 7299, 7848, 8112, 8495, 8813, 9630, 9958, 10409, 10918, 11441, 12323, 12866, 13209, 13433, 13528, 14176, 14963, 16050, 16679, 17887, 19193, 20449]","[0, 292, 613, 947, 1270, 1664, 2046, 2472, 3204, 3545, 4109, 4390, 5100, 5586, 6057, 6381, 6907, 7469, 8481, 9265, 9645, 10185, 10939, 11442, 12197, 12506, 13127, 13222, 13701, 13936, 14497, 15574, 15879, 16294, 17470]","[0, 209, 299, 389, 568, 704, 853, 1005, 1384, 1474, 1763, 1853, 2536, 2944, 3393, 3801, 4455, 4976, 5362, 6033, 6128, 6466, 6868, 7591, 8116, 8211, 8651, 9089, 9185, 9515, 10467, 11078, 12288, 12875, 13911]","[0, 209, 629, 765, 992, 1131, 1569, 1757, 1948, 2119, 2347, 2475, 2916, 3277, 3472, 3566, 4082, 4387, 4525, 5060, 5422, 5517, 6035, 6465, 6584, 6781, 7005, 7100, 7741, 8190, 9203, 9573, 9905, 10115, 10763]",25237,20449,17470,13911,10763,98,41,104,64,26,"[0, 222, 549, 802, 1099, 1465, 1927, 3058, 3606, 4231, 4835, 5527, 5973, 6310, 6678, 6913, 8262, 9067, 9447, 10375, 11341, 11901, 12853, 13817, 14498, 15005, 15450, 16447, 17801, 17972, 18143, 18636, 19321, 19526, 19887]","[0, 243, 561, 723, 1258, 1573, 1806, 2067, 2326, 2768, 3106, 3461, 4040, 4385, 4747, 5236, 6464, 7207, 7677, 8614, 9725, 10159, 10625, 10972, 11359, 12359, 12705, 13998, 15045, 15432, 15813, 16564, 17765, 17865, 18484]","[0, 271, 703, 1032, 1372, 1712, 1925, 2513, 2868, 3213, 3699, 4073, 4662, 5013, 5469, 5856, 6454, 6778, 7675, 8570, 8841, 9722, 10397, 10656, 10751, 11163, 11706, 11969, 12577, 12673, 12769, 13068, 13662, 13762, 14672]","[0, 154, 244, 334, 559, 649, 826, 1293, 1516, 1699, 1971, 2199, 2472, 2687, 2869, 2963, 3537, 3883, 4040, 4646, 5180, 5606, 5972, 6516, 7049, 7618, 7831, 8351, 8660, 8756, 9406, 9506, 10437, 10567, 10667]","[0, 154, 366, 492, 663, 787, 927, 1393, 1483, 1922, 2101, 2486, 2759, 2937, 3229, 3323, 3418, 3636, 3906, 4741, 5103, 5281, 5746, 6022, 6192, 6434, 6603, 7165, 7305, 7866, 8258, 8365, 9550, 9652, 9808]",19887,18484,14672,10667,9808,5350,1965,2798,3244,955,14312,35,radiant
7557847702,48,29,74,105,20,"[75, 720, 983, 1403, 1926, 2312, 2684, 3355, 3758, 4350, 4795, 5224, 6220, 7029, 7124, 8123, 8771, 9148, 10004, 10420, 11226, 11778, 12143, 12948, 13293, 13455, 14439, 15046, 17495, 18395, 19113, 19579, 20278, 20378, 21563]","[141, 436, 723, 960, 1110, 1364, 1644, 1828, 1945, 2331, 2732, 3293, 3855, 4366, 5114, 5347, 5972, 6194, 6580, 7316, 7411, 7802, 8915, 9184, 9625, 9824, 9919, 10849, 13108, 13826, 14441, 14993, 15093, 16606, 17244]","[208, 588, 797, 1086, 1216, 1643, 2090, 2257, 2879, 3063, 3406, 4018, 4882, 5341, 5659, 6024, 6865, 7068, 7625, 7906, 8501, 8838, 9149, 9278, 9545, 9745, 10133, 10267, 10609, 11587, 12077, 12259, 12588, 12688, 13190]","[75, 490, 580, 734, 907, 1077, 1492, 1582, 1966, 2377, 2821, 3331, 3731, 4157, 4502, 4850, 5271, 5872, 6029, 6342, 6613, 6955, 7237, 7573, 7775, 8275, 8719, 8889, 10003, 10808, 11027, 11235, 11364, 12113, 12788]","[0, 681, 801, 998, 1205, 1696, 1975, 2217, 2841, 3025, 3208, 3758, 3960, 4108, 4360, 4483, 4835, 4929, 5192, 5530, 5625, 5819, 6191, 6286, 6650, 6783, 7079, 7174, 8153, 8704, 8894, 8994, 9094, 9507, 9607]",21563,17244,13190,12788,9607,41,106,38,107,79,"[191, 631, 1033, 1243, 1524, 1900, 2303, 2767, 3245, 3747, 4406, 4637, 5406, 6102, 6718, 7231, 7741, 8240, 8873, 10007, 10697, 11099, 12619, 13233, 13927, 14867, 16214, 16770, 17573, 18371, 19105, 19705, 21393, 23077, 23864]","[122, 426, 961, 1124, 1514, 1874, 2213, 2738, 3033, 3692, 4477, 4567, 5123, 5731, 6302, 6746, 7588, 8495, 9045, 10082, 10597, 11086, 12327, 12996, 13980, 15559, 17042, 17620, 18014, 18110, 19141, 20050, 20995, 22367, 23271]","[390, 705, 923, 1050, 1425, 1821, 2197, 2647, 2855, 3260, 4007, 4506, 4956, 5661, 6436, 7092, 7587, 8256, 8794, 10014, 10599, 11034, 12632, 13327, 13672, 14673, 15360, 16231, 16906, 17173, 17432, 18352, 19080, 20768, 21431]","[122, 252, 425, 550, 675, 1225, 1315, 1450, 1540, 2003, 2489, 2700, 2880, 3443, 3839, 4229, 5049, 5673, 5816, 6234, 6712, 7358, 8226, 8475, 8928, 9610, 9950, 10245, 10466, 10917, 11466, 12364, 13161, 14225, 14830]","[122, 533, 663, 777, 954, 1129, 1267, 1420, 1786, 1912, 2304, 2568, 2821, 3256, 3917, 4298, 4671, 5053, 5193, 6029, 6250, 6344, 6856, 7232, 7597, 8500, 8840, 9135, 9592, 9688, 9784, 10338, 10980, 11695, 12300]",23864,23271,21431,14830,12300,-2301,-6027,-8241,-2042,-2693,-21304,35,dire
7557858600,98,51,6,105,100,"[0, 206, 480, 890, 1371, 1669, 2064, 2670, 3093, 3643, 4278, 5011, 5540, 6049, 6519, 7480, 7989, 9022, 9698, 10016, 10884, 11894, 12477, 13109, 13966, 14630, 15605, 16195, 16424, 16796, 17536, 18415, 19039, 19795, 20027]","[0, 243, 527, 910, 1089, 1447, 1862, 2623, 3013, 3495, 3790, 4443, 5182, 5774, 6365, 7394, 7593, 8341, 8651, 9482, 9991, 10802, 11509, 12032, 12703, 13325, 13723, 14238, 14877, 15704, 16421, 17094, 18104, 18795, 19152]","[0, 251, 704, 986, 1114, 1451, 1646, 1856, 2073, 2330, 2640, 2864, 3376, 3870, 4275, 5214, 5586, 6126, 6938, 7465, 8264, 9243, 10089, 10331, 10755, 11263, 11901, 12288, 12517, 13383, 14168, 14871, 15324, 15928, 16931]","[0, 169, 276, 370, 460, 595, 803, 1043, 1178, 1535, 1625, 2117, 2504, 2764, 2905, 3233, 3477, 3832, 4127, 4445, 4860, 5555, 5917, 6262, 6536, 6741, 6955, 7281, 7882, 8251, 8823, 9167, 9432, 9742, 10180]","[0, 384, 608, 718, 850, 1041, 1131, 1221, 1356, 1529, 1619, 1985, 2458, 2718, 2813, 3265, 3675, 3960, 4591, 4798, 5146, 5526, 5726, 5999, 6275, 6480, 6788, 6943, 7039, 7534, 8051, 8604, 9447, 9682, 9872]",20027,19152,16931,10180,9872,25,54,47,53,123,"[58, 387, 716, 1074, 1787, 2564, 2936, 3596, 3951, 4529, 5183, 5719, 6280, 7133, 7828, 8298, 8835, 9507, 10191, 11085, 11571, 11666, 12124, 12895, 13590, 14404, 15487, 15969, 16677, 17338, 18227, 18826, 19624, 20486, 21905]","[58, 263, 467, 681, 962, 1377, 1674, 2013, 2168, 2599, 2887, 3309, 3851, 4258, 4768, 5395, 5815, 6485, 6920, 7476, 8040, 8440, 9165, 9525, 10274, 10531, 11002, 11890, 12715, 13350, 14053, 14321, 15006, 15957, 16651]","[326, 596, 723, 901, 1187, 1437, 1993, 2313, 2662, 3491, 3980, 4225, 4794, 5526, 5767, 6598, 6756, 7287, 7793, 8088, 8464, 8667, 9511, 9606, 10063, 10263, 10695, 11289, 12098, 12470, 12904, 13039, 13517, 13864, 14346]","[58, 425, 515, 609, 783, 913, 1124, 1520, 1741, 2239, 2536, 2779, 3101, 3860, 3955, 4332, 5140, 5745, 6105, 6400, 6803, 7006, 7304, 7399, 7884, 7979, 8670, 8993, 9798, 9979, 10075, 10413, 10660, 11155, 11590]","[58, 330, 493, 583, 761, 891, 1102, 1498, 1588, 1910, 2412, 2797, 3466, 4081, 4176, 4698, 4856, 4951, 5494, 6026, 6121, 6216, 6797, 7402, 7755, 7850, 8529, 8852, 9427, 9824, 10013, 10113, 10441, 10631, 11155]",21905,16651,14346,11590,11155,-1878,2501,2585,-1410,-1283,515,35,radiant
7557904901,49,41,76,123,20,"[0, 290, 642, 943, 1299, 1770, 2192, 2677, 3223, 3475, 4267, 4667, 4983, 5540, 6171, 7041, 8028, 8478, 8676, 9520, 9875, 10275, 10568, 11255, 11765, 12347, 12874, 13041, 13843, 14554, 15300, 16549, 16649, 17273, 17901]","[0, 244, 445, 618, 914, 1316, 1615, 2024, 2391, 3106, 3805, 4174, 4753, 4848, 5343, 6031, 6468, 7020, 7356, 7900, 8619, 8995, 9288, 9817, 10346, 11128, 12190, 12285, 12811, 13890, 14513, 15834, 15934, 16658, 18600]","[0, 169, 383, 706, 901, 1229, 1509, 2120, 2571, 2962, 3735, 4121, 4426, 5306, 5754, 6374, 6587, 6899, 7175, 7569, 8150, 8614, 9244, 9538, 10069, 10466, 10895, 10990, 11120, 11857, 12227, 12327, 12466, 12783, 13296]","[0, 169, 259, 429, 563, 958, 1093, 1430, 1598, 1887, 2267, 2428, 2651, 2828, 3135, 3508, 4019, 4200, 4370, 4663, 4792, 5153, 5427, 5768, 6070, 6421, 6897, 6992, 7088, 7312, 8011, 8111, 8431, 9034, 9557]","[0, 169, 259, 349, 439, 590, 725, 906, 1110, 1280, 1757, 2113, 2300, 2602, 2697, 2944, 3184, 3420, 3515, 3772, 4044, 4370, 4602, 5006, 5101, 5378, 5472, 5621, 5766, 6175, 6381, 6656, 6902, 7396, 7737]",17901,18600,13296,9557,7737,106,22,71,93,53,"[0, 288, 690, 984, 1438, 1763, 2084, 2304, 2775, 3152, 4011, 4139, 4531, 5112, 5662, 6046, 6723, 7475, 7840, 8361, 9159, 9447, 10222, 11063, 11800, 12370, 13296, 14345, 14984, 15553, 16114, 17649, 18763, 19447, 19992]","[0, 169, 309, 877, 1007, 1255, 1562, 1697, 1897, 1987, 2167, 2497, 3114, 3668, 3869, 5011, 5374, 5925, 6233, 6904, 7585, 8592, 9698, 10153, 10585, 11098, 11436, 12006, 12669, 13442, 14325, 15798, 16895, 17437, 17627]","[0, 205, 482, 876, 1277, 1871, 2158, 2727, 3267, 3716, 4045, 4257, 4973, 5514, 5663, 6397, 6645, 6740, 7530, 8114, 8596, 9337, 10184, 10694, 11723, 12186, 12960, 14082, 14614, 15810, 16106, 17048, 17850, 18494, 19283]","[0, 208, 532, 690, 935, 1309, 1601, 2137, 2771, 2999, 3586, 3889, 4513, 5082, 5704, 6404, 7274, 7968, 8940, 9666, 10614, 11102, 12269, 12772, 13362, 13860, 14474, 15275, 15911, 16322, 16706, 17302, 17797, 18529, 19049]","[0, 169, 259, 383, 558, 688, 846, 981, 1071, 1161, 1455, 1545, 1819, 2128, 2377, 2807, 3055, 3448, 3712, 4315, 4536, 4931, 5746, 5947, 6301, 6482, 6762, 6982, 7356, 7859, 8327, 8427, 9107, 9297, 9711]",19992,17627,19283,19049,9711,-2091,973,-5987,-9492,-1974,-18571,35,dire
7557955707,120,41,102,107,75,"[0, 257, 622, 1092, 1414, 1614, 2057, 2475, 3015, 3105, 3488, 4181, 4434, 5279, 5679, 6066, 6803, 7285, 8116, 8273, 8857, 9617, 10021, 10343, 10880, 11514, 11947, 12203, 12500, 12808, 14182, 15008, 15450, 16939, 17723]","[0, 294, 490, 762, 1132, 1530, 1858, 2216, 2615, 3243, 3644, 4197, 4680, 5034, 5570, 5856, 6829, 7325, 7934, 8499, 8594, 9125, 9664, 10008, 10698, 11264, 11741, 12060, 13070, 14057, 14814, 15749, 16654, 18286, 18855]","[0, 208, 519, 804, 1102, 1433, 1523, 1909, 2313, 2968, 3508, 4040, 4284, 4454, 5054, 5401, 6564, 7152, 7502, 7826, 8272, 8716, 9460, 10003, 10264, 10883, 11153, 11835, 12112, 12420, 13046, 14168, 14325, 15513, 16107]","[0, 217, 359, 690, 780, 949, 1039, 1174, 1264, 1743, 2194, 2485, 2622, 3063, 3231, 3325, 3977, 4348, 4785, 4942, 5097, 5319, 5489, 5658, 5828, 6334, 6504, 6835, 7051, 7434, 8099, 8454, 8629, 9959, 10261]","[0, 169, 259, 349, 488, 630, 742, 877, 967, 1057, 1250, 1714, 1983, 2340, 2497, 2591, 2910, 3095, 3390, 3547, 3818, 3989, 4198, 4292, 4437, 4532, 4627, 4883, 4979, 5287, 5383, 5663, 5763, 6720, 6820]",17723,18855,16107,10261,6820,17,93,97,27,26,"[65, 382, 671, 885, 1282, 1832, 2087, 2460, 2771, 3547, 4127, 4954, 5352, 5782, 6133, 6680, 7341, 7895, 8495, 9592, 10522, 11304, 12329, 12955, 13863, 14636, 15577, 16832, 18397, 19100, 19511, 20086, 21111, 21714, 22483]","[65, 293, 614, 814, 1323, 1525, 1973, 2354, 2606, 2908, 3625, 3969, 4353, 5166, 5949, 6469, 7165, 7952, 8669, 9910, 10573, 11223, 11689, 12863, 13931, 14665, 15306, 16319, 17819, 18871, 19958, 20530, 21086, 21609, 21709]","[65, 259, 657, 1096, 1496, 1751, 1992, 2209, 2606, 3164, 3771, 4186, 4303, 4589, 5129, 5391, 6009, 6559, 6903, 7240, 7583, 7822, 8091, 8942, 9606, 10148, 10684, 11167, 12242, 12663, 13239, 13494, 14296, 15038, 16050]","[65, 259, 549, 705, 883, 1364, 1674, 1885, 2246, 2681, 2951, 3395, 3691, 3968, 4199, 4449, 4750, 5019, 5457, 6195, 6412, 6636, 7487, 8308, 8817, 9249, 9419, 10022, 11120, 11624, 11950, 12614, 13337, 14073, 14248]","[333, 577, 667, 846, 1137, 1227, 1361, 1511, 1898, 2603, 2873, 3263, 3400, 3781, 3975, 4151, 4309, 4538, 4809, 5414, 5789, 5984, 6244, 6912, 7261, 7653, 7748, 8733, 9473, 10147, 10398, 10953, 11253, 11535, 11635]",22483,21709,16050,14248,11635,-4760,-2854,57,-3987,-4815,-16359,35,dire
7558125303,50,54,29,123,20,"[0, 626, 943, 1436, 1930, 2413, 2934, 3379, 4118, 4590, 5054, 5747, 6276, 6619, 7227, 7322, 8215, 8925, 9602, 10188, 10527, 11038, 11852, 12578, 13707, 13911, 15029, 15158, 15558, 15654, 15929, 16320, 17996, 18402, 19186]","[0, 208, 575, 980, 1368, 1726, 2378, 3040, 3549, 3840, 4209, 5172, 5532, 5814, 6242, 6982, 7771, 8280, 9036, 9608, 10107, 10253, 10796, 11352, 12576, 12977, 13635, 14174, 14497, 14593, 15381, 15873, 16267, 17522, 18057]","[0, 272, 511, 764, 1120, 1280, 1370, 1670, 2330, 2937, 3600, 4162, 4606, 5047, 5447, 5655, 6325, 6724, 7120, 7619, 8380, 8571, 8793, 9272, 10239, 10544, 10639, 11146, 11430, 11674, 12495, 12775, 13169, 13819, 15131]","[0, 339, 429, 563, 699, 932, 1084, 1374, 1620, 1850, 2020, 2733, 3263, 3815, 4049, 4298, 4952, 5210, 5882, 6465, 7046, 7235, 7940, 8345, 9372, 9640, 10278, 10558, 11213, 11389, 11677, 12090, 12748, 13056, 13584]","[0, 238, 328, 418, 554, 644, 856, 1036, 1282, 1512, 1648, 1918, 2213, 2522, 2662, 2757, 3226, 3365, 3680, 4066, 4545, 4639, 4978, 5128, 5429, 5633, 5728, 5998, 6366, 6462, 6737, 7017, 7411, 7828, 8170]",19186,18057,15131,13584,8170,10,23,17,119,112,"[0, 282, 564, 769, 1096, 1457, 2194, 2921, 3416, 3849, 4394, 4999, 5611, 6763, 7468, 8561, 9324, 10239, 10614, 11368, 12151, 12632, 13675, 14251, 14346, 14982, 15618, 16884, 18364, 18972, 20414, 21840, 23365, 23465, 23655]","[0, 170, 414, 731, 1103, 1474, 1982, 2430, 2879, 3382, 3939, 4329, 4817, 5405, 5828, 6393, 7069, 7730, 8002, 8354, 9075, 9390, 9912, 10466, 10727, 11293, 12255, 13436, 14410, 15161, 15824, 16415, 17985, 18240, 18599]","[0, 219, 424, 646, 906, 1179, 1448, 1684, 2165, 2458, 3013, 3444, 4034, 4688, 5221, 5840, 6489, 7032, 7759, 8355, 9000, 9222, 10191, 11032, 11994, 12351, 12693, 13105, 13889, 14304, 15324, 16174, 17149, 17762, 18339]","[0, 170, 260, 350, 440, 530, 665, 1143, 1277, 1412, 1711, 1969, 2441, 2948, 3214, 3532, 4022, 4165, 4319, 4890, 5403, 6272, 6529, 7052, 7232, 7673, 8597, 8957, 9692, 10028, 10356, 11292, 12185, 12694, 13197]","[0, 170, 260, 350, 440, 618, 753, 934, 1154, 1356, 1688, 1778, 2001, 2451, 2944, 3356, 3531, 3672, 3826, 4167, 4530, 5415, 5821, 6452, 6693, 7538, 7849, 8464, 9152, 9286, 10395, 10806, 11911, 12011, 12717]",23655,18599,18339,13197,12717,-4469,-542,-3208,387,-4547,-12379,35,dire
7558127419,48,80,86,51,19,"[657, 906, 1372, 1844, 2148, 2406, 2729, 3432, 4046, 4589, 5101, 6094, 7141, 7589, 8084, 8892, 9848, 10973, 11868, 12805, 13738, 14234, 15021, 15885, 17055, 18079, 19139, 20244, 20931, 22328, 23687, 24666, 25678, 27369, 29093]","[684, 1174, 1375, 1709, 1981, 2459, 2832, 3336, 4096, 4637, 4732, 5133, 5858, 6062, 6724, 7307, 7851, 8420, 8924, 9120, 9735, 10178, 10632, 11252, 11491, 12021, 12971, 13067, 13533, 14570, 15419, 16196, 16735, 17482, 18161]","[793, 1294, 1769, 2463, 2877, 3104, 3761, 4461, 5283, 5764, 5949, 6386, 6731, 7399, 7494, 8000, 8711, 9150, 9245, 9477, 9896, 10177, 10824, 10918, 11527, 12045, 12515, 12611, 12841, 13509, 14336, 14847, 15394, 16138, 16818]","[318, 503, 878, 1278, 1506, 1758, 2004, 2375, 2816, 3152, 3247, 3641, 4011, 4211, 4725, 5019, 5114, 5223, 5393, 5580, 5840, 6010, 6252, 6466, 6922, 7427, 7972, 8143, 8448, 8929, 9447, 10099, 10543, 11430, 11912]","[269, 399, 625, 951, 1131, 1588, 1692, 1935, 2243, 2478, 2654, 2987, 3537, 4010, 4324, 4669, 4779, 5067, 5486, 5764, 6024, 6249, 6587, 6756, 7318, 7570, 8115, 9014, 9319, 10091, 10424, 10752, 10852, 12171, 12605]",29093,18161,16818,11912,12605,95,33,90,100,26,"[1171, 1750, 2275, 2523, 3148, 3617, 4221, 4796, 5440, 5910, 7233, 7960, 8618, 9407, 10779, 11442, 12092, 12743, 14137, 15215, 15861, 16799, 17421, 18119, 19139, 19646, 20501, 21738, 22840, 23529, 23990, 24864, 25542, 25856, 25956]","[1185, 1617, 1861, 2266, 2947, 3267, 4008, 4673, 5204, 5704, 6698, 7281, 7914, 8317, 8982, 9782, 10359, 11172, 11934, 12878, 13739, 14200, 14880, 15587, 15757, 16355, 16890, 18025, 18706, 19307, 20186, 20782, 21112, 21728, 22550]","[1147, 1469, 1903, 2511, 2941, 3695, 4329, 4733, 5153, 5606, 6530, 7414, 7791, 8370, 8919, 9253, 10038, 10196, 10607, 11451, 12161, 12602, 13020, 13643, 13955, 14363, 14996, 15917, 16841, 17400, 17500, 18027, 18307, 18898, 19738]","[684, 820, 910, 1076, 1211, 1441, 1666, 1824, 2023, 2113, 2697, 3256, 3666, 3895, 4186, 4518, 4861, 5019, 5389, 5755, 6151, 6357, 6524, 6618, 6857, 6953, 7414, 7682, 8035, 8210, 8385, 9617, 9841, 10153, 10328]","[937, 1075, 1210, 1300, 1435, 1824, 2050, 2209, 2299, 2389, 3004, 3442, 3635, 4026, 4620, 4849, 5007, 5165, 5535, 5901, 6106, 6296, 6463, 6557, 6796, 6892, 7257, 7858, 8459, 8559, 8659, 8759, 8951, 9188, 9288]",25956,22550,19738,10328,9288,3137,-4389,-2920,1584,3317,729,35,dire
7558241314,89,108,106,26,123,"[0, 164, 498, 784, 1019, 1579, 1978, 2177, 2615, 3198, 4073, 4392, 5311, 5983, 7008, 7511, 8254, 8820, 9366, 10125, 10591, 11251, 11829, 12876, 14026, 14553, 16123, 17539, 18628, 19973, 20714, 21766, 23140, 24430, 26151]","[0, 169, 495, 1137, 1551, 1731, 2178, 2515, 2933, 3685, 4304, 4853, 5473, 5693, 6186, 6835, 7241, 7758, 8620, 9768, 10326, 10579, 11434, 11853, 12499, 12850, 14017, 14661, 15015, 15405, 15768, 16223, 16568, 17032, 17866]","[0, 246, 651, 979, 1317, 1611, 1810, 2221, 2311, 2620, 3063, 3373, 4134, 4472, 5284, 5818, 6366, 6605, 7313, 7571, 7887, 8070, 8594, 9219, 10444, 10691, 11718, 12258, 12933, 13355, 13659, 14395, 15213, 15841, 17079]","[0, 130, 255, 405, 513, 631, 761, 856, 1104, 1479, 1800, 2219, 2560, 2688, 3205, 3486, 3581, 3944, 4549, 4807, 4949, 5044, 5443, 5538, 5632, 5809, 7160, 7802, 8004, 8151, 8299, 8579, 8769, 9034, 9810]","[0, 179, 659, 1034, 1169, 1304, 1492, 1599, 1689, 2086, 2580, 2670, 2967, 3061, 3464, 3957, 4067, 4161, 4443, 4701, 4934, 5118, 5547, 5757, 5947, 6088, 6721, 7212, 7308, 7537, 7633, 7961, 8151, 8251, 8991]",26151,17866,17079,9810,8991,73,46,135,65,20,"[0, 330, 502, 889, 1161, 1551, 1886, 2648, 3183, 4125, 4984, 5870, 6723, 8121, 9085, 10288, 11345, 11815, 12461, 13103, 14264, 15315, 16109, 16754, 17732, 18428, 19041, 19760, 21060, 22526, 23149, 23501, 24353, 25624, 25724]","[0, 320, 656, 942, 1631, 2051, 2651, 3202, 3833, 4059, 4837, 5332, 6249, 6882, 7341, 8314, 9267, 10134, 10627, 11024, 11879, 12525, 13366, 14009, 14823, 15554, 16351, 16547, 17563, 18214, 18772, 19480, 20388, 21263, 21574]","[0, 248, 446, 679, 1052, 1456, 1873, 2501, 3025, 3443, 3816, 4349, 4757, 5122, 5798, 6407, 7185, 7613, 8020, 8627, 9090, 10058, 10420, 11035, 11578, 12281, 12457, 13118, 13599, 14293, 15055, 15883, 16513, 17198, 17558]","[0, 258, 396, 486, 666, 1035, 1125, 1350, 1854, 1944, 2061, 2421, 2658, 3010, 3105, 3848, 4346, 4941, 5271, 5822, 6610, 6856, 7284, 7559, 7961, 8301, 8477, 8886, 9097, 9713, 9809, 10044, 10461, 10671, 11044]","[0, 297, 433, 560, 710, 1121, 1318, 1565, 1779, 1898, 2194, 2284, 2523, 2824, 2977, 3252, 3473, 3669, 3860, 4617, 4883, 5205, 5761, 5856, 5950, 6230, 6406, 6618, 6795, 7161, 7343, 7578, 7768, 7978, 8078]",25724,21574,17558,11044,8078,427,-3708,-479,-1234,913,-4081,35,dire
7558405219,48,13,102,21,119,"[2, 287, 594, 932, 1300, 1716, 2094, 2593, 3189, 3663, 4099, 4739, 5309, 6048, 6638, 7262, 8277, 9501, 9942, 10037, 11239, 12165, 13141, 14483, 15119, 15722, 16827, 17493, 18906, 19921, 21632, 22615, 24545, 25483, 26622]","[0, 279, 545, 908, 1237, 1684, 1984, 2585, 3128, 3659, 4352, 4477, 5085, 5449, 6046, 6517, 7340, 7920, 8140, 8958, 9681, 10016, 10699, 11401, 11776, 12026, 12405, 13058, 13703, 14520, 14756, 15704, 16369, 17485, 18334]","[0, 248, 533, 780, 1084, 1437, 1634, 1858, 2214, 2909, 3235, 3798, 4278, 4862, 5422, 5633, 6288, 6383, 7187, 7651, 8300, 8395, 8873, 9404, 9944, 10326, 10612, 11225, 11599, 11776, 12604, 12982, 13662, 14317, 14776]","[2, 176, 270, 360, 456, 635, 795, 928, 1035, 1283, 1418, 1697, 2083, 2274, 2518, 2838, 3022, 3391, 3486, 3823, 4065, 4160, 4462, 4668, 5028, 5249, 5415, 5848, 6323, 6573, 6809, 7166, 7921, 8335, 8708]","[0, 170, 260, 414, 504, 640, 1022, 1159, 1356, 1585, 1720, 2012, 2493, 2587, 2682, 2777, 3007, 3464, 3934, 4586, 4887, 5024, 5194, 5436, 5645, 5982, 6152, 6658, 7149, 7399, 8051, 8529, 9209, 9640, 9938]",26622,18334,14776,8708,9938,120,28,89,3,45,"[0, 329, 714, 1085, 1430, 1958, 2353, 3016, 3421, 4051, 4713, 5298, 5661, 6474, 6822, 7588, 8182, 9856, 10410, 11251, 11846, 12517, 13595, 14273, 15634, 15922, 16419, 17101, 17755, 19184, 19702, 20466, 21588, 22859, 23501]","[0, 220, 481, 775, 1170, 1569, 1950, 2450, 2761, 3267, 3930, 4231, 4997, 5728, 6432, 6970, 7443, 8358, 8778, 9780, 10272, 11019, 11541, 12150, 12523, 12730, 13167, 14036, 14826, 15674, 16042, 16581, 17023, 17421, 18247]","[0, 309, 638, 886, 1194, 1583, 1845, 2253, 2674, 3010, 3538, 4016, 4818, 5501, 5943, 6630, 7313, 7794, 8647, 9543, 10342, 11164, 12249, 13113, 13564, 14184, 14991, 15765, 16621, 17230, 17919, 18783, 18988, 19339, 20028]","[0, 220, 335, 517, 647, 753, 1078, 1303, 1717, 1852, 2086, 2640, 2900, 3102, 3318, 3963, 4373, 4748, 4887, 5587, 5996, 6409, 6599, 7147, 7285, 7509, 7815, 8072, 8367, 8520, 8706, 8931, 9031, 9536, 9682]","[0, 220, 335, 425, 999, 1155, 1245, 1425, 1728, 1921, 2233, 2385, 2696, 2932, 3127, 3562, 3972, 4166, 4412, 4810, 5006, 5727, 6086, 6519, 6716, 6847, 7251, 7508, 7803, 8149, 8335, 8580, 9057, 9351, 9451]",23501,18247,20028,9682,9451,3121,87,-5252,-974,487,-2531,35,radiant
7558802112,109,13,129,90,100,"[0, 170, 520, 798, 1031, 1319, 1409, 1887, 2118, 2545, 3014, 3554, 3755, 4228, 4754, 5287, 6037, 7123, 8043, 9017, 9973, 10489, 11248, 11973, 12811, 14055, 14467, 14706, 15222, 16028, 16562, 17338, 18484, 19341, 20429]","[0, 205, 418, 706, 915, 1144, 1603, 1855, 2483, 2929, 4002, 4513, 5024, 5315, 5947, 6149, 6750, 7969, 8528, 8841, 10116, 10705, 11351, 12141, 12842, 13346, 13516, 14055, 14521, 15190, 15796, 16256, 17277, 17965, 19320]","[0, 170, 555, 957, 1227, 1711, 1997, 2449, 2734, 3414, 4133, 4497, 5054, 5558, 5993, 6721, 7041, 8040, 8635, 8882, 9796, 10473, 11126, 11708, 12296, 12608, 13139, 13379, 13475, 14424, 15140, 15703, 15803, 16013, 16380]","[0, 219, 405, 540, 630, 837, 927, 1062, 1231, 1526, 2235, 2510, 2636, 2990, 3225, 3365, 3633, 4357, 5146, 5747, 6606, 7197, 7434, 7676, 7991, 8158, 8253, 8347, 8653, 8979, 9455, 10068, 10257, 10467, 11043]","[0, 170, 260, 394, 484, 620, 829, 1010, 1100, 1568, 1862, 1952, 2129, 2224, 2319, 2413, 2758, 3322, 3677, 3924, 4471, 4863, 5346, 5485, 5580, 5944, 6039, 6492, 6796, 6973, 7101, 7201, 7422, 7632, 7957]",20429,19320,16380,11043,7957,41,39,137,45,20,"[0, 216, 458, 814, 1219, 1595, 1842, 2122, 2698, 2872, 3511, 4012, 4458, 5076, 5531, 6275, 7035, 7461, 7767, 8350, 8661, 8915, 9811, 10555, 11191, 11669, 12244, 12834, 13261, 14366, 14849, 15903, 16776, 17444, 18274]","[0, 280, 635, 919, 1325, 1745, 2204, 2696, 3100, 3643, 4271, 4901, 5465, 6007, 6335, 6987, 7744, 8132, 8571, 9079, 9467, 10309, 10973, 11196, 11790, 12886, 13246, 14176, 14630, 15188, 16062, 16584, 16903, 17286, 18387]","[0, 245, 575, 813, 1137, 1436, 1812, 2192, 3059, 3758, 4552, 5190, 5793, 6225, 6863, 7767, 8872, 9143, 9759, 9988, 10295, 10912, 11657, 12172, 12579, 13149, 13780, 14708, 15001, 15277, 15568, 16376, 16867, 17452, 18670]","[0, 207, 297, 412, 588, 1141, 1535, 1625, 2092, 2716, 3081, 3321, 3664, 4379, 4709, 5106, 5417, 5696, 5920, 6249, 6458, 6675, 7311, 7848, 8059, 8226, 8381, 9253, 9767, 10102, 10328, 10752, 11232, 11740, 12201]","[0, 170, 260, 422, 552, 731, 830, 967, 1281, 1457, 1682, 1772, 1970, 2323, 2664, 3162, 3473, 3568, 3692, 3921, 4106, 4324, 4785, 5507, 5602, 5769, 5864, 6581, 6968, 7382, 7584, 7864, 8074, 8346, 8807]",18274,18387,18670,12201,8807,2155,933,-2290,-1158,-850,-1210,35,dire
7558826219,95,23,20,72,19,"[1250, 1541, 1910, 2253, 2683, 3049, 3649, 4044, 4559, 4931, 5472, 5915, 6346, 7290, 7972, 8641, 9317, 10163, 11118, 12121, 12830, 13630, 14296, 14815, 16568, 17869, 18966, 19614, 21158, 22080, 22908, 23154, 23655, 23901, 24224]","[1148, 1454, 1775, 2348, 2632, 3263, 3973, 4440, 5363, 5686, 5984, 6231, 6882, 7261, 7749, 8216, 8450, 9056, 9872, 10414, 10833, 11595, 12138, 12695, 13672, 14023, 14256, 14690, 15354, 15760, 16358, 16849, 17994, 18540, 18943]","[1019, 1415, 1796, 2196, 2500, 2782, 3372, 3728, 4056, 4535, 5066, 5672, 6071, 6652, 7100, 7584, 8165, 8435, 9160, 9698, 10094, 10820, 11067, 11269, 11781, 12124, 12495, 12969, 13538, 13672, 13873, 14391, 14491, 15173, 15458]","[841, 1040, 1165, 1255, 1418, 1691, 2021, 2188, 2471, 2833, 3117, 3339, 3766, 4106, 4296, 4438, 4926, 5279, 5374, 5975, 6198, 6445, 7005, 7441, 8041, 8323, 8536, 8956, 9638, 9738, 9938, 10184, 10398, 10717, 11138]","[650, 740, 865, 999, 1422, 2021, 2351, 2518, 2752, 2923, 3216, 3637, 4123, 4385, 4926, 5280, 5583, 5964, 6095, 6361, 6615, 6851, 6946, 7122, 7216, 7472, 7568, 7745, 8439, 8539, 8639, 8885, 9192, 9398, 9498]",24224,18943,15458,11138,9498,46,41,96,110,21,"[799, 1247, 1673, 1929, 2416, 2872, 3223, 3618, 4400, 5061, 5601, 6313, 7005, 8035, 9230, 10062, 11025, 11943, 12715, 13256, 14375, 15204, 15988, 16470, 17265, 18004, 19021, 19252, 19785, 20677, 21294, 22403, 23858, 25098, 25488]","[620, 870, 1073, 1432, 1731, 1973, 2558, 2956, 3661, 4171, 4582, 5124, 5446, 5948, 6511, 7181, 7590, 8429, 8925, 9757, 10304, 10897, 11502, 11707, 12086, 12283, 13329, 14089, 14633, 15895, 16587, 17786, 18717, 19583, 20578]","[617, 1060, 1200, 1566, 2097, 2391, 3119, 3418, 3859, 4074, 4512, 4746, 4937, 5366, 5762, 6260, 6506, 7218, 7569, 7860, 8452, 8708, 9281, 9827, 10227, 10424, 10839, 11070, 11315, 11588, 11724, 13346, 13807, 14120, 14366]","[340, 430, 520, 752, 881, 1285, 1465, 1600, 2016, 2316, 2746, 3197, 3498, 3846, 4060, 4373, 4699, 5093, 5464, 5908, 6075, 6889, 7213, 7418, 7617, 7814, 8185, 8416, 8914, 9330, 9966, 11321, 12051, 12375, 12751]","[332, 470, 630, 720, 1123, 1327, 1592, 2015, 2786, 3087, 3308, 3577, 3887, 4476, 4690, 5051, 5474, 5972, 6198, 6575, 7157, 7406, 7795, 8233, 8549, 8865, 9331, 9637, 10257, 10447, 10621, 11286, 11831, 12028, 12281]",25488,20578,14366,12751,12281,-1264,-1635,1092,-1613,-2783,-6203,35,dire
7558963713,41,97,29,20,45,"[0, 198, 513, 755, 1071, 1448, 1886, 2379, 2705, 2891, 3619, 3870, 4395, 4689, 5886, 6175, 6580, 7515, 8022, 8657, 9699, 10533, 11174, 11754, 13053, 13611, 14773, 15152, 16240, 17098, 17542, 18172, 18452, 19343, 20477]","[0, 288, 576, 947, 1340, 1773, 2141, 2710, 2922, 3440, 4224, 4640, 4985, 5495, 6644, 7121, 7486, 7804, 8451, 8648, 9470, 10002, 10452, 11527, 11622, 11871, 12425, 12951, 13531, 14287, 14635, 15204, 16268, 16736, 17680]","[0, 245, 608, 871, 1332, 1589, 1990, 2481, 2875, 3144, 3446, 3622, 3999, 4446, 5345, 5861, 6280, 7232, 8211, 8649, 9336, 9653, 9983, 10577, 11194, 11527, 12213, 12645, 13393, 14039, 14395, 14838, 16374, 16474, 17222]","[0, 231, 321, 411, 549, 722, 929, 1109, 1199, 1289, 1623, 1887, 2084, 2638, 3162, 3912, 4069, 4508, 5087, 5181, 5445, 5737, 6030, 6298, 6850, 7249, 7478, 7573, 8004, 8952, 9446, 9757, 10834, 11000, 11715]","[0, 129, 472, 562, 697, 822, 960, 1168, 1304, 1422, 1604, 1785, 1922, 2101, 2617, 2810, 2954, 3167, 3640, 3908, 4355, 4693, 5037, 5320, 6568, 6663, 7109, 7204, 7649, 8630, 8783, 9247, 10028, 10276, 10867]",20477,17680,17222,11715,10867,48,106,69,40,26,"[0, 287, 923, 1173, 1406, 1851, 2225, 2661, 2967, 3491, 3999, 4423, 4803, 5543, 5782, 6098, 6869, 7448, 8386, 9198, 10001, 10648, 10872, 11698, 12716, 13563, 14554, 14989, 15439, 15631, 16333, 16754, 17852, 18668, 19225]","[0, 364, 565, 890, 1335, 1629, 2084, 2422, 3094, 3523, 4079, 4353, 4637, 5188, 5579, 6148, 6618, 6939, 8002, 8421, 8845, 9260, 9636, 9810, 10213, 10504, 11122, 11659, 12185, 12826, 13232, 13679, 14408, 15042, 15343]","[0, 287, 486, 767, 891, 1278, 1785, 2066, 2473, 2841, 3224, 3634, 4308, 4695, 5048, 5442, 6091, 6378, 6876, 7338, 8212, 8627, 9222, 9479, 9991, 10242, 10921, 11286, 11626, 11886, 12085, 12735, 13053, 13498, 13898]","[0, 209, 337, 642, 732, 822, 957, 1091, 1356, 1589, 1843, 2073, 2665, 3099, 3338, 3647, 3900, 4065, 4312, 4471, 4794, 5168, 5428, 5756, 6564, 6897, 7147, 7463, 7882, 8053, 8276, 8933, 9430, 9892, 10067]","[0, 209, 379, 514, 604, 743, 918, 1312, 1492, 1707, 2213, 2303, 2393, 2789, 3028, 3397, 3700, 3867, 4117, 4274, 4681, 4776, 4961, 5135, 5487, 5762, 6063, 6244, 6340, 6482, 6578, 6768, 7180, 7280, 7428]",19225,15343,13898,10067,7428,1252,2337,3324,1648,3439,12000,35,radiant
7558993106,106,109,28,53,112,"[1, 362, 743, 1004, 1449, 1781, 2308, 2739, 3031, 3404, 4098, 4637, 5151, 5799, 6119, 6469, 7181, 7782, 8335, 8991, 9739, 10318, 10700, 11387, 12050, 12752, 13517, 13881, 14431, 15271, 15694, 16162, 17021, 17877, 18624]","[1, 239, 517, 798, 1149, 1539, 1898, 2248, 2833, 3251, 3767, 4358, 5040, 5565, 6181, 6760, 7527, 8081, 8699, 9330, 9931, 10677, 11438, 12401, 13247, 14121, 14816, 15157, 15997, 16093, 16968, 17649, 18535, 19254, 19747]","[1, 209, 535, 987, 1482, 1659, 2138, 2637, 3173, 3682, 4175, 4685, 5227, 5824, 6346, 6874, 7300, 7933, 8628, 9394, 10125, 10390, 10698, 11274, 12021, 12883, 13419, 13725, 14093, 14189, 14485, 15080, 15180, 15624, 15924]","[1, 171, 337, 427, 609, 756, 846, 1295, 1519, 1709, 1889, 2205, 2369, 2677, 2976, 3225, 3509, 3850, 4265, 4760, 5016, 5257, 5839, 6485, 6777, 7471, 7895, 8422, 8830, 9203, 9839, 10367, 11057, 11387, 11954]","[101, 271, 361, 451, 701, 814, 953, 1378, 1728, 1818, 1998, 2178, 2268, 2516, 2709, 3132, 3392, 3982, 4190, 4401, 4697, 4882, 5112, 5297, 5482, 5880, 6212, 6548, 6693, 6887, 7277, 7467, 7567, 7667, 7803]",18624,19747,15924,11954,7803,10,29,120,123,20,"[1, 245, 568, 885, 1326, 1606, 2012, 2317, 2583, 2981, 3463, 3989, 4616, 5169, 5786, 6273, 6978, 7691, 8262, 9804, 10484, 11016, 11695, 12287, 13230, 13874, 14288, 14976, 15909, 17596, 18883, 20858, 21974, 23439, 25526]","[332, 696, 987, 1286, 1654, 1947, 2261, 2741, 2950, 3656, 4427, 5029, 5607, 6171, 6610, 7388, 7808, 8440, 9202, 9802, 10430, 10708, 11455, 11888, 12548, 13289, 13637, 14211, 14850, 15678, 16362, 16910, 18158, 19166, 20183]","[1, 353, 550, 1009, 1452, 1812, 2268, 2408, 2498, 2878, 3316, 3727, 4142, 4682, 5297, 6080, 6526, 7108, 7403, 8297, 9089, 9461, 9870, 10372, 11011, 11610, 12412, 12996, 13992, 14933, 15546, 16065, 17013, 17809, 18718]","[64, 295, 432, 572, 902, 1012, 1342, 1482, 1592, 1742, 2023, 2348, 2514, 2627, 2819, 3109, 3465, 3660, 3755, 4301, 4471, 4633, 5140, 5424, 5630, 6225, 6612, 6756, 7464, 7896, 8075, 8500, 9268, 10006, 10739]","[64, 234, 324, 414, 654, 744, 925, 1065, 1358, 1496, 1974, 2064, 2337, 2431, 2572, 2714, 2871, 3017, 3112, 3461, 3696, 3817, 4310, 4522, 4637, 5000, 5095, 5294, 5684, 5850, 6030, 6927, 7162, 7498, 8269]",25526,20183,18718,10739,8269,-6902,-436,-2794,1215,-466,-9383,35,dire
7559020110,41,69,23,110,26,"[205, 366, 616, 916, 1204, 1452, 1758, 1978, 2106, 2575, 2950, 3511, 4106, 4674, 6180, 6878, 7494, 8160, 8838, 9562, 10202, 11022, 11546, 12708, 13237, 13528, 14404, 15477, 15573, 16703, 17275, 17375, 18267, 19265, 19804]","[204, 442, 701, 1166, 2060, 2692, 3007, 3832, 4137, 4754, 5080, 5890, 6042, 6656, 7729, 8077, 8489, 8915, 9494, 10277, 10713, 11681, 12451, 13027, 13531, 14377, 15185, 16464, 16833, 17174, 17793, 18451, 19239, 19733, 20101]","[326, 654, 1102, 1427, 1909, 2347, 2891, 3557, 4160, 4761, 5129, 5609, 6072, 6436, 7304, 7800, 8328, 8973, 9324, 9594, 9885, 10199, 10366, 10967, 11625, 12033, 12429, 13053, 13149, 13908, 14614, 14731, 15440, 16016, 16407]","[170, 296, 497, 652, 896, 998, 1399, 1640, 1730, 2076, 2462, 2775, 2972, 3157, 3805, 4025, 4418, 4676, 5215, 5416, 5822, 6598, 7212, 7622, 7809, 8060, 8888, 9558, 9654, 9782, 9881, 10036, 10651, 10798, 11124]","[221, 311, 447, 585, 955, 1161, 1296, 1801, 1910, 2120, 2669, 2967, 3116, 3401, 4271, 4733, 4995, 5335, 5637, 5897, 6067, 6456, 6794, 7198, 7530, 7865, 8230, 8402, 8725, 8975, 9308, 9571, 10202, 10823, 10945]",19804,20101,16407,11124,10945,94,120,33,123,85,"[288, 465, 745, 1074, 1479, 1814, 2420, 2566, 3102, 3689, 4245, 4593, 5244, 5981, 6877, 8120, 8644, 9769, 10583, 11567, 12534, 12701, 13426, 14365, 15106, 16021, 16992, 18358, 20151, 21073, 21976, 22951, 24209, 25449, 27140]","[290, 526, 894, 1351, 1691, 2039, 2417, 2873, 3403, 4189, 4881, 5703, 6644, 7723, 8144, 8238, 8823, 9253, 9961, 10725, 11392, 12110, 12374, 12764, 13308, 13975, 14069, 14899, 15643, 16601, 17228, 18303, 18884, 19179, 19877]","[206, 568, 843, 1247, 1834, 2052, 2704, 3166, 3874, 4875, 5378, 6113, 6462, 6823, 7088, 7280, 7776, 8163, 8636, 9270, 9533, 10432, 10817, 11100, 11267, 11969, 12172, 13060, 14084, 14512, 14967, 15419, 15931, 16293, 16981]","[170, 260, 372, 591, 764, 941, 1453, 1543, 1855, 2416, 2699, 2987, 3369, 3635, 3800, 3894, 4284, 4872, 5105, 5535, 5705, 6431, 6601, 7090, 7332, 7796, 8208, 9086, 9975, 10149, 10880, 11246, 11755, 12419, 13142]","[170, 260, 350, 487, 896, 986, 1263, 1435, 1744, 2198, 2983, 3392, 3760, 4075, 4321, 4439, 4680, 5116, 5274, 5566, 5842, 6288, 6681, 6775, 6959, 7401, 7702, 8087, 8318, 8414, 8772, 9184, 9374, 9474, 9755]",27140,19877,16981,13142,9755,-7336,224,-574,-2018,1190,-8514,35,dire
7559833511,48,76,97,65,110,"[0, 209, 370, 747, 981, 1187, 1679, 1992, 2301, 2747, 3280, 3675, 4162, 5006, 5614, 6454, 7191, 8168, 8880, 9362, 10839, 11555, 12512, 13493, 14637, 15463, 16734, 17504, 18907, 20219, 20993, 21330, 21955, 22493, 24467]","[0, 291, 589, 827, 1226, 1576, 1975, 2302, 2827, 3173, 3690, 4161, 4814, 5137, 5750, 6018, 6409, 6754, 7216, 7568, 9012, 9773, 10288, 11085, 11573, 12620, 13915, 14386, 15091, 16016, 16653, 17235, 17837, 18444, 19171]","[0, 204, 452, 542, 897, 1266, 1442, 1688, 2144, 2605, 2861, 3389, 3891, 4491, 5045, 5140, 5657, 6352, 7075, 7332, 8398, 9141, 9999, 10709, 10894, 11473, 12151, 12777, 13758, 13929, 14332, 14623, 14814, 15161, 15667]","[0, 170, 260, 458, 885, 1022, 1136, 1283, 1373, 1556, 1992, 2262, 2518, 2681, 3073, 3168, 3414, 3874, 4329, 4424, 5459, 5913, 6201, 6616, 6971, 7383, 7800, 8426, 8953, 9680, 10057, 10282, 10473, 10852, 11445]","[0, 219, 309, 399, 580, 670, 807, 936, 1026, 1209, 1603, 1804, 1980, 2299, 2710, 2888, 3402, 3496, 3777, 3872, 4192, 4358, 4569, 4923, 5177, 5343, 5724, 5844, 6021, 6763, 6859, 7091, 7310, 7545, 8077]",24467,19171,15667,11445,8077,25,13,102,3,26,"[0, 326, 600, 845, 1257, 1630, 2122, 2683, 3284, 3876, 4429, 5024, 5380, 6032, 6720, 7539, 8267, 8983, 9461, 9725, 9820, 10653, 11798, 12573, 12843, 13993, 14642, 14737, 15581, 16782, 17592, 18098, 18671, 19540, 20570]","[0, 242, 430, 758, 1101, 1420, 1581, 1908, 2235, 2639, 3390, 3705, 4114, 4670, 4924, 5100, 5590, 6059, 6700, 6880, 6975, 7476, 8295, 8972, 9204, 9583, 10336, 10669, 11415, 12232, 12611, 13216, 13631, 14707, 15905]","[0, 209, 591, 758, 1132, 1397, 1757, 2144, 2756, 2960, 3474, 3835, 4544, 4879, 5233, 5566, 6004, 6542, 6796, 7339, 7434, 8098, 8752, 9376, 9865, 10187, 10654, 10855, 11162, 11479, 11613, 12380, 12977, 13863, 14541]","[0, 170, 285, 375, 505, 595, 706, 967, 1147, 1237, 1372, 1503, 1683, 2093, 2490, 2585, 2806, 2900, 2995, 3380, 3654, 3954, 4352, 4447, 4542, 4708, 4803, 5017, 5238, 5532, 5628, 6021, 6365, 7028, 7502]","[0, 170, 285, 426, 601, 691, 830, 1457, 1768, 1858, 2126, 2216, 2445, 2593, 2725, 2820, 3041, 3579, 3964, 4366, 4513, 4679, 4846, 5160, 5287, 5593, 5737, 5832, 6009, 6303, 6399, 6792, 7216, 7606, 7796]",20570,15905,14541,7502,7796,3897,3266,1126,3943,281,12513,35,radiant
7559889100,13,95,97,66,138,"[281, 494, 858, 1304, 1672, 2028, 2406, 2919, 3369, 3944, 4575, 5440, 6253, 6758, 7253, 8124, 8896, 9679, 10230, 11201, 11789, 12379, 12972, 13894, 14678, 14961, 15819, 16827, 17252, 18929, 19952, 20643, 21226, 22110, 23508]","[360, 635, 762, 1277, 1694, 2100, 2535, 2849, 3324, 3648, 4077, 4666, 5470, 6175, 6807, 7466, 8195, 8914, 9615, 10371, 11483, 12246, 13190, 14065, 15128, 15747, 16255, 16432, 17177, 17931, 19326, 20005, 20298, 20398, 22063]","[232, 610, 876, 1161, 1667, 2045, 2504, 2956, 3394, 3816, 4203, 4442, 4885, 5225, 5738, 5937, 6441, 6916, 7166, 7535, 8171, 8338, 8892, 9349, 9941, 10807, 11256, 11633, 11731, 12804, 13611, 14355, 14806, 14906, 15006]","[500, 615, 749, 958, 1065, 1395, 1641, 1910, 2247, 2465, 2694, 3089, 3366, 3837, 4440, 5068, 5514, 6051, 6431, 7031, 7707, 7956, 8784, 9530, 9881, 10343, 10620, 11117, 11497, 12600, 13076, 13421, 14049, 14149, 14482]","[232, 347, 471, 596, 686, 776, 866, 1001, 1243, 1663, 2018, 2307, 2597, 2851, 3194, 3672, 4174, 4453, 4834, 5252, 5347, 5651, 6034, 6464, 6968, 7609, 8279, 8781, 9034, 9360, 9753, 10363, 11023, 11123, 11884]",23508,22063,15006,14482,11884,73,120,21,58,65,"[452, 858, 1222, 1583, 2195, 2628, 3441, 4272, 4949, 5888, 6625, 7596, 8129, 9563, 10061, 10502, 11501, 13037, 14274, 15058, 16426, 17238, 17798, 19115, 19443, 20279, 21973, 22840, 23345, 23899, 24309, 24885, 26414, 28143, 28694]","[283, 653, 1143, 1513, 2088, 2532, 2829, 3549, 4194, 4653, 5276, 5827, 6351, 6896, 7556, 8126, 9015, 9338, 9894, 10270, 10956, 11566, 12022, 12780, 13562, 14711, 15737, 16116, 16657, 17084, 17635, 18235, 19218, 21090, 21445]","[242, 445, 843, 1194, 1602, 1878, 2207, 2575, 3148, 3451, 3763, 4154, 4694, 5330, 5844, 6144, 6579, 7016, 7661, 8065, 9024, 9765, 10342, 10950, 11200, 12093, 13008, 13177, 13766, 14126, 14446, 15140, 16143, 16513, 16838]","[337, 427, 553, 683, 883, 973, 1118, 1500, 1618, 2018, 2198, 2742, 2927, 3266, 3447, 3587, 3886, 4574, 4977, 5718, 6080, 6497, 6790, 6968, 7420, 8523, 9031, 9376, 10207, 10542, 11042, 11142, 13140, 13929, 14402]","[237, 327, 462, 592, 770, 887, 1022, 1194, 1318, 1544, 1634, 1980, 2491, 2779, 3234, 3575, 3913, 4406, 4648, 4798, 5199, 5384, 5570, 5918, 6062, 6663, 7378, 7640, 8038, 8636, 9221, 9321, 10435, 10840, 11120]",28694,21445,16838,14402,11120,-5186,618,-1832,80,764,-5556,35,radiant
7559947915,17,129,47,110,100,"[0, 204, 418, 782, 1113, 1464, 1706, 2041, 2365, 3010, 3666, 4202, 4919, 5372, 6048, 6462, 7128, 7483, 8341, 9098, 9778, 10219, 11452, 12241, 13182, 13981, 14630, 15167, 15856, 16516, 16984, 17955, 18365, 18830, 19020]","[0, 174, 550, 1050, 1263, 1604, 2230, 2608, 2870, 3298, 3833, 4146, 4801, 5220, 5622, 6191, 6604, 7129, 7784, 8758, 10057, 10581, 11235, 12046, 13109, 13994, 14981, 15620, 16231, 16459, 16815, 17171, 17271, 17754, 18077]","[0, 526, 731, 1088, 1343, 1683, 1843, 2264, 2596, 3261, 3691, 4179, 4744, 5388, 5649, 6186, 6656, 7127, 7649, 8007, 8743, 9166, 9696, 10894, 11676, 12317, 12712, 13276, 13962, 14361, 14906, 15145, 15412, 16529, 16909]","[0, 90, 180, 352, 442, 572, 662, 927, 1064, 1245, 1473, 1687, 2138, 2480, 2630, 3105, 3432, 4081, 4730, 5050, 5397, 5707, 6686, 6960, 7329, 7860, 8490, 8905, 9348, 9602, 10074, 10692, 11396, 11828, 12093]","[0, 168, 258, 348, 438, 617, 707, 797, 887, 1063, 1243, 1333, 1790, 2008, 2158, 2252, 2475, 2960, 3254, 3574, 4153, 4446, 5225, 5648, 6147, 6434, 7198, 7455, 7632, 7868, 7964, 8581, 8681, 9138, 9328]",19020,18077,16909,12093,9328,43,120,41,58,123,"[0, 406, 718, 1093, 1428, 1897, 2262, 2673, 3156, 3711, 4237, 4728, 5533, 6018, 6914, 7350, 8102, 8761, 9311, 9624, 9967, 11043, 11402, 12046, 12570, 12836, 13308, 13402, 14258, 15354, 16024, 16580, 17683, 18314, 18552]","[0, 323, 528, 962, 1451, 1713, 1803, 2028, 2311, 2622, 3062, 3502, 4186, 4759, 5750, 6097, 6534, 6629, 7270, 7744, 8025, 8468, 8891, 9348, 9961, 10467, 10598, 11007, 11932, 12353, 13146, 13514, 14491, 14782, 15020]","[0, 287, 589, 867, 1030, 1272, 1719, 1980, 2395, 2741, 3211, 3713, 4078, 4433, 5288, 5881, 6521, 6802, 7547, 8327, 8838, 9113, 9585, 9985, 10759, 10952, 11809, 12401, 12917, 13692, 14395, 15087, 15914, 16676, 16776]","[0, 250, 389, 576, 715, 805, 1200, 1550, 1927, 2286, 2528, 2745, 2987, 3248, 4139, 4392, 4747, 5249, 5516, 5757, 5852, 6506, 6838, 7058, 7153, 7318, 7710, 8140, 8545, 8876, 9351, 9919, 10490, 11802, 12424]","[0, 250, 340, 511, 662, 752, 885, 1156, 1353, 1448, 2051, 2273, 2455, 2737, 3550, 3894, 4432, 4844, 5174, 5912, 6007, 6250, 6417, 6928, 7348, 7489, 7944, 8133, 8770, 9380, 10054, 10461, 10965, 11702, 11940]",18552,15020,16776,12424,11940,468,3057,133,-331,-2612,715,35,radiant
7559964211,82,98,20,26,112,"[0, 334, 746, 1116, 1484, 1814, 2514, 2799, 3453, 3904, 4313, 4725, 5087, 5672, 6388, 7394, 8023, 9285, 9904, 10899, 11781, 12681, 13623, 14507, 15459, 16252, 16575, 17649, 19135, 20315, 20850, 21913, 22848, 24023, 24918]","[0, 289, 638, 1092, 1471, 1845, 2197, 2796, 3091, 3593, 4011, 4295, 5005, 5310, 5704, 6340, 7154, 7452, 7895, 8466, 9163, 9413, 10198, 11086, 11849, 12397, 13201, 14372, 15296, 15670, 15766, 16498, 16880, 17649, 18357]","[0, 331, 777, 1093, 1347, 1816, 2154, 2606, 3102, 3486, 3801, 4118, 4208, 4302, 4547, 4822, 5085, 5537, 5990, 6511, 6941, 7437, 7714, 8452, 8955, 9508, 10129, 10840, 11523, 11685, 12108, 12744, 13182, 13833, 14382]","[0, 210, 300, 455, 637, 727, 866, 1005, 1184, 1309, 1399, 1658, 1869, 2240, 2406, 3308, 3465, 3595, 4384, 4892, 4986, 5682, 5954, 6691, 6995, 7165, 7335, 7965, 8633, 9018, 9227, 9551, 9726, 10131, 10538]","[100, 310, 465, 768, 972, 1106, 1243, 1333, 1718, 1808, 1898, 2085, 2540, 2634, 2729, 3276, 3594, 3735, 4059, 4439, 4607, 4829, 4924, 5978, 6464, 6559, 6654, 6987, 7578, 7690, 7830, 8019, 8119, 8662, 9471]",24918,18357,14382,10538,9471,10,71,74,119,21,"[0, 167, 450, 668, 997, 1295, 1646, 1948, 2486, 2766, 3329, 3755, 4149, 4759, 5292, 5896, 6479, 6885, 7394, 8091, 8667, 9447, 10004, 10099, 10945, 11569, 12334, 12662, 13164, 14145, 15117, 15912, 16722, 17642, 18238]","[0, 130, 474, 900, 1511, 1801, 2207, 2599, 2854, 3247, 3654, 4476, 4566, 5158, 5663, 5812, 6622, 6845, 7084, 7926, 8157, 8765, 9474, 10041, 10772, 11636, 12651, 12989, 13539, 14151, 15048, 15237, 16155, 17203, 17737]","[0, 179, 465, 821, 1139, 1556, 1959, 2835, 3574, 3985, 4772, 5170, 5439, 5864, 6082, 6231, 6786, 7280, 7753, 8335, 8769, 9354, 10023, 10118, 10938, 11673, 12369, 13274, 14074, 14528, 15391, 15614, 16174, 16964, 17064]","[0, 477, 792, 882, 1012, 1122, 1228, 1591, 1681, 2062, 2887, 3268, 3528, 4141, 4475, 4784, 5168, 5553, 5745, 6581, 6799, 7568, 8301, 8577, 9353, 9682, 10297, 10717, 11251, 12160, 13102, 13634, 14281, 14806, 14906]","[0, 209, 299, 750, 926, 1271, 1454, 1754, 2009, 2431, 3230, 3620, 4006, 4658, 5139, 5472, 5765, 6170, 6398, 6840, 7090, 7528, 8145, 8435, 9095, 9398, 10018, 10300, 10468, 11383, 12053, 12611, 13384, 14162, 14680]",18238,17737,17064,14906,14680,6680,620,-2682,-4368,-5209,-4959,35,radiant
7559964417,70,113,28,110,123,"[253, 608, 893, 1182, 1669, 2112, 2604, 2935, 3877, 4349, 5046, 5627, 6335, 6886, 7678, 8668, 9543, 10365, 11143, 11801, 12232, 12327, 12755, 14115, 15327, 15926, 17755, 18719, 19587, 20488, 21448, 22127, 22719, 23159, 24188]","[276, 609, 1057, 1445, 1791, 2523, 2664, 3122, 4188, 4695, 5301, 5767, 6291, 6729, 7236, 7817, 8267, 9043, 9418, 9892, 10560, 11139, 11667, 12366, 13196, 13772, 14806, 15288, 16285, 17213, 18308, 18869, 19540, 20688, 21695]","[294, 528, 1020, 1204, 1654, 1992, 2352, 2786, 3493, 4144, 4848, 5274, 6236, 6780, 7175, 7835, 8253, 8876, 9129, 9224, 10497, 11821, 12240, 12829, 13509, 13929, 14601, 15331, 16003, 17132, 17705, 18072, 18349, 19205, 19437]","[170, 260, 350, 523, 942, 1032, 1199, 1373, 1987, 2802, 2982, 3165, 4174, 4283, 4394, 5028, 5248, 5777, 6247, 6582, 6767, 7182, 7486, 8428, 9025, 9213, 9843, 10281, 11056, 11657, 11957, 12507, 13052, 13286, 13800]","[170, 309, 399, 875, 1014, 1171, 1261, 1612, 1980, 2232, 2412, 2734, 3330, 3425, 3636, 4008, 4289, 4611, 5051, 5282, 5467, 6024, 6435, 6883, 8062, 8240, 8858, 9191, 9587, 10160, 10491, 10690, 10838, 11311, 11411]",24188,21695,19437,13800,11411,41,17,14,128,105,"[259, 530, 814, 1022, 1335, 1712, 2021, 2167, 2393, 2662, 2957, 3839, 4416, 4836, 5260, 5810, 6552, 7219, 7655, 7802, 8876, 9919, 10591, 11327, 11822, 12805, 13813, 14467, 14745, 15035, 15754, 16260, 18461, 19658, 21037]","[333, 661, 1030, 1406, 1787, 2209, 2779, 2981, 3071, 3285, 3727, 4694, 4993, 5660, 6086, 6632, 7407, 7895, 8423, 8640, 9125, 9485, 9777, 10134, 10562, 10657, 11120, 11506, 11698, 11829, 12105, 12314, 12804, 13481, 14005]","[209, 370, 611, 808, 981, 1290, 1662, 2033, 2123, 2420, 3074, 3720, 4077, 4556, 5119, 5647, 6560, 6985, 7079, 7579, 8085, 8771, 9589, 10230, 10325, 10828, 11165, 11342, 11438, 11691, 11823, 11923, 12774, 13130, 13988]","[221, 358, 546, 636, 766, 901, 1450, 1540, 1630, 1720, 1895, 3751, 3846, 4104, 4198, 4416, 5581, 5815, 6114, 6467, 6823, 7436, 7530, 8162, 8257, 8352, 8689, 8960, 9056, 9152, 9349, 9553, 10476, 10576, 11111]","[170, 260, 399, 489, 905, 995, 1379, 1469, 1559, 1732, 1963, 2982, 3077, 3172, 3528, 3686, 4395, 4529, 4984, 5285, 5455, 5890, 6059, 6278, 6448, 6783, 7195, 7652, 7823, 8075, 8452, 8627, 9702, 10160, 10996]",21037,14005,13988,11111,10996,3151,7690,5449,2689,415,19394,35,radiant
7559972212,95,17,29,66,86,"[292, 602, 923, 1179, 1466, 1970, 2645, 3049, 3542, 4069, 4559, 5092, 5641, 6397, 6800, 7522, 8659, 9501, 10009, 10881, 11199, 11985, 12691, 13581, 14291, 15184, 15953, 16644, 17626, 18729, 19555, 20367, 21733, 23007, 23917]","[331, 696, 1049, 1413, 1792, 2127, 2744, 3206, 3661, 4015, 4453, 5152, 6082, 6478, 7029, 7756, 8278, 8591, 9611, 10117, 11258, 11956, 12607, 13135, 14052, 14542, 15400, 16072, 16806, 17361, 17858, 18708, 19499, 20216, 21042]","[293, 606, 846, 1179, 1516, 2033, 2597, 2950, 3202, 4119, 4754, 5388, 5766, 6021, 6421, 6750, 7956, 8947, 9471, 9591, 10249, 10713, 11666, 12030, 12700, 12894, 13483, 13787, 14155, 14669, 14926, 15724, 16228, 17035, 17844]","[170, 658, 784, 911, 1050, 1332, 1670, 1968, 2266, 2916, 3539, 4009, 4581, 5133, 5652, 6280, 6887, 7349, 7942, 8236, 8526, 9182, 9793, 10473, 11170, 11632, 12159, 12788, 13328, 14032, 14435, 14903, 15686, 16103, 16772]","[170, 312, 402, 492, 582, 854, 1073, 1294, 1462, 1733, 1977, 2338, 2639, 2823, 2918, 3444, 3843, 4073, 4382, 4477, 4837, 5332, 5633, 5838, 6172, 6267, 6744, 7046, 7430, 7619, 7819, 8217, 8651, 9225, 10600]",23917,21042,17844,16772,10600,46,120,97,123,110,"[249, 568, 882, 1203, 1459, 1990, 2397, 2807, 3690, 4150, 4674, 5382, 6310, 7179, 7593, 7928, 8652, 9202, 9914, 10799, 11394, 12700, 13763, 14494, 15072, 16130, 16980, 17207, 17750, 18478, 18971, 19947, 20643, 20981, 21418]","[206, 531, 1012, 1425, 1753, 2106, 2438, 2926, 3429, 4257, 4362, 4888, 5304, 5552, 5995, 6519, 6783, 7251, 8032, 8803, 8984, 9576, 10235, 10898, 11307, 11957, 12347, 13083, 13451, 14065, 14401, 15000, 15441, 15854, 16968]","[205, 464, 742, 988, 1187, 1491, 1941, 2236, 2376, 2849, 3306, 3947, 4386, 4847, 5321, 5617, 5711, 6401, 6950, 7662, 8220, 8727, 8963, 9058, 9345, 9620, 9961, 10057, 10277, 10958, 11128, 12000, 12500, 12600, 13400]","[213, 375, 465, 555, 696, 970, 1126, 1216, 1530, 1907, 2116, 2292, 2611, 2946, 3189, 3374, 3468, 3563, 3791, 3949, 4330, 4497, 4895, 5088, 5315, 5462, 5703, 5799, 5900, 5996, 6133, 6233, 6471, 6699, 7453]","[170, 260, 397, 487, 577, 677, 860, 969, 1109, 1314, 1404, 1494, 1697, 1888, 2304, 2647, 2741, 2852, 3063, 3491, 3886, 4333, 4569, 4970, 5228, 5377, 5603, 5699, 5795, 6108, 6208, 6308, 6498, 6723, 7283]",21418,16968,13400,7453,7283,2499,4074,4444,9319,3317,23653,35,radiant
7560048306,82,73,29,123,105,"[257, 639, 1028, 1464, 1782, 2399, 2682, 3280, 3743, 4469, 4893, 5582, 6229, 7055, 7997, 8752, 9440, 10487, 11071, 12630, 13206, 14349, 15558, 16833, 17707, 18505, 18975, 20437, 21443, 22513, 23847, 24134, 25092, 27963, 29435]","[407, 729, 1217, 1615, 1886, 2252, 2756, 3362, 4330, 5070, 6155, 6425, 7941, 8640, 9815, 10474, 11393, 12900, 13387, 14487, 15477, 16907, 17107, 17927, 19163, 20606, 20978, 22083, 23002, 23992, 24304, 25109, 26189, 27803, 29168]","[383, 877, 1426, 1772, 2363, 2840, 3552, 4044, 4473, 5256, 5958, 6476, 7048, 7452, 8254, 8763, 9363, 10429, 11179, 11437, 11893, 12320, 12716, 13176, 13905, 14738, 15084, 15594, 15941, 16405, 17020, 17540, 17999, 19556, 20067]","[499, 654, 868, 1004, 1094, 1351, 1644, 1780, 2052, 2269, 2664, 2873, 3143, 3373, 3818, 4427, 4648, 5023, 5750, 5960, 6370, 6674, 6769, 7463, 7964, 8454, 8864, 9640, 10024, 10697, 10989, 11357, 12186, 13654, 14303]","[231, 514, 651, 844, 934, 1130, 1518, 1620, 1807, 2017, 2175, 2525, 2728, 2870, 3241, 3475, 4008, 4228, 4530, 4852, 5196, 5440, 5600, 5948, 6285, 6817, 7395, 8099, 8413, 8815, 9295, 9948, 10793, 12223, 12884]",29435,29168,20067,14303,12884,89,7,106,58,86,"[241, 564, 849, 1073, 1363, 1692, 2111, 2689, 3041, 3573, 4330, 5019, 5821, 6589, 7125, 7657, 8419, 9768, 10944, 11614, 12626, 13222, 14112, 15555, 16398, 17549, 18681, 19789, 20791, 23034, 24128, 24570, 25524, 25624, 26228]","[208, 624, 994, 1330, 1741, 2080, 2767, 3270, 3664, 4195, 4592, 5465, 6254, 6590, 6723, 7277, 7419, 7656, 8248, 8611, 9383, 9645, 10340, 10543, 10638, 10923, 11738, 12668, 13087, 14399, 14872, 14972, 15119, 15219, 15569]","[169, 336, 747, 1004, 1343, 1576, 2153, 2483, 2847, 3403, 4086, 4292, 4971, 5464, 5864, 6372, 6983, 7379, 7474, 7899, 8599, 9423, 9608, 9779, 10072, 10402, 10769, 11292, 11584, 12381, 12717, 13038, 13518, 13618, 13886]","[169, 259, 396, 499, 633, 723, 1276, 1366, 1501, 1831, 2234, 2691, 3086, 3487, 3865, 4185, 4370, 4536, 4999, 5612, 5707, 6051, 6218, 6654, 6769, 6994, 7152, 7610, 8264, 8661, 9048, 9224, 9424, 9728, 9941]","[169, 530, 670, 760, 850, 1061, 1348, 1438, 1792, 2381, 2693, 2882, 3206, 3417, 3667, 3915, 4010, 4104, 4213, 4593, 4779, 4913, 5291, 5386, 5481, 5859, 5954, 6179, 6360, 6566, 6786, 6925, 7025, 7195, 7295]",26228,15569,13886,9941,7295,3207,13599,6181,4362,5589,32938,35,radiant
7560138206,73,98,39,123,5,"[0, 371, 802, 1303, 1563, 1817, 2709, 3218, 3729, 4590, 5399, 6373, 7520, 9111, 9959, 11101, 12567, 13677, 14380, 15542, 17369, 18901, 20608, 21633, 22308, 22942, 24111, 25078, 25831, 26259, 26355, 27556, 28559, 29805, 31166]","[0, 244, 477, 857, 1018, 1433, 1897, 2238, 2472, 2888, 3200, 3641, 4517, 5502, 5948, 6640, 7430, 8000, 8463, 9133, 9790, 10778, 11440, 12231, 12982, 13527, 13941, 15029, 15782, 15965, 16500, 17745, 18428, 19689, 20541]","[0, 331, 607, 961, 1410, 1822, 2196, 2743, 3213, 3691, 4349, 5160, 5483, 6068, 6619, 7353, 7854, 8333, 9151, 10312, 11068, 11372, 12447, 13330, 13926, 14712, 15800, 16193, 17095, 17483, 17579, 18519, 19313, 20462, 21414]","[0, 169, 640, 760, 850, 986, 1194, 1398, 1768, 1868, 2266, 2356, 2871, 3254, 3924, 4333, 4702, 4971, 5311, 5588, 6198, 6909, 7612, 8160, 8731, 9248, 9950, 10635, 10950, 11301, 11827, 12371, 13219, 14207, 15568]","[0, 169, 365, 550, 685, 775, 1003, 1236, 1504, 1865, 2205, 2540, 2870, 3107, 3291, 3636, 4002, 4232, 4503, 4997, 5498, 6142, 6524, 6978, 7284, 7527, 8596, 8984, 9248, 9422, 9518, 9844, 10504, 10998, 11357]",31166,20541,21414,15568,11357,22,48,29,45,58,"[0, 357, 962, 1254, 1673, 2098, 2470, 3144, 3550, 3855, 4352, 4784, 5396, 5890, 6388, 6665, 7370, 7889, 8885, 9551, 10546, 10887, 11791, 12295, 13002, 13966, 15052, 16257, 16989, 18443, 18836, 20176, 21160, 21528, 21809]","[0, 257, 658, 1098, 1381, 1791, 2007, 2480, 2905, 3333, 3950, 4390, 5055, 5890, 6098, 6658, 7471, 8516, 9279, 9964, 11056, 11789, 12158, 12545, 13053, 13575, 13866, 14105, 15042, 16395, 17297, 18060, 18907, 19007, 19240]","[0, 245, 564, 763, 1170, 1689, 2098, 2617, 3019, 3371, 3831, 4077, 4660, 5416, 5929, 6521, 7313, 8084, 8954, 9270, 9988, 10252, 10509, 11032, 11525, 11741, 12032, 12463, 12920, 13704, 14436, 15346, 15754, 16046, 16322]","[0, 169, 289, 426, 578, 811, 967, 1291, 1504, 1781, 2014, 2104, 2275, 2548, 2823, 3041, 3632, 4004, 4397, 5005, 5655, 5919, 6220, 6385, 6776, 6992, 7468, 7804, 8471, 9466, 9864, 10054, 10296, 10396, 10609]","[0, 169, 289, 398, 488, 736, 826, 961, 1056, 1146, 1566, 1688, 1880, 2100, 2317, 2448, 2950, 3176, 3462, 3916, 4256, 4825, 5220, 5375, 5642, 5809, 6361, 6582, 7155, 8184, 8505, 8695, 8937, 9083, 9183]",21809,19240,16322,10609,9183,9357,1301,5092,4959,2174,22883,35,radiant
7560377202,10,49,61,128,121,"[609, 813, 1117, 1479, 1821, 2279, 2830, 3294, 3928, 4561, 5155, 5376, 6036, 7003, 7911, 9053, 9990, 10925, 11864, 12661, 13228, 13665, 14474, 15712, 16385, 17807, 18731, 19870, 21122, 21715, 21815, 22726, 23843, 24343, 25150]","[532, 735, 1017, 1355, 1516, 1965, 2161, 2550, 3453, 4054, 4712, 5674, 6162, 6883, 7330, 8177, 8448, 8904, 9510, 10089, 10678, 10843, 11073, 11894, 12347, 13230, 13610, 14454, 15081, 16287, 16387, 17001, 17569, 17949, 18525]","[904, 1289, 1555, 2178, 2789, 3355, 3832, 4496, 5306, 5751, 7115, 7427, 8009, 9014, 9509, 9996, 10284, 10720, 11109, 11499, 12101, 12426, 13161, 14003, 14334, 15425, 16176, 16703, 17485, 18143, 18374, 19253, 19805, 20049, 20149]","[541, 677, 767, 998, 1322, 1715, 1883, 2021, 2249, 2751, 3123, 3427, 3522, 4305, 4601, 4909, 5175, 5510, 5672, 5951, 6151, 6366, 6671, 7002, 7305, 7844, 8392, 8685, 8907, 9408, 9940, 10814, 10914, 11014, 11151]","[350, 490, 624, 714, 1003, 1267, 1435, 1570, 1902, 2076, 2628, 2883, 3165, 3640, 4149, 4351, 4533, 4726, 4821, 5025, 5120, 5215, 5445, 5701, 5796, 6083, 6393, 6714, 6904, 7356, 7570, 7760, 7860, 7960, 8060]",25150,18525,20149,11151,8060,70,35,129,123,20,"[948, 1196, 1487, 2008, 2434, 2608, 2912, 3425, 4042, 4721, 5256, 5833, 6507, 7235, 8050, 8629, 9387, 9905, 11068, 11669, 12466, 13020, 14279, 14963, 16065, 17077, 17531, 18418, 19659, 21626, 22827, 23812, 24696, 25625, 26193]","[530, 819, 1282, 1603, 2002, 2744, 3559, 4307, 5102, 5708, 6562, 6832, 7477, 8115, 8290, 8960, 9720, 10354, 11114, 11683, 12219, 12745, 13178, 13510, 14129, 14701, 15364, 16084, 16810, 18736, 19418, 19966, 21019, 21535, 23082]","[932, 1348, 1848, 2227, 2633, 3139, 4121, 4681, 5098, 5801, 6596, 6700, 6939, 7386, 7561, 8274, 8932, 9460, 10047, 10400, 10758, 10903, 11388, 11799, 12818, 13661, 14172, 14320, 14623, 15416, 15621, 16131, 16443, 16552, 17341]","[532, 622, 1099, 1189, 1344, 1544, 1812, 2020, 2362, 2801, 3210, 3421, 3767, 4182, 4402, 4769, 4864, 5220, 5615, 5828, 6166, 6404, 6590, 6708, 7364, 7620, 7790, 8225, 8467, 9502, 9602, 10066, 10223, 10332, 10802]","[829, 966, 1267, 1572, 1920, 2020, 2425, 2873, 3266, 3383, 3700, 4200, 4439, 4732, 4907, 5371, 5585, 5863, 6329, 6570, 6893, 7063, 7351, 7568, 8072, 8288, 8459, 8630, 9088, 9900, 10060, 10325, 10500, 10870, 11585]",26193,23082,17341,10802,11585,-1043,-4557,2808,349,-3525,-5968,35,dire
7560508910,63,106,29,128,20,"[205, 446, 654, 1076, 1351, 1485, 2159, 2525, 2873, 3263, 3717, 4263, 4838, 5092, 5712, 6437, 6965, 7304, 7895, 8262, 9249, 10018, 10712, 11182, 11966, 12827, 13115, 14397, 15199, 16515, 16964, 18060, 19169, 19269, 19956]","[207, 415, 762, 1016, 1309, 1600, 1909, 2293, 2709, 2996, 3465, 3760, 4531, 4805, 5319, 5513, 5885, 6461, 7242, 7716, 8501, 9236, 9816, 10421, 10845, 11337, 11902, 12882, 13418, 14859, 15513, 16859, 18267, 18620, 19087]","[205, 452, 739, 1060, 1356, 1620, 2034, 2502, 2921, 3161, 3448, 4134, 4700, 5302, 5939, 6176, 7151, 7810, 8323, 8900, 9653, 10444, 11551, 11932, 12144, 12710, 13263, 14083, 14489, 15591, 16121, 16767, 17940, 18225, 18733]","[223, 313, 403, 533, 709, 799, 1076, 1303, 1704, 1929, 2019, 2319, 2737, 2832, 3324, 3518, 3774, 3916, 4611, 5135, 5230, 5666, 6393, 6646, 7059, 7511, 7859, 9042, 9483, 10213, 10416, 11191, 11918, 12089, 12218]","[221, 311, 401, 579, 980, 1107, 1372, 1507, 1683, 1792, 1882, 2005, 2351, 2539, 2879, 3073, 3168, 3353, 4189, 4508, 4603, 5081, 5559, 5653, 5820, 6005, 6210, 6894, 7338, 8556, 8707, 9464, 10270, 10449, 10838]",19956,19087,18733,12218,10838,17,21,129,33,45,"[326, 685, 1102, 1467, 1927, 2373, 2774, 3287, 3659, 4095, 4943, 5446, 5855, 6554, 6949, 7871, 8642, 9363, 9793, 10026, 10315, 10751, 11175, 11812, 11979, 12806, 13206, 13478, 13781, 14400, 14883, 15326, 15579, 17085, 17722]","[253, 454, 581, 1128, 1460, 1758, 2185, 2764, 3112, 3470, 4258, 4669, 5188, 5733, 6440, 6890, 7311, 8028, 8258, 9110, 9303, 9889, 10703, 11098, 11762, 12649, 12906, 13083, 13422, 13990, 14408, 14724, 15222, 16696, 17201]","[254, 541, 803, 1329, 1526, 2043, 2344, 2673, 3170, 3714, 4018, 4594, 4878, 5834, 6208, 6657, 7358, 7700, 8038, 8443, 9063, 9728, 9823, 10064, 10570, 11068, 11242, 11787, 12140, 12706, 13166, 13439, 13539, 14795, 15215]","[171, 261, 351, 573, 663, 753, 948, 1234, 1373, 1722, 1976, 2178, 2272, 2681, 2776, 3285, 3597, 3855, 4282, 4425, 5168, 5594, 5811, 6152, 6462, 6758, 7086, 7338, 7680, 8262, 8583, 8906, 9234, 9846, 10222]","[171, 610, 700, 874, 1186, 1276, 1696, 1959, 2049, 2229, 2464, 2665, 3329, 3941, 4207, 4464, 4950, 5599, 6111, 6299, 6394, 6561, 6739, 6915, 7082, 7616, 7763, 8104, 8325, 8481, 8688, 8837, 9112, 10155, 10255]",17722,17201,15215,10222,10255,2234,1886,3518,1996,583,10217,35,radiant
7560629402,49,25,23,123,45,"[0, 287, 601, 868, 1171, 1463, 1787, 2067, 2482, 2746, 3302, 3513, 4183, 4734, 5297, 5736, 6713, 7377, 8238, 9284, 10193, 10694, 11437, 11778, 12564, 13290, 14159, 15009, 16195, 16334, 17406, 18020, 18635, 20301, 21435]","[0, 293, 545, 787, 1021, 1233, 1323, 1648, 2008, 2286, 2853, 3223, 3857, 4462, 5287, 5823, 6344, 6656, 7707, 8103, 8738, 9319, 10015, 11096, 11716, 12551, 13273, 13699, 14517, 14700, 15432, 15810, 16544, 17924, 19013]","[0, 243, 408, 842, 1194, 1537, 2144, 2334, 3118, 3747, 4345, 5063, 5582, 6232, 6703, 7190, 7660, 8396, 9022, 9242, 9950, 10132, 10682, 12164, 12427, 12936, 13624, 14083, 14850, 15147, 15581, 15681, 16031, 17120, 17853]","[0, 215, 390, 480, 640, 730, 867, 1004, 1233, 1456, 1768, 2117, 2374, 2591, 3066, 3494, 3903, 4516, 5490, 6072, 6399, 6823, 6918, 7013, 7604, 7916, 8670, 9294, 9794, 10375, 10664, 10911, 11131, 12097, 12787]","[0, 205, 295, 385, 610, 769, 865, 955, 1184, 1674, 1980, 2070, 2291, 2434, 2960, 3325, 4185, 4336, 4706, 5138, 5473, 5567, 5662, 5757, 6090, 6258, 6751, 6902, 7189, 7553, 7879, 7979, 8079, 8697, 9384]",21435,19013,17853,12787,9384,59,15,106,102,105,"[0, 244, 442, 603, 1122, 1467, 2021, 2444, 3023, 3512, 4077, 4961, 5465, 6213, 6779, 7349, 8658, 9094, 9944, 10114, 11312, 12395, 13520, 14560, 14836, 15990, 16630, 17215, 17908, 18543, 20473, 21386, 22364, 23038, 23138]","[0, 243, 492, 1155, 1452, 1853, 2217, 2545, 2872, 3428, 3649, 4412, 4943, 5309, 5662, 6050, 6839, 7502, 8122, 8607, 9018, 9736, 10452, 11261, 11804, 12226, 12867, 13404, 13930, 14508, 16085, 16535, 17089, 17943, 18579]","[0, 208, 491, 708, 967, 1333, 1468, 1962, 2160, 2540, 3173, 3448, 3885, 4185, 4633, 5154, 5748, 6357, 7015, 7110, 8037, 8404, 9603, 11107, 11717, 12204, 12597, 13134, 13908, 14145, 14742, 15484, 16437, 16830, 16930]","[0, 170, 317, 407, 532, 871, 1079, 1321, 1411, 1552, 1733, 1960, 2313, 2748, 3152, 3350, 3691, 3921, 4319, 4414, 4841, 5116, 5714, 6341, 6436, 6710, 6805, 6946, 7177, 7273, 7841, 8361, 8878, 9123, 9476]","[0, 170, 299, 603, 757, 847, 1220, 1577, 1797, 1887, 2128, 2331, 2421, 2837, 3422, 3637, 4124, 4354, 4621, 4752, 5074, 5759, 6581, 7248, 7418, 7706, 8224, 8394, 8753, 8924, 9695, 9960, 10675, 10985, 11118]",23138,18579,16930,9476,11118,-1703,434,923,3311,-1734,1231,35,radiant
7560661218,73,93,120,86,105,"[0, 411, 690, 1068, 1410, 1862, 2343, 2809, 3361, 4084, 4977, 5503, 6194, 7192, 7596, 9063, 10430, 11472, 12646, 13727, 14701, 15752, 17094, 18168, 18599, 19495, 20031, 20392, 20991, 21832, 22297, 22817, 23356, 24211, 24338]","[0, 244, 560, 945, 1186, 1673, 1904, 2185, 2691, 2978, 3358, 3871, 4164, 4661, 4953, 5376, 6647, 6832, 7514, 8137, 8908, 9355, 9620, 10418, 10698, 10972, 11516, 12096, 12292, 12918, 13259, 14024, 14316, 15767, 15950]","[0, 245, 484, 1009, 1573, 2064, 2288, 2667, 2879, 3370, 3849, 4131, 4692, 5398, 5792, 6153, 6796, 7144, 7507, 8074, 8500, 8907, 9678, 10436, 10531, 11124, 11313, 11930, 12170, 12782, 13489, 14207, 14415, 15196, 15420]","[0, 258, 348, 485, 916, 1168, 1308, 1443, 1558, 2099, 2540, 2666, 2977, 3197, 3291, 3511, 3732, 4226, 4588, 4923, 5043, 5163, 5418, 5622, 5885, 6172, 6505, 6799, 7246, 7601, 7876, 8168, 8460, 9649, 9845]","[0, 210, 300, 437, 567, 776, 866, 1048, 1138, 1362, 1620, 1710, 1844, 2196, 2290, 2421, 2936, 3221, 3340, 3498, 3593, 3688, 4333, 4500, 4595, 4762, 4900, 4995, 5191, 5368, 5545, 5811, 6153, 6290, 6882]",24338,15950,15420,9845,6882,46,21,29,20,136,"[0, 205, 605, 1054, 1453, 1898, 2433, 2676, 3146, 3641, 4244, 4932, 5770, 6121, 6847, 7427, 9157, 9802, 10283, 10747, 11724, 12531, 13306, 14153, 15416, 16162, 17484, 18547, 19745, 20851, 21584, 22594, 23405, 24399, 24499]","[0, 165, 399, 856, 1064, 1261, 1558, 1841, 2239, 2747, 2980, 3386, 4076, 4713, 5146, 5579, 6630, 7280, 7866, 8207, 8951, 9583, 10343, 10900, 11746, 12475, 13226, 13826, 14360, 14826, 15332, 16138, 16722, 17375, 17500]","[0, 204, 915, 1194, 1515, 1810, 2168, 2479, 2920, 3482, 3987, 4695, 5188, 5721, 6489, 7330, 8107, 8619, 9172, 9267, 9977, 10767, 11634, 12570, 13020, 13642, 14442, 14906, 15491, 16124, 16329, 16773, 17010, 17554, 17654]","[0, 130, 272, 423, 537, 627, 751, 841, 931, 1060, 1303, 1623, 1943, 2407, 2712, 3035, 3705, 4021, 4485, 4980, 5339, 5555, 5894, 6196, 6731, 7272, 7494, 7759, 8141, 8654, 8787, 9265, 9455, 9645, 9745]","[0, 130, 297, 436, 526, 699, 836, 926, 1052, 1142, 1277, 1761, 2046, 2361, 2675, 3088, 3664, 3952, 4542, 4859, 5306, 5571, 6206, 6458, 6775, 7063, 7463, 7727, 8059, 8525, 8621, 9065, 9304, 9848, 10546]",24499,17500,17654,9745,10546,-161,-1550,-2234,100,-3664,-7509,35,dire
7560727113,95,126,65,120,110,"[328, 624, 992, 1327, 1610, 2149, 2542, 2942, 3399, 4047, 4391, 4860, 5283, 6041, 6672, 6984, 7589, 8401, 9042, 9953, 10760, 11538, 12392, 13367, 14890, 16114, 17583, 18314, 19213, 19986, 20723, 21547, 22920, 24309, 26099]","[0, 277, 609, 990, 1362, 1639, 2250, 2476, 2924, 3573, 3874, 4188, 4433, 5049, 5389, 6261, 6938, 7250, 7660, 8311, 9009, 10111, 10494, 11088, 11827, 12185, 12788, 13584, 13947, 14375, 15038, 16084, 17056, 18407, 19185]","[60, 269, 463, 858, 1296, 1598, 2169, 2587, 3145, 3855, 4503, 5775, 6282, 6840, 7125, 7393, 8104, 8495, 8725, 9674, 9982, 10686, 11283, 11603, 12453, 13025, 13894, 14284, 14800, 15104, 15247, 15948, 16277, 17565, 18607]","[60, 320, 410, 549, 682, 1116, 1312, 1447, 1638, 1818, 2178, 2507, 2927, 3236, 3557, 3652, 3809, 4049, 4401, 4746, 5156, 5833, 6094, 6189, 6969, 7686, 8145, 8538, 8634, 9095, 9416, 10023, 10328, 11523, 12454]","[160, 369, 459, 549, 679, 882, 1002, 1318, 1457, 1734, 1961, 2129, 2323, 2583, 2946, 3079, 3436, 4147, 4611, 4888, 5139, 5750, 5943, 6235, 6688, 7390, 7896, 8071, 8503, 8903, 9048, 9593, 10376, 11394, 12072]",26099,19185,18607,12454,12072,48,13,23,123,105,"[0, 164, 416, 663, 1161, 1667, 2205, 2536, 2747, 3160, 3773, 4296, 5030, 5546, 6106, 6892, 7822, 8531, 9357, 10328, 11333, 11957, 13307, 14088, 15144, 15239, 16255, 17021, 17866, 18227, 18771, 19695, 20152, 20437, 20644]","[0, 199, 438, 684, 1242, 1541, 1988, 2422, 2750, 3211, 4021, 4327, 4889, 5281, 5793, 5888, 6663, 7023, 7402, 7696, 8259, 8765, 9975, 10653, 11196, 11945, 12040, 12701, 13225, 13979, 14592, 15435, 15737, 15837, 15937]","[0, 178, 579, 790, 984, 1228, 1513, 1858, 2118, 2444, 3293, 3678, 4180, 4645, 4974, 5388, 6002, 6663, 7124, 7536, 8330, 8623, 9173, 9405, 9643, 9738, 10402, 10836, 11092, 11220, 11451, 11762, 11911, 12109, 12246]","[0, 129, 219, 359, 606, 734, 1337, 1975, 2100, 2190, 2401, 2539, 3041, 3234, 3377, 3527, 4129, 4224, 4916, 5533, 5750, 5845, 6537, 6906, 7308, 7403, 7743, 7979, 8156, 8420, 9035, 9542, 9741, 9841, 10204]","[0, 129, 219, 309, 469, 627, 1085, 1220, 1348, 1438, 1663, 1911, 2140, 2235, 2375, 2720, 3026, 3232, 4198, 4585, 4857, 4993, 5652, 5822, 6203, 6373, 6543, 6757, 7009, 7180, 7449, 7549, 7766, 7866, 7966]",20644,15937,12246,10204,7966,5455,3248,6361,2250,4106,21420,35,radiant
7560901901,72,76,38,20,105,"[314, 619, 937, 1393, 2180, 2572, 2994, 3527, 4144, 4696, 5116, 5710, 6450, 7189, 7706, 8788, 9124, 10359, 11470, 12351, 13275, 13928, 14673, 15456, 16320, 17403, 18801, 19278, 19776, 20489, 22281, 22967, 23067, 25024, 26131]","[249, 416, 581, 1117, 1448, 1831, 2243, 2817, 3318, 3739, 4020, 4569, 4834, 5250, 5441, 6013, 6325, 7518, 8139, 8719, 9256, 9971, 10502, 10597, 10859, 11113, 12514, 13217, 13949, 14045, 14960, 15107, 15729, 16017, 16658]","[535, 807, 985, 1260, 1679, 2010, 2281, 2795, 3101, 3575, 4334, 4775, 5231, 5548, 5943, 6314, 7085, 7796, 8455, 8788, 9133, 9745, 10098, 10563, 10789, 11490, 12488, 12897, 13173, 13454, 14130, 14588, 14688, 15785, 16081]","[229, 358, 465, 692, 978, 1068, 1439, 1616, 1721, 1856, 2061, 2629, 3097, 3385, 3693, 3944, 4174, 4709, 5016, 5336, 5597, 5770, 6080, 6175, 6398, 6947, 7675, 7771, 8047, 8143, 8687, 8920, 9380, 9480, 9580]","[277, 412, 502, 592, 726, 864, 999, 1089, 1179, 1560, 2281, 2547, 2715, 3165, 3623, 3718, 3948, 4453, 4649, 4744, 4902, 5243, 6511, 6606, 6724, 6818, 7854, 7994, 8147, 8243, 8813, 9081, 9181, 9281, 9381]",26131,16658,16081,9580,9381,95,23,97,110,26,"[197, 505, 993, 1389, 1718, 2268, 2818, 3252, 3725, 4193, 4728, 5429, 6636, 7404, 8294, 9478, 10346, 10524, 11474, 12392, 13250, 14292, 15371, 16431, 17565, 18305, 19073, 20487, 22726, 23307, 23970, 27379, 28536, 30372, 31450]","[239, 543, 914, 1123, 1458, 1632, 1942, 2321, 2672, 3158, 3802, 3943, 4637, 4902, 5568, 6412, 6924, 7590, 7903, 8396, 8885, 9233, 10438, 11023, 12126, 12675, 13354, 13726, 14638, 14955, 15617, 16490, 17338, 17918, 19285]","[207, 491, 808, 1131, 1615, 2236, 2681, 3200, 3607, 4153, 4775, 5053, 5250, 5710, 6298, 7057, 7715, 7893, 8328, 8850, 9424, 9881, 11072, 11319, 11740, 12446, 12614, 12946, 13419, 13815, 14969, 15826, 16173, 16855, 17135]","[169, 259, 406, 536, 626, 761, 1022, 1134, 1260, 1678, 1924, 2448, 2685, 3092, 3277, 3632, 4184, 4362, 4654, 4857, 5027, 5419, 6082, 6547, 6968, 7607, 7831, 8374, 9094, 9310, 9410, 10207, 10414, 10794, 11141]","[219, 346, 436, 612, 862, 1156, 1291, 1518, 1733, 1959, 2186, 2353, 2680, 2775, 3123, 3326, 3657, 3835, 3929, 4024, 4119, 4213, 5097, 5323, 5806, 6669, 6793, 7137, 7840, 8077, 8177, 8974, 9074, 9659, 9939]",31450,19285,17135,11141,9939,-5319,-2627,-1054,-1561,-558,-11119,35,dire
7561212717,94,137,17,123,90,"[0, 154, 481, 857, 1337, 1708, 1833, 2164, 2432, 3001, 3491, 4181, 4591, 5607, 6105, 6785, 7507, 8678, 9560, 10499, 10998, 11093, 12270, 13487, 14640, 15856, 16544, 17322, 18337, 19858, 20531, 21084, 21743, 22343, 23865]","[0, 191, 434, 706, 945, 1437, 1676, 1854, 2062, 2611, 3165, 3682, 3999, 4623, 5463, 5980, 6974, 7507, 8173, 8496, 9313, 9408, 9736, 10320, 11194, 11780, 12277, 12804, 13050, 13970, 14066, 14166, 14266, 14366, 15205]","[0, 273, 560, 1014, 1507, 2057, 2463, 3057, 3419, 3836, 4265, 4519, 4923, 5345, 5691, 6290, 6749, 7108, 7579, 8069, 8667, 8982, 9380, 10226, 10625, 11098, 11436, 11885, 12326, 13090, 13186, 13286, 13386, 13486, 14688]","[0, 154, 244, 514, 644, 779, 905, 1166, 1404, 1518, 1775, 2076, 2215, 2766, 3130, 3342, 3896, 4291, 4478, 4874, 5348, 5443, 5631, 5989, 6164, 6331, 6425, 6620, 6906, 7493, 7670, 7770, 7870, 7970, 9054]","[0, 154, 244, 381, 596, 780, 903, 1059, 1295, 1406, 1500, 1813, 1953, 2208, 2545, 2758, 3296, 3482, 3952, 4258, 4417, 4512, 4699, 5002, 5211, 5378, 5472, 5661, 5815, 6632, 6728, 6828, 7005, 7470, 8709]",23865,15205,14688,9054,8709,95,13,96,65,110,"[0, 317, 560, 758, 1227, 1650, 2141, 2672, 3170, 3722, 4308, 4732, 5175, 5722, 6291, 7222, 7620, 8304, 9150, 10066, 10796, 12769, 13695, 14811, 15629, 16694, 17521, 18390, 19537, 20395, 21233, 21790, 22706, 23531, 23884]","[0, 292, 542, 821, 1227, 1637, 2053, 2614, 3147, 3589, 4166, 4589, 5051, 5895, 6338, 6993, 7534, 7837, 8411, 8772, 9225, 10865, 11409, 12047, 12432, 13032, 13206, 14036, 14427, 14647, 15013, 15151, 15251, 15441, 16224]","[0, 243, 598, 962, 1321, 1609, 1952, 2244, 2580, 3032, 3556, 4020, 4397, 5073, 5567, 6160, 7040, 7677, 8254, 8858, 9151, 10200, 10908, 11247, 11546, 12269, 12363, 13225, 13928, 14446, 14594, 14772, 14948, 15263, 15728]","[0, 209, 299, 389, 863, 973, 1203, 1497, 1662, 1828, 2008, 2272, 2602, 3013, 3355, 3787, 4220, 4363, 4655, 4981, 5514, 6503, 7073, 7242, 7579, 7870, 8039, 8386, 8926, 9314, 9434, 9534, 9634, 9824, 9924]","[0, 255, 345, 455, 668, 803, 1116, 1472, 1605, 2169, 2349, 2483, 2679, 3045, 3348, 3532, 3765, 4059, 4307, 4639, 5035, 5602, 5841, 5935, 6186, 6521, 6615, 7027, 7369, 7709, 7923, 8069, 8207, 8397, 8907]",23884,16224,15728,9924,8907,-19,-1019,-1040,-870,-198,-3146,35,dire
7561287313,19,7,138,86,92,"[0, 322, 675, 937, 1267, 1709, 1927, 2362, 2641, 3011, 3242, 4073, 4479, 4733, 5043, 6051, 6890, 7280, 7727, 8310, 8923, 10064, 10578, 11308, 11403, 12139, 13157, 13391, 14156, 14953, 16365, 17743, 18892, 18992, 19152]","[0, 242, 475, 790, 1113, 1566, 1813, 2063, 2466, 2774, 3365, 3710, 4132, 4456, 4862, 5632, 6039, 6284, 7082, 7511, 7784, 8497, 8930, 9209, 9931, 10139, 10352, 11245, 11466, 11596, 13094, 13900, 14665, 14861, 14961]","[0, 207, 833, 968, 1058, 1312, 1501, 1591, 1763, 2108, 2375, 3486, 3720, 4260, 4435, 5148, 5706, 6078, 7002, 7562, 7657, 8473, 9063, 9201, 9593, 9872, 10153, 11010, 11106, 11334, 12513, 13189, 14429, 14630, 14730]","[0, 218, 308, 500, 674, 903, 1042, 1255, 1513, 1875, 2092, 3102, 3697, 3936, 4117, 4707, 4865, 4993, 5486, 5973, 6241, 6758, 6981, 7085, 7491, 7699, 8070, 8609, 8780, 9049, 11387, 12113, 13245, 13420, 13941]","[0, 204, 502, 705, 1008, 1332, 1494, 1704, 1839, 2014, 2194, 2859, 3171, 3481, 4031, 4516, 4935, 5151, 5778, 6141, 6285, 7346, 7538, 7653, 7857, 7951, 8270, 8751, 8892, 9123, 10170, 10654, 11114, 11518, 11692]",19152,14961,14730,13941,11692,46,120,97,123,21,"[0, 244, 559, 962, 1248, 1669, 2527, 3161, 3734, 4604, 5735, 6549, 7220, 8050, 8648, 9209, 10341, 11255, 12267, 13459, 14293, 15193, 16493, 18463, 19940, 20878, 22174, 23124, 23839, 25190, 25411, 25511, 26822, 28518, 31339]","[0, 288, 533, 981, 1384, 1727, 2507, 2801, 3411, 3587, 4065, 4535, 4974, 5761, 6086, 6340, 7026, 7526, 8076, 8893, 9177, 9564, 10369, 11035, 11710, 12168, 12662, 13421, 14233, 14501, 14597, 15051, 15403, 16636, 18545]","[0, 243, 581, 970, 1286, 1771, 2027, 2708, 3003, 3645, 4231, 4536, 4991, 5743, 6475, 6795, 7270, 7538, 8113, 8637, 9071, 9950, 10093, 10606, 11150, 11487, 11851, 12552, 13414, 13885, 14366, 14674, 15033, 15914, 17113]","[0, 170, 309, 545, 728, 958, 1195, 1453, 1682, 1993, 2384, 2730, 2964, 3292, 3491, 3936, 4303, 4654, 4749, 5761, 6190, 6360, 6561, 7106, 7521, 8046, 8687, 8946, 9684, 9943, 10039, 10325, 10425, 10946, 12786]","[0, 170, 260, 385, 540, 692, 999, 1172, 1480, 1726, 2096, 2457, 2547, 3007, 3101, 3365, 3590, 3849, 4077, 4421, 5052, 5193, 5607, 5991, 6331, 6585, 6934, 7382, 7817, 8125, 8246, 8528, 8703, 9286, 10482]",31339,18545,17113,12786,10482,-12187,-3584,-2383,1155,1210,-15789,35,dire
7561841307,80,39,129,45,20,"[0, 169, 412, 682, 998, 1353, 1973, 2311, 2607, 3615, 4171, 4636, 4975, 5626, 6243, 6553, 6931, 7541, 7966, 9158, 10233, 10684, 12134, 12943, 13492, 14232, 15161, 15694, 16106, 16605, 17626, 18652, 18927, 19635, 21026]","[0, 298, 569, 905, 1180, 1512, 1803, 2428, 2704, 2956, 3159, 3712, 4084, 4526, 4901, 5548, 5812, 6316, 6817, 7897, 9122, 9658, 10372, 10822, 11601, 12651, 13546, 13957, 15041, 16219, 16506, 17661, 18106, 18791, 20328]","[0, 278, 592, 920, 1096, 1575, 1927, 2423, 2905, 3232, 3659, 3957, 4207, 4485, 4860, 5233, 5434, 5831, 6281, 7160, 8153, 8454, 9139, 9677, 10019, 10220, 10693, 11355, 11900, 12337, 12617, 13151, 13251, 13667, 13998]","[0, 169, 259, 349, 439, 569, 659, 1107, 1197, 1582, 1904, 2094, 2234, 2383, 2948, 3503, 3761, 3981, 4184, 4641, 5532, 5942, 6663, 6944, 7285, 7418, 8112, 8364, 9046, 9248, 9540, 10115, 10302, 10718, 11230]","[0, 169, 298, 406, 531, 685, 822, 1168, 1258, 1403, 1732, 1822, 2058, 2273, 2548, 3055, 3150, 3260, 3463, 3926, 4988, 5083, 5680, 5962, 6163, 6502, 7029, 7199, 7855, 7951, 8047, 8515, 8615, 9031, 9688]",21026,20328,13998,11230,9688,10,106,137,21,136,"[0, 169, 334, 567, 1039, 1384, 1787, 2108, 2512, 3080, 3654, 4045, 4552, 5142, 5653, 6421, 7242, 7513, 8387, 9171, 9598, 9775, 10464, 11312, 12301, 12946, 13607, 14190, 14969, 15515, 16404, 17392, 18563, 19462, 19742]","[0, 278, 638, 889, 1305, 1604, 1953, 2170, 2551, 3153, 3380, 3590, 4307, 4985, 5421, 5773, 6422, 7018, 7547, 8142, 8491, 8978, 9463, 10172, 10638, 11177, 11668, 12287, 12993, 13467, 14230, 14420, 14629, 15815, 16811]","[0, 267, 720, 964, 1335, 1796, 2029, 2664, 3484, 4017, 4239, 4561, 5374, 5689, 5938, 7076, 7487, 8003, 8595, 9399, 9904, 10343, 10727, 10971, 11366, 11926, 12212, 12388, 13040, 13315, 13990, 14147, 14783, 15322, 15602]","[0, 501, 638, 778, 1193, 1323, 1511, 1822, 2032, 2465, 2854, 2979, 3355, 3647, 3954, 4301, 4792, 4887, 5279, 5605, 5849, 6270, 6684, 6864, 7003, 7170, 7264, 7635, 7973, 8246, 8393, 8493, 8629, 9037, 9317]","[0, 233, 429, 749, 872, 1002, 1092, 1354, 1513, 1859, 2326, 2416, 2797, 3343, 3564, 3912, 4414, 4509, 4604, 4761, 5021, 5116, 5418, 5512, 5607, 5774, 5868, 6044, 6526, 7193, 7557, 7657, 7982, 8390, 9169]",19742,16811,15602,9317,9169,1284,3517,-1604,1913,519,5629,35,dire
7561842010,120,21,28,79,85,"[60, 379, 807, 1057, 1473, 1841, 2180, 2440, 2723, 3181, 3713, 4317, 4569, 4757, 5268, 5998, 7184, 7764, 8290, 8798, 9581, 10426, 11091, 11596, 12733, 13533, 14750, 15562, 16427, 17356, 17961, 18992, 19507, 19811, 20795]","[60, 394, 623, 1157, 1499, 1828, 2223, 2559, 2958, 3564, 4177, 4722, 4972, 5140, 5516, 6619, 7678, 8120, 8413, 8829, 9576, 10084, 10487, 10991, 11238, 12018, 12933, 13512, 14158, 15168, 15686, 16550, 17038, 18170, 18737]","[60, 384, 674, 958, 1382, 2111, 2729, 3135, 3575, 4119, 4812, 5318, 5510, 5876, 6573, 7479, 8328, 8822, 9523, 9928, 10306, 11131, 11514, 12235, 12330, 13677, 14291, 14490, 14857, 15670, 16064, 16446, 17088, 17521, 18272]","[328, 537, 627, 717, 967, 1160, 1315, 1453, 1659, 1913, 2479, 2623, 2915, 3513, 4070, 4477, 5129, 5585, 5961, 6695, 7501, 7911, 8090, 8189, 8596, 8861, 9480, 9815, 10046, 10333, 10478, 11031, 11219, 11450, 11700]","[60, 269, 406, 680, 987, 1117, 1254, 1426, 1572, 1796, 2379, 2523, 2743, 2933, 3516, 3961, 4357, 5231, 5471, 5777, 6206, 6549, 6716, 6967, 7720, 8007, 8315, 8455, 8757, 9177, 9324, 9840, 10105, 10205, 10780]",20795,18737,18272,11700,10780,12,39,96,27,112,"[0, 168, 452, 822, 1216, 1486, 1670, 1880, 2090, 2413, 2886, 3257, 4525, 4934, 5531, 6097, 7097, 7516, 7745, 8820, 9336, 10039, 10768, 11539, 12310, 12911, 13934, 14378, 15374, 16098, 16643, 16842, 18026, 18769, 20915]","[0, 202, 436, 724, 1042, 1458, 1791, 2149, 2797, 3058, 3628, 4537, 4999, 5655, 6132, 6470, 7023, 7902, 8471, 9003, 9293, 9669, 10378, 10823, 11347, 11647, 12492, 12820, 13554, 14307, 14984, 15084, 15372, 16105, 16697]","[0, 205, 452, 724, 1222, 1431, 1782, 2327, 2818, 3368, 3692, 4036, 4742, 5118, 5849, 6046, 6858, 7161, 7355, 7808, 8080, 8280, 8900, 9224, 9776, 10071, 10272, 10808, 11221, 11595, 11823, 12179, 12708, 13008, 13907]","[0, 129, 219, 362, 709, 848, 982, 1072, 1492, 1701, 2121, 2477, 3049, 3921, 4127, 4306, 5357, 5795, 6140, 6297, 6392, 6681, 7276, 7677, 8156, 8380, 8588, 9017, 9549, 10149, 10320, 10695, 11096, 11471, 12858]","[0, 129, 219, 309, 490, 580, 1002, 1186, 1370, 1579, 1849, 2141, 2570, 2725, 2986, 3080, 3643, 4138, 4406, 4866, 5310, 5534, 6334, 6627, 6866, 7285, 7380, 7835, 8437, 9040, 9273, 9373, 9723, 10049, 10932]",20915,16697,13907,12858,10932,-120,2040,4365,-1158,-152,4975,35,dire
7562239303,21,69,43,20,26,"[0, 255, 646, 970, 1461, 1783, 2327, 2603, 3330, 3695, 4253, 4825, 5624, 6212, 6410, 7108, 7936, 8346, 9495, 10574, 11255, 11999, 12896, 13933, 14636, 15506, 16419, 17960, 18709, 19731, 20830, 22075, 22959, 23378, 24284]","[0, 243, 528, 687, 1242, 1556, 2045, 2396, 2700, 3184, 3789, 4142, 4677, 5521, 5909, 6436, 7103, 7794, 8289, 8930, 9610, 10362, 11094, 11774, 12473, 13332, 14150, 14570, 15690, 16208, 17059, 17744, 18480, 19797, 20688]","[0, 279, 556, 968, 1272, 1640, 2061, 2479, 3031, 3398, 4161, 5015, 5420, 6156, 6523, 6913, 7518, 8472, 9296, 10062, 10862, 11391, 12080, 12829, 13564, 14465, 15076, 15686, 16290, 16902, 18089, 19193, 19699, 20182, 20868]","[0, 170, 260, 475, 647, 1031, 1166, 1514, 1744, 1834, 2059, 2359, 2449, 2712, 2807, 3025, 3329, 3462, 3991, 4197, 4485, 4720, 4950, 5360, 5618, 5912, 6166, 6403, 6886, 7072, 7759, 8122, 8337, 9074, 9296]","[0, 170, 363, 524, 661, 859, 994, 1165, 1300, 1436, 1739, 1967, 2248, 2396, 2491, 2586, 2856, 2976, 3309, 3657, 3896, 4109, 4392, 4559, 4837, 5114, 5494, 6062, 6320, 6874, 7342, 7679, 7860, 8519, 8709]",24284,20688,20868,9296,8709,18,98,23,53,121,"[0, 568, 934, 1374, 1713, 2357, 2683, 3192, 3724, 4373, 4828, 5904, 6358, 6902, 7852, 8594, 9418, 10236, 10795, 11869, 12405, 13091, 14420, 15136, 15978, 16638, 17535, 18124, 19536, 20395, 21496, 22684, 23242, 24519, 24717]","[0, 195, 355, 756, 923, 1136, 1613, 2008, 2224, 2669, 3133, 3665, 3920, 4440, 5074, 5378, 5808, 6424, 6639, 7137, 7499, 8011, 8760, 9610, 10433, 11021, 11586, 11756, 12306, 12748, 13009, 13869, 14680, 15128, 15604]","[0, 346, 618, 782, 1117, 1319, 1914, 2049, 2287, 2737, 3008, 3276, 3755, 4345, 4883, 5556, 6063, 6287, 6723, 7233, 7599, 7930, 8775, 9378, 9495, 9590, 10175, 10478, 10763, 10944, 11078, 11401, 12176, 12851, 13657]","[0, 263, 353, 708, 798, 1093, 1264, 1399, 1535, 1625, 1932, 2218, 2586, 2834, 3289, 3482, 3897, 4145, 4360, 4721, 5135, 5473, 5895, 6297, 6966, 7313, 7733, 8396, 8591, 9267, 9363, 10060, 10504, 10748, 11509]","[0, 263, 371, 581, 716, 1055, 1226, 1377, 1518, 1608, 1758, 2235, 2494, 2853, 3256, 3558, 3715, 4064, 4279, 4545, 4677, 4772, 5279, 5482, 5576, 5671, 5936, 6145, 6552, 6862, 6958, 7208, 7308, 7542, 7697]",24717,15604,13657,11509,7697,-433,5084,7211,-2213,1012,10661,35,radiant
7562563601,89,13,97,66,119,"[646, 906, 1263, 1557, 2178, 2660, 3090, 3565, 4345, 5043, 5743, 6583, 7075, 7483, 8027, 9018, 9499, 10854, 11970, 13185, 14349, 15755, 16874, 17941, 18887, 20106, 21231, 21495, 22906, 24652, 25202, 26469, 27469, 28757, 29791]","[489, 613, 703, 924, 1305, 2198, 2619, 2709, 3173, 3434, 3923, 4310, 4881, 5474, 6212, 6781, 7266, 8031, 8537, 8832, 9867, 10538, 11380, 12257, 13188, 13708, 14768, 15416, 15711, 17078, 17779, 19817, 20949, 21810, 22304]","[505, 943, 1566, 1811, 2217, 2679, 3257, 3347, 3764, 4046, 4721, 5383, 5940, 6245, 7076, 7932, 8539, 9725, 10451, 11322, 12104, 12738, 13553, 14152, 14246, 14736, 15128, 16081, 16892, 17657, 18343, 19753, 20388, 21151, 21745]","[285, 524, 633, 882, 1256, 1902, 2170, 2312, 2638, 2969, 3144, 3656, 3932, 4145, 4512, 4931, 5139, 5580, 5852, 6334, 6861, 7246, 7501, 8087, 8592, 9177, 9569, 9897, 10137, 10527, 10752, 11596, 12113, 12462, 12762]","[260, 350, 607, 697, 952, 1253, 1445, 1535, 1900, 1990, 2433, 2618, 2713, 2834, 3106, 3312, 3549, 4072, 4167, 4372, 4727, 4922, 5017, 5184, 5364, 5714, 6106, 6415, 6710, 7100, 7371, 8754, 9101, 9585, 9819]",29791,22304,21745,12762,9819,113,14,112,123,136,"[946, 1400, 1737, 1947, 2461, 3101, 3315, 4182, 5125, 5640, 6297, 6991, 7269, 8161, 8874, 9399, 9896, 10760, 11735, 12341, 13158, 13568, 14473, 15421, 16359, 16968, 17738, 19492, 19957, 20937, 21655, 22695, 22992, 23987, 24823]","[946, 1420, 1692, 2305, 2792, 3244, 3555, 4387, 5058, 5569, 5988, 7212, 7678, 8417, 8943, 9700, 10344, 11012, 11774, 12386, 12979, 13365, 14071, 14756, 15493, 16024, 16195, 16689, 17135, 17804, 18523, 19148, 19667, 20214, 21061]","[483, 653, 1007, 1431, 1538, 2003, 2441, 2788, 3159, 3547, 3776, 4264, 4545, 5346, 5780, 6306, 6580, 6824, 7257, 8115, 8480, 9096, 9847, 10209, 10556, 10912, 11719, 12495, 12877, 13268, 13368, 13468, 13974, 14408, 14615]","[519, 697, 916, 1163, 1298, 1456, 1587, 2159, 2415, 2559, 2777, 3402, 3721, 4047, 4274, 4478, 4616, 4828, 5049, 5409, 5691, 5858, 6024, 6518, 6962, 7430, 7526, 7622, 7844, 7989, 8089, 8189, 8588, 8732, 8832]","[415, 553, 911, 1001, 1091, 1249, 1367, 1657, 2094, 2238, 2592, 2831, 3304, 3533, 3760, 3961, 4058, 4392, 4666, 5202, 5431, 6045, 6246, 6503, 6947, 7256, 7451, 7759, 8181, 8329, 8429, 8529, 8880, 9018, 9118]",24823,21061,14615,8832,9118,4968,1243,7130,3930,701,17972,35,radiant
7563295705,73,49,106,123,121,"[0, 354, 960, 1395, 1672, 1967, 2290, 2502, 2795, 3182, 3702, 4449, 5158, 5793, 6991, 8217, 9146, 9979, 10291, 11260, 12283, 13139, 14303, 15612, 16417, 17397, 18346, 18835, 19543, 20385, 21545, 22665, 23831, 24390, 25263]","[0, 199, 631, 911, 1146, 1505, 2028, 2253, 2964, 3424, 4191, 4837, 5196, 5694, 6585, 7220, 8109, 9019, 9793, 9991, 10948, 11981, 12913, 13808, 14485, 15135, 16112, 16739, 17199, 17548, 19473, 21200, 22359, 22735, 24153]","[0, 175, 457, 749, 996, 1208, 1435, 1690, 1993, 2287, 2790, 3323, 3462, 3973, 4744, 5194, 5860, 6238, 6818, 7291, 7972, 8742, 9938, 10685, 11162, 11646, 11931, 12891, 13070, 13732, 14356, 16398, 17290, 17726, 18811]","[0, 129, 553, 744, 834, 924, 1187, 1312, 1576, 1762, 1942, 2345, 2530, 2658, 3199, 3627, 4131, 4602, 4842, 5147, 5357, 5805, 6806, 7241, 7792, 8234, 8771, 9050, 9221, 9573, 10147, 10957, 11698, 11798, 12621]","[0, 247, 481, 633, 801, 1013, 1103, 1193, 1455, 1860, 2040, 2295, 2545, 2774, 3170, 3438, 3728, 4038, 4342, 4866, 4961, 5287, 5921, 6186, 6391, 6558, 6787, 7076, 7172, 7268, 7789, 8259, 8951, 9051, 9998]",25263,24153,18811,12621,9998,98,33,25,100,51,"[0, 336, 781, 1155, 1687, 2303, 2850, 3523, 4197, 4379, 4854, 5314, 5729, 6555, 6931, 7659, 8119, 8426, 9426, 10664, 11229, 11677, 11772, 12520, 13130, 14142, 15192, 15878, 16503, 16876, 18314, 19318, 20063, 20604, 20927]","[0, 243, 493, 809, 1175, 1705, 2009, 2602, 3582, 4283, 4939, 5729, 6084, 6591, 7148, 7508, 8269, 8719, 9275, 10166, 10685, 11125, 11708, 12148, 12403, 12887, 13340, 13832, 14355, 14522, 15087, 15785, 16115, 16555, 16768]","[0, 295, 633, 797, 1170, 1358, 1483, 1950, 2379, 2659, 3079, 3490, 4180, 4660, 5213, 5869, 6774, 7281, 7945, 9030, 9628, 9872, 9977, 10206, 10486, 11191, 11762, 12441, 13132, 13806, 14395, 14778, 15251, 15617, 15727]","[0, 209, 334, 424, 554, 779, 958, 1164, 1471, 1719, 1899, 2133, 2304, 2584, 2754, 3118, 3629, 3804, 4020, 4568, 4895, 5065, 5327, 5631, 5801, 6161, 6486, 7016, 7761, 8247, 8935, 9393, 9876, 10386, 10486]","[0, 209, 299, 389, 519, 731, 821, 1405, 1680, 1804, 1984, 2248, 2389, 2659, 2819, 2999, 3157, 3418, 3810, 4167, 4262, 4383, 4478, 4735, 4830, 5304, 5526, 6061, 6348, 6444, 6886, 6986, 7086, 7414, 7514]",20927,16768,15727,10486,7514,4336,7385,3084,2135,2484,19424,35,radiant
7563784607,76,48,71,14,45,"[0, 242, 717, 1084, 1532, 1818, 2360, 2766, 3158, 3898, 4343, 5372, 5855, 6990, 7540, 7763, 8401, 9012, 9632, 10358, 10606, 12036, 12628, 13265, 13433, 14578, 15142, 16509, 17909, 19736, 20041, 20278, 21324, 21710, 22136]","[0, 293, 606, 968, 1129, 1690, 1780, 2023, 2534, 2962, 3321, 3872, 4312, 5113, 5750, 6443, 7549, 8587, 9224, 10275, 10732, 11258, 12427, 12787, 12882, 13948, 14816, 14911, 15256, 16836, 17141, 17689, 18739, 19464, 20193]","[0, 170, 290, 426, 600, 818, 908, 1065, 1305, 1469, 1643, 2173, 2347, 2786, 3102, 3572, 4283, 4663, 4917, 5123, 6061, 6906, 7478, 7866, 8379, 8636, 9315, 10224, 10874, 11280, 11966, 12066, 14196, 15531, 15631]","[0, 170, 401, 612, 1058, 1332, 1813, 1999, 2320, 2644, 2993, 3285, 3522, 4000, 4365, 4995, 5537, 6346, 6638, 7571, 8178, 8673, 9458, 9723, 9867, 10275, 10522, 11034, 11736, 12698, 13248, 13430, 13530, 13859, 14282]","[0, 170, 374, 464, 764, 1352, 1538, 1991, 2423, 2719, 3077, 4007, 4097, 4402, 4747, 5228, 5745, 6123, 6351, 6958, 7324, 7791, 8151, 8415, 8510, 8803, 9121, 9665, 10238, 10506, 10691, 10893, 11549, 11802, 11902]",22136,20193,15631,14282,11902,25,39,49,64,121,"[0, 256, 820, 1070, 1650, 2171, 2535, 3340, 3928, 4573, 5153, 5709, 6252, 7053, 7755, 8388, 8988, 10258, 10890, 11299, 12714, 13184, 13534, 15768, 16860, 17906, 18673, 19490, 20221, 21261, 23537, 24759, 26236, 26426, 27198]","[0, 280, 568, 884, 1093, 1409, 1736, 2176, 2469, 2785, 3140, 3320, 4202, 4628, 5062, 5410, 6020, 6970, 7414, 7776, 9253, 9471, 9850, 11036, 11791, 12249, 12684, 13943, 14424, 15830, 15926, 17267, 18432, 19200, 19763]","[0, 244, 566, 887, 1381, 1926, 2384, 2854, 3431, 3954, 4462, 4933, 5844, 6467, 7477, 7719, 7814, 7999, 8470, 8928, 9717, 10040, 10295, 10700, 10977, 11456, 11731, 12265, 12361, 13015, 13403, 13874, 14209, 14474, 14843]","[0, 170, 260, 350, 534, 713, 852, 1113, 1287, 1425, 1625, 1984, 2509, 2914, 3742, 4041, 4224, 4887, 5266, 5709, 6501, 6750, 7324, 8407, 9105, 9584, 10235, 10545, 10767, 11373, 11761, 12321, 12986, 13176, 13716]","[0, 170, 501, 591, 851, 1134, 1389, 1666, 1852, 1942, 2121, 2338, 2632, 2893, 3335, 3657, 3752, 3981, 4389, 4547, 5093, 5683, 5816, 6710, 7079, 8175, 8631, 9170, 9266, 10511, 10607, 11436, 12105, 12460, 13295]",27198,19763,14843,13716,13295,-5062,430,788,566,-1393,-4671,35,dire
7564044018,48,104,138,74,136,"[0, 282, 557, 843, 1390, 1768, 2273, 2723, 3487, 3763, 4266, 5069, 5745, 6452, 7386, 8370, 9360, 9942, 10753, 12427, 13602, 13931, 15091, 16282, 16885, 18084, 19192, 20052, 21998, 22204, 23125, 24168, 25512, 28053, 28268]","[0, 247, 524, 921, 1309, 1774, 2203, 2512, 3244, 3858, 4373, 5399, 6034, 6360, 7069, 8012, 8658, 8753, 8936, 10223, 10715, 10987, 11289, 12042, 12342, 13027, 13320, 13618, 14448, 15489, 16446, 17197, 17667, 18066, 18281]","[0, 209, 514, 621, 866, 1004, 1193, 1351, 1531, 1690, 2016, 2373, 2598, 3065, 3598, 4055, 4461, 4654, 4938, 5430, 5797, 6386, 6759, 6926, 7923, 8847, 9410, 9788, 10581, 11741, 13093, 14229, 15016, 15991, 16206]","[0, 322, 484, 863, 1113, 1455, 1703, 2203, 2652, 2868, 3101, 3681, 3983, 4558, 5086, 5382, 5862, 5957, 6140, 6665, 7083, 7544, 7959, 8400, 8694, 9120, 9214, 9649, 10274, 10899, 11578, 12225, 12791, 13896, 14186]","[0, 209, 299, 421, 624, 748, 991, 1081, 1434, 1593, 1849, 2049, 2229, 2506, 2810, 3180, 3453, 3548, 4127, 5059, 5264, 5511, 5760, 5927, 6146, 6540, 6894, 6989, 7292, 7796, 8164, 8650, 9120, 9330, 9545]",28268,18281,16206,14186,9545,106,69,93,26,40,"[0, 286, 646, 999, 1443, 1895, 2327, 2864, 3246, 3457, 4412, 4575, 5263, 5616, 5890, 6575, 7112, 8253, 8866, 9238, 9523, 10467, 11230, 11831, 12614, 13607, 14767, 15229, 16575, 16671, 17251, 18135, 19263, 20951, 21051]","[0, 202, 641, 913, 1386, 1633, 2012, 2364, 2828, 3352, 3969, 4249, 4922, 5354, 5684, 6106, 6826, 7647, 7956, 8115, 8837, 9471, 10358, 10523, 11764, 12231, 12584, 12801, 13464, 13823, 14655, 15399, 16000, 17094, 18276]","[0, 513, 710, 836, 1090, 1388, 1770, 2103, 2457, 2645, 3121, 3487, 3908, 4466, 5125, 5665, 6005, 6804, 7212, 7930, 8265, 8875, 9964, 10354, 10996, 11243, 11762, 12488, 13281, 13377, 13887, 14077, 14700, 15997, 17431]","[0, 129, 293, 656, 845, 935, 1340, 1475, 1676, 1813, 2734, 2824, 3013, 3198, 3475, 3705, 4044, 4452, 4604, 5167, 5440, 5607, 5863, 6055, 6639, 6734, 7235, 7330, 7917, 8013, 8109, 8299, 8671, 10124, 10820]","[0, 210, 300, 390, 480, 570, 670, 805, 1006, 1289, 1497, 1809, 1953, 2138, 2333, 2468, 2810, 3256, 3705, 4137, 4232, 4681, 4937, 5251, 5821, 6359, 6571, 6666, 7169, 7265, 7748, 7986, 8364, 8952, 9477]",21051,18276,17431,10820,9477,7217,5,-1225,3366,68,9431,35,radiant
7565176702,53,120,40,97,30,"[0, 580, 707, 1055, 1307, 1731, 1840, 2047, 2930, 3236, 4256, 4513, 5191, 5796, 6473, 7012, 8083, 9408, 10376, 10902, 11338, 12191, 12336, 12784, 13683, 14421, 15312, 15882, 17811, 18683, 19615, 20884, 22034, 22627, 23686]","[0, 346, 616, 867, 1125, 1493, 1687, 2625, 2879, 3231, 3700, 3790, 4192, 4716, 5235, 5612, 5897, 6664, 7600, 8236, 8689, 9127, 9743, 10064, 10876, 11396, 11776, 11871, 12861, 13476, 13875, 14984, 15687, 16031, 16944]","[0, 192, 492, 661, 924, 1435, 1666, 1801, 2228, 2415, 2706, 2796, 3126, 3429, 3907, 4390, 5219, 5973, 6650, 7262, 7772, 7962, 8494, 8723, 9307, 9782, 10805, 10900, 11635, 12392, 12794, 13229, 13564, 13908, 14628]","[0, 192, 331, 459, 753, 1097, 1561, 1977, 2155, 2436, 2862, 3036, 3409, 3794, 4181, 4441, 4713, 5179, 5715, 6410, 6658, 7134, 7414, 7509, 8359, 8630, 9074, 9758, 10668, 11626, 12324, 13155, 13641, 14615, 15085]","[0, 292, 434, 568, 816, 1353, 1566, 1701, 1963, 2232, 2585, 2675, 2765, 2914, 3387, 4116, 4345, 4672, 5220, 5619, 5714, 5893, 5987, 6082, 6965, 7204, 7465, 7765, 8814, 9126, 9576, 10147, 10447, 10547, 11205]",23686,16944,14628,15085,11205,98,41,69,123,79,"[0, 368, 680, 1004, 1364, 1785, 2200, 2445, 3261, 3490, 4335, 5365, 5597, 6525, 7095, 7881, 8911, 9006, 9530, 10427, 10997, 11442, 12769, 12936, 13218, 13976, 14810, 15589, 16051, 16228, 16724, 17843, 18802, 19175, 20018]","[0, 247, 495, 700, 996, 1533, 1817, 2322, 2630, 3292, 3747, 4510, 4872, 5169, 5581, 6527, 6983, 7234, 7610, 8233, 9085, 9853, 10266, 10433, 10633, 11113, 11878, 12906, 13803, 14462, 15497, 16228, 16698, 17293, 17669]","[0, 210, 492, 686, 971, 1147, 1556, 2019, 2163, 2786, 3212, 3606, 3877, 4348, 4607, 5437, 6052, 6620, 7950, 8404, 8813, 9306, 10452, 10720, 10975, 11615, 12310, 12704, 12848, 13200, 13430, 14072, 14509, 15030, 15458]","[0, 210, 300, 425, 563, 728, 938, 1131, 1221, 1472, 1699, 2201, 2345, 2549, 2730, 3268, 3499, 3895, 4214, 4621, 4956, 5384, 6359, 6948, 7425, 7804, 8229, 8650, 8766, 8943, 9459, 9616, 9987, 10150, 10417]","[0, 210, 300, 390, 480, 659, 749, 839, 1145, 1539, 1674, 2017, 2213, 2483, 2835, 3457, 3650, 3745, 4310, 4551, 4653, 4913, 5570, 6030, 6200, 6370, 6539, 6848, 7066, 7356, 7527, 7702, 7967, 8186, 8405]",20018,17669,15458,10417,8405,3668,-725,-830,4668,2800,9581,35,radiant
7565351207,25,13,135,136,20,"[0, 253, 399, 771, 1373, 1751, 2535, 2888, 3215, 4063, 4731, 5127, 5770, 6474, 7245, 8197, 9089, 9976, 10593, 11829, 12691, 13197, 14251, 15315, 15410, 16061, 17135, 17846, 18213, 18773, 19282, 19841, 20360, 20460, 20904]","[0, 328, 698, 940, 1217, 1554, 1875, 2564, 3034, 3758, 4227, 4335, 5025, 5872, 6351, 7075, 7753, 8460, 9051, 10245, 10927, 11440, 12720, 13363, 14142, 14858, 15581, 15676, 16590, 17524, 18304, 19389, 19897, 19997, 20879]","[0, 290, 595, 851, 1293, 1655, 1890, 2265, 2700, 2945, 3496, 4068, 4365, 5180, 5904, 6543, 6986, 7828, 8259, 9118, 9668, 10346, 10837, 11607, 11702, 12485, 13450, 13852, 14188, 15090, 15608, 16176, 17193, 17293, 17549]","[0, 170, 260, 752, 996, 1248, 1482, 1798, 1888, 2085, 2464, 2593, 3060, 3379, 3801, 4020, 4150, 4356, 4602, 4993, 5244, 5383, 5704, 5954, 6069, 6383, 6707, 6877, 7048, 7219, 7629, 8017, 8192, 8367, 8576]","[0, 170, 260, 350, 525, 660, 777, 956, 1117, 1314, 1493, 1583, 1912, 2245, 2600, 2784, 2915, 3088, 3273, 3727, 3976, 4251, 4545, 4749, 4892, 5495, 5822, 5992, 6163, 6571, 6891, 7066, 7367, 7938, 8221]",20904,20879,17549,8576,8221,41,129,120,58,105,"[0, 207, 499, 709, 913, 1442, 1953, 2490, 2839, 3286, 3892, 4183, 5067, 5638, 6302, 6901, 7756, 8385, 9181, 9949, 10706, 11522, 12139, 12823, 14371, 15216, 15919, 17262, 17819, 19536, 19954, 21263, 22719, 23379, 24541]","[0, 206, 548, 906, 1355, 1611, 1775, 2598, 3276, 3596, 4128, 4795, 5436, 6189, 6801, 7384, 8047, 8464, 9145, 9769, 10280, 11149, 12017, 12870, 14026, 14961, 16051, 16970, 17548, 18202, 18539, 19839, 21231, 22251, 22930]","[0, 289, 589, 788, 1243, 1624, 2070, 2518, 2936, 3159, 3735, 4340, 4675, 4871, 5226, 5997, 6869, 7290, 8010, 8230, 8723, 9217, 9621, 10028, 11070, 11568, 12199, 12796, 13441, 14875, 15552, 16379, 17765, 18691, 19590]","[0, 170, 260, 350, 440, 836, 971, 1515, 1760, 2004, 2350, 2558, 3010, 3223, 3437, 3705, 4200, 4378, 4760, 5048, 5209, 5397, 5715, 6172, 7089, 7610, 7900, 8130, 8639, 10708, 11560, 12693, 13268, 14217, 14769]","[0, 170, 260, 437, 576, 706, 841, 1278, 1458, 1675, 2294, 2664, 2844, 3170, 3390, 3505, 3981, 4202, 4710, 4930, 5025, 5361, 5699, 5865, 6583, 6750, 7383, 7605, 7892, 8520, 8751, 9121, 10112, 10647, 11073]",24541,22930,19590,14769,11073,-3637,-2051,-2041,-6193,-2852,-16774,35,dire
7565603215,113,63,14,72,26,"[0, 282, 621, 901, 1169, 1539, 1937, 2271, 2686, 3149, 3821, 4133, 4439, 4951, 5476, 6020, 6450, 7204, 7672, 8283, 8753, 9183, 9634, 10933, 11643, 12416, 13299, 13609, 14312, 14666, 16270, 17224, 18119, 18514, 19638]","[0, 245, 561, 970, 1274, 1590, 2017, 2242, 2441, 3141, 3634, 4229, 4669, 5456, 6026, 6711, 7244, 8225, 9300, 9853, 10510, 11617, 12198, 13278, 13923, 14954, 15708, 15802, 16012, 16591, 17660, 18318, 18975, 19909, 21669]","[0, 290, 604, 855, 1252, 1574, 1852, 1942, 2409, 2977, 3425, 3751, 4296, 4859, 5428, 5732, 6739, 6997, 7182, 7436, 7958, 8160, 8646, 8990, 9194, 9612, 10118, 10212, 10623, 10909, 11584, 12268, 12502, 12722, 14407]","[0, 261, 351, 489, 856, 1093, 1259, 1408, 1754, 2301, 2679, 2944, 3477, 3835, 3981, 4252, 4496, 4834, 5102, 5356, 5724, 5998, 6541, 6688, 6892, 7223, 7747, 7841, 8150, 8493, 9919, 10367, 10529, 10817, 11690]","[0, 209, 640, 730, 865, 1073, 1258, 1348, 1874, 2132, 2488, 2624, 2804, 3007, 3187, 3372, 3715, 4037, 4284, 4538, 4809, 5044, 5139, 5278, 5372, 5556, 5804, 5898, 6312, 6485, 6859, 7048, 7172, 7472, 8324]",19638,21669,14407,11690,8324,21,98,49,105,58,"[0, 237, 484, 890, 1220, 1800, 2285, 2791, 2881, 3595, 4095, 4508, 5201, 5924, 6590, 7101, 7821, 8501, 9193, 10459, 11017, 11112, 11773, 12459, 13058, 13646, 14682, 15970, 17024, 17848, 18260, 18668, 19068, 19942, 20762]","[0, 287, 499, 907, 1285, 1704, 2435, 3219, 3637, 4355, 4445, 4719, 5613, 6152, 6568, 7219, 7901, 8381, 8959, 9483, 10139, 10437, 11304, 12323, 12821, 13575, 14493, 15341, 16114, 16586, 17123, 18385, 19153, 19539, 20231]","[0, 248, 558, 769, 1346, 1707, 2240, 2426, 2913, 3369, 3774, 4053, 4657, 5233, 5737, 6088, 6937, 7314, 7677, 8518, 8708, 8928, 9095, 9638, 10461, 10878, 11255, 12306, 13351, 13753, 14302, 15037, 15137, 15905, 16849]","[0, 129, 219, 309, 796, 930, 1143, 1494, 1584, 1793, 1883, 2009, 2224, 2632, 2727, 2904, 3283, 3697, 3840, 4392, 4702, 4797, 5300, 5717, 5899, 6156, 6533, 7670, 7848, 8205, 8388, 8851, 8951, 9051, 9305]","[0, 181, 306, 396, 535, 992, 1263, 1614, 1704, 2011, 2141, 2575, 2720, 2972, 3229, 3488, 3891, 4043, 4409, 4782, 5055, 5150, 5589, 5926, 6239, 6736, 6959, 7399, 7767, 8070, 8253, 8493, 8593, 8764, 9105]",20762,20231,16849,9305,9105,-1124,1438,-2442,2385,-781,-524,35,radiant
7565753404,49,32,137,121,26,"[1007, 1282, 1696, 1988, 2583, 2882, 3105, 3281, 3796, 4131, 4621, 5421, 6068, 6605, 7236, 8085, 9330, 10229, 11365, 12266, 13168, 13693, 14266, 14739, 15825, 16590, 17425, 18673, 20139, 20638, 21472, 23064, 24117, 25334, 25768]","[664, 1077, 1400, 1768, 2179, 2701, 2834, 3445, 3875, 4572, 4830, 5161, 5513, 5984, 6810, 7270, 7901, 8600, 9239, 9793, 10032, 10223, 10947, 11359, 11837, 12007, 12479, 13027, 13337, 13695, 13795, 14511, 15111, 15382, 16080]","[788, 1002, 1332, 1733, 2288, 3095, 3703, 4239, 4410, 5103, 5859, 6279, 6434, 6687, 7209, 7535, 7954, 8369, 9106, 9508, 9843, 10352, 10591, 11055, 11938, 12408, 12651, 13086, 13714, 14264, 14364, 15999, 16468, 16568, 17150]","[418, 508, 681, 868, 1073, 1396, 1535, 1777, 1912, 2239, 2384, 2569, 2664, 2758, 3216, 3366, 3821, 4092, 4549, 4832, 5146, 5523, 5837, 6216, 6669, 7021, 7192, 7546, 7717, 8194, 8315, 8860, 9178, 9353, 9768]","[553, 715, 876, 1031, 1471, 1689, 1817, 1907, 2216, 2391, 2619, 3178, 3514, 3608, 3903, 4218, 4666, 5304, 5674, 6160, 6579, 7233, 7472, 7680, 7922, 8016, 8112, 8289, 8385, 8575, 8675, 9227, 9527, 9724, 9887]",25768,16080,17150,9768,9887,41,78,53,90,20,"[478, 816, 1523, 1767, 2111, 2334, 2693, 3183, 3737, 4160, 4539, 4863, 5377, 5824, 6148, 6716, 7352, 8122, 8663, 9175, 9790, 10788, 12519, 13730, 14208, 15029, 16460, 17301, 17621, 18368, 19361, 20170, 20971, 21733, 22340]","[372, 708, 798, 1207, 1414, 2048, 2508, 3063, 3699, 4175, 4718, 5249, 5688, 6168, 6702, 7004, 7541, 8081, 8299, 9129, 9709, 10500, 12344, 12793, 13023, 13523, 14309, 14678, 15298, 15875, 16797, 17290, 17939, 18670, 19344]","[319, 493, 787, 1016, 1384, 1509, 1827, 2366, 2665, 2806, 2896, 3045, 3431, 3742, 3960, 4390, 4659, 4993, 5473, 5806, 5976, 6633, 7629, 7871, 8410, 8579, 9395, 10068, 10301, 11218, 12437, 12892, 13810, 14042, 14480]","[535, 814, 1052, 1531, 1832, 2344, 2599, 3371, 4301, 4541, 4786, 5225, 5572, 6027, 6449, 6967, 7596, 7951, 8357, 8452, 8924, 9521, 9875, 10357, 10587, 10888, 11781, 12219, 12603, 13102, 13837, 13987, 14481, 14898, 15389]","[219, 309, 567, 707, 879, 1086, 1324, 1685, 2038, 2334, 2488, 2676, 2874, 2968, 3126, 3332, 4048, 4222, 4317, 4412, 4739, 4936, 5629, 5913, 6143, 6237, 6874, 7079, 7175, 7440, 7775, 7875, 8134, 8477, 8577]",22340,19344,14480,15389,8577,3428,-3264,2670,-5621,1310,-1477,35,radiant
7565999305,98,95,43,90,20,"[0, 382, 669, 1045, 1570, 2056, 2519, 3122, 3737, 4427, 5301, 6138, 6478, 7068, 7594, 8820, 9366, 10279, 10991, 11409, 12042, 12822, 13347, 14259, 14902, 15366, 16145, 17633, 18458, 19060, 19794, 21226, 21722, 22487, 24001]","[0, 219, 504, 772, 1262, 1711, 2086, 2560, 2999, 3524, 4093, 4563, 4943, 5436, 6116, 6611, 7465, 8065, 8534, 9429, 10107, 10856, 12064, 12772, 14010, 14670, 15370, 16354, 17268, 18096, 19276, 20411, 21154, 21762, 23777]","[0, 216, 526, 880, 1174, 1624, 1880, 2372, 2798, 3352, 3803, 4179, 4604, 4934, 5393, 6035, 7008, 7784, 8395, 8952, 9239, 10046, 10441, 10914, 11387, 11865, 12133, 13145, 14141, 14664, 15082, 16353, 17038, 17879, 19330]","[0, 180, 270, 713, 839, 929, 1019, 1233, 1485, 1712, 1919, 2157, 2479, 2644, 2815, 3234, 3603, 3978, 4234, 4459, 4689, 5137, 5548, 5791, 6185, 6413, 6691, 6953, 7421, 8015, 8630, 9504, 9829, 10136, 12167]","[0, 281, 371, 480, 664, 799, 889, 1489, 1903, 2083, 2346, 2577, 2667, 2832, 2980, 3111, 3464, 3699, 3794, 3933, 4163, 4485, 4814, 5055, 5253, 5347, 5523, 5967, 6335, 6629, 6948, 7531, 7922, 8137, 9416]",24001,23777,19330,12167,9416,36,106,129,88,110,"[0, 353, 558, 873, 1206, 1584, 2026, 2378, 2721, 2984, 3482, 3876, 4479, 5057, 5558, 6207, 6626, 7388, 8225, 9039, 9904, 10617, 11375, 11957, 12649, 13487, 14143, 14238, 14443, 15375, 15599, 16589, 17586, 17994, 18424]","[0, 388, 717, 1001, 1315, 1525, 1812, 2098, 2469, 2818, 3301, 3588, 3857, 4375, 4834, 5457, 5805, 6117, 6401, 6911, 7470, 8063, 8473, 9196, 9972, 10844, 11528, 11623, 12278, 13021, 13339, 13539, 14174, 15129, 15428]","[0, 269, 474, 646, 944, 1153, 1632, 2099, 2353, 2767, 3120, 3522, 4045, 4431, 4862, 5348, 5518, 6028, 6470, 7073, 7699, 7901, 8413, 8508, 9165, 9895, 10525, 10620, 11183, 11680, 12063, 12263, 13101, 13656, 13945]","[0, 235, 360, 487, 577, 711, 846, 1192, 1355, 1494, 1629, 2026, 2116, 2265, 2558, 3069, 3329, 3717, 4082, 4475, 4653, 4970, 5112, 5478, 5855, 6397, 6639, 6772, 7394, 7490, 7927, 8172, 8581, 9327, 9427]","[0, 235, 361, 451, 541, 631, 783, 873, 1008, 1119, 1326, 1622, 1712, 1997, 2091, 2346, 2695, 3248, 3421, 3788, 3979, 4413, 4508, 4828, 5337, 5736, 6049, 6144, 6294, 6390, 6614, 6814, 7077, 7424, 7946]",18424,15428,13945,9427,7946,5577,8349,5385,2740,1470,23521,35,radiant
7566090506,41,98,97,128,105,"[76, 321, 609, 857, 1142, 1426, 1862, 2493, 2909, 3440, 4218, 4474, 4757, 5427, 5942, 6382, 7037, 7808, 8876, 9463, 10582, 10800, 11407, 11905, 12699, 12794, 13442, 13715, 14627, 15180, 16909, 18035, 18589, 19835, 20482]","[76, 281, 643, 967, 1287, 1774, 2074, 2584, 2979, 3679, 4216, 4375, 4967, 5294, 5806, 6178, 6725, 7638, 8367, 8501, 9173, 9268, 9680, 10058, 10620, 10786, 11360, 11455, 12031, 12554, 14882, 15404, 16011, 16608, 16908]","[76, 359, 740, 938, 1288, 1694, 2124, 2341, 2934, 3510, 3764, 4233, 4742, 5202, 5556, 5651, 6263, 7354, 7854, 8216, 8676, 8771, 9336, 9925, 10518, 10803, 11357, 11967, 12845, 13150, 14827, 15672, 16708, 17713, 18114]","[209, 636, 778, 1019, 1195, 1386, 1565, 1700, 1790, 2118, 2647, 2737, 2873, 2967, 3062, 3206, 3486, 4524, 5090, 5438, 5724, 5819, 6000, 6168, 6262, 6357, 6492, 6765, 7345, 7571, 8750, 9067, 9280, 9885, 10219]","[76, 246, 469, 589, 807, 1034, 1169, 1304, 1605, 1931, 2111, 2201, 2291, 2400, 2534, 2915, 3072, 3596, 4008, 4359, 4671, 4841, 5528, 5736, 5976, 6271, 6475, 6831, 7082, 7253, 8605, 8794, 8894, 9501, 9704]",20482,16908,18114,10219,9704,21,137,135,53,19,"[250, 469, 944, 1352, 1796, 2230, 2697, 3140, 3766, 4427, 5016, 5500, 6318, 6956, 7663, 8209, 8702, 9494, 10178, 10679, 11395, 12270, 13320, 14024, 14657, 15582, 16720, 17653, 18286, 18624, 19165, 20068, 21144, 21625, 22178]","[117, 375, 608, 909, 1463, 1747, 2241, 3031, 3541, 3744, 4164, 4417, 4949, 5440, 5882, 6392, 7365, 7834, 8802, 9544, 10408, 11142, 11889, 12459, 12858, 13628, 14611, 15360, 15911, 16257, 16544, 16733, 17598, 18219, 18799]","[117, 287, 599, 860, 1233, 1361, 1801, 2205, 2572, 2831, 3227, 3771, 4784, 5074, 5532, 5969, 6474, 6610, 6940, 7710, 8497, 9100, 9526, 10184, 10836, 11509, 12334, 13198, 13893, 14496, 14874, 15244, 15947, 16250, 16532]","[117, 287, 377, 467, 597, 914, 1004, 1463, 2037, 2332, 2572, 2882, 3448, 3813, 4250, 4753, 5050, 5313, 5658, 6053, 6429, 7373, 7771, 8452, 9310, 9707, 10434, 10887, 11610, 12331, 13067, 13256, 13911, 14465, 14948]","[385, 555, 765, 855, 985, 1272, 1619, 1906, 2244, 2334, 2667, 2794, 3634, 3935, 4262, 4685, 5260, 5360, 5620, 5913, 6147, 6654, 7007, 7217, 7534, 7914, 8633, 9085, 9262, 9920, 10398, 11114, 11716, 11816, 12041]",22178,18799,16532,14948,12041,-1696,-1891,1582,-4729,-2337,-9071,35,radiant
7566202716,70,21,49,123,75,"[0, 321, 516, 991, 1317, 1589, 2624, 2997, 3087, 3676, 4182, 4836, 5323, 6309, 7003, 7583, 8399, 9805, 9902, 10405, 10889, 11958, 12690, 13258, 14447, 15196, 15834, 16458, 17055, 17256, 17583, 18046, 19336, 20975, 21938]","[0, 301, 574, 888, 1283, 1389, 1707, 2032, 2417, 2872, 3164, 3732, 4405, 4959, 5534, 6004, 6622, 7409, 7506, 8057, 8616, 9335, 9773, 10490, 10740, 11558, 12509, 12984, 13761, 14754, 15040, 15857, 17031, 17545, 18222]","[0, 246, 580, 776, 1027, 1446, 1715, 2044, 2447, 2823, 3336, 3696, 4368, 4754, 5269, 5829, 6590, 7211, 7459, 7992, 8626, 8897, 9709, 10268, 11137, 12054, 12591, 12965, 13457, 14329, 15352, 15968, 16831, 18166, 19233]","[0, 210, 337, 427, 563, 671, 761, 896, 986, 1076, 1256, 1425, 1695, 1906, 2164, 2669, 3144, 3484, 3683, 4183, 4334, 4605, 4764, 5142, 5397, 5564, 5846, 6289, 6488, 6913, 7393, 7684, 8936, 9256, 9928]","[0, 210, 350, 488, 623, 729, 938, 1073, 1235, 1366, 1501, 1606, 1876, 2270, 2579, 2756, 3112, 3398, 3495, 3924, 4216, 4540, 4820, 5023, 5230, 5397, 5599, 5694, 5957, 6216, 6567, 6885, 7750, 8484, 9382]",21938,18222,19233,9928,9382,102,98,39,110,26,"[0, 253, 899, 1199, 1655, 2089, 2720, 3374, 3623, 4025, 4545, 5064, 5416, 6058, 6767, 7481, 8434, 8751, 8846, 9229, 10222, 10811, 11410, 11999, 12313, 13045, 14049, 14735, 15518, 16387, 17614, 18530, 19682, 19782, 20222]","[0, 201, 517, 757, 1061, 1294, 1556, 1941, 2350, 2607, 2778, 3126, 3788, 4504, 5433, 5991, 6467, 7257, 7685, 8487, 9055, 9282, 9887, 10374, 10824, 11444, 12417, 13712, 14429, 14854, 15641, 15831, 17002, 17102, 17306]","[0, 164, 373, 497, 747, 943, 1152, 1403, 1704, 1916, 2244, 2338, 2644, 3078, 3626, 3833, 4182, 4277, 4687, 5231, 5731, 6336, 7019, 7276, 7706, 7839, 8650, 8933, 9371, 9927, 10665, 11154, 12284, 12524, 13347]","[0, 130, 295, 385, 554, 932, 1188, 1368, 1749, 2070, 2252, 2393, 2565, 2879, 3186, 3281, 3689, 3784, 4032, 4631, 4788, 5086, 5328, 5598, 6106, 6325, 6697, 7023, 7384, 7994, 8381, 8762, 9209, 9384, 9559]","[0, 176, 313, 403, 493, 583, 940, 1120, 1437, 1601, 1736, 1886, 1976, 2268, 2546, 2641, 2888, 3013, 3449, 4129, 4395, 4659, 4826, 5107, 5730, 6074, 6345, 6671, 7071, 7539, 7851, 8195, 8443, 8670, 8770]",20222,17306,13347,9559,8770,1716,916,5886,369,612,9499,35,radiant
7566439806,102,21,106,100,121,"[206, 449, 811, 1095, 1474, 1825, 2148, 2870, 3297, 3684, 4368, 4633, 5137, 5747, 6484, 7067, 7551, 7963, 8531, 9309, 9910, 10389, 10799, 12234, 13238, 14327, 15054, 15538, 16515, 17525, 17916, 19004, 19609, 21647, 22155]","[73, 356, 602, 1003, 1390, 1979, 2221, 3200, 3435, 3820, 4139, 4465, 4870, 5400, 6513, 7317, 7899, 8236, 8688, 9225, 10144, 10739, 11187, 11703, 12608, 13617, 14390, 15037, 15301, 16176, 16914, 17731, 18076, 19278, 20366]","[73, 404, 685, 968, 1333, 1771, 1979, 2610, 3195, 3601, 4197, 4522, 5309, 5912, 6477, 7238, 7864, 8416, 9286, 9858, 10546, 11078, 11469, 12194, 12731, 13118, 13782, 14097, 14743, 15095, 15476, 17157, 17846, 19289, 20432]","[0, 170, 304, 677, 767, 1015, 1105, 1300, 1621, 1711, 2054, 2297, 3223, 3748, 4162, 4447, 4934, 5418, 5713, 6153, 6392, 6487, 6710, 7274, 7894, 8171, 8265, 8360, 8803, 9155, 9415, 10561, 10661, 10854, 11388]","[73, 243, 333, 653, 795, 1041, 1181, 1454, 1589, 1803, 2328, 2453, 2977, 3299, 4019, 4304, 4731, 4989, 5195, 5290, 5636, 5731, 6128, 6561, 6925, 7272, 7615, 7833, 7929, 8175, 8424, 8614, 9167, 9854, 10411]",22155,20366,20432,11388,10411,63,120,19,20,101,"[310, 567, 897, 1393, 1945, 2335, 3137, 3435, 3970, 4678, 5367, 5935, 6192, 7036, 7579, 7980, 8827, 10192, 10846, 11893, 12376, 12989, 14365, 15249, 15946, 16864, 17813, 19463, 20303, 21596, 22369, 23475, 24515, 25409, 25689]","[445, 703, 864, 1322, 1789, 2171, 2388, 2962, 3485, 4033, 4481, 4993, 5432, 5951, 6745, 7181, 7666, 8635, 9463, 9831, 10222, 11073, 11677, 11934, 12376, 12810, 13559, 14642, 15326, 16189, 17229, 18077, 18177, 18873, 20017]","[310, 591, 874, 1284, 1957, 2236, 2611, 2868, 3182, 3526, 3661, 4055, 4485, 4779, 5023, 5243, 6044, 6648, 6832, 7592, 7891, 8309, 8526, 9096, 9268, 9645, 9858, 10759, 11380, 11476, 11816, 12250, 13037, 13597, 14241]","[177, 347, 437, 620, 973, 1156, 1481, 1680, 1836, 2050, 2586, 2746, 2848, 2997, 3217, 3546, 3979, 4244, 4451, 4702, 4994, 5493, 5768, 6067, 6231, 6326, 6578, 6754, 7021, 7427, 7683, 7888, 8113, 8339, 8711]","[116, 286, 376, 526, 737, 891, 1026, 1213, 1503, 1869, 2184, 2274, 2485, 2634, 2939, 3084, 3517, 3705, 3889, 4110, 4205, 4385, 4847, 5156, 5251, 5346, 5796, 6648, 7139, 7235, 7513, 7718, 7863, 8318, 8598]",25689,20017,14241,8711,8598,-3534,349,6191,2677,1813,7496,35,radiant
7566572217,28,93,106,53,26,"[0, 129, 329, 567, 847, 1379, 1779, 2263, 2912, 3610, 4433, 4973, 5367, 6028, 6634, 7379, 7859, 8791, 9433, 10650, 11008, 12136, 13368, 13792, 14383, 16212, 16534, 16629, 17429, 18175, 19370, 19886, 20677, 20777, 20967]","[58, 315, 644, 1041, 1425, 1793, 2030, 2550, 2685, 3039, 3664, 4006, 4716, 5363, 5845, 7092, 7692, 8466, 8806, 9857, 10405, 11644, 12455, 13067, 13407, 14330, 14505, 14600, 15670, 16258, 17082, 17638, 18545, 19230, 19646]","[58, 314, 635, 976, 1356, 1805, 1966, 2332, 2796, 3183, 3763, 4244, 4540, 4899, 5189, 5502, 6194, 7024, 7272, 8159, 8495, 9314, 9943, 10442, 10754, 11789, 12096, 12754, 13602, 13911, 14117, 14584, 15331, 16086, 16713]","[326, 520, 610, 971, 1061, 1516, 1719, 1856, 2035, 2297, 2707, 2926, 3252, 3450, 4064, 4451, 4929, 5360, 5626, 6203, 6379, 7398, 8250, 8647, 9309, 9820, 10504, 10889, 11645, 11993, 12726, 13738, 14708, 15312, 15701]","[58, 385, 546, 751, 888, 1157, 1538, 1707, 1891, 2209, 2525, 2615, 2705, 2800, 3291, 3856, 4077, 4172, 4401, 4764, 4859, 5335, 6122, 6934, 7123, 7290, 7465, 7560, 8131, 8439, 8645, 8916, 9718, 9981, 10256]",20967,19646,16713,15701,10256,41,38,120,101,102,"[0, 293, 625, 858, 1102, 1605, 1935, 2354, 2631, 3138, 3491, 3974, 4629, 5202, 5799, 6286, 7004, 7825, 8698, 9324, 9419, 10103, 10197, 10725, 11975, 12294, 12982, 14587, 14691, 15168, 15689, 16612, 17237, 17895, 18556]","[0, 243, 391, 556, 901, 1264, 1650, 2384, 2836, 3530, 3944, 4526, 4879, 5776, 6276, 6825, 7393, 7812, 7984, 8652, 9435, 9798, 10056, 10717, 11849, 12764, 13085, 14133, 14830, 15360, 15494, 15911, 16212, 17365, 17889]","[0, 247, 689, 1050, 1431, 1677, 2094, 2399, 2783, 3235, 3833, 4490, 5169, 5681, 5892, 6314, 6678, 7025, 8014, 9023, 9689, 9905, 10510, 10782, 11474, 11793, 12247, 13218, 13441, 13744, 14297, 14566, 15428, 15528, 16215]","[0, 209, 302, 392, 482, 652, 1328, 2009, 2424, 2706, 2978, 3143, 3590, 4251, 4393, 4757, 4942, 5286, 5461, 5847, 6017, 6187, 6570, 6789, 7369, 7737, 8527, 9240, 9411, 9717, 9983, 10193, 10569, 11124, 11873]","[0, 209, 299, 428, 518, 741, 831, 1046, 1181, 1460, 1640, 1779, 1915, 2371, 2635, 3001, 3186, 3530, 3624, 3931, 4228, 4429, 4570, 4665, 5369, 5705, 6192, 6702, 6798, 7029, 7125, 7446, 7616, 8210, 8400]",18556,17889,16215,11873,8400,2411,1757,498,3828,1856,10350,35,radiant
7566637019,49,95,107,123,121,"[376, 738, 1053, 1261, 1714, 2316, 2815, 3482, 3886, 4635, 5577, 5867, 6674, 7170, 7645, 8368, 9200, 9986, 10588, 11007, 11660, 12955, 13586, 14135, 14890, 15743, 16675, 17208, 17863, 18691, 19344, 20141, 20619, 20953, 22173]","[240, 522, 719, 1019, 1459, 1654, 2386, 3053, 3304, 3661, 4056, 4660, 5159, 5584, 6201, 6974, 7949, 8730, 9006, 9930, 10345, 11486, 12163, 12943, 13815, 14256, 14872, 16211, 16857, 18276, 19216, 20769, 22535, 23018, 23238]","[506, 870, 1157, 1494, 1794, 2128, 2691, 3515, 4037, 4716, 5351, 5937, 6280, 7383, 7678, 7822, 8511, 9598, 9977, 11330, 11583, 12959, 13261, 13624, 14117, 15243, 15779, 16528, 16749, 17814, 17910, 18410, 18937, 19258, 20143]","[373, 583, 673, 763, 940, 1351, 1896, 2378, 2468, 2648, 3113, 3366, 3608, 4112, 4297, 4392, 4612, 5181, 5453, 5967, 6062, 6157, 6459, 6824, 7183, 7806, 8274, 8866, 9467, 9843, 10133, 10873, 11397, 11544, 11876]","[108, 318, 408, 498, 707, 797, 1127, 1418, 1553, 1786, 2057, 2362, 2982, 3474, 3661, 3775, 4169, 4836, 4931, 5645, 5740, 6336, 6638, 6914, 7209, 7768, 7992, 8251, 8730, 9339, 9435, 10075, 10709, 10928, 11260]",22173,23238,20143,11876,11260,82,126,69,64,45,"[154, 309, 630, 1149, 1396, 1603, 1812, 2030, 2478, 2856, 3207, 3764, 4356, 4672, 5160, 5897, 6570, 6776, 7574, 8252, 9094, 9732, 10324, 11198, 12182, 12990, 13735, 14135, 14438, 15669, 16833, 18722, 18822, 19322, 20986]","[287, 564, 818, 1217, 1504, 1956, 2526, 3122, 3794, 4089, 4857, 5020, 5460, 5997, 6181, 6672, 7193, 7343, 7682, 8174, 9097, 9768, 9863, 10331, 10729, 11350, 11571, 11988, 12084, 13171, 13719, 14697, 15098, 16104, 17203]","[154, 378, 499, 900, 1128, 1577, 1856, 2173, 2425, 2750, 3446, 3907, 4287, 4873, 5326, 5969, 6473, 7434, 7773, 8332, 8427, 8968, 9089, 9652, 10622, 11398, 12091, 12601, 12857, 13279, 13482, 14308, 14640, 14839, 16619]","[154, 309, 486, 606, 993, 1183, 1396, 1639, 1833, 2166, 2991, 3156, 3246, 3494, 3589, 4256, 4511, 4651, 4840, 5731, 6011, 6945, 7247, 7979, 8517, 8924, 9198, 9292, 9508, 10097, 10349, 11000, 11272, 11793, 12237]","[287, 691, 781, 992, 1160, 1285, 1421, 1601, 1795, 1979, 2413, 2503, 2593, 2878, 3127, 3823, 3917, 4057, 4152, 4357, 4452, 4737, 4832, 5169, 5646, 5847, 5942, 6223, 6746, 8201, 8433, 9045, 9379, 10019, 11392]",20986,17203,16619,12237,11392,1187,6035,3524,-361,-132,10253,35,radiant
7566638207,97,107,136,72,100,"[0, 323, 574, 1002, 1402, 1737, 2817, 3119, 3846, 4493, 5159, 5620, 6265, 7050, 7351, 8186, 8931, 9252, 10089, 11022, 11371, 11868, 13070, 13670, 13991, 14085, 15033, 15642, 16124, 16370, 17097, 17725, 18233, 19140, 20672]","[0, 279, 498, 859, 1179, 1383, 1761, 2022, 2452, 2914, 3361, 3780, 4252, 4985, 5796, 5982, 6871, 7480, 8264, 9050, 9277, 10147, 10751, 11347, 11962, 12334, 12900, 13389, 14024, 15029, 15684, 15874, 16558, 17713, 18603]","[0, 204, 439, 1015, 1348, 1879, 2389, 2992, 3930, 4209, 5367, 6136, 6989, 7365, 8131, 8408, 8792, 9707, 10423, 10779, 11441, 11960, 12558, 13287, 13961, 14228, 15481, 15658, 16339, 16683, 17355, 18027, 18895, 20459, 20649]","[100, 270, 663, 922, 1056, 1233, 1399, 1579, 1879, 1991, 2544, 2871, 3139, 3345, 3630, 4114, 4567, 4881, 5062, 5610, 5828, 6503, 6861, 7171, 7266, 7526, 7621, 8322, 8844, 9224, 9463, 9726, 10529, 10832, 11682]","[100, 270, 411, 576, 716, 862, 1040, 1258, 1616, 1706, 2378, 2623, 2992, 3332, 3796, 3982, 4603, 4777, 4913, 5251, 5407, 5885, 6211, 6576, 6969, 7144, 7539, 7749, 8175, 8597, 9382, 9597, 10104, 10606, 11622]",20672,18603,20649,11682,11622,49,21,78,53,86,"[0, 363, 699, 1094, 1466, 2010, 2644, 2898, 3344, 3639, 3950, 4129, 4710, 5251, 5650, 6277, 6832, 7901, 9056, 9747, 10674, 10971, 11548, 12417, 12598, 13386, 13565, 14101, 15203, 16086, 16569, 17915, 18334, 18748, 19103]","[0, 287, 562, 682, 1186, 1386, 1646, 2256, 2609, 3079, 3630, 3850, 4554, 5204, 5736, 7154, 7592, 7941, 8450, 8930, 9576, 10460, 11106, 12202, 12596, 13186, 13748, 13917, 14414, 15564, 16067, 16949, 17844, 18465, 19449]","[0, 260, 500, 774, 1134, 1260, 1779, 2110, 2200, 2669, 3341, 4122, 4284, 5273, 5390, 5901, 6380, 6870, 7378, 7583, 8227, 8691, 9217, 9418, 9706, 9902, 10457, 10633, 11224, 11722, 12029, 12541, 13063, 13163, 13710]","[0, 170, 260, 415, 505, 595, 1063, 1425, 1515, 1706, 2078, 2222, 2723, 3358, 3569, 4035, 4391, 4675, 4985, 5319, 5905, 6192, 6562, 6788, 7087, 7707, 8121, 8251, 8653, 9163, 9259, 9630, 10422, 10522, 10684]","[0, 170, 605, 725, 861, 994, 1302, 1437, 1571, 1741, 2225, 2531, 2655, 3027, 3211, 3558, 3806, 3901, 4208, 4476, 4817, 4912, 5251, 5393, 5488, 5654, 5749, 5965, 6237, 6435, 6531, 6995, 7277, 7585, 8269]",19103,19449,13710,10684,8269,1569,-846,6939,998,3353,12013,35,dire
7566684319,95,39,29,53,64,"[0, 284, 737, 1156, 1402, 1682, 2401, 2881, 3131, 3506, 4123, 4594, 5008, 5612, 6227, 6675, 7256, 8022, 8789, 9372, 9921, 10473, 11752, 12500, 12950, 13713, 14372, 14843, 14939, 16981, 17077, 17718, 18237, 19701, 20245]","[0, 322, 573, 905, 1117, 1448, 1965, 2253, 2563, 3228, 4050, 4472, 4856, 5381, 5746, 6155, 7107, 7572, 8622, 9766, 10232, 11527, 12346, 12953, 13968, 14865, 15917, 16011, 16673, 17051, 17793, 18547, 19275, 19617, 19880]","[0, 245, 531, 732, 981, 1206, 1420, 1859, 2370, 2797, 2887, 3214, 3842, 4208, 4428, 4887, 5245, 5869, 6556, 6982, 7250, 8335, 8646, 9051, 9447, 9586, 9967, 10216, 10312, 10763, 11188, 11776, 12621, 12963, 13201]","[0, 170, 309, 399, 525, 699, 912, 1108, 1283, 1566, 1921, 2146, 2407, 2785, 3018, 3205, 3592, 4080, 4452, 5174, 5638, 6453, 6967, 7252, 7964, 8059, 8719, 8990, 9086, 9182, 9278, 9623, 10751, 11121, 11329]","[0, 170, 344, 434, 571, 661, 1062, 1258, 1348, 1575, 1665, 1890, 2096, 2459, 2644, 2739, 2916, 3406, 3591, 3913, 4008, 4516, 4827, 5361, 5456, 5600, 5810, 5904, 6127, 6223, 6656, 7012, 7745, 8387, 8487]",20245,19880,13201,11329,8487,82,13,137,58,86,"[0, 502, 735, 1283, 1561, 2081, 2766, 3150, 3870, 4420, 5343, 5810, 6625, 7172, 7831, 8783, 9527, 9983, 10547, 11513, 12040, 12972, 13934, 14934, 15952, 17237, 19089, 20258, 21088, 22798, 24776, 26462, 27596, 30040, 32200]","[0, 246, 607, 820, 1106, 1603, 2022, 2680, 3183, 3711, 4227, 4955, 5571, 6192, 6812, 7371, 8071, 8407, 9251, 9830, 10299, 10394, 11254, 11994, 13140, 13815, 14530, 15829, 17052, 17776, 18863, 19452, 19904, 21301, 22996]","[0, 207, 636, 904, 1200, 1592, 1880, 2259, 2660, 3138, 3454, 3955, 4566, 5102, 5720, 6272, 7125, 7490, 8040, 8292, 9038, 9210, 9446, 9650, 10297, 11289, 11661, 12524, 12838, 13288, 14075, 14638, 15007, 15781, 16970]","[0, 234, 324, 696, 786, 916, 1329, 1850, 2083, 2272, 2811, 3097, 3406, 3689, 4027, 4719, 4876, 5048, 5608, 5702, 6133, 6295, 6942, 7376, 7874, 8428, 8836, 9609, 10244, 10669, 11106, 11800, 12206, 13144, 14248]","[0, 170, 363, 453, 663, 1008, 1263, 1635, 1831, 2202, 2675, 2869, 3094, 3297, 3530, 3785, 4187, 4457, 4811, 5123, 5320, 5586, 5834, 6038, 6546, 6980, 7398, 7885, 8116, 8429, 8739, 9641, 9965, 10834, 12079]",32200,22996,16970,14248,12079,-11955,-3116,-3769,-2919,-3592,-25351,35,dire
7566717109,82,55,63,123,112,"[0, 376, 732, 1020, 1501, 1815, 2095, 2476, 3107, 3832, 4273, 4938, 5560, 6245, 7172, 7432, 7572, 8123, 8485, 8887, 9757, 10490, 11609, 12256, 13008, 13915, 14897, 15958, 16647, 16847, 17196, 18486, 18811, 19761, 20549]","[0, 331, 916, 1201, 1580, 2268, 2754, 3304, 3881, 4393, 4630, 5060, 6082, 6986, 7473, 8126, 8817, 9570, 10318, 10815, 11415, 12091, 12418, 12647, 13156, 14392, 14985, 15670, 16252, 16431, 16527, 18070, 19120, 19674, 20395]","[0, 205, 416, 592, 1029, 1373, 1698, 1990, 2412, 2688, 3147, 3471, 3877, 4464, 4975, 5443, 6091, 6480, 7173, 7921, 8713, 9390, 10284, 10379, 11449, 11823, 12158, 13063, 13446, 14097, 14736, 16138, 17019, 17706, 18884]","[0, 170, 335, 522, 652, 1107, 1209, 1299, 1461, 1839, 2146, 2505, 3031, 3508, 3761, 3946, 4169, 4550, 4900, 5388, 5732, 6035, 6373, 6805, 7054, 7578, 7693, 8197, 8405, 8752, 9001, 10324, 11228, 11484, 11809]","[0, 170, 260, 350, 590, 844, 934, 1060, 1240, 1449, 1905, 2038, 2321, 2618, 2888, 2982, 3171, 3432, 3743, 4051, 4904, 5188, 5525, 5989, 6243, 6576, 6670, 7394, 7834, 7930, 8074, 8565, 9242, 9567, 9757]",20549,20395,18884,11809,9757,1,13,102,20,101,"[0, 247, 461, 928, 1160, 1398, 1900, 2314, 2790, 3097, 3731, 4058, 4374, 4693, 5027, 5554, 6209, 6922, 7501, 8393, 9086, 9715, 10901, 11254, 12073, 12560, 13360, 14306, 15332, 16623, 17310, 17707, 18637, 20063, 21032]","[0, 255, 660, 1067, 1364, 1713, 2238, 2884, 3328, 3626, 3996, 4511, 5333, 5740, 6649, 7483, 8334, 8858, 9242, 9763, 10164, 10880, 11964, 12698, 13670, 14930, 15554, 16423, 17059, 18521, 19357, 20319, 20419, 21522, 22159]","[0, 287, 446, 716, 1033, 1287, 1411, 1856, 1980, 2366, 2659, 2834, 3301, 3650, 4088, 4459, 5200, 5646, 6219, 6713, 7274, 7545, 8647, 9074, 9554, 9760, 10242, 10604, 10951, 11578, 12503, 12905, 13040, 13268, 13959]","[0, 307, 397, 788, 976, 1066, 1263, 1803, 1932, 2115, 2403, 2585, 3110, 3297, 3743, 4145, 4971, 5231, 5427, 5732, 6258, 6739, 7213, 7465, 7803, 8119, 8340, 8606, 9286, 9765, 10285, 10682, 10971, 11161, 11379]","[0, 170, 260, 380, 517, 652, 849, 1150, 1240, 1330, 1465, 1848, 2265, 2656, 2891, 3174, 3522, 3617, 3774, 3869, 4160, 4409, 5114, 5318, 5606, 6118, 6367, 6627, 7149, 7920, 8172, 8644, 8977, 9213, 9367]",21032,22159,13959,11379,9367,-483,-1764,4925,430,390,3498,35,radiant
7566769601,48,13,21,14,68,"[0, 168, 297, 660, 1001, 1464, 1887, 2301, 2705, 3137, 3513, 3949, 4678, 5488, 6252, 7037, 7297, 7834, 8390, 9574, 10610, 11116, 12475, 12783, 13064, 14420, 15419, 16145, 17174, 17629, 19289, 20188, 20649, 20749, 21917]","[0, 202, 476, 687, 1109, 1310, 1843, 2379, 2766, 2986, 3584, 4008, 4338, 4472, 5132, 5850, 6107, 7152, 7350, 7878, 9094, 9802, 10073, 10327, 11162, 12193, 13102, 13196, 13542, 14310, 15838, 16747, 17397, 17497, 17687]","[0, 215, 751, 915, 1355, 1986, 2477, 2567, 2809, 3233, 3580, 3680, 4156, 4617, 4873, 5338, 5530, 6318, 6791, 7328, 8008, 8534, 8838, 8932, 9806, 10257, 10605, 10859, 11354, 11652, 11832, 12232, 12444, 12739, 13421]","[0, 168, 258, 664, 913, 1299, 1389, 1858, 2031, 2121, 2333, 2549, 2639, 2863, 3269, 3710, 4043, 4774, 5043, 5648, 5998, 6550, 6720, 6889, 7410, 7692, 7952, 8160, 9100, 9271, 9442, 9707, 9882, 10057, 11281]","[0, 129, 305, 400, 577, 798, 977, 1402, 1812, 1902, 2150, 2240, 2330, 2554, 2855, 3385, 3480, 3982, 4077, 4316, 4886, 5151, 5246, 5340, 5979, 6074, 6259, 6353, 6870, 6966, 7062, 7405, 7802, 7902, 8522]",21917,17687,13421,11281,8522,96,106,42,20,112,"[0, 209, 611, 1152, 1405, 1615, 2123, 2445, 2927, 3472, 3940, 4706, 5310, 6295, 6736, 6988, 7938, 8506, 9222, 10271, 10784, 11484, 12203, 12888, 13305, 13844, 14144, 15158, 15883, 16766, 17959, 18754, 19113, 19900, 20470]","[0, 209, 881, 1200, 1653, 1934, 2313, 2692, 3122, 4314, 4823, 5187, 5590, 6628, 7050, 7726, 8401, 8720, 9325, 10355, 11061, 11636, 11842, 12620, 13348, 13976, 14403, 15315, 16176, 17085, 18119, 18661, 19694, 22015, 22589]","[0, 256, 457, 619, 895, 1187, 1453, 1895, 2343, 2858, 3440, 4361, 4782, 5849, 6409, 6961, 7480, 8326, 9411, 10084, 10617, 11353, 12081, 12849, 13947, 14757, 15596, 16208, 17264, 18698, 19063, 19163, 19751, 20394, 21934]","[0, 209, 299, 694, 833, 1194, 1564, 1654, 1744, 2094, 2668, 3009, 3236, 3941, 4325, 4774, 5328, 5571, 5832, 6178, 6404, 6634, 7043, 7450, 7867, 8073, 8168, 8567, 8854, 9193, 9467, 9603, 9962, 10377, 10938]","[0, 209, 299, 389, 479, 605, 818, 908, 1368, 1718, 1988, 2551, 2970, 3601, 3868, 3962, 4384, 4568, 5026, 5549, 5754, 5984, 6188, 6784, 7201, 7700, 7795, 8198, 8574, 8913, 9761, 9861, 10445, 10849, 11374]",20470,22589,21934,10938,11374,1447,-4902,-8513,343,-2852,-14477,35,dire
7566771908,20,43,93,53,51,"[0, 304, 708, 945, 1388, 1780, 2146, 2848, 3850, 4272, 4810, 5493, 6188, 6752, 7195, 7510, 7993, 8087, 8821, 9433, 10033, 10783, 11506, 11783, 12314, 13692, 15021, 15724, 16697, 16831, 17084, 17951, 18417, 19008, 19650]","[0, 623, 912, 1212, 1545, 1988, 2545, 2841, 3370, 3793, 4137, 4507, 5147, 5600, 6429, 7118, 7937, 8331, 8683, 9501, 9739, 10174, 10907, 11506, 11874, 12410, 13252, 13932, 14691, 15147, 15559, 16605, 17212, 17703, 18870]","[0, 309, 507, 744, 950, 1193, 1301, 1476, 1741, 2116, 2382, 2707, 3311, 3759, 4078, 4762, 5487, 5768, 6478, 7145, 7670, 8190, 8678, 9243, 9647, 10467, 11190, 11926, 12707, 13334, 13684, 14310, 14893, 15911, 16479]","[0, 437, 527, 652, 1038, 1240, 1470, 1788, 2334, 2681, 2816, 3039, 3260, 3705, 3933, 4186, 4635, 4852, 5043, 5737, 5935, 6134, 6497, 7029, 7736, 8384, 9122, 9574, 10030, 10708, 11188, 11704, 12278, 12756, 13086]","[0, 304, 394, 519, 798, 963, 1343, 1564, 1953, 2214, 2447, 2665, 2951, 3172, 3400, 3549, 3862, 4218, 4323, 4616, 4877, 5072, 5267, 5800, 6069, 7406, 7899, 8203, 8747, 8918, 9089, 9681, 10194, 10471, 10930]",19650,18870,16479,13086,10930,49,10,60,123,136,"[0, 523, 807, 1081, 1411, 1660, 1868, 2204, 2329, 2690, 2986, 3884, 4416, 4921, 5745, 6269, 6860, 7938, 8509, 9347, 10170, 10881, 12218, 12851, 13128, 13586, 14822, 15390, 16677, 17497, 18072, 19114, 19464, 19754, 21569]","[0, 170, 460, 1043, 1221, 1720, 2124, 2360, 3027, 3360, 3994, 4535, 5129, 5626, 6296, 6977, 7417, 8922, 9455, 9933, 10650, 11607, 12620, 13379, 14164, 15426, 15870, 16515, 17495, 17949, 18292, 19254, 19745, 20610, 21246]","[0, 235, 514, 892, 1237, 1639, 2032, 2428, 2870, 3301, 3834, 4242, 4734, 5421, 5590, 6315, 6568, 7488, 8209, 9021, 9590, 10062, 10996, 11377, 11972, 13030, 13320, 14086, 14874, 15261, 15688, 15943, 16641, 17847, 18792]","[0, 279, 369, 489, 579, 782, 894, 1178, 1317, 1735, 2045, 2451, 2739, 2937, 3301, 3626, 4143, 4736, 4917, 5161, 5664, 5761, 6098, 6661, 7271, 8057, 8578, 8673, 9051, 9154, 9795, 10443, 10773, 11701, 11981]","[0, 283, 373, 576, 666, 846, 953, 1088, 1178, 1358, 1448, 1995, 2270, 2411, 2560, 2757, 3013, 3697, 4015, 4173, 4454, 4562, 4801, 5149, 5244, 5811, 5906, 6040, 6373, 6559, 7042, 7297, 7487, 8082, 8705]",21569,21246,18792,11981,8705,-1919,-2376,-2313,1105,2225,-3278,35,radiant
7567126703,10,120,21,65,110,"[0, 219, 422, 664, 913, 1186, 1571, 1997, 2525, 3019, 3526, 4089, 4676, 5256, 5884, 6376, 7414, 8096, 8497, 9005, 9559, 10134, 10727, 11083, 11640, 12195, 12848, 13735, 14234, 14330, 15815, 16598, 17031, 17131, 18178]","[0, 362, 524, 975, 1260, 1678, 2045, 2804, 3217, 3655, 4178, 4793, 5213, 5835, 6689, 7026, 7644, 8165, 8811, 9010, 9933, 10592, 11319, 11643, 12461, 12795, 13363, 13458, 13802, 13989, 14751, 15247, 15488, 16006, 17081]","[0, 251, 522, 924, 1305, 1585, 2101, 2513, 2967, 3418, 3671, 4084, 4454, 5107, 5779, 6436, 6885, 7617, 8318, 8553, 8902, 9358, 9936, 10272, 10451, 11724, 12009, 12368, 12608, 13082, 13648, 13925, 14025, 14125, 14887]","[0, 170, 260, 398, 567, 743, 955, 1090, 1180, 1316, 1530, 1698, 1992, 2682, 2831, 2926, 3515, 3784, 4068, 4554, 4978, 5409, 5954, 6265, 6434, 6968, 7419, 7796, 7967, 8175, 8979, 9153, 9328, 9452, 9736]","[0, 170, 260, 427, 517, 607, 791, 1011, 1101, 1191, 1326, 1491, 1581, 2307, 2648, 2843, 3090, 3188, 3601, 3696, 4045, 4370, 4827, 5336, 5598, 5826, 6002, 6097, 6231, 6500, 6731, 6833, 6963, 7063, 7366]",18178,17081,14887,9736,7366,70,82,98,26,123,"[0, 331, 598, 1004, 1342, 1776, 2069, 2503, 2828, 3437, 3865, 4421, 5023, 5566, 6012, 6572, 7412, 8337, 9132, 9743, 10994, 11863, 12669, 13484, 14790, 15555, 16729, 17813, 19495, 20578, 21444, 22572, 23922, 25147, 26585]","[0, 222, 661, 884, 1323, 1532, 1963, 2414, 2953, 3284, 3999, 4511, 5113, 5637, 6547, 7429, 8513, 9688, 10990, 11695, 12699, 13342, 14187, 15315, 16193, 16360, 17413, 18228, 19099, 20073, 20577, 20856, 21360, 22909, 23905]","[0, 299, 685, 1146, 1356, 1684, 2257, 3030, 3538, 4056, 4625, 5111, 5546, 5777, 6822, 7241, 7767, 8071, 9024, 9626, 10255, 10943, 11878, 12472, 13296, 13666, 14620, 15648, 16686, 17395, 18117, 18778, 19991, 21384, 22354]","[0, 170, 260, 416, 552, 733, 868, 1011, 1127, 1364, 1878, 2572, 2752, 2970, 3311, 3738, 4032, 4874, 5054, 5212, 5968, 6333, 6553, 6915, 7171, 7338, 7970, 8220, 9078, 9387, 9663, 9994, 10983, 11991, 12522]","[0, 170, 260, 350, 534, 670, 805, 1058, 1220, 1310, 1832, 1922, 2307, 2401, 2767, 3033, 3280, 3925, 4215, 4387, 4824, 5198, 5550, 6039, 6436, 6646, 6915, 7300, 7802, 8057, 8253, 8532, 9281, 10300, 10725]",26585,23905,22354,12522,10725,-8407,-6824,-7467,-2786,-3359,-28843,35,dire
7567721608,63,98,43,90,83,"[0, 331, 917, 1404, 1796, 2450, 3007, 3501, 4061, 4317, 4670, 5067, 5427, 6398, 6594, 7198, 8071, 8724, 9178, 10270, 11378, 12082, 12945, 13350, 14401, 14718, 15599, 16426, 17236, 17392, 18003, 19204, 21052, 22356, 23012]","[0, 364, 761, 1253, 1507, 1956, 2716, 3163, 3550, 4136, 4486, 4719, 5112, 5611, 5968, 6633, 7834, 8256, 8457, 10640, 11383, 12191, 12676, 13452, 13764, 14570, 15437, 16313, 16638, 16957, 17993, 18579, 19976, 21404, 22211]","[21, 269, 612, 906, 1187, 1613, 1870, 2191, 2449, 2880, 3258, 3631, 4225, 4730, 4910, 5327, 5857, 5952, 6666, 7295, 7647, 8010, 8568, 9398, 9870, 11095, 11527, 12132, 12343, 12981, 13077, 13527, 14698, 15305, 15979]","[0, 210, 374, 917, 1083, 1190, 1520, 1655, 1745, 1880, 2196, 2357, 2760, 3388, 3522, 3617, 3895, 4141, 4445, 5437, 5745, 5992, 6501, 7219, 7626, 8418, 8594, 8905, 9580, 9924, 10693, 11083, 12302, 12617, 12945]","[0, 210, 490, 681, 910, 1362, 1618, 1753, 1914, 2049, 2184, 2518, 2741, 3378, 3544, 3639, 4065, 4160, 4255, 4821, 5091, 5258, 5501, 6104, 6444, 6922, 7173, 7343, 7645, 7816, 7987, 8452, 9074, 9725, 10055]",23012,22211,15979,12945,10055,46,77,45,20,26,"[0, 130, 518, 907, 1364, 1648, 2186, 2548, 3007, 3506, 3963, 4672, 4936, 5951, 7004, 7747, 8407, 9299, 10528, 11653, 12107, 12883, 13785, 14969, 15756, 16351, 16713, 17405, 18484, 19562, 20456, 21717, 22315, 22449, 23556]","[0, 207, 571, 890, 1486, 1949, 2075, 2708, 3044, 3627, 4120, 4324, 4826, 5868, 6504, 7466, 7953, 8530, 9316, 9983, 10728, 11480, 12124, 12672, 12766, 13062, 13850, 14215, 14973, 15735, 15966, 17834, 18397, 19457, 19890]","[0, 253, 542, 914, 1316, 1489, 1725, 2126, 2337, 2680, 3115, 3618, 4200, 4706, 5211, 6068, 6952, 7311, 7550, 8175, 8641, 9063, 9366, 9919, 10355, 11212, 11634, 12268, 12796, 13179, 13426, 14194, 14453, 14755, 14962]","[0, 130, 220, 326, 589, 872, 1261, 1384, 1474, 2032, 2167, 2404, 2539, 3236, 3651, 4089, 4381, 4566, 5017, 5508, 5602, 5767, 6047, 6783, 6952, 7122, 7375, 7833, 8517, 8735, 9041, 10065, 10234, 10334, 10482]","[0, 130, 220, 560, 776, 911, 1218, 1322, 1517, 1607, 1871, 2218, 2308, 2766, 3137, 3460, 3752, 4017, 4482, 4928, 5236, 5399, 5604, 5955, 6162, 6360, 6794, 6970, 7425, 7808, 8039, 8709, 8809, 8909, 9155]",23556,19890,14962,10482,9155,-544,2321,1017,2463,900,6157,35,dire
7567823304,14,103,13,63,21,"[0, 372, 761, 1195, 1769, 2253, 2772, 3488, 4068, 4912, 6013, 6103, 6778, 7078, 8310, 8842, 9977, 10473, 10678, 11214, 12183, 12344, 13579, 14760, 15333, 16388, 16844, 17687, 18335, 19004, 19772, 20421, 20722, 21621, 22179]","[0, 547, 839, 1088, 1684, 2373, 2804, 3122, 3537, 3861, 4322, 4872, 5583, 5879, 7209, 7502, 8472, 8990, 9640, 10269, 10927, 11540, 12176, 12842, 13715, 14459, 14921, 16016, 16600, 17113, 17787, 18490, 20036, 20506, 21334]","[0, 792, 1044, 1278, 1697, 2070, 2448, 2815, 3114, 3616, 3779, 4381, 4471, 5232, 5956, 6471, 7438, 8051, 8896, 9191, 9366, 10515, 11367, 12273, 13079, 14070, 14773, 15352, 15448, 16320, 16781, 17370, 18929, 19983, 20539]","[20, 300, 594, 777, 1025, 1581, 1845, 2179, 2397, 2622, 2971, 3242, 3510, 3605, 3929, 4070, 4334, 5075, 5612, 5936, 6625, 6882, 7906, 8681, 9136, 9588, 9717, 11278, 11617, 12215, 12632, 13326, 14616, 15086, 15428]","[100, 639, 729, 868, 1259, 1504, 1825, 2276, 2501, 3050, 3241, 3510, 4024, 4208, 4657, 4785, 5349, 5700, 6076, 6519, 7069, 7381, 8258, 8821, 9133, 9884, 10119, 10504, 11054, 11150, 11517, 11925, 13031, 13938, 14152]",22179,21334,20539,15428,14152,113,82,20,51,5,"[0, 364, 649, 1020, 1317, 1540, 2001, 2308, 2730, 3235, 3829, 4465, 5289, 5956, 6439, 6972, 7966, 8941, 9348, 10084, 11281, 12292, 13079, 13281, 14994, 15992, 16895, 17511, 17607, 18187, 18760, 20283, 20929, 21297, 22154]","[0, 229, 554, 682, 1028, 1414, 1849, 2092, 2480, 2880, 3659, 4204, 5328, 6028, 6757, 7545, 7678, 8892, 9889, 10697, 11924, 12246, 13319, 13519, 13813, 14502, 14879, 14974, 15593, 16650, 16807, 17219, 18082, 18182, 18368]","[0, 605, 767, 976, 1182, 1272, 1813, 2201, 2513, 2935, 3363, 3805, 4303, 4815, 5141, 5351, 5746, 6082, 6452, 6674, 7268, 7556, 8020, 8452, 8862, 9325, 9827, 11197, 11783, 12778, 13155, 13883, 15196, 15296, 15396]","[0, 268, 358, 448, 554, 678, 942, 1127, 1673, 1857, 2231, 2469, 3362, 3692, 3888, 4118, 4644, 5040, 5135, 5538, 5702, 5974, 6513, 6788, 7531, 7836, 8334, 9025, 9196, 9652, 9823, 10480, 11884, 12649, 12978]","[100, 501, 591, 681, 817, 907, 1330, 1923, 2013, 2153, 2379, 2964, 3443, 3787, 4172, 4266, 4788, 5263, 5748, 6353, 7251, 7445, 7990, 8243, 8777, 9007, 9195, 9608, 10336, 10929, 11125, 11610, 12304, 12563, 13127]",22154,18368,15396,12978,13127,25,2966,5143,2450,1025,11609,35,radiant
7568258612,120,96,54,86,65,"[0, 213, 540, 937, 1316, 1698, 2101, 2402, 2841, 3528, 4424, 4845, 5810, 6511, 7415, 7821, 8309, 9090, 9675, 10616, 11324, 12010, 12823, 13533, 13628, 14407, 15135, 15766, 16809, 17312, 17704, 18498, 19061, 19161, 19969]","[0, 216, 508, 958, 1290, 1535, 1955, 2571, 3045, 3459, 3725, 4024, 4672, 5205, 6170, 6264, 7194, 7802, 8329, 9020, 9810, 10262, 11197, 11571, 12406, 12978, 13363, 13834, 13930, 14686, 14953, 15250, 15430, 15922, 16454]","[0, 199, 563, 722, 1029, 1227, 1575, 2012, 2191, 2428, 2999, 3376, 3925, 4407, 5219, 5629, 6395, 6884, 7596, 8198, 8784, 9318, 9832, 10175, 10639, 10970, 11064, 11159, 11255, 11351, 11547, 11734, 12158, 12809, 12909]","[0, 129, 222, 312, 402, 492, 582, 948, 1126, 1320, 1575, 1665, 1958, 2244, 2698, 3057, 3437, 3934, 4122, 4431, 4589, 5308, 5953, 6176, 6406, 6573, 7005, 7276, 8101, 8687, 9011, 9625, 10758, 11920, 12200]","[100, 229, 319, 409, 499, 589, 767, 857, 1127, 1254, 1517, 1607, 2148, 2577, 3077, 3171, 3559, 3921, 4415, 4825, 5489, 5848, 6455, 6648, 7048, 7798, 8262, 8502, 9724, 10040, 10556, 10876, 11089, 11419, 11519]",19969,16454,12909,12200,11519,39,102,78,123,72,"[0, 321, 687, 1053, 1459, 1800, 2194, 2861, 3277, 3783, 4304, 5238, 5675, 5963, 6206, 7121, 7979, 8074, 8749, 9411, 10317, 10795, 11949, 12715, 14145, 14836, 15594, 17366, 18596, 19475, 20256, 21373, 22740, 23477, 23757]","[0, 256, 548, 904, 1192, 1670, 1914, 2344, 2921, 3345, 3770, 4248, 4777, 5143, 5738, 6152, 7038, 7407, 7963, 8637, 9438, 10051, 10569, 11157, 11918, 12572, 13520, 14801, 15295, 15641, 16055, 16587, 17892, 18405, 18958]","[0, 280, 548, 828, 1451, 2034, 2279, 2612, 2996, 3412, 3718, 4204, 4696, 4997, 5813, 6207, 6689, 6936, 7398, 7988, 8228, 8515, 8982, 9220, 10050, 10361, 10925, 11567, 12558, 13283, 13878, 14486, 15756, 17209, 17731]","[0, 209, 299, 433, 589, 797, 887, 1131, 1346, 1591, 1995, 2313, 2466, 2607, 2860, 3395, 3706, 3849, 4106, 4411, 4751, 5161, 5730, 5847, 6434, 6604, 7354, 8162, 8656, 8752, 9083, 9416, 10199, 10778, 11436]","[0, 209, 316, 485, 575, 1024, 1236, 1416, 1906, 1996, 2219, 3028, 3181, 3392, 3700, 4015, 4326, 4495, 4655, 4904, 5121, 5319, 5620, 5844, 6383, 6529, 6989, 8013, 8686, 8782, 9113, 9348, 10212, 10932, 11212]",23757,18958,17731,11436,11212,-3788,-2504,-4822,764,307,-10043,35,dire
7568353308,4,22,69,110,121,"[0, 204, 561, 915, 1403, 1790, 2248, 2679, 3018, 3163, 3465, 3895, 4582, 5018, 5757, 6387, 6862, 7433, 8163, 8845, 9679, 10294, 10691, 12334, 13129, 13668, 14316, 15068, 15802, 16295, 18465, 19124, 19802, 20805, 21234]","[0, 326, 723, 1046, 1453, 1780, 2194, 2706, 2988, 3420, 4181, 4491, 5034, 5492, 6375, 6479, 7122, 7823, 8097, 9051, 9789, 10043, 10306, 10994, 11327, 11924, 12146, 12240, 12748, 12967, 13959, 14533, 15364, 15758, 16282]","[0, 206, 333, 423, 634, 1050, 1140, 1266, 1737, 2199, 2581, 2765, 3665, 4155, 4363, 4667, 5147, 5592, 6264, 6840, 8372, 8627, 9208, 10095, 10591, 11069, 11324, 11522, 11817, 12132, 13377, 14034, 15222, 15616, 15774]","[0, 170, 260, 417, 555, 896, 1776, 1866, 2213, 2498, 2623, 3109, 3508, 3773, 4120, 4217, 4477, 4913, 5464, 5559, 5978, 6586, 6866, 7554, 8003, 8222, 8317, 8411, 8646, 8787, 9834, 10416, 10789, 11414, 11968]","[0, 170, 260, 422, 512, 788, 1136, 1226, 1360, 1495, 1748, 1885, 2335, 2484, 2867, 3071, 3587, 3691, 4222, 4645, 5682, 5956, 6182, 6990, 7266, 7473, 7643, 8089, 8475, 8781, 10057, 10445, 10691, 11018, 11272]",21234,16282,15774,11968,11272,21,120,129,53,136,"[0, 251, 864, 1647, 2173, 2614, 3224, 3865, 4392, 4517, 5611, 6303, 6843, 7293, 8064, 8572, 9695, 10158, 11227, 11819, 12584, 12679, 13482, 13872, 14705, 15581, 16743, 17789, 18563, 19131, 20032, 20879, 21685, 21785, 23781]","[0, 329, 682, 1095, 1548, 1923, 2525, 2828, 3700, 4182, 5106, 5776, 6095, 6707, 7388, 8095, 8252, 9014, 10058, 10955, 12313, 12808, 13523, 13759, 14437, 15214, 15750, 16868, 17501, 17828, 18186, 18556, 19684, 20064, 20164]","[0, 274, 585, 746, 914, 1294, 1747, 2118, 2600, 3206, 3751, 3985, 4237, 4484, 5052, 5429, 6115, 6970, 7847, 8380, 8935, 9030, 9698, 10063, 10720, 11186, 11617, 12831, 13400, 13706, 14540, 14988, 15390, 15490, 16050]","[0, 170, 344, 591, 776, 1128, 1567, 1930, 2284, 2507, 3313, 3916, 4208, 4467, 4719, 5006, 5576, 5901, 6744, 7512, 8058, 8153, 8592, 9075, 9717, 10226, 11383, 12127, 12549, 12845, 13245, 13735, 14729, 14829, 16237]","[0, 170, 673, 921, 1106, 1444, 1718, 1853, 2110, 2200, 2452, 2770, 2933, 3241, 3640, 3735, 4517, 4722, 5424, 5681, 6512, 7029, 7394, 7634, 7779, 8035, 8466, 9346, 9885, 10261, 10745, 10985, 11262, 11489, 11628]",23781,20164,16050,16237,11628,-2547,-3882,-276,-4269,-356,-11330,35,dire
7568433407,114,71,2,123,121,"[62, 303, 502, 703, 912, 1283, 1578, 2057, 2457, 2835, 3689, 4158, 4573, 4810, 5385, 5840, 6416, 6910, 7570, 8383, 8996, 9469, 9699, 10034, 10646, 11588, 12775, 13251, 14319, 14842, 15549, 16271, 17454, 17554, 19054]","[60, 353, 667, 914, 1078, 1293, 1706, 2235, 2574, 2916, 3839, 4144, 4789, 5350, 5711, 6249, 7161, 7346, 7755, 8226, 8408, 8675, 9242, 9662, 10040, 10262, 10744, 11158, 11836, 12279, 12839, 13063, 13719, 13819, 14779]","[328, 534, 880, 1105, 1338, 1743, 2326, 2873, 3267, 3471, 4127, 4845, 5271, 5668, 6156, 6895, 7560, 7844, 8281, 8745, 9213, 9969, 10575, 10814, 11088, 11527, 13190, 13641, 14184, 14280, 14618, 14718, 15903, 16099, 17041]","[60, 229, 319, 615, 705, 1070, 1324, 1586, 1721, 2113, 2332, 2737, 3087, 3430, 3961, 4359, 4731, 5256, 5580, 6079, 6209, 6520, 6785, 7034, 7376, 7870, 8956, 9279, 9990, 10086, 10708, 11386, 12222, 12643, 13273]","[60, 229, 337, 472, 664, 895, 1032, 1744, 2014, 2220, 2662, 2904, 3200, 3386, 3550, 3744, 4261, 4356, 4885, 5197, 5292, 5484, 5650, 5828, 6369, 6536, 7695, 8095, 8473, 8569, 8665, 8765, 9448, 9615, 10371]",19054,14779,17041,13273,10371,63,65,29,100,79,"[0, 250, 559, 876, 1232, 1445, 1689, 2003, 2317, 2726, 3299, 3389, 3817, 4348, 4745, 5159, 5603, 5875, 6401, 6819, 7872, 8348, 9029, 9792, 10634, 11138, 11407, 12419, 13134, 13929, 14787, 16054, 17212, 18033, 19107]","[0, 274, 562, 894, 1173, 1543, 2070, 2501, 2942, 3350, 3566, 3829, 4225, 4392, 4764, 5407, 5838, 6343, 6778, 7677, 8078, 8739, 9024, 9504, 10784, 11833, 12256, 12556, 13157, 13627, 14079, 14705, 16359, 16459, 16664]","[0, 169, 375, 704, 1154, 1591, 1911, 2261, 2652, 2742, 2926, 3253, 3540, 4242, 4692, 5466, 5665, 6249, 6663, 7277, 7647, 8082, 8546, 9025, 9587, 10268, 10733, 10914, 11390, 11675, 12598, 13321, 14339, 14645, 14927]","[0, 169, 259, 435, 565, 703, 793, 883, 1060, 1430, 1520, 1610, 1700, 2002, 2143, 2328, 2602, 2697, 2883, 3041, 3136, 3566, 3749, 4453, 5313, 5902, 6543, 6847, 7169, 7265, 7603, 8100, 8951, 9051, 9560]","[0, 169, 259, 397, 572, 799, 972, 1325, 1425, 1622, 2027, 2117, 2207, 2614, 2985, 3205, 3691, 3933, 4374, 4744, 4839, 5111, 5388, 5865, 6675, 7128, 7382, 7477, 7654, 7875, 7971, 8406, 8897, 8997, 9146]",19107,16664,14927,9560,9146,-53,-1885,2114,3713,1225,5114,35,dire
7568469704,93,97,47,19,112,"[0, 237, 582, 791, 1116, 1447, 1748, 1924, 2246, 2573, 2875, 3262, 3543, 4185, 4666, 5398, 6104, 6653, 7354, 8167, 9580, 10191, 10733, 11677, 12495, 13374, 13989, 14907, 15086, 15866, 16433, 17618, 17980, 19258, 20114]","[0, 316, 720, 965, 1263, 1586, 1808, 1993, 2370, 2645, 2998, 3444, 4426, 4824, 5085, 5594, 6019, 6584, 7005, 7163, 7693, 8176, 8353, 8930, 9334, 9868, 10223, 10901, 11200, 12020, 12530, 13013, 13378, 14479, 15009]","[0, 268, 495, 831, 1171, 1460, 1901, 2266, 2735, 2825, 3034, 3859, 4213, 4437, 4995, 5533, 5926, 6335, 6701, 7167, 7647, 8407, 8669, 8809, 8904, 9241, 9688, 10708, 10970, 11728, 11905, 12491, 12927, 13569, 15205]","[0, 194, 434, 524, 625, 760, 1094, 1184, 1681, 1855, 1975, 2218, 2512, 2813, 3424, 3938, 4339, 4684, 4994, 5152, 5859, 6278, 6791, 6886, 6981, 7358, 7686, 8410, 8506, 9278, 9455, 9860, 10139, 10239, 10591]","[0, 194, 284, 485, 623, 774, 864, 1069, 1375, 1534, 1754, 2042, 2205, 2457, 2718, 2896, 3054, 3326, 3420, 3712, 4479, 4911, 5015, 5255, 5447, 5717, 6244, 6339, 6435, 6924, 7318, 7997, 8673, 9450, 9933]",20114,15009,15205,10591,9933,102,76,96,121,26,"[0, 205, 1023, 1149, 1681, 1914, 2280, 2889, 3346, 3644, 4123, 4786, 5300, 6149, 6567, 7095, 7698, 8662, 9042, 9541, 9699, 10547, 11774, 12705, 13385, 13926, 14763, 15644, 15831, 16331, 16810, 17732, 18642, 18742, 19001]","[0, 285, 571, 734, 1023, 1156, 1400, 1672, 2017, 2587, 2945, 3331, 3791, 4336, 4897, 5567, 6243, 6937, 7802, 8367, 9032, 9809, 9975, 11398, 12262, 12888, 14000, 14548, 14739, 15886, 16536, 17162, 17918, 18400, 19064]","[0, 244, 605, 1045, 1505, 1795, 2188, 2770, 3147, 3631, 3934, 4298, 4864, 5445, 5847, 6352, 6799, 7279, 7894, 8160, 8426, 8658, 9273, 9741, 10243, 10685, 11032, 12049, 12145, 12736, 13149, 13541, 13914, 14518, 14759]","[0, 169, 259, 488, 672, 795, 977, 1293, 1716, 1892, 2378, 2468, 2793, 3080, 3282, 3553, 4067, 4351, 5208, 5686, 5844, 6245, 6635, 7254, 7548, 7753, 8060, 8526, 8735, 9212, 9308, 9821, 10639, 10848, 11389]","[0, 169, 540, 634, 844, 934, 1113, 1293, 1453, 1629, 1747, 1837, 2017, 2179, 2286, 2972, 3153, 3635, 4284, 4528, 4686, 5139, 5567, 6035, 6733, 6977, 7284, 7456, 7552, 7945, 8155, 8710, 9142, 9242, 9582]",19001,19064,14759,11389,9582,1113,-4055,446,-798,351,-2943,35,radiant
7568521109,82,76,33,51,83,"[0, 323, 880, 1380, 1620, 2277, 2680, 3184, 3879, 4884, 5532, 5925, 6918, 7445, 8321, 9010, 9878, 10777, 11597, 11925, 12497, 13173, 14124, 14745, 15310, 15924, 17324, 18709, 19545, 20077, 20982, 22727, 24484, 26087, 27218]","[0, 372, 700, 981, 1437, 1838, 2393, 2904, 3401, 3956, 4272, 4840, 5356, 5760, 6218, 6398, 7237, 7814, 8492, 9039, 9610, 9811, 10577, 11269, 11808, 12264, 13226, 14303, 15195, 15463, 16386, 16948, 17884, 18807, 19237]","[0, 286, 567, 900, 1185, 1412, 1722, 2011, 2236, 2801, 2967, 3608, 4223, 4973, 5461, 6233, 6684, 7243, 7738, 8056, 8980, 9949, 10813, 11132, 11506, 12130, 12555, 13139, 13789, 14156, 14833, 15561, 16523, 17392, 18375]","[0, 250, 340, 492, 582, 883, 1095, 1399, 1579, 1951, 2459, 2654, 3025, 3626, 3810, 4187, 4526, 5091, 5333, 6257, 6661, 7399, 8481, 9058, 9153, 9715, 10504, 11476, 12123, 12439, 13132, 13715, 14715, 16078, 16423]","[100, 350, 550, 791, 881, 1033, 1183, 1566, 1827, 2394, 2802, 3099, 3426, 3696, 4116, 4392, 4660, 5085, 5348, 5515, 5756, 5968, 6360, 6609, 6704, 6947, 7569, 8055, 8443, 8752, 9176, 9502, 10217, 10674, 11388]",27218,19237,18375,16423,11388,72,98,137,121,100,"[19, 255, 470, 796, 1411, 1667, 2106, 2938, 3276, 3556, 3745, 4259, 4946, 5561, 6244, 7073, 7711, 7985, 8833, 9797, 10365, 11385, 12389, 13090, 14190, 14460, 15279, 15374, 15764, 16580, 17678, 18098, 18460, 19426, 19700]","[0, 235, 372, 706, 954, 1205, 1462, 1766, 2178, 2506, 2949, 3809, 4105, 4374, 4652, 4950, 5319, 5751, 6189, 7305, 7540, 8284, 8655, 9540, 10016, 10711, 10917, 11012, 11527, 11905, 12363, 12755, 13301, 16191, 17077]","[19, 222, 460, 638, 1126, 1535, 2048, 2382, 3223, 3521, 4390, 4860, 4961, 5068, 5549, 6038, 6133, 6227, 6923, 7473, 8007, 8381, 8566, 9261, 9958, 10197, 10964, 11176, 11520, 12102, 12464, 12771, 13080, 13180, 13427]","[0, 432, 573, 663, 802, 927, 1129, 1308, 1893, 2032, 2322, 2619, 2773, 2903, 2997, 3222, 3486, 3990, 4246, 5435, 5530, 5775, 5960, 6328, 6648, 6815, 6910, 7170, 7420, 7516, 7774, 7874, 8167, 8305, 8826]","[0, 164, 254, 344, 575, 665, 847, 1260, 1485, 1575, 1710, 2146, 2284, 2709, 2803, 2898, 2993, 3284, 3540, 3942, 4037, 4282, 4467, 4562, 4882, 5121, 5216, 5311, 5407, 5503, 5761, 5861, 6154, 6713, 6813]",19700,17077,13427,8826,6813,7518,2160,4948,7597,4575,26798,35,radiant
7568521216,41,128,47,19,112,"[0, 618, 780, 1177, 1373, 1834, 2032, 2715, 3189, 3439, 3615, 4140, 4944, 5386, 5590, 6154, 6804, 7429, 7814, 8443, 8573, 8909, 11387, 12124, 12939, 13553, 14272, 15366, 16379, 17057, 17711, 18260, 18360, 18770, 20269]","[0, 374, 720, 1122, 1284, 1751, 2198, 3095, 3185, 3814, 3904, 4537, 5128, 5580, 6233, 6373, 6804, 7175, 7805, 7985, 8628, 8894, 9252, 9842, 10511, 10902, 11517, 12209, 13373, 13878, 14644, 15051, 15228, 15648, 17213]","[0, 247, 483, 731, 903, 1029, 1365, 1949, 2039, 2241, 2571, 3084, 3486, 3911, 4464, 5311, 6153, 6892, 7544, 7702, 8273, 8738, 9989, 10270, 11048, 11515, 12020, 13096, 13785, 14417, 15018, 15506, 15606, 16134, 16619]","[0, 210, 300, 481, 571, 756, 893, 1193, 1516, 1606, 1696, 2080, 2682, 2878, 2973, 3246, 3449, 3761, 4023, 4553, 4693, 4877, 5916, 6405, 6882, 7159, 7309, 7711, 8557, 8734, 9462, 10645, 10745, 10845, 11660]","[0, 273, 397, 534, 624, 759, 849, 1301, 1624, 1889, 1979, 2311, 2876, 3344, 3582, 3902, 4220, 4488, 4673, 4831, 5279, 5606, 6337, 6432, 6634, 6806, 7166, 7568, 8028, 8258, 8650, 8892, 9069, 9397, 9882]",20269,17213,16619,11660,9882,21,96,137,45,26,"[0, 167, 467, 870, 1272, 1726, 2048, 2261, 2828, 3336, 3847, 4363, 4979, 5332, 5909, 6738, 7619, 8397, 9076, 10042, 11430, 12663, 13092, 13515, 13977, 15027, 15833, 16437, 16533, 17266, 18490, 18836, 19187, 20763, 21156]","[0, 130, 374, 656, 1101, 1420, 1840, 2050, 2628, 2973, 3338, 3652, 4128, 4319, 4971, 5421, 5877, 6465, 6835, 7636, 7893, 8380, 8591, 8932, 9479, 10083, 10517, 11058, 11892, 12396, 12980, 14079, 14732, 15428, 15656]","[0, 285, 546, 921, 1499, 1661, 2026, 2116, 3046, 3516, 4306, 5066, 5231, 5422, 5617, 6062, 7294, 7759, 8471, 9113, 9670, 10127, 10551, 11062, 11537, 11881, 12472, 12850, 12946, 13639, 14168, 15192, 15580, 16148, 16674]","[0, 180, 270, 406, 581, 727, 866, 956, 1323, 1452, 1773, 2015, 2345, 2860, 3719, 4121, 4671, 5207, 5851, 6560, 6870, 7078, 7455, 7834, 8264, 9042, 9883, 10148, 10319, 10586, 10851, 12540, 12798, 13632, 13869]","[0, 130, 220, 310, 488, 626, 799, 889, 1191, 1449, 1632, 2017, 2107, 2201, 2620, 3158, 3413, 3660, 3951, 4665, 4947, 5117, 5403, 5801, 6144, 6678, 7205, 7544, 7715, 8332, 8593, 9534, 9709, 10146, 10411]",21156,15656,16674,13869,10411,-887,1557,-55,-2209,-529,-2123,35,dire
7568606319,10,69,17,58,26,"[0, 220, 459, 964, 1419, 1798, 2168, 2321, 2614, 3168, 3641, 4085, 5066, 5466, 6214, 6908, 7979, 8735, 9427, 10227, 11648, 12279, 13322, 14217, 14658, 15809, 16534, 17344, 18535, 19603, 20759, 21970, 22713, 23822, 24463]","[0, 314, 571, 994, 1283, 1572, 1900, 2222, 2593, 2927, 3347, 4133, 4590, 5604, 6066, 6951, 7562, 8060, 8709, 10034, 10614, 11612, 12677, 13291, 14140, 15279, 16481, 17317, 18472, 18620, 20655, 21405, 21965, 22704, 23137]","[0, 289, 611, 979, 1398, 1842, 2473, 2817, 3362, 3542, 3694, 4121, 5070, 5553, 6115, 6566, 7133, 8214, 8925, 9689, 10402, 11685, 12299, 13122, 13644, 14463, 14781, 15685, 16800, 17444, 17875, 18920, 19476, 20464, 21369]","[0, 170, 260, 394, 590, 680, 1131, 1393, 1587, 1722, 1865, 2102, 2570, 2768, 3216, 3556, 3876, 4117, 4506, 4684, 5260, 5470, 5847, 6423, 6710, 6967, 7108, 7574, 7930, 8366, 8797, 9210, 9400, 10403, 10638]","[100, 515, 605, 806, 936, 1112, 1406, 1544, 1690, 1814, 2106, 2373, 3064, 3213, 3685, 3881, 4422, 4598, 5008, 5103, 5459, 5669, 6052, 6388, 6577, 6902, 7105, 7573, 7831, 8083, 9049, 9511, 9701, 9963, 10198]",24463,23137,21369,10638,10198,49,25,96,121,51,"[0, 328, 612, 907, 1387, 1824, 2204, 2535, 3160, 3975, 4477, 5085, 5570, 6195, 6815, 7282, 7843, 8815, 9665, 10640, 11081, 11277, 12094, 13418, 14256, 15126, 15807, 17136, 17887, 19379, 19977, 20077, 21012, 22669, 22769]","[0, 584, 1100, 1425, 1747, 2108, 2649, 3110, 3627, 4051, 4408, 4902, 5414, 6142, 6966, 7373, 7932, 8701, 9076, 9930, 10586, 11181, 11992, 12473, 13469, 14444, 15106, 15683, 16321, 16752, 17431, 17733, 18280, 19490, 20316]","[0, 240, 636, 807, 1138, 1431, 1912, 2685, 2980, 3336, 3793, 4211, 4385, 5172, 5395, 5583, 6152, 6481, 7158, 7740, 7926, 8371, 9156, 9635, 9747, 10556, 10650, 11119, 11381, 12017, 12628, 12728, 12997, 13898, 14331]","[0, 170, 260, 350, 506, 640, 999, 1178, 1279, 1514, 1994, 2174, 2353, 2640, 2955, 3280, 3482, 3661, 3923, 4361, 4456, 4609, 4850, 5532, 5702, 6055, 6555, 7088, 7501, 8655, 9076, 9251, 9570, 10256, 10406]","[0, 239, 402, 538, 719, 817, 1141, 1403, 1542, 1905, 2165, 2385, 2536, 2819, 2913, 3008, 3187, 3324, 3418, 3783, 3878, 3995, 4209, 4775, 4880, 5516, 5907, 6238, 6735, 7894, 8787, 9094, 9279, 9771, 9871]",22769,20316,14331,10406,9871,1694,2821,7038,232,327,12112,35,radiant
7568781105,46,41,137,65,26,"[608, 1057, 1456, 1872, 2294, 2630, 3083, 3717, 4433, 5524, 5778, 6593, 7253, 7899, 8689, 9284, 10178, 11120, 12363, 13020, 13743, 14489, 15192, 16173, 16819, 17295, 18120, 19042, 19581, 20105, 21200, 21897, 22098, 22481, 23114]","[493, 846, 1214, 1615, 1865, 2208, 2582, 3020, 3503, 4244, 4706, 5168, 5826, 6265, 6932, 7869, 8227, 8799, 9110, 9750, 10518, 11446, 12357, 13388, 14088, 14289, 14520, 14727, 15499, 16248, 17264, 17919, 18099, 18807, 19225]","[533, 843, 1537, 1803, 2370, 2875, 3640, 3971, 4640, 5344, 5509, 6544, 6780, 7296, 7749, 7945, 8718, 9243, 10179, 10456, 10963, 11276, 11517, 12432, 12527, 12772, 13542, 13996, 14425, 14785, 15430, 16006, 16106, 16206, 16994]","[260, 350, 485, 580, 914, 1233, 1460, 1751, 2015, 2540, 2630, 3031, 3512, 3828, 4092, 4680, 5286, 5726, 6055, 6413, 6868, 7465, 7940, 9064, 9434, 9895, 10201, 10602, 11095, 11270, 11605, 11838, 11975, 12078, 12696]","[260, 395, 547, 637, 866, 1046, 1204, 1343, 1632, 2127, 2217, 2501, 2795, 2985, 3421, 3627, 3955, 4280, 4955, 5144, 5633, 5974, 6144, 6604, 6820, 7377, 7939, 8110, 8580, 9068, 9423, 9839, 10447, 10746, 10921]",23114,19225,16994,12696,10921,1,13,97,123,110,"[517, 642, 967, 1284, 1542, 1838, 2124, 2371, 2646, 3035, 3814, 4524, 5199, 5730, 6452, 7321, 7951, 8400, 9733, 10605, 11697, 12243, 12873, 13902, 14928, 15507, 16907, 17850, 18705, 19585, 20886, 21273, 22854, 24624, 25797]","[555, 926, 1141, 1489, 1819, 2032, 2484, 3126, 3559, 3952, 4527, 5201, 6036, 6577, 7148, 7530, 8170, 8565, 8985, 9487, 10277, 10584, 10969, 11616, 11910, 12231, 12817, 13384, 14000, 14961, 15692, 15924, 17431, 18260, 18657]","[528, 766, 1053, 1530, 1833, 2122, 2547, 3217, 3627, 4332, 4553, 5203, 5533, 6167, 6795, 7486, 7908, 8261, 8522, 8834, 9369, 9972, 10291, 10839, 11116, 11233, 11829, 12365, 12894, 13473, 13877, 14485, 15718, 16573, 17255]","[260, 387, 477, 726, 1468, 1637, 1727, 1817, 1955, 2290, 2499, 3015, 3261, 3655, 4061, 4526, 4878, 5281, 6208, 6477, 6872, 7625, 7830, 8178, 8524, 9202, 10067, 10330, 10643, 10977, 11479, 11997, 12734, 13599, 14354]","[312, 402, 492, 622, 770, 918, 1033, 1161, 1289, 1564, 1790, 2019, 2194, 2403, 2865, 2980, 3075, 3384, 3922, 4103, 4360, 4655, 4950, 5064, 5393, 5823, 6009, 6191, 6312, 6646, 6921, 7165, 8348, 8998, 9222]",25797,18657,17255,14354,9222,-2683,568,-261,-1658,1699,-2335,35,dire
7568789619,94,29,106,123,68,"[0, 416, 630, 921, 1212, 1378, 1586, 1844, 2062, 2361, 2960, 3462, 3815, 4634, 5345, 5971, 6554, 7354, 8614, 9632, 10641, 11507, 12682, 13332, 14103, 14896, 15798, 16487, 17612, 19111, 20756, 22783, 23302, 23402, 24017]","[0, 288, 697, 1159, 1535, 2110, 2650, 3193, 3789, 4283, 5184, 5402, 5492, 6204, 6559, 7277, 7953, 8853, 9348, 9697, 10319, 11124, 12444, 13022, 13419, 13901, 14121, 14716, 15706, 16113, 16962, 18138, 18455, 18555, 19298]","[0, 170, 374, 769, 1084, 1342, 1669, 2080, 2736, 3356, 3876, 4128, 4491, 4786, 5162, 5483, 6023, 7160, 7832, 8531, 9324, 9735, 10521, 11306, 11536, 12367, 12717, 12903, 13546, 13845, 14427, 15007, 15405, 16254, 16892]","[100, 346, 436, 653, 743, 1089, 1228, 1318, 1707, 2003, 2347, 2523, 3024, 3555, 4090, 4185, 4411, 5175, 5871, 6078, 6833, 7153, 8129, 8844, 9399, 10108, 10328, 10567, 10932, 11556, 12144, 12758, 13030, 13404, 14142]","[0, 284, 374, 591, 745, 1162, 1252, 1348, 1692, 1925, 2269, 2422, 2609, 2899, 3171, 3340, 3435, 4035, 4423, 4581, 4806, 5258, 6316, 6881, 7111, 7459, 7721, 7960, 8532, 8923, 9683, 10172, 10406, 10506, 10972]",24017,19298,16892,14142,10972,41,49,47,19,58,"[0, 205, 495, 854, 1271, 1742, 2330, 2733, 3272, 3812, 4344, 4868, 5691, 6340, 6698, 7609, 8244, 8889, 9640, 10805, 11639, 12476, 12643, 13002, 13866, 14332, 14991, 15745, 17012, 17577, 17914, 18213, 19531, 20015, 20676]","[0, 251, 508, 722, 1081, 1257, 1944, 2532, 3238, 3689, 4002, 4405, 5112, 5433, 5955, 6430, 7310, 7707, 8232, 8999, 9591, 10461, 11423, 12516, 13019, 14143, 14597, 15070, 16764, 17540, 18460, 18560, 19331, 20106, 20725]","[0, 272, 430, 826, 1122, 1589, 1810, 2297, 2557, 2852, 3123, 3338, 3832, 4495, 4671, 5176, 5663, 5990, 7066, 7848, 8405, 8696, 8863, 9128, 9514, 10275, 10800, 11613, 12305, 12681, 13335, 13937, 14977, 15204, 15939]","[100, 570, 828, 1268, 1406, 1737, 1827, 2031, 2440, 2530, 2710, 2865, 3438, 3774, 4006, 4379, 4567, 4908, 5086, 6052, 6388, 6482, 6649, 7114, 7625, 7919, 8124, 8740, 9637, 10194, 10796, 11056, 12123, 12722, 13243]","[0, 571, 661, 879, 1033, 1123, 1422, 1663, 1942, 2139, 2603, 2796, 3246, 3689, 3931, 4227, 4454, 4548, 4688, 5288, 5659, 6282, 6449, 6579, 6861, 7777, 8317, 9137, 9696, 9892, 10200, 10608, 10856, 11036, 12226]",20676,20725,15939,13243,12226,3341,-1427,953,899,-1254,2512,35,radiant
7569050306,41,13,97,50,87,"[0, 241, 589, 986, 1403, 1770, 2134, 2521, 2924, 3181, 3425, 3913, 4496, 4782, 5179, 6101, 6680, 7511, 8088, 8875, 10039, 10543, 11055, 11448, 12304, 14132, 14739, 15484, 15962, 16610, 17905, 18005, 18105, 18378, 18869]","[0, 169, 503, 826, 1096, 1351, 1646, 2092, 2419, 2672, 2919, 3120, 3946, 4397, 5481, 6301, 6484, 6732, 7123, 7675, 7860, 8038, 8249, 8689, 9176, 9566, 9854, 10276, 10539, 11073, 12061, 12253, 12464, 12705, 12965]","[0, 320, 448, 794, 1328, 1812, 2352, 3082, 3326, 3739, 4156, 4380, 4638, 5119, 5573, 5942, 6278, 6570, 6712, 7318, 7548, 7726, 8095, 8429, 8853, 9653, 10023, 10828, 11390, 11961, 12057, 12359, 12489, 12784, 13472]","[0, 169, 259, 427, 552, 876, 966, 1104, 1263, 1353, 1849, 2022, 2382, 2631, 3288, 3604, 3968, 4261, 4669, 5010, 5415, 5709, 5920, 6114, 6433, 7645, 8454, 8694, 8943, 9195, 10020, 10562, 10662, 11034, 11134]","[0, 169, 272, 452, 621, 794, 1101, 1428, 1518, 1675, 1765, 1960, 2320, 2628, 3014, 3385, 3568, 3816, 3957, 4226, 4411, 4625, 4836, 5197, 5292, 6027, 6211, 6306, 6402, 6579, 6675, 6775, 6964, 7220, 7371]",18869,12965,13472,11134,7371,113,102,81,40,27,"[0, 326, 526, 951, 1617, 1958, 2299, 2706, 3037, 3731, 4092, 4218, 5381, 6264, 6359, 7101, 7625, 8034, 8925, 9519, 9801, 9896, 11768, 12147, 12639, 13168, 13934, 14445, 15358, 16217, 17798, 18547, 20529, 22586, 23377]","[0, 208, 470, 693, 1012, 1409, 1556, 1782, 1987, 2179, 2269, 2619, 3209, 3919, 4077, 5129, 5591, 6045, 6400, 6892, 7384, 7479, 9110, 9638, 10224, 10823, 11390, 12027, 12639, 13203, 15357, 15914, 16793, 17578, 17991]","[0, 204, 425, 784, 914, 1125, 1574, 1830, 2269, 2645, 2894, 3144, 3519, 3986, 4343, 4933, 5302, 5493, 5960, 6537, 7099, 7266, 8651, 9200, 9659, 10628, 10929, 11253, 11638, 12107, 12509, 13258, 15112, 16134, 16553]","[0, 169, 259, 395, 559, 748, 883, 1066, 1294, 1431, 1608, 1698, 2568, 2753, 2848, 3314, 3509, 3604, 3836, 4274, 4423, 4593, 5515, 5682, 6011, 6453, 6731, 6826, 7138, 7516, 8287, 8816, 9957, 10841, 10991]","[0, 169, 259, 459, 634, 805, 895, 1030, 1159, 1306, 1537, 1790, 2042, 2790, 2885, 3386, 3544, 3805, 4034, 4191, 4336, 4431, 5435, 5616, 5711, 5940, 6416, 6511, 6823, 6948, 7134, 7434, 8955, 9882, 10087]",23377,17991,16553,10991,10087,-4508,-5026,-3081,143,-2716,-15188,35,dire
7569069818,25,63,28,20,31,"[0, 291, 875, 1409, 1895, 2146, 2702, 3413, 3946, 4666, 5604, 6378, 7244, 8273, 8983, 9940, 10596, 11017, 11788, 12643, 14026, 15164, 15527, 16828, 17440, 17534, 17966, 18611, 19341, 19999, 20743, 21591, 22351, 22451, 23084]","[0, 286, 569, 810, 1100, 1371, 1820, 2378, 2540, 3066, 3651, 3991, 4375, 5050, 5690, 6248, 6548, 7149, 7818, 8312, 8920, 9853, 10236, 11178, 11683, 11958, 12438, 13150, 13470, 13949, 14466, 15237, 15855, 15955, 16932]","[0, 205, 587, 786, 1328, 1453, 1891, 2312, 3070, 3601, 4294, 4921, 5279, 6047, 6591, 7083, 7498, 8258, 8595, 9296, 9978, 10724, 11285, 11445, 11996, 12339, 12923, 13177, 13273, 13526, 13965, 14847, 15114, 15680, 16275]","[0, 130, 384, 474, 949, 1155, 1846, 2120, 2545, 3014, 3431, 3767, 4292, 4685, 5048, 5564, 5984, 6429, 6689, 7218, 7487, 7864, 8212, 8539, 8731, 8825, 9055, 9357, 9797, 10385, 10987, 11267, 11412, 11512, 11852]","[0, 130, 220, 358, 488, 578, 1208, 1433, 1634, 1724, 2141, 2637, 2877, 3225, 3373, 4005, 4428, 4709, 4969, 5263, 5568, 5945, 6128, 6571, 6867, 6961, 7191, 7493, 7589, 7685, 7781, 8183, 8328, 8428, 8700]",23084,16932,16275,11852,8700,93,13,102,107,30,"[0, 210, 373, 987, 1165, 1542, 1737, 1976, 2976, 3145, 3271, 3716, 3944, 4354, 4948, 5287, 5491, 5620, 6125, 6629, 6724, 8141, 8484, 9000, 11195, 12080, 13090, 14341, 15091, 15187, 15660, 16219, 17919, 19775, 20493]","[0, 321, 611, 854, 1225, 1507, 1672, 1957, 2283, 2864, 3098, 3622, 3819, 4402, 4638, 4886, 5296, 5391, 5590, 5794, 5982, 6431, 6737, 7328, 10062, 11277, 12333, 13563, 14809, 15367, 15685, 16190, 17377, 18346, 19544]","[0, 247, 411, 617, 937, 1139, 1435, 1602, 2103, 2316, 2742, 3179, 3303, 3485, 3656, 4101, 4196, 4422, 4551, 4646, 4920, 5236, 5464, 5826, 6262, 7023, 7993, 8912, 9519, 9795, 10080, 10622, 11521, 11915, 13273]","[0, 269, 359, 479, 666, 756, 846, 1271, 1659, 1943, 2033, 2339, 2429, 2795, 2936, 3184, 3279, 3423, 3648, 3780, 3988, 4630, 4942, 5386, 6215, 6925, 7596, 9200, 9773, 10083, 10306, 10496, 11361, 12237, 12996]","[0, 537, 627, 821, 911, 1049, 1401, 1601, 1840, 1969, 2093, 2238, 2328, 2563, 2811, 3059, 3154, 3286, 3380, 3513, 3692, 4103, 4197, 4645, 5047, 5357, 6028, 6301, 6696, 6878, 7104, 7396, 8295, 8779, 9018]",20493,19544,13273,12996,9018,2591,-2612,3002,-1144,-318,1519,35,radiant
7569216703,120,21,96,79,20,"[63, 309, 573, 929, 1341, 1735, 2065, 2509, 2931, 3469, 3559, 3874, 4565, 5025, 5800, 6100, 6641, 7448, 8011, 8711, 9170, 9457, 10398, 11031, 11645, 12622, 13612, 14995, 15304, 16000, 16501, 17829, 18257, 19567, 20167]","[63, 233, 514, 968, 1333, 1985, 2202, 2678, 3120, 3518, 3955, 4429, 5261, 5767, 6485, 6978, 7546, 8340, 8732, 9424, 10085, 10738, 11345, 12147, 12609, 12804, 13289, 14390, 14900, 15921, 16412, 16968, 17598, 18270, 19067]","[63, 277, 402, 724, 1242, 1366, 1583, 1952, 2299, 2666, 3445, 3973, 4226, 5017, 5839, 6101, 6764, 7887, 8610, 8968, 9512, 10052, 10570, 10916, 11210, 12388, 12823, 13950, 14046, 14418, 14868, 15863, 16188, 17104, 18273]","[331, 501, 591, 916, 1172, 1262, 1709, 2276, 2366, 2658, 2843, 3014, 3325, 3783, 3970, 4109, 4562, 4657, 5536, 5982, 6492, 6745, 6839, 7305, 7492, 8227, 8321, 9071, 9167, 9312, 9408, 9805, 10040, 11141, 11982]","[63, 278, 414, 551, 721, 960, 1050, 1251, 1341, 1746, 1931, 2319, 2409, 2594, 2833, 2963, 3219, 3314, 3660, 3979, 4200, 4430, 4664, 4989, 5084, 5672, 5766, 6178, 6524, 6620, 6716, 6906, 7186, 7814, 8087]",20167,19067,18273,11982,8087,48,13,69,58,119,"[0, 170, 445, 694, 1110, 1527, 1790, 1985, 2535, 3028, 3471, 3851, 4597, 5361, 5735, 6175, 7433, 8176, 8952, 10265, 11155, 12311, 12721, 13628, 15014, 15700, 16128, 17342, 17871, 18666, 19595, 20783, 22328, 23292, 23392]","[0, 327, 646, 1062, 1295, 1671, 2033, 2414, 2704, 3202, 3834, 4334, 4757, 5375, 5976, 6247, 6729, 7004, 8154, 8459, 9062, 9882, 10341, 10574, 11379, 12195, 13167, 14829, 15909, 16595, 17123, 17601, 19029, 20111, 20211]","[0, 170, 688, 934, 1186, 1315, 1883, 2118, 2428, 2669, 2996, 3620, 4020, 4685, 5448, 6083, 6560, 7273, 7976, 8549, 9264, 9795, 10198, 10835, 11343, 12420, 12953, 13475, 14023, 14933, 15642, 16077, 17501, 17888, 18404]","[0, 172, 262, 400, 537, 914, 1300, 1390, 1565, 1655, 2284, 2613, 2930, 3575, 3753, 4180, 4799, 5145, 5886, 6411, 6628, 7202, 7296, 7484, 7977, 8505, 8599, 9275, 9633, 10112, 10467, 10876, 11701, 12051, 12151]","[0, 170, 414, 504, 594, 684, 774, 864, 954, 1044, 1384, 1611, 1823, 2250, 2431, 2580, 2936, 3211, 3562, 3867, 3962, 4147, 4241, 4446, 4851, 5384, 5478, 6096, 6828, 7030, 7175, 7450, 8739, 9347, 9874]",23392,20211,18404,12151,9874,-3225,-1144,-131,-169,-1787,-6456,35,dire
7569767419,82,17,96,123,110,"[173, 462, 1104, 1376, 1657, 2076, 2787, 3366, 3751, 4332, 4672, 5262, 5815, 6695, 7682, 8847, 9445, 10282, 11738, 12590, 13607, 14679, 16224, 16967, 19036, 19886, 20547, 21289, 22586, 23782, 26947, 27657, 27847, 28746, 29499]","[116, 441, 716, 1167, 1491, 1864, 2250, 2659, 3006, 3650, 4027, 4336, 4805, 5109, 5294, 6007, 6397, 6532, 7351, 8040, 8497, 9019, 9686, 10379, 11304, 12324, 12418, 13326, 14360, 14769, 16870, 17228, 17762, 18320, 18820]","[173, 302, 559, 1036, 1351, 1700, 2223, 2868, 3199, 3543, 4091, 4351, 4987, 5619, 6181, 6464, 6694, 7235, 7713, 8266, 8892, 9748, 10701, 11177, 12150, 12627, 12843, 13587, 14089, 14942, 16585, 17279, 17821, 18555, 18989]","[574, 703, 902, 1259, 1447, 1777, 2044, 2179, 2355, 2494, 3052, 3452, 3637, 3822, 4216, 4489, 4822, 5117, 5465, 5941, 6195, 6808, 7569, 8076, 8887, 9499, 9649, 9993, 10664, 11493, 13074, 13317, 13507, 14102, 14669]","[306, 435, 850, 1178, 1268, 1358, 1538, 1673, 1808, 1898, 2033, 2123, 2213, 2448, 2633, 3240, 3470, 3765, 4090, 4564, 4711, 5617, 6253, 6486, 6861, 7259, 7431, 7741, 8430, 8936, 10506, 11211, 11475, 11665, 12135]",29499,18820,18989,14669,12135,49,120,112,128,136,"[0, 278, 567, 1097, 1437, 1649, 2057, 2406, 2813, 3541, 3888, 4316, 4735, 5550, 6344, 6792, 7556, 8390, 8838, 9508, 10007, 10875, 11735, 12282, 12377, 12737, 13739, 14658, 15501, 16050, 16146, 17582, 18285, 19248, 19959]","[163, 393, 798, 1105, 1474, 1863, 2546, 3019, 3442, 3888, 4222, 4615, 5160, 5980, 6336, 6864, 7188, 7876, 8482, 9170, 9931, 10539, 10838, 10933, 11728, 11981, 13084, 13888, 14451, 15108, 15265, 17268, 17728, 18337, 18980]","[429, 583, 707, 1600, 1805, 1895, 2316, 2722, 3196, 3711, 4077, 4167, 4626, 5370, 5745, 6108, 6519, 7391, 7909, 8350, 9085, 9243, 9382, 10024, 10263, 10868, 11858, 12253, 12549, 12917, 13134, 13953, 14899, 15296, 15664]","[163, 317, 407, 635, 811, 911, 1081, 1314, 1491, 1730, 1865, 2000, 2410, 3102, 3197, 3497, 3655, 4370, 4464, 4606, 4886, 5030, 5390, 5614, 5709, 5804, 6427, 6669, 6987, 7083, 7179, 8046, 8728, 8914, 9574]","[81, 272, 362, 744, 874, 964, 1236, 1626, 1801, 1992, 2308, 2683, 2906, 3424, 3519, 3679, 3923, 4999, 5372, 5618, 6092, 6506, 6866, 7209, 7304, 7722, 8349, 8485, 8626, 8829, 8925, 9025, 9425, 9630, 9932]",19959,18980,15664,9574,9932,9540,-160,3325,5095,2203,20003,35,radiant
7569905905,48,76,33,53,26,"[0, 255, 519, 1093, 1468, 1841, 2430, 2854, 3309, 3497, 4006, 4635, 5187, 5804, 6151, 6892, 8042, 9274, 9924, 10937, 12088, 12889, 13523, 14284, 15621, 16881, 17749, 19023, 19696, 20486, 21237, 22924, 23239, 24728, 26523]","[0, 248, 601, 879, 1441, 1729, 2077, 2335, 2720, 3107, 3568, 3811, 4281, 4754, 5336, 5911, 6313, 6691, 7232, 7729, 8054, 8427, 9425, 9803, 10564, 10876, 12014, 12814, 13536, 14486, 15782, 16858, 17418, 18796, 20015]","[0, 280, 925, 1466, 2075, 2482, 3093, 3801, 4472, 5119, 5570, 5940, 6446, 6611, 7389, 7995, 8789, 9733, 10323, 10912, 11515, 11789, 12056, 12402, 13468, 13634, 14268, 15097, 15661, 16022, 16828, 17438, 17614, 18244, 19412]","[0, 210, 341, 519, 789, 923, 1077, 1806, 2121, 2421, 2902, 3121, 3590, 4402, 4749, 4880, 5511, 5806, 6039, 6605, 6924, 7191, 7869, 8265, 8942, 9557, 10060, 10412, 11001, 11269, 12270, 12929, 13331, 14753, 16041]","[0, 210, 394, 552, 744, 834, 1056, 1732, 1958, 2379, 2559, 2649, 2758, 3032, 3287, 3382, 3929, 4554, 4649, 4807, 4957, 5406, 5705, 5949, 6119, 6616, 7075, 7407, 7703, 7936, 8290, 9070, 9245, 10095, 11078]",26523,20015,19412,16041,11078,98,41,112,3,100,"[0, 203, 499, 831, 1113, 1454, 1967, 2375, 2794, 3905, 4542, 4791, 5078, 6049, 6416, 7274, 7986, 8207, 8659, 9173, 10030, 10987, 11366, 11780, 13875, 13969, 15097, 15702, 16938, 17580, 18230, 19087, 19643, 20684, 20808]","[0, 279, 578, 943, 1195, 1478, 1759, 2013, 2564, 2960, 3401, 4217, 4465, 5233, 5551, 5902, 6729, 6915, 7483, 7910, 8787, 9344, 9511, 9711, 10530, 10789, 11042, 11672, 12271, 12883, 13086, 13945, 14965, 15723, 15837]","[0, 205, 687, 820, 969, 1211, 1508, 2066, 2450, 2592, 3773, 4239, 4588, 5726, 6109, 6414, 7121, 7215, 7555, 8065, 8959, 9285, 9920, 10672, 10938, 11549, 11644, 12074, 12547, 13001, 13180, 13304, 13678, 13868, 14097]","[0, 130, 257, 367, 610, 700, 889, 979, 1159, 1604, 2026, 2287, 2377, 2815, 3255, 3757, 4205, 4863, 5106, 5285, 5890, 6364, 6714, 6933, 7451, 7745, 8174, 8489, 9084, 9499, 9984, 10255, 11169, 11434, 11660]","[0, 130, 309, 399, 549, 639, 729, 948, 1128, 1573, 1763, 2024, 2197, 2917, 3449, 3754, 4273, 4422, 4517, 4675, 5067, 5281, 5523, 5693, 6290, 6845, 7468, 8019, 8280, 8532, 8748, 8888, 8988, 9178, 9326]",20808,15837,14097,11660,9326,5715,4178,5315,4381,1752,21341,35,radiant
7569953309,46,74,120,65,26,"[0, 541, 942, 1239, 1732, 2097, 2597, 3235, 3721, 4369, 5008, 5358, 5831, 6678, 7268, 7965, 8517, 8961, 9553, 10010, 10348, 11040, 11557, 11812, 11968, 12865, 13294, 14763, 15789, 16595, 17522, 18011, 18951, 20768, 22094]","[0, 264, 662, 791, 1276, 1448, 2039, 2250, 2761, 3239, 3574, 3814, 4532, 5103, 5684, 6255, 6666, 7029, 7595, 8922, 9563, 10534, 11224, 11697, 12186, 13240, 13536, 14451, 15312, 16277, 17138, 17884, 18341, 19708, 21727]","[0, 192, 589, 1049, 1266, 1659, 2100, 2394, 2848, 3298, 3857, 4042, 4263, 4920, 5530, 6066, 6438, 7008, 7819, 8147, 8569, 8961, 9825, 10281, 10376, 10660, 10917, 11245, 11979, 12530, 12716, 13448, 13811, 14215, 14492]","[0, 130, 220, 573, 728, 931, 1243, 1450, 1540, 1750, 2200, 2486, 2576, 3176, 3711, 4113, 4490, 4664, 4759, 5087, 5182, 5661, 6307, 6474, 6569, 7317, 8078, 8616, 9012, 9411, 9878, 10600, 10919, 11920, 12020]","[0, 192, 362, 549, 639, 897, 1083, 1219, 1459, 1711, 2102, 2192, 2349, 2676, 2794, 2889, 3261, 3401, 3496, 3853, 4023, 4336, 4687, 4992, 5162, 5495, 6079, 6692, 7071, 7284, 7705, 8472, 8866, 9327, 10398]",22094,21727,14492,12020,10398,49,135,59,123,72,"[0, 247, 640, 926, 1499, 1915, 2507, 2889, 3613, 4396, 4950, 5533, 6114, 6777, 7426, 8085, 9059, 9627, 10378, 11041, 11728, 12506, 13437, 13851, 15214, 15986, 17079, 18375, 19181, 20034, 20926, 22397, 23762, 26562, 27022]","[0, 248, 710, 1031, 1528, 1957, 2416, 3202, 3676, 4122, 5141, 5992, 6504, 7052, 7758, 8535, 9276, 9931, 10337, 11252, 11808, 12574, 12864, 13253, 14407, 15190, 15998, 16093, 16661, 17538, 18321, 18956, 19913, 21096, 21351]","[0, 332, 633, 941, 1235, 1568, 1861, 2303, 2752, 3327, 4259, 4751, 5451, 6247, 6558, 7402, 8540, 9154, 9771, 10832, 11728, 12592, 13058, 13472, 14163, 15225, 15745, 16660, 17734, 18386, 18860, 19498, 20147, 20759, 21372]","[0, 210, 402, 976, 1066, 1707, 1866, 2168, 2348, 2600, 2958, 3227, 3654, 4094, 4631, 5259, 5858, 6336, 6605, 7106, 7612, 8217, 8312, 8527, 9363, 10167, 10461, 10556, 11224, 11477, 11788, 12258, 12725, 13870, 14222]","[0, 210, 372, 462, 561, 814, 904, 994, 1174, 1591, 1841, 2163, 2379, 2684, 2832, 3165, 3598, 3973, 4488, 5476, 5719, 6132, 6227, 6322, 6950, 7586, 7838, 8579, 9003, 9099, 9410, 9924, 10294, 11760, 12112]",27022,21351,21372,14222,12112,-4928,376,-6880,-2202,-1714,-15348,35,dire
7570468116,49,80,28,86,3,"[0, 247, 614, 1093, 1370, 2068, 2367, 2927, 3419, 3768, 4350, 4565, 5527, 6179, 6725, 7429, 8137, 8957, 9767, 10319, 11602, 11905, 12908, 13594, 14245, 14542, 15265, 16139, 17086, 17917, 18875, 19435, 20778, 21539, 22444]","[0, 206, 409, 684, 927, 1366, 1692, 1986, 2357, 2820, 3290, 3719, 4602, 5125, 5582, 5929, 7269, 7679, 8644, 9278, 11355, 11960, 13457, 14589, 15440, 15712, 17154, 17981, 18220, 19055, 19678, 19958, 20866, 21567, 22163]","[0, 212, 636, 979, 1395, 1771, 2155, 2698, 3141, 3651, 4115, 4354, 5080, 5549, 5872, 6853, 7400, 7882, 8461, 8906, 9612, 9707, 10838, 11513, 12156, 12584, 13166, 13601, 13840, 14488, 15248, 15486, 16706, 17489, 18028]","[0, 129, 269, 481, 728, 905, 1040, 1168, 1483, 1573, 1753, 2150, 2537, 3185, 3588, 4017, 4552, 4839, 5310, 5468, 6324, 6604, 7129, 7665, 8003, 8190, 8608, 8943, 9182, 9359, 9825, 9925, 11498, 11733, 11833]","[0, 129, 564, 911, 1050, 1230, 1836, 1926, 2147, 2237, 2417, 2617, 3091, 3497, 3752, 3873, 4182, 4393, 4928, 5350, 5751, 5982, 6520, 7005, 7188, 7283, 7761, 8081, 8231, 8514, 9029, 9206, 10113, 10506, 10606]",22444,22163,18028,11833,10606,89,17,71,26,85,"[0, 243, 605, 950, 1233, 1571, 1947, 2418, 3002, 3329, 3806, 4474, 4971, 5945, 6748, 7240, 8240, 9049, 9446, 10930, 12114, 12423, 13617, 13712, 14637, 15767, 16812, 17517, 19122, 20140, 21226, 22399, 22766, 22866, 24018]","[0, 365, 734, 1149, 1374, 1791, 2167, 2422, 3098, 3861, 4208, 4589, 4974, 5234, 5795, 6242, 6841, 7289, 8404, 9030, 9664, 9846, 10205, 10300, 12995, 13650, 14294, 14389, 15816, 16446, 16714, 17153, 17786, 18565, 19339]","[0, 209, 440, 902, 1189, 1521, 1878, 2172, 2628, 3255, 3445, 3889, 4398, 4808, 5539, 6023, 6207, 6608, 7158, 7877, 8269, 8860, 9177, 9656, 10386, 11283, 11598, 11853, 12477, 13113, 13473, 14274, 14832, 15262, 15821]","[0, 209, 299, 635, 725, 908, 1159, 1249, 1697, 1826, 2100, 2467, 2937, 3106, 3681, 3946, 4168, 4478, 4744, 4992, 5384, 5851, 6173, 6373, 6898, 7065, 7263, 7441, 8880, 9275, 9433, 9533, 9900, 10594, 11094]","[0, 209, 344, 464, 601, 1035, 1169, 1319, 1735, 1825, 2080, 2308, 2616, 2779, 3061, 3156, 3286, 3617, 3970, 4418, 4513, 4764, 5089, 5184, 6109, 6708, 7170, 7845, 8801, 9007, 9103, 9203, 9570, 9853, 10133]",24018,19339,15821,11094,10133,-1574,2824,2207,739,473,4669,35,radiant
7570519515,82,49,51,66,86,"[0, 215, 484, 718, 1082, 1442, 1771, 2252, 2831, 3575, 4187, 4867, 5373, 6114, 6649, 7547, 8794, 9777, 10734, 12113, 12775, 14409, 15581, 16664, 17637, 18152, 18948, 19893, 20423, 21319, 22799, 23636, 24246, 24346, 25536]","[0, 220, 575, 980, 1426, 1805, 2203, 2805, 3143, 3438, 3813, 4331, 4930, 5354, 5603, 6522, 7149, 7817, 8350, 9504, 9934, 10731, 11533, 12454, 13604, 14234, 14918, 16335, 17053, 17763, 18115, 19178, 19870, 19970, 21244]","[0, 202, 443, 964, 1251, 1719, 2011, 2551, 2997, 3296, 3985, 4639, 5048, 5748, 5880, 6169, 6647, 7097, 7688, 8052, 8311, 9698, 10423, 10805, 11524, 11737, 11877, 12137, 12233, 12890, 13562, 14755, 15144, 15578, 16132]","[0, 130, 220, 310, 471, 674, 852, 1102, 1276, 1366, 1716, 1827, 2042, 2571, 2779, 3067, 3761, 4039, 4420, 4956, 5270, 5893, 6245, 6726, 6978, 7425, 7818, 8407, 8724, 8895, 9435, 10190, 10716, 11061, 11426]","[0, 130, 220, 432, 522, 631, 727, 907, 1042, 1207, 1367, 1542, 1632, 2078, 2345, 2664, 2934, 3396, 3804, 4060, 4318, 4664, 5008, 5350, 5587, 5999, 6142, 6347, 6443, 6634, 6974, 7528, 8016, 8586, 8872]",25536,21244,16132,11426,8872,10,129,23,58,105,"[0, 262, 541, 890, 1259, 1813, 2311, 2681, 3169, 3647, 4321, 4877, 5530, 6150, 6695, 7268, 7890, 8745, 9503, 10386, 11264, 12204, 12639, 13344, 14134, 14812, 15673, 17292, 17994, 19444, 19994, 20274, 21334, 21909, 23039]","[0, 336, 580, 1306, 1740, 2335, 2828, 3375, 3952, 4652, 5137, 5891, 6634, 7392, 7903, 8524, 9218, 9978, 10994, 11477, 11749, 12522, 12616, 12820, 13737, 14261, 14800, 15967, 16532, 17429, 18696, 19806, 20585, 20898, 22132]","[0, 253, 622, 1006, 1376, 1758, 2141, 2546, 3145, 3737, 4450, 4788, 5240, 5952, 6609, 7000, 7738, 8587, 9187, 9696, 10246, 10568, 10885, 11509, 12354, 12647, 13072, 14170, 14475, 15419, 15969, 16392, 18000, 18247, 18545]","[0, 210, 300, 420, 510, 689, 839, 1125, 1323, 1719, 1979, 2288, 2414, 2633, 2961, 3213, 3755, 4157, 4483, 4742, 5037, 5132, 5412, 5579, 5862, 6225, 6402, 7232, 7807, 8437, 9283, 9563, 10047, 10282, 10632]","[0, 210, 300, 490, 580, 710, 845, 1155, 1377, 1626, 2152, 2371, 2655, 2840, 3127, 3259, 3889, 4328, 4714, 5252, 5347, 5459, 5553, 5720, 6169, 6264, 6436, 7087, 7313, 7634, 7972, 8447, 9046, 9256, 9356]",23039,22132,18545,10632,9356,2497,-888,-2413,794,-484,-494,35,radiant
7570561812,15,19,96,20,112,"[0, 207, 530, 862, 1137, 1542, 1863, 2199, 2568, 2858, 3831, 4327, 5008, 5400, 5646, 6332, 7090, 8006, 8652, 10048, 10842, 11152, 12007, 13090, 14023, 14882, 15744, 16971, 17399, 18125, 18982, 19633, 21356, 22010, 23570]","[0, 283, 564, 969, 1250, 1453, 1801, 2201, 2674, 3060, 3851, 4688, 5044, 5934, 6539, 6988, 7655, 8958, 9642, 10497, 10592, 11138, 11268, 11989, 13042, 13721, 14118, 15152, 15501, 16375, 17067, 17333, 18606, 19064, 20680]","[0, 419, 720, 885, 1206, 1444, 1900, 2490, 2894, 3180, 3680, 4249, 4740, 5465, 5922, 6802, 7181, 8013, 8752, 9256, 9713, 10072, 10167, 11009, 11394, 12791, 13405, 13956, 14359, 15376, 15655, 15868, 16658, 17057, 18175]","[0, 169, 259, 397, 522, 892, 1084, 1174, 1264, 1490, 1724, 1995, 2131, 2614, 3040, 3278, 3493, 3772, 3867, 4714, 4809, 5125, 5229, 5832, 6483, 7011, 7289, 7840, 7936, 8375, 8782, 8921, 9489, 9865, 11030]","[0, 249, 339, 467, 641, 731, 861, 1071, 1206, 1341, 1615, 1896, 2082, 2457, 2939, 3225, 3371, 3708, 3974, 4068, 4495, 4590, 4747, 5333, 5659, 6073, 6594, 6890, 7399, 8126, 8618, 8718, 9332, 9566, 10075]",23570,20680,18175,11030,10075,1,49,61,62,123,"[0, 242, 533, 975, 1343, 1771, 2263, 2547, 2768, 3515, 3776, 4287, 5077, 5172, 5896, 6451, 7277, 8239, 9064, 9945, 10843, 11991, 13640, 14905, 16098, 17233, 18576, 19351, 19855, 20804, 22036, 23535, 24499, 24698, 25983]","[0, 208, 405, 730, 977, 1301, 1680, 1946, 2583, 3109, 3388, 3761, 4378, 4824, 5027, 5381, 5937, 6338, 7024, 7758, 7916, 8601, 9626, 10224, 10829, 11014, 11390, 11701, 12927, 13588, 14436, 15945, 16814, 16914, 18426]","[0, 602, 887, 1094, 1371, 1536, 2032, 2766, 3162, 3514, 4135, 4563, 5045, 5645, 6410, 6845, 7401, 8318, 8818, 10035, 10233, 11136, 12462, 12974, 13069, 13547, 14095, 14879, 15771, 16361, 16457, 17188, 17533, 18196, 18566]","[100, 327, 417, 531, 693, 827, 1027, 1182, 1398, 1533, 2492, 3119, 3389, 3520, 4437, 4531, 4915, 5609, 5796, 6617, 7227, 7691, 8648, 8982, 9113, 9298, 9749, 10239, 10915, 11121, 11501, 12703, 12827, 13333, 13703]","[0, 227, 317, 430, 553, 784, 964, 1192, 1282, 1545, 1816, 2035, 2305, 2422, 2625, 2719, 3050, 3844, 4130, 4832, 5371, 5874, 6403, 6753, 7325, 7984, 8374, 9648, 10093, 10299, 10395, 11171, 11741, 12158, 12528]",25983,18426,18566,13703,12528,-2413,2254,-391,-2673,-2453,-5676,35,radiant
7570740708,49,35,28,53,123,"[0, 170, 547, 788, 999, 1303, 1687, 2162, 2612, 3049, 3327, 3942, 4473, 5001, 5729, 6306, 6939, 7120, 7433, 8301, 8652, 8855, 9481, 9989, 10345, 11172, 12143, 12238, 14099, 14844, 15876, 16294, 17134, 17730, 18369]","[0, 297, 487, 893, 1120, 1518, 1745, 1967, 2383, 2732, 3242, 3879, 4599, 5168, 5701, 6348, 7029, 7518, 8134, 8516, 9138, 9465, 10370, 10952, 11953, 12589, 13356, 14245, 15861, 16449, 16683, 17615, 18707, 19482, 19804]","[0, 284, 572, 986, 1542, 2333, 2868, 3512, 4115, 4407, 5695, 5903, 6869, 7602, 8199, 8350, 9019, 9700, 10034, 10285, 10848, 10943, 11948, 12176, 12638, 13336, 13896, 14303, 14719, 15031, 15555, 16145, 16890, 17426, 17819]","[0, 170, 285, 375, 549, 729, 1031, 1242, 1625, 1806, 1986, 2326, 2659, 3168, 3653, 4277, 4823, 5378, 6098, 6361, 6632, 6760, 7040, 7536, 8072, 8528, 9324, 9897, 11337, 11761, 12016, 13099, 13850, 14871, 15140]","[0, 170, 285, 375, 559, 864, 1041, 1243, 1359, 1969, 2149, 2281, 2695, 2987, 3291, 3441, 4009, 4364, 4631, 4822, 5171, 5266, 5572, 5849, 6232, 6740, 7302, 8223, 8596, 9240, 9547, 10052, 10395, 10719, 10819]",18369,19804,17819,15140,10819,73,43,29,105,20,"[0, 289, 695, 1056, 1442, 1678, 2215, 3180, 3346, 3634, 3892, 4578, 5036, 5819, 6782, 7867, 8714, 10024, 10778, 12231, 13680, 14428, 15838, 16996, 18668, 19831, 21336, 21431, 22039, 22135, 22992, 24310, 25590, 25896, 27429]","[0, 291, 653, 1028, 1413, 1938, 2514, 3220, 3749, 4598, 5457, 5973, 6194, 6715, 7242, 7893, 8402, 9003, 9168, 9963, 10580, 10849, 11774, 12294, 12830, 13376, 14059, 14581, 15557, 15677, 16088, 16663, 17210, 17608, 19090]","[0, 291, 612, 935, 1360, 1724, 2040, 2577, 2725, 3254, 3790, 4302, 4784, 5381, 5932, 6208, 6664, 7315, 7847, 8440, 8793, 9194, 9956, 10604, 11272, 11367, 11894, 12300, 12594, 12765, 13449, 14109, 14486, 14719, 15960]","[0, 170, 260, 703, 958, 1048, 1221, 1615, 2014, 2277, 2542, 2772, 3177, 3451, 3722, 3871, 4035, 4472, 4813, 5124, 5320, 6199, 6649, 6972, 7274, 7369, 8024, 8538, 9211, 9881, 10398, 10773, 11768, 11868, 13084]","[100, 322, 412, 549, 639, 959, 1116, 1412, 1578, 1834, 2044, 2229, 2326, 2566, 2761, 2955, 3236, 3415, 3511, 3779, 4195, 4468, 4665, 4760, 5054, 5149, 5435, 5574, 6002, 6098, 6194, 6738, 6838, 6938, 7631]",27429,19090,15960,13084,7631,-9060,714,1859,2056,3188,-1243,35,dire
7570812500,10,17,123,38,21,"[0, 242, 521, 717, 1095, 1546, 1893, 2256, 2796, 3431, 3763, 4589, 5462, 6242, 6650, 7328, 8143, 8777, 10206, 10812, 11424, 12149, 13245, 14177, 14977, 15895, 16910, 17004, 17660, 18971, 19974, 21741, 22765, 23562, 23842]","[0, 277, 602, 970, 1370, 1682, 2193, 2752, 3351, 3889, 4443, 4780, 5879, 6597, 6958, 7546, 8444, 9044, 9845, 10200, 10899, 11675, 12381, 13027, 14038, 14426, 15105, 15802, 16173, 16378, 16773, 17086, 17650, 17750, 18487]","[0, 317, 407, 595, 798, 1019, 1352, 1536, 1626, 1716, 1851, 2253, 3065, 3550, 4066, 4450, 4890, 5316, 5720, 6282, 7246, 8070, 8684, 9156, 9747, 10677, 11502, 11813, 12372, 13056, 13914, 14548, 15568, 15877, 16600]","[0, 239, 505, 788, 1338, 1719, 1944, 2325, 2887, 3069, 3416, 4088, 4722, 5421, 5806, 6725, 7603, 7788, 8436, 8831, 9558, 10050, 10796, 11212, 11610, 11985, 13097, 13191, 13747, 14123, 14333, 14851, 15458, 15767, 16773]","[0, 221, 360, 453, 717, 891, 1142, 1325, 1545, 1804, 2006, 2308, 2959, 3297, 3493, 4119, 4480, 4748, 5259, 5517, 6401, 6729, 7186, 7473, 7638, 7869, 8267, 8661, 8919, 9015, 9410, 9915, 10540, 10640, 11038]",23842,18487,16600,16773,11038,95,57,98,37,86,"[0, 209, 561, 975, 1173, 1578, 1811, 2659, 3034, 3332, 3894, 4211, 4844, 5431, 5942, 6485, 7265, 7649, 8580, 9179, 10210, 10970, 11445, 12381, 12956, 13678, 14333, 16444, 18210, 18764, 19416, 20154, 20862, 22465, 23641]","[0, 294, 623, 1036, 1373, 1672, 1879, 2425, 2826, 3174, 3662, 4171, 4380, 4740, 5005, 5194, 5616, 6266, 6746, 7499, 7731, 7955, 8217, 8529, 9128, 9544, 9917, 10294, 10873, 11337, 11557, 11903, 12373, 13701, 14404]","[0, 258, 458, 820, 1093, 1420, 1802, 2013, 2229, 2546, 2935, 3202, 3292, 3630, 4341, 4604, 4858, 5510, 6615, 7175, 7704, 8421, 8825, 9239, 9529, 9808, 10078, 10602, 11203, 11656, 12131, 12273, 12488, 14180, 14997]","[0, 170, 260, 398, 528, 618, 727, 817, 952, 1077, 1304, 1443, 1667, 1875, 2214, 2498, 2676, 3041, 3586, 3947, 4041, 4375, 4617, 4787, 5007, 5901, 6159, 6895, 7606, 7912, 8240, 8500, 9423, 9952, 10809]","[0, 170, 260, 395, 573, 953, 1095, 1309, 1488, 1613, 1901, 2065, 2155, 2295, 2443, 2584, 2854, 3220, 3966, 4116, 4507, 5004, 5246, 5692, 6006, 6372, 6856, 7568, 8343, 8779, 9366, 9844, 10389, 11071, 11510]",23641,14404,14997,10809,11510,201,4083,1603,5964,-472,11379,35,dire
7571494203,4,23,135,86,20,"[0, 241, 518, 901, 1233, 1415, 1671, 1870, 2261, 2689, 3117, 3570, 4189, 4476, 5045, 5778, 6460, 7338, 8035, 8774, 10111, 10895, 11491, 12583, 13161, 14313, 15115, 15934, 16596, 16839, 16935, 17653, 18124, 18670, 20444]","[0, 244, 485, 894, 1354, 1602, 2047, 2483, 3172, 3554, 4130, 4822, 5161, 5595, 6403, 6904, 7640, 8050, 9047, 9774, 10859, 11227, 11574, 12343, 13371, 14205, 14570, 14861, 15184, 15688, 16154, 16911, 17475, 18080, 19264]","[0, 208, 588, 763, 1224, 1494, 1929, 2101, 2512, 3174, 3497, 4209, 4512, 4907, 5142, 5747, 6943, 7258, 7988, 8485, 9346, 9828, 10669, 11626, 12495, 13149, 13543, 13947, 14427, 14670, 15037, 15584, 15810, 16379, 16946]","[0, 169, 600, 779, 998, 1088, 1542, 1680, 1815, 2057, 2482, 2703, 3126, 3752, 4110, 4387, 4977, 5233, 5827, 6168, 7358, 7733, 7975, 8882, 9971, 10380, 10636, 11034, 11250, 11719, 12481, 12961, 13399, 13741, 14715]","[0, 169, 311, 481, 611, 929, 1133, 1223, 1564, 1802, 1937, 2417, 2537, 2724, 3364, 3641, 3945, 4040, 4521, 4768, 5287, 5454, 5705, 6585, 7140, 7504, 7599, 7859, 8082, 8325, 8582, 8957, 9646, 10070, 11229]",20444,19264,16946,14715,11229,114,97,120,58,26,"[0, 203, 473, 842, 1255, 1711, 1956, 2348, 2636, 2854, 3602, 4142, 4733, 5293, 5908, 6448, 7569, 8134, 8883, 9390, 9940, 10349, 11054, 11498, 11593, 12369, 13870, 14740, 15887, 18263, 18688, 19598, 20980, 22391, 23383]","[0, 203, 432, 681, 965, 1384, 1871, 2287, 2951, 3551, 4054, 4451, 4874, 5560, 5745, 6313, 6534, 6973, 7581, 8434, 8627, 8828, 10108, 10540, 11182, 12142, 13208, 14053, 14952, 15623, 16552, 17338, 18393, 19305, 19605]","[0, 251, 721, 1189, 1560, 1855, 2188, 2432, 3081, 3542, 4242, 5037, 5405, 5905, 6399, 6588, 7215, 8180, 8275, 8675, 8868, 9024, 9996, 10544, 10639, 11617, 11905, 12563, 13215, 13918, 14665, 14906, 15369, 15969, 16428]","[0, 169, 321, 458, 588, 965, 1074, 1417, 1604, 1946, 2241, 2390, 2747, 3085, 3646, 3777, 4056, 4253, 4431, 4676, 5005, 5284, 5972, 6122, 6576, 6981, 7685, 8034, 8828, 9506, 9906, 10096, 10633, 10892, 11426]","[0, 169, 284, 374, 504, 638, 728, 922, 1102, 1236, 1669, 1884, 2072, 2275, 2589, 2728, 3144, 3288, 3383, 3646, 3839, 4195, 4667, 4761, 4942, 5477, 5858, 6072, 6663, 7300, 7693, 7883, 8145, 8355, 8655]",23383,19605,16428,11426,8655,-2939,-341,518,3289,2574,3101,35,radiant
7571688104,94,13,97,84,45,"[0, 200, 497, 773, 1057, 1480, 1743, 2445, 3304, 3799, 4543, 5041, 5509, 6345, 7198, 7846, 8712, 9494, 9664, 10320, 10822, 12042, 12893, 14231, 15049, 15984, 16722, 17857, 19317, 19413, 20828, 22035, 23326, 26338, 27443]","[0, 280, 579, 876, 1293, 1552, 2103, 2452, 2799, 3264, 3601, 4417, 4759, 5302, 6140, 6831, 7310, 7632, 7727, 8619, 8939, 9034, 9441, 10211, 11078, 11755, 12060, 12775, 13850, 14269, 15960, 16540, 17747, 18980, 19934]","[0, 167, 483, 812, 1027, 1313, 1667, 2346, 2956, 3337, 3472, 4068, 4282, 4901, 5310, 5552, 5869, 6586, 6681, 6838, 7063, 7158, 7253, 7658, 7986, 8153, 8633, 9223, 9847, 10126, 11124, 11322, 12127, 12922, 13947]","[0, 269, 359, 493, 583, 983, 1331, 1511, 1782, 2008, 2143, 2233, 2442, 2608, 3063, 3292, 3480, 3638, 3733, 3890, 4254, 4349, 4694, 4788, 5203, 5405, 5889, 6320, 6631, 6727, 7448, 8251, 8463, 9588, 9798]","[18, 453, 789, 879, 969, 1219, 1416, 1596, 1686, 1998, 2260, 2534, 2677, 2977, 3340, 3504, 3895, 4398, 4493, 4650, 4966, 5061, 5156, 5250, 5578, 5745, 6345, 6441, 6703, 6903, 7340, 7838, 8025, 9137, 9347]",27443,19934,13947,9798,9347,41,106,33,40,30,"[0, 368, 681, 1063, 1268, 1706, 2138, 2701, 3200, 3434, 4115, 4750, 5469, 6133, 7419, 8301, 9101, 10140, 11560, 12750, 13703, 15539, 16535, 17347, 17936, 18905, 20149, 21111, 22602, 24349, 25813, 26003, 26583, 27051, 27151]","[0, 412, 711, 1003, 1250, 1429, 1554, 2028, 2315, 2691, 3863, 4007, 4580, 4729, 5134, 5999, 6391, 6614, 7514, 8050, 8350, 9735, 10342, 11056, 11754, 12606, 13107, 13607, 13989, 14830, 16159, 16737, 17483, 18467, 18567]","[0, 250, 475, 790, 1172, 1608, 1805, 2665, 2831, 2958, 3126, 3358, 3842, 4452, 4911, 5649, 6284, 6661, 6980, 7543, 8360, 8879, 9660, 10030, 10704, 10909, 11700, 12336, 13003, 13718, 15191, 15697, 16217, 16317, 17089]","[0, 250, 365, 722, 1143, 1278, 1602, 1788, 1878, 1968, 2093, 2237, 3150, 3382, 3722, 4147, 4425, 4638, 5241, 5705, 5875, 6328, 6579, 6835, 7351, 7716, 8207, 8576, 9012, 9732, 10868, 11058, 11282, 11806, 12009]","[0, 284, 399, 489, 659, 835, 925, 1462, 1670, 1760, 2275, 2419, 2910, 3363, 3618, 3987, 4212, 4546, 5033, 5319, 5657, 5967, 6206, 6372, 6674, 7185, 7611, 7867, 8149, 9203, 10085, 10368, 10573, 11314, 11414]",27151,18567,17089,12009,11414,292,1367,-3142,-2211,-2067,-5761,35,dire
7573242905,38,11,106,105,86,"[0, 533, 931, 1173, 1584, 1989, 2466, 2875, 3581, 4347, 4825, 5247, 5756, 6316, 6840, 7722, 8566, 10012, 10692, 11790, 12511, 13856, 14738, 14897, 15945, 16539, 16715, 17557, 18598, 20429, 21088, 22584, 23191, 23932, 26316]","[0, 328, 650, 859, 1405, 1785, 2284, 2688, 3055, 3454, 4018, 4585, 4941, 5491, 5960, 6497, 7086, 7775, 8309, 8577, 9284, 9872, 10291, 10837, 11172, 11422, 13318, 13621, 14228, 15962, 16985, 18936, 19289, 19522, 20970]","[0, 357, 755, 1073, 1410, 1737, 2162, 2809, 3146, 3645, 4146, 4698, 5048, 5564, 5886, 6406, 7103, 7296, 7523, 7791, 8256, 8423, 9074, 10562, 10656, 11369, 11954, 12048, 12904, 13612, 14154, 14469, 14837, 15378, 15950]","[0, 170, 260, 350, 512, 650, 838, 1037, 1376, 1675, 1972, 2541, 2948, 3498, 4185, 4614, 5482, 5887, 6354, 6822, 7208, 7690, 7947, 8272, 8366, 8461, 8877, 8971, 9249, 10278, 10669, 11723, 11942, 12256, 13131]","[0, 231, 321, 411, 545, 715, 941, 1031, 1544, 1724, 1904, 2203, 2630, 2954, 3049, 3278, 3471, 3681, 3900, 4168, 4591, 4797, 5054, 5427, 5521, 5616, 5963, 6254, 6431, 7135, 7480, 8220, 8320, 8420, 9254]",26316,20970,15950,13131,9254,71,22,41,119,5,"[0, 205, 511, 772, 1177, 1745, 2037, 2526, 3110, 3796, 4570, 4939, 6072, 6389, 6644, 7235, 7768, 7968, 8797, 9787, 10723, 11616, 12624, 13470, 14048, 15448, 16258, 16352, 17323, 17773, 17869, 19143, 19243, 20650, 22002]","[0, 334, 662, 916, 1259, 1663, 2039, 2248, 2577, 3138, 3485, 3883, 4577, 5138, 5986, 6081, 6453, 7605, 8091, 9557, 10497, 11605, 12364, 13248, 14256, 15498, 16519, 17834, 18239, 18857, 18953, 19724, 20641, 21267, 21815]","[0, 170, 332, 572, 775, 999, 1251, 1378, 1582, 1898, 2457, 2817, 3329, 3810, 4141, 4761, 5161, 5888, 6837, 7791, 8819, 9532, 9855, 10794, 12012, 13110, 13689, 14694, 15700, 16341, 16941, 18185, 19929, 20827, 21017]","[0, 170, 260, 396, 575, 665, 800, 890, 1349, 1698, 1790, 1880, 2436, 2574, 2843, 3158, 3742, 4513, 4735, 5392, 5668, 5921, 6675, 6999, 8318, 9042, 9381, 9816, 10371, 10482, 10578, 11095, 11346, 11925, 12535]","[0, 251, 341, 431, 600, 690, 825, 915, 1050, 1306, 1416, 1590, 1974, 2068, 2163, 2616, 2999, 3582, 3767, 4099, 4375, 4470, 4610, 4922, 5944, 6623, 6718, 7032, 7420, 7652, 7911, 8137, 8237, 8427, 8776]",22002,21815,21017,12535,8776,4314,-845,-5067,596,478,-524,35,radiant
7573302602,46,29,39,121,31,"[0, 213, 685, 1282, 1711, 2166, 2830, 3352, 3993, 4508, 4995, 5530, 6134, 6852, 7607, 8112, 8645, 9245, 9507, 9743, 10389, 11533, 13060, 13154, 14062, 15905, 17447, 18279, 18456, 19292, 20850, 22110, 22909, 24551, 25994]","[0, 203, 481, 678, 1197, 1478, 1907, 2185, 2596, 3188, 3974, 4546, 5206, 5754, 6061, 6533, 6905, 7758, 8019, 8484, 8876, 9244, 10298, 10392, 10898, 11705, 12423, 12778, 13423, 14158, 14548, 15393, 16264, 17422, 17646]","[0, 241, 576, 1035, 1360, 1736, 2167, 2613, 3108, 3715, 4365, 4699, 5791, 6101, 6362, 6804, 7251, 7697, 7826, 8163, 8523, 8778, 9799, 9893, 10148, 10499, 10976, 11553, 11835, 12543, 12933, 13521, 14262, 15187, 15957]","[0, 130, 220, 310, 492, 630, 801, 938, 1076, 1263, 1882, 1972, 2152, 2403, 2498, 2870, 3011, 3241, 3336, 3626, 4421, 4602, 5122, 5382, 5805, 6326, 6829, 7492, 7708, 8527, 8917, 9386, 9811, 11252, 11352]","[0, 130, 575, 742, 898, 1037, 1171, 1436, 1573, 1760, 2086, 2623, 3056, 3369, 3464, 3668, 3763, 4038, 4133, 4369, 4464, 4631, 5252, 5421, 5591, 6148, 6590, 6759, 7046, 7754, 8219, 8656, 9081, 9325, 9425]",25994,17646,15957,11352,9425,95,16,71,23,101,"[0, 364, 564, 868, 1394, 1703, 2119, 2631, 3048, 3219, 3655, 4043, 4737, 5105, 5628, 6405, 7170, 7833, 8764, 9243, 10685, 11325, 12152, 12356, 13296, 13638, 14362, 15957, 17209, 18582, 18678, 19077, 20207, 21078, 21268]","[0, 291, 537, 1255, 1671, 1918, 2148, 2500, 2881, 3090, 3572, 3991, 4838, 5557, 5885, 6896, 7482, 7768, 8100, 9046, 9635, 9898, 10749, 11789, 12318, 12718, 12894, 13865, 14673, 15269, 16053, 16866, 17942, 18807, 20085]","[0, 210, 300, 407, 603, 732, 979, 1110, 1245, 1910, 2221, 2311, 2401, 2765, 3144, 3880, 4380, 4801, 5323, 6172, 7223, 7807, 8988, 9387, 10050, 10518, 11264, 11873, 12736, 13101, 13306, 14012, 14312, 14817, 15658]","[0, 377, 728, 1126, 1584, 1997, 2362, 2751, 3091, 3478, 3869, 4067, 4251, 5083, 5794, 7416, 8140, 8657, 8889, 9438, 9759, 10546, 11159, 11253, 11881, 12244, 12487, 12679, 13253, 14250, 14568, 14963, 15555, 16491, 17105]","[0, 210, 300, 508, 638, 792, 882, 1275, 1410, 1632, 2234, 2609, 2745, 3074, 3277, 3857, 4245, 4340, 4521, 5308, 5466, 5645, 6486, 6580, 6957, 7226, 7610, 8074, 8648, 9244, 9696, 9796, 10096, 10196, 10573]",21268,20085,15658,17105,10573,4726,-2439,299,-5753,-1148,-4315,35,dire
7573491301,98,67,33,9,19,"[0, 281, 481, 897, 1301, 1720, 2136, 2617, 3176, 3587, 4941, 5277, 6382, 7092, 7754, 9032, 9780, 10446, 11291, 12000, 12603, 12833, 13605, 14610, 14957, 16175, 17049, 17143, 17795, 18307, 18403, 18739, 18854, 19130, 20179]","[0, 165, 449, 809, 1167, 1457, 1661, 1896, 2061, 2374, 2711, 3228, 3511, 4051, 4725, 5613, 6313, 6865, 7645, 8152, 8757, 9396, 9691, 10655, 10750, 11558, 12518, 13260, 14014, 14872, 14968, 15255, 16153, 16879, 17756]","[0, 253, 578, 1015, 1502, 1919, 2373, 2748, 3141, 3599, 4075, 4702, 5369, 6060, 6460, 7070, 7690, 8379, 8956, 9341, 9885, 10238, 11153, 11948, 12259, 12545, 13201, 13829, 14457, 14950, 15097, 15853, 16080, 16611, 17476]","[0, 180, 314, 786, 969, 1263, 1419, 1567, 1756, 1938, 2678, 2887, 3191, 3430, 3677, 4201, 4393, 4661, 4913, 5676, 6080, 6310, 6720, 7082, 7445, 7751, 8476, 8645, 8952, 9419, 9790, 9965, 10349, 10642, 10897]","[0, 130, 220, 310, 400, 538, 675, 810, 1030, 1120, 1817, 1961, 2351, 2590, 2770, 3362, 3723, 4036, 4284, 4489, 4647, 4877, 5044, 5675, 5770, 5865, 6580, 6746, 6976, 7275, 7371, 7471, 7571, 7862, 8052]",20179,17756,17476,10897,8052,10,28,90,85,26,"[0, 247, 406, 602, 789, 1251, 1755, 2426, 2882, 3335, 3793, 4375, 5035, 5504, 6131, 6279, 7078, 7361, 7817, 8318, 9041, 9903, 11055, 11232, 12550, 12835, 13421, 13749, 14053, 15054, 16620, 17287, 18516, 19374, 20973]","[0, 284, 477, 872, 1198, 1487, 1869, 2510, 2965, 3326, 3730, 3874, 4743, 5322, 5780, 6261, 6544, 7514, 7969, 8279, 8376, 9079, 9485, 10582, 11411, 12173, 12418, 13080, 13214, 13793, 15782, 16741, 17691, 17903, 19226]","[0, 259, 552, 890, 1140, 1518, 1957, 2499, 2956, 3701, 3899, 4364, 5015, 5516, 6228, 6539, 7026, 7469, 7564, 8347, 8693, 9095, 9785, 10219, 11180, 11527, 12075, 12271, 12658, 13286, 15082, 15720, 16389, 17189, 17955]","[0, 210, 300, 409, 499, 635, 770, 1042, 1260, 1724, 1814, 2130, 2450, 2604, 2903, 2997, 3092, 3247, 4406, 4886, 5043, 5363, 5764, 5858, 6741, 7093, 7188, 7365, 7706, 8048, 9170, 9434, 10535, 10635, 11300]","[0, 210, 300, 620, 759, 1180, 1315, 1584, 1803, 2270, 2534, 2696, 3025, 3174, 3560, 3654, 3749, 3879, 4166, 4437, 4541, 4779, 5077, 5512, 5983, 6255, 6425, 6594, 6765, 7216, 8193, 8496, 9468, 9681, 10452]",20973,19226,17955,11300,10452,-794,-1470,-479,-403,-2400,-5546,35,dire
7573544108,89,43,96,58,26,"[209, 450, 888, 1142, 1426, 1882, 2251, 2764, 2924, 3104, 3364, 4269, 4983, 5741, 6330, 7249, 8161, 8901, 10064, 11531, 12544, 13319, 13751, 14755, 15192, 15892, 17053, 18215, 18741, 19806, 20886, 21491, 22567, 24046, 25518]","[322, 740, 1024, 1598, 2012, 2442, 3053, 3589, 4061, 4577, 5040, 5675, 6042, 6555, 7055, 7392, 7995, 8480, 9330, 9892, 10700, 10929, 11260, 11541, 12065, 12490, 12947, 13576, 14077, 14830, 14930, 15115, 15821, 16538, 16945]","[260, 497, 942, 1142, 1495, 1882, 2229, 2788, 3114, 3895, 4442, 4657, 5280, 5642, 6077, 6656, 6931, 7295, 7886, 8391, 8928, 9319, 9618, 10297, 10778, 11142, 11553, 11835, 12251, 12622, 12867, 12967, 13691, 14549, 15180]","[209, 299, 433, 523, 646, 769, 1066, 1212, 1500, 1763, 1962, 2178, 2894, 3422, 3731, 4220, 4407, 4861, 5085, 5748, 6056, 6526, 6991, 7559, 8229, 8687, 9033, 9210, 9345, 9819, 10222, 10322, 10557, 11953, 12143]","[209, 342, 823, 980, 1117, 1223, 1488, 1641, 2075, 2255, 2391, 2589, 2956, 3110, 3259, 3527, 3622, 3716, 3948, 4428, 4687, 4991, 5161, 5632, 5802, 6279, 6633, 6917, 7088, 7592, 7790, 7926, 8292, 8818, 9077]",25518,16945,15180,12143,9077,48,49,137,27,105,"[209, 375, 618, 982, 1109, 1488, 1888, 2234, 2753, 3398, 3938, 4803, 6112, 6944, 7655, 8254, 9148, 9981, 10418, 11545, 12413, 13294, 13961, 15006, 15882, 16398, 17031, 18152, 19089, 19750, 20060, 20801, 21839, 22347, 22863]","[207, 483, 825, 1276, 1484, 1963, 2551, 3313, 3740, 4454, 5159, 5361, 5911, 6306, 6850, 7517, 7748, 8389, 8989, 9391, 9543, 9780, 10073, 10559, 12115, 12708, 13442, 13691, 14408, 14898, 15381, 16132, 16841, 17616, 18409]","[200, 445, 845, 1052, 1568, 1785, 2240, 2634, 2769, 3593, 3809, 4229, 4681, 5155, 5547, 6233, 6851, 7374, 7961, 8500, 9165, 9259, 9607, 10059, 11961, 12771, 13114, 13725, 14355, 14792, 15186, 15702, 16748, 17455, 17555]","[177, 312, 406, 634, 797, 977, 1067, 1316, 1500, 2089, 2196, 2521, 3018, 3255, 3719, 4184, 4369, 4625, 4854, 5233, 5433, 5602, 5844, 6060, 6919, 7594, 8093, 8424, 8556, 8733, 9129, 9497, 9597, 10152, 10634]","[129, 254, 344, 575, 665, 884, 1204, 1294, 1685, 1993, 2130, 2519, 3205, 3346, 3600, 3868, 4110, 4557, 4908, 5077, 5232, 5326, 5626, 5805, 6450, 7097, 7484, 7883, 8704, 8921, 9229, 9446, 10191, 10881, 11019]",22863,18409,17555,10634,11019,2655,-1464,-2375,1509,-1942,-1617,35,dire
7573683309,1,41,137,33,121,"[0, 244, 556, 811, 1391, 1766, 2089, 2498, 2768, 3497, 4172, 4939, 5704, 6229, 6631, 7215, 7573, 7720, 8645, 9280, 9912, 10654, 10912, 11833, 12408, 12703, 13159, 13437, 13783, 14193, 14699, 14941, 15663, 16235, 16335]","[0, 206, 438, 565, 846, 1304, 1468, 1867, 2239, 2599, 3056, 3322, 3767, 4433, 4989, 5954, 6261, 6891, 7266, 7708, 8365, 8752, 9230, 9933, 10569, 11332, 12170, 12859, 13307, 13480, 14367, 14870, 14970, 15670, 16128]","[0, 205, 484, 779, 1155, 1485, 1963, 2453, 2955, 3207, 3674, 4163, 4341, 4718, 5211, 6052, 6659, 7267, 7611, 8338, 8968, 9312, 9407, 10167, 10853, 11261, 11499, 11763, 12372, 13046, 13583, 13773, 14630, 14966, 15320]","[0, 170, 295, 385, 499, 717, 1128, 1535, 1783, 1873, 2527, 2801, 2891, 3169, 3388, 3939, 4506, 4732, 4907, 5459, 5932, 6374, 7031, 7584, 8027, 8746, 9042, 9582, 9753, 10271, 10736, 11397, 11572, 12172, 12347]","[0, 214, 646, 956, 1229, 1395, 1814, 2073, 2180, 2289, 2559, 2928, 3106, 3424, 3518, 4212, 4370, 4508, 4906, 5339, 5543, 5794, 5889, 5984, 6079, 6450, 6875, 6970, 7066, 7210, 7397, 7587, 7946, 8338, 8672]",16335,16128,15320,12347,8672,94,129,126,65,86,"[0, 217, 506, 879, 1134, 1348, 1788, 1994, 2255, 2753, 3087, 3355, 3568, 4090, 4614, 5308, 6240, 6681, 7322, 8459, 9192, 9979, 10948, 11833, 12999, 13996, 15040, 16101, 17623, 18388, 19133, 20303, 21687, 22586, 23174]","[0, 260, 510, 904, 1192, 1556, 1944, 2272, 2683, 3233, 3839, 4658, 4913, 5474, 6223, 6913, 7512, 8658, 9046, 9803, 10429, 10939, 11560, 12256, 12981, 13324, 13781, 14672, 15394, 15937, 16421, 17724, 19056, 19674, 19995]","[0, 219, 579, 1025, 1394, 1609, 2104, 2521, 2848, 3712, 4200, 4664, 5044, 5497, 6106, 6270, 6987, 7731, 8112, 8596, 8954, 9847, 10298, 10730, 11114, 11638, 12307, 12944, 13487, 13716, 14944, 16183, 17343, 18035, 19152]","[0, 206, 315, 455, 617, 707, 842, 977, 1150, 1580, 1765, 2159, 2343, 2859, 3294, 3389, 3898, 4514, 4805, 5071, 5290, 6099, 6935, 7754, 8200, 8586, 9472, 9862, 10382, 10738, 11246, 12180, 12625, 13237, 13464]","[0, 170, 260, 857, 987, 1092, 1510, 1878, 2194, 2799, 3217, 3480, 3831, 4076, 4210, 4305, 4667, 5377, 5690, 5876, 6090, 6541, 6852, 7308, 7650, 7987, 8505, 8785, 9208, 9379, 9538, 10204, 11036, 11372, 12000]",23174,19995,19152,13464,12000,-6839,-3867,-3832,-1117,-3328,-18983,35,dire
7573878007,48,106,47,26,100,"[0, 202, 399, 775, 939, 1125, 1487, 1957, 2138, 2969, 3396, 3889, 4398, 4948, 5703, 6695, 7587, 8030, 8642, 9035, 10907, 11382, 12155, 13062, 14174, 15337, 16718, 17658, 18676, 19400, 20701, 22500, 24513, 25331, 25431]","[0, 228, 392, 687, 816, 906, 1119, 1260, 1813, 2168, 2559, 3037, 3468, 4161, 4572, 5288, 6033, 7332, 7856, 8541, 9218, 9490, 9766, 10099, 11072, 11608, 12460, 13437, 14322, 14975, 15387, 16632, 17694, 18024, 18672]","[0, 189, 487, 855, 1103, 1724, 1971, 2871, 3109, 3520, 4469, 4665, 5018, 5751, 6312, 6990, 7796, 8645, 8859, 9519, 10065, 10770, 11259, 11916, 12303, 12515, 12719, 13077, 13628, 14084, 14521, 14939, 15995, 16402, 16624]","[100, 298, 388, 478, 568, 756, 893, 1304, 1523, 1925, 2950, 3040, 3448, 3633, 3875, 4602, 4961, 5954, 6257, 6638, 7327, 7744, 8109, 8782, 9197, 9416, 9695, 10185, 10518, 10689, 11632, 12380, 13116, 13291, 13597]","[0, 154, 244, 378, 468, 583, 718, 1277, 1367, 1663, 2001, 2125, 2215, 2857, 3154, 3672, 4242, 4485, 4985, 5559, 6069, 6307, 6769, 6978, 7364, 7719, 8083, 8440, 8698, 8794, 9191, 10265, 10973, 11296, 11396]",25431,18672,16624,13597,11396,73,114,49,123,79,"[0, 368, 819, 1102, 1438, 1571, 2059, 2149, 2541, 3279, 3642, 4206, 5037, 6395, 6965, 7844, 8960, 9810, 10654, 11987, 12688, 13408, 14369, 15365, 16354, 17569, 19000, 20372, 21585, 22162, 23715, 23815, 23915, 25334, 26463]","[0, 327, 693, 1069, 1443, 2074, 2450, 2905, 3355, 3903, 4166, 4502, 5120, 5412, 5594, 5883, 6392, 6846, 7185, 7279, 8219, 8638, 9190, 9285, 10254, 10783, 11479, 11869, 12244, 13042, 13325, 13425, 14150, 15497, 16610]","[0, 294, 581, 791, 953, 1543, 1994, 2373, 2950, 3245, 3884, 4567, 5115, 5542, 6067, 6227, 6461, 7074, 7465, 8167, 8609, 8867, 9312, 9540, 10160, 10835, 11100, 11768, 12054, 12230, 12513, 12613, 13221, 14069, 14169]","[0, 209, 299, 389, 479, 676, 812, 902, 1141, 1406, 1702, 1792, 1882, 2197, 2292, 2386, 2691, 3453, 3635, 3863, 4103, 4361, 4527, 4866, 5373, 6194, 6680, 7468, 7879, 8132, 8618, 8718, 9681, 10711, 10997]","[0, 209, 299, 442, 870, 960, 1281, 1371, 1521, 1830, 2055, 2156, 2282, 2549, 2664, 2787, 2950, 3427, 4244, 4338, 4588, 5262, 5428, 5727, 5912, 6128, 6488, 6808, 6904, 7196, 7341, 7441, 7928, 8776, 9367]",26463,16610,14169,10997,9367,-1032,2062,2455,2600,2029,8114,35,radiant
7575056413,46,43,96,86,100,"[0, 297, 630, 1087, 1546, 2171, 2725, 3295, 3728, 4491, 5175, 5645, 6389, 7313, 7977, 8577, 9422, 10057, 10809, 11551, 12346, 13004, 13588, 13896, 13991, 16160, 16647, 17524, 18396, 19943, 21199, 21604, 23868, 25638, 25993]","[0, 322, 653, 983, 1269, 1498, 1854, 2196, 2635, 3200, 3727, 3943, 4561, 5071, 5824, 6352, 6731, 7071, 7322, 7973, 8068, 8785, 9535, 9752, 10039, 10742, 11778, 12330, 12826, 14370, 15047, 15512, 16909, 17366, 18177]","[0, 315, 621, 1044, 1287, 1754, 2231, 2717, 3228, 3765, 4454, 4957, 5562, 5862, 6613, 6926, 7195, 7727, 7978, 8214, 8643, 9096, 9499, 9902, 9997, 10529, 11209, 11789, 12443, 13124, 14078, 14893, 15943, 16534, 16769]","[0, 256, 395, 987, 1127, 1295, 1529, 1857, 2300, 2390, 2615, 2705, 2933, 3232, 3730, 4223, 4318, 4756, 4914, 5071, 5264, 5551, 5970, 6203, 6451, 7223, 7606, 8109, 8344, 9734, 9989, 10089, 10849, 11213, 11448]","[0, 210, 300, 464, 554, 730, 1126, 1264, 1460, 1694, 1919, 2270, 2597, 2765, 2991, 3182, 3277, 3529, 3780, 4221, 4430, 4635, 5038, 5132, 5593, 6293, 6689, 6832, 7009, 7874, 8125, 8225, 9338, 9698, 9933]",25993,18177,16769,11448,9933,39,21,67,26,3,"[0, 291, 533, 792, 1123, 1461, 1806, 2191, 2881, 3551, 4195, 4782, 5395, 6245, 7190, 7583, 8870, 9401, 10499, 11544, 12198, 13128, 13963, 15055, 16327, 16809, 17089, 18108, 19197, 19554, 19650, 20007, 20737, 21564, 21866]","[0, 289, 668, 1079, 1529, 1803, 2102, 2477, 2879, 3220, 3701, 4547, 5190, 6052, 6424, 6813, 8047, 8472, 9029, 9780, 10784, 11049, 11289, 11828, 12964, 13131, 13564, 14207, 14785, 15437, 15603, 16310, 16795, 17894, 18110]","[0, 206, 523, 764, 1134, 1489, 1867, 2235, 2643, 3244, 3924, 4360, 4704, 5124, 5815, 6257, 6918, 7467, 7894, 8459, 8918, 9503, 10421, 11216, 12382, 13077, 13626, 14110, 14632, 15130, 15935, 16519, 17004, 17280, 17684]","[0, 130, 220, 310, 445, 540, 630, 768, 903, 1212, 1448, 1816, 1936, 2324, 2559, 2653, 3504, 3718, 3903, 4123, 4402, 4739, 5289, 5743, 5938, 6225, 6688, 7074, 7409, 7673, 8152, 8327, 8979, 9571, 9859]","[0, 130, 220, 310, 444, 548, 744, 880, 1137, 1227, 1362, 1611, 1701, 2012, 2247, 2388, 3001, 3288, 3933, 4371, 4606, 4836, 5283, 5587, 5894, 6061, 6195, 6358, 6535, 6631, 6727, 6827, 6927, 7603, 7703]",21866,18110,17684,9859,7703,4127,67,-915,1589,2230,7098,35,radiant
7575446802,120,4,97,65,5,"[0, 276, 608, 960, 1390, 1885, 2293, 2976, 3506, 3929, 4658, 5448, 6336, 6929, 7868, 8211, 8520, 9365, 10404, 10643, 11004, 11470, 12340, 12679, 13204, 13624, 13965, 14596, 15792, 16145, 17303, 19556, 20074, 20861, 21782]","[0, 282, 607, 974, 1240, 1562, 1849, 1939, 2215, 2580, 3194, 3926, 4422, 4920, 5309, 5848, 6798, 7219, 7841, 8326, 8862, 9445, 10412, 10507, 10871, 11567, 12251, 13318, 13795, 14943, 16583, 17736, 18391, 19087, 19858]","[0, 245, 475, 1067, 1496, 1918, 2334, 2747, 3386, 3706, 4366, 4991, 5819, 6409, 7140, 7605, 8728, 8912, 9778, 10099, 10922, 11548, 11715, 12418, 13176, 13610, 14590, 14843, 15430, 16251, 17330, 18763, 19056, 19385, 19911]","[0, 170, 276, 411, 531, 692, 1000, 1164, 1436, 1657, 2014, 2415, 2595, 2888, 3299, 3394, 3845, 4137, 4528, 4833, 5355, 5548, 5762, 6060, 6155, 6577, 6779, 7054, 7422, 8314, 8410, 9666, 9766, 9866, 10265]","[0, 220, 310, 961, 1226, 1461, 1655, 1839, 2236, 2362, 2591, 3309, 3508, 3821, 4213, 4464, 4745, 5037, 5176, 5271, 5539, 5679, 5933, 6071, 6270, 6542, 6808, 7138, 7506, 7898, 8656, 9712, 9812, 9912, 10058]",21782,19858,19911,10265,10058,29,90,93,58,86,"[0, 207, 385, 671, 911, 1300, 1601, 2014, 2544, 3127, 3508, 3978, 4547, 5110, 5467, 5645, 6255, 7112, 8084, 8799, 9491, 10034, 10610, 11250, 11850, 12413, 12953, 13570, 14036, 14268, 14364, 14464, 15183, 15745, 16427]","[0, 249, 564, 895, 1242, 1534, 1940, 2574, 2983, 3601, 3834, 4362, 4625, 5281, 5756, 6025, 6465, 7231, 7745, 8784, 9234, 9798, 10393, 11138, 11757, 12188, 12962, 13370, 13785, 14352, 14776, 15005, 15526, 16105, 16827]","[0, 258, 544, 779, 1273, 1517, 1878, 2229, 2373, 2907, 3466, 3781, 4440, 5274, 5782, 5877, 6646, 7148, 7300, 7992, 8424, 8849, 9084, 9644, 10182, 10941, 11520, 12473, 13278, 13518, 13920, 14020, 14727, 15165, 16031]","[0, 170, 260, 350, 440, 592, 700, 835, 1121, 1597, 1807, 2144, 2406, 2914, 3075, 3221, 3793, 4272, 4696, 5519, 6078, 6407, 6754, 7199, 7635, 8360, 8663, 9276, 9710, 10239, 10850, 10950, 11587, 12063, 12707]","[0, 170, 360, 488, 578, 764, 854, 1096, 1510, 1846, 2507, 2779, 3209, 3470, 3636, 3731, 4719, 5094, 5375, 6035, 6349, 6480, 6715, 7050, 7471, 7737, 7955, 8299, 8571, 8808, 9028, 9128, 9318, 9541, 9945]",16427,16827,16031,12707,9945,5355,3031,3880,-2442,113,9937,35,radiant
7575553506,25,97,80,119,5,"[0, 240, 583, 987, 1376, 1739, 2075, 2289, 3018, 3445, 4425, 4929, 5441, 6409, 6998, 7893, 8834, 9292, 9386, 10519, 11009, 12003, 12959, 13828, 14245, 14835, 14929, 15781, 16487, 16718, 17776, 18478, 19741, 20502, 21170]","[0, 169, 499, 901, 1184, 1363, 1794, 2298, 2703, 3089, 3600, 4259, 4805, 5844, 6438, 7276, 7766, 8200, 9412, 10120, 10657, 11284, 11903, 12464, 12733, 12828, 12993, 14246, 15651, 16428, 16686, 16967, 17534, 18208, 19436]","[0, 205, 580, 835, 1204, 1677, 2150, 2778, 3315, 3687, 4437, 4877, 5337, 5928, 6622, 7400, 7775, 8501, 8595, 9250, 10165, 10750, 11379, 11847, 12577, 12868, 12962, 13438, 14298, 14738, 15290, 15572, 16070, 16516, 18105]","[0, 169, 259, 473, 612, 768, 858, 1221, 1345, 1435, 2008, 2302, 2471, 2763, 3113, 3371, 3694, 4203, 4400, 4742, 4974, 5230, 5550, 5802, 5897, 5992, 6125, 6478, 7035, 7475, 7939, 8262, 8584, 8836, 9737]","[0, 254, 344, 478, 663, 771, 1093, 1272, 1439, 1574, 1983, 2277, 2367, 2708, 2885, 3157, 3490, 3686, 3780, 4363, 4459, 4730, 5099, 5303, 5632, 6001, 6359, 6713, 7122, 7837, 8305, 8480, 9136, 9311, 10285]",21170,19436,18105,9737,10285,10,39,129,65,85,"[0, 206, 603, 1165, 1467, 1705, 1961, 2276, 2671, 3056, 3504, 4412, 4902, 5701, 6282, 6943, 7946, 8677, 9892, 10951, 11908, 12578, 13406, 14177, 14902, 15768, 17384, 18073, 18408, 19956, 20965, 22466, 23374, 24208, 25033]","[0, 290, 464, 799, 1051, 1266, 1601, 2382, 2655, 3157, 3480, 4161, 4845, 5441, 6153, 6784, 7756, 8358, 9454, 10124, 10556, 11095, 11858, 12498, 13448, 14721, 15991, 16643, 17197, 18249, 18609, 19435, 19995, 20331, 21800]","[0, 214, 527, 788, 1076, 1490, 1924, 2227, 2604, 3057, 3373, 3939, 4496, 4884, 5357, 5955, 6896, 7483, 8117, 8440, 8651, 9098, 9264, 10109, 10766, 11400, 12608, 12919, 14040, 14551, 15182, 15634, 16259, 16726, 17634]","[0, 169, 259, 349, 479, 677, 1075, 1369, 1760, 2025, 2289, 3005, 3234, 3426, 3845, 4159, 5130, 5668, 6610, 7105, 7292, 7632, 8144, 8349, 8607, 9145, 10094, 10346, 10523, 10782, 11013, 11726, 12095, 12425, 13072]","[0, 169, 259, 468, 642, 772, 1017, 1482, 1654, 1744, 1834, 2335, 2495, 2639, 2885, 3046, 3711, 3896, 4768, 5016, 5111, 5404, 5570, 5823, 6081, 6599, 7357, 7489, 7941, 8200, 8524, 8871, 9328, 9496, 10084]",25033,21800,17634,13072,10084,-3863,-2364,471,-3335,201,-8890,35,dire
7575788217,120,97,80,119,58,"[0, 241, 491, 869, 1293, 1681, 1975, 2584, 2986, 3409, 4030, 5116, 5596, 6273, 6901, 7284, 8327, 8524, 9276, 10118, 10364, 10459, 11111, 11710, 12330, 12604, 13380, 13947, 15007, 15242, 15434, 16252, 16910, 17703, 18657]","[0, 217, 574, 877, 1413, 1579, 2027, 2279, 2566, 3032, 3578, 4283, 4837, 5203, 5966, 6236, 7167, 7615, 8338, 9146, 9431, 9578, 10466, 11561, 12014, 12832, 13586, 14631, 15526, 15895, 15991, 16091, 16737, 17045, 17619]","[0, 207, 528, 931, 1416, 1716, 2114, 2618, 2900, 3371, 3636, 3983, 4288, 5106, 5649, 6170, 6663, 7680, 8031, 9091, 9457, 9552, 10060, 10661, 11122, 11924, 13150, 13468, 13963, 14553, 15035, 15135, 15495, 16142, 16413]","[0, 170, 595, 700, 961, 1098, 1330, 1465, 1606, 1933, 2255, 2860, 2950, 3283, 3468, 3563, 4128, 4418, 4637, 5024, 5695, 5976, 6385, 6692, 7021, 7309, 8007, 8716, 9250, 9581, 9797, 9968, 10303, 10653, 10879]","[0, 207, 297, 435, 605, 695, 975, 1232, 1483, 1675, 1912, 2219, 2421, 2926, 3263, 3373, 3913, 4312, 4584, 4991, 5275, 5370, 5704, 5923, 6347, 6548, 7712, 8406, 9393, 9572, 9933, 10033, 10420, 11138, 11792]",18657,17619,16413,10879,11792,25,54,129,5,100,"[0, 366, 743, 1123, 1560, 2030, 2451, 3019, 3462, 4198, 4686, 5404, 5773, 6172, 6784, 7446, 8098, 9625, 10336, 10747, 11310, 12694, 13179, 13917, 14612, 15152, 15968, 16531, 17113, 17379, 18171, 19888, 20757, 21418, 22366]","[0, 170, 409, 569, 1121, 1492, 1839, 2323, 2856, 3439, 4006, 4597, 5086, 5669, 6239, 6862, 7608, 8181, 8657, 9282, 9772, 10765, 11359, 11868, 12815, 13221, 14308, 14946, 15580, 15888, 16505, 17320, 18543, 19377, 20451]","[0, 258, 432, 804, 1243, 1498, 1972, 2300, 2806, 3264, 4031, 4781, 5215, 5676, 6083, 6663, 7252, 7924, 8706, 9384, 9478, 10839, 11540, 12274, 12813, 13039, 13381, 13732, 14537, 14819, 15462, 16748, 17695, 18392, 18872]","[0, 219, 309, 413, 670, 878, 968, 1125, 1270, 1360, 1495, 2067, 2277, 2535, 2812, 3223, 3607, 4124, 4463, 4930, 5346, 5844, 6104, 6274, 6781, 7719, 8307, 8797, 9088, 9381, 9853, 10298, 10668, 11048, 11692]","[0, 170, 260, 350, 568, 658, 856, 991, 1081, 1331, 1466, 1646, 1736, 1928, 2199, 2562, 2831, 3398, 3976, 4522, 4928, 5770, 6166, 6261, 6499, 6890, 7326, 7785, 7962, 8155, 8535, 8980, 9411, 9666, 10103]",22366,20451,18872,11692,10103,-3709,-2832,-2459,-813,1689,-8124,35,dire
7576855616,61,48,59,123,64,"[0, 217, 576, 900, 1336, 1743, 2224, 2868, 3627, 4048, 4773, 5352, 6099, 6417, 7436, 8204, 8999, 9736, 10520, 10886, 11516, 12209, 14048, 14183, 15484, 15969, 16063, 16912, 17792, 19262, 20931, 21207, 22651, 23398, 24343]","[0, 251, 678, 1129, 1501, 1947, 2413, 2656, 3290, 3889, 4489, 4916, 5267, 5553, 6220, 6805, 7246, 8110, 8668, 9618, 10297, 10626, 11507, 12188, 13406, 14658, 15601, 15696, 17137, 18216, 19301, 20478, 21353, 22855, 23883]","[0, 292, 592, 1044, 1414, 1867, 2281, 2767, 3306, 3905, 4630, 5001, 5621, 6274, 6920, 7447, 7980, 8508, 9173, 9730, 10004, 10524, 11098, 11193, 12105, 12725, 12819, 14304, 15314, 15520, 15951, 16162, 16781, 17098, 18089]","[0, 170, 260, 400, 534, 624, 714, 894, 1368, 1671, 1806, 1977, 2101, 2246, 2439, 2657, 3285, 3469, 3699, 4431, 4864, 5016, 5763, 6017, 6319, 6838, 6932, 7589, 8740, 9559, 10044, 10193, 10293, 11037, 11929]","[0, 170, 276, 366, 811, 922, 1072, 1162, 1287, 1486, 1621, 1711, 2054, 2640, 2995, 3517, 3852, 4350, 4796, 5186, 5477, 5706, 5890, 5985, 6913, 7229, 7323, 7472, 8340, 8760, 9119, 9686, 9786, 10301, 11016]",24343,23883,18089,11929,11016,46,22,14,74,5,"[0, 242, 608, 968, 1269, 1821, 2265, 2715, 3236, 3716, 4302, 4923, 5681, 6593, 7109, 7718, 8520, 9209, 9908, 10447, 11358, 12204, 13172, 14098, 14692, 15202, 16757, 17897, 18618, 18924, 20384, 20954, 22135, 22784, 22884]","[0, 334, 732, 1150, 1519, 2276, 2858, 3471, 4197, 4659, 5176, 5516, 6160, 6417, 7071, 7638, 8360, 8835, 9727, 11314, 12122, 12596, 13227, 13657, 14446, 15601, 17299, 17550, 18719, 19152, 19349, 19449, 20436, 20536, 21205]","[0, 287, 595, 1081, 1618, 2176, 2576, 3127, 3584, 3971, 4272, 4726, 5615, 6069, 6453, 6865, 8133, 8975, 10411, 11551, 11971, 12969, 13849, 13944, 14400, 14911, 15962, 16331, 16596, 17282, 17459, 17559, 19094, 20325, 20479]","[0, 170, 260, 395, 625, 794, 1020, 1734, 1914, 2049, 2265, 2634, 2932, 3314, 3463, 3722, 4200, 4450, 4545, 4808, 5118, 5733, 6452, 6718, 6960, 7396, 8416, 9344, 9646, 10606, 10961, 12198, 12668, 13146, 13982]","[0, 170, 365, 503, 593, 736, 936, 1106, 1292, 1427, 1582, 1672, 2007, 2343, 2493, 2587, 3256, 3510, 3631, 3878, 4036, 4640, 4989, 5084, 5179, 5654, 6152, 6360, 6727, 6823, 7281, 8010, 8200, 8541, 8641]",22884,21205,20479,13982,8641,1459,2678,-2390,-2053,2375,2069,35,dire
7577206517,48,39,137,65,84,"[0, 274, 695, 1019, 1230, 1395, 1805, 2302, 2570, 3022, 3616, 4261, 4855, 5899, 6597, 7395, 8516, 9654, 10022, 11277, 11813, 12641, 13932, 14674, 15566, 16234, 17317, 17632, 19148, 20303, 21290, 21785, 23459, 24861, 25759]","[0, 314, 599, 775, 1284, 1541, 2294, 2814, 3496, 3586, 4112, 5166, 5620, 5803, 6397, 7031, 7648, 8803, 9438, 9759, 10227, 10866, 11693, 12443, 13319, 13871, 15319, 15742, 16725, 17398, 17801, 18353, 19356, 19760, 20515]","[0, 202, 365, 752, 1062, 1467, 1636, 2134, 2588, 3005, 3274, 4144, 4446, 5117, 5476, 5868, 6873, 7563, 8266, 9433, 9773, 10428, 10810, 12040, 12399, 12727, 13595, 13897, 14902, 15348, 15700, 16251, 16548, 16943, 17648]","[0, 520, 610, 745, 835, 1107, 1319, 1536, 1744, 1952, 2225, 2476, 2995, 3487, 3706, 4041, 4784, 5533, 6081, 6601, 7131, 7754, 8414, 8707, 9126, 9458, 10195, 10705, 12017, 12370, 12466, 12701, 13087, 13306, 14070]","[0, 204, 294, 440, 584, 1216, 1577, 1729, 1865, 2161, 2499, 3122, 3304, 3579, 3886, 4099, 4859, 5582, 5959, 6730, 6992, 7205, 8062, 8361, 8528, 8623, 9218, 9312, 9967, 10388, 10521, 10756, 11042, 11187, 11556]",25759,20515,17648,14070,11556,10,126,96,53,121,"[0, 245, 517, 799, 1243, 1609, 2112, 2612, 2981, 3545, 4228, 4779, 5690, 6318, 6938, 7756, 8978, 10328, 11100, 11195, 12107, 12419, 13689, 14452, 15110, 15883, 16456, 16550, 17246, 18249, 19150, 20021, 21086, 21904, 23493]","[0, 286, 497, 698, 910, 1186, 1512, 1803, 2147, 2656, 2966, 3147, 3388, 3917, 4608, 5188, 5620, 6390, 6927, 8369, 8903, 9596, 10111, 10448, 10543, 10926, 11405, 12131, 12320, 12617, 13033, 13532, 14538, 15164, 15880]","[0, 209, 376, 740, 1153, 1818, 2208, 2814, 3194, 3637, 4088, 4301, 4891, 5471, 5981, 6365, 6977, 7914, 8328, 8800, 9283, 9513, 9825, 9919, 10406, 10640, 10936, 11436, 11532, 12033, 12597, 13233, 14101, 14589, 14799]","[0, 209, 299, 433, 830, 1002, 1314, 1523, 1752, 1906, 2075, 2165, 2391, 2751, 3303, 3594, 4541, 5193, 5532, 6117, 6459, 7236, 7766, 8124, 8452, 8965, 9502, 10025, 10566, 10813, 11414, 12109, 12572, 12900, 13346]","[0, 209, 415, 526, 787, 959, 1223, 1485, 1703, 2298, 2434, 2780, 2915, 3178, 3592, 3832, 4247, 4680, 4970, 5618, 5938, 6189, 6566, 6660, 6755, 6940, 7236, 7330, 7463, 7944, 8777, 9167, 9494, 9692, 9972]",23493,15880,14799,13346,9972,2266,4635,2849,724,1584,12058,35,radiant
7577579206,93,120,28,66,123,"[0, 170, 482, 698, 985, 1188, 1681, 2091, 2951, 3888, 4521, 4953, 5660, 6137, 6855, 7273, 7746, 8846, 9247, 10767, 11484, 12493, 13397, 13921, 15029, 15697, 16429, 16761, 17668, 17927, 19156, 19256, 19792, 20517, 21223]","[0, 288, 562, 894, 1022, 1314, 2053, 2388, 3066, 3321, 4427, 4857, 5521, 6095, 6798, 7233, 7749, 8528, 9015, 9675, 10208, 10690, 11426, 11723, 12676, 13573, 14138, 15080, 15718, 16200, 16502, 17622, 18268, 19051, 19520]","[0, 204, 530, 767, 997, 1436, 1825, 2237, 2327, 2671, 3171, 3898, 4196, 4741, 5339, 6110, 6528, 7473, 7784, 8326, 8714, 9182, 9971, 10373, 11098, 11724, 12075, 12326, 12949, 13146, 13537, 14140, 14819, 15153, 16104]","[0, 216, 366, 770, 918, 1113, 1508, 1782, 2333, 2787, 3262, 3595, 3958, 4281, 4980, 5371, 6024, 7056, 7360, 7743, 8217, 8729, 9249, 9558, 9954, 10737, 11235, 11510, 12300, 12560, 13275, 13547, 13844, 14279, 14801]","[0, 170, 309, 399, 580, 805, 985, 1247, 1337, 1427, 1751, 1977, 2410, 2558, 2932, 3083, 3614, 4175, 4648, 5231, 5636, 6197, 6481, 7042, 7319, 8023, 8373, 8700, 9003, 9128, 10001, 10260, 10368, 10523, 11085]",21223,19520,16104,14801,11085,48,106,14,53,27,"[0, 208, 483, 863, 1096, 1545, 2030, 2485, 2992, 3679, 4184, 4833, 5575, 6426, 7342, 8246, 9560, 10147, 10860, 11718, 12564, 13471, 14199, 14683, 15308, 16183, 17678, 18466, 19304, 20103, 20460, 22418, 23457, 23758, 24642]","[0, 276, 602, 1064, 1588, 1978, 2544, 2869, 3766, 4360, 4488, 4742, 5044, 5680, 5956, 6372, 7184, 7476, 7928, 8330, 8646, 9238, 9782, 10203, 10297, 10941, 11036, 11454, 12066, 12162, 12258, 12921, 14419, 14519, 15422]","[0, 205, 441, 1054, 1278, 1797, 2050, 2501, 2916, 3310, 3697, 3787, 3877, 4486, 4923, 5423, 5892, 6490, 6963, 7272, 7487, 7923, 8267, 8427, 8947, 9277, 9520, 9946, 10232, 10414, 10720, 11512, 11879, 12476, 12926]","[0, 170, 260, 602, 761, 941, 1300, 1554, 1924, 2285, 2503, 2658, 2826, 3128, 3292, 3387, 3905, 4546, 4921, 5016, 5293, 5663, 6313, 6446, 6589, 6986, 7447, 7598, 7840, 8173, 8673, 9431, 9807, 10226, 10703]","[0, 220, 310, 682, 772, 989, 1145, 1399, 1534, 1987, 2251, 2341, 2431, 3216, 3452, 3547, 3813, 4180, 4275, 4395, 4489, 4786, 4926, 5021, 5115, 5282, 5415, 5710, 5916, 6012, 6108, 6715, 6995, 7095, 7195]",24642,15422,12926,10703,7195,-3419,4098,3178,4098,3890,11845,35,radiant
7577870703,10,49,53,97,26,"[0, 204, 473, 802, 1170, 1394, 1899, 2400, 2900, 3260, 4074, 4663, 5294, 5798, 5927, 6371, 7051, 7611, 8159, 9201, 9296, 10612, 11800, 12781, 13592, 13867, 15275, 15441, 15938, 16754, 17092, 17192, 17697, 18851, 19586]","[0, 314, 604, 1085, 1251, 1496, 2090, 2553, 3137, 3599, 4274, 4618, 5115, 5884, 6284, 6478, 6663, 6994, 7495, 8075, 8615, 9557, 10482, 10967, 11622, 12337, 13142, 14220, 14316, 15049, 15485, 16133, 16818, 18175, 18765]","[0, 170, 260, 350, 528, 656, 1122, 1245, 1479, 1569, 1905, 2748, 2972, 3298, 3495, 3783, 4169, 4563, 4947, 5542, 6063, 6804, 7444, 7960, 8460, 8913, 9892, 9986, 10248, 10477, 11133, 11233, 11687, 12548, 13081]","[0, 242, 489, 774, 1059, 1360, 1616, 1958, 2225, 2614, 3051, 3653, 3887, 4466, 4827, 5014, 5528, 6206, 6410, 6783, 7745, 8355, 8671, 9629, 9813, 9908, 10296, 10764, 11304, 11850, 12490, 12943, 13099, 13743, 14240]","[0, 170, 358, 492, 622, 712, 880, 970, 1060, 1150, 1389, 1562, 1817, 2201, 2466, 2584, 2961, 3056, 3293, 3508, 3906, 4590, 4946, 5246, 5416, 5654, 6220, 6481, 6652, 6877, 7034, 7270, 7706, 8972, 9236]",19586,18765,13081,14240,9236,48,65,96,20,79,"[0, 294, 572, 736, 1107, 1349, 1928, 2365, 2894, 3660, 4318, 5094, 5821, 6668, 7318, 8029, 8984, 10139, 10957, 11966, 12347, 13198, 14454, 15116, 15955, 16644, 17768, 19200, 20583, 21705, 23434, 24781, 26390, 26892, 27377]","[0, 209, 497, 829, 1135, 1404, 1747, 2280, 2869, 3665, 3983, 4503, 5004, 5905, 6282, 7145, 7803, 8401, 8967, 9853, 10479, 10752, 11467, 11749, 11954, 12413, 13355, 14137, 14969, 15707, 16528, 17138, 17608, 18368, 18468]","[0, 255, 611, 899, 1301, 1671, 2044, 2479, 2820, 3279, 3877, 4458, 4979, 5521, 6311, 6992, 7537, 8523, 8859, 9468, 10169, 10599, 10914, 11277, 11774, 12462, 13066, 13465, 14107, 14997, 15690, 16152, 17148, 17635, 18098]","[0, 170, 260, 445, 940, 1084, 1507, 1687, 1834, 2090, 2380, 2614, 3032, 3531, 3680, 4081, 4440, 5125, 5320, 5966, 6233, 6608, 6999, 7373, 7661, 8107, 8669, 8995, 9590, 10190, 10528, 10948, 11518, 11826, 12083]","[0, 170, 279, 422, 641, 731, 821, 1050, 1314, 1633, 2210, 2822, 3088, 3409, 3766, 4423, 5086, 5686, 6025, 6535, 6860, 7387, 7626, 7910, 8429, 8596, 8827, 9356, 9777, 9873, 10309, 10777, 11263, 11804, 11938]",27377,18468,18098,12083,11938,-7791,297,-5017,2157,-2702,-13056,35,radiant
7578076914,25,70,98,20,121,"[0, 278, 402, 655, 979, 1223, 1762, 2325, 2855, 3249, 3865, 3992, 4177, 4609, 5263, 6044, 6750, 7691, 8506, 9192, 10270, 10996, 12080, 12803, 13569, 14502, 15064, 15742, 15846, 16568, 17158, 17684, 18117, 18615, 19357]","[0, 628, 805, 963, 1419, 1699, 1941, 2150, 2452, 2542, 3205, 3760, 4097, 4836, 5230, 6033, 6737, 7517, 8081, 8853, 10243, 10587, 11330, 11882, 12719, 13444, 14799, 15145, 15452, 16091, 17608, 17708, 17808, 18299, 18730]","[0, 278, 563, 1081, 1398, 1758, 2072, 2416, 2826, 3443, 4187, 4328, 4565, 5126, 5861, 6075, 6916, 7606, 8617, 9304, 9474, 9851, 10297, 10806, 11546, 12133, 12399, 12809, 13109, 13282, 13689, 13941, 14381, 14824, 15483]","[100, 339, 429, 563, 825, 1170, 1260, 1505, 1595, 1685, 2195, 2457, 2607, 2850, 3011, 3240, 3449, 3610, 3938, 4189, 4354, 4656, 5293, 5616, 5764, 6035, 6593, 6742, 6921, 7248, 7460, 7664, 8064, 8272, 8439]","[0, 218, 308, 479, 663, 799, 1154, 1474, 1593, 1683, 2008, 2098, 2248, 2396, 2643, 3026, 3184, 3386, 3571, 3811, 4271, 4440, 4906, 5165, 5335, 5576, 5782, 5952, 6123, 6352, 6799, 6974, 7314, 7510, 7685]",19357,18730,15483,8439,7685,113,114,29,53,27,"[0, 289, 650, 992, 1366, 1780, 2140, 2658, 3406, 4102, 4817, 5877, 6840, 7541, 7899, 8435, 8944, 9449, 10105, 10880, 11894, 12428, 13097, 14234, 14768, 15950, 17848, 18638, 19778, 21205, 22047, 23926, 25013, 25663, 26404]","[0, 293, 612, 935, 1247, 1537, 1732, 2037, 2494, 2823, 3040, 3499, 4439, 4971, 5390, 5877, 6661, 7177, 7650, 7808, 8903, 9386, 9553, 10243, 10742, 11432, 12329, 13201, 13832, 14642, 15214, 16561, 17132, 17232, 17867]","[0, 208, 569, 772, 1116, 1331, 1603, 2247, 2834, 3516, 3845, 4581, 5222, 5926, 6498, 7022, 7734, 8491, 9463, 10172, 10357, 10451, 10827, 11190, 11627, 12163, 12938, 13918, 14799, 15671, 16386, 17351, 17674, 17891, 18448]","[0, 170, 260, 901, 1283, 1465, 2051, 2296, 2768, 3285, 3614, 4097, 4836, 5159, 5568, 5957, 6452, 7222, 7656, 7988, 8772, 9314, 10004, 10481, 10989, 11299, 11730, 12140, 13139, 13699, 14769, 15825, 16343, 17030, 17830]","[0, 170, 260, 350, 577, 707, 944, 1125, 1509, 1715, 1932, 2184, 2922, 3125, 3219, 3411, 3641, 3798, 4159, 4409, 4834, 4976, 5143, 5671, 5869, 6035, 6745, 6840, 7770, 8332, 9244, 10039, 10249, 10349, 10449]",26404,17867,18448,17830,10449,-7047,863,-2965,-9391,-2764,-21304,35,dire
7578151603,44,98,23,75,101,"[0, 244, 454, 857, 1436, 1770, 2246, 2669, 3151, 3369, 3782, 4325, 4775, 5637, 6110, 6806, 7642, 8314, 8773, 9617, 10182, 11226, 12143, 12731, 13958, 14870, 15869, 16850, 17196, 17838, 17934, 18423, 18613, 19586, 21051]","[0, 208, 621, 957, 1373, 1791, 2195, 2509, 2842, 3601, 4441, 4920, 5534, 6789, 7245, 7701, 8201, 8745, 9506, 9995, 10524, 10879, 11060, 11561, 11856, 13053, 13222, 13673, 13896, 14678, 14774, 15054, 16014, 16926, 17182]","[0, 243, 443, 685, 924, 1110, 1348, 1664, 2238, 2445, 3292, 3833, 4281, 4940, 5738, 6156, 6649, 7373, 7888, 8200, 8515, 8925, 9657, 9963, 10476, 11148, 11343, 12264, 12535, 13281, 13785, 14432, 14622, 15136, 15236]","[0, 169, 259, 394, 601, 739, 999, 1356, 1446, 1672, 2061, 2448, 2583, 3089, 3437, 3647, 3797, 4153, 4313, 4612, 4724, 4987, 5154, 5879, 5974, 6403, 6497, 6848, 7084, 7611, 7707, 7987, 8177, 8371, 8521]","[0, 169, 605, 908, 1082, 1216, 1306, 1498, 1874, 1964, 2359, 2600, 2690, 2929, 3078, 3280, 3405, 3668, 3808, 3968, 4290, 4456, 4794, 5013, 5108, 5348, 5442, 5618, 6075, 6171, 6267, 6596, 6876, 7116, 7357]",21051,17182,15236,8521,7357,38,114,93,123,26,"[0, 243, 537, 844, 1127, 1873, 2318, 2621, 3292, 3551, 4339, 4693, 5407, 5971, 6833, 7287, 8089, 8613, 9744, 10452, 11061, 11767, 12602, 13009, 13718, 14483, 14780, 15574, 16110, 16352, 17513, 18472, 20203, 20641, 21124]","[0, 281, 599, 827, 1291, 1587, 2072, 2579, 3029, 3513, 3826, 4626, 5270, 6171, 6612, 6706, 7496, 8357, 8674, 9217, 9548, 10142, 10444, 10904, 11395, 12085, 12478, 13262, 13946, 14648, 15596, 16908, 18488, 18776, 19262]","[0, 275, 478, 875, 1114, 1373, 1742, 2111, 2606, 3151, 3391, 4180, 4686, 5257, 5676, 6102, 6939, 7652, 8072, 8818, 9426, 10166, 11486, 12207, 12707, 13329, 13517, 14303, 15064, 15280, 15624, 16499, 17557, 18215, 19038]","[0, 169, 303, 441, 647, 1136, 1226, 1445, 1868, 2222, 2462, 2774, 2894, 3254, 3581, 4016, 4433, 5336, 5732, 6204, 6607, 6900, 7518, 8237, 8671, 9118, 9393, 10160, 10783, 10913, 12004, 12442, 14029, 14821, 15340]","[0, 169, 259, 394, 519, 771, 878, 1058, 1283, 1472, 1738, 2045, 2135, 2745, 3023, 3117, 3583, 3877, 4017, 4323, 4418, 4597, 5277, 5473, 5734, 6325, 6494, 7113, 7284, 7623, 8334, 8990, 9730, 10096, 10657]",21124,19262,19038,15340,10657,-73,-2080,-3802,-6819,-3300,-16074,35,dire
7578531212,41,120,98,65,121,"[0, 239, 441, 570, 947, 1099, 1298, 1756, 2094, 2453, 2854, 3279, 3656, 4129, 4972, 5313, 5574, 6838, 7717, 8311, 9065, 9997, 10463, 10674, 11618, 12074, 12586, 12846, 13287, 14297, 15054, 15556, 15656, 16039, 17050]","[0, 247, 499, 822, 1135, 1386, 1574, 1995, 2171, 2729, 3313, 3502, 4479, 4971, 5972, 6540, 6850, 8236, 8875, 9822, 10694, 11228, 11530, 11970, 12204, 12651, 13450, 13740, 14329, 14804, 15202, 15783, 16589, 17496, 17764]","[0, 206, 333, 648, 872, 1117, 1315, 1915, 2158, 2774, 3686, 4255, 4421, 5405, 6027, 6624, 7213, 8047, 8851, 9291, 10027, 10647, 11601, 11812, 12253, 12401, 12692, 13147, 13563, 14237, 14333, 14548, 14648, 15429, 15759]","[0, 170, 341, 526, 898, 1074, 1164, 1631, 1721, 1858, 2253, 2460, 2864, 3246, 3815, 4119, 4509, 5462, 6177, 6503, 7092, 7262, 7639, 7992, 8604, 9022, 9388, 10014, 10185, 10535, 11033, 11223, 11790, 12712, 12812]","[0, 170, 310, 419, 593, 736, 860, 1257, 1347, 1572, 2041, 2131, 2489, 2728, 3292, 3505, 3645, 4187, 4542, 4779, 5164, 5259, 5586, 5860, 6129, 6224, 6515, 6634, 6876, 7151, 7247, 7549, 7649, 7839, 7939]",17050,17764,15759,12812,7939,46,23,96,68,26,"[0, 323, 667, 868, 1356, 1660, 2218, 2701, 3203, 3783, 4268, 4915, 5757, 6474, 7195, 7881, 8527, 9574, 10099, 10686, 11056, 11431, 12280, 13706, 15169, 16452, 17986, 18680, 19387, 20128, 20742, 20842, 21521, 21756, 23011]","[0, 294, 619, 1029, 1318, 1734, 2157, 2549, 3065, 3689, 4128, 4582, 4821, 5476, 5684, 6032, 6386, 6906, 7648, 8436, 9179, 9655, 10171, 10860, 11212, 12021, 13251, 14049, 14964, 16030, 16579, 16828, 17918, 18684, 19366]","[0, 241, 482, 695, 1114, 1435, 1716, 2107, 2462, 2879, 3014, 3390, 3605, 4200, 4334, 4846, 5521, 5901, 6369, 7034, 7337, 7984, 8828, 9097, 9790, 10546, 11483, 12396, 12962, 13374, 13692, 13865, 14659, 15027, 16052]","[0, 170, 260, 350, 440, 610, 918, 1172, 1262, 1505, 1852, 2212, 2408, 2730, 2825, 2920, 3249, 3917, 4310, 4657, 5260, 5515, 6024, 6798, 7273, 7960, 9213, 9918, 10492, 10809, 11227, 11666, 12598, 13561, 14228]","[0, 170, 593, 683, 922, 1012, 1293, 1473, 1590, 1722, 1867, 2003, 2181, 2388, 2521, 2616, 2773, 2997, 3199, 3467, 3562, 3710, 4026, 4950, 5572, 6135, 6506, 6951, 7284, 7455, 8051, 8226, 9237, 9547, 10012]",23011,19366,16052,14228,10012,-5961,-1602,-293,-1416,-2073,-11345,35,radiant
7578647418,1,63,120,105,100,"[0, 241, 572, 863, 1194, 1357, 1688, 1896, 2073, 2458, 3084, 3875, 4580, 4986, 5220, 5788, 6624, 7116, 7944, 8039, 8970, 9849, 10941, 11994, 12639, 13681, 14674, 15490, 16430, 17306, 18257, 19106, 20091, 20529, 21528]","[0, 221, 386, 748, 1246, 1819, 2487, 2879, 3444, 4109, 4467, 5322, 5808, 6447, 6761, 7126, 7472, 7979, 8637, 9288, 10181, 10741, 11685, 12271, 12847, 13304, 13719, 14369, 14911, 15750, 15947, 16504, 17293, 18096, 19509]","[0, 279, 563, 1008, 1409, 1772, 2185, 2518, 3042, 3672, 4056, 4576, 5086, 5478, 5824, 5919, 6713, 7317, 7917, 8313, 8985, 9692, 10392, 11021, 11941, 12623, 13128, 13772, 14225, 14750, 15542, 16066, 16533, 16871, 18165]","[0, 170, 278, 413, 543, 711, 880, 1015, 1135, 1643, 1778, 2316, 2447, 2865, 3089, 3188, 3693, 3938, 4212, 4496, 4956, 5225, 5796, 6073, 6425, 6906, 7365, 7577, 8352, 8535, 9011, 9591, 9850, 10221, 11168]","[0, 208, 298, 424, 691, 856, 1093, 1482, 1618, 1909, 2081, 2579, 2808, 3215, 3309, 3404, 3608, 3905, 4179, 4470, 4837, 5439, 6116, 6531, 6799, 7138, 7399, 7662, 7875, 8163, 8401, 8726, 8826, 9463, 10135]",21528,19509,18165,11168,10135,94,98,106,65,86,"[0, 389, 559, 981, 1143, 1433, 1821, 2216, 2599, 3018, 3303, 3972, 4423, 5044, 5850, 6517, 7556, 8156, 8810, 9511, 10564, 10892, 11671, 12474, 13265, 14211, 14920, 15607, 16702, 17107, 17896, 18923, 19483, 20239, 21298]","[0, 305, 601, 1055, 1221, 1628, 2165, 2590, 3188, 4051, 4547, 5227, 5940, 6681, 7220, 7867, 8433, 9020, 9698, 10399, 10950, 11542, 12323, 12960, 13324, 14206, 15220, 15748, 16749, 17575, 18823, 19267, 20766, 21371, 21972]","[0, 688, 931, 1437, 1730, 2109, 2582, 3394, 3724, 4172, 4549, 5284, 5870, 6236, 6790, 7370, 7834, 8100, 8766, 9333, 9776, 9942, 10746, 10951, 11596, 11996, 12599, 13066, 13773, 14378, 14987, 15177, 16059, 16401, 16756]","[0, 232, 322, 459, 549, 719, 1110, 1403, 1519, 1813, 1950, 2442, 2806, 3180, 3457, 3946, 4462, 4906, 5501, 5769, 6215, 6381, 6687, 7005, 7193, 7625, 8336, 8636, 9137, 9653, 9965, 10447, 10723, 11426, 11651]","[0, 232, 358, 497, 736, 906, 1342, 1639, 1787, 2159, 2563, 2759, 3412, 3655, 3940, 4162, 4625, 4771, 5190, 5877, 6142, 6308, 6622, 6920, 7343, 7765, 8090, 8185, 8472, 8998, 9208, 9398, 9678, 9888, 10159]",21298,21972,16756,11651,10159,230,-2463,1409,-483,-24,-1331,35,radiant
7578648816,80,98,74,105,26,"[0, 256, 536, 992, 1236, 1638, 2198, 2446, 2792, 3254, 3908, 4579, 5077, 5272, 6168, 6663, 7099, 7955, 8944, 9694, 10324, 10634, 11653, 11768, 12444, 12566, 12970, 13718, 14325, 15700, 15796, 16147, 16947, 17275, 17375]","[0, 294, 544, 1030, 1386, 1623, 1955, 2089, 2713, 3220, 3885, 4450, 5072, 5647, 5929, 6591, 7073, 7610, 7890, 8381, 9328, 9758, 10832, 11109, 11282, 11493, 12099, 12672, 13512, 14167, 14263, 15034, 15672, 16620, 16720]","[0, 296, 609, 996, 1251, 1482, 1774, 2116, 2782, 3333, 3646, 4095, 4554, 5000, 5792, 6192, 6377, 6957, 7158, 7507, 8301, 8916, 10069, 11112, 11580, 11674, 12077, 12884, 13851, 14500, 14596, 15220, 15853, 15953, 16053]","[0, 170, 260, 475, 565, 655, 745, 835, 1139, 1401, 1705, 1949, 2440, 2649, 3115, 3377, 3472, 3825, 4036, 4365, 4880, 5253, 5645, 5740, 6231, 6430, 6930, 7187, 7364, 7619, 8105, 8822, 9387, 9487, 9657]","[0, 170, 260, 394, 518, 608, 724, 814, 1296, 1692, 1821, 1911, 2205, 2438, 2622, 2807, 2902, 3480, 3807, 4139, 4452, 4731, 4984, 5288, 5899, 6182, 6277, 6534, 6711, 7218, 7314, 7969, 8350, 8808, 8908]",17375,16720,16053,9657,8908,25,120,97,86,83,"[0, 204, 570, 1126, 1801, 2353, 2728, 3437, 3861, 4328, 4841, 5441, 5914, 6462, 6839, 7337, 8079, 9039, 9836, 10565, 11271, 12440, 12717, 13493, 14334, 15825, 16467, 17337, 17908, 19573, 19772, 20386, 21691, 23917, 26143]","[0, 347, 633, 922, 1383, 1769, 1980, 2604, 2817, 3146, 3780, 4142, 4848, 5099, 5769, 6414, 6806, 7261, 7931, 8446, 9009, 9506, 10314, 10971, 11324, 11802, 12262, 12776, 13466, 14039, 15018, 15626, 15894, 16849, 18411]","[0, 255, 874, 1037, 1364, 1738, 1962, 2281, 2578, 2826, 3190, 3621, 4163, 4530, 4836, 5684, 6356, 6613, 6894, 7275, 7512, 7992, 8528, 9979, 10264, 10636, 11242, 11732, 12474, 13192, 14441, 15226, 16142, 17184, 18058]","[0, 209, 368, 504, 641, 839, 958, 1198, 1580, 1670, 1937, 2105, 2331, 2812, 3291, 3554, 4024, 4890, 5200, 5530, 5828, 6497, 6724, 7298, 7513, 7958, 8251, 8747, 9208, 10500, 11108, 11433, 11936, 12620, 13532]","[0, 170, 260, 503, 713, 1291, 1510, 1938, 2028, 2118, 2253, 2691, 2917, 3199, 3353, 3569, 3828, 4138, 4333, 4569, 4860, 5215, 5405, 5985, 6223, 6389, 6717, 7054, 7311, 7835, 8430, 8755, 8855, 9400, 10275]",26143,18411,18058,13532,10275,-8768,-1691,-2005,-3875,-1367,-17706,35,dire
7578746005,95,17,20,100,45,"[142, 661, 972, 1338, 1557, 1942, 2193, 2628, 3255, 3591, 4131, 4472, 4919, 5372, 6332, 6771, 7467, 7651, 8030, 8973, 9561, 9909, 10912, 12205, 12896, 13757, 14459, 15645, 15741, 16093, 16750, 16850, 17380, 18133, 19019]","[408, 792, 1086, 1507, 2036, 2567, 3187, 4462, 4800, 5148, 5753, 6465, 6555, 6704, 7382, 7780, 8172, 8356, 9295, 10073, 10709, 11497, 12013, 13028, 13233, 13674, 14171, 14998, 15454, 16015, 16578, 16678, 17301, 18542, 18911]","[142, 498, 698, 898, 1285, 1968, 2506, 3159, 3294, 4019, 4255, 4613, 4965, 5542, 6038, 6513, 6968, 7396, 8212, 8970, 9382, 9897, 11587, 12112, 12207, 12373, 12761, 13933, 14614, 14829, 15894, 16347, 17441, 18361, 18626]","[142, 383, 473, 563, 693, 919, 1358, 1810, 2016, 2251, 2522, 2715, 2969, 3164, 3499, 3594, 3851, 4035, 4412, 4806, 4964, 5097, 5420, 5853, 6023, 6264, 6743, 7839, 8263, 8515, 9101, 9391, 9781, 10398, 10608]","[142, 587, 677, 848, 978, 1155, 1290, 1854, 2071, 2161, 2417, 2507, 2597, 2772, 3000, 3095, 3190, 3497, 3867, 4700, 4911, 5235, 5419, 5852, 5947, 6314, 6490, 6585, 6681, 6987, 7714, 7814, 8139, 8818, 9028]",19019,18911,18626,10608,9028,1,96,138,106,83,"[187, 357, 756, 1247, 1442, 1804, 1894, 2154, 2775, 3217, 3642, 4227, 4655, 5216, 5412, 5723, 6551, 7308, 8354, 9461, 10323, 11195, 11652, 12533, 13421, 14417, 14963, 15751, 15928, 16846, 18175, 18540, 19599, 20754, 22534]","[187, 509, 775, 1044, 1439, 2038, 2410, 2925, 3109, 3678, 4243, 4886, 5457, 5811, 6237, 6666, 7421, 8947, 9585, 9778, 10630, 11623, 11718, 12525, 13133, 13858, 14270, 14365, 15162, 15554, 16964, 17619, 18098, 18939, 19858]","[320, 702, 792, 931, 1591, 2012, 2166, 2388, 2670, 2841, 3024, 3248, 3709, 4372, 4554, 4793, 5435, 6421, 7093, 7381, 7679, 8502, 8859, 9605, 10009, 10702, 10853, 11569, 12160, 12256, 13851, 14714, 14814, 15345, 15847]","[121, 367, 494, 775, 1103, 1410, 1582, 1800, 1941, 2820, 3235, 3415, 3969, 4489, 4879, 5458, 5841, 6389, 6972, 7165, 7648, 8397, 8492, 8935, 9973, 10483, 10887, 12330, 12507, 12791, 13853, 14043, 14562, 14772, 15247]","[588, 758, 1105, 1299, 1635, 1763, 2029, 2164, 2375, 2482, 3098, 3611, 4067, 4367, 4461, 4714, 5458, 5997, 6495, 6909, 7169, 8184, 8362, 8529, 8912, 9415, 9510, 9928, 10213, 10309, 11121, 11311, 11411, 11772, 12021]",22534,19858,15847,15247,12021,-3515,-947,2779,-4639,-2993,-9315,35,dire
7579518917,48,43,123,97,26,"[0, 174, 479, 722, 1006, 1324, 1627, 2007, 2338, 2834, 3246, 3747, 4423, 5102, 5196, 6335, 7155, 8475, 10047, 11180, 11902, 12845, 13676, 14659, 15894, 16766, 17349, 18433, 18699, 20008, 20690, 21782, 22453, 22758, 22920]","[0, 506, 756, 1012, 1422, 1670, 2289, 3366, 3791, 4542, 4941, 5462, 6000, 6671, 6804, 7378, 7945, 8265, 8872, 9427, 9827, 10137, 10683, 11413, 12428, 13217, 14263, 14581, 15230, 15761, 15990, 16674, 17257, 17404, 17843]","[0, 462, 637, 762, 1008, 1133, 1315, 1603, 1796, 2043, 2268, 2599, 3081, 3338, 3609, 4215, 4763, 5333, 6150, 6933, 7239, 8545, 9172, 10065, 10554, 12110, 13122, 14119, 14798, 15725, 16032, 16436, 16654, 16912, 17012]","[0, 404, 605, 874, 1413, 1760, 2309, 2720, 3265, 3797, 4604, 5099, 5520, 5875, 6257, 6592, 7103, 7773, 8569, 8765, 9071, 9471, 9798, 10500, 11327, 12577, 13258, 14042, 14591, 14867, 15239, 15577, 15677, 15821, 16237]","[0, 462, 598, 737, 905, 1041, 1176, 1673, 1896, 2178, 2488, 2625, 2765, 3328, 3422, 3729, 3887, 3982, 4368, 4510, 4872, 5225, 5506, 5970, 6270, 6913, 7112, 7288, 7465, 7938, 8360, 8722, 9125, 9273, 9504]",22920,17843,17012,16237,9504,49,46,28,121,105,"[0, 396, 709, 879, 1140, 1558, 1901, 2430, 2851, 3151, 3484, 4015, 4635, 5061, 6355, 6820, 7344, 7998, 8430, 9501, 9864, 9959, 10510, 11410, 12119, 12815, 13290, 14147, 15124, 15943, 17064, 17717, 17961, 18868, 20136]","[0, 685, 857, 1224, 1603, 2039, 2334, 2590, 3062, 3560, 4218, 4865, 5295, 5836, 7044, 7792, 8344, 8936, 9104, 9756, 10143, 10441, 11491, 12207, 12302, 12767, 13127, 13640, 14317, 14647, 15188, 16782, 17432, 19293, 20574]","[0, 206, 477, 889, 1017, 1481, 1949, 2464, 2784, 3222, 3608, 4043, 4604, 4805, 5814, 6196, 6740, 7411, 7891, 8255, 8607, 9015, 9197, 9749, 9844, 10171, 10449, 10544, 11055, 11337, 11876, 12293, 12557, 13618, 14433]","[0, 438, 528, 666, 756, 975, 1188, 1323, 1727, 2043, 2266, 2410, 2572, 2769, 3392, 3644, 3739, 4541, 4635, 4812, 4995, 5115, 5339, 5506, 5601, 6049, 6327, 6479, 6702, 6908, 7413, 8099, 8549, 10386, 10776]","[0, 305, 395, 485, 603, 821, 911, 1046, 1181, 1316, 1483, 1699, 1789, 2287, 2861, 2956, 3148, 3582, 3676, 4098, 4288, 4552, 5013, 5180, 5275, 5602, 6250, 6555, 6860, 7268, 8101, 8513, 8772, 9507, 9897]",20136,20574,14433,10776,9897,2784,-2731,2579,5461,-393,7700,35,radiant
7580040907,1,49,14,86,123,"[0, 259, 532, 995, 1259, 1622, 1820, 2629, 3037, 3509, 4101, 4744, 5185, 6131, 6313, 6726, 7156, 7933, 8803, 9600, 10562, 10739, 11932, 12504, 13387, 14266, 15146, 15780, 16470, 17191, 17941, 18688, 20707, 22602, 23749]","[0, 364, 814, 1190, 1482, 2064, 2584, 2984, 3547, 4006, 4595, 5522, 6399, 7188, 7676, 7825, 8323, 8761, 9098, 9523, 9653, 10523, 11260, 11787, 12795, 13173, 13644, 14174, 15147, 15840, 16346, 17543, 18051, 19426, 20239]","[0, 282, 612, 871, 1227, 1764, 2284, 2824, 3268, 3752, 4412, 5209, 5569, 6644, 6774, 6923, 7505, 8195, 8478, 8588, 8704, 9068, 9550, 10078, 10638, 11019, 11502, 12354, 12872, 13107, 13859, 14336, 14802, 14902, 15308]","[0, 261, 351, 758, 848, 1064, 1226, 1506, 1668, 1852, 2250, 2721, 3002, 3428, 3999, 4409, 4567, 4946, 5185, 5537, 5770, 5941, 6182, 6352, 6742, 7055, 7435, 7857, 8669, 9347, 10299, 10564, 11233, 11879, 12489]","[0, 210, 405, 570, 660, 873, 963, 1308, 1452, 1587, 1888, 2233, 2593, 2996, 3140, 3289, 3610, 3815, 4062, 4305, 4403, 4659, 4994, 5475, 6438, 6720, 6895, 6990, 7723, 8081, 8287, 8599, 8699, 9176, 9720]",23749,20239,15308,12489,9720,12,106,43,31,121,"[0, 236, 434, 918, 1237, 1354, 1494, 1890, 2116, 2392, 2679, 3070, 3333, 4009, 4605, 5443, 6161, 6845, 8380, 9030, 9461, 10231, 11113, 12290, 13259, 14191, 15139, 15868, 16691, 17141, 18011, 18851, 20262, 20678, 20778]","[0, 250, 518, 848, 1074, 1435, 1675, 2089, 2306, 2804, 2980, 3243, 3631, 3949, 4269, 5175, 5636, 6004, 6749, 7552, 8454, 9096, 10149, 10721, 11582, 12126, 13233, 13814, 14610, 15135, 15950, 16902, 17451, 17551, 18289]","[0, 547, 821, 1019, 1599, 1763, 2115, 2388, 2547, 3060, 3318, 3535, 3917, 4275, 5219, 5909, 6435, 7114, 8117, 8835, 9379, 9884, 10599, 11199, 11885, 12907, 13229, 13411, 13642, 14321, 14883, 15477, 15577, 16118, 16588]","[0, 200, 290, 510, 649, 746, 968, 1058, 1148, 1238, 1376, 1514, 1751, 1968, 2096, 2689, 2946, 3223, 3775, 3933, 4526, 4919, 5157, 5457, 5887, 6341, 6546, 6727, 6958, 7350, 7446, 7807, 8803, 9048, 9190]","[0, 200, 290, 415, 803, 893, 1031, 1245, 1424, 1514, 1724, 1814, 1904, 2044, 2138, 2648, 2743, 2928, 3303, 3774, 4410, 4803, 5041, 5341, 5771, 5938, 6032, 6174, 6405, 6582, 6678, 6888, 7575, 8065, 8207]",20778,18289,16588,9190,8207,2971,1950,-1280,3299,1513,8453,35,radiant
7580268816,21,48,13,62,64,"[0, 204, 691, 972, 1371, 1641, 2270, 2811, 3644, 4305, 4787, 5781, 6405, 7303, 8040, 8758, 9601, 10165, 11309, 11948, 12757, 13570, 14418, 15540, 16726, 17689, 19027, 19956, 21185, 23259, 23714, 24566, 25559, 25659, 27116]","[0, 279, 555, 910, 1244, 1659, 2019, 2383, 2887, 3343, 3934, 4646, 5281, 5824, 6183, 6819, 8107, 8379, 9214, 9770, 10693, 11333, 12197, 12607, 13303, 14727, 16313, 18343, 19029, 21482, 22511, 23192, 24435, 25295, 25844]","[0, 327, 653, 1033, 1356, 1782, 2372, 2810, 3636, 4116, 4609, 4878, 5417, 6155, 6698, 7140, 7958, 8443, 9130, 9887, 10420, 11160, 11578, 12416, 13188, 13595, 14646, 15248, 15955, 17554, 18622, 18888, 19168, 19768, 20698]","[0, 187, 622, 789, 947, 1077, 1234, 1344, 1606, 1714, 1804, 2022, 2377, 2696, 3086, 3512, 4501, 5184, 5387, 5867, 6172, 6461, 7208, 7392, 7984, 8611, 9153, 10391, 11081, 13081, 13466, 14335, 15417, 15747, 17563]","[0, 170, 260, 394, 533, 671, 808, 902, 1139, 1274, 1412, 1614, 1790, 1939, 2166, 2299, 2585, 3041, 3379, 3473, 3568, 3663, 4328, 4613, 4852, 5247, 5932, 6136, 6645, 8706, 9162, 9262, 9827, 9927, 10297]",27116,25844,20698,17563,10297,25,16,138,67,97,"[0, 340, 664, 1085, 1463, 2163, 2800, 3304, 3990, 4557, 5407, 6617, 7268, 8056, 8877, 9566, 10542, 11994, 13345, 13933, 14760, 16095, 16634, 17669, 18573, 20319, 21788, 21882, 22395, 22491, 23236, 24191, 26928, 27028, 28243]","[0, 280, 571, 1053, 1414, 1741, 2343, 2727, 3173, 3538, 3954, 4380, 4870, 5526, 6243, 6677, 7390, 8076, 8591, 8860, 9403, 9572, 10401, 11530, 11960, 12399, 12582, 12819, 12915, 13011, 13658, 14434, 15559, 15946, 16768]","[0, 222, 312, 481, 669, 850, 1034, 1195, 1401, 1673, 1977, 2121, 2430, 2716, 2932, 3111, 3665, 3940, 4458, 4948, 5324, 5770, 6386, 6888, 7992, 8736, 8869, 10006, 10683, 10779, 11478, 11665, 12385, 12736, 15062]","[0, 283, 490, 672, 922, 1135, 1309, 1693, 1865, 2004, 2473, 2720, 3217, 3484, 4046, 4455, 4926, 5319, 5826, 6466, 6822, 7639, 8572, 8973, 9809, 10776, 10896, 11728, 11824, 11920, 12016, 12411, 13365, 13936, 14581]","[0, 170, 260, 583, 673, 763, 898, 1033, 1404, 1530, 1701, 1883, 2202, 2618, 2979, 3139, 3596, 3813, 4135, 4361, 4694, 5314, 5707, 5876, 6261, 6821, 7192, 7707, 7878, 8160, 8604, 8999, 9243, 9343, 10455]",28243,16768,15062,14581,10455,-1127,9076,5636,2982,-158,16409,35,radiant
7580511616,62,106,41,53,40,"[2, 170, 453, 790, 1449, 1731, 2336, 2583, 3223, 4088, 5108, 5334, 6540, 7013, 7354, 7521, 8127, 9606, 10071, 10337, 12628, 13015, 13605, 14793, 15481, 16337, 17141, 18249, 18974, 19278, 20361, 20924, 24418, 24518, 25713]","[0, 243, 503, 833, 1316, 1729, 2100, 2585, 3100, 4059, 4563, 5537, 6264, 6660, 7165, 7791, 8786, 9152, 9890, 10518, 11716, 12368, 13211, 13651, 14360, 15126, 16198, 17320, 18345, 18899, 20061, 20665, 22242, 22974, 23843]","[0, 164, 326, 926, 1241, 1562, 1861, 2117, 2523, 2931, 3555, 4098, 4877, 5386, 5968, 6436, 7021, 7787, 8327, 9150, 9864, 10545, 10794, 11584, 11970, 12717, 13292, 14006, 14876, 15762, 16958, 17839, 19702, 19802, 21789]","[0, 131, 264, 354, 622, 718, 1162, 1252, 1688, 1990, 2322, 2607, 3284, 3433, 4174, 4269, 4768, 5218, 5887, 6452, 7088, 7359, 7945, 8830, 9469, 10231, 11000, 11651, 12020, 12443, 12681, 13428, 14043, 15526, 16318]","[0, 129, 219, 309, 509, 599, 760, 866, 1129, 1564, 1869, 2119, 2382, 2631, 2823, 3018, 3324, 3776, 4218, 4397, 5334, 5823, 5993, 6409, 7111, 7867, 8140, 8535, 8741, 9217, 9870, 10086, 10517, 11183, 12320]",25713,23843,21789,16318,12320,89,98,39,19,112,"[0, 291, 536, 1151, 1325, 1690, 2002, 2188, 2494, 3060, 3517, 4044, 4513, 5179, 6028, 6667, 7315, 8476, 9127, 9585, 9743, 10410, 11204, 12557, 12886, 14009, 15062, 15592, 16836, 17896, 18899, 19664, 20965, 21238, 21472]","[0, 247, 707, 894, 1320, 1686, 2022, 2674, 3005, 4062, 4450, 4865, 4955, 5897, 6425, 6970, 7428, 8152, 8778, 9685, 9909, 10247, 10850, 11681, 12591, 12978, 13582, 14593, 15107, 16095, 16367, 17239, 19049, 19149, 19725]","[0, 361, 649, 1039, 1402, 1713, 1927, 2360, 2537, 3071, 3161, 3378, 3600, 4336, 4702, 5412, 5830, 6794, 7451, 8063, 8188, 8700, 9357, 9994, 10344, 10843, 11148, 11779, 11875, 12119, 12872, 13406, 14894, 14994, 15436]","[0, 209, 299, 414, 504, 674, 933, 1113, 1203, 1557, 1764, 1931, 2114, 2403, 2746, 3548, 3658, 4292, 4386, 4607, 4702, 4907, 5073, 5330, 5650, 5817, 6104, 6980, 7076, 7253, 7754, 7915, 8810, 8910, 9125]","[0, 209, 299, 535, 625, 761, 966, 1146, 1236, 1590, 1719, 1844, 2079, 2787, 2928, 3292, 3459, 4078, 4342, 4563, 4658, 4753, 4919, 5414, 5809, 6139, 6314, 6924, 7020, 7474, 7804, 8204, 8304, 8577, 8794]",21472,19725,15436,9125,8794,4241,4118,6353,7193,3526,25431,35,radiant
7580525516,109,7,97,65,20,"[0, 216, 462, 965, 1240, 1590, 1874, 2667, 3127, 3569, 3890, 4369, 5011, 5928, 6579, 7172, 8471, 9011, 10241, 11020, 11688, 12525, 12761, 13245, 13830, 15282, 16303, 17536, 18722, 19156, 20070, 21252, 22237, 23837, 24661]","[0, 205, 621, 956, 1487, 1781, 2266, 2763, 3063, 3601, 4146, 4813, 4903, 5579, 5805, 6075, 6696, 7366, 7769, 8099, 8911, 9051, 9292, 9859, 10444, 11106, 11583, 12405, 13033, 13426, 14101, 14663, 15149, 16238, 16599]","[0, 241, 606, 732, 1383, 1820, 2431, 2777, 3567, 3953, 4320, 4979, 5436, 6538, 6982, 7598, 8062, 8519, 8952, 9109, 10100, 10790, 11069, 11348, 12099, 12884, 13429, 14109, 14467, 14599, 15093, 15827, 16709, 16899, 17189]","[0, 130, 220, 462, 552, 669, 759, 1105, 1195, 1469, 1718, 1863, 1953, 2950, 3045, 3190, 3724, 4011, 4357, 4698, 4981, 5257, 5352, 5518, 5956, 6499, 6893, 7098, 7336, 7432, 8045, 8898, 9322, 9957, 10057]","[0, 130, 270, 452, 729, 914, 1129, 1264, 1354, 1444, 1797, 2149, 2262, 2843, 2966, 3337, 3582, 4061, 4334, 4499, 4773, 4988, 5232, 5586, 5913, 6356, 6661, 6989, 7276, 7447, 7848, 8070, 8595, 9294, 9469]",24661,16599,17189,10057,9469,12,120,43,100,31,"[0, 284, 592, 867, 1153, 1543, 1793, 2243, 2415, 2896, 3292, 3842, 4349, 4759, 5153, 5918, 6581, 7319, 7894, 8695, 9143, 10198, 10485, 11764, 12423, 13281, 14289, 14981, 15666, 16731, 17302, 17973, 18567, 19480, 20060]","[0, 282, 526, 860, 1250, 1923, 2250, 2628, 3413, 3904, 4341, 4724, 5276, 5425, 6215, 6585, 7430, 7955, 8306, 9282, 9470, 10158, 10590, 11442, 12072, 12698, 13579, 14039, 14235, 15009, 15342, 15876, 17085, 17476, 18259]","[0, 246, 336, 674, 956, 1291, 1932, 2187, 2752, 3363, 3889, 3979, 4433, 4941, 5635, 6191, 6433, 6882, 7356, 7997, 8092, 8978, 9340, 9959, 10300, 10910, 11253, 11765, 12275, 12904, 13118, 13557, 14445, 14674, 14864]","[0, 210, 334, 590, 680, 953, 1238, 1328, 2012, 2504, 2683, 2773, 2944, 3039, 3408, 3784, 4195, 4574, 4716, 4963, 5081, 5420, 5515, 6302, 6502, 6715, 7009, 7214, 7310, 7707, 7803, 8029, 8580, 8706, 9130]","[0, 210, 300, 390, 480, 627, 844, 1014, 1197, 1790, 1925, 2389, 2634, 2729, 3060, 3208, 3808, 4070, 4412, 4812, 4954, 5169, 5339, 6033, 6372, 6542, 6911, 7191, 7362, 8126, 8507, 8807, 9256, 9413, 9644]",20060,18259,14864,9130,9644,4601,-1660,2325,927,-175,6018,35,dire
7580560302,49,43,129,128,121,"[0, 207, 598, 761, 1223, 1703, 2238, 2698, 3001, 3515, 4076, 4592, 5374, 5841, 6412, 6722, 6817, 7387, 8323, 9216, 10231, 11060, 12217, 12888, 13191, 13830, 14661, 15261, 15918, 16194, 16290, 17137, 17818, 18311, 18963]","[0, 362, 628, 845, 1141, 1418, 1774, 2171, 2761, 3647, 4118, 4411, 5196, 5579, 6025, 6459, 6640, 7076, 7623, 9072, 9816, 10071, 10489, 10894, 11586, 12925, 13020, 13198, 14021, 14981, 15354, 15988, 16467, 16567, 16915]","[0, 252, 450, 974, 1227, 1521, 1911, 2310, 2803, 3109, 3424, 3893, 4480, 4938, 5415, 5516, 5981, 6460, 6948, 7551, 8073, 8255, 8350, 8731, 9261, 9749, 9844, 10249, 10622, 11189, 11580, 12301, 12696, 12908, 13541]","[0, 170, 353, 711, 861, 991, 1196, 1405, 1540, 1764, 2014, 2152, 2415, 2509, 2704, 3080, 3175, 3318, 3614, 3890, 4060, 4154, 4415, 4653, 4747, 5343, 5569, 5909, 6201, 6297, 6596, 7300, 7743, 7843, 8191]","[0, 170, 600, 690, 857, 1080, 1250, 1459, 1594, 2061, 2607, 2697, 2991, 3119, 3433, 3616, 3962, 4199, 4582, 4677, 4870, 4964, 5328, 5471, 5565, 5927, 6022, 6163, 6385, 7189, 7440, 7686, 8130, 8266, 8614]",18963,16915,13541,8191,8614,47,93,106,123,110,"[0, 241, 522, 858, 1206, 1618, 1818, 2393, 2828, 3203, 3734, 4254, 4530, 5472, 5986, 6682, 7723, 8384, 8847, 9550, 10459, 11552, 12488, 13050, 13656, 14080, 14271, 15099, 15958, 16959, 17665, 18699, 19548, 20010, 21198]","[0, 170, 483, 700, 1195, 1534, 1838, 1991, 2361, 2852, 3390, 3809, 4596, 5607, 6245, 7047, 7590, 8782, 9679, 10033, 10645, 11069, 11983, 12927, 13640, 14708, 15312, 15855, 16737, 17366, 17623, 18964, 19502, 19779, 20328]","[0, 170, 440, 719, 1049, 1299, 1795, 2070, 2447, 2707, 3042, 3265, 3441, 4091, 4573, 5563, 6125, 6577, 6950, 7544, 8282, 8617, 9077, 9678, 10208, 10918, 11441, 12425, 13124, 13925, 14702, 15397, 16636, 16736, 17383]","[100, 270, 360, 497, 856, 1029, 1205, 1373, 1463, 1553, 1741, 1831, 1923, 2125, 2368, 2833, 3814, 4423, 4594, 5047, 5365, 5788, 6245, 6939, 7454, 8199, 8694, 8870, 9346, 10576, 10723, 11159, 11970, 12296, 12980]","[0, 170, 260, 350, 526, 700, 1062, 1230, 1365, 1455, 1643, 1843, 1946, 2202, 2450, 3012, 3403, 3751, 4078, 5208, 5497, 6116, 6589, 7047, 7421, 7861, 8322, 8498, 8830, 9469, 9582, 9987, 11064, 11177, 11765]",21198,20328,17383,12980,11765,-2235,-3413,-3842,-4789,-3151,-17430,35,dire
7581196114,34,41,28,20,101,"[0, 214, 500, 906, 1289, 1632, 1851, 2111, 2447, 2732, 3010, 3453, 3543, 3638, 3918, 4594, 5207, 5587, 5908, 6286, 6381, 7099, 7559, 8062, 8736, 9064, 9650, 9945, 10236, 10862, 11559, 13968, 14987, 16100, 17439]","[0, 243, 415, 789, 1193, 1492, 1655, 2041, 2414, 2917, 3271, 4062, 4407, 4698, 5254, 5810, 6157, 6492, 7098, 7574, 7954, 8637, 9518, 10205, 10472, 11329, 12079, 13135, 13749, 14309, 14940, 15040, 15901, 16632, 16908]","[0, 239, 599, 689, 813, 1348, 1607, 2104, 2399, 2617, 2927, 3174, 3420, 3640, 3872, 4468, 5068, 5289, 5579, 5775, 6051, 6588, 7473, 7614, 8166, 8260, 8436, 8569, 9327, 9849, 10308, 10408, 10831, 11330, 11430]","[0, 170, 260, 434, 611, 838, 928, 1018, 1152, 1552, 1702, 2053, 2143, 2387, 2666, 3289, 3548, 3642, 3988, 4146, 4290, 5048, 5215, 5330, 5847, 5941, 6117, 6292, 6628, 6897, 7299, 7399, 7589, 7970, 8246]","[0, 170, 260, 350, 440, 577, 667, 804, 943, 1033, 1183, 1273, 1411, 1506, 1937, 2371, 2690, 2784, 3230, 3388, 3483, 3963, 4130, 4225, 4578, 4672, 4892, 4987, 5278, 5547, 5733, 6314, 6504, 6789, 6889]",17439,16908,11430,8246,6889,94,25,98,86,26,"[61, 315, 644, 1148, 1465, 1589, 1982, 2368, 2810, 3258, 3874, 4720, 5292, 5688, 6355, 6796, 7224, 8125, 8583, 9768, 10478, 11630, 12830, 13694, 13903, 14695, 15182, 16334, 17066, 17539, 18279, 19623, 20626, 21506, 23035]","[61, 268, 394, 518, 762, 1050, 1303, 1685, 2064, 2403, 3195, 3934, 4554, 4996, 5090, 5409, 5731, 5990, 6648, 7806, 8365, 8539, 8959, 9362, 9825, 10492, 11150, 11472, 12230, 12774, 13493, 14483, 15147, 16157, 17336]","[61, 307, 785, 949, 1229, 1789, 2252, 2509, 2909, 3188, 3918, 4262, 4792, 5274, 5474, 5667, 6174, 6868, 7093, 7666, 8107, 8281, 8742, 9379, 9691, 10316, 10971, 11587, 12123, 12219, 12953, 13574, 13980, 14295, 14703]","[61, 231, 518, 608, 747, 960, 1099, 1189, 1361, 1523, 2187, 2493, 2673, 2912, 3041, 3324, 3762, 4080, 4265, 4738, 4920, 5291, 5555, 5650, 5915, 6248, 6538, 6793, 7314, 7573, 7921, 8268, 8458, 8773, 9570]","[329, 499, 589, 753, 1021, 1111, 1291, 1381, 1519, 1609, 2025, 2331, 2627, 2866, 3131, 3535, 3737, 3870, 4055, 4779, 5227, 5401, 5568, 5663, 6123, 6570, 6665, 6760, 7173, 7269, 7617, 8441, 8631, 8946, 9246]",23035,17336,14703,9570,9246,-5596,-428,-3273,-1324,-2357,-12978,35,dire
7581657607,113,93,28,56,26,"[0, 275, 591, 924, 1334, 1699, 1972, 2678, 2803, 3728, 4201, 4970, 5148, 5608, 6244, 6990, 7682, 8176, 8755, 9438, 9625, 10489, 11073, 11854, 12597, 13355, 14202, 14570, 15366, 16184, 16945, 17430, 18415, 18748, 19769]","[0, 321, 581, 779, 1030, 1433, 1925, 2311, 2520, 2782, 3045, 3389, 3825, 4277, 4987, 5728, 6406, 7265, 8044, 8711, 9317, 10202, 10860, 11504, 12155, 13146, 13962, 14419, 14675, 15698, 16643, 16979, 18280, 18553, 19425]","[0, 241, 473, 960, 1358, 1885, 2131, 2472, 2703, 3138, 3614, 4296, 4527, 4872, 5194, 5764, 6253, 6648, 7094, 7770, 8284, 8538, 9016, 9410, 9597, 10176, 10732, 11001, 11475, 12076, 12889, 13298, 13600, 13750, 14304]","[0, 170, 278, 419, 631, 779, 1001, 1294, 1673, 2113, 2362, 2885, 3242, 3337, 3700, 4185, 4457, 4766, 5276, 6260, 6459, 6750, 7041, 7437, 8161, 8827, 9040, 9135, 9680, 9963, 10472, 10971, 11567, 11667, 11925]","[0, 170, 297, 435, 641, 820, 1064, 1598, 1723, 1863, 2048, 2375, 2465, 2560, 2783, 3114, 3496, 3702, 3849, 4203, 4522, 4623, 4845, 5127, 5348, 5824, 6252, 6660, 7136, 7733, 8068, 8796, 8986, 9086, 9276]",19769,19425,14304,11925,9276,49,21,126,114,58,"[0, 241, 573, 821, 1236, 1643, 1937, 2325, 3116, 3494, 4273, 4868, 5115, 5815, 6284, 6963, 7224, 7685, 8432, 9544, 10024, 10690, 11536, 11870, 12744, 13934, 14638, 15185, 15876, 16378, 16878, 18934, 19367, 19698, 20839]","[0, 170, 511, 801, 1039, 1330, 1793, 2215, 2891, 3334, 3794, 4096, 4714, 5438, 5867, 5961, 6443, 7378, 7875, 8517, 9018, 9863, 10629, 11284, 12104, 13216, 13917, 14447, 14899, 15238, 16002, 18192, 18650, 19490, 19961]","[0, 208, 495, 743, 1118, 1578, 1948, 2239, 2550, 2863, 3573, 3752, 4839, 5379, 5751, 6144, 6428, 6669, 7459, 7781, 8175, 8642, 9322, 9731, 10236, 11059, 11539, 11969, 12441, 12787, 13513, 14958, 15256, 15559, 16359]","[0, 218, 372, 580, 1063, 1291, 1426, 1841, 2141, 2241, 2671, 2815, 3108, 3782, 4008, 4102, 4543, 4823, 5011, 5304, 5752, 6424, 7126, 7543, 7730, 8007, 8271, 8576, 8753, 8849, 9108, 10083, 10762, 10997, 11471]","[0, 170, 260, 411, 549, 684, 835, 1072, 1485, 1575, 2007, 2285, 2697, 3028, 3197, 3400, 3690, 4080, 4458, 4632, 4741, 5017, 5436, 5802, 6296, 6962, 7466, 7679, 7856, 8156, 8457, 9304, 9518, 9894, 10830]",20839,19961,16359,11471,10830,-1070,-536,-2055,454,-1554,-4761,35,dire
7581700206,95,36,14,53,26,"[0, 517, 788, 1028, 1283, 1783, 1923, 2810, 3207, 3523, 3880, 4402, 4602, 5617, 6316, 6942, 7635, 8294, 8898, 9056, 9631, 10509, 11232, 11986, 12281, 12376, 13383, 13477, 14023, 14556, 14760, 15794, 16741, 16956, 17414]","[0, 491, 737, 991, 1270, 1530, 1968, 2488, 2988, 3193, 3283, 3561, 3914, 4892, 5071, 5340, 5954, 6354, 7096, 7823, 8088, 8385, 8570, 8927, 9728, 10076, 10615, 10709, 10996, 11193, 11537, 11910, 12252, 12467, 12608]","[0, 381, 577, 860, 1260, 1633, 1908, 2314, 3120, 3470, 3808, 4058, 4642, 5073, 5216, 5427, 5889, 6021, 6227, 6585, 6814, 7040, 7323, 7634, 8032, 8703, 9133, 9445, 9751, 9990, 10086, 10343, 10745, 10960, 11342]","[0, 302, 536, 626, 878, 1004, 1134, 1495, 1698, 2179, 2269, 2413, 2503, 2842, 3116, 3364, 3851, 4233, 5397, 5831, 6060, 6518, 6703, 6926, 7221, 7316, 7974, 8068, 8220, 8411, 8637, 8827, 9037, 9390, 9797]","[0, 337, 427, 563, 697, 862, 992, 1176, 1442, 1597, 1697, 1841, 2081, 2760, 2855, 3185, 3470, 3688, 4126, 4284, 4513, 4608, 4793, 4887, 5443, 5538, 5795, 5889, 6030, 6126, 6222, 6412, 6622, 6837, 6937]",17414,12608,11342,9797,6937,47,41,28,121,3,"[0, 543, 864, 1150, 1359, 1734, 2254, 2598, 2946, 3430, 4371, 4888, 5505, 5984, 6407, 6983, 7657, 8252, 9029, 9358, 9915, 10493, 10901, 11593, 13201, 14232, 14994, 16172, 17125, 18919, 19839, 20785, 22000, 24099, 24751]","[0, 214, 455, 662, 876, 1270, 1591, 1969, 2249, 2635, 3074, 3905, 4252, 4623, 5152, 5480, 6308, 6848, 7677, 8155, 8665, 9190, 9781, 10306, 10517, 11121, 11895, 13575, 14297, 14696, 15086, 15745, 16769, 18150, 18875]","[0, 307, 475, 821, 1189, 1279, 1959, 2049, 2357, 2571, 3584, 4039, 4815, 5170, 5429, 6085, 6546, 6888, 7212, 7764, 8347, 9010, 9446, 10008, 10686, 11426, 11631, 12480, 13195, 14082, 14528, 14763, 16169, 17943, 18421]","[0, 268, 441, 548, 683, 773, 1184, 1274, 1364, 1498, 1838, 2183, 2700, 2912, 3084, 3313, 3524, 3692, 4005, 4136, 4999, 5184, 5351, 5445, 6085, 6519, 6614, 7480, 7787, 8331, 9062, 9297, 10136, 11215, 11558]","[0, 401, 531, 621, 715, 853, 1171, 1261, 1369, 1510, 1884, 2229, 2359, 2454, 2622, 2891, 3178, 3319, 3541, 3710, 3867, 4052, 4219, 4313, 4524, 4848, 5112, 5822, 6143, 6963, 7169, 7435, 8157, 9136, 9986]",24751,18875,18421,11558,9986,-7337,-6267,-7079,-1761,-3049,-25493,35,dire
7581788819,10,71,97,5,86,"[0, 208, 504, 843, 1255, 1532, 1866, 2747, 3139, 4011, 4479, 5452, 6418, 6686, 7442, 8059, 8858, 10027, 10749, 10843, 10985, 11484, 12376, 12946, 14094, 14452, 15088, 15374, 15702, 18425, 19689, 20494, 22944, 24213, 25525]","[0, 482, 790, 1051, 1569, 1699, 2293, 2658, 3036, 3414, 3959, 4579, 5108, 6082, 6510, 7187, 7942, 8406, 9180, 9384, 9983, 10313, 10862, 11382, 12275, 13147, 13630, 14486, 15486, 16668, 17505, 18362, 19526, 20801, 21340]","[0, 247, 539, 739, 1142, 1623, 1819, 2083, 2531, 2755, 3440, 3770, 3967, 4313, 4804, 5214, 5816, 6741, 7200, 7486, 7581, 7676, 8476, 9162, 10188, 10772, 11461, 12046, 12352, 13910, 14907, 15818, 16587, 16687, 17501]","[0, 230, 405, 495, 631, 902, 1039, 1386, 1476, 1763, 2405, 2976, 3378, 3723, 3925, 4161, 4527, 5192, 5440, 5534, 5629, 5906, 6338, 6898, 7107, 7446, 7540, 7635, 8032, 8380, 9263, 9855, 10194, 10405, 11057]","[0, 568, 706, 796, 973, 1103, 1380, 1717, 2092, 2619, 2937, 3237, 3524, 3753, 4450, 4896, 5465, 6023, 6271, 6365, 6548, 6735, 7196, 7291, 7587, 7845, 7939, 8188, 8578, 9012, 9218, 9588, 9933, 10033, 10799]",25525,21340,17501,11057,10799,106,69,93,65,58,"[0, 322, 818, 1241, 1656, 1823, 2228, 2708, 3119, 3613, 3836, 4126, 5318, 6154, 7104, 7438, 7769, 8788, 9271, 9933, 11351, 11446, 12616, 13682, 14191, 14740, 15134, 16329, 17079, 18168, 18506, 19410, 21524, 21624, 22101]","[0, 204, 509, 1073, 1528, 1726, 2198, 2481, 3241, 3731, 4152, 4342, 5206, 5850, 6505, 6648, 6743, 8034, 8678, 9283, 10338, 10802, 11287, 11780, 12097, 12608, 12827, 13567, 13929, 14532, 14658, 14913, 15280, 15436, 15673]","[0, 244, 487, 684, 1059, 1555, 1803, 2307, 2700, 3245, 3731, 4138, 4334, 4795, 5895, 6339, 6835, 7238, 7877, 8884, 9771, 10617, 11654, 12139, 12527, 13052, 13647, 14592, 15105, 15505, 15601, 16012, 16222, 16631, 16800]","[0, 169, 273, 520, 715, 805, 1043, 1178, 1563, 1929, 2177, 2540, 2884, 3497, 4022, 4116, 4746, 4993, 5336, 6256, 6718, 7096, 7426, 7720, 8075, 8170, 8636, 8989, 9364, 9742, 9838, 10779, 11730, 12169, 12269]","[0, 169, 259, 383, 618, 1004, 1390, 1570, 2028, 2339, 2528, 2908, 3708, 4149, 4525, 4721, 5450, 6079, 6748, 7871, 8451, 8932, 9498, 9593, 9876, 10439, 10916, 11883, 12357, 12588, 12731, 13265, 13678, 13778, 14164]",22101,15673,16800,12269,14164,3424,5667,701,-1212,-3365,5215,35,radiant
7582214316,1,47,23,105,26,"[0, 377, 659, 1024, 1619, 2032, 2400, 3060, 3675, 4051, 4157, 4585, 5004, 5581, 6026, 6688, 7901, 8781, 9798, 10708, 11396, 12148, 12242, 13409, 14467, 15477, 16532, 17824, 20589, 22102, 23525, 24863, 27279, 28478, 29263]","[0, 201, 492, 701, 1113, 1284, 1652, 2291, 2596, 2964, 3488, 3949, 4418, 5055, 5494, 6085, 6522, 7082, 7608, 8021, 8864, 9148, 9242, 9702, 10406, 10661, 11112, 12062, 13095, 13618, 14175, 14536, 15994, 16647, 17074]","[0, 495, 728, 991, 1482, 1647, 2010, 2397, 2821, 3286, 3686, 4256, 4918, 5220, 5401, 5933, 6335, 6806, 7241, 7886, 8447, 8751, 9114, 9794, 10332, 10851, 11212, 12050, 12885, 13573, 14356, 14730, 15442, 16286, 16594]","[0, 398, 488, 599, 798, 1146, 1236, 1778, 2271, 2475, 2565, 2797, 2977, 3148, 3243, 3960, 4369, 4464, 5051, 5819, 6640, 6936, 7073, 7243, 7716, 8199, 8482, 8858, 9430, 9867, 10273, 10896, 11878, 12267, 12486]","[0, 265, 444, 853, 1104, 1194, 1333, 1697, 1849, 2223, 3179, 3398, 3578, 3809, 3904, 4127, 4311, 4502, 4806, 5185, 5578, 5751, 5845, 6067, 6274, 6634, 6812, 7113, 7560, 8114, 8210, 8663, 9634, 9979, 10169]",29263,17074,16594,12486,10169,69,17,21,86,72,"[0, 369, 618, 828, 993, 1227, 1513, 1930, 2060, 2322, 2864, 3532, 4010, 4508, 5325, 5691, 6105, 6747, 7473, 8014, 8620, 9788, 10390, 10804, 11598, 12423, 13001, 13498, 14417, 15223, 15582, 16455, 17088, 18087, 18888]","[0, 366, 650, 1207, 1384, 1707, 2329, 2934, 3380, 4465, 4822, 5219, 5683, 5897, 6341, 6656, 7385, 7625, 7978, 8821, 9445, 9973, 11237, 11688, 12445, 13087, 13943, 14290, 14787, 15653, 16089, 16556, 16792, 17398, 18195]","[0, 241, 558, 813, 1061, 1484, 1804, 2210, 2977, 3784, 4004, 4422, 5257, 5533, 5878, 6798, 7624, 8199, 8797, 9418, 10021, 11330, 11803, 12490, 12829, 13556, 14037, 14410, 15253, 15411, 16058, 16822, 16922, 17112, 17688]","[0, 380, 470, 560, 874, 1317, 1543, 1891, 2134, 3035, 3436, 3920, 4561, 4703, 5338, 5501, 5749, 5893, 6286, 6663, 6834, 7841, 8531, 8953, 9258, 9748, 10090, 10498, 10918, 11179, 11332, 11632, 11868, 12118, 12438]","[0, 646, 736, 1054, 1178, 1399, 1751, 2223, 2464, 3384, 3604, 3694, 4174, 4393, 4788, 5090, 5386, 5481, 5695, 5852, 6077, 6918, 7351, 7648, 7878, 8133, 8337, 9105, 9335, 9431, 9881, 10217, 10490, 11255, 11626]",18888,18195,17688,12438,11626,10375,-1121,-1094,48,-1457,6751,35,radiant
7582264918,93,106,96,123,26,"[0, 320, 551, 831, 1100, 1428, 1636, 2241, 2415, 2786, 3252, 3687, 4270, 4410, 5078, 5602, 6316, 6927, 8005, 8099, 9301, 10002, 10767, 11548, 12204, 12803, 12898, 14070, 14841, 15391, 16025, 16948, 17845, 19612, 20986]","[0, 293, 661, 1020, 1345, 1784, 2430, 2845, 3142, 3839, 4303, 4895, 5375, 5961, 6257, 6527, 7073, 7594, 8235, 8497, 8969, 9382, 9568, 9806, 10450, 11054, 11773, 12621, 13245, 13862, 14494, 15496, 15981, 18375, 18765]","[0, 209, 490, 872, 1111, 1610, 1811, 2254, 2673, 3543, 3853, 4555, 4827, 5076, 5646, 5891, 6205, 7038, 7641, 7982, 8840, 8935, 9268, 9506, 9792, 10325, 10686, 12796, 13001, 13475, 13571, 14135, 15056, 16210, 16600]","[0, 252, 342, 534, 711, 847, 937, 1433, 1637, 2110, 2245, 2462, 2907, 3610, 3818, 3948, 4253, 4526, 5010, 5460, 6221, 6316, 6456, 7361, 8145, 8240, 8666, 9094, 9647, 10164, 10525, 11335, 12224, 13767, 14859]","[0, 356, 834, 1017, 1171, 1310, 1411, 1750, 1886, 2091, 2312, 2521, 2735, 2990, 3139, 3233, 3999, 4184, 4528, 4670, 5041, 5184, 5279, 5517, 5612, 5904, 6096, 7138, 7234, 7411, 7507, 8024, 8124, 8967, 9357]",20986,18765,16600,14859,9357,18,97,23,105,45,"[0, 245, 532, 948, 1398, 1728, 2147, 2905, 3534, 4123, 4541, 5059, 5609, 7071, 7689, 8671, 9650, 10386, 11418, 12408, 13313, 14311, 15426, 16201, 17461, 18492, 19697, 19791, 20358, 21058, 21792, 22781, 22881, 24087, 24187]","[0, 167, 568, 906, 1268, 1936, 2219, 2771, 3487, 4170, 4588, 5172, 5819, 6262, 6911, 7464, 8103, 8771, 9150, 9935, 10538, 11292, 12166, 13043, 13514, 13954, 15108, 15653, 15846, 16853, 17082, 18060, 18778, 19606, 19706]","[0, 250, 602, 984, 1345, 1752, 1925, 2394, 2753, 3675, 4168, 4677, 5245, 6058, 6336, 6765, 7282, 7776, 8364, 8757, 8852, 9141, 9984, 10165, 11128, 11747, 12702, 12963, 13872, 14348, 14742, 15572, 15997, 16677, 16973]","[0, 129, 377, 467, 604, 861, 951, 1131, 1325, 1983, 2261, 2351, 2639, 2816, 3064, 3339, 3615, 3893, 4683, 5284, 5379, 5767, 6651, 6924, 7244, 8220, 8487, 8581, 8677, 9052, 9351, 10000, 10280, 11216, 11316]","[0, 129, 270, 386, 745, 986, 1081, 1307, 1397, 1798, 1955, 2262, 2406, 3068, 3217, 3810, 4391, 4666, 5254, 5743, 6148, 6570, 7097, 7895, 8335, 9313, 9667, 9761, 9857, 10115, 10308, 10911, 11354, 11454, 12000]",24187,19706,16973,11316,12000,-3201,-941,-373,3543,-2643,-3615,35,dire
7582314402,89,120,112,121,96,"[0, 291, 526, 856, 1667, 1960, 2316, 2807, 3467, 3970, 4500, 5108, 5499, 6256, 6984, 7561, 8096, 8551, 9112, 9925, 10486, 11965, 12987, 14074, 15140, 16365, 17091, 18429, 19617, 20816, 20912, 22101, 23677, 24567, 25615]","[0, 330, 574, 786, 1243, 1578, 2003, 2530, 2869, 3126, 3760, 4082, 4788, 5406, 6012, 6653, 7622, 8599, 8924, 9388, 10184, 10477, 11057, 11196, 11550, 11852, 12353, 12610, 13237, 13333, 14274, 14374, 14906, 15387, 16105]","[0, 245, 526, 931, 1306, 2059, 2284, 2529, 3139, 3576, 4079, 4642, 5172, 5793, 6468, 6920, 7479, 7838, 8411, 8776, 9393, 9626, 10197, 10386, 10904, 11453, 12068, 12720, 13523, 13748, 14470, 14570, 14716, 14906, 15650]","[0, 209, 351, 493, 863, 1051, 1190, 1404, 1539, 1800, 1949, 2136, 2281, 2478, 3660, 3845, 4339, 4627, 4727, 4905, 5444, 5954, 6306, 6476, 6645, 6854, 7179, 7729, 8113, 8375, 8537, 8787, 9453, 9809, 10262]","[0, 209, 372, 556, 787, 1133, 1345, 1451, 1664, 1904, 2158, 2248, 2430, 2715, 3451, 3778, 4033, 4530, 4647, 4883, 5204, 5570, 5999, 6316, 6485, 6861, 7347, 7960, 8510, 8710, 9323, 9438, 9574, 9764, 10193]",25615,16105,15650,10262,10193,49,4,92,33,100,"[0, 632, 967, 1225, 1596, 1985, 2425, 3190, 3780, 4422, 5021, 5689, 6481, 7426, 7710, 7859, 8460, 9423, 9811, 10227, 10958, 11239, 11742, 12322, 13532, 14674, 15508, 16462, 17590, 18248, 19949, 21080, 21793, 22651, 22833]","[0, 273, 644, 938, 1352, 1561, 2037, 2485, 2805, 3153, 3555, 3986, 4245, 4896, 5119, 5770, 6272, 7170, 7810, 8099, 8937, 9370, 9810, 10223, 11582, 12312, 13556, 14706, 15184, 15758, 17121, 18534, 19054, 19466, 19602]","[0, 240, 499, 925, 1098, 1298, 1828, 2376, 2879, 3249, 3837, 4272, 4633, 5125, 5496, 5843, 6239, 6512, 6919, 7393, 7829, 8398, 8894, 9168, 9584, 10272, 10783, 10964, 11773, 11869, 12972, 13795, 14267, 14627, 14885]","[0, 200, 310, 473, 575, 772, 936, 1173, 1440, 1701, 2039, 2538, 2962, 3377, 3526, 3838, 4059, 4395, 4796, 5024, 5523, 5988, 6414, 6759, 7668, 8096, 9002, 9543, 9932, 10452, 11464, 12639, 13247, 13854, 13989]","[0, 200, 308, 470, 595, 685, 775, 1087, 1352, 1531, 1666, 1929, 2159, 2473, 2622, 2894, 3376, 3946, 4071, 4500, 4819, 5216, 5610, 6094, 7054, 7441, 8077, 8457, 8809, 9387, 10154, 10597, 11523, 12018, 12193]",22833,19602,14885,13989,12193,2782,-3497,765,-3727,-2000,-5677,35,dire
7582691602,25,93,65,51,110,"[0, 276, 604, 1052, 1342, 1797, 2291, 2626, 3484, 4065, 4567, 4952, 5405, 5750, 6354, 7505, 8569, 9236, 9875, 10979, 11933, 12604, 13849, 13944, 14765, 15746, 16646, 18701, 19956, 22234, 23060, 23948, 25820, 26288, 26388]","[0, 326, 697, 1124, 1377, 1761, 2008, 2357, 2648, 2970, 3320, 3689, 4441, 5197, 5809, 7079, 7843, 8440, 9206, 9851, 10576, 10671, 11785, 12609, 13245, 14178, 14463, 15100, 15361, 15779, 16383, 17184, 18231, 18604, 19030]","[0, 208, 384, 511, 985, 1137, 1351, 1548, 1824, 2077, 2589, 3132, 3385, 4355, 4527, 5202, 6115, 6290, 6677, 7235, 7936, 8031, 8301, 8783, 9040, 9685, 10413, 10753, 10959, 11258, 11769, 12586, 13194, 13294, 13394]","[0, 170, 301, 435, 525, 655, 794, 929, 1019, 1154, 1617, 1751, 2003, 2856, 2951, 3659, 4032, 4660, 5088, 5759, 6142, 6497, 7066, 7445, 7650, 8002, 8337, 9338, 9783, 10788, 11103, 11395, 12077, 12252, 12484]","[0, 170, 260, 464, 657, 826, 952, 1086, 1211, 1383, 1605, 1695, 1948, 2136, 2384, 3084, 3518, 4131, 4556, 5352, 5706, 5954, 6720, 6815, 7184, 7738, 7927, 8867, 9073, 10129, 10631, 10877, 11447, 12213, 12421]",26388,19030,13394,12484,12421,70,14,129,119,111,"[0, 332, 677, 1114, 1485, 2130, 2595, 2956, 3945, 4509, 5113, 5606, 6138, 6604, 6936, 7131, 8023, 8740, 9826, 10193, 10287, 11577, 12945, 13785, 14604, 15259, 15678, 16562, 16794, 17129, 17434, 18447, 19764, 20671, 21612]","[0, 277, 545, 905, 1319, 1652, 1932, 2303, 2516, 3123, 3808, 3898, 4388, 4977, 5741, 5836, 6387, 7074, 7721, 8125, 8443, 10000, 10765, 11922, 12393, 12843, 13102, 13512, 14257, 14398, 14746, 15720, 16765, 17116, 17655]","[0, 204, 535, 862, 1143, 1475, 1962, 2423, 2912, 3259, 3877, 4291, 4563, 5069, 5527, 6197, 6898, 7384, 7639, 7734, 8481, 9398, 10538, 10833, 11224, 12040, 12265, 12675, 13422, 13564, 13952, 14585, 15720, 16368, 17072]","[0, 170, 671, 1008, 1564, 1818, 2143, 2278, 2793, 2922, 3377, 3724, 3814, 3909, 4103, 4279, 4463, 5057, 5447, 5542, 5998, 6546, 6931, 7662, 7966, 8318, 8618, 9298, 10443, 10650, 10821, 11260, 12079, 13372, 13873]","[0, 170, 260, 464, 668, 772, 1036, 1434, 1573, 1707, 2182, 2321, 2411, 2545, 2640, 2770, 3181, 3538, 3903, 4218, 4440, 4886, 5478, 6063, 6387, 6916, 7060, 7470, 8633, 8907, 9003, 9673, 10854, 11724, 12148]",21612,17655,17072,13873,12148,4776,1375,-3678,-1389,273,1357,35,radiant
7583012200,89,106,137,112,105,"[0, 321, 625, 1048, 1256, 1628, 2355, 2621, 3145, 3698, 4447, 5148, 5565, 6279, 7260, 8132, 8969, 9596, 10353, 10867, 11270, 12003, 12378, 13626, 14775, 15272, 16077, 16726, 17576, 18442, 19057, 20115, 20781, 21083, 21429]","[0, 243, 446, 536, 735, 934, 1522, 1867, 2158, 2611, 2985, 3584, 4215, 4748, 4847, 5388, 5919, 6517, 7075, 7736, 8064, 8819, 9845, 10554, 11534, 12074, 12416, 12887, 13515, 14326, 15482, 16477, 17106, 17460, 17701]","[0, 296, 533, 977, 1172, 1512, 2129, 2566, 3072, 3331, 4207, 4703, 5176, 5976, 6071, 6624, 7360, 7798, 8158, 8861, 9316, 9615, 10227, 11091, 12102, 12681, 12943, 13461, 13724, 14005, 14855, 15459, 15757, 16042, 16433]","[0, 209, 299, 389, 479, 697, 1075, 1291, 1381, 1507, 1717, 1841, 2217, 2511, 2825, 3093, 3407, 3891, 4582, 4739, 5144, 5484, 5746, 6159, 6351, 6985, 7270, 7466, 7691, 8059, 8593, 9012, 9313, 9682, 9817]","[0, 209, 299, 389, 479, 657, 1035, 1170, 1322, 1489, 1705, 1795, 2010, 2159, 2254, 2599, 2864, 3574, 4056, 4252, 4460, 4660, 5035, 5523, 6028, 6590, 6962, 7105, 7201, 7432, 7638, 8086, 8290, 8523, 8623]",21429,17701,16433,9817,8623,73,46,50,19,111,"[0, 263, 527, 991, 1528, 2095, 2284, 2623, 2982, 3638, 4502, 5049, 6274, 7237, 8104, 9160, 10104, 10489, 11444, 12027, 12989, 13420, 14662, 15414, 15887, 17075, 18134, 19501, 21099, 22274, 23397, 24097, 25034, 25790, 27144]","[0, 205, 530, 693, 1212, 1577, 1902, 2423, 2918, 3550, 4162, 4733, 5490, 6408, 6984, 7727, 8391, 9060, 9830, 10439, 11072, 11644, 12896, 13284, 13568, 14104, 14937, 15819, 16941, 17756, 18715, 19156, 19793, 20369, 21076]","[0, 166, 479, 971, 1422, 1913, 2523, 2929, 3605, 4063, 4402, 5049, 5517, 6023, 6649, 7173, 8228, 8458, 8981, 9399, 10233, 10573, 10914, 11663, 12089, 12961, 13626, 14134, 15056, 15729, 16217, 16751, 17056, 17287, 18087]","[0, 168, 334, 588, 762, 913, 1070, 1323, 1503, 1633, 2028, 2240, 2584, 2939, 3173, 3673, 4094, 4324, 4508, 4932, 5090, 5188, 5983, 6149, 6548, 7073, 7214, 7395, 7653, 8301, 8642, 8819, 8919, 9116, 9683]","[0, 229, 349, 439, 529, 619, 917, 1007, 1187, 1367, 1568, 1851, 2090, 2239, 2646, 2831, 3334, 3564, 3734, 3967, 4127, 4222, 4527, 4693, 4898, 5083, 5178, 5272, 5530, 5716, 5812, 5912, 6012, 6437, 6690]",27144,21076,18087,9683,6690,-5715,-3375,-1654,134,1933,-8677,35,dire
7583211100,48,36,53,2,20,"[0, 281, 957, 1156, 1532, 1767, 2116, 2668, 3137, 3549, 4268, 4779, 5338, 6007, 6806, 7610, 8309, 9118, 10388, 11980, 12983, 13983, 14589, 15108, 15839, 16740, 17772, 18062, 18376, 19462, 20416, 20874, 22413, 22779, 23059]","[0, 324, 609, 997, 1411, 1984, 2444, 2941, 3729, 4429, 5564, 5969, 6620, 7045, 7338, 7611, 8202, 8786, 9549, 10526, 10941, 11519, 12234, 12782, 13192, 13816, 14760, 14955, 15319, 15572, 16406, 16912, 17012, 17254, 17534]","[0, 209, 299, 654, 789, 1136, 1434, 1778, 2535, 2625, 3398, 3929, 4417, 4679, 5523, 5729, 6098, 6304, 6778, 7455, 8412, 8585, 9172, 10119, 10718, 11318, 12056, 12197, 12924, 13508, 13843, 14828, 15462, 15977, 16608]","[0, 376, 771, 1200, 1558, 2018, 2402, 3068, 3562, 3860, 4765, 5305, 6246, 7069, 7403, 7703, 8147, 8412, 8635, 9880, 10038, 10250, 10432, 11274, 11760, 12018, 12576, 12670, 12821, 13140, 13383, 13941, 14456, 15018, 15946]","[0, 209, 410, 543, 941, 1031, 1661, 2311, 2546, 2707, 3188, 3441, 3733, 3995, 4215, 4430, 4711, 4806, 5029, 6165, 6492, 6700, 7035, 7501, 7781, 8192, 8736, 8905, 9296, 9801, 10490, 10642, 11012, 11261, 11589]",23059,17534,16608,15946,11589,94,49,74,138,68,"[0, 202, 540, 704, 1151, 1581, 1766, 2294, 2629, 3177, 3431, 3732, 4376, 4816, 5646, 6205, 7037, 7547, 8326, 9163, 9963, 10931, 11657, 12198, 13227, 14245, 15399, 16631, 17538, 18171, 19081, 20435, 21500, 22874, 24391]","[0, 200, 438, 842, 1004, 1369, 1691, 2057, 2270, 2743, 3201, 3500, 4314, 4899, 5444, 6242, 6791, 7219, 7856, 7987, 8328, 8977, 9725, 10324, 11018, 11539, 12588, 13777, 14243, 14503, 15148, 15861, 17201, 17879, 18648]","[0, 202, 361, 805, 1194, 1368, 1785, 2132, 2556, 3161, 3323, 3482, 3787, 4224, 4892, 5373, 5702, 6593, 7388, 8060, 8392, 8998, 9329, 9571, 9823, 11136, 11775, 13204, 13436, 13688, 14637, 15310, 16192, 16969, 17724]","[0, 129, 219, 352, 491, 630, 991, 1447, 1537, 1709, 2103, 2231, 2411, 2607, 2885, 3152, 3404, 3697, 3936, 4381, 4502, 5037, 5609, 6063, 6564, 7091, 7885, 8578, 9229, 9873, 10336, 10939, 11264, 11812, 13004]","[0, 129, 219, 309, 399, 782, 986, 1177, 1390, 1676, 1766, 2046, 2272, 3064, 3388, 3814, 4016, 4442, 4681, 4818, 5164, 5562, 5844, 6195, 6525, 7238, 7858, 8831, 9138, 9309, 9983, 10153, 10301, 10601, 11325]",24391,18648,17724,13004,11325,-1332,-1114,-1116,2942,264,-356,35,dire
7583888910,54,69,123,97,121,"[64, 312, 723, 1160, 1705, 2045, 2505, 2917, 3599, 4169, 4652, 5263, 5642, 6354, 7124, 7930, 8615, 9341, 10347, 11200, 11619, 12443, 13655, 13795, 14646, 15278, 16161, 16916, 18724, 19089, 19722, 20190, 21629, 22018, 22868]","[0, 169, 403, 662, 1063, 1445, 1841, 2091, 2762, 3491, 3963, 4093, 4662, 5242, 5661, 6218, 6872, 7319, 7607, 8134, 8386, 9469, 10172, 10296, 10762, 11291, 11386, 11999, 12835, 13091, 13240, 13613, 15086, 15457, 16852]","[64, 295, 430, 639, 774, 1372, 1564, 1654, 2089, 2344, 2453, 2683, 2867, 3278, 3941, 4333, 4723, 5031, 5386, 5816, 6016, 6946, 7531, 7728, 8206, 8812, 8907, 9484, 10534, 11026, 11328, 11702, 13498, 14254, 15738]","[64, 231, 519, 884, 1289, 1617, 2129, 2717, 3128, 3433, 4054, 4634, 5157, 5484, 6125, 6613, 7176, 7581, 8370, 8956, 9166, 9655, 10183, 10721, 10908, 11470, 11565, 12777, 13671, 13862, 14239, 14817, 15761, 16203, 16924]","[332, 462, 587, 783, 1047, 1155, 1617, 1914, 2237, 2539, 2629, 2936, 3026, 3174, 3458, 3553, 3800, 4231, 4359, 4672, 4872, 5459, 5772, 5867, 6016, 6345, 6440, 6967, 7587, 7688, 7898, 8215, 9540, 9640, 10180]",22868,16852,15738,16924,10180,82,120,55,65,105,"[0, 335, 899, 1176, 1343, 1510, 1903, 2608, 3176, 3662, 4379, 5439, 6080, 6506, 7369, 8139, 8871, 10109, 11014, 11602, 12895, 13648, 14551, 15092, 15792, 16370, 17839, 19160, 20933, 21775, 22968, 24251, 24826, 26231, 26854]","[0, 284, 562, 899, 1071, 1287, 1550, 2055, 2477, 3563, 4170, 4880, 5412, 5665, 6342, 6765, 7313, 7766, 7955, 8497, 9701, 9933, 10785, 11724, 12115, 12454, 12932, 13467, 13916, 14777, 15406, 17105, 17205, 17470, 17777]","[0, 246, 488, 905, 1029, 1617, 1745, 2282, 2382, 2778, 3458, 3858, 4442, 4696, 5210, 5923, 6505, 6860, 7123, 7865, 9000, 9094, 10134, 10512, 10890, 11120, 12154, 12434, 13081, 13279, 14024, 14743, 15015, 15193, 15486]","[0, 210, 373, 676, 771, 1326, 1455, 1728, 1818, 2473, 2861, 3260, 3538, 3881, 4214, 4572, 5286, 5735, 5830, 6046, 7004, 7271, 7441, 7710, 8166, 8471, 9290, 9580, 10104, 10600, 10967, 12173, 12455, 12691, 13474]","[0, 254, 394, 588, 764, 1008, 1108, 1472, 1847, 2398, 2799, 3170, 3349, 3511, 3831, 4078, 4723, 5357, 5546, 5915, 7082, 7300, 8125, 8529, 8874, 9401, 10392, 10597, 11517, 11613, 12197, 13167, 13267, 13434, 13690]",26854,17777,15486,13474,13690,-3986,-925,252,3450,-3510,-4719,35,radiant
7584193705,78,46,13,86,58,"[0, 207, 370, 751, 1075, 1165, 1623, 1890, 2433, 2742, 3064, 3711, 4543, 4940, 5354, 5935, 6816, 7318, 7571, 8145, 9016, 10013, 11066, 11196, 11738, 12110, 12826, 13666, 14178, 14957, 15693, 16116, 17443, 18500, 19564]","[0, 247, 421, 736, 935, 1378, 1505, 2012, 2529, 3053, 3541, 4408, 4992, 5700, 6455, 6974, 7873, 8644, 8988, 9841, 10395, 10717, 11584, 11731, 12509, 12604, 13621, 14473, 15210, 16067, 17021, 17534, 18776, 18986, 20255]","[0, 370, 612, 896, 1142, 1362, 1495, 1818, 1951, 2347, 2814, 3251, 3791, 4326, 4904, 5704, 6180, 6903, 7661, 8364, 9047, 9519, 10012, 10106, 10727, 10822, 11551, 12080, 12720, 13112, 14146, 14941, 16790, 17842, 18445]","[0, 169, 306, 430, 555, 703, 841, 982, 1163, 1433, 1663, 1887, 2112, 2868, 3053, 3630, 4046, 4204, 4610, 4842, 5012, 5794, 6950, 7119, 7289, 7459, 7710, 8157, 8772, 9192, 9983, 10434, 11360, 11602, 11792]","[0, 169, 259, 349, 474, 564, 654, 822, 984, 1294, 1578, 1896, 2270, 2672, 2900, 3589, 3897, 4236, 4679, 5206, 5346, 5788, 6256, 6350, 6913, 7046, 7262, 7356, 7576, 8046, 8776, 8986, 10502, 10760, 11161]",19564,20255,18445,11792,11161,67,47,137,19,110,"[0, 244, 625, 944, 1144, 1631, 1919, 2356, 2683, 2979, 3333, 3701, 3958, 4592, 5010, 5629, 6049, 6616, 7338, 7866, 8752, 10336, 10973, 12855, 13354, 14585, 15086, 15644, 16594, 17271, 18043, 19052, 19714, 19961, 20700]","[0, 250, 722, 1103, 1417, 1940, 2608, 2998, 3496, 4039, 4675, 5183, 5797, 6289, 6807, 7058, 7459, 7654, 8215, 8956, 9559, 10269, 10411, 11089, 11717, 12054, 12466, 13168, 13896, 14604, 15274, 16296, 17110, 17771, 18614]","[0, 169, 674, 990, 1323, 1583, 2102, 2557, 2806, 3341, 3844, 4213, 4509, 5080, 5961, 6270, 6666, 7199, 7586, 8155, 8777, 9505, 9705, 10764, 11441, 12164, 12498, 13326, 13891, 14295, 14915, 15710, 17128, 17318, 18247]","[0, 169, 284, 419, 597, 722, 1186, 1321, 1493, 1677, 1857, 2102, 2364, 2877, 3279, 3499, 3931, 4130, 4497, 4855, 5196, 5819, 6329, 7507, 7729, 8604, 8699, 9414, 9893, 10531, 10731, 10921, 11591, 11781, 12321]","[0, 169, 325, 797, 982, 1125, 1315, 1523, 1673, 1933, 2484, 2838, 3066, 3398, 3493, 3588, 3980, 4276, 4628, 5193, 5648, 6375, 6630, 7541, 8334, 9731, 10268, 10750, 11765, 11886, 12260, 12450, 13224, 13486, 14125]",20700,18614,18247,12321,14125,-1136,1641,198,-529,-2964,-2790,35,radiant
7584220301,48,17,98,86,84,"[0, 293, 654, 903, 1075, 1236, 1552, 1900, 2172, 2498, 2987, 3288, 3744, 4592, 5191, 5813, 7139, 8280, 9507, 11125, 12223, 13198, 13897, 15288, 16482, 17596, 18648, 20563, 21610, 22663, 23652, 24845, 25753, 27341, 27441]","[0, 403, 763, 1207, 1750, 2125, 2708, 3138, 3520, 3990, 4516, 5120, 5601, 6381, 7072, 7268, 8229, 9763, 10194, 11174, 11880, 12263, 12434, 12981, 13076, 13972, 14169, 14783, 15449, 16300, 16635, 16844, 17174, 18323, 18483]","[0, 170, 337, 646, 857, 1032, 1356, 2313, 2454, 2742, 3151, 3429, 4094, 4772, 5638, 5907, 6718, 7401, 7825, 8892, 9245, 9635, 9938, 10178, 10602, 11457, 11659, 11754, 13045, 13603, 13699, 14752, 15080, 15860, 15960]","[0, 218, 395, 485, 799, 934, 1071, 1457, 1547, 1758, 1902, 2087, 2177, 3037, 3764, 3858, 4538, 4783, 5275, 5563, 5884, 6324, 6418, 6756, 6941, 7437, 7574, 8476, 9088, 9862, 9958, 10747, 10885, 11085, 11185]","[0, 170, 260, 350, 474, 564, 654, 758, 848, 938, 1028, 1167, 1257, 1591, 1732, 1826, 2056, 2698, 3012, 3106, 3201, 3642, 3736, 3941, 4230, 4742, 5050, 5560, 5818, 6376, 6472, 6619, 6719, 6819, 6919]",27441,18483,15960,11185,6919,106,114,97,105,3,"[0, 325, 854, 1190, 1561, 1966, 2421, 3050, 3875, 4338, 5281, 5771, 6243, 6811, 7488, 8181, 8924, 9459, 9885, 11160, 11786, 12736, 13486, 14904, 15745, 16644, 18176, 18817, 19115, 19897, 20592, 21243, 22259, 24801, 25630]","[0, 208, 539, 830, 1256, 1670, 2129, 2472, 3272, 3684, 4315, 4810, 5466, 6243, 6523, 7210, 7918, 8742, 9285, 10031, 10513, 10895, 11760, 13530, 14285, 15178, 16056, 17098, 17968, 18064, 18471, 19624, 20671, 22481, 23001]","[0, 204, 447, 764, 1232, 1642, 1979, 2552, 3282, 3701, 4544, 5395, 5856, 6303, 6830, 8014, 8319, 8558, 9215, 9413, 10137, 11618, 11978, 12762, 13544, 15340, 16317, 16537, 16933, 18152, 18991, 19830, 20610, 21165, 22197]","[0, 170, 260, 695, 834, 1157, 1247, 1426, 1734, 1868, 2347, 2437, 2593, 3054, 3221, 3526, 3783, 4123, 4218, 5032, 5454, 6125, 6291, 6880, 7147, 7774, 8202, 8422, 8657, 8753, 9254, 9909, 10009, 11163, 11701]","[0, 170, 260, 350, 520, 833, 970, 1060, 1540, 1750, 2131, 2267, 2423, 2771, 2957, 3262, 3483, 3578, 3673, 4354, 4571, 5415, 5879, 6548, 6915, 7252, 7641, 7861, 8004, 8259, 8457, 8862, 9132, 9723, 9984]",25630,23001,22197,11701,9984,1811,-4518,-6237,-516,-3065,-12525,35,radiant
7584695605,48,17,53,96,5,"[0, 255, 537, 922, 1340, 1778, 2288, 2729, 3230, 3602, 4113, 4682, 5366, 6275, 6844, 7342, 8188, 9388, 10338, 11212, 11660, 12595, 14071, 15311, 16389, 17204, 17299, 18717, 19857, 20493, 21876, 22831, 23599, 24391, 25510]","[0, 169, 453, 773, 1179, 1598, 1993, 2165, 2634, 3018, 3520, 4137, 4580, 5176, 5540, 5843, 6631, 7695, 8380, 9305, 9798, 10260, 10816, 11165, 12325, 12808, 13499, 14415, 15033, 15483, 16436, 17076, 17176, 17525, 17956]","[0, 352, 529, 639, 1184, 1274, 1484, 1608, 2002, 2294, 2460, 2721, 2935, 3383, 3796, 4005, 4465, 4969, 5439, 6092, 6530, 6652, 7330, 7553, 8468, 9386, 9725, 10813, 11340, 12306, 12876, 13979, 14409, 15142, 15656]","[0, 164, 480, 679, 1014, 1337, 1668, 2061, 2510, 3156, 3690, 4410, 5118, 5624, 5980, 6397, 6797, 7233, 7768, 8523, 9025, 9531, 9861, 10066, 10858, 11183, 11278, 12206, 12840, 13466, 14156, 15082, 15277, 15545, 15848]","[0, 219, 313, 498, 805, 1001, 1360, 1450, 1584, 2026, 2116, 2331, 2428, 2915, 3169, 3378, 3699, 3990, 4196, 4527, 5096, 5190, 5474, 5723, 6241, 6517, 6673, 6973, 7521, 7617, 8240, 8880, 8980, 9125, 9315]",25510,17956,15656,15848,9315,73,49,98,9,79,"[0, 330, 534, 807, 1230, 1675, 2035, 2491, 3123, 3962, 4729, 5414, 6428, 7073, 7743, 9336, 10571, 11230, 12342, 13372, 14380, 15119, 16131, 17150, 17507, 18031, 19305, 19929, 20382, 20744, 21502, 22716, 23967, 25754, 26596]","[0, 318, 653, 1027, 1445, 1940, 2417, 3027, 3516, 3881, 4401, 4783, 5402, 5795, 6197, 6672, 7346, 7529, 7998, 8483, 9124, 9485, 10015, 10679, 11223, 11768, 12100, 12586, 13056, 13904, 14407, 15544, 16250, 16583, 17452]","[0, 684, 1004, 1335, 1494, 1750, 2104, 2362, 2705, 2939, 3587, 4109, 4748, 5085, 5600, 6396, 7407, 8110, 8726, 9524, 9982, 10521, 11061, 11325, 11944, 13026, 13313, 13645, 14161, 14701, 14912, 15706, 16390, 16794, 17828]","[0, 408, 546, 722, 890, 1076, 1166, 1346, 1481, 1751, 1970, 2188, 2828, 3332, 3650, 4903, 5506, 5697, 6019, 6590, 6685, 6850, 7455, 7749, 8240, 8631, 8996, 9503, 9599, 9764, 9860, 10008, 10659, 11100, 11498]","[0, 263, 353, 443, 533, 736, 826, 1050, 1185, 1709, 1889, 2027, 2207, 2396, 2810, 3318, 3797, 3892, 4304, 4911, 5207, 5707, 5922, 6282, 6664, 7255, 7542, 7637, 7844, 7940, 8168, 8595, 9055, 9450, 9847]",26596,17452,17828,11498,9847,-1086,504,-2172,4350,-532,1064,35,radiant
7584866405,73,98,45,14,86,"[0, 377, 867, 1184, 1710, 2155, 2667, 2948, 3198, 3635, 4375, 4822, 5493, 6603, 7274, 8717, 9803, 11507, 13249, 14607, 15458, 17284, 18326, 19819, 21472, 22316, 24158, 25183, 27545, 28538, 29482, 30624, 31175, 32912, 34681]","[0, 707, 943, 1398, 2055, 2387, 2884, 3302, 3718, 3808, 4103, 4391, 4481, 5105, 5314, 5609, 6470, 7580, 8934, 9449, 9667, 10440, 10776, 11477, 12274, 12915, 13577, 13920, 15738, 16628, 17017, 17695, 18221, 18321, 19713]","[0, 370, 565, 790, 1174, 1370, 1765, 1935, 2154, 2383, 2621, 2909, 3049, 3521, 3715, 3974, 4344, 5031, 5621, 5816, 6043, 6723, 7059, 7600, 8001, 8486, 8928, 9389, 9843, 10391, 10730, 11817, 11917, 12229, 13051]","[0, 303, 704, 912, 1108, 1506, 1695, 2151, 2570, 2940, 3396, 3486, 3737, 4234, 4666, 4857, 5349, 5551, 6316, 6708, 6885, 7065, 7592, 8397, 8819, 8914, 9186, 9381, 9587, 10250, 10432, 10927, 11209, 11309, 11608]","[0, 232, 322, 500, 704, 842, 932, 1105, 1195, 1392, 1630, 1720, 2100, 2393, 2626, 3031, 3352, 3720, 4240, 4789, 4966, 5061, 5502, 5673, 5984, 6079, 6927, 7122, 7680, 8048, 8230, 8899, 9134, 9279, 10160]",34681,19713,13051,11608,10160,75,106,137,20,91,"[0, 245, 754, 1072, 1444, 1806, 2291, 2630, 2958, 3585, 3962, 4122, 4764, 5524, 6319, 6841, 7305, 8498, 8836, 9479, 10569, 10951, 11342, 12054, 12953, 13818, 14745, 16080, 16695, 17138, 17865, 18002, 18294, 19502, 20056]","[0, 282, 452, 759, 1120, 1450, 1614, 2118, 2330, 2871, 3474, 3814, 4317, 5099, 5544, 6277, 6655, 7044, 7347, 8008, 8356, 8820, 9381, 9931, 10283, 10642, 11127, 11385, 11771, 12446, 12821, 13485, 15343, 16257, 16991]","[0, 169, 452, 788, 1156, 1402, 1777, 2161, 2602, 3308, 3764, 4389, 4651, 5455, 5805, 6330, 6919, 7507, 7803, 8098, 8619, 8953, 9398, 9963, 10315, 10965, 11679, 12301, 12924, 13068, 13310, 13620, 14972, 15652, 16394]","[0, 169, 400, 536, 666, 829, 1069, 1618, 2016, 2430, 2830, 3041, 3355, 3880, 4236, 4470, 4885, 5273, 5368, 5733, 6185, 6542, 6672, 6766, 7118, 7458, 7943, 8037, 8133, 8437, 8533, 8843, 9917, 10515, 10825]","[0, 169, 366, 456, 857, 947, 1121, 1654, 1897, 2448, 2583, 2743, 3005, 3673, 3996, 4191, 4705, 4982, 5338, 5533, 6000, 6216, 6311, 6452, 6804, 7155, 7640, 8002, 8388, 8484, 8580, 8890, 9831, 10325, 10425]",20056,16991,16394,10825,10425,14625,2722,-3343,783,-265,14522,35,dire
7585578410,48,137,126,53,121,"[0, 244, 460, 1000, 1359, 1641, 1856, 2433, 2876, 3217, 3733, 4262, 4952, 5935, 7192, 7924, 8890, 9881, 10306, 11007, 11902, 12377, 13284, 13979, 14972, 15610, 16559, 17513, 18418, 18595, 18946, 19606, 20481, 20581, 21785]","[0, 284, 424, 1327, 1546, 1834, 2247, 2732, 3401, 3539, 4186, 4916, 5274, 5985, 6696, 7316, 7573, 8090, 8605, 9459, 10082, 10212, 11010, 11104, 11693, 12143, 12706, 13226, 13526, 13703, 13799, 14689, 16684, 17208, 17645]","[0, 283, 411, 744, 951, 1364, 1715, 2094, 2599, 2900, 3481, 4282, 4408, 5313, 5809, 5903, 6712, 7705, 8199, 8799, 9284, 9628, 10556, 10723, 11238, 12055, 12752, 13362, 13817, 14472, 14939, 15209, 16605, 18010, 19234]","[0, 310, 400, 823, 958, 1185, 1275, 1766, 2406, 2624, 3460, 4022, 4549, 5269, 5857, 6249, 6430, 6780, 7358, 7730, 8236, 8857, 9553, 10065, 10888, 11258, 11759, 12878, 13685, 14900, 15203, 15619, 16933, 17373, 17653]","[0, 210, 352, 515, 626, 756, 846, 1108, 1198, 1288, 1468, 1774, 2048, 2622, 3017, 3148, 3264, 3753, 4082, 4606, 4844, 4939, 5340, 5434, 5963, 6166, 6775, 7577, 7855, 8087, 8439, 8818, 9480, 9605, 10261]",21785,17645,19234,17653,10261,10,135,74,20,26,"[0, 166, 490, 874, 1215, 1581, 1971, 2454, 2936, 3492, 3809, 4111, 4742, 5353, 6191, 7119, 7826, 8669, 9438, 10656, 12590, 13185, 14158, 15279, 16180, 17239, 17964, 18950, 19502, 20756, 21527, 22806, 23634, 23734, 24578]","[0, 244, 562, 992, 1389, 1871, 2336, 2719, 3484, 3781, 4243, 4662, 5168, 5435, 6582, 7062, 7967, 8525, 9177, 10130, 11072, 11555, 11856, 12448, 12943, 13756, 14279, 14484, 15163, 16742, 17552, 18780, 19429, 20794, 21321]","[0, 292, 619, 962, 1260, 1587, 1871, 2298, 2447, 2943, 3116, 3216, 3536, 3717, 4480, 4874, 5579, 6096, 6191, 6518, 6720, 7195, 7983, 8866, 9260, 9735, 10334, 11173, 11590, 12492, 12698, 13264, 13989, 14331, 15429]","[0, 130, 254, 344, 517, 626, 1008, 1098, 1449, 1875, 2085, 2211, 2301, 2434, 2868, 3087, 3455, 3597, 3947, 4363, 4862, 4957, 5227, 5438, 5770, 6082, 6176, 6425, 6729, 7430, 7682, 7984, 8575, 8807, 9195]","[0, 130, 220, 456, 595, 733, 1148, 1238, 1411, 1664, 1886, 1976, 2160, 2255, 2574, 3008, 3437, 3592, 3747, 4165, 4781, 4876, 5282, 5483, 5796, 6125, 6281, 6622, 6718, 7539, 7794, 7984, 8232, 8659, 8894]",24578,21321,15429,9195,8894,-2793,-3676,3805,8458,1367,7161,35,radiant
7585844612,106,114,14,86,5,"[0, 413, 871, 1297, 1821, 2207, 2680, 3249, 3754, 4267, 5028, 5556, 6293, 7263, 7965, 8568, 9818, 10048, 11136, 11756, 12602, 13436, 14040, 14792, 15577, 16308, 17928, 18825, 20397, 21069, 21916, 22975, 24147, 25038, 25138]","[0, 339, 658, 1038, 1411, 1737, 2185, 2604, 3123, 3447, 4442, 4798, 5980, 6629, 6964, 7539, 8232, 9474, 10721, 11741, 12510, 14056, 14683, 15952, 16134, 16653, 16748, 16932, 17993, 19197, 19972, 21373, 22541, 23920, 24020]","[0, 256, 660, 1006, 1431, 1850, 2181, 2717, 3216, 3927, 4436, 4692, 5219, 5744, 5875, 6207, 6781, 7030, 7744, 8198, 8496, 8812, 9578, 10229, 10761, 11931, 12239, 12666, 13338, 13655, 14216, 14628, 15047, 15544, 16370]","[0, 299, 389, 543, 677, 831, 921, 1044, 1178, 1483, 2103, 2396, 3059, 3435, 3813, 4169, 4604, 5168, 5608, 6109, 6549, 6678, 6896, 7365, 7692, 8192, 8761, 9272, 10131, 10330, 11002, 11503, 12286, 13299, 13399]","[0, 219, 309, 466, 603, 693, 783, 873, 1008, 1170, 1543, 1671, 2039, 2155, 2250, 2345, 2903, 3183, 3458, 3946, 4157, 4502, 4597, 4751, 5185, 5672, 5842, 6647, 7399, 7759, 8040, 9117, 9527, 9805, 9980]",25138,24020,16370,13399,9980,48,17,18,72,83,"[0, 330, 688, 1058, 1502, 1995, 2598, 3251, 3745, 4239, 4993, 5802, 6513, 7170, 8286, 9106, 10272, 10925, 12154, 12967, 13949, 14761, 15695, 16649, 17488, 18623, 19727, 20744, 21790, 21967, 23162, 23691, 24922, 27193, 28813]","[0, 330, 884, 1283, 1738, 2323, 2904, 3422, 3938, 4416, 5083, 5843, 6216, 6736, 7793, 8486, 9098, 9766, 10436, 10770, 11214, 12246, 13760, 14558, 16211, 16724, 17590, 18304, 19321, 20471, 21071, 22044, 22344, 24146, 26466]","[0, 281, 488, 919, 1198, 1607, 1944, 2524, 2979, 3406, 3990, 4510, 4878, 5274, 5660, 6193, 7189, 7819, 8218, 8524, 8706, 9378, 10194, 10678, 11865, 12032, 13231, 13406, 13990, 14167, 15024, 15349, 16417, 17439, 18196]","[0, 214, 341, 478, 608, 712, 1008, 1205, 1340, 1458, 1703, 2044, 2544, 2850, 3366, 3554, 3937, 4258, 4353, 4895, 5382, 5577, 5816, 6100, 6623, 6892, 7339, 7558, 7970, 8147, 8243, 8688, 9094, 10556, 11232]","[0, 169, 259, 349, 532, 669, 848, 1028, 1204, 1369, 1641, 1778, 1981, 2361, 2668, 3081, 3457, 3552, 3682, 3888, 4020, 4215, 4454, 4662, 4847, 5014, 5474, 5649, 6103, 6280, 6425, 6794, 7094, 8012, 8402]",28813,26466,18196,11232,8402,-3675,-2446,-1826,2167,1578,-4202,35,dire
7586185405,73,39,28,33,100,"[1, 251, 582, 797, 1207, 1642, 2150, 2890, 3627, 4125, 4916, 5699, 6506, 7516, 8154, 9165, 10712, 11331, 13078, 13914, 14761, 15662, 16314, 17233, 18180, 18767, 20277, 21405, 22183, 23558, 24371, 26317, 28389, 29845, 31361]","[1, 283, 556, 855, 1336, 1547, 1910, 2096, 2495, 3054, 3572, 4055, 4735, 5769, 5991, 6346, 6593, 7047, 7396, 7914, 9200, 9835, 10534, 10916, 11787, 12316, 13007, 13569, 14398, 14604, 15372, 16349, 18155, 19157, 19864]","[1, 459, 905, 1172, 1547, 1998, 2246, 2706, 3066, 3156, 3995, 4153, 4476, 4983, 5340, 6094, 6894, 7265, 7948, 8593, 9121, 9663, 10210, 10702, 11180, 11454, 11941, 12380, 12987, 13469, 14073, 15676, 16398, 16874, 17879]","[1, 171, 463, 567, 702, 963, 1310, 1560, 1667, 1841, 2082, 2208, 2351, 2740, 2910, 3146, 3452, 3595, 3982, 4140, 4396, 4675, 5093, 5585, 6125, 6458, 7050, 7408, 7938, 8407, 8982, 9852, 11210, 11629, 12272]","[1, 256, 416, 506, 690, 920, 1091, 1500, 1709, 1883, 2244, 2540, 2676, 2974, 3225, 3466, 3757, 3852, 4037, 4195, 4451, 4701, 5009, 5239, 5591, 5954, 6378, 6518, 7020, 7226, 7322, 8143, 9474, 9774, 10288]",31361,19864,17879,12272,10288,113,63,65,58,136,"[1, 274, 520, 810, 1022, 1421, 1651, 1986, 2202, 2471, 2899, 3588, 3696, 4178, 4622, 5012, 6058, 6448, 6936, 7537, 7672, 8313, 9166, 9519, 10744, 11517, 12540, 13278, 13534, 14489, 16120, 16220, 17785, 17920, 19090]","[1, 598, 793, 1275, 1687, 1937, 2358, 2811, 3172, 3827, 4178, 4690, 5050, 5292, 5540, 5853, 6311, 7110, 7703, 8475, 8957, 10339, 11625, 12372, 12920, 13740, 13939, 14844, 15738, 16743, 17634, 17734, 18395, 18495, 19155]","[1, 209, 645, 888, 1295, 1684, 2347, 2795, 2884, 3174, 3956, 4421, 5008, 5493, 6036, 6599, 7314, 8056, 8628, 9244, 9886, 10895, 11343, 11980, 12608, 13117, 13394, 13685, 14062, 14686, 14955, 15377, 16265, 16365, 16547]","[1, 239, 480, 669, 799, 1257, 1425, 1810, 1899, 2248, 2372, 2658, 2843, 3090, 3288, 3398, 3750, 4135, 4306, 4540, 4634, 5165, 5687, 5977, 6251, 6418, 6548, 6814, 7020, 7403, 7711, 7911, 9099, 9247, 9562]","[1, 239, 364, 502, 775, 900, 1035, 1244, 1354, 1934, 2040, 2499, 2661, 3078, 3264, 3359, 3912, 4185, 4629, 4774, 4868, 4963, 5486, 5941, 6383, 6657, 7161, 7351, 7655, 7995, 8264, 8364, 8770, 9216, 9570]",19090,19155,16547,9562,9570,12271,709,1332,2710,718,17740,35,radiant
7586617402,109,126,29,21,112,"[0, 318, 560, 1087, 1485, 1720, 2301, 2730, 3142, 3877, 4258, 4845, 5689, 6087, 6181, 6805, 7622, 8412, 9213, 10136, 10660, 11578, 12130, 12669, 13425, 14515, 15350, 16117, 17236, 18330, 19768, 21329, 22401, 24285, 25499]","[0, 298, 619, 913, 1204, 1402, 1651, 2035, 2497, 3301, 3840, 4235, 4851, 5093, 5711, 6131, 6633, 7125, 7794, 8182, 9124, 10276, 10507, 10849, 11497, 11969, 12732, 13728, 14723, 16186, 16698, 17141, 17983, 19323, 20303]","[0, 207, 405, 798, 1092, 1384, 1584, 2141, 2400, 2721, 2856, 3017, 3381, 3906, 4228, 4714, 5322, 5788, 6434, 6529, 7230, 7885, 8415, 8698, 8982, 9420, 9761, 10298, 10650, 11318, 11708, 11898, 12320, 13440, 14094]","[0, 213, 352, 442, 579, 839, 1068, 1275, 1455, 1678, 2227, 2317, 2680, 3077, 3344, 3630, 3950, 4190, 4359, 4887, 5175, 5818, 6060, 6348, 6754, 7192, 7428, 7702, 8005, 8641, 9459, 9858, 10337, 11424, 11973]","[0, 170, 260, 441, 531, 621, 906, 1008, 1194, 1747, 2030, 2120, 2210, 2649, 2909, 3053, 3211, 3306, 3400, 3647, 3931, 4116, 4282, 4377, 4472, 5305, 5550, 5680, 6017, 6421, 6679, 6869, 7348, 7495, 8078]",25499,20303,14094,11973,8078,41,25,53,96,20,"[0, 320, 788, 1172, 1596, 1950, 2456, 2828, 3361, 4014, 4663, 5664, 6200, 6829, 7224, 8101, 8851, 9486, 10626, 12390, 13342, 14471, 15024, 16170, 16811, 17806, 19039, 20006, 20483, 21318, 22257, 23297, 24083, 24923, 25493]","[0, 588, 860, 1107, 1655, 2010, 2440, 2750, 3349, 3796, 4446, 4820, 5013, 5262, 5446, 5984, 6320, 6933, 7292, 8178, 9018, 9563, 10435, 11331, 12075, 13230, 13707, 14111, 14809, 14905, 15531, 16223, 16985, 17085, 17683]","[0, 268, 614, 741, 837, 1047, 1464, 1989, 2306, 2645, 3014, 3490, 3801, 4728, 5032, 5371, 5818, 6218, 6739, 7634, 8226, 8720, 9380, 10030, 10756, 11289, 12159, 12676, 13462, 14525, 15356, 16429, 17420, 17520, 17937]","[0, 248, 375, 517, 899, 1109, 1279, 1594, 2057, 2277, 2725, 3203, 3538, 3927, 4240, 4945, 5517, 6223, 6669, 7278, 7822, 7917, 8302, 8953, 9698, 10695, 11450, 11892, 12480, 12664, 13193, 13832, 14028, 14128, 14672]","[0, 234, 632, 1043, 1179, 1679, 2045, 2289, 2668, 2842, 3222, 3519, 3690, 4203, 4393, 4778, 4970, 5065, 5249, 5810, 6157, 6252, 6418, 6866, 7156, 7840, 8045, 8365, 8711, 9021, 9660, 10000, 10100, 10200, 10536]",25493,17683,17937,14672,10536,6,2620,-3843,-2699,-2458,-6374,35,dire
7586877601,94,43,21,5,100,"[0, 210, 439, 713, 999, 1417, 1870, 2122, 2746, 3219, 4172, 4840, 5339, 5708, 6094, 6690, 7310, 8012, 9210, 9833, 11185, 11644, 13235, 14014, 14438, 14918, 15824, 16780, 17513, 18108, 18491, 19866, 20937, 21761, 22486]","[0, 337, 582, 956, 1353, 1807, 2243, 2585, 2928, 3510, 4324, 5180, 5615, 6223, 6843, 7272, 8498, 8911, 9776, 10300, 10953, 11313, 12009, 12180, 12752, 12875, 13512, 14647, 15240, 16409, 17586, 18474, 19343, 19624, 20257]","[0, 293, 512, 823, 1022, 1359, 1718, 2099, 2549, 3358, 3800, 4360, 4920, 5281, 5716, 6061, 6593, 6894, 7573, 8057, 8502, 8987, 9241, 9422, 9964, 10495, 10915, 11346, 11967, 12447, 13215, 14307, 14769, 15664, 16125]","[0, 331, 754, 844, 981, 1358, 1578, 1687, 2237, 2372, 2932, 3437, 3665, 3904, 4213, 4308, 5150, 5324, 5622, 5717, 5922, 6017, 6251, 6582, 6713, 6907, 7001, 7467, 7698, 8392, 8702, 9148, 9614, 9952, 10164]","[0, 210, 300, 470, 597, 727, 937, 1078, 1168, 1384, 1781, 2007, 2332, 2571, 2750, 3003, 3342, 3497, 3795, 4042, 4440, 4785, 5027, 5137, 5251, 5372, 5466, 6158, 6380, 6683, 6779, 7717, 8214, 8618, 8718]",22486,20257,16125,10164,8718,95,39,28,58,20,"[0, 130, 520, 811, 1258, 1455, 2449, 2903, 3465, 4179, 4771, 5383, 6366, 7635, 8452, 9237, 9475, 10305, 10843, 11149, 11576, 12466, 13439, 14592, 15321, 16080, 17007, 17596, 18405, 19238, 19334, 20417, 21486, 21586, 22836]","[0, 205, 455, 907, 1197, 1532, 2001, 2476, 3067, 3359, 3449, 4135, 4611, 5190, 5708, 6450, 6869, 7483, 8305, 8958, 9571, 10287, 11340, 11929, 12370, 12799, 13386, 13578, 13926, 15163, 15698, 17140, 18492, 19065, 20277]","[0, 206, 539, 951, 1222, 1417, 1544, 1974, 2143, 2516, 2640, 2820, 3381, 4044, 4273, 5000, 5535, 6073, 6446, 6934, 7290, 7710, 8470, 9204, 9525, 10674, 10999, 11751, 12099, 12751, 13200, 13951, 15474, 16431, 17299]","[0, 130, 220, 345, 435, 762, 852, 1226, 1361, 1451, 1624, 1855, 1945, 2663, 2892, 3461, 3619, 4171, 4547, 5085, 5391, 5937, 6175, 6699, 7023, 7607, 8081, 8399, 8879, 9801, 10179, 10369, 11304, 11909, 12532]","[0, 130, 438, 563, 653, 757, 1069, 1354, 1533, 1751, 1841, 2083, 2319, 2924, 3153, 3392, 3678, 3964, 4149, 4579, 4853, 4948, 5417, 5739, 5969, 6416, 6845, 7238, 7676, 8357, 8779, 8969, 9562, 9890, 10170]",22836,20277,17299,12532,10170,-350,-20,-1174,-2368,-1452,-5364,35,dire
7587097513,102,120,129,58,26,"[0, 206, 478, 727, 1096, 1547, 2067, 2470, 2945, 3319, 3862, 4234, 4672, 5282, 6126, 6495, 7264, 8017, 8646, 9392, 10194, 11018, 11848, 12831, 13922, 14669, 16040, 16913, 18037, 18479, 19637, 20506, 21321, 22684, 23678]","[0, 315, 652, 1000, 1433, 1845, 2300, 2737, 3174, 3623, 4390, 5047, 5641, 6240, 6882, 7650, 8201, 8743, 9316, 10518, 11060, 11410, 11955, 12642, 13614, 14439, 15108, 15526, 16423, 17060, 17889, 18821, 19571, 20817, 21335]","[0, 255, 531, 810, 1104, 1314, 1559, 2026, 2447, 2899, 3705, 4090, 5037, 5380, 5690, 6406, 6945, 7666, 8109, 8823, 9561, 9901, 10633, 11278, 11997, 12318, 12988, 13259, 13778, 14502, 15032, 16325, 16919, 17400, 17815]","[200, 370, 460, 550, 736, 913, 1040, 1130, 1369, 1630, 1900, 2171, 2361, 2547, 2893, 3023, 3180, 3474, 3740, 3977, 4110, 4340, 4970, 5389, 5777, 6188, 6780, 6967, 7395, 7757, 8356, 8746, 9273, 9696, 10237]","[0, 170, 260, 350, 440, 579, 792, 882, 972, 1062, 1381, 1566, 1822, 2020, 2281, 2546, 2866, 3069, 3520, 3678, 3901, 4159, 4674, 4950, 5338, 5766, 6399, 6493, 6699, 6876, 7660, 8153, 8547, 9194, 9609]",23678,21335,17815,10237,9609,53,106,19,138,51,"[0, 205, 597, 897, 1147, 1750, 2198, 2478, 3102, 3489, 4137, 4754, 5208, 5754, 6455, 7007, 7668, 8707, 9597, 9824, 10797, 11417, 12389, 13297, 14291, 15073, 15760, 16879, 17918, 18347, 19182, 19729, 19930, 20847, 20947]","[0, 254, 581, 1032, 1475, 1836, 2209, 2780, 3355, 3565, 4159, 4400, 4833, 5281, 6018, 6350, 7015, 7844, 8156, 8667, 9017, 9711, 10399, 11143, 11999, 12358, 12888, 13288, 13994, 14819, 15548, 16482, 17355, 18732, 20056]","[0, 255, 454, 1225, 1464, 1753, 2152, 2699, 3104, 3516, 4040, 4288, 4638, 5136, 5231, 5868, 6125, 6782, 7082, 7460, 7621, 8179, 8468, 9081, 9770, 10144, 10591, 10909, 11170, 11444, 11866, 12158, 12747, 12847, 13335]","[0, 170, 260, 444, 574, 917, 1007, 1167, 1448, 1584, 2029, 2165, 2273, 2667, 2833, 2928, 3406, 3826, 4433, 4622, 5227, 5487, 5680, 5999, 6313, 6480, 6685, 7300, 7647, 7927, 8189, 8379, 8961, 9594, 9993]","[0, 170, 260, 350, 526, 780, 870, 1098, 1503, 1709, 2052, 2214, 2304, 2591, 2686, 3039, 3161, 3582, 3766, 4036, 4130, 4495, 4590, 4756, 5073, 5240, 5787, 6105, 6201, 6297, 6393, 6583, 6903, 7003, 7147]",20947,20056,13335,9993,7147,2731,1279,4480,244,2462,11196,35,radiant
7588356005,138,21,76,83,84,"[0, 265, 586, 863, 1188, 1643, 2016, 2354, 2845, 3551, 3938, 4406, 5092, 5442, 6052, 6592, 7055, 7832, 8327, 9086, 9460, 9827, 10501, 11496, 12202, 12756, 13622, 13909, 14513, 16444, 17129, 17559, 18154, 18290, 20911]","[0, 616, 830, 1156, 1280, 1528, 1683, 1967, 2356, 2653, 2896, 3377, 3788, 4269, 4613, 5075, 5169, 5900, 6192, 6557, 6651, 6960, 7669, 8051, 8772, 9070, 9210, 9372, 9587, 10287, 10757, 10902, 11002, 11102, 12955]","[0, 302, 465, 626, 915, 1238, 1411, 1610, 1821, 2125, 2511, 2779, 2959, 3228, 3639, 4114, 4390, 5465, 5824, 6372, 6627, 6722, 7391, 7800, 8182, 8708, 9098, 9192, 9574, 10242, 10338, 10589, 10794, 11286, 12710]","[0, 226, 316, 610, 700, 1172, 1601, 1711, 2086, 2377, 3308, 3481, 3571, 3719, 4292, 4511, 4605, 4917, 5330, 5619, 5751, 6065, 6429, 6714, 7359, 7669, 8052, 8146, 8243, 8805, 8901, 9032, 9132, 9232, 10422]","[0, 226, 316, 493, 583, 713, 803, 893, 983, 1145, 1235, 1575, 2003, 2200, 2420, 2618, 2712, 3085, 3233, 3425, 3570, 3665, 4012, 4212, 4450, 4974, 5118, 5212, 5572, 6134, 6927, 7704, 7848, 8304, 9520]",20911,12955,12710,10422,9520,35,95,15,123,75,"[0, 284, 536, 774, 1147, 1561, 1940, 2586, 3333, 3591, 4699, 4789, 5456, 6363, 6698, 7828, 8615, 9254, 9799, 10242, 10901, 11448, 12362, 12973, 13964, 14491, 15148, 15645, 16655, 17495, 18093, 18989, 19600, 20361, 21432]","[0, 257, 616, 1187, 1567, 1790, 2587, 2909, 3692, 4067, 4702, 5590, 6224, 6536, 7206, 7938, 8738, 9331, 10053, 10811, 12072, 12698, 13587, 14409, 15249, 15857, 16203, 16762, 17291, 17906, 18002, 18429, 19299, 19650, 20072]","[0, 252, 463, 734, 923, 1359, 1576, 1945, 2237, 2493, 3037, 3833, 4142, 4768, 5311, 5802, 6610, 6808, 7564, 8098, 8701, 9204, 9879, 10309, 10839, 11588, 12105, 12662, 13334, 13547, 14090, 14468, 15470, 16135, 17526]","[0, 170, 260, 401, 491, 632, 722, 984, 1156, 1337, 1775, 1995, 2330, 2681, 3321, 3540, 4104, 4690, 5183, 5278, 5731, 6395, 6777, 7047, 7450, 7725, 8148, 8972, 9597, 10198, 10473, 11109, 12111, 12709, 13367]","[0, 170, 260, 489, 643, 773, 1025, 1240, 1491, 1581, 2307, 2682, 2862, 3201, 3386, 4001, 4645, 4860, 5186, 5500, 6065, 6270, 6761, 7233, 7794, 7961, 8230, 8479, 8882, 9856, 10282, 10506, 11138, 11442, 12226]",21432,20072,17526,13367,12226,-521,-7117,-4816,-2945,-2706,-18105,35,dire
7588454903,1,69,80,123,112,"[0, 240, 508, 710, 1125, 1449, 1753, 2044, 2211, 2465, 3285, 4136, 4555, 5328, 5834, 6209, 7385, 8161, 8978, 9958, 10941, 11583, 12005, 12771, 13588, 14622, 15259, 16547, 18423, 19342, 20270, 21740, 22696, 24912, 25771]","[0, 324, 684, 1056, 1492, 1945, 2336, 2767, 3348, 3777, 3985, 4422, 4911, 5394, 5932, 6185, 6810, 7647, 8066, 9030, 9760, 10429, 11399, 11596, 12238, 13085, 13868, 14428, 15769, 16417, 16673, 17395, 18514, 19200, 20089]","[0, 279, 526, 899, 1309, 1791, 2162, 2780, 3149, 3581, 3927, 4295, 4813, 5404, 5879, 6434, 7073, 7904, 8583, 9553, 10387, 10557, 10892, 10986, 11749, 12348, 13090, 13871, 14970, 15623, 16002, 16669, 17345, 17652, 18906]","[0, 170, 285, 471, 607, 697, 804, 1315, 1657, 1837, 2235, 2610, 2748, 2978, 3263, 3787, 4262, 4564, 4949, 5494, 5865, 6065, 6308, 6620, 7296, 8158, 8467, 8664, 9558, 10590, 11087, 11737, 12674, 13232, 14458]","[0, 170, 334, 424, 609, 743, 833, 1013, 1103, 1464, 2194, 2452, 2586, 2865, 3036, 3130, 3494, 3589, 3979, 4587, 5291, 5486, 5718, 6145, 6715, 7250, 8205, 8784, 9757, 10583, 10770, 11712, 12516, 13416, 13761]",25771,20089,18906,14458,13761,94,90,136,58,91,"[0, 279, 535, 738, 973, 1482, 1847, 2339, 2765, 3198, 3668, 4436, 4896, 6041, 6639, 7316, 8200, 8710, 9482, 10668, 11667, 12409, 13275, 14207, 14776, 15759, 16656, 17601, 18027, 18549, 19299, 20077, 21839, 23313, 23413]","[0, 440, 694, 902, 1162, 1514, 2051, 2460, 3246, 3630, 4277, 4822, 5400, 5886, 6519, 6825, 7394, 7772, 8347, 8604, 8897, 9934, 10361, 11013, 11829, 12294, 12818, 13022, 13167, 13599, 13739, 14005, 14422, 14823, 15123]","[0, 537, 1003, 1291, 1646, 1947, 2242, 2724, 3076, 3557, 3647, 4061, 4637, 5068, 5687, 6460, 6706, 7207, 7354, 7741, 8400, 9202, 9407, 9808, 10171, 10681, 10886, 11159, 11255, 12225, 12625, 12725, 14248, 14348, 14487]","[0, 232, 322, 412, 502, 716, 806, 1145, 1280, 1435, 1611, 1735, 1982, 2515, 2811, 3222, 3404, 3672, 4111, 4870, 5145, 5616, 6598, 6692, 7187, 8391, 8645, 8849, 9077, 9570, 9691, 9916, 10443, 10577, 10677]","[0, 269, 558, 695, 832, 968, 1058, 1234, 1373, 1597, 1826, 1916, 2054, 2546, 2736, 3118, 3330, 3425, 3540, 3731, 3916, 4337, 4576, 4868, 5170, 5684, 5889, 6093, 6236, 6332, 6428, 6572, 7595, 8085, 8217]",23413,15123,14487,10677,8217,2358,4966,4419,3781,5544,21068,35,radiant
7588655005,94,96,106,123,112,"[0, 289, 647, 936, 1334, 1748, 2028, 2505, 2985, 3422, 3884, 4345, 4882, 5476, 5749, 6617, 7310, 8232, 9271, 10610, 11038, 12192, 13016, 13305, 13915, 14825, 15904, 16569, 17761, 19566, 20606, 21612, 22365, 23464, 24309]","[0, 277, 519, 939, 1312, 1654, 1977, 2402, 2845, 3197, 4376, 5133, 5650, 6225, 7102, 7685, 8098, 8301, 8729, 9217, 9827, 10189, 10886, 11343, 12001, 12258, 13333, 13789, 14483, 15314, 15582, 16763, 17178, 17353, 17837]","[0, 322, 650, 922, 1411, 1801, 2152, 2614, 3019, 3468, 3935, 4253, 4704, 5140, 5372, 5585, 6421, 7274, 8420, 8740, 8835, 9277, 10021, 10962, 11633, 11970, 12146, 12240, 12336, 13377, 14148, 14645, 15375, 16184, 16654]","[0, 170, 260, 398, 553, 927, 1017, 1157, 1632, 1812, 2246, 2912, 3053, 3148, 3243, 3460, 3645, 4263, 4583, 4952, 5129, 5395, 5667, 5908, 6233, 6475, 6726, 7011, 7846, 8529, 8793, 9493, 10308, 10840, 11498]","[0, 170, 260, 714, 804, 894, 984, 1124, 1329, 1619, 1891, 2246, 2421, 2561, 2911, 3210, 3494, 3893, 3988, 4317, 4678, 4773, 5104, 5679, 5774, 5941, 6819, 6953, 7084, 7710, 8028, 8444, 8659, 9133, 9733]",24309,17837,16654,11498,9733,120,10,69,33,20,"[0, 295, 458, 824, 1138, 1465, 1849, 2255, 2937, 3442, 3967, 4635, 5218, 5789, 7206, 7592, 8772, 9522, 10259, 11066, 11457, 12194, 12865, 13912, 14694, 15852, 17015, 17292, 18083, 18349, 18618, 19092, 19974, 20640, 21223]","[0, 170, 440, 763, 1087, 1251, 1852, 2333, 2602, 3011, 3252, 3787, 4181, 4844, 5827, 6369, 7240, 7477, 8009, 9275, 9801, 10572, 11135, 12030, 12449, 13317, 14633, 15847, 16786, 17309, 18019, 18685, 19727, 20519, 21314]","[0, 242, 482, 1236, 1527, 1813, 2107, 2638, 3201, 3614, 4115, 4821, 5359, 6021, 7389, 7754, 8442, 9046, 9468, 10496, 11133, 11661, 12283, 12972, 13618, 14594, 14925, 15546, 16143, 16582, 17651, 18442, 19450, 19932, 20592]","[0, 170, 260, 350, 566, 745, 1071, 1243, 1431, 1625, 2140, 2537, 2746, 3406, 3900, 4413, 4908, 5356, 5733, 6499, 7239, 7797, 8319, 9044, 9750, 10403, 10883, 11400, 12102, 12273, 12626, 13052, 14037, 14602, 15185]","[0, 271, 413, 658, 826, 956, 1277, 1456, 1671, 1933, 2398, 2627, 2762, 3158, 3563, 3831, 4249, 4792, 5075, 5379, 5657, 6106, 6456, 6758, 7126, 7666, 8121, 8858, 9601, 9886, 10054, 10229, 10839, 11264, 11542]",21223,21314,20592,15185,11542,3086,-3477,-3938,-3687,-1809,-9825,35,radiant
7589043306,17,14,43,19,20,"[329, 619, 960, 1288, 1628, 2146, 2620, 3004, 3498, 3913, 4473, 4846, 5372, 5771, 5876, 6012, 6658, 7616, 8918, 9252, 9796, 10266, 10462, 11643, 12290, 12812, 13214, 14710, 14806, 15824, 16555, 16961, 17450, 18782, 19245]","[61, 340, 853, 1172, 1699, 2026, 2406, 2768, 2903, 3435, 3693, 4003, 4545, 4911, 5042, 5489, 6592, 7293, 7502, 8653, 9224, 9750, 9845, 9939, 11060, 11400, 12123, 12604, 13347, 14094, 14865, 15435, 16451, 17725, 18298]","[0, 170, 531, 793, 1364, 1699, 1987, 2154, 2497, 3386, 3802, 3976, 4404, 4535, 5130, 5563, 6820, 7561, 8145, 8650, 9638, 10045, 10140, 10447, 10885, 11741, 12228, 13113, 13334, 14069, 14647, 15352, 15452, 16182, 16674]","[61, 231, 321, 711, 933, 1367, 1457, 1552, 1735, 2018, 2404, 2494, 2584, 2717, 2968, 3154, 3855, 4407, 4845, 5368, 5793, 5888, 5983, 6265, 6711, 6878, 7296, 8176, 8272, 8792, 9092, 9699, 10170, 10318, 10494]","[61, 231, 389, 568, 739, 929, 1403, 1493, 1628, 2063, 2198, 2288, 2422, 2829, 2924, 3177, 3720, 4151, 4341, 4773, 5198, 5341, 5436, 5709, 6125, 6292, 6433, 6914, 7010, 7364, 7460, 7740, 8439, 9207, 9307]",19245,18298,16674,10494,9307,42,98,80,72,26,"[0, 285, 642, 964, 1380, 1899, 2180, 2816, 3265, 3727, 4298, 4634, 5369, 5978, 6576, 6950, 7829, 8633, 9660, 10221, 10618, 11634, 12648, 13827, 14510, 15951, 17073, 18400, 19506, 20194, 21257, 22032, 23290, 23743, 24306]","[0, 454, 859, 1154, 1396, 1988, 2078, 2444, 3077, 3566, 4320, 4957, 5614, 6102, 6662, 7069, 7226, 7839, 9393, 10306, 10583, 11333, 12377, 13639, 14023, 14684, 15523, 16338, 16697, 17633, 18089, 18998, 20189, 21225, 22138]","[0, 291, 559, 964, 1138, 1418, 1865, 2511, 3022, 3349, 4080, 4615, 5169, 6528, 7089, 7394, 7776, 8219, 8671, 9080, 9765, 10426, 11349, 12405, 13022, 13934, 14699, 15272, 15981, 16731, 17307, 18160, 19228, 20524, 21393]","[0, 252, 342, 432, 571, 741, 846, 1277, 1810, 1990, 2466, 2643, 2899, 3192, 3879, 4325, 4482, 4735, 5096, 5803, 5898, 6526, 7036, 7959, 8126, 8493, 8882, 9231, 9841, 10007, 10103, 10682, 11298, 12188, 12591]","[0, 170, 260, 350, 440, 610, 797, 1116, 1206, 1386, 1673, 2145, 2408, 2942, 3411, 3695, 3868, 4207, 4494, 4968, 5229, 5987, 6486, 7208, 7449, 8173, 8452, 8546, 8842, 9020, 9366, 9827, 10256, 10457, 11129]",24306,22138,21393,12591,11129,-5061,-3840,-4719,-2097,-1822,-17539,35,dire
7589891206,10,61,108,123,20,"[0, 206, 443, 678, 960, 1321, 1805, 2280, 2843, 3183, 3765, 4163, 4814, 5449, 6166, 6675, 7433, 7922, 8805, 9880, 10271, 10678, 11306, 12093, 12902, 14072, 15130, 15848, 16870, 17202, 18599, 19352, 20917, 22238, 23600]","[0, 164, 456, 896, 1303, 1687, 2257, 2777, 3773, 4621, 5085, 5844, 7041, 8059, 8876, 9278, 9902, 10821, 11079, 11780, 12590, 13417, 14162, 14472, 14766, 15256, 16489, 16583, 17833, 18209, 18812, 19208, 20659, 21390, 22927]","[0, 167, 367, 776, 1204, 1537, 1815, 2630, 3365, 3612, 3990, 4589, 5216, 6122, 6709, 7417, 8063, 8374, 8875, 9616, 10345, 10869, 11337, 11942, 12432, 12743, 13069, 13498, 14018, 14114, 14494, 15103, 15941, 16614, 18425]","[0, 129, 219, 309, 512, 769, 871, 1130, 1497, 1769, 2186, 2355, 2658, 3337, 3822, 4048, 4453, 4907, 5112, 5341, 6124, 6444, 6677, 7324, 7703, 8039, 8684, 9342, 9689, 9785, 10204, 10690, 11373, 11905, 13076]","[100, 229, 363, 463, 604, 734, 984, 1119, 1389, 1575, 1964, 2133, 2313, 2899, 3203, 3343, 3602, 3919, 4182, 4411, 5178, 5428, 5829, 6546, 6766, 7000, 7176, 7270, 7537, 7633, 8231, 8756, 9439, 10095, 10671]",23600,22927,18425,13076,10671,89,21,90,53,19,"[0, 313, 688, 923, 1137, 1523, 1741, 2083, 2336, 3044, 3565, 3978, 4502, 4681, 5324, 6023, 7131, 7947, 8706, 9634, 10781, 11460, 12398, 13447, 14085, 14346, 16251, 17208, 18367, 19627, 20424, 21335, 21555, 21960, 22470]","[0, 658, 948, 1165, 1411, 1775, 2326, 2688, 3153, 3569, 4059, 4752, 5193, 5401, 5700, 6338, 6523, 7216, 7640, 8078, 8378, 8864, 10168, 10439, 10733, 11101, 11853, 12683, 12947, 13912, 14272, 14686, 15255, 15627, 16239]","[0, 328, 606, 941, 1312, 1601, 2159, 2454, 2674, 3006, 3568, 3936, 4312, 4581, 4972, 5412, 6041, 6413, 6859, 7283, 7493, 7739, 8397, 9092, 9515, 9971, 10815, 10999, 11672, 12655, 13054, 13297, 13903, 14183, 15194]","[0, 268, 358, 466, 684, 857, 1061, 1422, 1557, 1992, 2331, 2523, 2622, 2817, 3066, 3311, 3521, 4434, 5037, 5370, 5605, 6007, 6874, 7320, 7604, 7904, 8820, 9274, 10362, 10858, 11254, 11354, 11998, 12511, 13414]","[0, 268, 358, 460, 624, 761, 965, 1169, 1388, 1672, 1807, 1951, 2041, 2136, 2231, 2615, 2995, 3379, 3901, 4244, 4339, 4562, 5017, 5260, 5450, 5617, 6261, 6547, 6990, 7486, 7732, 7832, 8623, 9083, 9536]",22470,16239,15194,13414,9536,1130,6688,3231,-338,1135,11846,35,radiant
7590250603,48,53,47,123,137,"[0, 256, 585, 1036, 1363, 1632, 1942, 2544, 2996, 3398, 4169, 4706, 5746, 6498, 7254, 7973, 8961, 9925, 10577, 11471, 11760, 12123, 12673, 13323, 13939, 14501, 15138, 16455, 17702, 18431, 21175, 21809, 22676, 23317, 24688]","[0, 170, 260, 434, 524, 663, 753, 1073, 1281, 1544, 2155, 2617, 3277, 3735, 4025, 4574, 5479, 6138, 6423, 7578, 7921, 8108, 8482, 8901, 10226, 10570, 10664, 11015, 11598, 12039, 13526, 14483, 15162, 15262, 16349]","[0, 252, 494, 829, 1201, 1500, 1907, 2521, 2947, 3209, 3538, 3988, 4078, 4588, 5054, 5474, 6113, 7268, 7787, 8057, 8664, 8759, 9072, 9385, 9683, 9778, 9872, 10693, 11088, 11464, 12732, 13306, 13789, 13889, 14732]","[0, 270, 360, 719, 890, 994, 1084, 1264, 1399, 1539, 2280, 2462, 2581, 3045, 3378, 3669, 4241, 4683, 5306, 5589, 5709, 5894, 6605, 6785, 7717, 8020, 8114, 8389, 8748, 9321, 10750, 11531, 12309, 12718, 14104]","[0, 244, 334, 579, 873, 1099, 1272, 1827, 2191, 2528, 3650, 4005, 4095, 4588, 4736, 4882, 5224, 5583, 5677, 5947, 6364, 6778, 6872, 7133, 7688, 7996, 8127, 8610, 8958, 9144, 9706, 10327, 10699, 10870, 11983]",24688,16349,14732,14104,11983,49,46,80,27,86,"[0, 273, 521, 1003, 1221, 1921, 2400, 2819, 3193, 4215, 4595, 5139, 5855, 6576, 6899, 7594, 8547, 8642, 9361, 10259, 11201, 11860, 12695, 13597, 14970, 15445, 16257, 16467, 16976, 17677, 18292, 19128, 19596, 20780, 21730]","[0, 300, 496, 730, 961, 1230, 1544, 1823, 2504, 2806, 3232, 3633, 3723, 4438, 4855, 5285, 6715, 7627, 8258, 9272, 9867, 10714, 11504, 12329, 13532, 14040, 14704, 15384, 15966, 17241, 17948, 18048, 18908, 20608, 21615]","[0, 280, 599, 867, 992, 1361, 1774, 2070, 2524, 3025, 3422, 4054, 4587, 5080, 5872, 6623, 6906, 7394, 8060, 9522, 10309, 11717, 12254, 13322, 14416, 15325, 16369, 17128, 17341, 18910, 20058, 20158, 20955, 21917, 22698]","[0, 195, 285, 716, 806, 896, 1112, 1430, 1884, 2136, 2352, 3022, 3293, 4096, 4356, 4451, 4699, 5120, 5347, 6394, 6816, 7337, 8028, 8427, 8597, 9011, 9303, 9756, 10069, 10720, 11306, 11677, 11942, 12881, 13321]","[0, 195, 285, 471, 611, 929, 1283, 1410, 1840, 2146, 2400, 2596, 2916, 3516, 3838, 4093, 4618, 4957, 5344, 5674, 6651, 7059, 7385, 7727, 8170, 8505, 9009, 9268, 9538, 10534, 11012, 11112, 11618, 12330, 12987]",21730,21615,22698,13321,12987,2958,-5266,-7966,783,-1004,-10495,35,dire
7590356016,73,90,106,86,26,"[0, 553, 1016, 1400, 1604, 1932, 2362, 2711, 3305, 3860, 4499, 4874, 5524, 6155, 7154, 8331, 9356, 10092, 10851, 11584, 12685, 14491, 15355, 15996, 17018, 17499, 18477, 19058, 19264, 19560, 20019, 20633, 21822, 24217, 25818]","[0, 722, 1158, 1488, 1831, 2121, 2539, 3287, 3977, 4529, 5107, 5662, 6286, 6891, 7432, 7841, 8561, 8997, 9417, 9793, 10379, 10874, 11367, 12374, 12988, 13477, 13849, 14172, 14453, 15034, 15543, 16363, 16805, 17780, 18862]","[0, 416, 795, 1164, 1620, 1911, 2430, 2882, 3305, 3811, 4225, 4723, 4999, 5390, 6174, 6808, 7337, 7929, 8401, 9171, 9844, 10754, 11293, 11507, 12015, 12603, 13265, 13602, 14060, 14951, 15335, 16041, 17024, 18466, 19281]","[0, 297, 588, 678, 882, 1281, 1460, 1660, 1927, 2062, 2152, 2315, 2563, 2818, 3314, 3644, 4258, 4353, 4448, 4724, 5401, 5757, 6115, 6634, 7069, 7239, 7521, 7758, 8039, 8448, 8619, 8883, 9109, 9915, 10617]","[0, 297, 387, 486, 583, 711, 941, 1141, 1406, 1733, 1836, 1970, 2286, 2523, 2708, 2803, 3309, 3485, 3727, 4032, 4967, 5344, 5761, 5969, 6269, 6488, 6983, 7177, 7706, 7958, 8129, 8303, 8729, 8904, 9355]",25818,18862,19281,10617,9355,18,28,43,19,20,"[0, 324, 842, 1180, 1633, 1963, 2251, 2565, 3171, 3767, 4374, 5837, 6497, 7275, 7876, 8354, 8988, 9820, 10608, 11819, 12756, 13077, 15220, 15931, 17101, 17842, 19014, 19795, 21622, 22607, 24124, 25457, 26742, 29144, 29334]","[0, 395, 725, 1011, 1497, 2021, 2543, 2826, 3346, 3769, 4273, 4916, 5805, 6264, 6636, 6961, 7308, 7869, 8319, 8992, 9191, 9536, 10465, 10853, 11645, 12368, 13100, 13301, 14097, 14702, 15170, 16287, 16931, 17892, 19353]","[0, 296, 497, 799, 958, 1245, 1614, 1961, 2399, 2731, 3281, 3978, 4290, 4726, 5161, 5698, 6258, 7125, 7364, 8071, 8578, 8835, 9740, 9916, 10410, 11023, 11538, 11750, 12825, 13112, 13465, 14155, 14545, 15150, 15750]","[0, 239, 329, 509, 682, 807, 970, 1060, 1150, 1375, 1510, 1941, 2329, 2535, 2935, 3160, 3639, 3824, 3919, 4314, 4456, 4982, 5546, 5835, 6031, 6496, 6762, 6972, 7856, 8270, 8516, 9282, 9555, 9999, 10189]","[0, 372, 555, 739, 829, 988, 1123, 1213, 1303, 1438, 1620, 2149, 2425, 2608, 2703, 2954, 3223, 3529, 3761, 4156, 4250, 4345, 4624, 4909, 5264, 5540, 5716, 5811, 7032, 7319, 7415, 7778, 7879, 8510, 8700]",29334,19353,15750,10189,8700,-3516,-491,3531,428,655,607,35,dire
7591136209,46,106,28,53,5,"[0, 294, 568, 953, 1351, 1679, 2132, 2491, 2994, 3255, 3554, 4076, 4342, 4819, 5234, 5494, 6217, 6927, 7774, 8623, 9807, 10749, 11863, 12657, 13152, 13781, 14953, 15719, 16394, 16574, 17093, 17794, 18705, 19948, 20831]","[0, 252, 579, 876, 1443, 1950, 2246, 2617, 3240, 3545, 3858, 4188, 4844, 5267, 6069, 6200, 6774, 7219, 8075, 8834, 10215, 10572, 10936, 11956, 12605, 13537, 14324, 14500, 14838, 15572, 16805, 16905, 17909, 20228, 20708]","[0, 208, 495, 795, 1289, 1692, 1853, 1988, 2408, 2923, 3427, 3842, 4580, 4997, 5635, 6198, 7334, 7700, 8771, 9833, 10968, 11659, 12456, 13405, 14383, 15659, 16738, 17527, 18542, 18799, 19585, 19685, 19785, 19885, 20108]","[0, 550, 677, 1314, 1720, 1972, 2206, 2386, 2808, 3063, 3325, 3515, 4241, 4665, 5336, 5736, 6486, 6581, 7392, 7815, 8906, 9438, 10106, 10437, 11263, 12000, 12210, 12386, 12482, 12890, 13409, 13643, 14511, 15274, 15765]","[0, 170, 307, 585, 788, 975, 1416, 1595, 1685, 1775, 1910, 2023, 2446, 2689, 3066, 3253, 3770, 4078, 4801, 5224, 5957, 6052, 6359, 6571, 6860, 7132, 7307, 7483, 7617, 7713, 8501, 8601, 8701, 8801, 8954]",20831,20708,20108,15765,8954,1,129,90,17,121,"[0, 316, 635, 993, 1360, 1735, 2077, 2574, 3196, 3581, 4345, 4816, 5513, 6005, 6956, 7473, 8269, 9052, 9147, 9367, 10060, 10768, 11660, 12582, 13601, 14448, 15783, 16872, 18498, 20345, 22084, 23408, 25058, 25158, 25438]","[0, 241, 530, 721, 934, 1260, 1505, 2086, 2502, 2703, 3176, 3666, 4224, 4930, 5834, 6274, 7026, 7315, 7410, 7665, 8172, 8320, 8734, 9912, 10541, 10636, 10919, 11741, 12904, 13899, 15123, 15503, 17139, 17699, 18906]","[0, 423, 553, 673, 783, 1110, 1314, 1448, 1753, 2330, 2933, 3162, 3460, 4343, 4521, 5125, 5628, 6130, 6707, 7515, 8025, 8558, 9231, 9684, 10789, 11186, 11807, 12702, 13980, 15030, 16049, 17441, 18500, 19389, 19669]","[0, 291, 657, 1067, 1290, 1380, 2189, 2735, 2955, 3900, 4385, 4643, 5023, 6080, 6260, 7100, 7386, 7825, 8554, 9389, 9484, 9889, 10055, 10671, 10947, 11294, 11997, 12750, 13470, 14291, 14387, 15610, 16319, 16655, 17945]","[0, 170, 351, 471, 619, 709, 799, 1342, 1432, 1713, 2031, 2180, 2671, 3030, 3125, 3412, 3824, 4319, 4497, 5123, 5507, 5904, 6280, 6499, 7033, 7128, 7607, 7702, 9077, 9873, 10610, 11297, 12068, 12168, 12496]",25438,18906,19669,17945,12496,-4607,1802,439,-2180,-3542,-8088,35,dire
7591146603,8,106,102,123,112,"[0, 574, 844, 1168, 1513, 2055, 2418, 3091, 3593, 4175, 4595, 5002, 5720, 6339, 7022, 8188, 8759, 9531, 9903, 10624, 10887, 11914, 13212, 13888, 14461, 15070, 15619, 16689, 17775, 18497, 19169, 19849, 20630, 21161, 21308]","[0, 319, 646, 897, 1296, 1663, 2031, 2405, 2910, 3409, 4252, 4727, 5430, 6092, 6484, 6775, 7550, 8224, 8748, 9432, 9527, 10160, 10640, 11529, 12209, 12999, 13197, 13732, 14721, 15003, 15376, 15566, 16440, 16926, 17063]","[0, 368, 539, 880, 1084, 1283, 1409, 1499, 1589, 1972, 2440, 2737, 3040, 3826, 4184, 4568, 4663, 5448, 6236, 6478, 6645, 7134, 7373, 7722, 8360, 8686, 8884, 9633, 10892, 11317, 11811, 12445, 12635, 12774, 12874]","[0, 210, 300, 506, 596, 906, 996, 1342, 1470, 1711, 2205, 2588, 3594, 3864, 4122, 4812, 4993, 5342, 6046, 6283, 6462, 6578, 7033, 7520, 7991, 8441, 8536, 9319, 9804, 10187, 10393, 11120, 11680, 11947, 12289]","[0, 271, 379, 469, 606, 774, 909, 1657, 1747, 1985, 2168, 2464, 2680, 3031, 3217, 3636, 3854, 4211, 4830, 5359, 5585, 6072, 6818, 7323, 7713, 7969, 8064, 8629, 9865, 10153, 10398, 11001, 11581, 12022, 12122]",21308,17063,12874,12289,12122,136,14,137,20,91,"[0, 167, 485, 836, 1331, 1978, 2429, 3132, 3907, 4440, 5060, 5774, 6142, 6495, 7438, 7739, 8613, 9517, 10179, 11765, 12963, 13596, 13864, 14801, 15311, 16554, 17042, 17983, 18690, 19233, 19843, 20534, 20932, 21661, 23616]","[0, 130, 438, 646, 927, 1179, 1686, 2000, 2313, 3061, 3577, 3896, 4328, 4915, 5505, 6087, 6867, 7484, 7752, 8186, 8940, 9741, 10394, 11113, 11954, 12649, 13112, 13663, 14116, 14553, 15293, 15578, 16152, 16696, 18451]","[0, 205, 525, 771, 1069, 1475, 2129, 2301, 2773, 3236, 3597, 4089, 4571, 5015, 5387, 6130, 6774, 7780, 8458, 9116, 10001, 10345, 10567, 10751, 11385, 11971, 12403, 12927, 13185, 13824, 14439, 14891, 15777, 16474, 17788]","[0, 177, 285, 375, 510, 669, 1111, 1246, 1381, 1683, 1858, 2191, 2472, 2767, 3012, 3390, 3548, 3909, 4156, 4978, 5982, 6404, 6779, 6926, 7327, 8055, 8441, 8946, 9204, 9512, 9767, 9977, 10497, 10825, 11893]","[0, 130, 265, 440, 614, 845, 1026, 1300, 1832, 1967, 2407, 2701, 2890, 2984, 3329, 3459, 3858, 4264, 4501, 4873, 5257, 5469, 5681, 5776, 6006, 6328, 6513, 7095, 7353, 7635, 8060, 8467, 8983, 9311, 10493]",23616,18451,17788,11893,10493,-2308,-1388,-4914,396,1629,-6585,35,dire
7592853213,15,93,21,33,19,"[0, 254, 584, 826, 1197, 1528, 1898, 2096, 2559, 2780, 3502, 4535, 4947, 5322, 6003, 6492, 6934, 7798, 8577, 9150, 9794, 10462, 11638, 12356, 12937, 13555, 14585, 15900, 16381, 17693, 17951, 19374, 20388, 21467, 22222]","[0, 287, 487, 773, 1181, 1394, 1748, 2168, 2591, 3167, 4100, 4650, 5169, 6002, 6327, 7431, 8144, 8789, 9377, 10017, 11058, 11728, 12143, 12496, 13855, 14469, 15533, 16618, 17028, 17314, 18227, 18914, 19796, 20084, 21383]","[0, 243, 367, 694, 1260, 1633, 2082, 2431, 3218, 3606, 3902, 4524, 4758, 5020, 5375, 5940, 6476, 7359, 8399, 9829, 10981, 11866, 12455, 12797, 13328, 14422, 15818, 16444, 17128, 17817, 18275, 18730, 19469, 20530, 20755]","[0, 169, 259, 397, 532, 667, 1021, 1148, 1326, 1547, 1955, 2273, 2613, 2762, 2952, 3441, 3607, 4149, 4557, 5534, 5767, 6126, 6398, 6691, 7478, 7956, 8797, 9001, 9389, 9918, 10198, 10781, 11464, 12305, 12569]","[0, 217, 307, 397, 612, 747, 858, 999, 1177, 1563, 1895, 2315, 2482, 2752, 2981, 3157, 3572, 4428, 4523, 5041, 5493, 5743, 6177, 6316, 6663, 7063, 7712, 7916, 8517, 9234, 9588, 10076, 10694, 10907, 11365]",22222,21383,20755,12569,11365,4,46,129,72,65,"[0, 169, 756, 1136, 1587, 2011, 2344, 2946, 3267, 3477, 3640, 4223, 4976, 5527, 6002, 7045, 7881, 8685, 9462, 9556, 10378, 10964, 11226, 12217, 12508, 13185, 14249, 14343, 15138, 16996, 17605, 17705, 17805, 19654, 20539]","[0, 284, 588, 840, 1090, 1330, 1642, 2098, 2607, 3176, 3610, 4488, 5041, 6016, 6565, 7009, 8054, 8491, 9338, 9559, 10074, 10955, 11320, 12048, 12444, 12539, 12907, 13240, 14142, 14292, 14854, 14954, 15152, 16326, 16606]","[0, 208, 454, 769, 1019, 1419, 1740, 2214, 2576, 2990, 3560, 3955, 4501, 4996, 5614, 6668, 7226, 7480, 7967, 8136, 8400, 8854, 9500, 10114, 10792, 11082, 11593, 12013, 12464, 13242, 13417, 13815, 13915, 14357, 15345]","[0, 206, 296, 386, 476, 651, 974, 1154, 1272, 1648, 1921, 2246, 2611, 3000, 3248, 3704, 4224, 4670, 5297, 5521, 5853, 6149, 6539, 7718, 7913, 8008, 8265, 8568, 8959, 10142, 10423, 10623, 10981, 12150, 12957]","[0, 169, 333, 471, 621, 751, 1202, 1467, 1867, 2111, 2519, 2687, 3074, 3317, 3515, 4699, 5182, 5399, 6032, 6290, 6429, 6807, 7086, 7753, 8355, 8501, 8921, 9230, 9579, 10404, 10747, 10866, 11028, 11528, 11808]",20539,16606,15345,12957,11808,1683,4777,5410,-388,-443,11039,35,radiant
7593062809,12,61,96,19,26,"[0, 270, 645, 735, 1174, 1474, 1757, 2174, 2962, 3344, 3783, 4309, 4969, 5741, 6425, 6965, 7525, 8248, 9247, 9342, 9865, 11502, 12542, 13430, 13992, 14087, 14540, 15409, 16204, 16880, 17596, 17969, 18784, 19869, 20492]","[0, 231, 510, 754, 1309, 1728, 2172, 2471, 3103, 3951, 4309, 4743, 4833, 5556, 6259, 6719, 7561, 7837, 8288, 8570, 9057, 10758, 11388, 11768, 12632, 12872, 13528, 13718, 13976, 14252, 14942, 15182, 15541, 16325, 16537]","[0, 304, 469, 722, 1153, 1604, 1941, 2323, 2661, 3190, 3534, 4079, 4430, 5009, 5604, 5841, 6465, 7067, 7202, 7297, 7787, 8805, 9500, 9595, 9821, 9916, 10011, 10703, 11148, 11534, 11794, 12000, 12713, 12813, 12913]","[0, 195, 331, 421, 541, 718, 841, 1021, 1454, 1813, 2259, 2791, 3076, 3809, 4464, 4767, 5047, 5252, 5393, 5488, 5582, 6484, 7184, 7406, 7500, 7595, 7690, 7785, 8043, 8455, 9129, 9228, 9676, 10018, 10118]","[0, 538, 628, 757, 965, 1115, 1205, 1512, 1870, 2169, 2259, 2506, 2596, 2999, 3184, 3279, 3436, 3531, 3661, 3756, 3972, 4417, 4728, 4823, 5195, 5365, 5460, 5819, 6149, 6459, 6601, 6738, 6838, 6938, 7162]",20492,16537,12913,10118,7162,73,94,23,100,86,"[0, 250, 703, 1246, 1637, 1810, 2380, 2884, 3210, 4407, 4985, 5847, 6399, 7458, 8397, 9519, 10186, 11221, 11911, 13581, 14988, 15161, 16374, 17588, 18582, 19813, 20869, 21262, 22215, 23114, 23634, 24041, 24666, 25976, 26076]","[0, 324, 540, 751, 998, 1212, 1384, 1837, 2052, 2324, 2681, 2947, 3242, 3632, 4245, 4949, 5403, 6049, 7021, 7640, 8399, 8566, 9222, 10044, 10938, 11390, 12513, 13622, 14448, 15265, 16042, 16882, 18056, 18977, 19614]","[0, 279, 603, 904, 1192, 1518, 1825, 2809, 3462, 4067, 4642, 5275, 5801, 6130, 6426, 6917, 7813, 8259, 8671, 9741, 10268, 10373, 10869, 11272, 11489, 12297, 12714, 13175, 13622, 13915, 14694, 15121, 15635, 15871, 16024]","[0, 170, 260, 439, 529, 619, 709, 889, 979, 1253, 1463, 1785, 2080, 2174, 2365, 2491, 2994, 3666, 3761, 4402, 4759, 4929, 5716, 5886, 6174, 7011, 7551, 7921, 8404, 8968, 9305, 9569, 9914, 10317, 10514]","[0, 170, 374, 727, 896, 1036, 1175, 1422, 1643, 1924, 2110, 2283, 2761, 2905, 3305, 3400, 3706, 4312, 4434, 5006, 5224, 5660, 6230, 6400, 6764, 7348, 7820, 8190, 8926, 9226, 9563, 10033, 10890, 10999, 11163]",26076,19614,16024,10514,11163,-5584,-3077,-3111,-396,-4001,-16169,35,dire
7593576711,94,90,20,71,85,"[0, 245, 491, 855, 1135, 1537, 1857, 2267, 2809, 2937, 3204, 3674, 4045, 4410, 4676, 5362, 6045, 7006, 7897, 8919, 9484, 10411, 11515, 12379, 13192, 13884, 14560, 15251, 15981, 16899, 17595, 17818, 18355, 19420, 21166]","[0, 444, 828, 1190, 1537, 2033, 2548, 3284, 3513, 3867, 4626, 5306, 6237, 6521, 6731, 7763, 8328, 8984, 9557, 10546, 10936, 11219, 11682, 12708, 13473, 14377, 15419, 16043, 16355, 16745, 17704, 18494, 18854, 19204, 19574]","[0, 247, 473, 1017, 1420, 1701, 1961, 2177, 2477, 3008, 3535, 3958, 4712, 4894, 5587, 6383, 6726, 7172, 7643, 8188, 8310, 8831, 8956, 9098, 9726, 10487, 10845, 11014, 11341, 11518, 11824, 12047, 12271, 13050, 13547]","[0, 222, 337, 498, 588, 718, 808, 943, 1033, 1123, 1587, 1820, 2470, 2760, 2953, 3337, 4057, 4825, 5421, 5725, 6432, 6675, 7020, 7246, 7429, 8159, 8758, 9318, 9753, 10184, 10442, 11128, 11377, 11994, 12428]","[0, 170, 285, 422, 512, 759, 885, 1020, 1110, 1284, 1549, 1639, 1933, 2027, 2122, 2462, 2649, 2860, 3068, 3369, 3463, 3788, 3883, 4199, 4365, 4686, 5559, 5654, 6139, 6568, 6665, 6986, 7210, 7433, 8038]",21166,19574,13547,12428,8038,49,120,43,123,30,"[0, 267, 549, 1081, 1277, 1520, 1976, 2750, 3055, 3361, 4237, 4960, 5898, 6149, 6873, 7532, 8186, 9316, 10178, 10760, 12033, 12661, 13497, 14524, 15033, 15754, 16385, 17092, 17757, 18923, 19594, 20626, 22850, 23430, 24404]","[0, 306, 577, 957, 1361, 1705, 2355, 2567, 2844, 3370, 3786, 4240, 4749, 5319, 6105, 6254, 6848, 7381, 8077, 8713, 9632, 10374, 11360, 11825, 12159, 12799, 13302, 13956, 14941, 15440, 15990, 16785, 18193, 19080, 19722]","[0, 233, 408, 665, 794, 984, 1238, 1625, 1790, 2187, 2624, 3203, 3795, 3988, 4400, 4839, 5481, 5898, 6574, 7157, 7708, 8666, 8989, 9460, 9857, 10262, 10545, 10692, 10825, 11466, 11888, 12436, 13686, 14123, 15377]","[0, 266, 459, 549, 764, 971, 1296, 1448, 1538, 2053, 2368, 2749, 3287, 3601, 4039, 4356, 4841, 5440, 5637, 6135, 6553, 6879, 7118, 7472, 7723, 7932, 8217, 8349, 8908, 9672, 9946, 10318, 10738, 11050, 11599]","[0, 240, 367, 590, 680, 785, 1314, 1503, 1637, 1727, 2042, 2380, 2882, 3075, 3493, 3642, 3978, 4148, 4475, 4924, 5382, 5711, 6025, 6195, 6605, 7093, 7307, 7587, 8056, 8402, 8574, 9005, 9673, 10034, 10334]",24404,19722,15377,11599,10334,-3238,-148,-1830,829,-2296,-6683,35,radiant
7594024404,12,13,96,123,128,"[0, 245, 715, 994, 1322, 1798, 2214, 2515, 2754, 3056, 3571, 3989, 4260, 4606, 5131, 5315, 5528, 5703, 6105, 7982, 9023, 9712, 10362, 10831, 11124, 11730, 11997, 13747, 14466, 14562, 14893, 18172, 18911, 19615, 19940]","[0, 283, 614, 900, 1192, 1413, 1705, 1958, 2328, 2963, 3156, 3841, 4031, 4299, 4817, 5247, 5733, 5828, 6503, 6808, 7256, 7748, 8096, 8522, 9164, 9578, 9986, 10834, 10931, 11027, 11418, 12222, 12412, 12789, 12889]","[0, 208, 573, 789, 1115, 1324, 1710, 2090, 2487, 3171, 3261, 3492, 3937, 4162, 4907, 5094, 5498, 5593, 5968, 6231, 6831, 7260, 7547, 7752, 8033, 8226, 8321, 8749, 9044, 9140, 9236, 10787, 11655, 11890, 12037]","[0, 170, 260, 350, 485, 575, 757, 895, 985, 1325, 1462, 1814, 1910, 2397, 2537, 2711, 2805, 2900, 3067, 3540, 4464, 4886, 5222, 5418, 5789, 5991, 6086, 7188, 7358, 7454, 7718, 8168, 8358, 8835, 9617]","[0, 170, 339, 478, 730, 820, 1001, 1091, 1181, 1350, 1478, 1665, 1755, 1850, 1990, 2104, 2319, 2414, 2524, 3175, 3588, 3865, 3960, 4055, 4149, 4244, 4339, 4954, 5220, 5316, 5412, 6540, 6930, 7200, 7346]",19940,12889,12037,9617,7346,93,71,120,110,20,"[0, 218, 529, 1096, 1312, 1737, 2223, 2651, 3077, 3336, 3932, 4573, 5181, 5756, 6222, 6856, 7397, 8295, 8803, 9528, 10345, 11174, 11836, 12526, 13115, 13770, 14615, 15021, 15911, 16583, 17664, 18583, 18683, 19416, 20716]","[0, 247, 602, 981, 1313, 1675, 2042, 2409, 3399, 3895, 4517, 5123, 6014, 6347, 6870, 7623, 7959, 8470, 9150, 9566, 9957, 10583, 11092, 11731, 12460, 13021, 13841, 15128, 15591, 16454, 17070, 17825, 17925, 19466, 20664]","[0, 245, 506, 677, 1016, 1213, 1623, 2032, 2449, 2955, 3896, 4226, 4443, 5039, 5516, 5906, 6441, 7241, 7840, 8239, 8503, 9171, 10015, 10121, 11160, 12027, 12938, 13387, 14279, 15092, 15592, 16871, 16971, 17614, 18861]","[0, 170, 629, 766, 902, 1221, 1631, 1745, 2242, 2509, 2925, 3108, 3377, 4176, 4592, 4856, 5090, 5770, 6555, 6943, 7110, 7418, 7834, 8157, 8598, 9391, 10374, 10846, 11323, 11849, 12332, 12938, 13049, 13405, 14157]","[0, 170, 285, 422, 512, 724, 951, 1088, 1269, 1441, 1668, 1812, 2361, 2694, 2987, 3250, 3852, 4769, 5203, 5467, 5769, 5936, 6108, 6406, 6772, 7131, 7934, 8491, 8750, 9186, 9409, 9885, 10086, 10222, 10846]",20716,20664,18861,14157,10846,-776,-7775,-6824,-4540,-3500,-23415,35,dire
7594159214,46,93,98,65,20,"[0, 290, 566, 819, 1299, 1661, 2186, 2579, 2984, 3510, 3937, 4696, 5541, 6050, 6619, 7333, 7727, 8261, 9692, 10094, 10717, 10945, 11546, 12379, 13233, 13760, 14979, 15364, 16078, 16313, 17496, 18887, 19686, 20373, 21584]","[0, 242, 491, 833, 1165, 1608, 1908, 2251, 2506, 2663, 3183, 3877, 4237, 4883, 5606, 5992, 6833, 7368, 8354, 9238, 10097, 10743, 11491, 11751, 12352, 12994, 13466, 14216, 14748, 15231, 16577, 18280, 18380, 18876, 19773]","[0, 207, 616, 1076, 1362, 2185, 2521, 3112, 3871, 4574, 5235, 5504, 6503, 7133, 7446, 8014, 9032, 9930, 10132, 11054, 11682, 11933, 12847, 13414, 13754, 14580, 15379, 15625, 16603, 17276, 17372, 18925, 19322, 19709, 20430]","[0, 169, 259, 414, 504, 763, 1041, 1485, 1575, 1888, 2160, 2445, 3017, 3741, 4314, 4891, 5766, 6202, 6927, 7558, 7944, 8696, 9330, 9508, 10036, 10669, 11174, 11562, 12026, 12122, 13369, 14632, 15224, 15389, 16210]","[0, 169, 304, 469, 608, 968, 1148, 1843, 2023, 2673, 2808, 2988, 3483, 4068, 4372, 4466, 5011, 5277, 5505, 6021, 6490, 6935, 7336, 7585, 7890, 8486, 9151, 9444, 9831, 9959, 10094, 11370, 11939, 12215, 12980]",21584,19773,20430,16210,12980,48,13,102,123,26,"[0, 208, 410, 696, 1044, 1170, 1625, 1847, 2222, 2861, 3390, 3894, 4294, 5173, 5855, 6636, 7579, 7787, 8119, 9069, 9847, 10768, 11675, 12508, 13600, 14527, 16091, 16964, 17763, 19125, 20515, 21675, 22548, 23940, 25090]","[0, 328, 619, 1027, 1445, 1832, 2149, 2557, 3019, 3344, 3934, 4209, 4421, 4771, 5197, 5684, 6212, 6711, 8132, 8643, 9355, 10039, 10534, 11699, 12439, 12632, 13038, 13676, 14557, 15225, 15321, 16617, 16884, 16984, 17855]","[0, 203, 405, 919, 1162, 1587, 2189, 2713, 3151, 3654, 4151, 5097, 5621, 6083, 6809, 7471, 7845, 8212, 8972, 9604, 10009, 10291, 10741, 11902, 12482, 12775, 13091, 13276, 13744, 14784, 14880, 15113, 15600, 16361, 16954]","[0, 169, 259, 424, 597, 787, 1220, 1676, 2174, 2664, 2935, 3201, 3291, 3404, 3775, 4159, 4459, 4852, 5465, 5867, 6369, 6609, 7128, 7666, 8087, 8331, 8610, 9380, 10348, 11137, 11356, 11610, 11735, 11835, 11935]","[0, 217, 357, 447, 630, 770, 925, 1060, 1409, 1734, 1923, 2100, 2190, 2484, 2700, 3358, 3453, 3592, 4140, 4444, 5272, 5408, 5702, 6279, 6559, 6729, 7120, 7587, 7887, 8272, 8415, 8515, 8615, 8770, 8870]",25090,17855,16954,11935,8870,-3506,1918,3476,4275,4110,10273,35,radiant
7594427402,70,13,96,105,5,"[0, 204, 488, 814, 981, 1318, 1642, 1803, 2336, 2925, 3304, 3650, 4018, 4632, 5388, 5929, 6392, 6698, 7361, 8465, 9279, 10208, 10811, 11747, 12543, 13407, 14259, 14428, 14952, 15571, 17610, 19056, 20179, 20934, 21645]","[0, 326, 563, 898, 1125, 1605, 1822, 2111, 2403, 2733, 3166, 3491, 3928, 4550, 5116, 5682, 6365, 6561, 7062, 7911, 8300, 8982, 9510, 10259, 10885, 11480, 12174, 12268, 12843, 13521, 14904, 15783, 16402, 17083, 18013]","[0, 215, 606, 1035, 1289, 1840, 2138, 2352, 2721, 3263, 3687, 4064, 4244, 4595, 5244, 5716, 6040, 6708, 7255, 7585, 8144, 8711, 9191, 9925, 10819, 11222, 12039, 12197, 12684, 13029, 13536, 14334, 15065, 15921, 16364]","[0, 169, 464, 599, 689, 1408, 1623, 1713, 1852, 2092, 2227, 2856, 3269, 3447, 4421, 4618, 5166, 6066, 6627, 7454, 7666, 7927, 8141, 8601, 8971, 9213, 9595, 9764, 9969, 10607, 12018, 12373, 12913, 13356, 14013]","[0, 169, 514, 946, 1036, 1338, 1473, 1563, 1886, 2198, 2333, 2566, 3122, 3310, 3658, 3855, 4179, 4574, 4759, 5699, 5970, 6233, 6376, 6597, 6692, 6859, 7365, 7459, 7555, 7944, 8631, 9031, 9404, 9532, 9735]",21645,18013,16364,14013,9735,21,49,54,19,121,"[0, 169, 857, 1138, 1508, 2086, 2383, 2682, 3014, 3429, 3679, 3978, 4627, 5341, 5765, 6280, 6781, 8091, 8694, 9464, 10072, 11123, 11720, 12354, 12764, 13635, 14409, 15503, 16139, 16834, 17886, 18076, 18847, 19564, 20639]","[0, 286, 528, 818, 1175, 1542, 2081, 2839, 3380, 3832, 4663, 4948, 5474, 5916, 6677, 7380, 8168, 8561, 9566, 10487, 10978, 12146, 12593, 13137, 13573, 14144, 14768, 15758, 16231, 16327, 16755, 17244, 18003, 18938, 19933]","[0, 203, 367, 601, 846, 974, 1372, 1758, 2150, 2491, 2734, 2850, 3536, 4508, 4797, 5251, 5645, 5963, 6364, 6997, 7595, 8241, 9011, 9808, 10636, 11185, 12088, 13232, 13727, 14748, 15358, 15579, 16500, 17186, 17772]","[0, 169, 371, 513, 603, 836, 1096, 1502, 1639, 1729, 1819, 2136, 2607, 2921, 3106, 3284, 3596, 3827, 4072, 4419, 4617, 4913, 5241, 5407, 5502, 5804, 6226, 6546, 6934, 7030, 7314, 8173, 8631, 9187, 9561]","[0, 169, 259, 367, 505, 595, 855, 1065, 1155, 1338, 1428, 1643, 1972, 2394, 2579, 2673, 2894, 3385, 3543, 4063, 4210, 4402, 4569, 4961, 5333, 5832, 6231, 6661, 6838, 6934, 7218, 7467, 7836, 8110, 8390]",20639,19933,17772,9561,8390,1006,-1920,-1408,4452,1345,3475,35,dire
7594577403,36,76,16,20,110,"[0, 336, 703, 893, 1017, 1386, 1718, 2274, 2700, 3000, 3247, 3832, 4659, 5154, 5643, 5983, 6431, 6713, 7861, 8464, 9250, 9967, 11497, 12266, 13513, 14441, 15352, 15803, 16319, 17721, 17817, 18820, 19164, 19339, 19881]","[0, 280, 527, 989, 1250, 1614, 2103, 2274, 3329, 3785, 4187, 4860, 5517, 6030, 6512, 6784, 7161, 7621, 8173, 8710, 9074, 9331, 9858, 10387, 10482, 10942, 11333, 11909, 12257, 13052, 13348, 13951, 14351, 15339, 16138]","[0, 280, 567, 895, 1361, 1894, 2309, 3166, 4076, 4689, 5034, 5815, 6345, 6708, 7285, 7717, 7952, 8530, 8946, 9308, 9733, 10177, 11913, 12372, 13055, 13638, 14031, 14261, 14529, 15109, 15676, 16365, 16732, 16832, 17145]","[0, 500, 590, 680, 770, 908, 1088, 1298, 1653, 1788, 1878, 2235, 2615, 3218, 3367, 3701, 3796, 4084, 4374, 4469, 4564, 4703, 5126, 5717, 6255, 6531, 6899, 7204, 7583, 8085, 8295, 8606, 8936, 9460, 9635]","[0, 232, 322, 412, 630, 811, 991, 1420, 1764, 2127, 2292, 2670, 3050, 3275, 3561, 3861, 3992, 4236, 4497, 4592, 5019, 5216, 5806, 6251, 6705, 6871, 7047, 7277, 7420, 8171, 8466, 8769, 9233, 9734, 9909]",19881,16138,17145,9635,9909,129,106,70,53,128,"[0, 301, 569, 836, 1290, 1657, 2105, 2349, 2824, 3283, 3764, 3990, 4447, 5020, 5285, 6107, 6202, 7747, 8197, 8840, 9203, 9971, 10436, 10856, 11055, 11623, 11993, 12524, 13246, 14507, 15164, 16121, 18285, 18817, 19464]","[0, 512, 830, 1081, 1396, 1671, 2000, 2748, 2978, 3068, 3283, 3427, 3656, 4007, 4384, 4974, 5188, 6061, 6531, 7046, 7741, 8202, 8981, 9076, 9312, 9811, 10357, 11051, 11748, 13401, 14147, 15068, 16382, 17007, 17457]","[0, 481, 793, 1006, 1528, 1931, 2374, 2620, 2785, 3204, 3435, 3845, 4116, 4301, 4666, 5025, 5354, 5676, 6227, 7166, 7651, 8394, 9166, 9532, 9952, 10323, 10836, 11397, 11933, 12692, 13386, 13964, 15531, 16376, 16974]","[0, 262, 352, 459, 598, 703, 838, 1054, 1274, 1364, 1501, 1645, 1871, 2189, 2339, 3328, 3477, 4991, 5149, 5629, 6111, 6578, 7602, 7822, 8112, 8820, 8915, 9320, 10388, 11029, 11640, 11830, 12605, 13054, 13664]","[0, 192, 282, 409, 547, 683, 912, 1280, 1370, 1460, 1598, 1742, 1832, 2075, 2336, 2690, 2867, 3410, 3736, 4094, 4257, 4588, 5333, 5503, 5815, 5985, 6155, 6529, 7140, 8520, 8691, 9296, 10273, 10695, 10960]",19464,17457,16974,13664,10960,417,-1319,171,-4029,-1051,-5811,35,radiant
7594924106,73,95,120,123,5,"[1, 352, 694, 1241, 1595, 1851, 2164, 2600, 3171, 3897, 4336, 5194, 6019, 6847, 8181, 9067, 10098, 11162, 12402, 13364, 13852, 14155, 14394, 16401, 17282, 17838, 19251, 20012, 20355, 20817, 22464, 22857, 23416, 24229, 25946]","[1, 204, 567, 923, 1293, 1838, 2113, 2481, 2957, 3211, 3762, 4162, 4603, 5032, 5585, 6169, 6848, 7763, 8633, 9381, 10594, 11351, 12190, 13872, 14873, 15467, 16791, 17567, 18604, 19839, 21408, 22010, 22454, 22554, 23502]","[1, 620, 847, 1154, 1402, 1729, 2111, 2412, 2689, 2928, 3269, 3835, 4351, 5016, 5603, 5903, 6425, 7457, 8098, 8363, 9158, 9938, 10105, 11613, 12397, 13463, 14369, 14930, 15176, 15592, 16303, 16624, 17234, 17334, 18332]","[1, 291, 430, 626, 754, 963, 1053, 1420, 1521, 1630, 2283, 2373, 2663, 2871, 3214, 3363, 3840, 4145, 4512, 4803, 5162, 5376, 5543, 6199, 6491, 6732, 7682, 7992, 8088, 8384, 9271, 9371, 9471, 10072, 10739]","[1, 598, 740, 877, 1068, 1281, 1371, 1581, 1752, 1923, 2191, 2374, 2608, 2771, 3074, 3294, 3669, 3928, 4190, 4348, 4508, 4814, 5053, 5796, 6088, 6330, 7092, 7306, 7477, 7897, 8641, 8933, 9775, 10014, 10681]",25946,23502,18332,10739,10681,39,18,102,26,110,"[1, 289, 631, 916, 1337, 1675, 2260, 2869, 3577, 3779, 4033, 4439, 4789, 5438, 6034, 6662, 7058, 7857, 8081, 8692, 9495, 9783, 10800, 10895, 11521, 12254, 13199, 13800, 14786, 15492, 16114, 17592, 19491, 19674, 20490]","[1, 209, 487, 910, 1318, 1698, 2186, 2921, 3662, 4433, 5035, 6046, 6485, 7256, 7775, 8929, 9709, 10721, 12067, 12594, 13520, 13754, 14537, 14938, 15251, 16362, 16730, 16825, 17648, 18222, 18318, 18763, 19560, 19660, 20295]","[1, 209, 519, 943, 1226, 1351, 1775, 2110, 2268, 2714, 3065, 3629, 4057, 4833, 5236, 5535, 5755, 5889, 6891, 7498, 8019, 8326, 9009, 9213, 9754, 10579, 11319, 11967, 12486, 13606, 13965, 14961, 16270, 16629, 17235]","[1, 384, 572, 736, 866, 1008, 1186, 1649, 1739, 1906, 2041, 2547, 2891, 3179, 3459, 3681, 4075, 4336, 4759, 4956, 5403, 5545, 5885, 6089, 6183, 6604, 6774, 6967, 7388, 7980, 8232, 8944, 9923, 10097, 10332]","[1, 170, 260, 424, 572, 678, 784, 964, 1104, 1271, 1615, 1759, 1955, 2313, 2408, 3025, 3281, 3564, 4133, 4291, 4830, 5100, 5593, 5876, 5970, 6137, 6394, 6489, 6764, 7175, 7427, 8361, 9752, 9852, 10172]",20490,20295,17235,10332,10172,5456,3207,1097,407,509,10676,35,radiant
7594930014,82,13,29,86,5,"[0, 170, 482, 855, 1053, 1658, 2288, 2908, 3190, 3725, 4266, 4880, 5581, 6442, 7120, 8161, 9131, 10063, 10774, 11661, 12460, 13063, 13764, 14144, 14838, 15520, 16388, 17165, 17365, 17506, 18211, 18895, 19676, 20529, 21251]","[0, 241, 523, 787, 914, 1204, 1425, 1683, 1991, 2702, 3272, 3811, 4349, 4980, 5513, 5896, 6293, 6569, 7449, 8186, 8451, 8890, 9600, 10171, 10814, 11197, 12239, 12498, 13238, 13863, 15963, 16568, 17232, 17497, 18626]","[0, 219, 533, 812, 1174, 1551, 1919, 2371, 2766, 3037, 3560, 4062, 4699, 5474, 6184, 6711, 7430, 8089, 8504, 8810, 9348, 9790, 9956, 10051, 10606, 11233, 11693, 12156, 12457, 12974, 14160, 14260, 14450, 14550, 15367]","[0, 170, 345, 435, 569, 694, 905, 1040, 1225, 1662, 1844, 2102, 2519, 2812, 3198, 3450, 3717, 4151, 4984, 5670, 6184, 6279, 6445, 6624, 7103, 7860, 8113, 8903, 9198, 9340, 11808, 12125, 12539, 12756, 13368]","[0, 221, 413, 551, 682, 889, 1179, 1323, 1665, 2064, 2264, 2354, 2590, 2936, 3191, 3285, 3610, 3933, 4362, 4630, 4849, 5019, 5260, 5501, 5871, 6088, 6501, 6781, 7050, 7378, 7568, 7868, 8058, 8211, 8591]",21251,18626,15367,13368,8591,95,59,129,105,26,"[0, 209, 492, 849, 1227, 1560, 1981, 2461, 2829, 3523, 4015, 4467, 4957, 5697, 6424, 7281, 7941, 8650, 9907, 10609, 11561, 12548, 14471, 14965, 16111, 17622, 18487, 19873, 21485, 22952, 24199, 24299, 24666, 26301, 26848]","[0, 278, 609, 938, 1292, 1635, 2079, 2575, 3102, 3564, 4186, 4546, 4961, 5857, 6631, 7010, 7687, 8188, 8876, 9391, 9962, 10635, 11784, 12370, 12801, 13697, 13923, 14674, 15400, 15959, 16534, 17083, 17888, 18862, 19345]","[0, 246, 518, 798, 1087, 1533, 1697, 2040, 2536, 2778, 2957, 3416, 3881, 4572, 4980, 5437, 6462, 6734, 7273, 7695, 8237, 8614, 9606, 9968, 10458, 11122, 11348, 12065, 12756, 13151, 14063, 14773, 15914, 16808, 17247]","[0, 170, 308, 444, 574, 932, 1022, 1648, 1849, 2214, 2432, 2719, 3103, 3435, 3952, 4527, 5039, 5298, 5787, 5944, 6279, 6471, 7353, 7670, 8015, 8454, 8680, 9328, 9796, 10412, 11457, 11609, 11976, 12918, 13229]","[0, 214, 356, 494, 669, 759, 909, 1184, 1385, 1577, 1851, 2019, 2199, 2530, 2715, 2825, 3225, 3488, 4066, 4223, 4483, 4602, 5355, 5873, 5968, 6455, 6926, 7699, 8119, 8559, 9073, 9173, 9540, 10502, 10602]",26848,19345,17247,13229,10602,-5597,-719,-1880,139,-2011,-10068,35,dire
7595374901,11,17,40,84,93,"[1, 253, 574, 815, 1144, 1573, 1991, 2770, 3214, 3669, 3855, 4640, 5076, 5548, 6088, 6679, 7275, 8185, 8888, 9436, 10262, 10688, 11125, 12036, 12463, 13333, 14800, 16007, 17529, 17928, 18830, 19629, 20322, 20750, 21566]","[1, 406, 686, 1135, 1514, 1970, 2830, 3280, 3888, 4381, 5033, 5841, 6398, 7019, 7718, 8014, 8785, 9055, 9150, 9512, 9828, 10790, 10885, 11706, 12404, 12979, 13410, 15413, 16141, 16588, 16684, 17055, 17611, 18199, 18759]","[1, 278, 589, 923, 1164, 1654, 2025, 2426, 2957, 3624, 4217, 5222, 5407, 5811, 6209, 6722, 7253, 7865, 8367, 9205, 9508, 9705, 9909, 10774, 12016, 12595, 12727, 13711, 14548, 14766, 15196, 15386, 15909, 16146, 16397]","[1, 171, 261, 396, 533, 708, 845, 1086, 1620, 2006, 2145, 2553, 2940, 3466, 3680, 3949, 4715, 4925, 5395, 5706, 6401, 6496, 6911, 7345, 7529, 8578, 8673, 9893, 10485, 11061, 11681, 11871, 12188, 12378, 12478]","[1, 171, 261, 395, 485, 740, 830, 920, 1100, 1238, 1374, 1807, 2103, 2357, 2452, 2877, 3278, 4008, 4487, 5084, 5474, 6179, 6369, 6576, 7942, 8201, 8594, 9806, 10699, 10917, 11232, 11678, 12241, 13042, 13506]",21566,18759,16397,12478,13506,18,13,71,121,85,"[1, 320, 653, 1091, 1451, 2338, 2807, 3349, 3737, 4394, 4889, 5452, 6061, 6635, 7394, 8066, 8981, 9888, 10825, 12420, 13434, 13962, 15442, 16522, 16915, 18232, 19209, 19304, 19705, 20850, 21308, 21989, 23113, 24602, 26078]","[1, 326, 730, 1138, 1553, 2010, 2381, 2998, 3713, 4098, 5221, 5926, 6644, 7126, 7749, 8153, 8727, 9396, 10208, 10915, 11678, 11773, 12927, 14343, 14818, 15686, 17282, 17377, 17511, 18548, 19631, 20541, 21296, 22228, 23406]","[1, 206, 549, 794, 1121, 1318, 1714, 1915, 2136, 2471, 3198, 3465, 3960, 4551, 5532, 5921, 6442, 7111, 7866, 8480, 8727, 8822, 10320, 11109, 11242, 11925, 12526, 12621, 12983, 14044, 14437, 14762, 15312, 15966, 16569]","[1, 217, 307, 397, 567, 657, 792, 882, 972, 1111, 1536, 1626, 1819, 2099, 2672, 2767, 2924, 3561, 3746, 4693, 4940, 5035, 5202, 6098, 6192, 6359, 6475, 6570, 6749, 7366, 7462, 7787, 7946, 8320, 8556]","[1, 171, 261, 413, 503, 721, 858, 1116, 1248, 1389, 1524, 1974, 2283, 2464, 2698, 2793, 2975, 3415, 3769, 4349, 4778, 4937, 5104, 5651, 5807, 6011, 6150, 6245, 6396, 7013, 7109, 7434, 7886, 8096, 8331]",26078,23406,16569,8556,8331,-4512,-4647,-172,3922,5175,-234,35,radiant
7595378008,49,76,65,112,20,"[0, 254, 527, 847, 1099, 1603, 2084, 2676, 3534, 3781, 4576, 5346, 5912, 6296, 7347, 7825, 8350, 9198, 9924, 10790, 11459, 12044, 12610, 13194, 13682, 14325, 14420, 14793, 15966, 16705, 17318, 18001, 20326, 21385, 22222]","[0, 274, 628, 958, 1207, 1579, 2048, 2435, 2831, 3360, 4087, 4542, 4925, 5708, 6959, 7696, 8136, 9056, 10095, 11345, 11967, 12264, 12988, 13396, 14306, 14784, 15269, 15806, 16608, 16704, 17435, 18138, 18598, 19330, 21398]","[0, 206, 367, 601, 803, 1243, 1725, 2186, 2655, 3174, 4008, 4296, 4728, 5278, 6513, 7025, 8230, 8739, 9345, 10437, 10786, 11812, 11907, 12733, 13242, 13866, 13961, 14560, 15059, 15155, 15487, 15712, 16322, 16704, 17577]","[0, 217, 327, 421, 511, 601, 1032, 1196, 1286, 1440, 2127, 2466, 2879, 3028, 3447, 3935, 4294, 4551, 5202, 6279, 6884, 8250, 8731, 9073, 9877, 10656, 10826, 11201, 12299, 12856, 13437, 13662, 15434, 16032, 17052]","[0, 170, 359, 494, 584, 910, 1281, 1371, 1461, 1719, 2213, 2380, 2728, 3027, 3405, 3598, 4095, 4541, 5057, 5975, 6070, 6528, 6677, 7163, 8138, 8531, 8776, 9072, 9786, 10095, 10623, 10935, 11517, 11862, 12703]",22222,21398,17577,17052,12703,138,15,137,96,100,"[0, 242, 514, 844, 1123, 1561, 1729, 2083, 2749, 2954, 3297, 3841, 4609, 5289, 5891, 6220, 6840, 7954, 8990, 9311, 9406, 10257, 10352, 11178, 12239, 13066, 13854, 15032, 16586, 17211, 17345, 18501, 19188, 19288, 20576]","[0, 170, 383, 624, 984, 1395, 1868, 1958, 2300, 2778, 2907, 3157, 3339, 3840, 4101, 4610, 5040, 5735, 6073, 6167, 6437, 7422, 8513, 8704, 9053, 10068, 11346, 11670, 12893, 13094, 13735, 14482, 15337, 15652, 16177]","[0, 255, 584, 877, 1766, 2020, 2436, 2928, 3526, 3813, 3987, 4178, 4823, 5006, 5258, 5750, 6378, 6653, 6914, 7008, 7205, 8376, 8922, 9199, 9809, 10856, 11378, 11714, 12398, 13145, 13496, 13794, 14115, 14463, 14915]","[0, 170, 280, 414, 537, 695, 833, 960, 1547, 1804, 1894, 2042, 3081, 3481, 3885, 4015, 4303, 4744, 4839, 4933, 5028, 5614, 6013, 6441, 6971, 7497, 8160, 8464, 9776, 9947, 10455, 11314, 11710, 12058, 12550]","[0, 215, 305, 395, 563, 885, 1172, 1280, 1597, 1809, 1899, 2298, 2651, 2746, 2886, 2981, 3105, 3502, 3653, 3747, 3842, 4350, 5231, 5417, 5766, 6265, 6787, 7016, 7610, 7706, 7858, 8382, 8737, 8837, 9259]",20576,16177,14915,12550,9259,1646,5221,2662,4502,3444,17475,35,radiant
7595612013,39,93,137,90,86,"[0, 246, 570, 893, 1380, 1798, 2238, 2709, 3150, 3596, 4341, 4849, 5118, 5472, 6027, 6601, 7695, 8196, 9091, 9640, 10706, 11614, 12583, 13290, 14154, 15137, 15572, 16596, 17720, 18933, 19455, 20579, 21960, 22602, 23742]","[0, 206, 765, 1128, 1294, 1678, 2013, 2561, 3091, 3711, 4077, 4666, 5093, 5764, 6314, 6851, 7442, 7979, 8443, 9176, 9845, 10617, 11222, 11675, 12212, 13186, 14265, 15377, 16423, 17294, 17994, 19191, 20188, 21021, 21803]","[0, 169, 450, 696, 947, 1457, 1780, 2308, 2583, 3081, 3613, 4462, 4790, 4939, 5375, 5801, 6383, 6762, 6943, 7322, 7932, 8401, 9406, 9928, 10362, 10823, 11897, 12711, 13321, 14051, 14668, 15421, 16355, 17148, 17922]","[0, 269, 398, 590, 768, 891, 1071, 1251, 1380, 1567, 1850, 2194, 2509, 2869, 3341, 4028, 4676, 5086, 5415, 5803, 6281, 6765, 7181, 7482, 8210, 8581, 9716, 9927, 10786, 11222, 12065, 12935, 13507, 13887, 14472]","[100, 316, 485, 623, 713, 921, 1093, 1435, 1584, 1674, 1809, 2056, 2349, 2543, 2763, 3094, 3538, 3879, 4150, 4599, 5217, 5965, 6336, 6563, 7043, 7215, 7764, 8250, 8748, 9527, 10201, 11171, 11916, 12363, 12663]",23742,21803,17922,14472,12663,89,120,49,26,5,"[0, 238, 451, 770, 1071, 1354, 1708, 2228, 2550, 2871, 3207, 3794, 4387, 5215, 5889, 6168, 7074, 7446, 8167, 9012, 9665, 10042, 11146, 11720, 12584, 13469, 13563, 13658, 14745, 15097, 15280, 15380, 16323, 17331, 17431]","[64, 302, 591, 986, 1226, 1652, 2184, 2519, 2698, 3638, 3954, 4374, 4876, 5539, 5785, 6362, 6991, 7724, 7900, 8134, 8666, 9519, 10289, 11120, 12050, 12668, 13021, 13587, 13942, 14331, 14427, 15731, 16257, 16768, 17345]","[332, 552, 744, 950, 1316, 1588, 1882, 2053, 2420, 2806, 3345, 3995, 4480, 5150, 5435, 5816, 6535, 6911, 7233, 7691, 8094, 8693, 9285, 9433, 9921, 10612, 11469, 11564, 12376, 12588, 13377, 13562, 14183, 14883, 15238]","[64, 271, 405, 533, 672, 802, 996, 1121, 1233, 1576, 1666, 2161, 2382, 2531, 2673, 2768, 3061, 3384, 3478, 3791, 4240, 4410, 4759, 4929, 5134, 5633, 6015, 6185, 6518, 6689, 6829, 6929, 7029, 7300, 7400]","[64, 233, 342, 476, 647, 890, 1025, 1115, 1205, 1641, 1904, 2234, 2746, 2895, 3142, 3318, 3476, 3571, 3890, 3985, 4207, 4302, 4576, 4710, 4805, 5008, 5339, 5434, 5784, 6139, 6235, 6335, 6435, 6625, 6757]",17431,17345,15238,7400,6757,6311,4458,2684,7072,5906,26431,35,radiant
7596368016,89,22,69,123,9,"[0, 245, 488, 901, 1191, 1722, 2438, 3174, 3786, 4461, 5017, 6003, 6451, 7161, 8499, 9054, 10180, 10813, 10907, 11718, 12426, 13640, 14613, 15262, 16517, 17228, 18354, 19328, 20913, 22157, 22763, 23541, 24382, 25245, 25394]","[0, 325, 637, 1055, 1572, 1992, 2370, 2927, 3550, 4225, 4856, 5283, 6424, 7118, 7782, 8094, 8732, 9788, 10724, 11922, 12845, 13663, 14712, 15292, 16248, 16931, 18092, 18595, 19656, 20982, 21708, 22745, 23693, 24224, 24681]","[0, 292, 560, 926, 1562, 1903, 2264, 2908, 3331, 3970, 4514, 4954, 5636, 6196, 6706, 7495, 8385, 9386, 10178, 10731, 11280, 11912, 12653, 12859, 13778, 14594, 15512, 15732, 17705, 18644, 19239, 20597, 21342, 21822, 22264]","[0, 170, 304, 494, 655, 785, 972, 1264, 1548, 1737, 1888, 2285, 2647, 2949, 3348, 3497, 3745, 4188, 4790, 5318, 5722, 6137, 6555, 6680, 7541, 8125, 9350, 9507, 10762, 11801, 12361, 13863, 14531, 15196, 15601]","[0, 218, 358, 522, 695, 889, 1082, 1286, 1564, 1819, 2183, 2391, 3026, 3324, 3747, 4080, 4557, 4766, 5336, 5832, 6464, 6894, 7350, 7806, 8628, 8933, 9639, 10117, 10875, 11767, 11938, 12637, 13436, 13728, 13864]",25394,24681,22264,15601,13864,94,73,129,26,5,"[0, 253, 603, 958, 1360, 1799, 2219, 2641, 3145, 3697, 4429, 5160, 5744, 6016, 6669, 7414, 8440, 9306, 9848, 9943, 10937, 11820, 12930, 13619, 14674, 15805, 16891, 17761, 18561, 18657, 20291, 20890, 21521, 22842, 24402]","[0, 426, 766, 1127, 1482, 1813, 1990, 2498, 3001, 3621, 4411, 4904, 5428, 6106, 6457, 7601, 8530, 9664, 10869, 11515, 12508, 12891, 13228, 13601, 13696, 14649, 15434, 15567, 16159, 16382, 17396, 17918, 18753, 19171, 19725]","[0, 278, 587, 880, 1281, 1735, 2280, 2815, 3320, 3718, 4358, 4625, 4937, 5501, 5829, 6442, 6987, 7463, 7882, 8169, 8578, 8833, 9203, 9407, 9976, 10653, 10927, 11431, 11970, 12206, 12512, 13304, 13907, 14007, 14401]","[0, 172, 274, 364, 552, 874, 999, 1284, 1420, 1603, 1991, 2168, 2540, 2635, 2800, 3088, 3443, 3564, 4008, 4247, 4447, 4542, 4666, 4881, 5042, 5359, 5453, 5711, 5862, 6320, 7249, 7686, 7985, 8277, 8895]","[0, 170, 285, 420, 550, 687, 853, 1113, 1276, 1412, 1811, 1938, 2117, 2212, 2420, 2890, 3024, 3167, 3955, 4050, 4277, 4372, 4466, 4869, 4964, 5278, 5395, 5490, 5641, 5818, 7209, 7524, 7714, 7814, 8152]",24402,19725,14401,8895,8152,992,4956,7863,6706,5712,26229,35,radiant
7596687303,18,120,135,20,121,"[0, 316, 624, 871, 1285, 1637, 1952, 2505, 2990, 3793, 4480, 5074, 5752, 6444, 7125, 8204, 8859, 9509, 11035, 11853, 13141, 13925, 14982, 15872, 16587, 17688, 18355, 19216, 20227, 21705, 22729, 23322, 24304, 25725, 26638]","[0, 248, 531, 898, 1237, 1527, 2161, 2671, 3079, 3378, 3791, 4366, 4852, 5338, 5769, 6544, 7105, 7493, 7805, 8302, 9486, 9825, 10074, 10807, 11404, 11710, 12244, 12775, 13413, 14287, 14768, 15028, 16206, 16695, 17459]","[0, 283, 565, 733, 859, 1103, 1314, 1449, 1751, 2168, 2396, 2726, 2868, 3300, 3596, 4213, 4691, 5054, 5503, 5868, 6289, 6741, 7255, 8800, 9080, 9524, 10126, 10221, 10662, 11384, 12032, 12374, 12849, 13399, 13720]","[0, 210, 346, 528, 666, 802, 908, 1074, 1216, 1441, 1670, 2201, 2489, 2667, 3380, 3678, 3933, 4226, 5013, 5214, 5652, 5765, 6049, 6813, 6956, 7149, 7344, 7523, 7734, 8287, 8854, 9599, 9868, 10252, 10530]","[0, 210, 347, 437, 624, 1170, 1307, 1442, 1617, 2028, 2465, 2748, 2838, 2994, 3280, 3649, 3788, 3930, 4463, 4558, 4946, 5122, 5623, 6108, 6203, 6603, 7016, 7726, 7953, 8195, 8784, 9019, 9119, 9329, 9539]",26638,17459,13720,10530,9539,114,28,106,5,26,"[0, 182, 490, 1006, 1306, 1631, 2211, 2498, 2896, 3172, 3621, 3785, 4254, 4767, 5311, 5514, 6125, 6971, 7403, 7970, 8869, 9870, 10520, 10928, 11551, 11940, 12586, 12907, 13468, 14219, 14668, 15721, 16710, 17446, 18267]","[0, 130, 377, 576, 1222, 1348, 1792, 2016, 2593, 3042, 3658, 4137, 4587, 5472, 6009, 6443, 7401, 7875, 8303, 9084, 9778, 10031, 11015, 11499, 12171, 12558, 13194, 13511, 13607, 14116, 14293, 15855, 16384, 17133, 18127]","[0, 279, 651, 964, 1373, 2061, 2393, 2845, 3589, 4210, 4771, 5657, 5977, 6618, 6881, 7412, 8149, 8262, 8847, 9393, 9790, 10473, 11072, 11167, 12042, 12696, 13439, 13902, 14167, 14439, 15373, 16160, 17010, 17804, 18547]","[0, 233, 366, 902, 1126, 1445, 1662, 2105, 2371, 2461, 2641, 2767, 3262, 3567, 3754, 3849, 4216, 4487, 4667, 5103, 5378, 5756, 6063, 6365, 6552, 6665, 7083, 7463, 7899, 7995, 8172, 8850, 9065, 9706, 10347]","[0, 130, 220, 310, 560, 698, 834, 1156, 1422, 1644, 1824, 2030, 2120, 2394, 2594, 2689, 3277, 3907, 4139, 4297, 4572, 4982, 5400, 5679, 5990, 6205, 6891, 7200, 7371, 7542, 7794, 8407, 8582, 8872, 9329]",18267,18127,18547,10347,9329,8371,-668,-4827,183,210,3269,35,radiant
7596756308,10,120,28,65,20,"[63, 345, 585, 867, 1193, 1966, 2472, 2915, 3562, 4103, 4472, 5111, 5362, 5604, 6209, 6944, 7470, 8282, 8945, 9463, 11281, 12185, 13364, 14118, 14950, 15606, 16779, 17686, 18651, 19858, 20759, 20978, 21078, 22495, 23740]","[63, 295, 649, 1025, 1403, 1834, 2197, 2330, 2688, 3187, 3582, 3967, 4089, 4679, 5186, 5843, 6661, 6879, 7492, 8438, 9483, 9989, 11056, 11791, 11886, 12618, 13226, 13444, 13895, 14661, 15023, 15169, 15269, 16324, 16983]","[331, 641, 1042, 1292, 1798, 2098, 2552, 3001, 3476, 3894, 4345, 5404, 5939, 6622, 6845, 7320, 7889, 8282, 8376, 8616, 9030, 9689, 10477, 10991, 11086, 11649, 11743, 12208, 12637, 13094, 13537, 13637, 14028, 15003, 15404]","[63, 428, 518, 608, 743, 873, 980, 1173, 1694, 1892, 2291, 2745, 2984, 3393, 3577, 4236, 4689, 4925, 5478, 5930, 6635, 6852, 7811, 8344, 8704, 9297, 9466, 9636, 9807, 10250, 10750, 10925, 11535, 11635, 12089]","[63, 442, 637, 727, 898, 1154, 1255, 1470, 1737, 1924, 2059, 2198, 2385, 2570, 2823, 3204, 3362, 3476, 3570, 3927, 4561, 5039, 5689, 5946, 6041, 6422, 6597, 6884, 7064, 7432, 7528, 7628, 8082, 8591, 8985]",23740,16983,15404,12089,8985,69,93,126,79,9,"[0, 374, 606, 891, 1170, 1300, 1675, 2210, 2746, 3111, 3862, 4330, 4500, 5623, 6335, 7080, 7625, 8863, 9991, 10993, 11668, 12030, 12357, 12708, 14534, 15046, 15959, 16827, 17646, 17992, 18457, 20375, 22170, 23199, 23923]","[0, 170, 537, 771, 1137, 1496, 1978, 2385, 2763, 3100, 3756, 4123, 4635, 5287, 5984, 6503, 7283, 8540, 8905, 9515, 10235, 10921, 11720, 12726, 13927, 14381, 16125, 16959, 17455, 18515, 19472, 20922, 21951, 22411, 22550]","[0, 328, 700, 1117, 1534, 1863, 2347, 3030, 3564, 3736, 4197, 4557, 5285, 5698, 6562, 6922, 7778, 8389, 8934, 9665, 10298, 10529, 10623, 10965, 12078, 12335, 13207, 13753, 14401, 14968, 15604, 18056, 19163, 19896, 20180]","[0, 321, 411, 621, 759, 849, 1140, 1360, 1495, 1585, 2093, 2217, 2506, 2969, 3259, 3562, 3807, 4177, 4695, 5051, 5481, 6255, 6855, 7231, 7571, 7903, 8474, 8938, 9236, 9671, 10016, 10647, 11556, 11802, 11954]","[0, 440, 530, 694, 863, 953, 1192, 1412, 1595, 1721, 2213, 2303, 2508, 2798, 3061, 3155, 3313, 3979, 4358, 4743, 5442, 5980, 6149, 6439, 7067, 7478, 8072, 8456, 8916, 9442, 9734, 10129, 10906, 11257, 11357]",23923,22550,20180,11954,11357,-183,-5567,-4776,135,-2372,-12763,35,dire
7597199202,74,80,93,121,26,"[0, 316, 598, 886, 1260, 1678, 1924, 2508, 2990, 3214, 3500, 3973, 4595, 5544, 5872, 6331, 6672, 7432, 7868, 8262, 8420, 8706, 9028, 9713, 10375, 11210, 11928, 12475, 13178, 13663, 14253, 15660, 15760, 15860, 17007]","[0, 297, 647, 1075, 1348, 2088, 2451, 2915, 3152, 3242, 3410, 3706, 4321, 5033, 5390, 6107, 6686, 7872, 8527, 8714, 9388, 10007, 10361, 10785, 11324, 11491, 11954, 12372, 12866, 13149, 13645, 14535, 14635, 15380, 15983]","[0, 285, 555, 948, 1256, 1593, 1946, 2364, 2782, 3448, 4041, 4963, 5883, 6799, 7353, 7448, 8156, 9100, 9868, 10423, 10719, 11678, 12042, 12798, 13277, 13715, 14312, 14774, 15497, 15674, 16466, 17673, 17773, 18119, 18830]","[0, 254, 387, 593, 764, 926, 1254, 1434, 1741, 1926, 2162, 2342, 2874, 3404, 3617, 4134, 4292, 4950, 5207, 5897, 6772, 7415, 7575, 7899, 8125, 8802, 9077, 9547, 10209, 10461, 10881, 12497, 12672, 12847, 13112]","[100, 309, 442, 612, 798, 1008, 1423, 1513, 1603, 1817, 2224, 2404, 2853, 3462, 3556, 3827, 4340, 4831, 5015, 5293, 6091, 6382, 6476, 6681, 6776, 6987, 7282, 7512, 8006, 8510, 8822, 9012, 9176, 9276, 9698]",17007,15983,18830,13112,9698,13,107,20,48,112,"[0, 590, 843, 1223, 1431, 1723, 2110, 2479, 3040, 3637, 4261, 5015, 5469, 5654, 6138, 6590, 7163, 7543, 7828, 8456, 8898, 9651, 10287, 10946, 11656, 12517, 13548, 14022, 15668, 16360, 17925, 18973, 20583, 21483, 22481]","[0, 199, 575, 849, 1312, 1605, 1902, 2237, 2603, 3594, 4283, 5222, 5548, 5746, 6013, 6866, 7555, 8343, 8727, 9761, 9945, 10654, 11021, 11862, 13039, 13850, 14527, 15381, 16350, 17209, 17739, 18867, 20697, 20992, 21795]","[0, 323, 642, 967, 1206, 1661, 1949, 2490, 2738, 2908, 3258, 3472, 4045, 4397, 4491, 4858, 5162, 5602, 5770, 6192, 6729, 7263, 7619, 7932, 8578, 9438, 10066, 10161, 10785, 11198, 11969, 13030, 13829, 14208, 14627]","[0, 199, 289, 637, 811, 901, 1036, 1662, 1786, 2022, 2393, 3429, 3671, 3820, 3914, 4225, 4446, 4779, 5221, 6583, 6870, 7377, 7861, 8283, 8796, 9296, 9978, 10347, 10921, 11605, 11879, 12661, 13143, 14314, 14706]","[0, 199, 289, 409, 602, 737, 872, 1008, 1255, 1796, 2044, 2644, 2837, 2986, 3080, 3529, 3672, 4083, 4177, 4814, 4979, 5231, 5708, 6066, 6525, 7120, 7389, 7484, 8306, 8402, 8814, 9204, 9569, 9816, 9916]",22481,21795,14627,14706,9916,-5474,-5812,4203,-1594,-218,-8895,35,radiant
7597334717,17,16,10,14,5,"[0, 376, 849, 1240, 1744, 2291, 2874, 3394, 3959, 4469, 5081, 5518, 5764, 6230, 7143, 8659, 9144, 9733, 10579, 11052, 11667, 12396, 13557, 14132, 14933, 15680, 17071, 18170, 18508, 18604, 20737, 21498, 22404, 23413, 23513]","[0, 245, 537, 1005, 1400, 1924, 2612, 3113, 3502, 4012, 4327, 5210, 5560, 6126, 6562, 7127, 8463, 8558, 9210, 9867, 10380, 10867, 11304, 11398, 12212, 12786, 13484, 13779, 14239, 14335, 15829, 16913, 17625, 18684, 18848]","[0, 290, 576, 834, 1172, 1503, 1877, 2347, 2711, 3387, 4089, 4319, 4893, 5331, 6061, 6694, 7274, 7857, 8226, 9006, 9407, 10834, 11073, 11271, 11414, 12506, 13023, 13631, 13916, 14012, 15324, 16361, 16948, 17048, 17743]","[0, 169, 302, 673, 809, 948, 1374, 1615, 1791, 2303, 2983, 3197, 3530, 3970, 4396, 4851, 5387, 5658, 5861, 6366, 6461, 6705, 7319, 7413, 8887, 9142, 9424, 9628, 9724, 9820, 11337, 11825, 12131, 12680, 12780]","[0, 203, 327, 462, 598, 747, 882, 1062, 1169, 1353, 1639, 1784, 1874, 1969, 2349, 2873, 3094, 3189, 3561, 3808, 3932, 4102, 4558, 4821, 5284, 5719, 5970, 6249, 6420, 6591, 7976, 8718, 9003, 9583, 9758]",23513,18848,17743,12780,9758,25,48,49,84,86,"[0, 313, 648, 1062, 1442, 1938, 2723, 3439, 4160, 4799, 5552, 6531, 7059, 7549, 8239, 8333, 8794, 9386, 9898, 10778, 12104, 12741, 13408, 14421, 14890, 15528, 16053, 17095, 18111, 20129, 20430, 20606, 22379, 23996, 25947]","[0, 266, 670, 1515, 1900, 2280, 2955, 3577, 3999, 4225, 4843, 5488, 6071, 6700, 7661, 8336, 8904, 9856, 10736, 11414, 12358, 13595, 14390, 15933, 16273, 16479, 17309, 18611, 19138, 21117, 22303, 22610, 23422, 24255, 25016]","[0, 266, 677, 1003, 1409, 1655, 2323, 3023, 3493, 3733, 4036, 4674, 5421, 5966, 6599, 7031, 7392, 8242, 8800, 9198, 9932, 10164, 10419, 11346, 11966, 12208, 12824, 13540, 14096, 15577, 15719, 16153, 16388, 16894, 18147]","[0, 194, 284, 579, 791, 940, 1230, 1736, 1941, 2112, 2437, 3024, 3195, 3494, 3912, 4006, 4469, 5079, 5533, 6191, 7272, 7442, 7904, 8585, 9270, 9365, 9799, 10316, 11462, 13092, 13267, 13527, 14308, 14972, 15487]","[0, 194, 284, 465, 644, 781, 1129, 1353, 1491, 1703, 2195, 2704, 2823, 3180, 3485, 3617, 4001, 4534, 4794, 5271, 6182, 6831, 7387, 8072, 8413, 8508, 8662, 8975, 9575, 11078, 11250, 11350, 12063, 12569, 12849]",25947,25016,18147,15487,12849,-2434,-6168,-404,-2707,-3091,-14804,35,dire
7597391314,109,128,7,123,102,"[0, 204, 541, 1008, 1394, 1813, 2215, 2526, 3036, 3533, 3857, 4473, 4849, 5181, 5800, 6160, 6941, 7525, 8222, 9240, 10003, 10920, 11690, 11785, 12766, 13926, 14573, 15619, 15901, 16241, 16579, 16995, 18389, 19521, 20742]","[0, 280, 622, 1034, 1637, 2061, 2617, 3116, 3559, 3774, 4086, 4810, 5066, 5406, 6363, 7209, 7744, 8849, 9366, 9910, 10499, 11095, 11828, 11923, 13373, 14394, 15076, 15664, 15760, 16147, 16243, 16343, 17661, 19206, 20366]","[0, 362, 818, 1258, 1692, 2196, 2748, 3193, 3727, 4070, 4507, 4597, 5300, 5607, 6726, 6876, 7748, 8045, 8273, 8446, 8702, 9234, 10012, 10107, 10831, 12677, 13401, 14101, 14476, 14613, 14876, 15022, 15982, 16082, 16817]","[0, 170, 260, 398, 567, 706, 943, 1078, 1217, 1307, 1483, 2150, 2505, 2728, 3235, 3783, 4109, 4318, 4504, 4768, 5202, 5490, 5821, 5969, 6420, 7403, 8160, 8639, 9430, 9765, 10554, 10775, 11909, 12360, 12755]","[0, 170, 260, 399, 592, 780, 920, 1123, 1538, 1743, 1985, 2112, 2483, 2790, 3454, 3765, 4282, 4449, 4902, 4997, 5191, 5285, 5616, 5711, 6005, 6580, 6846, 7293, 7511, 7744, 8078, 8223, 9148, 9662, 10003]",20742,20366,16817,12755,10003,106,77,8,86,84,"[0, 366, 745, 1185, 1585, 2205, 2768, 3156, 3614, 4275, 4794, 5428, 6044, 6404, 7084, 7578, 7940, 8506, 9124, 9935, 10696, 12004, 13770, 15476, 16261, 16355, 17275, 18238, 19385, 20848, 21617, 23264, 25164, 26044, 26324]","[0, 246, 558, 1097, 1551, 1864, 2293, 2729, 3027, 3252, 3867, 4480, 4660, 5616, 5911, 6356, 7054, 7356, 8157, 9139, 9998, 10347, 11085, 11945, 12493, 12773, 13095, 14851, 15474, 16641, 17721, 19617, 21296, 21486, 22014]","[0, 241, 694, 1131, 1492, 1818, 2135, 2481, 2970, 3853, 4383, 5123, 5324, 5900, 6088, 6385, 6738, 7321, 8198, 8897, 9487, 10303, 11624, 11829, 12809, 12903, 13482, 13806, 14375, 15927, 16641, 17355, 18461, 18765, 20161]","[0, 213, 303, 468, 662, 865, 1054, 1162, 1416, 1724, 1949, 2383, 2563, 2711, 3152, 3247, 3342, 3459, 3910, 4477, 4572, 4929, 5772, 6997, 7320, 7414, 7656, 8029, 8720, 9897, 10437, 11736, 12660, 13731, 14144]","[0, 170, 260, 380, 515, 605, 855, 945, 1197, 1591, 1816, 2094, 2481, 2748, 2897, 2992, 3179, 3273, 3834, 4236, 4551, 4726, 5303, 6056, 6504, 6598, 7082, 7683, 8099, 9135, 9556, 9766, 10691, 11015, 11968]",26324,22014,20161,14144,11968,-5582,-1648,-3344,-1389,-1965,-13928,35,dire
7597714703,72,69,81,112,136,"[0, 404, 703, 1199, 1524, 1893, 2508, 3004, 3597, 4430, 5227, 5918, 6621, 7259, 8117, 8793, 9596, 10776, 11855, 12254, 12771, 13572, 14886, 15516, 16788, 16883, 17297, 17622, 18603, 18699, 19360, 20379, 21224, 22031, 23619]","[0, 273, 721, 1067, 1522, 1947, 2765, 3203, 3781, 4406, 4668, 5060, 5490, 6105, 6565, 7078, 7645, 8161, 8792, 9612, 9967, 10561, 10966, 11504, 12331, 12585, 13345, 13863, 14210, 16571, 17609, 17784, 19019, 20462, 21579]","[0, 236, 445, 831, 1162, 1678, 1964, 2254, 2416, 3236, 3510, 3971, 4541, 4814, 5412, 5808, 6693, 7382, 8228, 8808, 9530, 10218, 11025, 11245, 11883, 11978, 13574, 14471, 14567, 15606, 16982, 17269, 17642, 18255, 18932]","[0, 198, 335, 474, 655, 792, 1211, 1301, 1481, 1661, 2002, 2823, 2967, 3116, 3298, 3833, 4464, 5305, 5554, 6159, 6361, 6844, 7213, 7447, 7802, 8035, 8984, 9079, 9897, 9993, 10148, 11274, 12447, 12547, 14155]","[0, 198, 288, 494, 584, 722, 812, 993, 1479, 1688, 1917, 2148, 2339, 2543, 2690, 2784, 2988, 3446, 3589, 4140, 4282, 4637, 4866, 5008, 5363, 5458, 5753, 5894, 5990, 6208, 6655, 7931, 8080, 8227, 9244]",23619,21579,18932,14155,9244,106,42,123,93,33,"[0, 349, 551, 954, 1322, 1913, 2239, 2561, 2992, 3623, 4038, 4699, 5185, 5752, 6701, 7244, 8232, 8752, 9415, 11525, 12644, 13163, 14085, 14430, 15973, 16372, 17517, 18488, 19807, 20628, 22111, 22666, 22937, 23723, 24850]","[0, 226, 610, 868, 1257, 1703, 1901, 2259, 2537, 2905, 3146, 3694, 3983, 4720, 5119, 5398, 5920, 6471, 7027, 8016, 8616, 8969, 9477, 10103, 10936, 11653, 12467, 13624, 14911, 16551, 17238, 19026, 19126, 19554, 19744]","[0, 192, 332, 422, 720, 854, 1167, 1305, 1654, 1947, 2415, 2588, 2939, 3503, 3955, 4622, 5077, 5172, 5519, 6238, 7001, 7265, 7631, 8398, 8919, 9636, 10293, 11072, 11635, 11977, 13560, 15171, 15846, 16506, 17642]","[0, 354, 527, 940, 1183, 1406, 1746, 2139, 2506, 2919, 3447, 3796, 4414, 4899, 5748, 6140, 6772, 7408, 8031, 8749, 9582, 10587, 11205, 11825, 13444, 14538, 14678, 15211, 16247, 16468, 17476, 18031, 18564, 18754, 19144]","[0, 460, 550, 687, 893, 1322, 1602, 1796, 2235, 2603, 2990, 3264, 3533, 3807, 4458, 4796, 5366, 5567, 6121, 6513, 6958, 7475, 8057, 8311, 9120, 9611, 10124, 10701, 11255, 11824, 12242, 13143, 13756, 13946, 14136]",24850,19744,17642,19144,14136,-1231,1835,1290,-4989,-4892,-7987,35,radiant
7598302418,21,19,53,96,100,"[0, 213, 574, 911, 1111, 1495, 2012, 2588, 3340, 4047, 4866, 5892, 6214, 6693, 7547, 9026, 9446, 10061, 10373, 12081, 12619, 12714, 13137, 13819, 14601, 15165, 15260, 15800, 16699, 18032, 19659, 20192, 20292, 21461, 22832]","[0, 242, 526, 935, 1347, 1606, 2105, 2829, 3596, 4022, 4366, 5005, 5312, 5638, 6497, 7069, 7725, 8148, 8529, 9520, 10228, 10834, 11680, 11959, 12631, 13123, 13264, 13929, 14533, 15323, 15943, 16316, 17001, 18575, 20028]","[0, 169, 476, 566, 656, 873, 1370, 1586, 1948, 2303, 2621, 3363, 3669, 3818, 4327, 4761, 5247, 5939, 6438, 7240, 8045, 8908, 9575, 9915, 10966, 12246, 12341, 13013, 13672, 14505, 14935, 15325, 15544, 16427, 17559]","[0, 169, 422, 666, 921, 1169, 1760, 2171, 2710, 2881, 3387, 3712, 4048, 4595, 4969, 5582, 6147, 6242, 6337, 6836, 7201, 7633, 8222, 9218, 9698, 9967, 11027, 11351, 11803, 12478, 12930, 13277, 13737, 15068, 15977]","[0, 169, 259, 394, 484, 623, 1035, 1359, 1494, 1711, 2186, 2516, 2606, 3026, 3475, 4063, 4319, 4948, 5081, 5422, 5662, 6070, 6402, 6890, 7527, 7739, 8076, 8282, 8569, 9067, 9346, 9446, 9604, 10568, 11143]",22832,20028,17559,15977,11143,25,10,123,129,20,"[0, 626, 918, 1291, 1633, 2033, 2645, 3081, 3616, 4050, 4653, 5089, 5635, 6126, 6859, 7594, 8171, 9262, 9879, 10427, 11307, 13155, 13789, 14616, 15244, 18597, 18854, 19590, 20951, 21047, 21748, 23583, 23870, 24124, 24224]","[0, 270, 579, 989, 1319, 1728, 2105, 2601, 3135, 3694, 4244, 4910, 5583, 6052, 6813, 7141, 7328, 7883, 8400, 9106, 9601, 10106, 10382, 11315, 11577, 12275, 13157, 13633, 14172, 14875, 16071, 17039, 17664, 17764, 18426]","[0, 234, 324, 682, 861, 1015, 1105, 1822, 2034, 2124, 2401, 2491, 2721, 2906, 3046, 3403, 3737, 3882, 4208, 4867, 5014, 5109, 5615, 6256, 6447, 8158, 8740, 8834, 9230, 9334, 10185, 11044, 11144, 12085, 12600]","[0, 254, 571, 900, 1244, 1564, 2044, 2378, 2699, 2965, 3100, 3383, 3681, 3944, 4341, 4436, 4610, 4962, 5827, 6105, 6822, 7021, 7362, 7922, 8302, 8843, 9878, 10257, 10434, 10787, 11258, 11960, 12304, 12566, 13049]","[0, 234, 324, 421, 556, 780, 882, 1315, 1479, 1746, 1881, 1971, 2587, 2772, 3046, 3289, 3703, 3986, 4278, 4641, 5189, 5792, 5887, 6099, 6193, 6495, 6775, 6943, 7315, 7602, 7908, 8098, 8206, 8721, 9136]",24224,18426,12600,13049,9136,-1392,1602,4959,2928,2007,10104,35,radiant
7598302507,70,49,96,123,20,"[0, 241, 490, 894, 1157, 1611, 2175, 2301, 2504, 2893, 3255, 3866, 4316, 4912, 5399, 5815, 6521, 7160, 7762, 8739, 10031, 11026, 12082, 12545, 13441, 14291, 14933, 16295, 16485, 17018, 17573, 18283, 18383, 18483, 19405]","[0, 287, 480, 570, 695, 914, 1206, 1378, 1782, 2100, 2529, 2752, 3238, 3961, 4213, 4980, 5580, 5939, 6218, 7100, 7394, 8068, 8856, 9228, 9804, 10523, 10942, 12890, 13583, 14078, 14265, 14978, 15224, 15648, 16023]","[0, 243, 525, 813, 976, 1224, 1431, 1819, 2165, 2703, 3291, 3593, 4183, 5065, 5799, 6289, 6730, 6936, 7467, 7755, 8500, 8646, 9378, 9803, 10063, 10682, 10777, 12746, 13558, 14030, 14271, 14791, 14961, 15321, 15786]","[0, 170, 260, 401, 491, 702, 837, 1046, 1265, 1369, 1504, 1754, 2342, 2680, 2884, 3209, 3473, 3568, 3937, 4264, 4766, 5040, 5559, 6400, 6700, 6932, 7245, 8788, 9489, 10077, 10723, 11172, 11950, 12583, 13180]","[0, 219, 309, 483, 573, 737, 872, 996, 1086, 1356, 1566, 1921, 2194, 2528, 2719, 2893, 3363, 3664, 3852, 4179, 4815, 4910, 5236, 5418, 5628, 5832, 6129, 7417, 7600, 7696, 7829, 8270, 8406, 8664, 8899]",19405,16023,15786,13180,8899,18,59,69,105,26,"[292, 534, 841, 1191, 1527, 1799, 2435, 2894, 3337, 4001, 4767, 5319, 5880, 6827, 7592, 8353, 8950, 9828, 10845, 11743, 12686, 13347, 14185, 14524, 15341, 16210, 16751, 17154, 17617, 18584, 19408, 20259, 22257, 22753, 23747]","[159, 451, 852, 1304, 1687, 2141, 2785, 3265, 3738, 4274, 5009, 5403, 6155, 6746, 7647, 8449, 9283, 10542, 11317, 12198, 12352, 12636, 13287, 13973, 15018, 15958, 16610, 17551, 17790, 18380, 18959, 19529, 20380, 20845, 21397]","[159, 415, 994, 1196, 1569, 2010, 2303, 3050, 3661, 4165, 4785, 5185, 5864, 6473, 6912, 7319, 7745, 8154, 8719, 9456, 9972, 10227, 10825, 11352, 12207, 13084, 14212, 15111, 15671, 16633, 16932, 17268, 18185, 18315, 18872]","[527, 697, 832, 968, 1103, 1228, 1432, 1719, 1855, 2063, 2316, 2565, 2912, 3638, 3782, 4184, 4892, 5433, 5591, 5979, 6438, 6584, 6981, 7076, 7305, 7664, 7998, 8826, 9401, 9879, 10178, 10356, 10611, 10752, 10942]","[292, 462, 659, 834, 972, 1157, 1301, 1625, 1849, 2197, 2496, 2653, 2872, 3411, 3673, 3992, 4176, 4778, 4936, 5233, 5441, 5655, 5911, 6081, 6534, 7105, 7448, 8037, 8535, 9325, 9496, 9670, 10255, 10465, 10847]",23747,21397,18872,10942,10847,-4342,-5374,-3086,2238,-1948,-12512,35,dire
7598355413,70,23,69,123,79,"[1, 282, 637, 952, 1361, 1773, 2370, 2809, 3108, 3415, 3646, 4229, 4749, 5859, 6330, 7100, 7726, 8815, 9542, 10315, 10985, 11080, 11655, 12398, 12902, 13827, 14524, 15399, 15747, 16954, 18076, 18176, 18729, 19788, 20273]","[1, 402, 695, 1185, 1681, 2013, 2182, 2477, 3097, 3749, 4267, 5226, 5837, 6544, 7076, 7243, 7783, 8086, 8624, 9133, 9527, 10100, 10729, 11066, 11333, 11849, 12216, 12618, 12977, 13183, 14412, 14905, 15413, 16148, 16573]","[1, 247, 405, 855, 1075, 1311, 1912, 2272, 2692, 2859, 3134, 3264, 3720, 4131, 4810, 5057, 5383, 5940, 6080, 6487, 6735, 7122, 8004, 8467, 8721, 9537, 10075, 11458, 11832, 11928, 12485, 13354, 13937, 14583, 14773]","[1, 171, 291, 500, 659, 789, 1134, 1270, 1360, 1633, 1984, 2123, 2361, 2802, 2897, 2992, 3499, 3699, 4206, 4971, 5352, 5618, 6449, 6675, 6790, 7639, 7800, 8202, 8402, 9053, 9721, 9821, 10005, 10219, 10720]","[1, 171, 291, 461, 597, 1042, 1262, 1665, 1769, 1859, 2402, 2492, 2708, 3265, 3499, 3744, 4195, 4493, 4676, 5281, 5686, 6013, 6470, 6810, 7019, 7417, 7678, 8155, 8664, 8835, 9840, 10071, 10230, 10330, 10639]",20273,16573,14773,10720,10639,21,97,40,96,85,"[1, 327, 657, 1031, 1629, 2141, 2404, 2880, 3372, 3791, 4491, 5034, 5633, 6180, 6702, 7906, 8702, 9010, 9716, 10252, 11187, 12138, 12467, 13086, 13972, 14527, 15330, 16929, 17865, 18404, 20216, 21120, 22045, 22874, 23584]","[1, 210, 571, 1102, 1521, 2038, 2412, 2917, 3540, 3903, 4185, 4466, 4916, 5156, 5420, 5713, 6168, 6812, 7702, 8389, 9463, 9946, 10625, 11063, 11892, 12094, 12705, 12800, 13372, 14075, 14171, 15009, 16369, 17277, 17838]","[1, 244, 574, 751, 999, 1410, 1839, 2027, 2411, 3004, 3336, 3879, 4085, 4179, 4519, 5394, 6040, 6637, 7533, 8128, 8994, 9411, 9859, 10287, 10766, 11220, 11315, 12069, 13124, 13767, 13863, 14245, 15491, 16012, 16196]","[1, 171, 261, 387, 524, 722, 961, 1051, 1305, 1495, 2180, 2669, 2924, 3194, 3632, 4074, 4644, 5249, 5832, 6053, 6522, 7186, 7410, 8214, 8398, 8944, 9039, 9345, 9603, 9787, 9883, 10715, 11116, 12040, 12443]","[1, 510, 600, 735, 1003, 1217, 1402, 1538, 1797, 1887, 2245, 2810, 2949, 3043, 3292, 3851, 4281, 4464, 4932, 5281, 6085, 6180, 6347, 6442, 6626, 6793, 6888, 7252, 7555, 7651, 7747, 7990, 8530, 8720, 8883]",23584,17838,16196,12443,8883,-3311,-1265,-1423,-1723,1756,-5966,35,radiant
7599121510,19,10,98,26,83,"[0, 370, 698, 1106, 1525, 1972, 2420, 2995, 3385, 3976, 4414, 5075, 5552, 6373, 6540, 7217, 8271, 9315, 9802, 10530, 11181, 11740, 13322, 13945, 14414, 15063, 15984, 16557, 17486, 17582, 18222, 20254, 21615, 23229, 24055]","[0, 242, 555, 885, 1295, 1679, 1927, 2697, 2898, 3310, 3595, 4052, 4612, 5124, 5641, 6154, 7468, 8220, 9259, 10417, 10794, 11291, 12315, 13111, 13767, 14540, 14957, 15052, 15662, 15975, 16121, 18768, 20093, 20474, 20664]","[0, 329, 689, 1013, 1395, 1722, 2304, 2498, 2662, 3088, 3375, 4031, 4727, 5349, 5443, 6353, 7007, 7598, 8023, 9298, 9620, 10620, 11294, 11693, 12875, 13387, 13619, 14243, 14975, 15896, 16153, 17006, 17676, 18057, 18430]","[0, 382, 472, 562, 697, 831, 1093, 1216, 1306, 1519, 1609, 1973, 2201, 2841, 3016, 3373, 3972, 4305, 4637, 5234, 5624, 6260, 6699, 6892, 7062, 7417, 7587, 8326, 8461, 8813, 9070, 9811, 10481, 10673, 10984]","[0, 170, 260, 394, 586, 951, 1131, 1528, 1662, 1886, 2013, 2150, 2400, 3075, 3301, 3654, 4639, 4852, 5398, 6013, 6189, 6513, 6750, 7040, 7363, 7662, 7757, 8160, 8445, 8748, 9005, 10154, 10824, 10924, 11114]",24055,20664,18430,10984,11114,46,11,14,30,5,"[0, 281, 686, 825, 1445, 1842, 2084, 2664, 3314, 3543, 4277, 4616, 5154, 5864, 6481, 7142, 7919, 8645, 9258, 9891, 11132, 12509, 12987, 13842, 14581, 15642, 16532, 18101, 19677, 20177, 21525, 21625, 21908, 22857, 23814]","[0, 414, 895, 1264, 1799, 2232, 2743, 3408, 4154, 4415, 5108, 5727, 6387, 7064, 8243, 8819, 9167, 9461, 9718, 10674, 11420, 12120, 12499, 13183, 14310, 15347, 16831, 18723, 20130, 20581, 21687, 21840, 22072, 23775, 25078]","[0, 241, 526, 786, 1210, 1740, 2101, 2486, 3007, 3553, 4198, 4847, 5360, 5920, 6791, 7006, 7482, 7749, 8250, 8913, 9171, 9858, 10163, 11128, 11295, 12224, 12786, 13518, 14046, 14508, 15137, 16113, 17062, 18105, 18295]","[0, 170, 296, 434, 818, 1176, 1311, 1539, 1911, 2111, 2980, 3070, 3398, 3637, 3879, 4275, 4472, 4566, 4661, 5145, 5710, 6360, 6672, 7456, 7829, 8098, 8768, 9454, 10406, 10969, 11460, 11876, 12311, 14367, 14923]","[0, 510, 649, 862, 1339, 1508, 1643, 2120, 2255, 2382, 2607, 2885, 3155, 3351, 3499, 3752, 3994, 4124, 4219, 4519, 4826, 5390, 5587, 5762, 5977, 6374, 6636, 7164, 7951, 8182, 8498, 8674, 8906, 9999, 10189]",23814,25078,18295,14923,10189,241,-4414,135,-3939,925,-7052,35,dire
7600037606,4,129,126,31,27,"[0, 287, 666, 1028, 1313, 1533, 1794, 2239, 2526, 3291, 3771, 4161, 4730, 5238, 5709, 6577, 7596, 8514, 9382, 10283, 11038, 12222, 13039, 14012, 14836, 15340, 16097, 16297, 16447, 17323, 17840, 18230, 18788, 19745, 20405]","[0, 217, 739, 967, 1410, 1609, 2030, 2542, 2833, 3250, 3826, 4502, 5030, 5472, 6210, 6668, 7176, 7437, 7705, 8551, 9223, 9538, 10456, 11260, 11895, 12742, 13208, 13621, 14195, 14439, 15046, 15794, 16167, 16840, 17730]","[0, 362, 565, 788, 1202, 1488, 1945, 2523, 2905, 3571, 3751, 4395, 4700, 5489, 6128, 6623, 6922, 7297, 7630, 8180, 8678, 8773, 9271, 9920, 10208, 10530, 10760, 10960, 11273, 11706, 12374, 12880, 13621, 14153, 14630]","[0, 169, 329, 419, 509, 600, 739, 930, 1020, 1349, 1529, 1854, 2348, 2443, 2678, 2911, 3276, 3481, 3793, 4380, 4518, 4688, 5341, 6018, 6222, 6574, 6879, 7154, 7542, 8009, 8246, 8789, 9191, 9595, 9860]","[0, 169, 326, 416, 599, 689, 824, 1049, 1139, 1383, 1563, 1861, 2187, 2282, 2517, 3028, 3347, 3500, 3925, 4285, 4427, 4522, 4914, 5008, 5103, 5951, 6181, 6275, 6371, 6548, 6644, 7198, 7335, 7435, 7625]",20405,17730,14630,9860,7625,34,41,96,110,86,"[0, 243, 583, 967, 1251, 1511, 2013, 2257, 2664, 3024, 3759, 4010, 4315, 5173, 5894, 6464, 6841, 7291, 7483, 7819, 8155, 8400, 8741, 8835, 9553, 10485, 11194, 12389, 12663, 13196, 13925, 14920, 16318, 17214, 17920]","[0, 207, 493, 829, 1188, 1508, 1666, 2063, 2465, 2748, 3199, 3435, 4017, 4525, 5277, 5936, 6589, 7183, 7778, 8278, 9075, 9642, 10013, 10894, 11510, 12275, 12786, 14136, 14595, 15087, 15504, 16352, 17412, 18181, 18959]","[0, 207, 861, 1138, 1637, 2002, 2324, 2632, 3261, 3657, 4106, 4600, 5400, 6044, 6398, 7529, 8278, 8856, 9286, 9707, 10137, 10700, 11373, 11467, 11562, 11833, 11967, 13394, 13632, 13820, 14244, 14941, 15767, 16260, 16698]","[0, 169, 259, 426, 574, 710, 848, 938, 1073, 1236, 1581, 1671, 1846, 2088, 2731, 3054, 3376, 3832, 4265, 4748, 5092, 5314, 5501, 5888, 6271, 6456, 6760, 7734, 7914, 8204, 8300, 9247, 9790, 10098, 10372]","[0, 169, 336, 426, 652, 795, 885, 975, 1284, 1447, 1898, 2032, 2675, 3136, 3676, 3999, 4367, 4618, 4767, 5274, 5369, 5464, 5651, 5745, 6232, 6417, 6750, 7632, 8023, 8519, 8829, 9292, 9752, 10188, 10398]",17920,18959,16698,10372,10398,2485,-1229,-2068,-512,-2773,-4097,35,radiant
7600161008,114,60,21,14,86,"[0, 344, 635, 1087, 1466, 2271, 2659, 3204, 3712, 4399, 4799, 5228, 5318, 5645, 5794, 6216, 7025, 7712, 8350, 9234, 10106, 11222, 11977, 12855, 13209, 13304, 13560, 13861, 14500, 16066, 16272, 17079, 17437, 17935, 18715]","[0, 297, 499, 881, 1078, 1208, 1459, 1981, 2545, 3042, 3711, 4104, 4581, 5081, 5573, 5939, 6235, 6786, 7969, 8490, 9230, 9729, 10110, 10784, 11017, 11339, 11912, 12337, 12920, 14263, 15190, 15673, 16394, 17042, 18421]","[0, 382, 717, 1053, 1414, 1664, 1913, 2468, 3099, 3562, 3950, 4150, 4502, 5227, 5893, 6284, 7045, 7626, 8963, 9322, 10086, 10550, 11365, 12319, 12975, 13706, 14172, 15052, 15663, 17127, 18186, 18978, 19335, 19737, 20186]","[0, 260, 350, 440, 916, 1046, 1469, 1884, 2051, 2190, 2540, 2911, 3145, 3472, 3621, 3716, 4062, 4416, 5194, 5431, 6190, 6357, 6733, 7059, 7153, 7248, 7647, 7946, 8123, 8698, 9323, 9737, 10408, 10508, 10914]","[0, 260, 394, 484, 574, 704, 847, 1090, 1304, 1495, 2183, 2343, 2739, 3005, 3227, 3361, 3518, 3911, 4513, 4974, 5216, 5383, 5692, 5969, 6063, 6158, 6253, 6402, 6746, 7548, 7905, 8095, 8195, 8672, 9742]",18715,18421,20186,10914,9742,18,97,69,58,45,"[0, 167, 538, 628, 996, 1309, 1694, 1998, 2498, 2862, 3295, 4068, 4565, 5362, 6629, 7180, 8278, 9069, 9254, 10595, 11143, 11238, 12127, 12665, 13718, 14519, 15942, 16642, 17808, 18699, 19045, 19662, 20882, 22118, 22963]","[0, 239, 486, 664, 862, 952, 1215, 1395, 1802, 2025, 2901, 3289, 3774, 4076, 4955, 5190, 5750, 5930, 6554, 6904, 7091, 7186, 7661, 8333, 8892, 9270, 9968, 10498, 11220, 11731, 11827, 12373, 13022, 13722, 13912]","[0, 164, 437, 688, 969, 1377, 1768, 1963, 2188, 2397, 2874, 3423, 3646, 3870, 4349, 4856, 5696, 6228, 6413, 7322, 7658, 7753, 7953, 8452, 8973, 9251, 10097, 10625, 10958, 11905, 12255, 12605, 13063, 13625, 13975]","[0, 130, 220, 438, 830, 1026, 1929, 2154, 2262, 2393, 2501, 2785, 2929, 3302, 3753, 4094, 4476, 4632, 4977, 5338, 5634, 5811, 6293, 6835, 7246, 7464, 8180, 8605, 9034, 9479, 9575, 9800, 10336, 10789, 10979]","[0, 130, 220, 316, 453, 627, 798, 1288, 1378, 1591, 1932, 2177, 2321, 2461, 3146, 3241, 3991, 4173, 4756, 5297, 5567, 5662, 5757, 6007, 6368, 6685, 6890, 7176, 7512, 7975, 8071, 8451, 8894, 9264, 9454]",22963,13912,13975,10979,9454,-4248,4509,6211,-65,288,6695,35,radiant
7600393009,48,22,129,30,84,"[0, 294, 555, 895, 1300, 1532, 1798, 2941, 3340, 3805, 4452, 5020, 5769, 6573, 7452, 8290, 9169, 9263, 10419, 11354, 11624, 13112, 13594, 14252, 15303, 16350, 16445, 18095, 19186, 19282, 20278, 20378, 21626, 22285, 22385]","[0, 253, 585, 1009, 1384, 1801, 2543, 3142, 3825, 4464, 5132, 5627, 6522, 7039, 7764, 8495, 9170, 9742, 9990, 10922, 11592, 12105, 12686, 13244, 13626, 14406, 14699, 15296, 16256, 16953, 18305, 18913, 19897, 21410, 22217]","[0, 212, 758, 1063, 1374, 1843, 2203, 2821, 3151, 3503, 3873, 4263, 5004, 5471, 6030, 6866, 7700, 8295, 9167, 9621, 9716, 10281, 11120, 11675, 12017, 13017, 13310, 14415, 14875, 14971, 15684, 16348, 17303, 17735, 17835]","[0, 130, 297, 387, 477, 801, 891, 1111, 1292, 1636, 1869, 1997, 2321, 2551, 2905, 3250, 4090, 4388, 5519, 6084, 7109, 7877, 8372, 8822, 9171, 9397, 9959, 10243, 10932, 11232, 11924, 12602, 13726, 14137, 14237]","[0, 130, 220, 395, 531, 621, 757, 1168, 1343, 1496, 1977, 2188, 3043, 3224, 3480, 3867, 4474, 4912, 5534, 6105, 6788, 7429, 7524, 7824, 8077, 8171, 8504, 10011, 10477, 10733, 11148, 11248, 11709, 11899, 11999]",22385,22217,17835,14237,11999,1,39,38,123,83,"[0, 293, 619, 1267, 1635, 2044, 2323, 2817, 3142, 3737, 4386, 4952, 5351, 5749, 6811, 7482, 8437, 9504, 10308, 11447, 12172, 12818, 14205, 14891, 16176, 16911, 19131, 20171, 21789, 22729, 23967, 26017, 26916, 28960, 30983]","[0, 405, 696, 893, 1269, 1646, 2084, 2627, 3014, 3600, 4184, 4712, 5066, 5817, 6550, 7131, 7274, 8187, 9037, 9982, 10602, 11896, 12975, 13574, 15053, 15554, 16518, 17124, 17645, 18339, 19753, 20943, 22116, 23577, 25334]","[0, 247, 495, 788, 1187, 1672, 1909, 2330, 2543, 2943, 3292, 3419, 3550, 4558, 5260, 5673, 6710, 8161, 8594, 8991, 9483, 9792, 10550, 11133, 11698, 12620, 13068, 13544, 14326, 14680, 14776, 15369, 15706, 15806, 17126]","[0, 210, 339, 473, 635, 806, 1080, 1344, 1584, 1674, 1975, 2065, 2236, 2501, 2893, 3157, 3568, 4039, 4390, 4693, 5450, 6105, 6505, 6600, 7818, 8530, 9243, 9700, 9977, 10222, 10864, 11418, 11866, 11966, 13327]","[0, 210, 406, 607, 777, 948, 1300, 1525, 1661, 2014, 2343, 2518, 2780, 3045, 3355, 3582, 4080, 4476, 5064, 5323, 5526, 5919, 6319, 6414, 7307, 8132, 9448, 9543, 10245, 10476, 10572, 11099, 11243, 12053, 13308]",30983,25334,17126,13327,13308,-8598,-3117,709,910,-1309,-11405,35,dire
7600480014,48,120,97,86,79,"[0, 243, 640, 1021, 1347, 1751, 2169, 2652, 3156, 3767, 4329, 5046, 5436, 6512, 7277, 8088, 8793, 9923, 10346, 10756, 11789, 12361, 12836, 12931, 13516, 14153, 14247, 15252, 16122, 16946, 18204, 18304, 19870, 20769, 21401]","[0, 204, 535, 824, 1285, 1658, 2202, 2547, 3087, 3496, 3764, 4293, 4639, 5008, 5595, 5920, 6383, 7425, 8008, 8557, 9880, 10308, 10716, 11537, 12476, 13380, 14156, 14810, 15398, 15948, 16620, 16720, 17759, 18582, 19219]","[0, 252, 602, 886, 1213, 1541, 2016, 2536, 3147, 3397, 3790, 4403, 4648, 5245, 5867, 6266, 6466, 7369, 7749, 8409, 8504, 9357, 9451, 9943, 10287, 10942, 11036, 11592, 11769, 11913, 12900, 13000, 13873, 14156, 14382]","[0, 170, 655, 766, 901, 1108, 1322, 1452, 1715, 1972, 2107, 2327, 2417, 2814, 2995, 3539, 3761, 4518, 4880, 5471, 5928, 6023, 6117, 6483, 6617, 7071, 7368, 7555, 7787, 7883, 8555, 8822, 9329, 9570, 9760]","[0, 170, 260, 394, 484, 841, 1025, 1204, 1385, 1503, 1691, 2105, 2516, 2956, 3180, 3385, 3675, 4220, 4343, 4437, 4578, 4754, 5035, 5322, 5417, 5818, 5912, 6284, 6591, 6687, 7666, 7766, 7956, 8056, 8246]",21401,19219,14382,9760,8246,106,93,23,123,105,"[0, 279, 562, 918, 1289, 1613, 1864, 2368, 2698, 3190, 3575, 4122, 4644, 5206, 5772, 6314, 7062, 7405, 8033, 8481, 9242, 10073, 10696, 10992, 11622, 12369, 14088, 14623, 14759, 15106, 16406, 17902, 18208, 18911, 19712]","[0, 323, 533, 889, 979, 1464, 1712, 2018, 2277, 2778, 3290, 3856, 4418, 5207, 5697, 6363, 7426, 7725, 8607, 9101, 9577, 10666, 11391, 12573, 13536, 14127, 14512, 15503, 16349, 17154, 17961, 18151, 19282, 20207, 21297]","[0, 209, 616, 895, 1263, 1393, 1959, 2410, 2908, 3616, 4245, 4805, 5828, 6465, 6966, 7165, 8054, 8315, 9187, 9624, 10034, 10775, 11487, 12005, 12770, 13466, 14366, 15218, 15841, 16485, 16940, 17314, 18419, 18987, 19912]","[0, 270, 573, 663, 821, 1027, 1403, 1586, 1676, 1961, 2119, 2586, 3072, 3311, 3488, 3843, 4510, 4814, 5225, 5764, 6009, 6651, 7058, 7803, 8535, 8952, 10133, 10518, 10910, 11735, 12054, 12617, 13208, 13939, 14470]","[0, 170, 311, 425, 515, 645, 851, 1457, 1580, 1948, 2083, 2390, 3011, 3498, 3935, 4255, 4725, 4904, 5575, 6034, 6411, 7003, 7316, 7687, 8251, 8582, 9217, 9754, 9925, 10334, 11368, 12222, 12563, 12848, 13113]",19712,21297,19912,14470,13113,1689,-2078,-5530,-4710,-4867,-15496,35,dire
7600548215,19,48,98,66,5,"[0, 252, 522, 845, 1250, 1660, 2039, 2669, 2992, 3530, 4117, 4442, 4719, 5258, 5643, 6112, 6542, 7264, 7359, 8194, 9675, 10460, 12103, 12407, 13260, 13846, 14594, 15737, 15941, 17313, 18658, 18953, 19053, 20118, 22066]","[0, 208, 489, 816, 1109, 1280, 1562, 2494, 2940, 3239, 3617, 3881, 4260, 4636, 5182, 5500, 6502, 7134, 7868, 8518, 10078, 10895, 11766, 12731, 13448, 14656, 15827, 16230, 16847, 18081, 18903, 19671, 20376, 21622, 22056]","[0, 206, 588, 1294, 1593, 2058, 2471, 3123, 3379, 3625, 5136, 5599, 6213, 6819, 7121, 7216, 8193, 8492, 9019, 9114, 11181, 11845, 12912, 13345, 14391, 14989, 15569, 15951, 16079, 16394, 16952, 17141, 18285, 19248, 19936]","[0, 170, 260, 434, 585, 904, 1172, 1574, 1895, 2161, 2569, 2994, 3460, 3609, 3743, 3901, 4291, 4707, 4865, 5539, 6829, 7461, 7882, 8151, 9120, 9783, 10162, 11053, 11186, 11282, 11765, 12000, 12408, 12997, 13700]","[0, 170, 347, 839, 979, 1107, 1197, 1369, 1663, 1802, 2183, 2360, 2782, 4089, 4436, 4531, 5945, 6040, 6135, 7159, 7728, 8814, 9512, 9816, 10451, 10960, 11055, 11239, 11335, 11544, 12100, 12374, 12474, 12843, 13260]",22066,22056,19936,13700,13260,90,69,93,20,26,"[56, 237, 396, 778, 1113, 1552, 2033, 2622, 3129, 3779, 4473, 5593, 7105, 7728, 8445, 9285, 10570, 11541, 12692, 13589, 13683, 14474, 15429, 16190, 17056, 18506, 19156, 19466, 21148, 21973, 22278, 23775, 24553, 25725, 27487]","[56, 146, 351, 575, 902, 1194, 1715, 2037, 2177, 2831, 3159, 3672, 4792, 5200, 6044, 6702, 7042, 7923, 8605, 9107, 9223, 9862, 10566, 11014, 12115, 13349, 14069, 14588, 15731, 16654, 16856, 18581, 19730, 20955, 21570]","[56, 219, 849, 1249, 1696, 2270, 2798, 3047, 3816, 4632, 5284, 5758, 6858, 7077, 7839, 8324, 9152, 9639, 10697, 11098, 11192, 11756, 12201, 12721, 12816, 13229, 13529, 13813, 14694, 14925, 15330, 16901, 17682, 17782, 19139]","[56, 146, 507, 861, 1309, 1843, 2205, 2900, 3202, 3506, 3669, 3989, 4173, 4376, 4781, 5391, 5924, 6186, 6551, 6646, 6740, 6907, 7160, 7326, 7421, 8543, 8638, 8922, 9715, 9946, 10126, 11045, 11762, 12127, 12807]","[324, 414, 706, 875, 1119, 1471, 1606, 1819, 2036, 2288, 2580, 3290, 3551, 3754, 4147, 4341, 4740, 5039, 5597, 5840, 5934, 6116, 6398, 6564, 6659, 7267, 7362, 7971, 8148, 8431, 8577, 8917, 9663, 9988, 10088]",27487,21570,19139,12807,10088,-5421,486,797,893,3172,-73,35,radiant
7600575200,18,49,19,53,26,"[0, 260, 582, 906, 1399, 1857, 2380, 2835, 3386, 3963, 4534, 5196, 6068, 6713, 7359, 8049, 9066, 9978, 11704, 12675, 13539, 14588, 14822, 15258, 15352, 15745, 16595, 16753, 17040, 17136, 17610, 18743, 20722, 21946, 24340]","[0, 221, 471, 800, 1014, 1176, 1758, 2298, 2546, 3070, 3620, 3937, 4672, 5501, 5929, 6362, 7013, 7288, 7942, 8686, 9216, 9667, 10498, 10849, 11458, 11742, 12967, 13061, 13662, 14136, 14463, 15527, 16896, 17309, 18946]","[0, 240, 450, 774, 1073, 1394, 1725, 2052, 2427, 2812, 3100, 3663, 3948, 4237, 4460, 5009, 5575, 6142, 6481, 6893, 7185, 7513, 8013, 8382, 9524, 11040, 11907, 12001, 12831, 13091, 13681, 13950, 14817, 15678, 17142]","[0, 170, 260, 721, 855, 945, 1201, 1291, 1429, 1688, 1870, 2318, 2632, 3089, 3366, 3715, 4416, 4794, 5240, 5546, 6035, 6350, 6944, 7349, 8430, 9298, 9887, 10110, 10657, 10865, 11227, 11553, 13130, 13833, 15295]","[0, 170, 299, 389, 479, 569, 749, 839, 973, 1063, 1198, 1372, 1601, 2193, 2360, 2501, 3084, 3484, 3627, 4039, 4198, 4359, 4529, 4699, 5466, 6134, 6697, 7014, 7543, 7810, 8199, 8835, 10331, 10983, 12506]",24340,18946,17142,15295,12506,81,86,95,27,126,"[0, 206, 541, 960, 1249, 1699, 2141, 2676, 3331, 3893, 4363, 5265, 5826, 6433, 7001, 7861, 8728, 9827, 10136, 11191, 12170, 13355, 13978, 15197, 16174, 16595, 18153, 19281, 20719, 20815, 21889, 23666, 24690, 25602, 25702]","[0, 256, 646, 926, 1181, 1392, 1518, 1860, 2572, 2977, 3426, 3943, 4324, 4740, 5248, 5869, 6292, 7809, 8351, 8581, 10182, 11248, 11891, 12590, 13542, 13768, 14235, 15162, 17438, 17668, 18105, 18815, 19288, 19608, 19743]","[0, 329, 632, 887, 1329, 1750, 2187, 2412, 2930, 3323, 3857, 4198, 4509, 4984, 5317, 5910, 6483, 7076, 7809, 8108, 8814, 9500, 10637, 11323, 12052, 12541, 13124, 15246, 16864, 17493, 18387, 18687, 18922, 19242, 19725]","[0, 170, 260, 399, 540, 901, 1037, 1176, 1621, 1845, 1980, 2250, 2482, 2905, 3375, 3525, 3865, 4696, 4791, 5323, 5417, 5957, 6303, 6685, 7541, 7977, 8339, 8549, 9966, 10152, 10612, 10948, 11346, 11947, 12047]","[0, 170, 260, 398, 488, 706, 845, 1029, 1317, 1407, 1542, 1877, 2366, 2633, 2826, 2981, 3381, 3932, 4027, 4185, 4435, 4907, 5289, 6021, 6596, 6711, 7017, 8432, 9253, 9626, 9943, 11049, 11149, 11469, 11621]",25702,19743,19725,12047,11621,-1362,-797,-2583,3248,885,-609,35,radiant
7601831103,10,76,96,53,100,"[0, 239, 566, 844, 1128, 1530, 1735, 2282, 2849, 3591, 4023, 4741, 5483, 6039, 6454, 6820, 7735, 8297, 8713, 10640, 11397, 12847, 14018, 14562, 14974, 15250, 16381, 17321, 17747, 19278, 20305, 22782, 23271, 24737, 25584]","[0, 207, 455, 737, 991, 1403, 1727, 2135, 2350, 3308, 3555, 3788, 3950, 4614, 5350, 5653, 6366, 6803, 7122, 7571, 7942, 8299, 8803, 9061, 9543, 9768, 10714, 10809, 11981, 12511, 13393, 14263, 14993, 15632, 16959]","[0, 170, 368, 732, 1195, 1406, 1694, 2111, 2492, 2848, 3285, 3605, 3951, 4923, 5273, 5685, 6186, 6527, 6755, 7577, 7782, 8245, 9011, 9307, 9648, 10796, 11324, 11691, 12450, 13197, 13771, 14594, 14852, 15459, 16064]","[0, 170, 260, 394, 528, 864, 1226, 1449, 1539, 1752, 1842, 2074, 2369, 2765, 2984, 3235, 3456, 3751, 4136, 4934, 5115, 5828, 6213, 6673, 7702, 7797, 8542, 9366, 10363, 10630, 11700, 12155, 13058, 14101, 14962]","[0, 170, 260, 350, 478, 695, 785, 1066, 1156, 1381, 1471, 1561, 1785, 2144, 2363, 2494, 2803, 2898, 3160, 3691, 3965, 4305, 4543, 4638, 5171, 5677, 6177, 6772, 7237, 7718, 8330, 9036, 9249, 9610, 10150]",25584,16959,16064,14962,10150,48,137,43,123,21,"[0, 205, 748, 980, 1220, 1680, 2199, 2686, 3173, 3401, 3929, 4577, 5392, 5542, 6821, 7316, 8169, 9274, 10584, 11505, 12584, 13702, 14382, 15171, 16790, 17789, 18871, 20345, 20989, 21585, 22282, 23162, 23262, 23406, 24434]","[0, 243, 577, 919, 1196, 1532, 1843, 2595, 3233, 3622, 4136, 4423, 5563, 5771, 6420, 7383, 8069, 8421, 8830, 9694, 9862, 10207, 10471, 11115, 11514, 12585, 13168, 13467, 14112, 14571, 15031, 15574, 16195, 16341, 17301]","[0, 207, 467, 756, 1082, 1461, 1865, 2028, 2676, 2923, 3512, 3813, 4204, 4646, 5465, 6061, 6846, 7817, 8481, 8639, 9268, 9495, 9589, 10048, 11212, 12326, 12984, 13851, 14028, 14375, 14508, 14608, 15110, 15634, 16328]","[0, 170, 309, 399, 519, 920, 1089, 1507, 1940, 2157, 2842, 3001, 3502, 3870, 4701, 5125, 5793, 6058, 6214, 6930, 7428, 7926, 8020, 8428, 9637, 10097, 10576, 12046, 12563, 12882, 13265, 13365, 13850, 14058, 14796]","[0, 170, 319, 409, 575, 700, 1054, 1144, 1346, 1475, 1733, 1877, 2191, 2656, 3407, 3556, 3714, 4156, 4482, 4911, 5006, 5101, 5195, 5470, 6131, 6578, 6865, 7506, 8175, 8271, 8383, 8978, 9213, 9357, 9769]",24434,17301,16328,14796,9769,1150,-342,-264,166,381,1091,35,radiant
7602639202,14,95,39,86,85,"[0, 273, 622, 879, 1482, 1790, 2256, 2673, 3132, 3767, 4288, 4938, 5465, 6281, 6808, 7345, 7988, 8411, 9366, 9970, 10779, 11203, 11733, 11828, 12619, 14617, 15188, 15951, 17574, 18392, 19410, 19510, 21042, 21870, 22212]","[0, 599, 991, 1262, 1829, 2028, 2612, 2866, 3546, 3796, 4304, 4979, 5602, 6105, 6612, 6881, 7273, 8050, 8638, 9516, 10192, 11023, 11994, 12516, 13120, 13627, 14798, 16370, 17301, 18643, 19384, 19484, 21074, 21299, 21555]","[0, 219, 385, 747, 1111, 1411, 1670, 2386, 2635, 3177, 3909, 4691, 5593, 6074, 6539, 6833, 7322, 7895, 8196, 8878, 9213, 9857, 10511, 10606, 10701, 11485, 11988, 12360, 13148, 13975, 14237, 14554, 14654, 15166, 15315]","[0, 219, 357, 558, 696, 824, 959, 1094, 1232, 1456, 1767, 2627, 2826, 3327, 3670, 3980, 4466, 4917, 5459, 6011, 6446, 7155, 7629, 7855, 8098, 8465, 8598, 8975, 9397, 10082, 10178, 10513, 11659, 12070, 12316]","[0, 244, 334, 424, 671, 761, 1068, 1203, 1412, 1758, 2123, 2511, 2784, 2968, 3592, 3735, 3893, 4203, 4457, 5442, 5537, 5949, 6117, 6246, 6500, 7476, 7880, 8166, 8588, 9251, 9637, 9953, 10053, 10717, 10817]",22212,21555,15315,12316,10817,1,7,21,76,5,"[0, 328, 649, 977, 1434, 1919, 2427, 2870, 3294, 3648, 4448, 4941, 5443, 6075, 7073, 7872, 8778, 9715, 10378, 11350, 12368, 13896, 14871, 16111, 17717, 18562, 19637, 20296, 20828, 21113, 22506, 24609, 26135, 27407, 28864]","[0, 205, 495, 700, 1114, 1497, 1836, 2055, 2329, 2539, 2666, 2876, 3085, 3805, 3979, 4455, 5121, 5801, 6307, 7432, 8047, 8561, 9459, 10134, 10628, 10944, 11085, 11799, 12270, 13408, 15687, 16653, 16960, 17060, 18953]","[0, 332, 508, 693, 1035, 1434, 1609, 1955, 2045, 2974, 3401, 3832, 4163, 4644, 5284, 6694, 7476, 8266, 8765, 9138, 9853, 10500, 11316, 12015, 12627, 12722, 13104, 13556, 13733, 13829, 14605, 15872, 16762, 16862, 18199]","[0, 170, 260, 387, 517, 653, 743, 923, 1013, 1522, 1612, 1740, 1830, 2546, 2675, 3292, 3846, 4252, 4779, 4937, 5485, 5580, 6087, 6935, 7747, 7842, 7982, 8349, 8526, 8622, 9517, 10103, 10739, 11066, 11822]","[0, 170, 260, 398, 661, 751, 879, 1037, 1127, 1237, 1547, 1637, 1727, 1822, 2206, 2523, 2921, 3016, 3320, 3478, 3573, 3668, 4237, 4684, 5296, 5391, 5732, 6480, 6974, 7259, 7920, 8726, 9315, 9415, 10140]",28864,18953,18199,11822,10140,-6652,2602,-2884,494,677,-5763,35,dire
7602837205,10,49,136,91,101,"[0, 204, 565, 885, 1321, 1703, 1990, 2518, 2993, 3495, 4050, 4670, 5265, 5812, 6501, 7417, 8320, 8938, 9458, 10330, 10992, 12052, 12785, 13800, 15054, 15779, 17149, 17621, 18509, 19794, 21396, 21850, 23096, 23686, 24595]","[0, 303, 511, 976, 1390, 1874, 2318, 3043, 3641, 4119, 4555, 5320, 5879, 6113, 6622, 7355, 7919, 8331, 8425, 9079, 9309, 10340, 10638, 11217, 11885, 12483, 14360, 15006, 15299, 16170, 17068, 17731, 18826, 19246, 20124]","[0, 272, 436, 674, 1147, 1539, 2285, 2749, 3163, 3879, 4268, 4887, 5319, 5957, 6940, 7802, 8473, 9192, 9364, 9459, 9736, 10283, 10734, 11421, 11844, 12117, 13673, 14071, 14352, 15584, 16661, 16896, 17618, 17898, 18386]","[0, 199, 289, 379, 560, 650, 1237, 1474, 1628, 2284, 2544, 2647, 2821, 2993, 3431, 4103, 4489, 4757, 4851, 4946, 5176, 5483, 5649, 5744, 5953, 6425, 7159, 7426, 7679, 8095, 9180, 9415, 9734, 10014, 10294]","[0, 467, 557, 693, 1062, 1196, 1286, 1551, 1661, 1886, 2021, 2173, 2307, 2669, 3024, 3515, 3673, 3941, 4035, 4175, 4405, 4949, 5159, 5475, 5769, 5936, 6840, 7189, 7285, 7787, 8792, 9027, 9488, 9768, 10048]",24595,20124,18386,10294,10048,48,60,112,20,79,"[0, 248, 774, 934, 1185, 1469, 1635, 2002, 2343, 2946, 3419, 4072, 4753, 5325, 6088, 6861, 7600, 8333, 9131, 10598, 11523, 12502, 13466, 13944, 15523, 16443, 16943, 17038, 18494, 18962, 19058, 19404, 20729, 21928, 22521]","[0, 282, 580, 842, 1137, 1422, 1985, 2310, 2434, 2788, 3208, 3625, 4192, 4714, 5250, 5675, 6013, 6268, 7011, 7777, 8342, 8686, 9237, 9532, 10244, 10339, 11034, 11334, 12081, 12528, 13241, 13577, 14249, 15247, 15528]","[0, 325, 635, 926, 1285, 1488, 1837, 2083, 2536, 2804, 3518, 4114, 4465, 4810, 5493, 5737, 5956, 6331, 6888, 7675, 8254, 9054, 9313, 9727, 10171, 10599, 10785, 11316, 11858, 12181, 12498, 13443, 14136, 15079, 15453]","[0, 210, 397, 527, 851, 989, 1079, 1169, 1297, 1477, 1612, 1822, 1912, 2395, 2996, 3172, 3386, 3481, 4159, 4943, 5281, 5586, 6019, 6247, 6773, 7035, 7129, 7430, 8174, 8572, 8979, 9558, 9889, 10500, 10799]","[0, 210, 325, 415, 550, 686, 879, 969, 1059, 1278, 1550, 1760, 1898, 2302, 3095, 3316, 3749, 3844, 4143, 4636, 4999, 5295, 5888, 6233, 6642, 6908, 7075, 7336, 7594, 7804, 8188, 8692, 9023, 9890, 9990]",22521,15528,15453,10799,9990,2074,4596,2933,-505,58,9156,35,radiant
7602935601,76,120,104,138,100,"[0, 248, 462, 780, 1086, 1282, 1639, 1803, 2235, 2817, 3217, 3821, 4386, 4759, 5687, 6262, 6910, 7997, 8912, 9803, 10422, 11450, 12095, 13005, 13335, 13760, 14734, 15445, 15876, 16878, 17377, 18319, 18674, 19831, 20733]","[0, 282, 567, 903, 1031, 1284, 1992, 2301, 2609, 3218, 3773, 4362, 4949, 5701, 6151, 6886, 7738, 8258, 8719, 9182, 9730, 10760, 11307, 12506, 13035, 13950, 14621, 15512, 16106, 17480, 18145, 18768, 19550, 20375, 20804]","[0, 334, 606, 816, 1065, 1540, 1858, 2399, 2653, 3264, 3692, 4250, 4802, 5422, 6028, 6259, 7099, 7401, 7768, 8019, 8547, 8870, 9167, 9670, 10175, 10412, 10844, 11237, 11458, 11812, 12159, 13047, 13402, 13803, 14171]","[0, 210, 300, 426, 565, 731, 905, 1241, 1466, 1747, 1951, 2227, 2379, 2723, 3195, 3425, 4063, 4330, 4655, 5314, 6048, 6310, 6832, 7575, 8307, 8579, 9504, 10026, 10690, 11215, 11401, 12232, 12422, 13481, 14020]","[0, 210, 300, 436, 526, 958, 1093, 1183, 1573, 2208, 2382, 2658, 2748, 3016, 3471, 3656, 4006, 4277, 4699, 4948, 5270, 5607, 5915, 6443, 6848, 7018, 7482, 7733, 8237, 8927, 9252, 9757, 10646, 11301, 11777]",20733,20804,14171,14020,11777,12,35,20,123,40,"[0, 215, 532, 769, 1179, 1269, 1680, 1925, 2492, 2897, 3279, 3826, 4291, 5060, 5709, 6266, 7025, 7710, 8047, 8806, 9450, 10266, 10974, 11861, 12879, 13950, 15117, 16118, 16905, 17704, 18515, 19473, 19737, 20955, 21749]","[0, 210, 407, 656, 1041, 1303, 1677, 2153, 2961, 3455, 3856, 4280, 4819, 5021, 6145, 6613, 7484, 7578, 8357, 9010, 9368, 9463, 9630, 10375, 11412, 11875, 12075, 12565, 13172, 13305, 13447, 14677, 16232, 16905, 17738]","[0, 252, 448, 882, 1291, 1610, 2047, 2182, 2534, 3126, 3517, 3752, 4149, 4587, 4916, 5323, 5643, 5961, 6919, 7507, 7999, 8511, 9262, 9386, 10637, 11760, 12257, 12430, 12970, 13203, 13613, 14255, 14789, 15330, 15520]","[0, 130, 220, 401, 932, 1311, 1401, 1491, 1630, 1947, 2037, 2208, 2436, 2750, 3159, 3254, 3628, 4124, 4549, 5178, 5526, 5983, 6387, 6925, 8432, 9225, 9849, 10228, 11016, 11112, 11482, 12317, 13076, 14080, 14920]","[0, 130, 220, 310, 440, 530, 667, 757, 946, 1397, 1625, 1929, 2191, 2434, 2929, 3164, 3349, 3540, 3635, 4107, 4201, 4296, 4542, 4659, 5592, 6161, 6561, 6656, 7020, 7151, 7513, 8348, 8847, 9388, 9687]",21749,17738,15520,14920,9687,-1016,3066,-1349,-900,2090,1891,35,dire
7603672316,98,10,21,86,84,"[0, 207, 447, 1154, 1604, 2136, 2273, 3032, 3635, 4848, 5715, 5850, 6417, 7154, 7771, 8594, 9288, 9614, 10004, 10577, 11180, 11584, 12269, 12934, 13516, 13838, 14096, 14541, 15482, 16194, 16685, 17642, 18421, 18625, 19208]","[0, 248, 528, 819, 1180, 1465, 1963, 2592, 3052, 3559, 4219, 4445, 5074, 5554, 6197, 7446, 8095, 8821, 9586, 10234, 10955, 11696, 12710, 13430, 14174, 14687, 15067, 15332, 15653, 16316, 16562, 17021, 17634, 17734, 18588]","[0, 284, 445, 985, 1298, 1579, 2064, 2360, 2860, 3259, 3530, 3841, 4403, 4774, 5456, 5953, 6560, 7458, 7973, 8597, 9227, 9984, 10791, 11606, 12525, 12692, 13104, 13751, 14415, 14511, 15441, 15808, 16877, 16977, 17475]","[100, 270, 360, 450, 736, 1001, 1151, 1241, 1423, 1908, 2579, 2791, 3019, 3409, 3704, 4074, 4443, 4620, 4990, 5254, 5479, 5757, 5924, 6305, 6724, 7095, 7658, 8246, 8511, 8877, 8973, 9287, 10121, 10221, 10321]","[0, 170, 260, 396, 526, 616, 755, 995, 1130, 1493, 1894, 2304, 2582, 3042, 3489, 3993, 4151, 4328, 4509, 4603, 5054, 5249, 5601, 6052, 6295, 6704, 6905, 7142, 7283, 7379, 7529, 7839, 8350, 8474, 8775]",19208,18588,17475,10321,8775,109,52,69,20,90,"[0, 280, 544, 845, 1246, 1419, 1842, 2218, 2638, 3066, 3546, 3688, 4341, 5003, 5806, 6130, 6688, 7422, 8207, 9104, 9962, 11147, 12063, 12934, 13530, 14530, 15606, 17034, 17975, 19405, 20600, 21903, 22805, 25485, 27456]","[0, 256, 615, 1019, 1400, 1926, 2361, 2705, 3327, 4004, 4335, 4602, 5612, 6583, 7308, 7756, 8323, 8754, 9322, 9907, 10002, 10747, 11532, 12124, 12556, 13717, 14867, 16033, 17597, 18582, 19823, 20130, 21377, 22898, 24232]","[0, 209, 514, 708, 1148, 1631, 1833, 2069, 2409, 2813, 4057, 4340, 4752, 5220, 5654, 6231, 6574, 7123, 7911, 8293, 8548, 9241, 10000, 10670, 11202, 12129, 12889, 14020, 14699, 15089, 15649, 16232, 17188, 18265, 19353]","[0, 170, 674, 794, 1187, 1388, 1478, 1790, 1925, 2182, 2553, 2823, 2913, 3317, 3584, 3703, 3861, 3956, 4260, 4454, 4660, 5312, 5476, 5885, 6055, 6495, 6824, 7882, 8504, 8937, 9346, 9521, 10088, 10909, 11769]","[0, 170, 285, 405, 627, 804, 941, 1408, 1543, 1965, 2197, 2589, 2730, 3079, 3292, 3549, 3842, 4133, 4571, 4728, 4877, 5568, 5707, 6012, 6107, 6412, 7001, 7206, 7545, 7964, 8260, 8360, 8740, 9951, 10810]",27456,24232,19353,11769,10810,-8248,-5644,-1878,-1448,-2035,-19253,35,dire
7604869804,49,123,17,96,21,"[0, 205, 533, 1073, 1319, 1734, 1896, 2519, 2984, 3546, 4148, 4779, 5254, 5811, 6576, 7172, 7815, 8387, 9116, 9543, 10236, 10823, 11005, 11542, 12149, 12925, 13871, 14421, 14911, 15439, 16128, 16875, 17906, 18272, 19398]","[0, 565, 706, 796, 986, 1406, 1496, 1902, 2328, 2433, 2772, 3207, 3614, 4110, 4426, 4652, 4747, 5356, 5844, 6306, 7103, 7384, 7737, 8223, 8653, 9211, 10062, 10435, 11518, 12254, 12841, 14199, 15024, 15961, 17131]","[0, 288, 460, 744, 1046, 1452, 1702, 2100, 2526, 3073, 3804, 4416, 4843, 5437, 6011, 6644, 7333, 8053, 8484, 9074, 9735, 10368, 10463, 10964, 11532, 11857, 12656, 13070, 13517, 13950, 14046, 15345, 16531, 17040, 18228]","[0, 297, 457, 774, 1103, 1584, 1914, 2572, 2953, 3397, 4070, 4897, 5607, 6351, 6979, 7191, 7457, 7806, 8040, 8252, 8859, 9286, 9381, 10061, 10490, 10649, 11563, 12463, 13243, 13420, 13680, 14328, 14806, 15309, 16457]","[0, 430, 544, 988, 1078, 1209, 1333, 1519, 1970, 2136, 2584, 3271, 3514, 4041, 4625, 5120, 5305, 5527, 5768, 6460, 6668, 7049, 7144, 7518, 7875, 8221, 8631, 8874, 9228, 9599, 10037, 10457, 11256, 11567, 12889]",19398,17131,18228,16457,12889,138,22,19,79,91,"[0, 170, 377, 657, 1067, 1308, 1634, 2061, 2548, 2875, 3487, 4091, 4461, 4871, 5640, 6327, 6948, 7818, 8941, 9962, 10772, 11870, 13493, 14126, 14850, 15952, 17140, 17993, 19267, 20189, 21309, 22629, 23773, 24403, 25086]","[0, 280, 612, 1030, 1471, 1965, 2417, 2871, 3471, 3965, 4641, 4731, 5348, 5848, 6036, 7116, 7713, 8432, 9144, 10215, 10940, 11729, 12842, 13315, 14059, 14956, 15690, 16031, 16628, 17242, 17917, 18515, 19165, 19786, 20137]","[0, 325, 530, 656, 1365, 1723, 1902, 2037, 2467, 2727, 3204, 3333, 4180, 4520, 4616, 5060, 5630, 5933, 6525, 7208, 7365, 7772, 8582, 8958, 9508, 10810, 10905, 11269, 11708, 12421, 12961, 13383, 13529, 14216, 14654]","[0, 170, 260, 350, 515, 680, 1103, 1238, 1472, 1690, 1906, 2152, 2326, 2520, 2815, 3666, 4103, 4260, 4500, 5170, 5444, 5705, 6633, 6909, 7114, 7729, 8077, 8517, 8987, 9732, 10194, 10659, 10827, 10927, 11187]","[0, 170, 260, 350, 560, 725, 861, 1044, 1328, 1418, 1598, 1743, 1835, 1931, 2032, 2138, 2420, 2577, 2839, 3417, 3657, 3800, 4411, 4578, 4730, 5050, 5190, 5478, 5745, 5987, 6422, 6847, 7037, 7137, 7401]",25086,20137,14654,11187,7401,-5688,-3006,3574,5270,5488,5638,35,radiant
7604869900,12,13,98,9,26,"[0, 278, 549, 861, 1263, 1547, 2258, 2522, 3080, 3683, 4122, 4790, 5275, 5942, 6323, 6825, 7457, 8358, 9151, 9623, 10019, 10267, 11086, 11950, 12719, 13670, 14839, 15652, 16360, 17393, 18336, 19029, 19878, 21129, 21688]","[0, 284, 621, 1030, 1447, 1828, 2267, 2775, 3401, 3743, 4078, 4783, 5010, 5105, 5506, 6016, 6823, 7550, 8038, 8466, 9136, 9407, 9743, 10265, 10621, 11245, 11339, 11628, 12409, 12972, 14146, 14809, 15562, 17572, 18357]","[0, 206, 499, 1154, 1598, 2265, 2633, 3152, 3673, 4064, 4621, 5444, 6076, 6322, 6643, 7353, 7899, 8922, 9225, 9754, 10018, 10185, 10765, 11579, 12222, 13025, 13668, 13763, 14781, 15221, 15485, 16109, 16990, 17629, 18285]","[0, 220, 378, 503, 633, 772, 972, 1062, 1478, 1613, 2146, 2571, 2830, 3067, 3162, 3280, 3658, 4058, 4548, 4906, 5110, 5874, 6095, 6557, 6775, 7159, 7395, 7827, 8422, 8770, 9315, 9604, 10004, 11326, 11861]","[0, 169, 259, 441, 615, 872, 962, 1123, 1322, 1457, 1966, 2211, 2301, 2547, 2681, 2877, 3123, 3544, 3639, 3823, 3955, 4629, 4977, 5221, 5672, 5914, 6083, 6253, 6505, 6676, 7000, 7190, 7515, 8172, 8469]",21688,18357,18285,11861,8469,41,120,112,19,20,"[0, 242, 552, 1066, 1493, 1945, 2265, 2628, 2941, 3376, 3535, 3847, 4423, 5135, 5637, 6135, 6984, 7394, 7696, 8504, 9136, 10238, 11052, 11805, 12538, 13551, 14233, 15349, 15918, 16737, 17799, 18977, 19873, 19973, 20649]","[0, 316, 750, 1147, 1525, 1975, 2137, 2775, 3688, 4144, 4481, 5178, 5594, 6611, 7052, 7321, 8283, 8901, 9758, 10529, 11114, 11930, 12639, 13131, 13874, 14754, 15547, 15977, 16765, 17778, 18621, 19427, 20229, 20329, 20648]","[0, 169, 598, 866, 1198, 1439, 1649, 2077, 2406, 2713, 3066, 3585, 3992, 4441, 5027, 5382, 6182, 6277, 6935, 7746, 8432, 8527, 9285, 9694, 10161, 10966, 11520, 12186, 13175, 13720, 14174, 14471, 15165, 15594, 16126]","[0, 169, 301, 391, 521, 682, 790, 971, 1189, 1447, 1613, 1941, 2054, 2731, 2880, 3261, 3572, 3766, 4268, 4918, 5496, 6137, 6303, 6770, 7072, 7598, 8441, 8802, 8973, 10003, 10284, 10638, 11037, 11212, 11455]","[0, 169, 259, 464, 635, 995, 1085, 1175, 1709, 2282, 2493, 2722, 2812, 3308, 3457, 3649, 4121, 4216, 4452, 4945, 5331, 5972, 6138, 6422, 6971, 7355, 7869, 8159, 8332, 8729, 8980, 9376, 9701, 9801, 9985]",20649,20648,16126,11455,9985,1039,-2291,2159,406,-1516,-203,35,radiant
7604962313,98,19,41,45,83,"[0, 213, 501, 828, 1028, 1680, 2066, 2325, 3069, 3430, 3614, 4132, 4622, 5139, 5616, 6390, 7171, 7754, 8135, 8607, 8749, 9512, 10268, 10363, 10729, 11573, 11907, 12483, 13007, 13185, 13602, 13702, 14648, 15467, 16737]","[0, 325, 730, 1127, 1458, 1720, 1975, 2289, 2556, 3094, 3713, 4233, 4429, 4747, 5061, 5965, 6685, 7249, 7779, 8311, 8579, 8984, 9583, 9769, 10279, 10985, 11080, 11496, 12102, 12530, 13143, 13243, 13765, 14462, 14562]","[0, 212, 492, 690, 865, 1159, 1532, 1911, 2286, 3079, 4127, 4632, 5104, 5252, 5447, 6066, 6697, 7125, 7609, 8000, 8501, 9151, 9425, 10166, 10737, 11177, 11703, 12319, 12923, 13474, 13890, 14043, 15435, 15592, 17429]","[0, 130, 267, 451, 541, 860, 1246, 1336, 1655, 2188, 2684, 3050, 3263, 3658, 3753, 4028, 4593, 5337, 5952, 6342, 6486, 7297, 7638, 7733, 8065, 8249, 8435, 8723, 8981, 9077, 9434, 9659, 10571, 11558, 12526]","[0, 130, 220, 310, 400, 538, 673, 809, 1128, 1218, 1644, 1854, 1944, 2166, 2261, 2356, 2628, 3104, 3529, 4061, 4231, 4746, 4988, 5158, 5381, 5854, 6281, 6622, 6910, 7273, 7548, 7672, 8115, 8491, 9397]",16737,14562,17429,12526,9397,70,74,104,53,86,"[60, 385, 702, 1078, 1545, 1826, 2473, 3310, 3726, 4533, 5118, 5674, 6609, 7543, 8602, 8759, 9655, 10256, 10625, 11167, 11541, 12012, 13020, 14250, 14982, 16364, 17271, 18228, 19301, 20110, 21582, 23274, 23804, 24288, 26042]","[60, 390, 776, 1024, 1428, 1739, 2116, 2537, 3165, 3545, 3758, 3896, 4541, 5063, 5914, 6185, 6935, 7196, 7629, 8297, 8852, 9853, 10265, 10742, 11525, 12376, 12869, 13818, 14341, 15061, 16218, 17161, 18358, 19654, 20915]","[60, 345, 618, 814, 1402, 1920, 2524, 2747, 3280, 3406, 3934, 4097, 4699, 5793, 6310, 6678, 7182, 7276, 7994, 8285, 8754, 9080, 9667, 10160, 10714, 11937, 12543, 12921, 13098, 13376, 14250, 15496, 16012, 16960, 18124]","[328, 538, 658, 854, 1009, 1169, 1350, 1516, 1775, 1950, 2075, 2223, 2465, 3047, 3422, 3740, 4236, 4628, 4977, 5271, 6155, 6350, 7559, 7998, 8637, 9031, 9503, 9960, 10485, 10923, 12004, 13348, 14404, 14753, 16028]","[60, 270, 434, 568, 704, 1017, 1396, 1566, 1702, 1872, 1962, 2124, 2366, 3164, 3616, 3726, 4325, 4419, 4565, 4660, 5541, 5766, 6083, 6609, 6914, 7575, 7936, 8410, 8662, 8949, 9511, 10351, 10750, 11678, 12383]",26042,20915,18124,16028,12383,-9305,-6353,-695,-3502,-2986,-22841,35,dire
7605068005,10,23,136,57,20,"[0, 273, 470, 835, 1340, 1706, 2180, 2477, 2982, 3343, 3879, 4508, 5102, 5775, 6327, 7289, 8433, 9338, 9928, 11397, 12139, 12918, 13097, 13937, 14231, 14732, 15953, 17053, 18146, 18494, 18831, 19813, 20718, 22048, 22148]","[0, 374, 740, 1274, 1402, 1994, 2428, 2743, 3328, 3770, 4573, 5338, 5885, 6211, 6761, 6981, 7653, 8068, 8711, 9258, 9918, 10415, 10902, 11436, 11530, 11625, 11887, 12397, 12994, 13247, 13670, 14015, 14295, 14813, 15199]","[0, 251, 570, 815, 1157, 1527, 1768, 2172, 2357, 2634, 3053, 3324, 3896, 4189, 4580, 4918, 5872, 6292, 6751, 7577, 8207, 8302, 9161, 9370, 9464, 9583, 9825, 10093, 10687, 11342, 11438, 11748, 12028, 12128, 12470]","[0, 170, 260, 350, 489, 579, 669, 759, 1119, 1209, 1344, 1686, 2196, 2713, 3110, 3448, 3937, 4225, 4356, 4514, 4780, 4875, 5072, 5261, 5355, 5865, 5960, 6165, 6858, 7283, 7414, 7559, 7839, 7939, 8322]","[0, 170, 260, 350, 440, 578, 668, 758, 980, 1165, 1481, 1742, 1844, 2140, 2427, 2681, 3216, 3400, 3559, 4580, 4799, 4894, 5037, 5132, 5226, 5321, 5416, 5621, 5942, 6038, 6134, 6278, 6840, 7068, 7265]",22148,15199,12470,8322,7265,1,74,96,26,105,"[0, 257, 531, 946, 1076, 1609, 1966, 2448, 3037, 3582, 3920, 4516, 4803, 5372, 5907, 6920, 7817, 8525, 9351, 10356, 11520, 12707, 13717, 15114, 15531, 16845, 17872, 19386, 20180, 22190, 23495, 24797, 26058, 27290, 28851]","[0, 208, 528, 864, 1383, 1680, 2097, 2630, 2945, 3368, 3657, 4119, 4440, 4715, 5019, 5594, 6279, 6710, 7558, 7716, 8166, 9427, 9999, 10523, 10707, 11612, 11958, 12505, 12916, 14073, 14921, 15705, 16133, 17049, 17760]","[0, 504, 742, 1089, 1340, 1804, 2070, 2354, 2668, 3038, 3369, 3587, 4067, 4370, 4666, 5077, 5363, 6342, 6853, 7192, 7286, 7840, 8879, 9082, 9350, 10090, 10401, 11012, 11155, 11812, 12099, 12644, 13220, 14108, 14750]","[0, 288, 416, 506, 683, 888, 1023, 1177, 1267, 1402, 1539, 1629, 1883, 2371, 2504, 2901, 3149, 3333, 4137, 4295, 4446, 5284, 5562, 5978, 6218, 7026, 7337, 7542, 7927, 8023, 8491, 8787, 8977, 9533, 10049]","[0, 236, 326, 416, 546, 737, 872, 1101, 1191, 1382, 1520, 1610, 1771, 2402, 2497, 2787, 3213, 3598, 4369, 4775, 4869, 5011, 5385, 5588, 5772, 6124, 6435, 6674, 6818, 6914, 7573, 7783, 8157, 8453, 9214]",28851,17760,14750,10049,9214,-6703,-2561,-2280,-1727,-1949,-15220,35,dire
7605501015,1,98,19,40,88,"[0, 207, 480, 800, 1243, 1806, 2449, 2847, 3169, 3650, 4271, 4927, 5227, 5925, 6534, 7279, 8011, 8983, 9865, 10683, 11434, 11957, 12978, 13951, 15213, 16480, 17557, 18537, 19469, 20633, 22029, 22947, 24430, 25094, 26292]","[0, 329, 648, 936, 1347, 1939, 2157, 2842, 3113, 3759, 4775, 5009, 6105, 6894, 7090, 8059, 8767, 9514, 10618, 11376, 11835, 12543, 13385, 13988, 14667, 15908, 16284, 16887, 17064, 17685, 18944, 20027, 20889, 21311, 23280]","[0, 282, 532, 937, 1396, 1568, 2039, 2366, 2851, 3112, 3859, 4366, 4913, 5439, 5745, 5840, 6201, 6887, 7563, 7913, 8529, 8768, 9307, 9402, 10108, 10824, 11217, 11650, 12018, 12720, 13370, 13611, 14032, 14311, 16024]","[0, 170, 260, 394, 620, 792, 1165, 1340, 1505, 1678, 2486, 2720, 2810, 3048, 3296, 3660, 3925, 4462, 4793, 5029, 5363, 5602, 5916, 6165, 6620, 7395, 7667, 8082, 8438, 8719, 9299, 9694, 10023, 10646, 12080]","[0, 170, 304, 394, 571, 661, 815, 1159, 1549, 1686, 2027, 2747, 2950, 3250, 3345, 3935, 4214, 4432, 4711, 4869, 5292, 5431, 5670, 5809, 6075, 6340, 6693, 7786, 7963, 8169, 8515, 8996, 9143, 9287, 10119]",26292,23280,16024,12080,10119,17,41,104,65,20,"[0, 280, 605, 1052, 1502, 1968, 2135, 2305, 2881, 3090, 3664, 4607, 4973, 5613, 6139, 6351, 6701, 6904, 7576, 8064, 8393, 9317, 9979, 10129, 10791, 11296, 11743, 12267, 13071, 13654, 14560, 15429, 16200, 16943, 18207]","[0, 206, 497, 798, 1166, 1381, 1581, 1831, 2136, 2311, 2755, 3403, 3644, 4152, 4499, 5292, 5870, 6336, 6515, 7064, 7517, 8231, 8671, 9415, 9906, 10160, 10658, 11449, 12072, 12510, 12759, 13493, 14520, 15244, 15727]","[0, 244, 450, 687, 1363, 1492, 1997, 2348, 2807, 3217, 3605, 4090, 4951, 5519, 6032, 6618, 7338, 7960, 8427, 9254, 9527, 10137, 10484, 11400, 11825, 11919, 12106, 12373, 12729, 13001, 13708, 13808, 14227, 15184, 15667]","[0, 213, 303, 393, 591, 681, 898, 1500, 1916, 2051, 2229, 2570, 2741, 3056, 3541, 3753, 4186, 4403, 4669, 5050, 5350, 5525, 6179, 6595, 6976, 7228, 7839, 8074, 8819, 8915, 9164, 9639, 9867, 10437, 10920]","[0, 170, 260, 350, 525, 741, 914, 1306, 1521, 1656, 2065, 2344, 2581, 2935, 3366, 3578, 3828, 4082, 4350, 4790, 4934, 5221, 5316, 5613, 5833, 6085, 6227, 6463, 6710, 6843, 7313, 7525, 7715, 8080, 8180]",18207,15727,15667,10920,8180,8085,7553,357,1160,1939,19094,35,radiant
7605620914,114,90,97,19,20,"[0, 329, 586, 1020, 1382, 1557, 2141, 2486, 3349, 3732, 4197, 4542, 5045, 5676, 5975, 6603, 7023, 7577, 7779, 8355, 9215, 9584, 10273, 10929, 12121, 12650, 13581, 13912, 14922, 15957, 16910, 17697, 18459, 19304, 20178]","[0, 285, 652, 818, 1234, 1607, 2019, 2875, 3728, 4317, 4746, 5248, 5644, 5878, 6061, 6679, 7474, 7691, 8094, 8518, 8704, 9550, 9915, 10597, 11213, 11441, 12600, 13352, 13827, 14974, 15389, 15842, 16222, 17084, 17839]","[0, 240, 445, 804, 1160, 1660, 2083, 2322, 2631, 3142, 3624, 4307, 4798, 5234, 5764, 6056, 6346, 6651, 6746, 6840, 7038, 7431, 7869, 8304, 8611, 9157, 9290, 9384, 9843, 10143, 10367, 10799, 11047, 11492, 11674]","[0, 169, 259, 379, 519, 655, 792, 1078, 1388, 1659, 2056, 2200, 2336, 2485, 2969, 3371, 3675, 4110, 4249, 4739, 4928, 5671, 6345, 6439, 6559, 6654, 6986, 7234, 7821, 7917, 8216, 8406, 8822, 9151, 9251]","[0, 269, 359, 524, 663, 753, 921, 1235, 1625, 1715, 2119, 2263, 2500, 2649, 2744, 3036, 3279, 3374, 3574, 3668, 3808, 4140, 4307, 4401, 4532, 4627, 5265, 5625, 6175, 6271, 6367, 6606, 6979, 7399, 7499]",20178,17839,11674,9251,7499,38,93,137,66,86,"[0, 169, 454, 844, 1493, 1843, 2194, 2649, 3334, 3754, 4470, 5077, 5691, 6757, 7591, 8213, 9210, 10461, 11492, 12382, 13224, 14284, 14708, 15614, 16357, 17463, 18607, 19023, 19491, 20552, 21557, 22333, 22795, 23873, 24882]","[0, 246, 441, 736, 994, 1526, 1862, 2301, 2732, 3173, 3660, 4251, 4817, 5237, 5926, 6467, 7261, 7889, 8494, 9516, 10499, 11346, 12044, 12519, 13162, 14360, 15928, 16336, 16960, 17577, 17875, 18567, 18947, 19358, 20210]","[0, 284, 605, 1193, 1651, 2067, 2625, 3071, 3491, 4176, 4686, 4776, 5293, 5725, 6493, 6695, 7722, 8437, 9185, 9700, 10124, 10679, 11110, 12133, 13087, 13803, 14778, 15121, 15558, 16029, 16680, 17080, 17893, 18128, 18775]","[0, 220, 310, 445, 596, 850, 1052, 1268, 1523, 1855, 2251, 2712, 2978, 3271, 3682, 3946, 4437, 4721, 5087, 5491, 6192, 6787, 7008, 7429, 7843, 8541, 9158, 9305, 9641, 9889, 10165, 11092, 11937, 12361, 12726]","[0, 169, 295, 472, 676, 920, 1085, 1258, 1568, 1777, 2181, 2516, 2606, 2900, 3744, 4171, 4429, 4587, 5038, 5501, 5790, 6437, 7039, 7612, 7920, 8612, 9051, 9145, 9510, 9792, 10153, 10563, 11119, 11759, 12188]",24882,20210,18775,12726,12188,-4704,-2371,-7101,-3475,-4689,-22340,35,dire
7605720616,120,129,114,40,26,"[0, 326, 689, 1013, 1347, 1862, 2191, 2559, 3048, 3462, 3949, 4329, 4802, 5378, 5981, 6244, 6787, 7294, 8148, 9229, 9712, 10143, 10609, 10806, 11199, 12016, 12323, 13144, 13316, 13905, 14483, 14884, 15726, 16476, 17113]","[0, 284, 651, 1016, 1230, 1796, 2202, 2620, 3136, 3794, 4351, 4865, 5337, 6049, 6344, 6438, 7150, 7498, 7843, 8733, 9210, 9597, 10042, 10239, 10334, 10501, 11065, 12015, 12538, 13044, 13340, 13551, 15028, 15128, 15896]","[0, 289, 456, 828, 1234, 1474, 1740, 2226, 2586, 3071, 3466, 3835, 4140, 4943, 5274, 5719, 6662, 7424, 7685, 8342, 8914, 9610, 10120, 10317, 10597, 10764, 10978, 11787, 11986, 12321, 12517, 13143, 14147, 14513, 15338]","[0, 169, 259, 399, 489, 619, 831, 1398, 1488, 1681, 1816, 1953, 2043, 2346, 2514, 2608, 3141, 3326, 3451, 4227, 4515, 4668, 5154, 5595, 5794, 6380, 6761, 7484, 7655, 8043, 8480, 8684, 9993, 10226, 10722]","[0, 169, 259, 349, 524, 745, 835, 974, 1064, 1448, 1629, 1729, 1819, 2102, 2235, 2377, 3096, 3325, 3540, 3904, 4257, 4762, 5532, 5804, 5974, 6216, 6386, 6555, 6726, 7290, 7386, 7486, 7892, 8563, 8976]",17113,15896,15338,10722,8976,73,43,137,19,121,"[0, 330, 663, 1098, 1528, 1658, 2058, 2703, 3600, 3952, 4307, 4998, 5824, 6732, 7551, 7943, 8937, 10654, 11336, 11928, 12566, 13456, 14367, 15821, 17216, 18288, 19826, 21741, 23169, 23559, 24327, 24980, 26267, 27262, 27981]","[0, 203, 735, 1122, 1680, 2061, 2477, 2952, 3404, 4168, 4563, 5036, 6179, 6509, 7090, 7744, 7975, 8133, 9182, 9734, 10256, 10722, 11757, 13267, 13902, 14159, 14998, 16248, 16968, 17948, 18449, 19316, 19775, 19983, 20308]","[0, 333, 702, 1064, 1343, 1695, 2148, 2558, 3006, 3242, 3760, 4434, 5176, 5921, 6302, 6497, 6871, 7462, 7909, 8561, 9087, 9682, 9958, 11094, 11722, 12472, 13043, 14043, 14220, 14525, 15070, 15419, 16994, 17301, 17726]","[0, 169, 324, 414, 675, 765, 855, 1184, 1324, 1767, 1966, 2165, 2588, 2885, 3131, 3421, 3516, 3952, 4459, 4769, 5203, 5463, 5824, 6660, 7234, 7629, 8055, 8736, 9003, 9203, 10004, 10311, 11133, 11372, 11697]","[0, 169, 298, 501, 746, 853, 1051, 1445, 1585, 1725, 1859, 2003, 2401, 2837, 3026, 3221, 3316, 3942, 4205, 4417, 4798, 4992, 5306, 5879, 6049, 6753, 7258, 7709, 8020, 8429, 8825, 9071, 9912, 10164, 10489]",27981,20308,17726,11697,10489,-10868,-4412,-2388,-975,-1513,-20156,35,dire
7606260002,73,21,28,45,26,"[0, 366, 833, 1212, 1631, 2058, 2379, 3066, 3338, 3772, 4976, 5667, 6517, 7868, 8460, 9172, 9648, 11106, 12452, 12932, 13842, 14862, 15886, 16405, 17852, 18685, 19936, 21950, 23217, 24239, 25463, 26203, 26407, 26507, 28022]","[0, 260, 591, 1000, 1708, 2038, 2467, 2557, 3314, 4208, 4779, 5686, 6178, 6736, 7257, 7643, 8086, 8346, 9424, 9827, 10165, 10490, 11034, 11797, 12419, 13360, 13536, 14649, 15290, 15941, 16680, 17045, 17528, 18485, 18585]","[0, 369, 497, 972, 1319, 1611, 1990, 2151, 2432, 2649, 3085, 3669, 4016, 4662, 5158, 5572, 6139, 6365, 6710, 7180, 7671, 7818, 8048, 8376, 8686, 9617, 9991, 10417, 10594, 11005, 11511, 11746, 11950, 12565, 13325]","[0, 364, 454, 544, 681, 771, 1131, 1337, 1427, 1945, 2463, 2706, 3171, 3904, 4279, 4595, 4831, 5006, 5270, 5864, 6031, 6524, 7027, 7194, 7335, 7786, 8362, 8970, 9147, 9474, 10095, 10628, 10832, 11444, 11770]","[0, 210, 344, 434, 572, 708, 798, 937, 1340, 1677, 2204, 2702, 2888, 3138, 3415, 3817, 4199, 4632, 4922, 5283, 5432, 6287, 6742, 6924, 7018, 7713, 7889, 8258, 8481, 8621, 8876, 9066, 9496, 10557, 10657]",28022,18585,13325,11770,10657,98,15,106,65,83,"[0, 503, 830, 1131, 1452, 1652, 2019, 2487, 3053, 3600, 4069, 4691, 5136, 5816, 6259, 6750, 7468, 8475, 9111, 10536, 11092, 12477, 12806, 14066, 14953, 16029, 16737, 17891, 18698, 18985, 19346, 20019, 22085, 23358, 23548]","[0, 198, 420, 630, 765, 1002, 1328, 1577, 2048, 2471, 2852, 3268, 3433, 3863, 4225, 4541, 4848, 5875, 6263, 6786, 7762, 8313, 9212, 9885, 10359, 11666, 11853, 12410, 12506, 12769, 13084, 13638, 15124, 16452, 17031]","[0, 322, 572, 1034, 1159, 1531, 2019, 2614, 3345, 3509, 4136, 4646, 5029, 5473, 5622, 5858, 6296, 7269, 7534, 7813, 8253, 8761, 9708, 10350, 11337, 11504, 11934, 12573, 12983, 13549, 14574, 14993, 15513, 15881, 16071]","[0, 198, 288, 412, 825, 955, 1568, 1835, 1973, 2063, 2312, 2678, 2942, 3281, 3790, 4515, 4909, 5498, 5593, 6047, 6433, 7326, 7655, 8267, 8994, 9418, 9513, 9832, 10591, 11200, 11570, 11956, 13124, 13881, 14584]","[0, 198, 288, 423, 513, 643, 733, 880, 1288, 1421, 1654, 1834, 2054, 2317, 2601, 2696, 2853, 3187, 3282, 3592, 3749, 4364, 4740, 4962, 5360, 5799, 5952, 6733, 7040, 7217, 7313, 7503, 8247, 8602, 8792]",23548,17031,16071,14584,8792,4474,1554,-2746,-2814,1865,2333,35,dire
7606980009,67,36,20,53,105,"[0, 169, 575, 894, 1286, 1491, 1878, 2292, 2751, 3011, 3469, 3643, 4603, 5029, 5568, 6135, 6638, 6989, 7564, 7991, 9606, 10023, 11394, 12223, 12895, 13393, 14606, 15463, 16753, 17373, 17469, 17951, 18896, 19703, 20589]","[0, 165, 456, 775, 1022, 1146, 1307, 1561, 1651, 2248, 2447, 3154, 3904, 4211, 4931, 6282, 6961, 7741, 8050, 8145, 8615, 9122, 9841, 10316, 10457, 10949, 11472, 12076, 13038, 13440, 14086, 14479, 15079, 16463, 16852]","[0, 242, 549, 825, 1328, 1759, 1957, 2554, 2778, 3083, 3306, 3568, 4133, 4227, 5083, 5756, 5878, 6459, 6868, 7485, 8269, 8539, 9335, 9607, 9702, 10153, 10577, 10820, 11497, 11963, 12454, 13230, 13898, 14511, 15050]","[0, 130, 220, 465, 677, 811, 1150, 1471, 1605, 1695, 1868, 2292, 2644, 2821, 3453, 3829, 4086, 4281, 4905, 5000, 6267, 6537, 6796, 7027, 7663, 8075, 8605, 9282, 9869, 10004, 10100, 10223, 10628, 11113, 11382]","[0, 130, 586, 713, 1262, 1598, 1722, 2440, 2594, 2763, 2853, 2943, 3510, 3719, 4115, 4682, 4777, 4871, 5102, 5447, 6207, 6328, 6498, 6668, 6838, 7332, 7998, 8168, 9285, 9555, 9898, 10073, 10570, 11018, 11193]",20589,16852,15050,11382,11193,43,21,92,19,100,"[0, 374, 820, 1073, 1562, 2201, 2550, 3216, 4002, 4379, 4938, 5532, 5914, 6859, 7317, 7566, 8137, 9548, 10869, 11485, 11690, 12614, 12934, 13658, 14637, 15919, 16964, 17375, 17999, 18095, 18892, 19547, 20322, 20766, 21236]","[0, 267, 567, 783, 1069, 1159, 1625, 1817, 2466, 2889, 3772, 4202, 4852, 5634, 6405, 7001, 7783, 8596, 10015, 10407, 10612, 11044, 11557, 12739, 13757, 14289, 15590, 16196, 17256, 17352, 18277, 19168, 19501, 19641, 20461]","[0, 305, 593, 863, 1173, 1592, 1977, 2366, 2672, 3050, 3628, 4350, 5052, 5692, 6038, 6395, 7292, 7585, 8240, 9018, 9715, 10808, 11162, 11659, 12039, 12779, 13378, 13554, 13776, 14202, 14553, 15194, 16064, 16339, 17261]","[0, 246, 373, 463, 597, 807, 1027, 1117, 1333, 1778, 2158, 2649, 2778, 3095, 3319, 3753, 4576, 4900, 5657, 6016, 6221, 6682, 7141, 7864, 8450, 8802, 9527, 10081, 10258, 10451, 10819, 11242, 11773, 12601, 13217]","[0, 636, 1020, 1205, 1295, 1385, 2076, 2166, 2465, 2665, 3236, 3604, 3694, 4066, 4471, 4620, 5221, 5598, 6254, 6412, 6689, 7691, 8163, 9093, 9612, 10128, 10726, 11268, 11653, 11749, 12190, 12603, 12793, 12893, 13218]",21236,20461,17261,13217,13218,-647,-3609,-2211,-1835,-2025,-10327,35,radiant
7607071600,18,129,120,79,86,"[0, 242, 509, 813, 1264, 1562, 1852, 2204, 2734, 3178, 3957, 4695, 5548, 6098, 7020, 7657, 8382, 9435, 10763, 11319, 12199, 13056, 13903, 14487, 15058, 15980, 17335, 18175, 19242, 20998, 21865, 23209, 23758, 23948, 24223]","[0, 249, 412, 692, 1200, 1488, 1749, 2015, 2275, 2514, 2849, 3182, 3625, 4302, 4741, 5766, 5992, 6516, 7132, 7227, 8533, 9125, 10408, 10988, 11473, 12244, 12992, 13782, 14520, 15748, 16914, 17977, 18395, 19817, 20607]","[0, 344, 664, 965, 1402, 1788, 2309, 2654, 3275, 3660, 3971, 4478, 5393, 5816, 6625, 7470, 8087, 8687, 9541, 9880, 10387, 10763, 11830, 12229, 13164, 14019, 14794, 15421, 15679, 16482, 16930, 17677, 17958, 18632, 19314]","[0, 170, 599, 689, 857, 986, 1076, 1211, 1526, 1711, 1902, 2008, 2412, 2627, 3159, 3659, 4320, 4954, 5063, 5279, 6137, 6370, 6667, 6981, 7313, 7737, 8055, 8587, 8973, 10015, 10482, 11093, 11331, 11596, 12060]","[0, 170, 260, 385, 636, 979, 1126, 1406, 1604, 1900, 2221, 2465, 2764, 3015, 3344, 3668, 3852, 4303, 4907, 5171, 5925, 6286, 6517, 7210, 7874, 8307, 8600, 9010, 9378, 9994, 10274, 10911, 11056, 11308, 11885]",24223,20607,19314,12060,11885,95,106,49,123,64,"[0, 243, 605, 856, 1469, 1829, 2390, 2889, 3301, 3757, 4342, 4839, 5510, 6024, 6612, 7278, 8261, 9115, 9929, 10976, 11098, 11294, 12020, 12911, 13887, 14873, 15588, 16200, 17006, 17249, 17345, 17934, 19105, 20474, 21777]","[0, 328, 733, 1120, 1567, 1840, 2211, 2704, 3169, 3522, 3908, 4399, 4699, 5014, 5582, 5677, 6368, 6932, 7273, 7736, 8318, 8914, 9571, 9912, 10627, 11181, 11884, 12661, 12960, 13526, 13622, 14180, 15874, 16373, 16738]","[0, 170, 453, 672, 1087, 1349, 1666, 2159, 2402, 2788, 3227, 3516, 4213, 4714, 5292, 5654, 6174, 6415, 6821, 7276, 7370, 7790, 7957, 8692, 9260, 9764, 9859, 10762, 11066, 11421, 11604, 12148, 13557, 14399, 15386]","[0, 170, 260, 413, 543, 719, 809, 1188, 1278, 1605, 1928, 2124, 2286, 2642, 2869, 3291, 3588, 4071, 4214, 4611, 5458, 5728, 6102, 6272, 6817, 7338, 7863, 8854, 9343, 9857, 10578, 11064, 12116, 12918, 13320]","[0, 170, 260, 395, 525, 692, 905, 1103, 1193, 1559, 1739, 1867, 2005, 2154, 2293, 2463, 2787, 3112, 3245, 3812, 3906, 4231, 4878, 5257, 5425, 5520, 5615, 6115, 6279, 6478, 6574, 6814, 7716, 8057, 8292]",21777,16738,15386,13320,8292,2446,3869,3928,-1260,3593,12576,35,radiant
7607094907,16,89,107,75,50,"[73, 240, 561, 1188, 1530, 1992, 2321, 2987, 3634, 3798, 4095, 4432, 4919, 5138, 5581, 5807, 7099, 7546, 7956, 9256, 9780, 10395, 11289, 11979, 12255, 12563, 12948, 13242, 13922, 14338, 15666, 16101, 16769, 17028, 17509]","[0, 291, 516, 606, 888, 1017, 1622, 1927, 2270, 2397, 2757, 3221, 3744, 4181, 4721, 5145, 5812, 6735, 7179, 7979, 8513, 8842, 8937, 9938, 10774, 11379, 11602, 11896, 12569, 13198, 14192, 15373, 16639, 17309, 17456]","[73, 354, 634, 856, 1406, 1829, 2721, 3259, 3739, 3979, 4646, 5547, 5876, 6414, 7040, 7357, 8261, 8685, 9294, 9877, 10591, 10980, 11392, 12119, 12264, 12618, 13007, 13538, 14156, 14473, 15637, 16440, 16967, 17424, 18163]","[206, 336, 426, 516, 843, 933, 1161, 1423, 1552, 1642, 2404, 3206, 3886, 4431, 4748, 4942, 5431, 5970, 6597, 7260, 7877, 8194, 8561, 8754, 9098, 9540, 9717, 9967, 10342, 10537, 11323, 11727, 11917, 12231, 12331]","[73, 203, 293, 655, 745, 862, 1229, 1610, 1780, 1870, 2004, 2231, 2778, 3391, 3885, 4034, 4572, 5018, 5176, 5656, 5855, 6104, 6996, 7340, 7434, 7601, 8183, 8685, 8917, 9171, 10073, 10487, 11107, 11582, 12256]",17509,17456,18163,12331,12256,71,93,19,85,64,"[176, 388, 730, 1195, 1419, 1888, 2018, 2724, 2972, 3443, 3770, 4450, 4865, 5172, 5918, 6470, 6802, 7330, 8053, 8539, 9145, 9737, 10573, 11155, 11763, 12496, 13056, 14098, 14876, 15135, 15924, 17054, 17709, 18316, 19258]","[178, 459, 732, 1052, 1385, 1594, 1759, 2171, 2467, 3108, 3505, 3916, 4158, 4533, 4872, 5690, 6043, 6318, 6765, 7194, 7404, 7748, 7915, 8343, 8721, 9089, 9660, 11852, 12282, 12580, 12766, 13043, 13445, 13801, 14244]","[121, 402, 634, 919, 1203, 1534, 1889, 2196, 2654, 3449, 4029, 4280, 4370, 4648, 4968, 5377, 5792, 6068, 6413, 6749, 7121, 7216, 7783, 8260, 8833, 9278, 9678, 9955, 10763, 11070, 11256, 11498, 12295, 12845, 13616]","[178, 388, 478, 831, 961, 1051, 1225, 1561, 1763, 3182, 3362, 3452, 3759, 3925, 4020, 4396, 4878, 4973, 5488, 5854, 6038, 6231, 6577, 6834, 7079, 7174, 8479, 9179, 9356, 9452, 9638, 9805, 10152, 10663, 10853]","[712, 924, 1014, 1317, 1447, 1671, 1891, 2314, 2569, 2845, 3078, 3335, 3489, 3584, 3965, 4237, 4394, 4642, 4737, 4895, 5079, 5357, 5727, 5984, 6123, 6218, 6686, 7358, 7535, 7631, 7817, 7917, 8017, 8223, 8562]",19258,14244,13616,10853,8562,-1749,3212,4547,1478,3694,11182,35,radiant
7607426114,48,78,13,86,138,"[0, 286, 531, 1064, 1564, 1901, 2532, 2975, 3345, 3875, 4257, 4698, 5637, 6184, 6985, 7789, 8719, 9413, 10492, 11653, 12462, 12992, 13850, 14967, 15931, 16691, 17612, 19186, 20327, 20727, 21429, 23170, 24855, 25909, 26099]","[0, 170, 438, 747, 994, 1202, 1329, 1654, 1988, 2352, 2706, 3296, 4264, 4791, 5343, 5904, 6687, 7175, 7837, 8826, 9162, 9436, 9789, 10351, 10695, 11719, 12488, 13713, 14493, 15343, 15978, 17135, 18570, 19040, 19789]","[0, 312, 551, 820, 1152, 1416, 1634, 1945, 2476, 2995, 3587, 3901, 4394, 5171, 5507, 5879, 6641, 7040, 7410, 8039, 8674, 9600, 10449, 11054, 11792, 12344, 12857, 13630, 14365, 14834, 15444, 16233, 17576, 18291, 18613]","[0, 170, 307, 427, 662, 801, 994, 1454, 1718, 1931, 2180, 2308, 2715, 3178, 3348, 3617, 3865, 4313, 4612, 4823, 5286, 5728, 6000, 6324, 6793, 7093, 7490, 8718, 9073, 9870, 10227, 11149, 11969, 12711, 13292]","[0, 170, 260, 380, 600, 726, 816, 951, 1375, 1515, 1650, 1815, 2338, 2820, 3118, 3433, 3726, 4022, 4321, 4585, 4781, 5011, 5106, 5758, 5943, 6148, 6467, 7056, 7390, 7735, 8359, 8866, 9678, 10197, 10918]",26099,19789,18613,13292,10918,21,98,19,100,26,"[0, 542, 971, 1339, 1713, 2124, 2537, 2863, 3439, 3757, 4150, 4577, 4667, 5055, 5648, 6251, 6744, 7396, 7721, 8371, 9017, 10024, 10613, 11239, 12069, 12836, 13398, 13770, 13956, 14602, 15274, 16149, 16249, 16490, 18063]","[0, 204, 499, 783, 1028, 1362, 1659, 1874, 2114, 2537, 3054, 3535, 3970, 4645, 5238, 6133, 6742, 7258, 8014, 8557, 9423, 10211, 10908, 12023, 12397, 12763, 13360, 13775, 13943, 14871, 15259, 15359, 15668, 15768, 16578]","[0, 256, 604, 921, 1221, 1549, 2176, 2795, 3150, 3753, 4096, 4458, 4893, 5088, 5433, 5888, 6422, 6587, 6912, 7273, 7842, 8109, 8861, 9345, 10198, 10638, 11024, 11440, 11915, 12476, 13416, 14008, 14108, 14208, 14656]","[0, 239, 354, 489, 624, 800, 935, 1101, 1281, 1371, 1687, 1899, 2131, 2489, 2584, 2891, 3120, 3285, 3778, 4013, 4419, 4586, 5003, 5281, 5421, 5833, 5928, 6297, 6440, 6716, 7333, 7433, 7533, 7633, 8081]","[0, 170, 285, 410, 581, 759, 894, 1060, 1195, 1550, 1703, 1832, 2026, 2203, 2500, 2702, 3109, 3388, 4044, 4263, 4448, 4633, 4800, 5078, 5265, 5432, 5595, 5689, 5869, 6046, 6661, 6761, 6861, 6961, 7409]",18063,16578,14656,8081,7409,8036,3211,3957,5211,3509,23924,35,radiant
7607666802,93,49,135,52,86,"[0, 283, 681, 967, 1341, 1678, 1992, 2400, 2683, 3117, 3630, 4151, 4539, 4688, 5451, 6055, 6622, 7404, 7888, 8352, 9232, 9866, 10210, 10985, 11636, 12682, 13255, 13995, 14506, 14776, 15043, 15223, 16083, 16891, 17521]","[0, 282, 702, 973, 1343, 1714, 2126, 2596, 2890, 3684, 4325, 4660, 5289, 5624, 6098, 6715, 7450, 7674, 7768, 8184, 8533, 8987, 9750, 10362, 11202, 11443, 12173, 12463, 12768, 13131, 13440, 13735, 14365, 15366, 16257]","[0, 331, 718, 976, 1382, 1681, 2359, 2630, 3073, 3725, 4404, 4959, 5165, 5860, 6435, 6926, 7466, 7688, 8133, 8604, 8855, 9335, 9965, 10391, 10882, 10977, 11371, 11906, 12300, 12396, 12903, 13003, 13636, 15642, 16198]","[100, 360, 1008, 1168, 1455, 1612, 1702, 1837, 1927, 2272, 2738, 2929, 3198, 3523, 3912, 4338, 4496, 4795, 5200, 5397, 5773, 6227, 6405, 6826, 7015, 7346, 7474, 7788, 7918, 8197, 8411, 9010, 9211, 9456, 9667]","[0, 210, 334, 428, 622, 821, 1025, 1406, 1496, 1781, 2159, 2591, 3064, 3389, 3574, 3899, 4104, 4565, 4816, 5061, 5535, 6604, 6698, 7122, 7312, 7456, 7791, 8461, 8844, 9080, 9269, 9501, 9727, 10084, 10353]",17521,16257,16198,9667,10353,109,98,137,27,45,"[0, 167, 524, 861, 1304, 1639, 1903, 2311, 2782, 3197, 3801, 4403, 4918, 5784, 6169, 6749, 7674, 9023, 9744, 11093, 12144, 13442, 13767, 14518, 15313, 16253, 16836, 18270, 19976, 21427, 22727, 23637, 24098, 25545, 26210]","[0, 178, 413, 655, 1060, 1443, 1838, 2008, 2489, 2949, 3399, 3919, 4095, 4863, 5275, 5992, 6150, 6955, 7379, 7697, 8802, 10336, 10954, 11259, 12107, 13201, 13771, 15122, 16010, 16872, 17206, 17866, 18800, 19150, 19354]","[0, 169, 586, 935, 1397, 1725, 2224, 2495, 2895, 3271, 3406, 3729, 4127, 4771, 5147, 5614, 6085, 6415, 6994, 7299, 7892, 8919, 9639, 9903, 10446, 11174, 11504, 11983, 12634, 13178, 13512, 13827, 14717, 15118, 15218]","[0, 165, 300, 440, 648, 784, 874, 1132, 1222, 1312, 1447, 1787, 2121, 2528, 2771, 2959, 3250, 3847, 4101, 4368, 5021, 5116, 5598, 5693, 6351, 7367, 7514, 8121, 8643, 9346, 10013, 10390, 11096, 11196, 11456]","[0, 130, 220, 356, 535, 699, 1064, 1366, 1456, 1773, 1987, 2233, 2476, 2840, 3083, 3308, 3512, 3994, 4177, 4335, 4980, 5219, 5578, 5673, 6502, 7268, 7715, 8466, 8988, 9705, 10292, 10607, 11000, 11215, 11400]",26210,19354,15218,11456,11400,-8689,-3097,980,-1789,-1047,-13642,35,dire
7607767417,41,28,35,123,26,"[0, 290, 502, 762, 1318, 1563, 2153, 2727, 3083, 3209, 3547, 3773, 4368, 4626, 5433, 6232, 7458, 8034, 9035, 9379, 9830, 10430, 10978, 11596, 12390, 12970, 13768, 14760, 15075, 15952, 16628, 17655, 19328, 19428, 20623]","[0, 531, 899, 1277, 1453, 1580, 2074, 2544, 3467, 3885, 4335, 4858, 5642, 6605, 7609, 7740, 8795, 9262, 9582, 10025, 10284, 10826, 11464, 12198, 13099, 13370, 13842, 14619, 15106, 15582, 16018, 16652, 17482, 17646, 19703]","[0, 263, 438, 642, 816, 1140, 1266, 1426, 1678, 2215, 2749, 3108, 3415, 3603, 4350, 4893, 5808, 6515, 6735, 6829, 7516, 8761, 9275, 9498, 10029, 10623, 11450, 11707, 13133, 13697, 14389, 15086, 15873, 15973, 17931]","[0, 228, 542, 632, 767, 857, 1133, 1359, 1535, 1625, 1805, 2018, 2360, 2548, 2838, 2983, 3743, 4112, 4374, 4711, 5067, 5496, 5684, 5982, 6373, 6751, 7137, 7617, 7875, 8189, 8726, 9166, 10529, 10629, 12121]","[0, 228, 318, 452, 622, 712, 898, 1247, 1386, 1476, 1656, 2039, 2129, 2314, 2643, 2737, 3399, 3601, 3696, 4287, 4546, 5070, 5255, 5384, 5822, 6187, 6558, 7158, 7683, 7994, 8430, 8758, 9069, 9169, 9593]",20623,19703,17931,12121,9593,98,19,95,60,37,"[0, 285, 574, 935, 1274, 1470, 1917, 2718, 3179, 3946, 4783, 5364, 5625, 6524, 6836, 7352, 7447, 8294, 9349, 9845, 10758, 11061, 11980, 12635, 13935, 14388, 15134, 15875, 16659, 16755, 17060, 17691, 19423, 20964, 21064]","[0, 254, 499, 949, 1290, 1699, 2112, 2531, 2965, 3337, 3928, 4626, 5033, 5395, 5797, 6750, 6884, 7470, 8870, 9810, 10391, 10693, 10860, 11605, 12595, 13464, 13797, 14853, 16018, 16182, 16278, 16831, 18485, 18800, 19631]","[0, 170, 344, 480, 570, 705, 887, 1131, 1355, 1937, 2624, 2898, 3107, 3552, 3864, 4805, 5129, 5568, 6098, 7113, 7564, 7708, 7926, 8416, 9116, 9660, 10321, 10797, 11852, 12317, 12901, 13465, 14452, 14767, 14867]","[0, 288, 460, 791, 1076, 1541, 1895, 2578, 2912, 3393, 3869, 4493, 5310, 5964, 6320, 6998, 7093, 7445, 8116, 8731, 9564, 9911, 10736, 10986, 11297, 11577, 12004, 12293, 12780, 13055, 13651, 14203, 15171, 15486, 15736]","[0, 206, 296, 386, 524, 998, 1181, 1404, 1584, 1710, 2292, 2766, 3084, 3936, 4085, 4640, 4741, 5003, 5738, 6184, 6656, 7311, 7727, 8083, 8394, 9031, 9261, 9843, 10130, 10226, 10495, 10749, 11225, 12402, 12502]",21064,19631,14867,15736,12502,-441,72,3064,-3615,-2909,-3829,35,dire
7607899304,129,22,41,105,112,"[0, 210, 542, 788, 1343, 1589, 1897, 2379, 2625, 3014, 3397, 3637, 4064, 4494, 4912, 5426, 6362, 6794, 7597, 8036, 8609, 9394, 10483, 11519, 11972, 13051, 14548, 15031, 15703, 16720, 17616, 18995, 19673, 20594, 21842]","[0, 333, 753, 1163, 1451, 1947, 2683, 2945, 3471, 4176, 4655, 5502, 6065, 7261, 7669, 8328, 8704, 8951, 9468, 10110, 10883, 11645, 12884, 13559, 14489, 14995, 15665, 16200, 16697, 17591, 18439, 18853, 19437, 19863, 20564]","[0, 217, 620, 865, 1171, 1497, 1825, 2496, 2813, 3486, 3812, 4089, 4624, 5372, 5687, 5945, 6437, 7010, 7439, 7791, 8163, 8594, 10382, 11246, 11808, 12880, 13753, 14181, 14958, 15690, 16159, 16259, 16667, 17155, 17674]","[0, 170, 260, 350, 480, 617, 833, 1230, 1320, 1805, 1940, 2287, 2695, 2951, 3506, 3601, 3822, 3917, 4550, 4820, 5263, 5537, 5758, 6214, 6672, 7072, 7628, 7784, 8061, 8401, 8804, 8928, 9073, 9427, 10053]","[0, 170, 260, 350, 572, 662, 966, 1101, 1191, 1843, 1978, 2176, 2362, 2607, 2878, 3071, 3413, 3642, 3848, 3943, 4185, 4280, 4374, 4913, 5168, 5734, 6000, 6095, 6375, 6623, 6891, 6991, 7091, 7344, 7444]",21842,20564,17674,10053,7444,49,45,32,21,37,"[0, 218, 521, 1122, 1571, 2022, 2586, 3124, 3619, 3867, 4258, 5094, 5693, 6100, 6414, 7389, 7962, 8673, 9792, 10189, 11053, 11359, 11834, 11929, 13155, 13805, 15044, 15364, 16138, 16592, 17141, 17933, 18949, 19839, 21141]","[0, 254, 502, 873, 1199, 1541, 1960, 2406, 3112, 3293, 3624, 4195, 4664, 4922, 5475, 5980, 6637, 7396, 8694, 9685, 10175, 11058, 11714, 11809, 12506, 12824, 13836, 14407, 14851, 15498, 16200, 16942, 17479, 18207, 18802]","[0, 279, 548, 684, 890, 1307, 1604, 1929, 2534, 2850, 3352, 3697, 4066, 4247, 4801, 5421, 5840, 6401, 6582, 7135, 7569, 8340, 8514, 8867, 9405, 9629, 10693, 11153, 11934, 12324, 13092, 13552, 14697, 16037, 17153]","[0, 518, 608, 867, 1020, 1202, 1508, 1775, 1865, 2087, 2428, 2608, 2783, 3214, 3308, 3485, 3905, 4196, 4701, 5486, 5850, 6168, 6539, 7063, 7591, 7954, 9125, 9713, 10291, 10468, 11318, 11543, 11885, 12514, 12832]","[0, 170, 260, 350, 730, 865, 1002, 1137, 1528, 1755, 2085, 2544, 2781, 2941, 3139, 3398, 3641, 3882, 4569, 4961, 5146, 5613, 6098, 6193, 6481, 6575, 7499, 7729, 9003, 9560, 9978, 10372, 10562, 10993, 11183]",21141,18802,17153,12832,11183,701,1762,521,-2779,-3739,-3534,35,radiant
7608021100,52,93,129,9,112,"[0, 289, 577, 950, 1285, 2007, 2382, 3007, 3309, 3616, 4105, 4633, 5595, 6679, 7031, 7449, 8326, 8902, 9623, 10280, 11291, 11899, 12422, 13102, 13734, 14307, 14881, 16269, 17029, 17210, 17909, 18683, 18871, 20080, 20937]","[0, 286, 605, 821, 985, 1453, 1902, 2291, 2861, 3349, 3695, 4370, 5065, 5707, 6159, 6760, 7002, 7500, 8203, 8931, 9579, 9923, 10636, 11550, 12386, 13312, 13782, 14357, 15140, 15827, 16827, 17735, 18304, 19629, 19954]","[0, 283, 531, 807, 1122, 1412, 1695, 1996, 2365, 2869, 3336, 3848, 4588, 5128, 5859, 6227, 6939, 7559, 8065, 8707, 9050, 9714, 10636, 11212, 12054, 12501, 12733, 13647, 15038, 15527, 16282, 17279, 17379, 18872, 19757]","[0, 222, 361, 555, 741, 1062, 1214, 1502, 1592, 1682, 1868, 2297, 2604, 3122, 3498, 3593, 3913, 4059, 4372, 4666, 4930, 5024, 5737, 5965, 6060, 6390, 6609, 7602, 8056, 8346, 9179, 9457, 9645, 10549, 10971]","[100, 270, 404, 494, 584, 767, 857, 947, 1109, 1199, 1455, 1703, 1996, 2427, 2686, 2781, 3118, 3454, 3548, 3781, 4305, 4399, 4494, 4661, 5091, 5327, 5713, 6292, 6768, 6949, 8038, 8448, 8548, 9169, 9822]",20937,19954,19757,10971,9822,48,106,97,123,105,"[0, 251, 654, 1021, 1473, 2091, 2457, 3008, 3604, 4108, 4830, 5463, 6136, 6599, 7079, 8030, 9544, 10496, 11289, 12028, 13593, 14590, 15369, 16517, 17577, 18607, 19802, 20403, 20823, 21636, 21732, 22927, 23640, 25490, 25590]","[0, 324, 539, 986, 1279, 1602, 1856, 2109, 2684, 3207, 3677, 3871, 4362, 4885, 5421, 5887, 6285, 7065, 7272, 7762, 8599, 8911, 9473, 9813, 10510, 11014, 11424, 11786, 11882, 12382, 12531, 13086, 13609, 13966, 14954]","[0, 278, 602, 972, 1381, 1711, 1992, 2519, 3018, 3594, 4164, 4866, 5725, 5921, 6471, 6716, 7422, 7750, 8150, 8417, 8879, 9632, 10468, 10766, 11311, 11560, 12039, 12355, 12769, 13455, 13551, 13853, 14358, 14715, 14815]","[0, 170, 310, 430, 560, 688, 826, 1068, 1346, 1575, 1710, 1865, 2198, 2552, 2819, 3013, 3616, 3892, 4111, 4434, 5003, 5356, 6090, 6466, 6899, 7341, 7671, 8100, 8498, 8837, 8933, 9170, 9401, 9501, 9688]","[0, 170, 260, 380, 555, 764, 854, 1036, 1194, 1397, 1532, 1676, 1805, 1915, 2226, 2321, 2695, 2790, 2977, 3259, 3574, 3668, 3970, 4175, 4460, 4712, 5161, 5451, 5798, 6021, 6117, 6307, 6455, 6849, 6949]",25590,14954,14815,9688,6949,-4653,5000,4942,1283,2873,9445,35,radiant
7608027516,90,69,51,105,83,"[0, 289, 600, 968, 1097, 1421, 1716, 2688, 3115, 3432, 4269, 4633, 4809, 5428, 5806, 6414, 6819, 7491, 8565, 9175, 9574, 10281, 11139, 11583, 12299, 13406, 14168, 14618, 14796, 15308, 15818, 16608, 18044, 18823, 19496]","[0, 324, 610, 944, 1358, 1718, 2264, 2698, 3114, 3841, 4554, 4962, 5345, 5938, 6626, 7221, 7915, 8466, 8945, 9691, 10689, 11182, 11831, 12197, 12534, 13026, 13525, 14004, 14316, 14803, 15231, 15492, 16081, 16673, 17485]","[0, 243, 402, 691, 1072, 1442, 1690, 2116, 2724, 3348, 4107, 4333, 4710, 5419, 5722, 5932, 6346, 6603, 7611, 8401, 8863, 9195, 9457, 9987, 10678, 11125, 11335, 12073, 12479, 13115, 13563, 14161, 14554, 15076, 15341]","[0, 169, 337, 474, 582, 712, 802, 937, 1283, 1418, 1702, 1987, 2126, 2631, 2725, 3124, 3371, 3887, 4438, 4689, 4874, 5081, 5712, 6065, 6414, 6856, 7025, 7195, 7680, 8635, 9188, 9436, 10085, 10310, 10574]","[0, 169, 259, 349, 503, 682, 784, 1012, 1102, 1256, 1584, 1971, 2406, 2706, 2800, 2895, 3084, 3346, 3831, 4317, 4678, 4889, 4984, 5172, 5364, 5615, 5709, 6008, 6197, 6444, 6586, 6732, 6832, 7049, 7355]",19496,17485,15341,10574,7355,94,120,129,9,20,"[0, 213, 532, 910, 1335, 1674, 2129, 2524, 3039, 3329, 4009, 4836, 5419, 6060, 6833, 7678, 9516, 10548, 11447, 12603, 13905, 14892, 15670, 16470, 17217, 18294, 19383, 20980, 22008, 23460, 25303, 26263, 27650, 29094, 31469]","[0, 169, 415, 778, 1195, 1534, 1965, 2576, 3032, 3583, 4134, 4724, 5358, 5900, 6448, 6958, 7606, 8576, 9208, 9605, 10048, 10545, 11247, 11767, 12506, 13323, 14249, 15678, 16175, 16657, 17390, 17949, 19115, 19890, 21007]","[0, 217, 609, 904, 1278, 1620, 2029, 2357, 2650, 3040, 3224, 3971, 5002, 5605, 6504, 7609, 8421, 8797, 9303, 9696, 10322, 10800, 11093, 11732, 12260, 12828, 12922, 13893, 14541, 15064, 15548, 16313, 17095, 17370, 18607]","[0, 169, 374, 518, 1100, 1482, 1709, 1936, 2111, 2620, 2728, 3181, 3582, 3836, 4000, 4369, 5147, 5503, 5745, 5998, 6560, 7390, 7624, 8117, 8883, 9292, 10047, 10867, 11088, 11536, 12151, 12539, 13180, 13577, 15533]","[0, 169, 296, 386, 623, 713, 1066, 1228, 1318, 1408, 1702, 2174, 2687, 3008, 3253, 3468, 3955, 4262, 4410, 4644, 5065, 5440, 5769, 6321, 6491, 7065, 7989, 8756, 9052, 9304, 9585, 10087, 10690, 11285, 12493]",31469,21007,18607,15533,12493,-11973,-3522,-3266,-4959,-5138,-28858,35,dire
7608362808,48,23,49,27,102,"[0, 245, 496, 1054, 1450, 1749, 2136, 2476, 2955, 3335, 3853, 4536, 5317, 5825, 7009, 7214, 8376, 9152, 10143, 11656, 12402, 12564, 13184, 14506, 14673, 16578, 17161, 17463, 18367, 19088, 20009, 21004, 21104, 22832, 24648]","[0, 245, 592, 1074, 1284, 1452, 1824, 2333, 2749, 3004, 3516, 3963, 4395, 5231, 5878, 6511, 7189, 7480, 8008, 8554, 9249, 9886, 10644, 11475, 11642, 12340, 13016, 13558, 14240, 14607, 15322, 16683, 16783, 17501, 18781]","[0, 292, 602, 982, 1275, 1528, 2105, 2459, 2886, 3294, 3471, 4014, 4388, 5176, 5543, 5865, 6302, 6935, 7375, 8012, 8280, 9027, 9281, 9997, 10506, 10681, 11495, 11946, 12336, 12930, 13335, 14617, 14717, 15909, 17147]","[0, 209, 299, 487, 666, 891, 1148, 1336, 1472, 1892, 2276, 2741, 2921, 3511, 4087, 4629, 5133, 5262, 5642, 5841, 6218, 6778, 7403, 8046, 8697, 9328, 9896, 10152, 10583, 11048, 11582, 12490, 12590, 12739, 13454]","[0, 209, 444, 701, 822, 956, 1120, 1255, 1529, 1798, 2224, 2544, 2724, 3116, 3733, 3881, 4039, 4134, 4534, 5435, 5703, 6088, 6342, 6934, 7101, 7552, 7855, 8231, 8673, 9313, 9773, 10583, 11031, 11469, 12113]",24648,18781,17147,13454,12113,4,135,50,19,5,"[0, 164, 582, 964, 1370, 1760, 2296, 2826, 3188, 3476, 4005, 4480, 5209, 5915, 7043, 8021, 8860, 9466, 10116, 10767, 11646, 12354, 13186, 13662, 15884, 16051, 17307, 17876, 18809, 19435, 20306, 21474, 23459, 24255, 24395]","[0, 240, 488, 689, 1019, 1484, 1809, 2358, 2596, 3166, 3462, 3844, 4427, 4938, 5291, 6095, 6679, 7393, 7797, 8174, 8422, 8681, 9284, 9943, 10933, 11558, 12136, 12408, 13154, 13486, 14013, 14396, 15582, 16462, 16562]","[0, 520, 760, 1038, 1367, 1699, 2015, 2662, 3185, 3527, 3944, 4153, 4780, 4875, 5077, 5691, 6465, 7161, 7473, 7793, 8203, 8298, 8720, 8814, 9113, 9779, 10474, 11175, 11715, 12263, 13042, 13167, 13442, 14135, 15037]","[0, 129, 303, 476, 611, 895, 1020, 1292, 1382, 1546, 1636, 1772, 2282, 2430, 3012, 3610, 4008, 4513, 5022, 5647, 5895, 6261, 6900, 6994, 7987, 8858, 9551, 10018, 10362, 10548, 10891, 11841, 13359, 14365, 14465]","[0, 129, 244, 334, 516, 606, 696, 963, 1098, 1188, 1447, 1584, 1921, 2016, 2158, 2437, 2657, 2842, 3073, 3167, 3415, 3510, 3823, 3917, 4579, 4942, 5509, 5872, 6667, 6853, 7113, 7496, 8196, 9013, 9113]",24395,16562,15037,14465,9113,253,2219,2110,-1011,3000,6571,35,radiant
7608734818,94,90,129,9,26,"[0, 243, 482, 740, 915, 1222, 1750, 2242, 2658, 3161, 3660, 3950, 4537, 5265, 5946, 6541, 7235, 8077, 8728, 9251, 9789, 10596, 11870, 12479, 12984, 13271, 14227, 14614, 15579, 16137, 16668, 17294, 18406, 19349, 19975]","[0, 289, 615, 1144, 1403, 1951, 2623, 2919, 3483, 3842, 4775, 5161, 5712, 6330, 7063, 7674, 8265, 9157, 9872, 10551, 10808, 11017, 11596, 11927, 12177, 12591, 13354, 14004, 14352, 15000, 15516, 16605, 17591, 18125, 18520]","[0, 254, 578, 792, 1276, 1527, 1757, 2204, 2412, 2799, 3151, 3758, 4353, 4851, 5183, 5539, 5912, 6826, 7363, 7934, 8519, 8935, 9731, 9989, 10479, 10850, 11048, 11426, 11522, 11901, 12097, 13165, 13632, 13732, 14189]","[0, 218, 357, 909, 1076, 1166, 1446, 1941, 2072, 2741, 3528, 3678, 3961, 4187, 4602, 4886, 5028, 5466, 6063, 6479, 6906, 7203, 7621, 7806, 8011, 8106, 8482, 8822, 9049, 9362, 9675, 10480, 10862, 11200, 11300]","[0, 170, 332, 422, 600, 690, 780, 1088, 1178, 1478, 1871, 1961, 2141, 2290, 2578, 2727, 2911, 3456, 3738, 3958, 4053, 4243, 4455, 4550, 4755, 4964, 5058, 5443, 5539, 5635, 5731, 6089, 6471, 6571, 6706]",19975,18520,14189,11300,6706,95,106,96,105,21,"[0, 229, 527, 1004, 1203, 1694, 2010, 2205, 2778, 3276, 3839, 4172, 5019, 5463, 6161, 7164, 8147, 8984, 9926, 10719, 11653, 12785, 13643, 14450, 16000, 16824, 17787, 18613, 19500, 20640, 21265, 21643, 21779, 22940, 23978]","[0, 232, 502, 869, 1357, 1647, 2101, 2510, 2922, 3664, 4175, 4590, 5168, 5429, 5864, 6351, 6877, 7017, 7762, 8061, 8956, 9556, 10029, 10575, 11445, 12365, 13107, 13331, 13735, 14104, 14455, 14845, 15216, 16598, 17260]","[0, 232, 592, 916, 1276, 1559, 1937, 2351, 2635, 3060, 3375, 3866, 4386, 4638, 4948, 5546, 5767, 6331, 7230, 7324, 8036, 8705, 9397, 9816, 10526, 11110, 11650, 12274, 13015, 13485, 13732, 15046, 15498, 16158, 17080]","[0, 195, 285, 419, 509, 689, 824, 950, 1186, 1723, 1963, 2138, 2326, 2566, 2958, 3344, 3586, 3726, 4250, 4344, 4692, 5106, 5824, 6153, 6666, 7521, 7861, 8658, 9086, 9551, 9860, 10125, 10667, 11970, 12766]","[0, 246, 336, 683, 819, 909, 1128, 1218, 1426, 1713, 2036, 2155, 2346, 2588, 2817, 3605, 3826, 4301, 4795, 5287, 5688, 6174, 6762, 7213, 8011, 8587, 8953, 9263, 9567, 10028, 10316, 10877, 11059, 11681, 12397]",23978,17260,17080,12766,12397,-4003,1260,-2891,-1466,-5691,-12791,35,radiant
7609240510,70,23,17,109,21,"[62, 302, 814, 1057, 1382, 1854, 2138, 2462, 2905, 3481, 4236, 4860, 5324, 5995, 6565, 7449, 8217, 8824, 9259, 10151, 10755, 11776, 13379, 14432, 15328, 15669, 17154, 17922, 18842, 19171, 19913, 20679, 22221, 23131, 24039]","[62, 278, 553, 928, 1214, 1467, 1997, 2493, 2992, 3470, 4388, 5015, 5644, 6141, 6287, 6830, 7432, 8085, 8714, 9176, 9675, 10739, 11152, 11926, 12566, 12796, 13320, 14276, 15017, 15113, 16047, 17144, 17398, 18346, 19574]","[62, 305, 694, 1099, 1460, 1782, 1917, 2680, 2935, 3864, 4574, 5293, 5985, 6201, 6857, 7442, 8023, 8630, 9492, 9980, 10565, 11053, 11797, 12321, 13146, 13692, 14436, 14996, 16081, 16457, 16765, 17638, 18400, 19361, 19977]","[62, 231, 321, 740, 923, 1053, 1503, 2132, 2497, 2827, 3209, 3502, 3633, 3830, 4252, 4497, 5151, 5691, 6201, 6359, 6675, 7250, 7761, 8173, 8780, 9009, 9877, 10676, 11075, 11559, 12610, 13588, 14084, 15004, 15331]","[430, 651, 842, 965, 1131, 1367, 1502, 1725, 1954, 2333, 2762, 3228, 3472, 3567, 3706, 3801, 4150, 4335, 4648, 4806, 4901, 5417, 5897, 6325, 6784, 7149, 7805, 8381, 8693, 8895, 9203, 9827, 10172, 10959, 11279]",24039,19574,19977,15331,11279,36,48,14,20,91,"[0, 251, 569, 814, 1229, 1748, 2148, 2326, 3106, 3668, 4203, 4758, 5280, 6875, 7465, 8158, 8603, 9686, 9870, 10521, 11212, 11827, 11993, 12372, 13216, 14047, 14631, 15450, 15785, 16666, 18252, 19202, 19513, 19613, 22215]","[0, 207, 484, 735, 1309, 1455, 1749, 2081, 2551, 2939, 3595, 3793, 4473, 5150, 5775, 6628, 7252, 8462, 9626, 10696, 11435, 12033, 12231, 12969, 13064, 14412, 14877, 15348, 15937, 16805, 17425, 18138, 18726, 18826, 19817]","[0, 205, 371, 573, 817, 1179, 1705, 2246, 2606, 3173, 3541, 3680, 4138, 4753, 5117, 5671, 5766, 6365, 6549, 6813, 7522, 7896, 8942, 9350, 9445, 10927, 11366, 11834, 12168, 12522, 13750, 13850, 14161, 14261, 15235]","[0, 169, 259, 349, 560, 816, 943, 1033, 1175, 1496, 1631, 1815, 2058, 2615, 2818, 3204, 3901, 4307, 4491, 4910, 5642, 5847, 6038, 6224, 6345, 7253, 7723, 8222, 8497, 8670, 9997, 10563, 10874, 10974, 11329]","[0, 169, 293, 383, 521, 705, 1003, 1247, 1472, 1676, 1947, 2199, 2307, 2695, 3079, 3333, 3428, 3997, 4201, 4626, 4975, 5180, 5346, 5478, 5573, 6077, 6908, 7600, 7813, 8141, 9310, 9784, 10095, 10464, 11027]",22215,19817,15235,11329,11027,1824,-243,4742,4002,252,10577,35,dire
7609245218,95,15,52,19,9,"[0, 216, 644, 993, 1243, 1413, 1744, 2039, 2341, 2738, 3173, 4032, 4367, 5068, 5523, 6195, 6770, 7261, 7987, 8891, 9546, 10103, 10614, 11234, 12110, 12936, 13562, 13925, 14485, 15445, 16139, 16528, 16628, 17312, 18402]","[0, 206, 435, 683, 877, 1273, 1923, 2391, 2737, 3245, 3678, 4031, 4631, 5532, 5908, 6003, 6645, 7328, 7535, 8136, 8617, 9265, 9549, 9644, 10182, 11040, 11848, 12576, 12884, 13661, 14148, 14587, 15628, 16950, 17348]","[0, 254, 631, 998, 1244, 1647, 2213, 2393, 2717, 3254, 3888, 4448, 4971, 5760, 6247, 6703, 7590, 7829, 8128, 8708, 9295, 9886, 10538, 10843, 11024, 11745, 11840, 12396, 13066, 13902, 14524, 14867, 14967, 15238, 15428]","[0, 234, 349, 439, 576, 794, 977, 1237, 1560, 1688, 2417, 2612, 2990, 3632, 3944, 4206, 4605, 4814, 5017, 5294, 5388, 6367, 6896, 7309, 7524, 8591, 8733, 8828, 9225, 9585, 9796, 9996, 10775, 11361, 11599]","[0, 502, 617, 755, 879, 1049, 1339, 1683, 1857, 2109, 2624, 2804, 3132, 3852, 4067, 4605, 5008, 5408, 5923, 6439, 6644, 7108, 7203, 7488, 7834, 8055, 8150, 8427, 8587, 9154, 9302, 9520, 10095, 10671, 10885]",18402,17348,15428,11599,10885,18,13,65,53,51,"[0, 245, 490, 680, 1168, 1258, 1531, 1704, 2024, 2438, 2988, 3836, 4418, 4862, 5919, 6543, 6791, 7660, 8896, 9781, 10780, 11279, 12325, 13059, 14081, 15181, 15980, 17910, 18618, 18876, 19408, 20195, 21309, 21867, 23039]","[0, 297, 546, 990, 1286, 1660, 2029, 2534, 2817, 3243, 3646, 3893, 4458, 4831, 5613, 6405, 6727, 7396, 7874, 8513, 9118, 9600, 10496, 11354, 12095, 12668, 13658, 14353, 14984, 15626, 15934, 16807, 17303, 17653, 18377]","[0, 329, 619, 905, 1187, 1935, 2192, 2596, 2851, 3200, 3371, 4137, 4292, 4666, 5370, 5894, 6734, 7553, 8221, 9175, 9467, 9837, 10768, 11360, 11923, 12271, 12492, 13107, 13578, 14419, 14658, 15607, 16514, 16832, 17372]","[0, 170, 260, 350, 530, 783, 873, 1008, 1098, 1357, 1555, 1664, 1995, 2323, 2634, 3200, 4007, 4119, 4214, 4738, 4832, 5257, 6583, 6750, 6979, 7480, 7862, 8270, 8524, 9269, 9402, 10024, 10563, 10663, 11309]","[0, 170, 295, 481, 618, 871, 961, 1134, 1224, 1314, 1592, 1972, 2218, 2750, 3033, 3415, 4038, 4241, 4439, 5037, 5465, 6023, 7031, 7911, 8265, 8477, 8662, 9020, 9226, 9544, 10015, 10537, 10934, 11034, 11430]",23039,18377,17372,11309,11430,-4637,-1029,-1944,290,-545,-7865,35,dire
7609292902,74,42,99,86,19,"[0, 171, 453, 865, 1364, 1876, 2355, 2792, 3327, 3536, 4125, 4647, 5152, 5344, 5929, 6238, 6913, 7349, 7541, 8134, 8387, 8931, 9721, 10692, 11594, 12117, 12812, 13417, 13741, 14329, 15458, 16310, 16810, 17384, 19378]","[0, 125, 327, 492, 750, 1259, 1560, 1883, 2295, 2629, 3047, 3290, 3773, 4404, 4922, 5563, 6015, 6357, 6501, 7283, 7868, 8661, 9206, 9838, 10471, 11366, 11741, 11915, 12635, 12993, 13648, 14404, 15105, 15248, 16993]","[0, 258, 631, 917, 1264, 1516, 2122, 2449, 2868, 3644, 3797, 4172, 4724, 5420, 6209, 6810, 7524, 7812, 7922, 8426, 8884, 9172, 9695, 10345, 11019, 12046, 12823, 12922, 13567, 14229, 15244, 15728, 15828, 16583, 18183]","[0, 136, 270, 395, 586, 866, 956, 1046, 1463, 1688, 2027, 2152, 2530, 2872, 3078, 3226, 3430, 3871, 4189, 4283, 4584, 4979, 5202, 5913, 6092, 6515, 6700, 6799, 6976, 7521, 8101, 8465, 8565, 8757, 10448]","[0, 90, 180, 270, 409, 539, 719, 933, 1104, 1194, 1415, 1505, 1595, 1690, 1821, 2140, 2490, 2858, 2973, 3494, 3926, 4021, 4628, 5319, 5528, 5695, 5880, 5974, 6354, 6814, 7095, 7285, 7385, 7485, 8118]",19378,16993,18183,10448,8118,12,120,96,9,105,"[0, 288, 661, 1019, 1185, 1504, 1833, 2301, 2737, 3331, 3885, 4290, 4986, 5470, 6082, 6776, 7560, 8680, 9945, 11133, 12394, 13041, 14101, 14321, 15087, 16079, 16909, 18951, 20090, 21084, 21430, 22804, 23840, 24841, 25616]","[0, 361, 676, 1052, 1342, 1586, 2098, 2278, 2583, 2847, 3444, 3908, 4546, 5066, 5528, 6205, 7019, 7697, 8450, 9252, 10032, 10444, 11044, 12212, 12629, 13188, 13789, 14390, 15215, 15632, 16189, 16379, 17625, 18337, 18818]","[0, 285, 594, 839, 1390, 1720, 2130, 2507, 2972, 3245, 3647, 4226, 4490, 5101, 5690, 6163, 6642, 7396, 8301, 8791, 9396, 10025, 10518, 11280, 11483, 12266, 12559, 13125, 13615, 14176, 14495, 16031, 16528, 16929, 17152]","[0, 302, 489, 667, 757, 1155, 1399, 1708, 2003, 2225, 3019, 3220, 3486, 3669, 4131, 4534, 5170, 5681, 6580, 7097, 7674, 8168, 8335, 8849, 8944, 9336, 9888, 10727, 11860, 12478, 12909, 13639, 13849, 14079, 14438]","[0, 250, 340, 547, 688, 839, 1020, 1200, 1290, 1514, 1787, 2066, 2250, 2605, 2846, 3110, 3403, 3978, 4530, 5055, 5516, 5683, 5850, 6528, 6877, 7227, 7857, 8463, 9134, 9387, 9814, 10050, 10665, 10949, 11709]",25616,18818,17152,14438,11709,-6238,-1825,1031,-3990,-3591,-14613,35,dire
7609332606,49,29,120,123,5,"[0, 204, 487, 696, 978, 1466, 1866, 2148, 2635, 2832, 3380, 4044, 4647, 5243, 5719, 6455, 7370, 8361, 8716, 9913, 11145, 11710, 12871, 13635, 14014, 15010, 15814, 16551, 17891, 18460, 19817, 20654, 21887, 22346, 23408]","[0, 295, 579, 1001, 1250, 1534, 1821, 2193, 2573, 3073, 3464, 3921, 4471, 5196, 5979, 6834, 7808, 8395, 9007, 10092, 11450, 11856, 12443, 13081, 13610, 14245, 14678, 15129, 15673, 16403, 17235, 17910, 18597, 19495, 20225]","[0, 288, 498, 941, 1346, 1727, 2138, 2590, 3029, 3336, 3590, 4059, 4753, 5258, 5604, 6480, 6974, 7341, 7697, 8285, 9169, 10111, 10926, 11470, 11889, 12224, 12976, 13819, 14504, 15256, 15845, 17013, 18024, 18214, 18456]","[0, 390, 480, 570, 660, 750, 887, 977, 1067, 1411, 1826, 1965, 2224, 2557, 2750, 3001, 3351, 4068, 4327, 4717, 5292, 5891, 6289, 6796, 6936, 7263, 7467, 7740, 8128, 8405, 9040, 9703, 10187, 11106, 11656]","[0, 214, 353, 498, 765, 904, 994, 1131, 1243, 1368, 1599, 1845, 2012, 2141, 2248, 2758, 3013, 3322, 3469, 3735, 4227, 4400, 4800, 5092, 5296, 5733, 5979, 6367, 7127, 7579, 8133, 8582, 9152, 9807, 10018]",23408,20225,18456,11656,10018,90,93,109,96,65,"[327, 740, 908, 1218, 1512, 1907, 2305, 2972, 3679, 4200, 5070, 5523, 6025, 6708, 7233, 7452, 8447, 8911, 9163, 9303, 9581, 10174, 10958, 11840, 12412, 13097, 13393, 14097, 14576, 15083, 15717, 16635, 17321, 17421, 18050]","[0, 220, 420, 792, 1034, 1397, 1859, 2450, 2750, 3180, 3769, 4270, 4958, 5646, 6336, 6955, 7575, 8143, 8690, 9619, 9890, 10196, 10711, 11260, 11757, 12211, 12790, 13348, 13907, 14797, 15374, 15474, 15945, 16489, 17126]","[59, 229, 319, 409, 543, 673, 1068, 1294, 1660, 1948, 2278, 2368, 2624, 2856, 3075, 3169, 3477, 4064, 4221, 4905, 5395, 5588, 5977, 6182, 6561, 7113, 7816, 8209, 8685, 9235, 9992, 10430, 11138, 12084, 12982]","[59, 229, 644, 932, 1305, 1542, 1877, 2331, 2719, 3067, 3774, 4067, 4503, 5132, 5298, 5749, 6344, 7024, 7441, 7888, 8154, 8752, 9190, 9743, 10211, 11053, 11592, 12044, 12184, 12949, 13562, 14211, 14311, 14616, 14830]","[59, 229, 333, 423, 513, 688, 858, 1056, 1448, 1789, 2300, 2537, 2827, 3450, 3929, 4023, 4448, 4622, 4928, 5075, 5374, 5469, 5612, 5779, 5874, 6131, 6225, 6637, 6733, 6910, 7006, 7312, 7412, 7740, 7867]",18050,17126,12982,14830,7867,5358,3099,5474,-3174,2151,12908,35,radiant
7609349210,70,13,96,5,79,"[0, 243, 523, 685, 1066, 1526, 2057, 2673, 3243, 3781, 4399, 4991, 5741, 6308, 7038, 7690, 8566, 9557, 10269, 10961, 13219, 13997, 14698, 15683, 17042, 17728, 18878, 20181, 21340, 22202, 23656, 24953, 25853, 27048, 27778]","[0, 278, 569, 904, 1276, 1629, 1956, 2370, 3144, 3584, 3946, 4205, 5024, 5382, 5772, 6267, 7183, 7551, 8107, 8202, 9316, 9841, 10681, 11130, 11911, 12875, 13654, 13749, 14307, 14866, 16054, 17102, 18406, 19313, 20045]","[0, 309, 596, 974, 1316, 1605, 2136, 2636, 3064, 3544, 3976, 4596, 5113, 5389, 5919, 6399, 7447, 7824, 8401, 8550, 9166, 9624, 10061, 10838, 11396, 11740, 12157, 12720, 13175, 13406, 14062, 14683, 15240, 15849, 16271]","[0, 504, 594, 684, 823, 1317, 1532, 1679, 1992, 2137, 2520, 2798, 3122, 3430, 3525, 3765, 4257, 4790, 5036, 5131, 5379, 5702, 5970, 6623, 6857, 7154, 7583, 7790, 8135, 8440, 8885, 9774, 10256, 10748, 11131]","[0, 169, 305, 520, 610, 740, 877, 1224, 1503, 1648, 1917, 2149, 2547, 2696, 2966, 3292, 4229, 4459, 4553, 4698, 5616, 5711, 5877, 6258, 6443, 6740, 7050, 7195, 7482, 7900, 8178, 8368, 8825, 9228, 9466]",27778,20045,16271,11131,9466,46,18,97,20,65,"[0, 329, 629, 1031, 1408, 1883, 2255, 2857, 3108, 3669, 4598, 5478, 6027, 6840, 7358, 8019, 8388, 8825, 9488, 10911, 11539, 12392, 13180, 13275, 13767, 14481, 15800, 16452, 17336, 18431, 19230, 20036, 20736, 20836, 21261]","[0, 250, 728, 1148, 1505, 1871, 2145, 2688, 3378, 3977, 4802, 5553, 6237, 6940, 7710, 8541, 9068, 9706, 10809, 12682, 12777, 13934, 14372, 14952, 15335, 15837, 16374, 17159, 17634, 18129, 18225, 18325, 18997, 19684, 20275]","[0, 206, 739, 1141, 1438, 2096, 2434, 2923, 3478, 3882, 4394, 4853, 5014, 5187, 5736, 6324, 6419, 7114, 7504, 8416, 8637, 9243, 9939, 10367, 10632, 10969, 11575, 12142, 12485, 12789, 13038, 13620, 14135, 14235, 14657]","[0, 169, 259, 398, 535, 643, 789, 1063, 1153, 1243, 1584, 1768, 1880, 2134, 2400, 2584, 2960, 3187, 3436, 4304, 4422, 4702, 5018, 5188, 5358, 6011, 6180, 6440, 6721, 7017, 7334, 7791, 8053, 8153, 8593]","[0, 169, 333, 423, 557, 731, 1072, 1511, 1601, 1691, 1994, 2474, 2696, 3042, 3339, 3691, 3878, 4036, 4241, 5165, 5286, 5491, 5657, 5804, 5899, 6481, 6835, 7020, 7298, 7612, 8098, 8724, 8914, 9014, 9114]",21261,20275,14657,8593,9114,6517,-230,1614,2538,352,10791,35,radiant
7609482509,89,120,96,9,79,"[0, 252, 502, 1042, 1322, 1728, 2154, 2550, 2911, 3536, 4056, 4350, 5209, 5828, 6434, 7183, 8278, 9340, 10286, 11102, 12356, 12938, 13216, 14664, 16168, 17398, 19128, 20135, 21274, 22855, 23573, 24794, 25434, 26068, 26356]","[0, 281, 561, 854, 1254, 1588, 1920, 2385, 2976, 3474, 4095, 4374, 4779, 5423, 5894, 6729, 7438, 7848, 8365, 8939, 9648, 10204, 10522, 11301, 12348, 12710, 13257, 13665, 14022, 14516, 14884, 15261, 15361, 15629, 16026]","[0, 169, 477, 918, 1334, 1624, 2169, 2588, 2922, 3698, 4194, 4643, 5466, 5891, 6304, 6899, 7203, 7575, 8386, 8950, 9125, 9606, 9716, 10134, 10658, 11150, 11784, 12221, 12685, 13369, 13599, 13905, 14005, 14273, 15026]","[0, 169, 259, 417, 507, 687, 846, 999, 1096, 1307, 1593, 1798, 2086, 2298, 2613, 2799, 3191, 3522, 3662, 4006, 4346, 4579, 4759, 5221, 5512, 5682, 6140, 6357, 6697, 7016, 7187, 7452, 7552, 7852, 8072]","[100, 269, 359, 573, 924, 1014, 1349, 1484, 1574, 1742, 1946, 2036, 2290, 2502, 2633, 2761, 3467, 3652, 3851, 3979, 4333, 4537, 4637, 5154, 5622, 5815, 6151, 6424, 6520, 6616, 6712, 6812, 7028, 7296, 7396]",26356,16026,15026,8072,7396,12,52,23,65,85,"[0, 238, 539, 855, 1196, 1441, 1681, 2146, 2604, 2913, 3311, 3630, 4322, 5000, 5534, 6162, 6411, 6928, 7403, 7742, 8437, 9288, 10269, 11307, 11586, 12516, 13426, 14421, 15513, 15990, 16870, 17674, 18501, 19766, 21223]","[0, 277, 1123, 1457, 1862, 2171, 2407, 2880, 3581, 4329, 4779, 5692, 6279, 6782, 7361, 8058, 9037, 9925, 10668, 11266, 12360, 13099, 13637, 13940, 14690, 15655, 16263, 17141, 17772, 18097, 18501, 19503, 19961, 21516, 22367]","[0, 169, 553, 805, 1268, 1628, 1845, 2305, 2896, 3324, 3659, 4209, 4793, 5637, 6221, 6970, 7675, 8174, 8795, 9578, 10391, 10662, 10962, 11481, 12183, 13076, 13714, 13840, 15203, 16171, 16589, 17617, 18011, 18786, 19745]","[2, 171, 286, 395, 577, 707, 797, 977, 1067, 1539, 1754, 2054, 2846, 3337, 3701, 4194, 4528, 4992, 5541, 5927, 6157, 6615, 7012, 7241, 7586, 8313, 9042, 9298, 9849, 10268, 10364, 10773, 11247, 11859, 12986]","[0, 169, 284, 672, 811, 1010, 1197, 1377, 1568, 1781, 2085, 2321, 2823, 3289, 3519, 4007, 4382, 5124, 5368, 5635, 5911, 6034, 6569, 6798, 6893, 7279, 7484, 7654, 7953, 8049, 8145, 8602, 8792, 9305, 9728]",21223,22367,19745,12986,9728,5133,-6341,-4719,-4914,-2332,-13173,35,dire
7610281513,48,17,49,109,5,"[0, 250, 621, 1050, 1388, 1901, 2524, 3098, 3782, 4298, 5032, 5890, 6611, 7111, 8192, 8806, 9467, 9818, 10215, 10634, 11062, 11998, 12771, 12866, 13788, 14819, 14986, 15708, 16841, 16937, 18020, 18120, 18220, 18320, 19772]","[0, 364, 607, 1061, 1393, 1793, 2083, 2749, 3264, 3453, 4402, 4741, 5324, 6166, 6920, 7195, 8235, 8747, 9317, 9880, 10069, 10321, 10773, 11601, 11727, 11912, 12313, 12932, 14831, 14927, 15420, 15664, 15764, 16226, 16670]","[0, 323, 603, 897, 1301, 1722, 2212, 2703, 3322, 3648, 4160, 4778, 5203, 5866, 6984, 7672, 8834, 9240, 9958, 11273, 11661, 12283, 12378, 12685, 13178, 13470, 13797, 14182, 14544, 14678, 15163, 15263, 15455, 16111, 16267]","[0, 170, 260, 364, 516, 653, 783, 921, 1103, 1295, 1522, 1822, 2063, 2275, 3111, 3272, 3632, 3726, 3968, 4432, 4587, 4682, 4893, 5427, 5656, 5911, 6311, 6455, 6590, 6686, 7144, 7265, 7365, 7540, 7718]","[0, 170, 260, 350, 457, 547, 677, 776, 945, 1035, 1170, 1260, 1364, 1700, 2128, 2284, 2469, 2563, 2787, 2945, 3145, 3343, 3614, 3784, 4184, 4369, 4510, 4605, 4701, 4835, 4931, 5070, 5170, 5270, 5470]",19772,16670,16267,7718,5470,69,41,51,40,84,"[0, 323, 569, 906, 1341, 1740, 2167, 2731, 3617, 4532, 5275, 5706, 6366, 7103, 8004, 8549, 9115, 10254, 10918, 12200, 13421, 14684, 15577, 16733, 17236, 17810, 19015, 20098, 20830, 22681, 24024, 25112, 26431, 27631, 28186]","[0, 245, 478, 938, 1311, 1769, 2109, 2439, 2737, 3238, 3867, 4276, 4966, 5603, 6192, 6666, 7339, 7986, 8829, 9437, 10901, 11473, 12605, 13042, 13944, 14714, 15511, 16073, 17673, 20102, 20858, 22531, 23841, 24500, 24941]","[0, 207, 580, 904, 1211, 1537, 1956, 2413, 2731, 3385, 4093, 4850, 5419, 6075, 6341, 6927, 7584, 8319, 8736, 9519, 10207, 10958, 11748, 11958, 12821, 13407, 14154, 14934, 15846, 17045, 17372, 17562, 18275, 18659, 18759]","[0, 170, 616, 735, 1067, 1376, 1633, 2032, 2291, 2953, 3487, 3842, 4260, 4800, 5194, 5800, 6454, 7103, 7548, 7836, 8254, 8779, 9553, 10035, 10305, 10661, 11451, 12164, 12756, 13365, 14282, 14875, 15328, 15895, 16382]","[0, 170, 260, 418, 543, 678, 813, 903, 993, 1330, 1508, 1663, 1817, 2044, 2139, 2374, 2893, 3206, 3505, 3609, 3995, 4222, 4590, 5360, 5734, 6367, 6985, 7827, 8255, 8729, 8825, 9410, 9821, 10072, 10972]",28186,24941,18759,16382,10972,-8414,-8271,-2492,-8664,-5502,-33343,35,dire
7610361001,93,78,15,58,19,"[0, 246, 497, 694, 1099, 1584, 1926, 2192, 2643, 3601, 4163, 4673, 5144, 5554, 5958, 6863, 7649, 8548, 8969, 9751, 10808, 11513, 11904, 12410, 13542, 14090, 14749, 15698, 15985, 16855, 17386, 18178, 19220, 19702, 20234]","[0, 210, 300, 533, 833, 1068, 1561, 2082, 2252, 2762, 3261, 3632, 4361, 4716, 5199, 6051, 6293, 6489, 7213, 7443, 8483, 8901, 9716, 10147, 10673, 11267, 11898, 12903, 13528, 14242, 14678, 15395, 16283, 16901, 17751]","[0, 285, 619, 988, 1199, 1440, 1674, 2089, 2294, 3024, 3325, 3852, 4443, 4934, 5409, 6316, 6897, 7526, 8041, 8376, 8707, 9567, 10120, 10610, 11085, 11527, 12099, 12304, 13097, 13683, 14380, 15636, 16634, 17372, 17888]","[0, 261, 351, 492, 630, 1235, 1392, 1501, 1818, 2229, 2453, 2722, 3015, 3346, 3495, 4512, 4891, 5609, 5835, 6100, 6594, 7232, 7493, 8017, 8238, 8581, 9142, 10274, 10689, 11209, 11839, 12563, 13568, 13728, 13944]","[0, 249, 425, 515, 656, 858, 948, 1038, 1402, 1835, 2150, 2285, 2551, 2663, 2859, 3546, 3948, 4813, 5377, 5535, 5821, 5916, 6482, 6621, 6851, 7472, 7968, 8916, 9093, 9494, 9793, 10464, 10817, 11077, 11554]",20234,17751,17888,13944,11554,41,49,21,56,85,"[0, 289, 566, 835, 1092, 1602, 1893, 2392, 2840, 3267, 3708, 3956, 4232, 4839, 5141, 6042, 6863, 7442, 7892, 8546, 9656, 10597, 11428, 11946, 12213, 12649, 13254, 14352, 15126, 15758, 16068, 16944, 17481, 18370, 18922]","[0, 165, 463, 856, 1040, 1339, 1620, 2133, 2223, 2313, 2853, 3317, 3621, 4129, 4601, 5044, 5772, 6163, 6741, 7428, 8034, 8591, 9299, 9724, 10411, 11294, 12026, 12302, 12639, 13569, 13884, 15007, 15107, 16273, 16853]","[0, 199, 601, 924, 1138, 1405, 1812, 2324, 2714, 2850, 3362, 3812, 4071, 4544, 4886, 5109, 5890, 6172, 6715, 7377, 7998, 8804, 9243, 9685, 10454, 11142, 11274, 11550, 12074, 12495, 12792, 13314, 14268, 15329, 15849]","[0, 130, 245, 353, 443, 582, 754, 1095, 1220, 1430, 1718, 1897, 2150, 2441, 2808, 3234, 3915, 4115, 4387, 4659, 5023, 5538, 5853, 6281, 6634, 7070, 7328, 7423, 7921, 8134, 8298, 8600, 8989, 9880, 10259]","[0, 130, 245, 452, 542, 753, 843, 1133, 1269, 1429, 1581, 1671, 1809, 2184, 2388, 2611, 3003, 3098, 3424, 3757, 4243, 4413, 4686, 4904, 5246, 5644, 6072, 6423, 6594, 6807, 6985, 7395, 7541, 7925, 8258]",18922,16853,15849,10259,8258,1312,898,2039,3685,3296,11230,35,radiant
7610750910,1,23,28,19,110,"[0, 266, 568, 827, 1039, 1289, 1621, 2052, 2494, 2794, 3462, 3755, 4022, 4263, 4792, 5373, 5665, 6094, 7576, 8547, 9558, 10440, 11321, 12101, 13372, 14207, 15492, 16510, 17459, 18498, 19555, 20936, 22172, 23546, 25200]","[0, 270, 775, 1073, 1277, 1659, 2039, 2746, 3099, 3690, 4102, 4410, 5361, 5867, 6489, 6687, 7521, 8143, 8472, 8970, 9662, 10079, 10694, 11626, 12099, 12586, 12893, 13562, 13829, 14302, 15026, 15591, 16463, 17132, 17810]","[0, 230, 431, 764, 1121, 1484, 1770, 2401, 2947, 3560, 4149, 4701, 4855, 5400, 5829, 6385, 6896, 7290, 8131, 8608, 8972, 9253, 9669, 10540, 11167, 12171, 12311, 12576, 13156, 13476, 13858, 14042, 14232, 14612, 15592]","[0, 195, 285, 375, 465, 555, 739, 1040, 1291, 1546, 1912, 2062, 2153, 2458, 3087, 3325, 3859, 4102, 4609, 4889, 5376, 5549, 5790, 6348, 6655, 7005, 7282, 7803, 8055, 8335, 9053, 9207, 9556, 10059, 10483]","[0, 195, 285, 375, 465, 620, 797, 1036, 1126, 1272, 1825, 1915, 2147, 2242, 2729, 2993, 3153, 3394, 4207, 4559, 5094, 5379, 5634, 5801, 6263, 6442, 6536, 6716, 7017, 7113, 7627, 8000, 8239, 8910, 9010]",25200,17810,15592,10483,9010,15,54,33,100,87,"[0, 208, 529, 912, 1283, 1690, 2192, 2525, 2943, 3663, 3804, 4315, 4893, 5681, 5831, 6842, 7562, 8260, 8449, 9581, 10180, 10664, 11433, 12191, 12396, 13052, 13676, 14538, 15371, 15928, 16462, 17159, 17702, 18495, 19251]","[0, 244, 479, 675, 1010, 1172, 1421, 1933, 2328, 2656, 2957, 3493, 3864, 4325, 4915, 5762, 6483, 6969, 7064, 7955, 8647, 9143, 9605, 10252, 11323, 11892, 12425, 13024, 13986, 14628, 14875, 15326, 15609, 15947, 16770]","[0, 331, 531, 767, 1183, 1443, 1854, 2342, 2842, 3367, 3851, 4757, 5398, 6134, 6434, 6958, 7778, 8061, 8450, 8982, 9455, 10075, 11217, 11650, 12203, 12626, 13175, 13577, 14080, 14869, 15316, 15912, 16348, 17139, 17847]","[0, 170, 305, 395, 565, 690, 830, 945, 1531, 1731, 1821, 2134, 2389, 2690, 2959, 3262, 3428, 3650, 3952, 4373, 4962, 5248, 5505, 5747, 6238, 6566, 6815, 6985, 7486, 7872, 8043, 8274, 8557, 9314, 9504]","[0, 170, 260, 360, 494, 636, 726, 1071, 1321, 1521, 1611, 1923, 2370, 2754, 2849, 3071, 3377, 3646, 3741, 3898, 4056, 4249, 4869, 5036, 5385, 5587, 5727, 5822, 6253, 6566, 6662, 6965, 7750, 7985, 8175]",19251,16770,17847,9504,8175,5949,1040,-2255,979,835,6548,35,dire
7610800301,18,74,137,79,9,"[0, 208, 527, 842, 1061, 1362, 1523, 2168, 2638, 3041, 3427, 3862, 4910, 5510, 6095, 6561, 7194, 8128, 8644, 9609, 10431, 11099, 11835, 11929, 12964, 13298, 13393, 14120, 14673, 15450, 16706, 16806, 17361, 17849, 18404]","[0, 205, 407, 702, 910, 1211, 1581, 2079, 2503, 2593, 2819, 3495, 3978, 4338, 4549, 4644, 4840, 4971, 5086, 5493, 6373, 6925, 7572, 7870, 8166, 9263, 9553, 10167, 10671, 11471, 11994, 12094, 13276, 13954, 14511]","[0, 288, 996, 1476, 2079, 2455, 2834, 3247, 3665, 4262, 4724, 5118, 5606, 6088, 6183, 6400, 6863, 7501, 7750, 8484, 9058, 9626, 10156, 10250, 10345, 10775, 11371, 11536, 11782, 11878, 12530, 12630, 13403, 13939, 14749]","[0, 169, 327, 502, 677, 784, 994, 1129, 1265, 1502, 1637, 1817, 2411, 2636, 2731, 2826, 2983, 3127, 3392, 3708, 4151, 4537, 4962, 5056, 5531, 5626, 5839, 6133, 6481, 7005, 7398, 7568, 8125, 8650, 8834]","[0, 213, 303, 505, 635, 803, 893, 1138, 1228, 1466, 1708, 1918, 2413, 2562, 2885, 3136, 3293, 3388, 3569, 4060, 4451, 4907, 5332, 5436, 5531, 6010, 6151, 6245, 6727, 6823, 7206, 7306, 7869, 8235, 8452]",18404,14511,14749,8834,8452,21,19,28,121,20,"[0, 250, 499, 933, 1384, 1836, 2171, 2630, 3066, 3870, 4532, 5040, 5544, 5966, 6625, 7367, 7819, 8462, 9045, 9302, 9827, 10485, 11380, 12624, 13201, 14431, 15514, 16125, 17069, 17948, 18842, 19962, 20984, 22175, 23839]","[0, 205, 486, 730, 1050, 1362, 1673, 1972, 2454, 2977, 3384, 4173, 4656, 4948, 5415, 5925, 6503, 7042, 7654, 7951, 8420, 8791, 9525, 10564, 10809, 11166, 11805, 12437, 13390, 13921, 14842, 16469, 17637, 17974, 19415]","[0, 291, 491, 827, 1423, 1825, 2515, 3248, 3646, 4137, 4598, 5298, 5821, 6138, 6565, 7398, 7777, 8500, 9197, 9622, 10088, 10483, 10799, 11143, 12257, 13196, 13573, 14112, 14575, 15292, 15739, 16245, 16958, 17379, 18094]","[0, 206, 296, 386, 780, 989, 1502, 1804, 1894, 2222, 2687, 2961, 3137, 3478, 3800, 4302, 4883, 5627, 5936, 6509, 7139, 7549, 7821, 9055, 9150, 9993, 10449, 10936, 11493, 12018, 12331, 12431, 12756, 12981, 13696]","[0, 169, 259, 349, 549, 679, 1077, 1284, 1396, 1760, 1986, 2315, 2405, 2639, 3058, 3426, 3736, 4017, 4280, 4375, 4577, 4807, 5079, 5173, 5548, 5805, 6260, 6567, 7056, 7342, 7691, 8392, 8795, 9020, 9779]",23839,19415,18094,13696,9779,-5435,-4904,-3345,-4862,-1327,-19873,35,dire
7610815600,18,120,129,105,26,"[57, 453, 680, 1099, 1493, 1985, 2265, 2693, 3207, 3708, 4218, 4842, 5328, 6466, 7112, 8179, 8708, 9477, 9977, 10335, 11233, 11717, 12435, 13053, 13147, 14099, 14757, 15892, 16946, 17568, 17664, 17948, 18789, 19386, 19576]","[57, 354, 745, 1166, 1674, 1927, 2462, 2951, 3661, 4406, 4881, 5394, 6021, 6203, 6738, 6934, 7514, 7818, 8355, 8548, 9195, 9839, 10740, 11099, 11731, 12164, 12378, 13105, 14995, 15480, 15949, 16524, 17468, 18013, 18871]","[325, 550, 844, 1221, 1845, 2092, 2446, 2873, 2963, 3580, 3836, 4374, 4640, 4935, 5541, 5970, 6703, 6922, 7372, 7714, 8042, 8355, 9214, 9573, 9873, 10474, 10940, 11660, 12766, 13068, 13218, 13477, 13577, 13881, 14448]","[157, 382, 497, 635, 835, 970, 1181, 1383, 1473, 1919, 2225, 2482, 2945, 3373, 3984, 4257, 4573, 4758, 5693, 5788, 6307, 6814, 7458, 8154, 8537, 9019, 9403, 10174, 11054, 11416, 11675, 11849, 12191, 12447, 13329]","[57, 282, 397, 562, 922, 1012, 1102, 1198, 1322, 1683, 1861, 2037, 2267, 2438, 2623, 2718, 3060, 3245, 3400, 3495, 3800, 4371, 5114, 5549, 5753, 5920, 6015, 6582, 6921, 7187, 7329, 7428, 7754, 8047, 8392]",19576,18871,14448,13329,8392,1,78,137,58,123,"[0, 170, 641, 1070, 1471, 1917, 2236, 2674, 3365, 3859, 4403, 4802, 5818, 6468, 7573, 8661, 9618, 10470, 12073, 13550, 14661, 15594, 16600, 17245, 18340, 19477, 20508, 21259, 21715, 21811, 23354, 24834, 26300, 27298, 28880]","[0, 244, 524, 807, 1035, 1441, 1932, 2397, 2871, 3348, 4099, 4773, 5204, 5774, 6405, 6639, 7662, 8597, 9922, 10398, 11210, 12233, 12708, 13313, 14496, 15308, 15717, 16440, 16817, 17135, 18265, 19249, 20316, 21136, 22138]","[0, 241, 720, 1061, 1399, 1738, 1955, 2552, 3018, 3279, 3642, 4087, 4495, 4950, 5374, 5933, 6475, 6810, 7742, 8872, 9659, 10198, 10741, 11125, 11700, 11978, 12418, 13072, 13447, 13731, 14538, 15186, 15466, 15984, 17521]","[0, 217, 332, 803, 983, 1136, 1226, 1595, 1849, 1984, 2209, 2353, 2753, 3057, 3298, 3548, 3806, 4203, 4916, 5596, 5900, 6034, 6277, 6521, 7123, 7375, 7519, 8073, 8521, 9028, 9951, 11054, 11526, 12574, 13495]","[0, 170, 285, 393, 483, 573, 757, 847, 1226, 1526, 1834, 2144, 2310, 2772, 2968, 3316, 3748, 4294, 5007, 5655, 5912, 6211, 6447, 6542, 6815, 7131, 7403, 7768, 7947, 8162, 8604, 9245, 9705, 9905, 10620]",28880,22138,17521,13495,10620,-9304,-3267,-3073,-166,-2228,-18038,35,dire
7611209103,44,28,121,62,85,"[0, 239, 647, 961, 1447, 1658, 2205, 2607, 2879, 3441, 3737, 4149, 4925, 5376, 5809, 6004, 6816, 7496, 8267, 9110, 9738, 10753, 11605, 11808, 12962, 13975, 15177, 15914, 16390, 17088, 17877, 18495, 19153, 20112, 21423]","[0, 290, 652, 1122, 1488, 2017, 2437, 2753, 3377, 3750, 4369, 4739, 5533, 6038, 6563, 6763, 7277, 8048, 8713, 8870, 9247, 9538, 9800, 10321, 11111, 11790, 11885, 12351, 12836, 13296, 13737, 14096, 14936, 15360, 16250]","[0, 170, 260, 616, 746, 974, 1183, 1273, 1493, 1823, 2258, 2384, 2932, 3489, 3876, 4312, 4570, 5066, 6021, 6226, 6618, 7079, 7421, 7670, 8482, 9027, 9299, 9874, 10813, 11208, 11586, 11881, 12129, 12415, 13207]","[0, 368, 630, 990, 1345, 1745, 1880, 2259, 2750, 3337, 3977, 4181, 4856, 5332, 5593, 5942, 6357, 6957, 7472, 8011, 8241, 8754, 9029, 9363, 9565, 9861, 10099, 10550, 10850, 11123, 11341, 11511, 11720, 12031, 12297]","[0, 170, 260, 565, 775, 865, 1077, 1266, 1356, 1482, 1662, 1845, 2465, 2845, 2940, 3542, 3981, 4686, 5114, 5632, 6046, 6731, 7008, 7174, 7509, 7947, 8042, 8317, 8713, 8973, 9152, 9309, 9576, 9775, 10401]",21423,16250,13207,12297,10401,109,120,129,101,5,"[0, 295, 536, 820, 1019, 1347, 1653, 2059, 2502, 3555, 4122, 4635, 5015, 5658, 6321, 7417, 8154, 9067, 10276, 11491, 12159, 13224, 14029, 15467, 16534, 17540, 19260, 20912, 21999, 22776, 24269, 25036, 25878, 26944, 28267]","[0, 366, 664, 1084, 1338, 1680, 2008, 2461, 2827, 3154, 3661, 4222, 4946, 5394, 5961, 6652, 7448, 7642, 8175, 8838, 9289, 9505, 10117, 10691, 11746, 12254, 13290, 14014, 14697, 14793, 15321, 15859, 16131, 16745, 17404]","[0, 267, 357, 557, 836, 1411, 1538, 1834, 2179, 2641, 3002, 3480, 4095, 4662, 5264, 6222, 6849, 7187, 7371, 7878, 8170, 8510, 8931, 9336, 9659, 9995, 10984, 11744, 12295, 12391, 12822, 13146, 13410, 13771, 13981]","[0, 526, 616, 745, 835, 1236, 1326, 1461, 1596, 1979, 2399, 2642, 2822, 3011, 3499, 3878, 4165, 4260, 4746, 5333, 5823, 5918, 6198, 6689, 7031, 7363, 8138, 8677, 9039, 9173, 9529, 9629, 9729, 10044, 10144]","[0, 302, 437, 652, 806, 1027, 1389, 1670, 1805, 2120, 2602, 2848, 3303, 3485, 3870, 4348, 4675, 4780, 5084, 5681, 5909, 6077, 6366, 6566, 6821, 7100, 8201, 8872, 9159, 9255, 9829, 9974, 10074, 10389, 10489]",28267,17404,13981,10144,10489,-6844,-1154,-774,2153,-88,-6707,35,radiant
7611332019,18,59,86,97,66,"[0, 250, 531, 745, 1203, 1678, 1966, 2460, 2852, 3603, 4005, 4761, 5450, 6139, 6713, 7137, 7379, 8485, 8933, 9189, 9469, 9564, 10067, 10879, 11715, 12149, 13416, 14418, 14873, 15587, 16086, 16838, 17351, 18628, 18728]","[0, 202, 416, 624, 1023, 1437, 1896, 2218, 2773, 3350, 3910, 4311, 4650, 5024, 5458, 6129, 6440, 6766, 7263, 7687, 8134, 8567, 9217, 9699, 10206, 10376, 10576, 11234, 11435, 12128, 12595, 12986, 13303, 13779, 13879]","[0, 129, 219, 344, 1004, 1259, 1432, 1669, 1759, 2026, 2163, 2253, 2766, 2930, 3195, 3780, 4305, 5050, 5417, 5691, 5989, 6235, 6364, 6688, 7662, 7815, 8535, 9246, 9890, 10275, 10371, 10578, 10856, 12271, 14386]","[0, 198, 548, 763, 1496, 1866, 2052, 2329, 2474, 2860, 3269, 3616, 3868, 4385, 5070, 5593, 5858, 6053, 6173, 6716, 7042, 7278, 7591, 7942, 8639, 8734, 9384, 9996, 10187, 10575, 11208, 11446, 11583, 12008, 12108]","[0, 129, 219, 385, 501, 626, 872, 1053, 1240, 1423, 1589, 1869, 2447, 2874, 3186, 3379, 3537, 4064, 4341, 4553, 5081, 5358, 5656, 6190, 6569, 7273, 7960, 8305, 9018, 9458, 9640, 9740, 10174, 10567, 10999]",18728,13879,14386,12108,10999,50,106,96,121,105,"[108, 397, 929, 1215, 1625, 1950, 2524, 2891, 3475, 4055, 4448, 4909, 5941, 6570, 7238, 7543, 7922, 8643, 9744, 10570, 11419, 12151, 13173, 13716, 14827, 15523, 16090, 16908, 18131, 18653, 19433, 20171, 20706, 21654, 22823]","[108, 393, 660, 942, 1085, 1493, 1863, 2215, 2729, 3144, 3657, 4145, 4541, 4880, 5732, 6312, 6662, 6931, 7748, 8191, 8765, 10161, 10598, 11097, 12025, 12718, 13056, 14075, 15202, 15605, 16066, 16989, 17535, 18651, 19232]","[509, 762, 1071, 1468, 1760, 2143, 2553, 2930, 3484, 3738, 4187, 4779, 5395, 5837, 6292, 6759, 7802, 8387, 8913, 9399, 9763, 10839, 11397, 12234, 13097, 13777, 14054, 14391, 15467, 15644, 16070, 16828, 17171, 18011, 18326]","[108, 317, 432, 522, 663, 850, 1104, 1295, 1671, 1805, 2047, 2438, 2723, 3084, 3815, 4221, 4580, 4753, 5223, 5884, 6058, 6745, 6950, 7465, 8589, 9074, 9463, 9993, 10815, 11147, 11450, 11730, 11830, 12243, 12811]","[108, 317, 432, 604, 694, 862, 997, 1087, 1508, 1645, 1870, 2156, 2732, 2912, 3546, 3912, 4388, 4720, 5375, 6049, 6336, 6785, 7104, 7620, 8133, 8485, 9247, 9866, 10327, 10900, 11277, 11635, 11735, 12412, 13105]",22823,19232,18326,12811,13105,-4095,-5353,-3940,-703,-2106,-16197,35,dire
7611472802,95,129,114,5,91,"[0, 283, 482, 822, 1295, 1647, 2158, 2804, 3309, 3924, 4814, 5633, 5993, 6434, 7125, 7418, 8585, 9609, 10812, 12270, 13263, 13709, 14369, 15718, 17220, 18180, 19713, 20022, 20908, 21049, 22316, 23885, 24275, 24847, 25437]","[0, 249, 571, 873, 1480, 1957, 2244, 2740, 3026, 3382, 3932, 4266, 5178, 5748, 6315, 6756, 7929, 8467, 9378, 10055, 10770, 12123, 12265, 12669, 13854, 14574, 14759, 15310, 15562, 16167, 16818, 17605, 18279, 19817, 20407]","[0, 214, 566, 1035, 1444, 1938, 2528, 3237, 3857, 4152, 4828, 5221, 6210, 6375, 6761, 7301, 8032, 8527, 9028, 9815, 10771, 11172, 11519, 11793, 12897, 13373, 14974, 16405, 16657, 16798, 17366, 17836, 18276, 19148, 19738]","[0, 130, 220, 310, 485, 649, 883, 1040, 1405, 1778, 2068, 2443, 3012, 3355, 4134, 4229, 4579, 4674, 5279, 5919, 6261, 6970, 7282, 7556, 8238, 8868, 10162, 10966, 11432, 11573, 11885, 12830, 13267, 14516, 15226]","[0, 130, 220, 344, 694, 918, 1008, 1175, 1489, 1641, 1930, 2165, 2539, 2679, 2774, 2907, 3472, 3776, 4229, 4807, 5084, 5605, 5700, 5974, 6892, 7368, 8380, 9022, 9274, 9452, 9758, 10664, 11152, 11497, 12189]",25437,20407,19738,15226,12189,46,86,135,23,100,"[0, 322, 487, 802, 1164, 1567, 1786, 2112, 2517, 3039, 3386, 4053, 4198, 4761, 5051, 5656, 6706, 7564, 8053, 8607, 9060, 10101, 11054, 11911, 12042, 12137, 12656, 12750, 14712, 15617, 16057, 16821, 17255, 19207, 20264]","[0, 261, 351, 441, 739, 1058, 1148, 1328, 1418, 1508, 1684, 1933, 2078, 2437, 4207, 4451, 4826, 4967, 5806, 6078, 6273, 8180, 8654, 9501, 9596, 10722, 11767, 12380, 14373, 15289, 15733, 16744, 18037, 18137, 18237]","[0, 210, 755, 918, 1293, 1398, 1488, 1741, 1867, 1996, 2238, 2483, 2813, 3266, 3968, 4612, 4948, 5472, 6106, 6815, 7257, 7797, 8411, 9122, 9380, 10459, 10736, 11075, 11431, 12615, 13041, 13319, 13932, 15107, 16098]","[0, 282, 447, 693, 863, 1085, 1329, 1714, 1898, 2241, 2708, 2798, 2995, 3307, 3850, 4405, 4780, 4901, 5558, 5678, 6314, 7342, 7615, 8274, 8534, 9691, 10050, 10493, 11322, 12126, 12371, 13097, 13782, 15120, 15664]","[0, 210, 380, 470, 778, 904, 994, 1174, 1264, 1511, 1601, 1939, 2216, 2490, 3451, 4248, 4623, 4812, 5391, 5524, 5681, 6115, 6210, 6863, 6958, 8667, 9325, 9419, 9811, 10195, 10415, 10693, 11171, 11619, 11719]",20264,18237,16098,15664,11719,5173,2170,3640,-438,470,11015,35,radiant
7611842709,18,129,106,105,79,"[0, 181, 516, 922, 1203, 1641, 1929, 2163, 2416, 2870, 3241, 3888, 4772, 5439, 6097, 6885, 7647, 8389, 8904, 9556, 10026, 10564, 11726, 12294, 12709, 12852, 13727, 14919, 15557, 16258, 17329, 17429, 17529, 17753, 17883]","[0, 141, 445, 854, 1224, 1517, 2038, 2527, 2984, 3369, 3782, 4178, 4878, 5383, 5889, 6641, 7013, 7228, 7674, 8607, 9369, 9661, 9869, 10392, 10907, 11002, 11160, 12330, 13536, 14150, 15319, 15419, 16264, 16593, 17015]","[0, 203, 514, 891, 1063, 1344, 1721, 1970, 2268, 2594, 2890, 3230, 3567, 4284, 4675, 5165, 5957, 6359, 6893, 7151, 7764, 8231, 8755, 9615, 10367, 10509, 11147, 12090, 12705, 12801, 13592, 14057, 14332, 14849, 15091]","[0, 90, 180, 317, 455, 957, 1094, 1220, 1396, 1592, 1767, 2262, 2422, 2709, 2990, 3405, 3883, 3977, 4437, 4540, 4996, 5273, 5554, 5807, 6398, 6989, 7286, 8013, 8659, 8755, 9559, 9659, 9759, 9947, 10047]","[0, 90, 180, 270, 378, 525, 925, 1015, 1105, 1466, 1556, 2047, 2229, 2666, 2891, 3162, 3513, 3882, 4193, 4339, 4632, 4726, 4821, 4965, 5273, 5448, 5543, 6301, 6747, 7091, 7662, 7825, 7925, 8025, 8205]",17883,17015,15091,10047,8205,95,78,13,58,5,"[111, 361, 673, 1216, 1546, 2034, 2585, 2931, 3546, 3999, 4633, 5255, 5734, 6357, 7299, 8066, 8992, 9871, 10917, 11917, 12899, 13597, 14559, 15334, 16247, 17293, 18152, 18649, 19858, 19954, 21102, 22935, 24527, 25953, 27852]","[244, 494, 852, 1213, 1554, 1881, 2241, 2918, 3248, 3738, 4595, 4892, 5441, 6044, 6562, 7249, 7773, 8372, 9472, 10132, 11360, 11916, 13001, 13536, 14176, 14981, 15518, 15613, 16253, 16887, 17521, 18306, 18965, 20428, 21978]","[111, 512, 781, 1146, 1403, 1726, 2237, 2676, 2845, 3618, 4250, 4634, 5237, 5698, 6266, 6747, 7749, 8448, 8811, 9542, 10466, 10760, 11717, 12472, 13504, 14243, 14644, 14988, 15715, 16586, 17225, 17680, 18855, 20183, 21486]","[379, 629, 719, 853, 991, 1121, 1211, 1461, 1609, 1850, 2193, 2425, 2695, 2870, 3145, 3294, 3479, 4073, 4440, 4650, 5345, 5477, 5851, 6343, 6841, 7552, 8063, 8158, 8745, 9393, 10193, 11007, 11332, 11754, 13201]","[111, 410, 500, 720, 810, 1029, 1305, 1559, 1694, 1844, 2328, 2418, 2790, 2932, 3240, 3417, 3618, 4044, 4269, 4475, 4933, 5333, 5710, 6199, 7108, 7603, 7854, 8028, 8670, 8841, 9471, 9993, 10393, 11261, 12333]",27852,21978,21486,13201,12333,-9969,-4963,-6395,-3154,-4128,-28609,35,dire
7611956203,113,28,120,105,20,"[0, 272, 668, 954, 1547, 2071, 2335, 2816, 3245, 3601, 3974, 4492, 4967, 5912, 6625, 7291, 8192, 8722, 9663, 10372, 11095, 12016, 12784, 13629, 14516, 15544, 16188, 17306, 18310, 19515, 20203, 21190, 22400, 22786, 24426]","[0, 130, 506, 753, 1162, 1424, 1803, 2222, 2587, 2973, 3482, 3930, 4508, 5492, 6126, 7151, 7541, 8495, 8712, 9201, 9603, 10166, 10650, 10994, 11324, 12537, 13115, 13467, 13786, 14096, 14290, 14523, 14841, 15494, 15594]","[0, 238, 588, 965, 1328, 1703, 2419, 2985, 3549, 3962, 4523, 5038, 5309, 5919, 6383, 6869, 7130, 7960, 8705, 8925, 9823, 10513, 11250, 11720, 12043, 12435, 12897, 12992, 13450, 13760, 14187, 15106, 15588, 16048, 16148]","[0, 467, 557, 691, 829, 969, 1342, 1574, 1878, 2271, 2573, 2713, 2938, 3549, 3899, 4292, 4580, 4920, 5119, 5770, 6167, 6690, 7335, 7642, 7879, 8551, 8722, 8865, 9042, 9352, 9448, 9801, 9991, 10355, 10497]","[0, 199, 289, 533, 911, 1125, 1419, 1778, 1925, 2285, 2800, 3016, 3480, 3988, 4280, 4705, 5178, 5484, 5695, 5853, 5999, 6154, 6321, 6487, 6724, 7237, 7498, 7639, 7816, 8126, 8222, 8643, 8890, 9076, 9176]",24426,15594,16148,10497,9176,63,137,23,72,121,"[0, 243, 495, 888, 1263, 1623, 1965, 2520, 2888, 3518, 3879, 4371, 4731, 4879, 5387, 5924, 6240, 6978, 7394, 8330, 9191, 10220, 10864, 11647, 12447, 12623, 13076, 14321, 15185, 16161, 16994, 18330, 18830, 19609, 21438]","[0, 323, 584, 912, 1203, 1529, 1799, 1979, 2157, 2359, 3060, 3515, 4506, 4884, 5862, 6108, 6891, 7346, 7963, 9480, 10198, 10971, 11720, 11905, 12650, 12983, 13835, 14381, 14891, 16430, 17015, 17355, 17645, 18562, 19830]","[0, 280, 488, 858, 1541, 1650, 2265, 2695, 3070, 3513, 3658, 4153, 4568, 5101, 5870, 6447, 6942, 7520, 7949, 9007, 9289, 9550, 10340, 10574, 10950, 11044, 12282, 12768, 13029, 13650, 14063, 14163, 14797, 15160, 16523]","[0, 170, 260, 350, 526, 668, 758, 972, 1062, 1264, 1409, 1499, 2227, 2380, 2735, 2830, 2988, 3082, 3323, 4311, 4454, 4779, 5018, 5251, 5775, 6331, 7004, 7099, 7379, 7781, 7927, 8250, 8441, 8561, 9426]","[0, 170, 490, 669, 965, 1055, 1267, 1447, 1704, 1906, 2188, 2278, 2491, 2703, 2924, 3170, 3364, 3458, 3555, 4062, 4377, 5022, 5336, 5596, 6292, 6606, 7036, 7206, 7458, 7866, 8039, 8407, 8672, 8797, 9931]",21438,19830,16523,9426,9931,2988,-4236,-375,1071,-755,-1307,35,dire
7612109715,109,38,106,85,27,"[0, 322, 520, 841, 1203, 1575, 2018, 2286, 2766, 3199, 3701, 4233, 4981, 5732, 6377, 7325, 8325, 9203, 10140, 11202, 12159, 13183, 14442, 15421, 16099, 16567, 17858, 19108, 20007, 20808, 21521, 21703, 22810, 24254, 25299]","[0, 367, 577, 1026, 1187, 1775, 1987, 2681, 3165, 3484, 4274, 4867, 5350, 6170, 6664, 7390, 8055, 8727, 10020, 10777, 11564, 11824, 12306, 13172, 13580, 14106, 14877, 15417, 15851, 16223, 17220, 17350, 18610, 18899, 19166]","[0, 372, 658, 917, 1286, 1661, 2051, 2824, 3169, 3463, 3943, 4408, 4745, 5077, 5433, 5867, 6628, 7132, 7624, 8170, 8806, 9031, 9862, 10358, 10937, 11275, 11480, 11670, 12104, 12367, 12908, 13392, 13908, 14778, 15222]","[0, 210, 338, 517, 656, 786, 876, 1410, 1641, 1731, 1988, 2263, 2421, 2594, 2724, 3057, 3350, 3445, 3799, 4160, 4394, 4545, 4821, 4916, 5196, 5501, 5708, 5852, 5948, 6044, 6426, 6526, 7062, 7317, 7417]","[0, 210, 334, 468, 558, 771, 861, 1070, 1301, 1436, 1645, 1735, 2139, 2486, 2617, 2839, 3132, 3227, 3594, 3925, 4148, 4243, 4565, 4956, 5311, 5691, 5860, 6079, 6250, 6420, 6726, 6946, 7326, 7555, 7754]",25299,19166,15222,7417,7754,12,13,129,9,123,"[0, 252, 574, 827, 1429, 1762, 2323, 2506, 3076, 3379, 3886, 4440, 5190, 5597, 6259, 6805, 7444, 7722, 8801, 9198, 9717, 10699, 11457, 11810, 13179, 13742, 14440, 15124, 16052, 16381, 17636, 18987, 19351, 20184, 21016]","[0, 245, 520, 808, 1098, 1188, 1520, 1655, 2171, 3071, 3744, 3962, 4646, 5092, 5607, 6093, 6967, 7356, 8082, 8575, 8877, 9580, 10567, 11266, 12603, 13153, 14000, 15028, 15480, 15827, 16924, 18320, 18718, 18873, 19481]","[0, 532, 696, 893, 1299, 1722, 1922, 2411, 2849, 3326, 3963, 4534, 5138, 5712, 6285, 6535, 6990, 7599, 8049, 8144, 8826, 9631, 10171, 10840, 11949, 13069, 14118, 14402, 15015, 15490, 16146, 16973, 17752, 18400, 19060]","[0, 192, 282, 459, 973, 1063, 1654, 1891, 2376, 2709, 2889, 3238, 4024, 4317, 4524, 4842, 5065, 5616, 5953, 6086, 6453, 7053, 7349, 7767, 8270, 8614, 8826, 9359, 9952, 10093, 10495, 10775, 11225, 11646, 11994]","[0, 192, 282, 455, 630, 756, 1003, 1138, 1370, 1538, 1718, 2052, 2530, 2794, 3033, 3128, 3411, 3861, 4153, 4537, 5083, 5665, 5870, 6340, 6684, 7487, 7581, 8044, 8568, 8822, 9431, 10267, 10486, 10950, 11570]",21016,19481,19060,11994,11570,4283,-315,-3838,-4577,-3816,-8263,35,dire
7612131018,49,78,21,58,9,"[0, 213, 437, 681, 1137, 1457, 2006, 2400, 2947, 3320, 4012, 4651, 5665, 6397, 7223, 8085, 8678, 9956, 10535, 11124, 11219, 11762, 12916, 13699, 14385, 15530, 16137, 16674, 17468, 18024, 19179, 19895, 20376, 20476, 21311]","[0, 250, 527, 847, 1096, 1502, 1954, 2265, 2665, 3127, 3683, 4153, 4622, 4956, 5564, 6104, 6478, 7659, 8275, 9448, 9697, 10110, 10623, 10717, 11325, 12078, 12631, 13366, 14209, 14648, 15010, 15569, 16034, 16493, 17051]","[0, 325, 700, 1155, 1458, 1752, 2229, 2600, 3050, 3639, 3940, 4630, 5204, 6003, 6807, 7161, 7523, 7896, 8259, 9105, 9481, 10318, 10859, 11310, 11405, 12055, 12584, 13146, 13780, 13876, 14509, 15574, 15674, 16331, 17020]","[0, 474, 564, 698, 852, 959, 1049, 1435, 1574, 1688, 1904, 2221, 2611, 2856, 3313, 3580, 3889, 4356, 4590, 4773, 4868, 5016, 5452, 5628, 5896, 6226, 6449, 6696, 6954, 7050, 7500, 7888, 7988, 8410, 9032]","[0, 166, 304, 474, 665, 800, 966, 1192, 1282, 1372, 1741, 1923, 2358, 2554, 2818, 3087, 3227, 3570, 3665, 4073, 4583, 4723, 4890, 4984, 5079, 5246, 5406, 5543, 5801, 6020, 6627, 6967, 7220, 7320, 7645]",21311,17051,17020,9032,7645,73,69,137,5,65,"[0, 366, 1039, 1509, 1853, 2149, 2672, 3186, 3695, 4112, 4866, 5255, 5669, 6375, 7039, 7777, 8699, 9573, 10719, 11581, 13195, 14172, 14702, 15863, 17208, 17955, 18692, 19325, 20791, 21875, 22807, 23679, 25716, 27502, 28252]","[0, 210, 539, 687, 1083, 1502, 1664, 2201, 2734, 3147, 3764, 3971, 4620, 5053, 5771, 6519, 7537, 8083, 8390, 9291, 9564, 10066, 10858, 11274, 12360, 12662, 13278, 13558, 14402, 15051, 15468, 16025, 17101, 17361, 17760]","[0, 293, 501, 834, 1077, 1364, 1663, 2007, 2308, 2930, 3467, 4034, 4737, 5386, 5872, 6274, 6989, 7862, 8315, 8819, 9159, 9883, 10402, 10778, 11683, 11985, 12641, 12965, 13151, 13907, 14676, 14866, 15522, 15977, 16661]","[0, 210, 372, 538, 742, 832, 1014, 1504, 1639, 2077, 2593, 2761, 2851, 3113, 3208, 3454, 3701, 4167, 4464, 4811, 5487, 5885, 6199, 6784, 7303, 7807, 7977, 8304, 8902, 9862, 10392, 10700, 12029, 12129, 12319]","[0, 210, 367, 543, 713, 850, 1297, 1652, 1787, 2219, 2642, 2732, 3220, 3569, 4017, 4565, 4913, 5125, 5321, 5937, 6735, 7119, 7547, 8079, 8271, 8894, 9363, 9457, 9763, 10643, 10893, 11083, 11441, 11955, 12324]",28252,17760,16661,12319,12324,-6941,-709,359,-3287,-4679,-15257,35,dire
7612171311,89,23,60,9,45,"[0, 130, 331, 691, 984, 1261, 1609, 1974, 2389, 2863, 3531, 4156, 4734, 5458, 6141, 6921, 7871, 8813, 9820, 11128, 12106, 13043, 14089, 15155, 16488, 17350, 17748, 18688, 19427, 20372, 20549, 21993, 23350, 24971, 26457]","[0, 237, 594, 1083, 1342, 1649, 2235, 2547, 3370, 3933, 4726, 5633, 6004, 6822, 7076, 7171, 7586, 8089, 8752, 9710, 10155, 10596, 11043, 11294, 11957, 12628, 12887, 13714, 14288, 14930, 15397, 15967, 16271, 16931, 17790]","[0, 214, 486, 770, 1100, 1390, 1915, 2306, 2867, 3333, 4193, 4675, 5327, 5782, 6123, 6735, 7414, 8013, 8499, 9780, 10526, 10860, 11136, 11538, 12248, 12597, 13008, 13300, 14358, 15003, 15775, 15984, 16386, 17083, 17749]","[0, 130, 220, 421, 544, 680, 826, 1054, 1184, 1871, 2307, 2702, 2933, 3268, 3573, 3668, 3953, 4433, 4746, 5372, 5612, 5738, 5891, 6259, 6489, 6804, 6899, 7145, 7630, 8042, 8410, 8769, 9036, 9449, 9915]","[100, 230, 368, 488, 693, 783, 873, 1001, 1292, 1584, 2056, 2371, 2655, 2883, 3298, 3393, 3686, 3834, 4409, 5138, 5624, 5838, 6225, 6478, 6751, 6993, 7329, 7544, 7796, 8058, 8355, 8574, 9045, 9647, 10160]",26457,17790,17749,9915,10160,73,49,13,128,85,"[0, 371, 827, 1139, 1599, 1897, 2376, 3278, 4156, 5108, 6095, 6405, 7474, 8500, 10294, 11321, 11996, 13212, 14522, 15027, 15431, 15999, 16586, 17933, 18976, 20043, 21651, 23306, 24498, 25904, 26925, 28733, 29487, 30090, 30417]","[0, 300, 628, 892, 1274, 1601, 2059, 2580, 3041, 3320, 3983, 4553, 5160, 5634, 6392, 6842, 7176, 7596, 8290, 8858, 9442, 10105, 10606, 11690, 12152, 12840, 14108, 14941, 15778, 16501, 17243, 17811, 18315, 18785, 19645]","[0, 330, 650, 943, 1362, 1563, 1812, 2137, 2463, 3043, 3223, 3751, 4336, 4707, 5495, 6144, 7016, 7769, 8669, 8799, 9485, 9718, 10572, 11415, 12167, 12926, 14000, 14717, 15436, 15707, 16332, 17102, 17733, 17833, 17973]","[0, 214, 402, 545, 750, 895, 1034, 1124, 1509, 2057, 2391, 2578, 2855, 3103, 3627, 3933, 4091, 4452, 4875, 4970, 5307, 5401, 5788, 6337, 6951, 7481, 8348, 8657, 9092, 9949, 10338, 10702, 10996, 11128, 11323]","[2, 212, 302, 439, 1019, 1109, 1248, 1468, 1626, 1868, 2104, 2194, 2421, 2642, 2965, 3060, 3303, 3397, 3622, 3717, 3812, 3977, 4233, 4590, 4808, 5024, 5553, 5783, 6306, 6790, 7170, 7406, 7733, 7833, 7933]",30417,19645,17973,11323,7933,-3960,-1855,-224,-1408,2227,-5220,35,dire
7612195805,48,78,19,123,103,"[0, 273, 601, 1043, 1330, 1828, 2243, 2676, 3155, 3649, 4252, 4962, 5428, 6120, 7088, 8004, 8724, 9619, 10528, 11751, 12829, 13630, 14841, 15582, 16329, 17009, 17589, 18640, 19601, 20766, 21617, 23058, 23947, 26054, 27290]","[0, 277, 559, 1095, 1386, 1656, 2122, 2516, 3114, 3385, 4078, 4737, 5318, 5795, 6142, 6596, 7405, 7724, 8920, 9547, 10053, 11092, 11988, 12585, 13395, 14167, 14751, 15148, 15610, 16168, 16711, 17719, 18092, 18525, 20245]","[0, 273, 565, 848, 1259, 1694, 1955, 2298, 2984, 3348, 3812, 4377, 4916, 5174, 5479, 5611, 6222, 6767, 7281, 7438, 7965, 8512, 8816, 9301, 10014, 10109, 10443, 11190, 11704, 12322, 12797, 13451, 13661, 15123, 15669]","[0, 199, 289, 444, 534, 624, 795, 1002, 1213, 1525, 1946, 2458, 2623, 2945, 3495, 3676, 4033, 4252, 4840, 4997, 5241, 5673, 6131, 7209, 7631, 7960, 8087, 8290, 8701, 8978, 9613, 10355, 10900, 11824, 12674]","[0, 195, 285, 375, 465, 600, 735, 825, 969, 1291, 1542, 2070, 2208, 2303, 2446, 2540, 2698, 2953, 3274, 3431, 3570, 3888, 4032, 4443, 4648, 4743, 4838, 4932, 5154, 5431, 5702, 6092, 6338, 7262, 7692]",27290,20245,15669,12674,7692,89,13,129,110,138,"[0, 220, 492, 773, 1273, 1656, 2073, 2485, 2730, 3116, 3629, 3947, 4748, 5657, 6349, 6905, 7932, 9393, 10412, 11574, 12479, 13335, 14102, 14659, 16433, 17504, 18658, 19916, 21192, 22248, 22925, 24288, 25006, 25382, 25572]","[0, 277, 522, 770, 1139, 1427, 1870, 2183, 2619, 3206, 3528, 3672, 4386, 5017, 5535, 5853, 6390, 6764, 7143, 8335, 8892, 9118, 9410, 9504, 9848, 11053, 11811, 12412, 12809, 13601, 14545, 15188, 15571, 15671, 16437]","[0, 206, 455, 766, 892, 1172, 1531, 1692, 2031, 2553, 3053, 3197, 3556, 4191, 4786, 5439, 5860, 6369, 6863, 7671, 8154, 8559, 8855, 9473, 10169, 10884, 11382, 11790, 12098, 12351, 12447, 12986, 13286, 13386, 13781]","[0, 170, 260, 350, 486, 860, 972, 1153, 1339, 1674, 1993, 2277, 2475, 2678, 2898, 3046, 3619, 4013, 4301, 5020, 5420, 5942, 6184, 6353, 6720, 7101, 7407, 7737, 8130, 8463, 8851, 8990, 9695, 9795, 10229]","[0, 170, 309, 443, 578, 767, 902, 1256, 1346, 1709, 1933, 2242, 2508, 2755, 2975, 3212, 3732, 3949, 4107, 4571, 4848, 5074, 5241, 5335, 5592, 5849, 6312, 6498, 6774, 7181, 7377, 7725, 8198, 8390, 8796]",25572,16437,13781,10229,8796,1718,3808,1888,2445,-1104,8755,35,radiant
7612212318,95,126,129,40,121,"[0, 251, 919, 1262, 1769, 2344, 2989, 3280, 3783, 4306, 4926, 5532, 5919, 6731, 7504, 8594, 9160, 9880, 11369, 12090, 13160, 13637, 14550, 15824, 16333, 17355, 17991, 18693, 18975, 20125, 20587, 21170, 22279, 23028, 24071]","[0, 319, 664, 1071, 1409, 1870, 2206, 3016, 3468, 4285, 4864, 5216, 5538, 6091, 6633, 6976, 7979, 8458, 9572, 9990, 10557, 10652, 11184, 11566, 12640, 13554, 13854, 15028, 16100, 16664, 16862, 17052, 18195, 19113, 20627]","[0, 135, 390, 553, 803, 1085, 1251, 1908, 2253, 2944, 3463, 3777, 4295, 4429, 5073, 5399, 5663, 6498, 7041, 7449, 8387, 8534, 9555, 10004, 10909, 11148, 11679, 12989, 14568, 14857, 15300, 15877, 16831, 17519, 18569]","[0, 129, 302, 392, 570, 707, 1051, 1141, 1428, 1785, 2021, 2301, 2572, 2946, 3443, 4112, 4751, 5294, 6146, 6804, 7281, 7467, 8085, 8407, 9130, 9828, 10466, 11290, 11914, 12426, 13164, 13413, 14107, 14608, 15454]","[0, 129, 219, 309, 399, 489, 579, 762, 988, 1309, 1537, 1764, 1854, 2048, 2248, 2669, 3073, 3347, 4060, 4365, 4693, 4788, 5127, 5332, 5662, 5901, 6112, 6580, 7052, 7478, 7574, 7838, 8093, 8436, 9288]",24071,20627,18569,15454,9288,84,90,96,37,53,"[0, 294, 733, 1167, 1410, 1899, 2276, 2673, 3103, 3647, 4199, 4806, 5336, 6323, 6851, 7695, 8044, 8692, 9113, 9528, 9890, 10802, 11686, 11856, 12399, 12630, 13541, 14230, 14799, 15495, 16966, 17406, 17596, 18727, 19349]","[0, 356, 684, 1007, 1429, 1721, 2142, 2782, 2872, 3527, 3902, 4528, 4899, 5347, 5884, 7085, 7385, 7940, 8640, 9032, 9407, 9775, 10363, 10705, 11558, 12422, 12853, 13435, 13707, 14266, 15158, 15638, 15828, 16234, 16581]","[0, 209, 567, 797, 953, 1203, 1408, 2160, 2365, 2504, 2853, 3228, 3813, 4268, 4689, 4934, 5527, 6238, 6854, 7160, 7711, 8039, 8441, 8611, 9013, 9541, 10141, 10558, 10965, 11714, 12279, 12592, 13178, 13805, 14875]","[0, 209, 299, 518, 608, 792, 983, 1231, 1360, 1617, 1903, 2086, 2369, 2742, 2977, 3605, 3907, 4439, 4819, 5056, 5364, 5479, 5720, 6124, 6994, 7499, 7668, 8836, 9279, 9713, 10125, 10664, 11155, 11330, 11985]","[0, 209, 299, 419, 716, 851, 975, 1155, 1620, 1970, 2174, 2324, 2516, 3085, 3412, 3795, 4083, 4555, 5003, 5098, 5537, 6202, 6368, 6793, 7825, 8336, 8682, 9332, 9604, 9738, 10180, 10899, 11089, 11735, 11835]",19349,16581,14875,11985,11835,4722,4046,3694,3469,-2547,13384,35,radiant
7613053405,48,98,23,68,20,"[0, 325, 657, 1024, 1346, 1760, 1888, 2527, 2898, 3229, 3640, 4021, 4604, 5317, 6223, 6816, 7496, 8317, 9158, 9867, 10137, 11462, 12150, 12925, 13896, 14832, 15733, 16338, 17122, 17992, 19269, 20015, 22238, 23567, 24332]","[0, 257, 491, 704, 998, 1243, 1370, 1870, 2357, 3090, 3555, 3978, 4713, 5400, 5869, 6473, 6704, 7245, 8288, 8798, 9876, 10239, 10757, 11523, 12581, 13060, 13607, 13998, 14375, 15403, 16058, 16808, 18166, 18931, 19459]","[0, 247, 583, 835, 1121, 1372, 1876, 2608, 2987, 3449, 4266, 4814, 5104, 5591, 6124, 6569, 6853, 7490, 7916, 8283, 8902, 9649, 10093, 10467, 10852, 11434, 12553, 12986, 13082, 13734, 14614, 14758, 16002, 16938, 17084]","[0, 170, 260, 394, 513, 647, 737, 1163, 1288, 1378, 2102, 2528, 2684, 2885, 3337, 3552, 3737, 4047, 4449, 4883, 5228, 5624, 5924, 6375, 6655, 6830, 7234, 7502, 7673, 8521, 8773, 9026, 10087, 10462, 10629]","[0, 170, 352, 486, 576, 666, 756, 1077, 1167, 1444, 1798, 2171, 2282, 2569, 3265, 3395, 3580, 4418, 4661, 4868, 5138, 5379, 5473, 5568, 5847, 6151, 6696, 7077, 7275, 7605, 8259, 8359, 9307, 9855, 10001]",24332,19459,17084,10629,10001,138,36,129,119,85,"[0, 255, 689, 1130, 1623, 2094, 2533, 3052, 3584, 4048, 4273, 4715, 5443, 6256, 7137, 7777, 9321, 10211, 11082, 11903, 12189, 13255, 13807, 14400, 15656, 16370, 17289, 18002, 19168, 19399, 19822, 20914, 21324, 21948, 22675]","[0, 365, 655, 983, 1467, 1797, 2481, 3039, 3555, 4175, 4737, 5214, 5964, 6455, 7254, 7632, 8909, 9917, 10675, 11225, 12643, 12981, 13721, 14074, 14965, 15617, 16564, 17451, 18151, 18443, 18728, 19454, 19554, 20012, 20973]","[0, 244, 493, 691, 1316, 1517, 2018, 2365, 2996, 3356, 3581, 4009, 4357, 5128, 5972, 6735, 7568, 8329, 8887, 9553, 10772, 11207, 11535, 11871, 12536, 13305, 13590, 14395, 15069, 15509, 15987, 16460, 17145, 17656, 18637]","[0, 170, 280, 405, 604, 694, 1080, 1478, 1613, 1780, 2383, 2473, 2646, 3240, 3718, 3861, 4485, 4759, 5036, 5329, 5710, 5969, 6173, 6597, 6989, 7573, 7748, 8127, 8419, 8650, 8827, 9260, 9407, 9758, 10170]","[0, 170, 260, 396, 643, 782, 928, 1251, 1421, 1593, 1856, 2046, 2183, 2612, 3291, 3510, 4294, 4551, 4894, 5198, 5472, 5677, 6004, 6211, 6532, 6871, 7121, 7675, 8116, 8529, 8913, 9375, 9534, 9759, 10145]",22675,20973,18637,10170,10145,1657,-1514,-1553,459,-144,-1095,35,radiant
7613240917,109,19,23,121,112,"[0, 209, 576, 855, 1135, 1382, 1804, 2044, 2431, 3084, 3399, 4232, 4626, 5093, 6318, 6935, 7281, 8245, 8877, 9684, 10014, 10394, 11133, 11648, 12371, 13227, 14933, 15258, 16032, 17042, 18160, 19055, 20119, 21058, 21765]","[0, 244, 461, 937, 1350, 1790, 2054, 2662, 2954, 3449, 3821, 3949, 4391, 5021, 5774, 5994, 6127, 6222, 6547, 6642, 7094, 7350, 8172, 8720, 8936, 9464, 10516, 10811, 11299, 12040, 12473, 12698, 14013, 14471, 14812]","[0, 289, 453, 748, 1164, 1571, 2190, 2765, 3342, 3781, 4025, 4657, 5394, 6205, 6715, 7348, 7761, 8094, 8498, 8708, 9190, 9515, 9955, 10309, 10782, 11173, 12099, 12415, 12751, 13385, 13722, 13822, 14320, 14789, 15499]","[0, 170, 358, 571, 750, 875, 1012, 1157, 1441, 1817, 2079, 2681, 2996, 3186, 3380, 4266, 4360, 4596, 4774, 5041, 5415, 5510, 5734, 6041, 6366, 6851, 8037, 8222, 8528, 8820, 9337, 9703, 10028, 10319, 10419]","[0, 170, 260, 418, 548, 673, 811, 946, 1287, 1498, 1588, 2006, 2186, 2324, 2518, 2908, 3288, 3419, 3598, 3693, 3901, 3996, 4230, 4325, 4463, 4630, 5380, 5773, 5908, 6379, 7127, 7338, 7438, 7843, 7943]",21765,14812,15499,10419,7943,48,126,84,43,123,"[0, 170, 440, 901, 1300, 1550, 1761, 2094, 2600, 3059, 3483, 4304, 5066, 5963, 6841, 7447, 8476, 9427, 10576, 11246, 12182, 12704, 13222, 14595, 15500, 16442, 17073, 17495, 18686, 19627, 20719, 20819, 21314, 22337, 23867]","[0, 286, 617, 946, 1277, 1637, 2052, 2436, 2850, 3251, 4421, 5367, 5989, 6635, 7380, 7768, 8799, 9362, 10084, 10702, 11254, 11928, 13035, 14239, 14861, 15782, 16695, 17700, 18174, 18779, 19879, 21526, 22269, 23410, 23980]","[0, 170, 260, 399, 562, 652, 742, 871, 1255, 1624, 2245, 2800, 3308, 3638, 3942, 4480, 5146, 6121, 6860, 7039, 8070, 8341, 8906, 9551, 10109, 10609, 11463, 12114, 12693, 13896, 14534, 14928, 15285, 15993, 16625]","[0, 253, 463, 825, 1119, 1505, 1918, 2315, 2491, 2711, 3457, 3634, 4421, 4818, 5264, 5511, 6377, 6824, 7276, 7699, 7856, 8194, 8918, 9644, 10129, 10654, 11250, 11345, 12076, 12519, 13067, 13300, 13788, 14372, 14948]","[0, 170, 309, 448, 724, 860, 998, 1652, 1742, 1832, 2170, 2321, 2885, 3178, 3479, 3647, 4276, 4886, 5172, 5838, 6689, 7149, 7928, 8318, 8570, 9124, 9516, 9870, 10363, 10817, 11075, 11900, 12294, 12868, 13472]",23867,23980,16625,14948,13472,-2102,-9168,-1126,-4529,-5529,-22454,35,dire
7613422607,70,86,84,121,88,"[0, 242, 566, 959, 1293, 1701, 2120, 2596, 3044, 3560, 4031, 4424, 4770, 5381, 6383, 7352, 7928, 8864, 9150, 9788, 11412, 12255, 13130, 14452, 15568, 16313, 17174, 17268, 17540, 17878, 18686, 18786, 19183, 20006, 20383]","[0, 284, 603, 1022, 1281, 1685, 2352, 2881, 3386, 3561, 4052, 4639, 5139, 5973, 7082, 8002, 8467, 8724, 9624, 10060, 10754, 11228, 11921, 12713, 14335, 14823, 15248, 15713, 16418, 16906, 18047, 19173, 20027, 20127, 20282]","[0, 283, 480, 875, 1219, 1579, 2066, 2266, 2617, 2790, 3287, 3416, 3913, 4111, 4931, 5135, 5886, 6515, 7056, 7303, 8172, 8552, 8865, 9585, 10837, 11270, 11540, 11794, 11890, 12628, 13837, 14169, 14713, 15203, 15783]","[0, 169, 259, 394, 484, 620, 710, 845, 935, 1046, 1478, 1568, 1775, 2047, 2404, 2759, 3090, 3527, 3622, 3717, 4246, 4480, 4793, 5050, 5767, 6006, 6101, 6195, 6291, 6387, 7230, 7737, 7837, 7937, 8037]","[0, 169, 309, 446, 536, 626, 995, 1085, 1175, 1313, 1494, 1693, 1783, 2120, 2611, 2965, 3182, 3545, 4154, 4298, 4439, 4624, 5150, 5407, 5597, 5836, 5931, 6025, 6121, 6217, 7267, 7599, 7699, 7799, 7899]",20383,20282,15783,8037,7899,106,19,54,119,5,"[0, 297, 490, 708, 1158, 1539, 1976, 2355, 2873, 3516, 4386, 4837, 5380, 5529, 5969, 6645, 7012, 8207, 8515, 9722, 10470, 10880, 11537, 12604, 13198, 14291, 15002, 16029, 16753, 17339, 18943, 19646, 21197, 22576, 23757]","[0, 242, 522, 957, 1547, 1913, 2531, 2915, 3214, 3580, 4020, 4635, 5066, 5974, 6367, 6462, 7686, 8779, 9332, 10022, 10776, 11509, 12007, 12628, 12836, 13312, 14638, 15853, 16372, 16896, 16992, 17504, 18703, 19978, 22010]","[0, 284, 532, 820, 1071, 1494, 1864, 2550, 3205, 3779, 4431, 4945, 5299, 6117, 6683, 7158, 7778, 8444, 8689, 9430, 10030, 10714, 11616, 12103, 12336, 12553, 13757, 14417, 15165, 15647, 16823, 16923, 17499, 18136, 18643]","[0, 510, 666, 802, 971, 1108, 1275, 1626, 1915, 2126, 2409, 2499, 2589, 2883, 3194, 3289, 3913, 4409, 4992, 5979, 6335, 6530, 6780, 6875, 6969, 7191, 7842, 8136, 8484, 8715, 8811, 9163, 9849, 10672, 11520]","[0, 169, 259, 403, 534, 716, 806, 1314, 1767, 1992, 2414, 2524, 2614, 2879, 2974, 3069, 3416, 3811, 3906, 4434, 4841, 4936, 5186, 5281, 5479, 5863, 6604, 6943, 7395, 7721, 8298, 8398, 8871, 9632, 10481]",23757,22010,18643,11520,10481,-3374,-1728,-2860,-3483,-2582,-14027,35,dire
7613436713,13,93,55,85,19,"[0, 207, 480, 760, 1088, 1379, 1780, 2214, 2786, 3222, 3751, 4202, 4352, 4953, 5548, 6537, 7699, 8426, 9410, 10226, 10892, 11828, 12577, 13156, 14091, 14912, 15674, 16734, 17046, 17237, 18242, 19032, 19923, 21577, 23495]","[0, 200, 519, 846, 1059, 1574, 1935, 2378, 2732, 3090, 3411, 4010, 4529, 5346, 5913, 6402, 7215, 7594, 8468, 9411, 9719, 10434, 11677, 12171, 12591, 13566, 13756, 13851, 14179, 14546, 15704, 16524, 16953, 17869, 18505]","[0, 239, 544, 897, 1356, 1590, 1983, 2143, 2518, 3066, 3289, 3807, 4403, 4813, 5464, 5917, 6776, 7275, 8096, 8687, 9097, 9625, 10471, 10795, 11498, 12136, 12615, 12710, 13080, 13249, 13972, 14443, 14848, 15735, 17328]","[0, 132, 247, 381, 488, 626, 753, 939, 1119, 1397, 1670, 1760, 1886, 2047, 2151, 2619, 3479, 3663, 4730, 5033, 5128, 5266, 5505, 5724, 5983, 6426, 7068, 7315, 7704, 7929, 9342, 9602, 9930, 11080, 11842]","[0, 132, 627, 772, 1123, 1257, 1347, 1437, 1796, 2010, 2234, 2351, 2469, 2617, 2783, 3209, 3908, 4462, 4995, 5369, 5464, 5602, 6111, 6262, 6405, 7003, 7253, 7412, 7643, 8165, 8762, 9385, 9691, 10364, 11565]",23495,18505,17328,11842,11565,89,59,129,65,52,"[0, 331, 571, 896, 1202, 1610, 1900, 2357, 2689, 3068, 3450, 4152, 4675, 5363, 6056, 6747, 7804, 8545, 9821, 10991, 12039, 12922, 14524, 15780, 16834, 17901, 18741, 20089, 20968, 21722, 22587, 24083, 24895, 25710, 25810]","[0, 282, 583, 946, 1156, 1490, 1852, 2633, 3022, 3767, 4286, 5140, 5655, 6190, 6929, 7533, 7799, 8291, 8454, 8612, 9270, 9516, 10093, 10638, 11187, 11645, 11740, 12875, 13198, 13689, 13890, 15125, 16045, 16672, 16772]","[0, 257, 419, 647, 944, 1303, 1598, 2008, 2468, 3195, 3905, 4451, 5293, 5958, 6475, 7029, 7259, 7662, 7825, 8014, 8525, 9144, 9577, 10485, 10926, 11356, 11466, 12215, 12752, 13063, 13977, 14735, 15072, 15994, 16094]","[100, 310, 400, 539, 773, 925, 1147, 1659, 2021, 2428, 2925, 3418, 3593, 3777, 4405, 4613, 4879, 4973, 5173, 5331, 5795, 6060, 6762, 7102, 7799, 8076, 8452, 9016, 9112, 9377, 9573, 10128, 10343, 10732, 10832]","[0, 210, 300, 390, 480, 619, 754, 987, 1125, 1415, 1939, 2279, 2436, 2669, 2928, 3229, 3600, 3694, 3852, 4112, 4270, 4535, 4952, 5047, 5210, 5449, 5591, 6187, 6283, 6975, 7352, 7835, 8045, 8700, 8800]",25810,16772,16094,10832,8800,-2315,1733,1234,1010,2765,4427,35,dire
7613494811,48,69,49,9,85,"[0, 296, 921, 1420, 1620, 1825, 2371, 2919, 3382, 3916, 4298, 4462, 4730, 5508, 5954, 6859, 7793, 9142, 10036, 11069, 11809, 12471, 12988, 13798, 14604, 15381, 15751, 16300, 17397, 17493, 18037, 18820, 19831, 21038, 21173]","[0, 297, 614, 905, 1236, 1516, 1797, 2279, 2576, 2816, 3664, 4263, 5050, 5771, 6064, 6509, 7474, 8080, 8884, 9645, 10386, 10744, 11497, 11969, 12567, 13035, 13498, 13996, 14583, 15065, 15793, 16699, 17328, 18110, 18729]","[0, 319, 637, 1071, 1467, 1754, 2221, 2594, 3193, 3663, 4402, 4610, 4948, 5469, 6089, 6475, 7193, 7834, 8314, 8885, 9337, 10034, 10580, 11389, 12198, 12579, 12674, 13428, 13879, 14355, 15058, 15447, 16745, 17163, 17321]","[0, 246, 353, 539, 728, 944, 1197, 1409, 1604, 1951, 2285, 2413, 2848, 3091, 3475, 3680, 4209, 4517, 4740, 4943, 5188, 5428, 5583, 5776, 5918, 6148, 6410, 6550, 6977, 7329, 7589, 8180, 8280, 8596, 8792]","[0, 210, 369, 504, 594, 734, 914, 1155, 1290, 1469, 1685, 1775, 1979, 2161, 2491, 2598, 2844, 2982, 3077, 3557, 3836, 4163, 4343, 4614, 4891, 5100, 5220, 5487, 5964, 6477, 7070, 7170, 7270, 8015, 8115]",21173,18729,17321,8792,8115,72,46,129,58,123,"[0, 238, 761, 1009, 1548, 1869, 2340, 2867, 3498, 3948, 4569, 5256, 5907, 6746, 7859, 8375, 9070, 10076, 11225, 11383, 12204, 13148, 13886, 14713, 15754, 16771, 17578, 18162, 19079, 19310, 19873, 21058, 21884, 22844, 25075]","[0, 130, 470, 693, 866, 1226, 1475, 1929, 2286, 2724, 3329, 3804, 4779, 5805, 6512, 7248, 8080, 8763, 9313, 9795, 10482, 10909, 11908, 12833, 13296, 14356, 15400, 16021, 17004, 17865, 17961, 18613, 19165, 19491, 20583]","[0, 207, 413, 700, 1151, 1514, 1853, 2217, 2625, 3168, 3616, 4310, 5066, 5823, 6420, 6835, 7359, 7881, 8738, 9425, 9951, 10620, 11229, 11610, 11989, 12718, 13464, 13960, 14714, 14999, 15329, 15755, 16194, 16463, 16688]","[0, 173, 346, 439, 641, 783, 873, 1008, 1422, 1557, 2026, 2424, 2981, 3544, 4064, 4266, 4870, 5057, 5319, 5507, 5910, 6106, 6417, 7162, 7571, 8066, 9516, 9850, 10465, 11341, 11836, 12513, 13386, 13486, 14260]","[0, 130, 292, 431, 567, 742, 902, 1216, 1387, 1605, 1722, 1964, 2276, 2901, 3081, 3569, 3802, 3896, 4264, 4805, 5260, 5597, 5782, 6392, 6757, 7280, 7938, 8297, 8906, 9426, 9951, 10449, 11034, 11134, 12271]",25075,20583,16688,14260,12271,-3902,-1854,633,-5468,-4156,-14747,35,dire
7614970519,41,28,76,110,114,"[0, 232, 577, 802, 1302, 1542, 1860, 2382, 2978, 3511, 3962, 4411, 5012, 5451, 6060, 6475, 7274, 8061, 8828, 9607, 10102, 10724, 11058, 11667, 12410, 13036, 13551, 14026, 15144, 15824, 16270, 17625, 18173, 19177, 19277]","[0, 231, 518, 840, 1290, 1611, 1964, 2724, 3171, 3593, 4152, 4761, 5320, 5722, 6467, 6786, 7644, 8221, 8800, 8894, 9094, 9870, 10521, 10942, 11537, 11775, 12116, 12682, 13329, 13930, 14782, 15451, 16411, 17296, 18161]","[0, 305, 624, 950, 1341, 1669, 2087, 2624, 3155, 3704, 4073, 4693, 5335, 5888, 6567, 6750, 7072, 7699, 8170, 8662, 9225, 9771, 10523, 11166, 11709, 12401, 13206, 13300, 13894, 13990, 14458, 15474, 16112, 16854, 17594]","[100, 294, 419, 509, 685, 882, 1100, 1273, 1648, 1930, 2175, 2361, 2673, 2954, 3375, 3661, 4162, 4718, 5123, 5521, 5795, 5996, 6555, 6886, 7078, 7584, 7935, 8066, 8990, 9651, 9828, 10514, 10707, 11333, 11540]","[0, 194, 319, 409, 539, 704, 1042, 1310, 1445, 1604, 1694, 1844, 2034, 2183, 2278, 2651, 2951, 3182, 3412, 3697, 4155, 4250, 4918, 5386, 5481, 5648, 5918, 6260, 6527, 7413, 7590, 8371, 8471, 8763, 9106]",19277,18161,17594,11540,9106,95,13,96,105,103,"[0, 350, 670, 989, 1395, 1904, 2239, 2786, 3285, 3763, 4308, 4963, 5582, 5849, 6455, 7195, 8194, 9031, 9908, 10997, 11743, 12264, 13028, 13761, 14214, 15491, 16279, 17027, 17844, 18230, 18326, 19247, 19958, 21066, 22103]","[0, 301, 540, 839, 1175, 1492, 1793, 2057, 2426, 2792, 3309, 3837, 4355, 4709, 4976, 5739, 6447, 7241, 8053, 8446, 9164, 9928, 10451, 10804, 11249, 12022, 13042, 13915, 14566, 15796, 16242, 17070, 17942, 18569, 19960]","[0, 531, 849, 1223, 1739, 2141, 2510, 2795, 3309, 3600, 4184, 4602, 5006, 5396, 5538, 6008, 6615, 7205, 7808, 8615, 9365, 9509, 9859, 10332, 10427, 10736, 11246, 11759, 12329, 12841, 13294, 13529, 14094, 14482, 14762]","[0, 363, 453, 586, 716, 925, 1015, 1105, 1243, 1333, 1468, 1752, 2066, 2682, 3030, 3498, 3756, 4055, 4150, 4982, 5420, 5981, 6515, 7056, 7151, 7656, 8457, 8551, 8920, 9849, 10034, 10425, 10733, 11075, 11441]","[0, 194, 284, 374, 504, 765, 900, 990, 1208, 1582, 1717, 1861, 1972, 2067, 2266, 2577, 3095, 3596, 3812, 4730, 5024, 5119, 5343, 5437, 5532, 5794, 6503, 6631, 6937, 8602, 8698, 8933, 9033, 9419, 9934]",22103,19960,14762,11441,9934,-2826,-1799,2832,99,-828,-2522,35,radiant
7615326007,1,129,13,123,58,"[0, 169, 566, 925, 1324, 1488, 2098, 2477, 2768, 3158, 3708, 4276, 5660, 6128, 7011, 7489, 8662, 9648, 10843, 11804, 12872, 13840, 14958, 15697, 16087, 17218, 18413, 19484, 20793, 21196, 21353, 22399, 24189, 25374, 26744]","[0, 130, 414, 727, 973, 1550, 1724, 1853, 2314, 2537, 3168, 3728, 4467, 5161, 5829, 6375, 7243, 7935, 8281, 8710, 9425, 10095, 10606, 11271, 11944, 12220, 12841, 13318, 13882, 15331, 15984, 16447, 17003, 17491, 18381]","[0, 288, 606, 870, 1286, 1655, 2048, 2289, 2901, 3664, 4194, 4981, 5682, 6101, 6848, 7429, 7891, 8504, 8599, 9192, 9389, 9972, 10307, 10741, 10919, 11624, 12386, 13073, 13553, 13956, 14510, 14957, 15843, 16897, 18207]","[0, 130, 220, 310, 437, 835, 1046, 1181, 1518, 1608, 2276, 2572, 2990, 3248, 3562, 3844, 4399, 4752, 5182, 5590, 5770, 5926, 6093, 6339, 6633, 7226, 7912, 8267, 8554, 9296, 9618, 9932, 11002, 11668, 12177]","[0, 176, 266, 356, 800, 930, 1109, 1244, 1334, 1531, 1879, 2097, 2623, 2871, 3125, 3405, 3836, 4206, 4389, 4668, 4788, 4920, 5087, 5288, 5429, 5936, 6144, 6610, 7018, 7421, 7517, 8060, 8696, 9061, 9357]",26744,18381,18207,12177,9357,48,46,78,27,105,"[0, 282, 515, 894, 1194, 1485, 1949, 2321, 2904, 3256, 3596, 4273, 5047, 5771, 6526, 7687, 8559, 9467, 10605, 11668, 13091, 13814, 14852, 15610, 16100, 17120, 17849, 19020, 20383, 20928, 21199, 21922, 22281, 22984, 23999]","[0, 319, 664, 1076, 1356, 1743, 2262, 2683, 3261, 3812, 4324, 4980, 5070, 5392, 5996, 6548, 7429, 8113, 9291, 9779, 10577, 11019, 12193, 12821, 13136, 14023, 14322, 14506, 14752, 16321, 16947, 17093, 17533, 17633, 18409]","[0, 246, 451, 682, 1044, 1527, 1765, 1987, 2404, 2776, 3417, 3650, 3899, 4434, 4721, 5123, 5748, 6471, 7074, 7438, 8017, 8474, 8776, 9469, 9808, 10548, 10724, 10990, 11295, 12165, 12767, 13138, 13611, 13952, 14297]","[0, 210, 390, 496, 648, 738, 896, 1081, 1341, 1431, 1787, 2093, 2192, 2491, 2984, 3269, 4144, 4284, 5035, 5414, 6039, 6342, 6618, 6946, 7116, 7726, 8026, 8196, 8554, 9376, 9587, 9895, 10147, 10297, 10632]","[0, 210, 300, 428, 518, 608, 976, 1166, 1346, 1442, 1731, 1821, 2073, 2507, 2736, 3334, 3865, 4135, 4653, 4895, 5062, 5533, 5982, 6296, 6466, 7010, 7444, 7614, 8117, 8657, 8991, 9422, 9732, 10052, 10485]",23999,18409,14297,10632,10485,2745,-28,3910,1545,-1128,7044,35,radiant
7615645410,13,18,23,58,5,"[0, 206, 569, 852, 1106, 1425, 1727, 2278, 2657, 3051, 3497, 4229, 5409, 6046, 6566, 7077, 7276, 8089, 9217, 9539, 10313, 11147, 11632, 11896, 11990, 13246, 13897, 14152, 14832, 15569, 15879, 16800, 17833, 18772, 19917]","[0, 254, 570, 1118, 1656, 2080, 2731, 3083, 3689, 4202, 4375, 4811, 5751, 6463, 7271, 7896, 8100, 8733, 9031, 9826, 10710, 11542, 11722, 12367, 13082, 14042, 14827, 15386, 15698, 15794, 15971, 16547, 16647, 17004, 17657]","[0, 217, 393, 834, 1522, 1777, 2258, 2777, 3140, 3652, 4283, 4913, 5394, 6208, 6590, 7036, 7867, 8183, 8967, 9542, 9693, 10183, 10664, 10990, 11507, 11864, 12572, 12942, 13249, 13558, 13786, 14362, 14819, 15188, 15694]","[0, 170, 260, 394, 582, 877, 1000, 1474, 1579, 1794, 1992, 2336, 2748, 3262, 3658, 3976, 4071, 4425, 4849, 5121, 5859, 6186, 6366, 6710, 7460, 7668, 8394, 8610, 8917, 9013, 9148, 10277, 10427, 11015, 11515]","[100, 270, 395, 546, 757, 896, 1094, 1229, 1419, 1554, 1753, 2090, 2734, 2918, 3383, 3776, 3918, 4061, 4364, 4604, 4766, 4977, 5232, 5327, 5802, 5997, 6328, 6617, 6713, 6809, 6951, 7553, 8268, 8368, 8558]",19917,17657,15694,11515,8558,82,55,19,62,40,"[0, 239, 533, 900, 1101, 1514, 1876, 2421, 2674, 3205, 3516, 4054, 4827, 5369, 6014, 6904, 7837, 9065, 10305, 11578, 12849, 13902, 15176, 15970, 16573, 17939, 19522, 20878, 22677, 24432, 25512, 27244, 29067, 30481, 31857]","[0, 206, 410, 534, 1247, 1516, 1758, 2923, 3352, 3975, 4541, 5237, 5683, 6058, 6796, 7397, 8412, 9055, 9734, 10065, 10584, 11190, 12143, 12699, 13360, 14030, 14355, 14525, 16139, 16813, 17571, 18452, 18830, 19202, 19740]","[0, 245, 540, 882, 1319, 1637, 2053, 2235, 2482, 2973, 3555, 4136, 4653, 5272, 5483, 6632, 7443, 7705, 7975, 8669, 9221, 9823, 10586, 11613, 11869, 12298, 13000, 13466, 13672, 14380, 14838, 15777, 16670, 17411, 18016]","[0, 170, 260, 350, 536, 684, 810, 1104, 1459, 1640, 1833, 2073, 3043, 3245, 3394, 3986, 4684, 4790, 5235, 5631, 6095, 6309, 7041, 7965, 8221, 8396, 8581, 9028, 10431, 10799, 11057, 11861, 12306, 12542, 12777]","[0, 170, 260, 350, 501, 595, 685, 889, 1101, 1279, 1552, 1895, 2190, 2432, 2984, 3211, 3857, 3976, 4583, 5045, 5363, 5577, 6963, 7290, 7815, 8158, 8456, 9205, 10177, 10772, 11143, 12256, 12820, 13102, 13337]",31857,19740,18016,12777,13337,-11940,-2083,-2322,-1262,-4779,-22386,35,dire
7615652918,21,36,96,109,20,"[0, 311, 561, 899, 1271, 1836, 2173, 2581, 2994, 3661, 3934, 4426, 5011, 5745, 6546, 6716, 7188, 7447, 7877, 8727, 9308, 9790, 10458, 11517, 12174, 12431, 12780, 13121, 13217, 13606, 14133, 14904, 15737, 16119, 16219]","[0, 238, 509, 711, 1031, 1198, 1498, 1773, 2245, 2595, 2820, 3266, 3541, 4172, 4560, 5259, 5875, 6100, 6305, 7263, 7867, 8150, 8536, 9015, 10057, 10314, 11041, 11999, 12269, 13025, 13689, 14746, 14846, 15048, 15223]","[0, 266, 775, 1183, 1466, 1642, 2132, 2567, 2982, 3439, 3960, 4344, 4776, 5533, 6076, 6240, 6698, 7364, 7619, 8339, 8847, 9299, 9788, 10105, 10371, 11257, 11669, 12085, 12376, 12636, 13375, 14247, 14347, 14629, 14973]","[0, 195, 374, 464, 636, 742, 877, 1088, 1178, 1559, 1785, 2089, 2398, 2710, 3393, 3582, 4205, 4300, 4488, 5216, 5672, 6910, 7148, 7776, 8466, 9705, 10070, 10329, 10602, 10755, 11048, 12163, 12686, 13448, 13679]","[0, 195, 285, 375, 684, 774, 1031, 1263, 1353, 1653, 1834, 2008, 2279, 2572, 2815, 2928, 3309, 3455, 3745, 4143, 4699, 5083, 5297, 5699, 6040, 6664, 6924, 7510, 7774, 7941, 8531, 9201, 9543, 9992, 10092]",16219,15223,14973,13679,10092,52,93,71,123,121,"[0, 256, 457, 837, 1174, 1475, 2046, 2664, 3068, 3408, 3727, 4247, 4760, 5461, 6255, 6890, 7445, 7807, 8667, 9194, 9352, 10164, 11336, 12029, 12508, 12781, 13558, 14321, 15649, 16870, 17430, 19304, 20451, 21039, 22366]","[0, 208, 509, 634, 888, 1129, 1334, 1744, 2076, 2268, 2674, 3336, 3952, 4631, 5229, 5830, 6936, 7472, 8123, 8408, 9092, 9636, 10743, 11795, 12583, 13764, 14136, 15251, 15875, 17008, 17592, 18395, 18905, 19663, 20653]","[0, 170, 370, 549, 1105, 1710, 2035, 2651, 3141, 3775, 4359, 4980, 5537, 6096, 6667, 7590, 8098, 8779, 9121, 9493, 10145, 10806, 11453, 11548, 11931, 12831, 13583, 14361, 15278, 15745, 16246, 16728, 17189, 17613, 18348]","[0, 170, 260, 402, 882, 1347, 1482, 1972, 2252, 2644, 3387, 3987, 4167, 4538, 5171, 5626, 6364, 7167, 7479, 7708, 8270, 8880, 9548, 10089, 10674, 11112, 11296, 12513, 13116, 13475, 13749, 14383, 14618, 15383, 15889]","[100, 316, 406, 496, 586, 740, 920, 1175, 1265, 1355, 1525, 1895, 2075, 2331, 2479, 2804, 3166, 3339, 3496, 3591, 3749, 4048, 4419, 4739, 4879, 5299, 5769, 6158, 6597, 7122, 7371, 8228, 8660, 8820, 9646]",22366,20653,18348,15889,9646,-6147,-5430,-3375,-2210,446,-16716,35,dire
7616110516,18,98,43,45,121,"[0, 243, 407, 691, 1032, 1601, 1939, 2318, 2754, 3093, 3792, 4561, 5461, 6448, 6961, 7939, 8765, 9795, 10125, 10939, 11522, 11850, 13667, 14298, 15456, 15788, 17228, 18208, 18850, 19511, 19607, 20270, 21052, 22133, 22233]","[0, 250, 491, 891, 1304, 1604, 1994, 2489, 2893, 3240, 3938, 4604, 5309, 5976, 6108, 6372, 6833, 7756, 8173, 8778, 9550, 9688, 9819, 10410, 11727, 12896, 13430, 13525, 13709, 14556, 15236, 15336, 15482, 16038, 16819]","[0, 213, 550, 809, 957, 1279, 1920, 2260, 2603, 2993, 3608, 4380, 4838, 5405, 5573, 5915, 6213, 6513, 7172, 7967, 8776, 9527, 9739, 10084, 11486, 12253, 12347, 12998, 13350, 14513, 15222, 15956, 16056, 16694, 17345]","[0, 182, 320, 410, 500, 653, 840, 1065, 1200, 1375, 2146, 2470, 2662, 3145, 3367, 3618, 3775, 3870, 4100, 4620, 4981, 5128, 5309, 5461, 5860, 6833, 7062, 7406, 7574, 8119, 8490, 9030, 9130, 10288, 10413]","[0, 130, 220, 310, 537, 642, 939, 1362, 1713, 2053, 2362, 2506, 2849, 3239, 3334, 3587, 3753, 4033, 4263, 4546, 4964, 5059, 5193, 5485, 6529, 6971, 7292, 7591, 7687, 8276, 8372, 8627, 8743, 9322, 9471]",22233,16819,17345,10413,9471,53,46,78,100,30,"[59, 375, 586, 988, 1279, 1515, 2429, 2748, 2966, 3363, 4057, 4460, 5049, 5869, 6843, 7252, 7777, 8276, 8942, 9811, 10769, 11923, 12473, 13293, 14393, 15202, 15974, 16527, 17353, 17721, 20769, 22020, 23546, 25299, 25950]","[59, 316, 740, 1204, 1416, 1685, 1894, 2261, 2648, 3103, 3600, 4106, 4352, 4599, 5676, 6452, 7243, 7982, 8757, 9636, 10579, 11544, 12692, 13268, 13892, 14468, 15279, 15845, 16530, 17035, 17772, 18272, 19493, 20978, 22252]","[59, 308, 591, 848, 1084, 1337, 1700, 2103, 2434, 2806, 3389, 3941, 4515, 5367, 6030, 6522, 6913, 7310, 7890, 8560, 9189, 9716, 10428, 11321, 11753, 11953, 12625, 13429, 14016, 14197, 15573, 16264, 17718, 18694, 19090]","[59, 269, 359, 497, 627, 761, 869, 1449, 1539, 1694, 2239, 2457, 2654, 2803, 3266, 3600, 3795, 4117, 4261, 4683, 5168, 5652, 6021, 6187, 6533, 6945, 7520, 7869, 8124, 8230, 8785, 9244, 10133, 11034, 11314]","[327, 537, 627, 786, 976, 1066, 1277, 1586, 1713, 1803, 1983, 2216, 2403, 2552, 3239, 3338, 3706, 3973, 4121, 4398, 5107, 5769, 6101, 6470, 6716, 7124, 7511, 7606, 7783, 8289, 8738, 8928, 10180, 11241, 11521]",25950,22252,19090,11314,11521,-3717,-5433,-1745,-901,-2050,-13846,35,dire
7616158604,67,109,112,137,100,"[0, 89, 417, 674, 799, 923, 1262, 1721, 2110, 2348, 2808, 3231, 3947, 5218, 5821, 6194, 6803, 7885, 8546, 9097, 9913, 10878, 11811, 12281, 13352, 14279, 14600, 15596, 16734, 17869, 18957, 19537, 19637, 20776, 21266]","[0, 169, 259, 349, 439, 529, 709, 1282, 1514, 1719, 1985, 2187, 2879, 3312, 3765, 3970, 4466, 4759, 5480, 5877, 6423, 7039, 7628, 8013, 8713, 9632, 10486, 11264, 11633, 12373, 13110, 14153, 15031, 15802, 16048]","[0, 474, 716, 930, 1570, 1765, 1983, 2271, 2813, 3237, 3793, 4217, 4663, 4938, 5502, 5932, 6153, 7263, 7943, 8954, 9636, 10362, 10783, 11240, 11434, 11765, 12276, 12927, 13409, 14373, 14689, 14879, 15333, 15548, 15648]","[0, 240, 416, 747, 873, 1086, 1372, 1633, 2021, 2426, 2677, 3068, 3694, 4394, 4764, 5247, 6174, 6521, 6895, 7160, 7957, 8311, 8750, 9234, 10188, 10996, 11226, 11813, 12537, 13213, 13773, 14828, 14928, 15028, 15166]","[0, 169, 259, 349, 603, 693, 873, 1008, 1098, 1370, 1550, 1928, 2447, 2865, 3332, 3836, 4423, 4751, 5447, 5645, 6316, 6547, 6714, 6808, 7167, 7648, 7878, 8268, 8670, 9456, 9867, 10407, 10507, 10607, 10789]",21266,16048,15648,15166,10789,49,21,76,9,65,"[0, 409, 606, 885, 1336, 1708, 2234, 2738, 3127, 3900, 4563, 5118, 5327, 5568, 6546, 7139, 7555, 8157, 9017, 9832, 10184, 10502, 11254, 11833, 12558, 12725, 13420, 14308, 15063, 15159, 15649, 17025, 18068, 18270, 20054]","[0, 324, 748, 1121, 1462, 1787, 2253, 2766, 3055, 3572, 4013, 4517, 4657, 5290, 5631, 6075, 6336, 6803, 6898, 7055, 7749, 8468, 8964, 9058, 10164, 10446, 11170, 11817, 12553, 12649, 13205, 14732, 15919, 16303, 18279]","[0, 337, 703, 1049, 1503, 1802, 2263, 2718, 3530, 3850, 4288, 4687, 4962, 5111, 5445, 5809, 6102, 6596, 6709, 7254, 7540, 7759, 8651, 9019, 9718, 9885, 10852, 10983, 11443, 11700, 12246, 13941, 14423, 15076, 17245]","[0, 249, 339, 476, 706, 963, 1165, 1394, 1591, 1980, 2323, 2628, 2988, 3528, 3861, 4441, 4599, 4782, 4877, 5245, 5558, 5661, 6316, 6527, 6873, 7115, 7352, 7573, 7890, 8024, 8120, 9888, 10346, 10886, 12025]","[0, 249, 339, 429, 612, 826, 979, 1223, 1383, 1636, 1891, 2468, 2866, 3142, 3907, 4001, 4321, 4795, 5083, 5240, 5335, 5430, 6223, 6548, 6803, 6970, 7446, 7711, 8146, 8242, 8626, 9739, 9929, 10230, 11525]",20054,18279,17245,12025,11525,1212,-2231,-1597,3141,-736,-211,35,dire
7616192306,73,21,78,45,20,"[328, 692, 1121, 1323, 1699, 2528, 3005, 3825, 4499, 5641, 6409, 7047, 7998, 8624, 9124, 10364, 10933, 11869, 12734, 13841, 15187, 16129, 17386, 18547, 19661, 20514, 21921, 22288, 23509, 24660, 25249, 26607, 27709, 28330, 29250]","[58, 633, 874, 1296, 1707, 2069, 2784, 3392, 3938, 5024, 5314, 5933, 6735, 6830, 7830, 8342, 9121, 9873, 10602, 11101, 11690, 12160, 12409, 12959, 13256, 14149, 14581, 14965, 15630, 16452, 16663, 17696, 18692, 19366, 20109]","[58, 314, 601, 802, 1160, 1489, 2052, 2525, 3249, 3793, 4255, 4382, 4788, 5355, 6351, 6630, 7112, 7819, 8074, 8445, 9241, 9782, 10163, 10708, 11114, 11800, 12129, 12223, 12698, 13846, 14128, 15004, 15664, 15874, 16277]","[58, 415, 697, 787, 923, 1659, 1794, 2163, 2405, 2752, 3015, 3392, 3688, 4088, 4799, 5182, 5883, 6455, 6964, 7496, 8117, 8230, 8815, 9047, 9569, 9997, 10349, 10518, 10855, 11325, 11596, 11826, 12091, 12613, 12803]","[58, 576, 666, 756, 846, 1006, 1217, 1408, 1578, 1790, 1970, 2132, 2312, 2484, 2723, 2939, 3266, 3593, 3688, 3845, 4255, 4350, 4517, 4797, 4896, 5444, 5729, 5870, 6170, 6639, 6850, 7040, 7456, 7666, 7856]",29250,20109,16277,12803,7856,48,29,106,100,64,"[0, 205, 490, 990, 1245, 1796, 2038, 2200, 2362, 2730, 3206, 3856, 4472, 5115, 5878, 6562, 7009, 8071, 8804, 9534, 10477, 11911, 12817, 14087, 15175, 16251, 17167, 18025, 18865, 19953, 20937, 21783, 23205, 23789, 25126]","[0, 243, 509, 925, 1217, 1396, 1800, 2369, 3005, 3651, 4165, 4990, 5475, 5942, 6446, 6840, 7121, 7875, 8225, 9223, 10060, 10477, 11205, 12257, 12794, 13357, 13737, 14696, 15022, 15721, 16093, 16714, 17595, 17887, 18514]","[0, 473, 746, 1029, 1286, 1673, 1763, 2104, 2513, 2693, 3073, 3228, 3487, 3827, 4394, 4694, 4942, 5618, 5713, 6055, 6449, 6909, 7004, 8116, 8518, 8879, 9116, 10012, 10499, 11031, 11247, 11457, 11725, 12354, 12791]","[0, 254, 381, 755, 915, 1067, 1340, 2078, 2321, 2501, 2791, 3190, 3280, 3960, 4921, 5061, 5555, 5871, 5966, 6350, 6652, 7136, 7695, 8153, 8534, 9107, 9298, 10008, 10267, 10518, 10782, 11158, 11258, 11696, 11983]","[0, 254, 344, 676, 766, 1045, 1135, 1225, 1403, 1583, 1964, 2475, 2565, 2969, 3364, 3557, 3838, 4068, 4333, 4545, 4909, 5547, 5717, 6802, 6972, 7426, 7596, 8425, 8950, 9265, 9556, 10007, 10230, 10405, 10580]",25126,18514,12791,11983,10580,4124,1595,3486,820,-2724,7301,35,dire
7616790114,96,120,95,53,112,"[328, 684, 948, 1434, 1784, 2529, 2854, 3421, 3909, 4721, 5260, 5697, 6176, 6415, 7147, 7807, 8144, 8676, 9167, 9724, 10371, 10998, 11649, 12702, 13736, 13903, 14099, 14672, 15119, 15825, 16288, 17060, 18379, 18479, 18945]","[60, 456, 743, 1186, 1680, 2084, 2887, 3488, 4028, 4313, 4962, 5527, 5862, 6338, 7001, 7561, 7910, 8167, 8878, 9734, 10066, 10549, 11516, 11854, 12187, 13097, 13674, 14427, 14766, 15353, 15845, 16035, 17335, 17534, 18523]","[60, 390, 641, 731, 949, 1287, 1614, 1886, 2240, 2711, 3082, 3331, 3894, 4537, 4984, 5565, 6501, 7202, 8032, 8325, 9310, 9964, 10779, 10874, 11502, 11669, 12283, 13766, 14379, 15016, 15644, 15983, 17466, 17566, 18017]","[60, 476, 610, 938, 1479, 1894, 2140, 2230, 2320, 2605, 3230, 3470, 4030, 4526, 5176, 5614, 6360, 6599, 7058, 7286, 8053, 9445, 9764, 10035, 10536, 10900, 11462, 12080, 12907, 14292, 14469, 15172, 15545, 15775, 16494]","[60, 294, 384, 782, 1025, 1391, 1481, 1644, 1781, 2066, 2330, 2464, 2746, 2937, 3208, 3580, 3738, 4173, 4419, 4514, 5254, 5681, 6143, 6238, 6628, 6875, 7132, 7621, 7792, 8561, 8840, 9182, 9787, 9973, 10148]",18945,18523,18017,16494,10148,46,17,23,123,5,"[0, 203, 490, 903, 1029, 1263, 1673, 2103, 2474, 3160, 3731, 4332, 5540, 6297, 7389, 8133, 9895, 10258, 10907, 11577, 12368, 13006, 13348, 14668, 15415, 16663, 17437, 17661, 18234, 18500, 19126, 20296, 22846, 23200, 24265]","[0, 462, 858, 1265, 1604, 2027, 2187, 2919, 3611, 4057, 4521, 4909, 5130, 5428, 6179, 6607, 7801, 8081, 8453, 9040, 9281, 9376, 9730, 11112, 12121, 12971, 13388, 14344, 15039, 15682, 16148, 16635, 18646, 18746, 19563]","[0, 334, 775, 1309, 1709, 2077, 2637, 3192, 4009, 4562, 4856, 5731, 6283, 6822, 7616, 8003, 8838, 9695, 10052, 10643, 11260, 11355, 11962, 13185, 13678, 14495, 15182, 15922, 16494, 17215, 17311, 17969, 18229, 18483, 19512]","[0, 348, 513, 684, 995, 1125, 1436, 1526, 1616, 1966, 2241, 2651, 2741, 3008, 3509, 3880, 4292, 4387, 4813, 5168, 5453, 5750, 5844, 7015, 7777, 8034, 8823, 9233, 9640, 9927, 10219, 10365, 12020, 13180, 13505]","[0, 564, 700, 837, 1013, 1225, 1417, 1622, 2161, 2546, 2699, 3248, 3603, 3886, 4260, 4457, 5157, 5252, 5438, 6044, 6253, 6423, 6592, 7593, 8136, 8468, 8785, 9329, 9769, 10137, 10233, 10333, 10768, 11064, 11505]",24265,19563,19512,13505,11505,-5320,-1040,-1495,2989,-1357,-6223,35,dire
7616882903,1,76,98,27,5,"[0, 154, 410, 691, 937, 1295, 1587, 1911, 2153, 2394, 2683, 2864, 3453, 3968, 4566, 5152, 5786, 6482, 7211, 7829, 8687, 9379, 10584, 11139, 12308, 13359, 14047, 14908, 15932, 17122, 18090, 18847, 18947, 19543, 21054]","[0, 242, 528, 767, 1192, 1614, 2368, 2706, 3033, 3457, 4086, 4794, 5347, 6210, 6803, 7403, 7517, 8735, 9288, 9822, 10176, 10698, 11571, 12482, 13211, 14251, 14654, 15848, 16639, 17216, 17793, 18094, 18402, 18780, 19293]","[0, 239, 488, 791, 1084, 1610, 1874, 2211, 2417, 2772, 3411, 3858, 4739, 5255, 5883, 6382, 7026, 7950, 8710, 9620, 10237, 10518, 11143, 12134, 12682, 13344, 13667, 14097, 14803, 15442, 16482, 17577, 17832, 18277, 18591]","[0, 154, 244, 488, 717, 936, 1219, 1309, 1399, 1571, 1937, 2152, 2638, 3255, 3404, 4146, 4241, 4579, 4935, 5191, 5831, 6097, 6516, 6738, 6956, 7126, 7421, 8081, 8660, 8995, 9742, 10126, 10273, 10997, 11341]","[0, 154, 244, 462, 721, 894, 1065, 1155, 1370, 1732, 2004, 2149, 2547, 2977, 3178, 3549, 3644, 3998, 4237, 4615, 4886, 5542, 5847, 5942, 6037, 6344, 6528, 6729, 7016, 7328, 7659, 7849, 8251, 8641, 8831]",21054,19293,18591,11341,8831,72,21,129,85,105,"[0, 258, 610, 898, 1311, 1609, 1900, 2345, 2815, 3242, 3845, 4292, 5114, 5618, 6186, 6983, 7752, 8923, 9612, 10945, 11618, 12258, 13317, 13996, 14845, 16129, 17449, 17894, 19017, 20230, 21589, 23003, 24240, 25392, 26812]","[0, 378, 629, 927, 1309, 1641, 2065, 2561, 3017, 3311, 3955, 4374, 4802, 5429, 6049, 6740, 7423, 7811, 8604, 9326, 10050, 10652, 10998, 11301, 12234, 13045, 13964, 14648, 15515, 15940, 17020, 17616, 18135, 18951, 19554]","[0, 290, 722, 1037, 1357, 1765, 2140, 2602, 3142, 3754, 4211, 4969, 5462, 5751, 6228, 6501, 7326, 7747, 8411, 8982, 9129, 9827, 10597, 11167, 12025, 12769, 13298, 13785, 14654, 15383, 15527, 16323, 17241, 17711, 18252]","[0, 209, 299, 409, 545, 669, 844, 1070, 1202, 1375, 1533, 1715, 2156, 2399, 2598, 2979, 3521, 3763, 4187, 4517, 4687, 4947, 5371, 5702, 6051, 6621, 7150, 7449, 7946, 8271, 9126, 9584, 10178, 10478, 10833]","[0, 209, 636, 726, 845, 1005, 1095, 1350, 1575, 1710, 1845, 2288, 2819, 2914, 3141, 3455, 3724, 3857, 4125, 4551, 4646, 4958, 5323, 5418, 5929, 6299, 6928, 7164, 7586, 7792, 8536, 9335, 9850, 10075, 10633]",26812,19554,18252,10833,10633,-5758,-261,339,508,-1802,-6974,35,dire
7617881416,126,95,96,121,101,"[332, 724, 1039, 1237, 1535, 1950, 2400, 2867, 3484, 4080, 4375, 5047, 5646, 6121, 6297, 6726, 7487, 7990, 8583, 9600, 10491, 10857, 11852, 12610, 13172, 13773, 14158, 14253, 14560, 15627, 16344, 16946, 17660, 17877, 18334]","[64, 310, 568, 1017, 1262, 1511, 1855, 2066, 2345, 2542, 2984, 3974, 4327, 4828, 5279, 5905, 7152, 7523, 8241, 9151, 9523, 9980, 10356, 11898, 12813, 13389, 14098, 14193, 14594, 15296, 15979, 17433, 18316, 18614, 19843]","[64, 351, 677, 996, 1327, 1867, 2260, 2606, 2942, 3492, 3966, 4329, 4959, 5157, 5696, 6076, 7398, 8034, 8355, 8797, 9344, 10590, 11145, 12100, 12974, 13249, 14041, 14584, 14962, 15733, 16487, 18017, 18959, 19471, 20050]","[64, 325, 415, 572, 708, 831, 1054, 1144, 1500, 1696, 1838, 2299, 2532, 2800, 3115, 3292, 4064, 4222, 4426, 4584, 5159, 5525, 5778, 6523, 6798, 6892, 7285, 7380, 7476, 7902, 7998, 9170, 9417, 9640, 10496]","[64, 274, 364, 490, 629, 882, 1105, 1321, 1549, 1729, 1864, 2228, 2597, 2795, 2889, 2984, 3590, 3784, 3934, 4433, 4740, 5106, 6111, 6503, 6778, 7068, 7819, 7914, 8010, 8632, 8828, 9839, 10056, 10156, 10770]",18334,19843,20050,10496,10770,70,53,135,104,123,"[0, 216, 559, 845, 1125, 1475, 1727, 2198, 2613, 2900, 3541, 4321, 4546, 6171, 6788, 7520, 7809, 8319, 8856, 9762, 10591, 11243, 11645, 12226, 12634, 13262, 14528, 15770, 16487, 17210, 17815, 18801, 18901, 19397, 21509]","[0, 130, 220, 606, 776, 1176, 1704, 1908, 2074, 2723, 2878, 3358, 3675, 4178, 4688, 5035, 5388, 6210, 6801, 7124, 7505, 8046, 8448, 8877, 9112, 9724, 10626, 11822, 12604, 13251, 13347, 14149, 14249, 15134, 16306]","[0, 206, 447, 741, 1028, 1451, 1762, 2059, 2268, 2449, 2754, 3280, 3503, 4222, 4616, 4933, 5210, 5780, 6497, 6941, 7343, 7695, 8334, 8748, 9163, 9919, 10095, 11240, 11951, 12183, 12658, 13560, 13958, 14460, 15632]","[0, 239, 592, 867, 1124, 1564, 1777, 1907, 2457, 2699, 3113, 3642, 4141, 4891, 5177, 5528, 6081, 6904, 7124, 7514, 8083, 8640, 9201, 9561, 9910, 10293, 10621, 11329, 11891, 11987, 12465, 13106, 13206, 13414, 14238]","[0, 130, 220, 418, 611, 845, 1511, 1678, 1768, 1996, 2387, 2720, 2893, 3554, 3875, 4215, 4922, 5414, 5775, 6151, 6710, 7037, 7341, 8021, 8762, 9111, 9945, 10769, 11194, 11617, 12373, 12730, 13272, 13588, 14111]",21509,16306,15632,14238,14111,-3175,3537,4418,-3742,-3341,-2303,35,dire
7618039602,52,61,2,105,121,"[94, 351, 728, 1076, 1581, 2025, 2829, 3427, 4202, 4500, 5442, 6184, 7126, 7971, 8421, 9058, 10013, 10622, 11361, 12277, 13040, 13856, 14423, 16119, 17028, 18072, 19012, 19589, 20580, 21353, 22144, 23032, 23572, 24518, 25638]","[0, 273, 558, 921, 1159, 1490, 1716, 2066, 2259, 2768, 3155, 3679, 4129, 4848, 5356, 6252, 6862, 7577, 8072, 9021, 9765, 10103, 10769, 11550, 12321, 13323, 13883, 14837, 15975, 16874, 17324, 18213, 19200, 20101, 20446]","[0, 219, 774, 1179, 1637, 2333, 2915, 3159, 3810, 4395, 5320, 5911, 6283, 7734, 8238, 8963, 10008, 10711, 11267, 11754, 12422, 13057, 13302, 13457, 13552, 14089, 14351, 14932, 15677, 15991, 16530, 16797, 17514, 17721, 18066]","[245, 414, 577, 697, 858, 1119, 1254, 1817, 2330, 2420, 3002, 3142, 3353, 3943, 4171, 4514, 4867, 5007, 5447, 5868, 6759, 7126, 7577, 7805, 7900, 8666, 8916, 9011, 9793, 10109, 10293, 10916, 11551, 11969, 12522]","[79, 263, 387, 523, 613, 703, 889, 1076, 1537, 1627, 2341, 2538, 2798, 3548, 3693, 3900, 4187, 4506, 4600, 5050, 5494, 5971, 6137, 6396, 6491, 7244, 7448, 7543, 7845, 8171, 8267, 8722, 8912, 9385, 9854]",25638,20446,18066,12522,9854,89,33,38,19,5,"[61, 269, 637, 991, 1364, 1716, 1999, 2226, 2956, 3354, 3657, 4046, 4716, 5331, 5900, 6510, 7429, 7996, 9112, 9818, 10615, 11382, 12821, 13669, 14460, 15319, 15930, 16866, 17376, 18124, 18597, 19325, 20403, 21207, 21645]","[61, 302, 668, 1155, 1596, 2200, 2877, 3266, 4181, 4646, 5352, 5714, 6103, 6373, 6574, 7246, 7589, 8062, 8622, 9134, 9898, 10475, 11007, 11571, 12302, 12936, 13619, 14091, 14327, 14484, 14703, 14980, 15391, 15733, 16003]","[329, 571, 868, 1343, 1675, 2156, 2449, 2733, 3040, 3541, 3933, 4133, 4740, 5248, 5479, 5938, 6376, 6821, 7202, 7559, 7843, 8270, 9051, 9436, 9818, 10148, 10597, 11029, 11274, 11519, 11814, 12274, 13016, 13477, 14066]","[61, 230, 350, 566, 727, 967, 1150, 1662, 1921, 2011, 2236, 2326, 2492, 2645, 3044, 3430, 4059, 4523, 4620, 4715, 4999, 5300, 5983, 6317, 7279, 7787, 8426, 8864, 8960, 9056, 9183, 9340, 9836, 10539, 10639]","[61, 230, 384, 504, 643, 808, 1065, 1638, 1863, 1953, 2178, 2268, 2440, 2643, 2891, 3031, 3189, 3284, 3574, 3669, 3953, 4230, 4707, 4802, 5007, 5356, 5540, 5635, 6026, 6122, 6218, 6367, 6881, 7067, 7170]",21645,16003,14066,10639,7170,3993,4443,4000,1883,2684,17003,35,radiant
7618139706,60,18,129,86,128,"[0, 291, 563, 835, 1521, 1768, 2083, 2648, 3278, 3657, 4338, 5120, 5507, 6074, 6592, 6984, 7426, 8337, 8934, 9464, 9847, 10224, 10727, 11560, 12149, 12423, 12737, 13554, 14930, 15999, 17388, 18301, 18832, 19486, 20430]","[0, 328, 642, 1083, 1505, 1713, 1997, 2524, 2888, 3192, 3585, 4132, 4660, 5644, 6359, 6835, 7858, 8961, 9056, 10060, 10676, 11126, 11527, 12450, 13252, 13865, 14495, 14937, 15381, 16104, 16970, 17866, 18942, 19814, 20485]","[0, 331, 579, 932, 1264, 1505, 1934, 2059, 2383, 2711, 3329, 3885, 4518, 5259, 5953, 6234, 6690, 7087, 7182, 7757, 8051, 8607, 8803, 9219, 9936, 10669, 10764, 10985, 11512, 12067, 12846, 13315, 13720, 13927, 14263]","[0, 209, 299, 471, 645, 735, 825, 950, 1254, 1415, 1958, 2716, 3196, 3452, 4180, 4275, 4576, 5427, 5522, 5943, 6037, 6628, 7088, 7291, 7781, 8459, 8804, 9318, 10286, 10688, 11232, 11469, 11659, 12419, 12609]","[0, 209, 299, 389, 957, 1047, 1137, 1434, 1610, 1752, 2210, 2719, 3199, 3690, 4040, 4328, 4444, 4931, 5300, 5816, 6399, 6713, 6924, 7116, 7608, 7775, 7906, 8127, 8708, 9503, 9599, 10294, 10914, 11300, 11795]",20430,20485,14263,12609,11795,73,10,120,105,121,"[0, 207, 335, 860, 1074, 1807, 2242, 2789, 3662, 4066, 4688, 5277, 5552, 6101, 6978, 8029, 9135, 10423, 11002, 11223, 12397, 12983, 14789, 15512, 16303, 17209, 17602, 19042, 19462, 19743, 20712, 21810, 22527, 23200, 23626]","[0, 129, 360, 768, 1019, 1454, 1778, 2138, 2497, 2876, 3167, 3822, 4219, 4906, 5471, 6067, 6688, 6998, 7650, 8205, 8588, 8956, 10599, 11419, 12381, 13465, 14444, 16485, 17212, 18182, 18517, 19032, 19302, 19537, 20699]","[0, 248, 528, 911, 1274, 1716, 2077, 2502, 3042, 3510, 4211, 4996, 5543, 5803, 6344, 7170, 7979, 8074, 8872, 9591, 10511, 11021, 11764, 12243, 12770, 13658, 14684, 15802, 16561, 17107, 17563, 17663, 18516, 19136, 19608]","[0, 129, 219, 433, 570, 832, 967, 1327, 1683, 1821, 2183, 2498, 2694, 2870, 3063, 3428, 3668, 4078, 4525, 4955, 5228, 5591, 5925, 6331, 6607, 7191, 7502, 8051, 9080, 9660, 10428, 10844, 11150, 11407, 11787]","[0, 129, 263, 353, 443, 619, 805, 1016, 1326, 1416, 1593, 1683, 1918, 2218, 2365, 2650, 2870, 3214, 3796, 4178, 4468, 4773, 5191, 5492, 5697, 5998, 6290, 6619, 7086, 7351, 7447, 7547, 7693, 7928, 8308]",23626,20699,19608,11787,8308,-3196,-214,-5345,822,3487,-4446,35,dire
7618205704,82,2,106,65,83,"[0, 245, 526, 938, 1312, 1969, 2414, 2983, 3500, 3999, 4426, 4853, 5620, 6194, 6934, 8324, 9183, 10243, 10978, 12245, 13409, 14420, 14708, 16223, 16902, 18238, 19508, 20526, 21721, 22283, 22874, 24291, 25428, 25661, 25929]","[0, 279, 479, 805, 1366, 1810, 2268, 2561, 2701, 3017, 3723, 4271, 5250, 5734, 6230, 7335, 7798, 8545, 9412, 9851, 10801, 11771, 12507, 13610, 14414, 15745, 16600, 17002, 18005, 18634, 19167, 20446, 21698, 21798, 22803]","[0, 309, 590, 835, 1081, 1340, 1856, 1990, 2403, 2575, 2965, 3327, 3554, 4144, 4711, 5414, 6094, 6725, 7446, 7955, 8626, 8951, 9290, 10095, 10756, 11342, 12409, 12993, 13781, 14523, 14928, 15795, 16801, 17095, 17195]","[0, 195, 285, 422, 638, 768, 997, 1087, 1465, 1637, 2206, 2431, 2788, 3038, 3319, 4089, 5210, 5694, 6020, 6589, 7154, 7392, 7869, 8151, 8660, 9246, 10115, 10553, 11417, 12567, 13201, 13571, 14580, 14680, 15521]","[0, 195, 285, 375, 584, 852, 1153, 1291, 1508, 1731, 1866, 2152, 2242, 2584, 2801, 3435, 3781, 4216, 4365, 4676, 5010, 5214, 5381, 5698, 6120, 6580, 7236, 7566, 8111, 8605, 8863, 9233, 10196, 10296, 10564]",25929,22803,17195,15521,10564,10,23,114,88,5,"[0, 240, 482, 778, 1319, 1744, 2304, 2791, 3261, 3821, 4451, 5248, 5914, 6499, 7124, 7501, 8304, 8818, 9324, 9781, 10237, 10822, 12454, 13288, 14235, 14774, 15705, 16199, 16732, 18477, 18982, 20213, 20909, 23449, 24269]","[0, 216, 613, 1236, 1921, 2193, 2561, 2782, 3317, 3850, 4214, 4882, 5393, 6129, 6756, 7272, 7603, 7749, 8114, 8839, 8978, 9240, 10114, 10439, 11052, 11254, 11545, 11754, 12022, 12433, 12672, 13907, 14224, 16864, 17141]","[0, 326, 688, 1072, 1451, 1864, 2200, 2826, 3113, 3897, 4424, 5132, 5515, 5766, 6068, 6481, 6923, 7365, 7663, 8207, 8610, 9104, 9638, 10255, 10854, 11092, 11451, 11638, 11768, 13302, 13877, 14714, 14814, 14914, 16013]","[0, 170, 260, 500, 724, 814, 940, 1174, 1591, 1726, 2427, 2820, 3353, 3764, 3970, 4065, 4582, 4819, 5374, 5558, 5904, 6159, 6931, 7213, 7383, 7624, 7794, 7964, 8135, 9460, 9631, 10362, 10537, 11951, 12204]","[0, 170, 260, 386, 476, 648, 738, 873, 1208, 1478, 1698, 2032, 2174, 2479, 2938, 3148, 3429, 3523, 3749, 3936, 4031, 4163, 5132, 5227, 5322, 5488, 5632, 5839, 5980, 6452, 6854, 7647, 8027, 9560, 10030]",24269,17141,16013,12204,10030,1660,5662,1182,3317,534,12355,35,radiant
7618629204,89,22,69,21,20,"[0, 164, 366, 612, 931, 1257, 1920, 2163, 2668, 3053, 3546, 4299, 4789, 5903, 6444, 7416, 8424, 9543, 9981, 10245, 10907, 11002, 12340, 13177, 14170, 14540, 16401, 17012, 17108, 17909, 18189, 18289, 19338, 19688, 19834]","[0, 172, 430, 804, 1239, 1603, 1893, 2354, 2741, 3581, 4482, 4731, 5593, 6527, 7112, 7296, 7768, 8291, 9167, 9901, 10432, 11955, 12600, 13121, 13477, 13958, 14718, 15614, 16100, 16622, 17184, 17858, 18655, 19621, 20274]","[0, 207, 634, 976, 1269, 1551, 1980, 2405, 2935, 3377, 4184, 4753, 5490, 6460, 7077, 7716, 8158, 9045, 9672, 10215, 10880, 11801, 12658, 13022, 13277, 13765, 14783, 15141, 15794, 16255, 16717, 17549, 18249, 19197, 19962]","[0, 131, 611, 970, 1100, 1288, 1391, 1525, 1797, 2062, 2568, 2804, 3056, 3458, 3859, 4152, 4432, 4874, 5415, 5869, 6138, 7271, 7510, 7797, 7963, 8460, 9102, 9768, 10038, 10677, 11274, 11590, 12499, 12944, 14146]","[0, 129, 219, 358, 523, 699, 1020, 1110, 1307, 1555, 2287, 2658, 2910, 3519, 3800, 4121, 4266, 4657, 5836, 5994, 6269, 7053, 7316, 7776, 7945, 8127, 8873, 9048, 9144, 9540, 9707, 10173, 10498, 10598, 11083]",19834,20274,19962,14146,11083,114,19,53,109,79,"[0, 245, 531, 891, 1256, 1589, 2034, 2566, 2873, 3426, 3613, 3853, 4148, 4632, 5117, 6260, 7002, 8003, 8543, 9600, 10422, 10517, 11436, 12486, 12960, 13898, 14623, 15227, 15986, 16960, 18002, 19361, 20570, 21938, 22618]","[0, 291, 500, 918, 1300, 1589, 2041, 2627, 3233, 3586, 4186, 4617, 4830, 5561, 6150, 6739, 7502, 8856, 9365, 9612, 10667, 10927, 11140, 11724, 12411, 12827, 13401, 14020, 14703, 14978, 15955, 16795, 17916, 18663, 19310]","[0, 209, 299, 466, 604, 773, 942, 1117, 1303, 1552, 1853, 2474, 2989, 3873, 4145, 5070, 5334, 6040, 6363, 6720, 7668, 8250, 8657, 9241, 9759, 10527, 10870, 11406, 11949, 12290, 12921, 13525, 14140, 14542, 15798]","[2, 299, 595, 1090, 1487, 1863, 2253, 2636, 3047, 3484, 3715, 4054, 4506, 5138, 5252, 6367, 6831, 7828, 8210, 8551, 9059, 9275, 9825, 10388, 10609, 11574, 12091, 12408, 12806, 13017, 13769, 14188, 14529, 14726, 15259]","[0, 209, 299, 401, 491, 627, 746, 1155, 1474, 1993, 2555, 2768, 2906, 3347, 3442, 3814, 4174, 4760, 4855, 5191, 6099, 6397, 6648, 6969, 7064, 7159, 7583, 7874, 8180, 8276, 8868, 9339, 9625, 10246, 10601]",22618,19310,15798,15259,10601,-2784,964,4164,-1113,482,1713,35,dire
7618832016,48,23,112,58,20,"[0, 165, 326, 706, 1056, 1292, 1614, 1909, 2463, 2813, 3162, 3881, 4425, 5170, 5936, 6457, 6936, 7661, 8390, 8778, 9947, 10972, 12118, 12975, 13466, 13926, 14682, 15407, 15503, 16364, 16932, 17032, 18067, 18292, 18482]","[0, 217, 461, 844, 1387, 2052, 2301, 2852, 3239, 3952, 4532, 5065, 5741, 6262, 6895, 7604, 7827, 8231, 9009, 10125, 11407, 12229, 12324, 12714, 13158, 13781, 13978, 14872, 15138, 15330, 16096, 16196, 16319, 17909, 18649]","[0, 218, 624, 991, 1248, 1460, 1899, 2189, 2603, 3177, 3621, 4352, 4940, 5462, 6162, 6468, 6810, 7175, 8000, 8237, 8440, 9387, 9899, 10864, 11094, 12018, 12215, 13365, 13629, 13992, 14348, 14573, 14825, 15506, 16169]","[0, 130, 224, 314, 496, 813, 920, 1700, 1966, 2440, 3028, 3763, 4235, 4462, 4809, 4967, 5218, 5376, 5902, 6245, 7265, 7652, 7985, 8874, 9347, 10112, 10419, 10805, 11552, 12079, 12928, 13275, 13527, 15374, 15564]","[0, 182, 272, 631, 838, 928, 1073, 1163, 1338, 1602, 1858, 2280, 2539, 2812, 3265, 3434, 3618, 3900, 4153, 4760, 5382, 5987, 6354, 6587, 6967, 7507, 7704, 8300, 8396, 8492, 8894, 8994, 9318, 10247, 10549]",18482,18649,16169,15564,10549,78,22,70,123,84,"[330, 576, 945, 1070, 1673, 1965, 2325, 2719, 3184, 3683, 4224, 4353, 4736, 5355, 5740, 6798, 7973, 9255, 9936, 10465, 10729, 11047, 11836, 12528, 13366, 13857, 14080, 15593, 16766, 17301, 18594, 19792, 20770, 21781, 21881]","[0, 333, 706, 1034, 1361, 1696, 2026, 2369, 2732, 2892, 3428, 3698, 4497, 4856, 5176, 5810, 7062, 7684, 8183, 8975, 9477, 9963, 11259, 11712, 12452, 12934, 13325, 15113, 15713, 16136, 16900, 17344, 18015, 19339, 20167]","[62, 361, 570, 875, 1103, 1481, 1961, 2458, 2728, 3128, 3663, 4137, 5011, 5405, 6200, 6687, 7483, 8210, 9123, 9943, 10083, 10605, 11552, 12301, 12714, 13044, 13175, 13429, 14694, 15467, 16413, 17212, 17732, 18388, 18986]","[62, 322, 412, 502, 715, 845, 983, 1163, 1616, 1706, 2082, 2172, 2573, 2833, 2982, 3325, 4257, 4653, 4942, 5533, 5848, 6137, 6669, 7195, 7485, 7799, 7894, 8810, 9601, 10381, 11796, 12360, 12771, 13366, 13466]","[62, 272, 381, 515, 653, 788, 1192, 1372, 1609, 1750, 2367, 2457, 2586, 2754, 3019, 3674, 4396, 4872, 5287, 5625, 5765, 6020, 6722, 6947, 7042, 7690, 8337, 9822, 10493, 10833, 12038, 12228, 13687, 14508, 14608]",21881,20167,18986,13466,14608,-3399,-1518,-2817,2098,-4059,-9695,35,radiant
7618866208,113,12,29,31,75,"[0, 295, 619, 1077, 1489, 1842, 2218, 2342, 2592, 3700, 4115, 4997, 5179, 6105, 6712, 7537, 8350, 9341, 9751, 10982, 11292, 12071, 13242, 13650, 14888, 16529, 17797, 18550, 18646, 19458, 21389, 22715, 23418, 23518, 24487]","[0, 248, 485, 771, 1020, 1345, 1668, 1914, 2243, 2645, 2991, 3225, 3716, 4211, 4999, 5358, 5849, 6389, 6795, 7625, 8012, 8889, 9559, 9967, 10616, 11154, 12053, 12429, 13289, 14802, 16668, 17356, 18382, 18482, 18727]","[0, 246, 526, 852, 1208, 1532, 1936, 2290, 2538, 3005, 3516, 3808, 4003, 4430, 5181, 5276, 5896, 6628, 6965, 7536, 7914, 8129, 9142, 10424, 10948, 12058, 12849, 13415, 13714, 14278, 15132, 15232, 15332, 15618, 16044]","[0, 210, 330, 420, 628, 763, 898, 988, 1209, 1389, 1498, 1732, 1822, 2310, 3238, 3486, 3852, 3946, 4157, 4315, 4446, 4540, 4883, 5780, 5993, 6216, 6575, 6709, 6805, 7505, 8477, 8577, 8719, 8819, 9314]","[0, 210, 330, 466, 591, 725, 815, 953, 1062, 1262, 1690, 1924, 2014, 2634, 3131, 3434, 3964, 4261, 4444, 4772, 4867, 4961, 5372, 5467, 5689, 6046, 6422, 6614, 6710, 6954, 7530, 7630, 7730, 7830, 8310]",24487,18727,16044,9314,8310,28,95,114,7,79,"[51, 219, 498, 806, 1024, 1396, 1813, 2082, 2592, 2858, 3172, 4119, 4624, 4773, 5601, 6105, 6563, 7098, 7821, 8300, 10206, 10896, 11527, 11884, 12833, 13502, 14142, 15992, 16703, 17167, 17263, 18959, 20609, 20819, 21134]","[319, 501, 819, 1018, 1262, 1509, 1637, 1880, 2204, 2332, 2550, 2928, 3202, 3502, 4133, 4629, 4938, 5417, 5745, 6457, 6981, 7714, 8402, 9085, 9524, 9944, 10539, 11096, 12037, 12740, 12851, 13337, 14720, 15692, 16767]","[51, 219, 466, 608, 865, 1107, 1339, 1624, 2277, 2804, 2983, 3391, 4072, 4426, 4914, 5274, 5462, 5556, 5973, 6583, 7268, 7539, 8063, 8654, 8955, 9049, 9755, 10185, 10726, 11083, 11217, 12824, 14791, 15627, 16354]","[51, 181, 271, 361, 451, 632, 810, 970, 1153, 1253, 1425, 2219, 2647, 2869, 3357, 3452, 3659, 4079, 4302, 4697, 5133, 5227, 5439, 6161, 6401, 6942, 7118, 7441, 7810, 7987, 8161, 8746, 9294, 9694, 10009]","[51, 181, 271, 361, 495, 669, 796, 931, 1100, 1226, 1316, 1568, 1997, 2146, 2580, 2818, 2913, 3226, 3455, 3703, 4300, 4394, 4671, 5175, 5454, 6104, 6326, 6421, 6790, 7252, 7353, 7633, 7765, 8209, 8658]",21134,16767,16354,10009,8658,3353,1960,-310,-695,-348,3960,35,radiant
7618873617,113,93,29,105,45,"[0, 571, 901, 1119, 1497, 1784, 2209, 2717, 3242, 3772, 4147, 4999, 5661, 6400, 6610, 7664, 8688, 9241, 9858, 11684, 12162, 13596, 14347, 15565, 16420, 16785, 17546, 17640, 19132, 19561, 20077, 20929, 21496, 24192, 25362]","[0, 200, 506, 694, 818, 1076, 1346, 1749, 1981, 2121, 2211, 2551, 3206, 4010, 4502, 4868, 5389, 5911, 6275, 8327, 8761, 9678, 10187, 10769, 10863, 10958, 11655, 11803, 12287, 12441, 13019, 13595, 14298, 15148, 15619]","[0, 168, 439, 600, 889, 1367, 1713, 2118, 2448, 2699, 3123, 3629, 4260, 4631, 5269, 5544, 5955, 6448, 6844, 7979, 8675, 9381, 10097, 10497, 10591, 10686, 11138, 11232, 12147, 12572, 12668, 13108, 13609, 14459, 14969]","[0, 129, 219, 548, 674, 848, 1223, 1722, 1818, 1908, 2305, 2523, 2667, 3471, 3691, 3966, 4060, 4306, 4401, 5510, 5961, 6950, 7297, 7777, 7903, 7998, 8458, 8552, 9269, 10116, 10212, 10401, 10748, 11886, 12466]","[0, 129, 219, 309, 448, 624, 750, 840, 974, 1184, 1323, 1688, 1891, 2079, 2631, 2726, 3093, 3293, 3433, 3528, 3665, 3832, 4174, 4403, 4497, 4592, 5170, 5264, 5887, 6252, 6436, 6746, 7134, 7984, 8416]",25362,15619,14969,12466,8416,46,137,98,53,86,"[0, 248, 493, 805, 1125, 1469, 1879, 2433, 3208, 3582, 3982, 4904, 5254, 6023, 6616, 8177, 8868, 9564, 10237, 11030, 11280, 12028, 12920, 13630, 14813, 15857, 17594, 18824, 20190, 20980, 21692, 22029, 23390, 24144, 24785]","[0, 243, 766, 1021, 1308, 1691, 2222, 2892, 3656, 4086, 4636, 5557, 6231, 6792, 7804, 8787, 9016, 9619, 10399, 11390, 11624, 12179, 12895, 13377, 14082, 14560, 16511, 17763, 18250, 19232, 19573, 20590, 21564, 22306, 22406]","[0, 248, 446, 888, 1377, 1929, 2374, 2755, 3451, 4144, 4659, 5129, 5351, 5530, 5625, 6541, 6770, 7124, 7597, 8165, 8679, 8954, 9438, 9894, 10273, 11153, 11806, 12775, 13409, 13673, 13877, 14111, 14551, 14930, 15334]","[0, 261, 467, 557, 647, 862, 1155, 1527, 2081, 2270, 2807, 3024, 3669, 3848, 4227, 4829, 5358, 5745, 6013, 6702, 6831, 7092, 7331, 7534, 8036, 8430, 9420, 10616, 11568, 12118, 12214, 12760, 13304, 13790, 13890]","[0, 209, 336, 679, 878, 1093, 1183, 1488, 1696, 1877, 2057, 2560, 2786, 2965, 3415, 3769, 4257, 4717, 5218, 6153, 6624, 7157, 7597, 8081, 8883, 9891, 10093, 11163, 11816, 12143, 12400, 12656, 13552, 14044, 14325]",24785,22406,15334,13890,14325,577,-6787,-365,-1424,-5909,-13908,35,dire
7619331703,10,74,137,121,3,"[0, 201, 362, 646, 830, 1246, 1385, 1760, 2121, 2592, 2860, 3174, 3513, 3951, 4507, 4898, 5292, 5969, 6520, 7232, 7852, 8682, 9521, 10307, 11171, 11700, 11859, 12778, 13452, 13949, 15165, 16118, 17320, 18195, 18334]","[0, 219, 456, 782, 1159, 1515, 1919, 2337, 2883, 3393, 3646, 3881, 4266, 4782, 5697, 5932, 6121, 6963, 7192, 7537, 7954, 9013, 9562, 9871, 10384, 10715, 10810, 11850, 12711, 12807, 13443, 14526, 14740, 15204, 15746]","[0, 164, 359, 543, 780, 953, 1259, 1560, 1843, 2128, 2344, 2506, 3097, 3497, 4556, 5019, 5113, 5696, 6015, 6134, 6478, 7318, 7925, 8427, 8870, 9217, 9376, 9797, 10295, 10391, 11261, 11807, 12166, 12461, 12561]","[0, 130, 220, 310, 408, 498, 725, 905, 995, 1135, 1225, 1315, 1491, 1668, 2377, 2677, 2783, 3327, 3422, 3516, 3655, 4449, 4691, 4907, 5077, 5247, 5417, 5866, 6208, 6379, 7071, 7701, 7968, 8314, 8747]","[0, 130, 220, 358, 448, 869, 959, 1139, 1229, 1369, 1459, 1640, 1730, 2091, 2523, 2618, 2712, 2897, 3004, 3134, 3229, 3938, 4105, 4199, 4326, 4457, 4552, 4646, 4943, 5039, 5678, 5983, 6083, 6331, 6431]",18334,15746,12561,8747,6431,89,14,2,65,105,"[0, 249, 475, 755, 958, 1562, 1943, 2518, 3048, 3493, 4060, 4520, 5046, 5840, 6611, 7194, 8170, 8858, 9927, 10796, 11675, 12596, 13971, 15000, 15884, 17011, 17919, 18778, 19471, 20707, 21461, 22417, 23345, 25375, 27000]","[0, 329, 572, 949, 1112, 1493, 1710, 1985, 2285, 2524, 2950, 3181, 3441, 3741, 3836, 4581, 5070, 5165, 5664, 5916, 6142, 6504, 6710, 7260, 7559, 8107, 8843, 9339, 9570, 11035, 11256, 11950, 12348, 13706, 14638]","[0, 210, 429, 700, 1577, 1777, 2156, 2509, 2767, 3022, 3237, 3361, 3627, 3842, 3975, 4326, 5071, 5667, 6271, 6884, 7286, 7526, 7996, 8456, 9034, 9306, 9951, 10414, 10749, 11645, 12004, 12997, 13213, 14219, 15167]","[0, 210, 334, 424, 681, 876, 1027, 1250, 1359, 1561, 1943, 2401, 2554, 2928, 3144, 3600, 4173, 4521, 5069, 5394, 5808, 6065, 6405, 6816, 7581, 8124, 8540, 8775, 9006, 9406, 9684, 10362, 10462, 11388, 11929]","[0, 210, 300, 475, 565, 655, 826, 961, 1083, 1173, 1481, 1620, 1747, 1962, 2057, 2310, 2884, 2979, 3431, 3756, 4157, 4342, 4610, 5064, 5373, 5766, 6927, 7206, 7778, 8326, 8547, 8917, 9017, 10129, 10511]",27000,14638,15167,11929,10511,-8666,1108,-2606,-3182,-4080,-17426,35,dire
7619338103,44,106,43,19,79,"[0, 248, 502, 1153, 1278, 1594, 1957, 2414, 2971, 3230, 3600, 4109, 4749, 5045, 5573, 6210, 6510, 7380, 8380, 8514, 9328, 10207, 10737, 11460, 11834, 12609, 13227, 14260, 14671, 15943, 16748, 16848, 17779, 18280, 18836]","[0, 205, 443, 572, 662, 842, 976, 1250, 1627, 1979, 2267, 2499, 3093, 3479, 4004, 4528, 5201, 6114, 6681, 7197, 7660, 8599, 8984, 9286, 10185, 10405, 10966, 11796, 11977, 12703, 13024, 13341, 13785, 15184, 15848]","[0, 285, 562, 723, 1034, 1271, 1839, 2000, 2488, 2623, 2913, 3885, 5113, 5430, 6463, 6865, 7635, 8707, 9144, 9642, 10301, 10875, 11498, 12037, 12696, 13011, 13187, 13590, 13957, 14217, 14643, 14743, 15265, 16317, 16893]","[0, 130, 271, 396, 680, 770, 950, 1040, 1363, 1490, 1580, 1986, 2507, 2698, 3078, 3511, 3809, 4580, 5329, 5525, 5736, 6197, 6398, 6700, 7459, 7553, 7875, 8311, 8443, 9124, 9445, 9545, 9845, 10786, 11097]","[0, 130, 575, 749, 883, 1038, 1128, 1236, 1411, 1501, 1638, 2044, 2273, 2368, 2633, 2885, 3307, 3615, 4095, 4291, 4511, 4786, 4880, 4975, 5127, 5221, 5397, 5717, 6021, 6172, 6493, 6593, 7161, 7817, 7961]",18836,15848,16893,11097,7961,35,123,114,21,71,"[0, 276, 526, 814, 1066, 1388, 1586, 2336, 2851, 3588, 4064, 4357, 4607, 5738, 6130, 6581, 7687, 8119, 8581, 9299, 10230, 11297, 12028, 13599, 14067, 14521, 15110, 15707, 16753, 17548, 19217, 20556, 21617, 21717, 22756]","[0, 242, 502, 761, 1044, 1349, 1815, 2187, 2550, 3211, 3489, 4074, 4453, 5088, 5699, 6228, 6818, 7597, 8200, 8683, 9240, 9775, 10493, 10910, 11716, 12266, 13036, 13626, 14818, 15076, 15688, 17164, 18757, 19835, 20597]","[0, 277, 796, 1108, 1820, 2272, 2999, 3814, 4266, 5183, 5702, 6367, 6457, 7049, 8076, 8818, 9576, 9773, 9925, 10490, 11083, 11590, 12268, 12568, 13408, 14408, 14922, 15501, 16110, 16828, 17566, 18025, 19011, 19273, 20083]","[0, 170, 512, 649, 739, 874, 1060, 1255, 1410, 1636, 1986, 2241, 2493, 2696, 3077, 3417, 3686, 3781, 4186, 4923, 5434, 5987, 6892, 7780, 7875, 8041, 8725, 9532, 10330, 10973, 11790, 13070, 14265, 14840, 15723]","[0, 170, 260, 350, 503, 671, 914, 1176, 1419, 1725, 1901, 2221, 2311, 2867, 3229, 3486, 3859, 4273, 4385, 4637, 5314, 5549, 5817, 6457, 7287, 8133, 8338, 8926, 9315, 9746, 10950, 12050, 12700, 13223, 13503]",22756,20597,20083,15723,13503,-3920,-4749,-3190,-4626,-5542,-22027,35,dire
7619709106,10,107,97,105,103,"[0, 222, 621, 952, 1405, 1615, 2136, 2544, 3021, 3334, 3783, 4374, 4906, 5496, 6131, 6662, 7375, 7575, 8105, 8958, 9052, 9147, 10210, 10782, 11001, 11947, 13061, 13873, 15578, 16623, 17381, 18233, 18358, 19462, 21037]","[0, 256, 567, 932, 1062, 1237, 1560, 1988, 2208, 2298, 2475, 2735, 3063, 3670, 4030, 4373, 4614, 5406, 6090, 6921, 7217, 7487, 8383, 8795, 9368, 9995, 10595, 11656, 13048, 14025, 14218, 14318, 14541, 14870, 15150]","[0, 245, 567, 906, 1211, 1470, 1639, 2090, 2350, 2739, 3264, 3613, 4322, 4623, 4819, 5161, 5318, 5894, 6152, 6713, 6828, 7017, 7808, 8439, 9338, 9724, 10617, 10712, 11796, 12741, 12837, 13414, 13620, 13720, 14134]","[0, 170, 306, 396, 572, 662, 1149, 1239, 1374, 1464, 1554, 1814, 2071, 2434, 2529, 2843, 3000, 3437, 4666, 5228, 5344, 5514, 5846, 6219, 6929, 7397, 7781, 7951, 9000, 9494, 9739, 9914, 10076, 10176, 10492]","[0, 170, 260, 394, 558, 648, 820, 910, 1045, 1416, 1713, 1973, 2537, 2734, 2829, 3082, 3239, 3334, 3914, 4471, 4565, 4660, 4917, 5012, 5106, 5273, 5548, 5947, 6841, 7281, 7396, 7496, 7653, 7753, 8033]",21037,15150,14134,10492,8033,41,49,35,86,110,"[0, 170, 419, 633, 1003, 1481, 1759, 2256, 2626, 3081, 3815, 4253, 4895, 5597, 6373, 6968, 7706, 8519, 9136, 9746, 10396, 11070, 11829, 12561, 13512, 14040, 14964, 16370, 16502, 17202, 17450, 18112, 18771, 19291, 20411]","[0, 209, 535, 823, 1280, 1480, 1818, 2134, 2558, 3249, 4003, 4518, 5258, 5803, 6102, 6570, 7007, 7883, 8721, 9523, 10514, 11384, 12194, 12901, 13513, 14060, 14830, 15730, 16224, 16938, 17563, 18019, 18474, 19097, 20168]","[0, 244, 553, 997, 1300, 2099, 2468, 2798, 3247, 3899, 4607, 5698, 6242, 6821, 7415, 8314, 8684, 9350, 9761, 10276, 11294, 11656, 12427, 12814, 13494, 13589, 14475, 14888, 15237, 15724, 16923, 17257, 17507, 19003, 19684]","[0, 221, 311, 440, 619, 760, 1057, 1182, 1403, 1726, 2154, 2374, 2606, 2818, 3481, 4062, 4667, 5170, 5453, 5758, 6332, 6603, 7461, 7658, 8170, 8265, 8564, 8864, 9005, 9211, 10338, 10819, 11364, 11887, 12354]","[0, 270, 360, 450, 596, 999, 1089, 1214, 1304, 1616, 1979, 2269, 2521, 2819, 3404, 3807, 4094, 4361, 4580, 4746, 5200, 5842, 6422, 6592, 6974, 7144, 7477, 7979, 8279, 8488, 9190, 9687, 10001, 10505, 10830]",20411,20168,19684,12354,10830,626,-5018,-5550,-1862,-2797,-14601,35,dire
7619822517,72,23,43,136,5,"[145, 347, 545, 784, 1073, 1513, 1979, 2363, 2885, 3410, 4093, 4701, 5049, 5256, 6221, 7154, 7969, 8885, 9458, 9903, 10702, 11287, 11958, 12612, 13352, 14956, 16162, 18193, 19107, 19203, 19428, 19822, 20536, 21621, 22461]","[278, 554, 908, 1408, 1764, 2147, 2758, 3263, 3758, 4230, 4783, 5320, 5744, 6207, 6825, 7303, 8084, 8764, 9364, 9839, 10553, 11161, 11809, 12554, 13357, 13733, 14231, 15194, 15572, 16343, 16507, 16984, 17084, 18106, 18759]","[145, 362, 597, 827, 1104, 1509, 1807, 2200, 2420, 2791, 3337, 3788, 4192, 4585, 5223, 5584, 6079, 6369, 7077, 7695, 8077, 8499, 9034, 9623, 10151, 10873, 11227, 11961, 12524, 13289, 13385, 13867, 13967, 14537, 15032]","[145, 275, 365, 455, 631, 783, 873, 1346, 1475, 1695, 2194, 2425, 2571, 2797, 3475, 3732, 4283, 4562, 4968, 5676, 6110, 6427, 6903, 7382, 8160, 8484, 8999, 10011, 10187, 10449, 10638, 11430, 11700, 12859, 13049]","[278, 457, 597, 739, 887, 1037, 1127, 1217, 1680, 1969, 2317, 2930, 3061, 3343, 3750, 4263, 4618, 4890, 5111, 5451, 5687, 6381, 6717, 6858, 7136, 7412, 7717, 8609, 8996, 9092, 9308, 9498, 9598, 10127, 10317]",22461,18759,15032,13049,10317,109,22,98,9,26,"[513, 723, 1149, 1492, 2023, 2383, 3179, 3497, 4114, 4857, 5172, 5785, 6469, 6943, 7547, 7746, 8522, 8832, 9764, 10764, 11314, 12281, 13035, 14008, 14859, 15978, 16857, 17635, 18876, 19816, 20539, 21068, 22321, 23028, 23723]","[120, 365, 770, 1091, 1381, 1748, 1958, 2417, 2926, 3600, 4147, 4479, 4695, 5325, 6021, 6381, 6684, 7466, 7875, 8200, 8878, 9832, 10588, 11431, 12149, 12739, 13450, 13692, 14534, 15353, 15802, 17011, 18456, 18783, 19793]","[388, 598, 954, 1389, 1554, 1871, 2306, 2518, 2874, 3290, 4028, 4616, 5359, 6069, 6420, 6793, 7059, 7925, 8957, 9193, 9736, 10373, 10971, 12034, 12397, 12597, 13637, 13898, 15138, 16202, 16606, 17230, 18119, 18543, 19024]","[247, 508, 705, 893, 1157, 1264, 1976, 2200, 2417, 2776, 3010, 3619, 3932, 4480, 4915, 5098, 5193, 5371, 5577, 5844, 6132, 6429, 6767, 7301, 7435, 7601, 7992, 8197, 8953, 9385, 10015, 10547, 11106, 11406, 11644]","[380, 590, 680, 770, 935, 1025, 1115, 1274, 1430, 1608, 1949, 2196, 2421, 2792, 2950, 3045, 3140, 3234, 3531, 3626, 3832, 4016, 4183, 4368, 4463, 4629, 5098, 5303, 5835, 6204, 6300, 6832, 7116, 7326, 7565]",23723,19793,19024,11644,7565,-1262,-1034,-3992,1405,2752,-2131,35,dire
7619853714,18,90,138,106,121,"[0, 206, 707, 997, 1393, 1917, 2263, 2455, 3005, 3626, 4100, 5029, 5635, 6454, 6973, 8168, 8974, 10045, 11264, 12141, 13081, 13332, 14619, 15134, 16208, 17193, 17888, 18946, 19469, 20577, 21654, 22587, 23296, 23805, 25333]","[0, 209, 543, 915, 1354, 1800, 2401, 2839, 3882, 4464, 4698, 5234, 5723, 6801, 7458, 8380, 8939, 9395, 10163, 10812, 11437, 12377, 13383, 14176, 14470, 15094, 15342, 15914, 16299, 16977, 17664, 18346, 18775, 18875, 19378]","[0, 129, 219, 309, 475, 565, 910, 1154, 1380, 1705, 1885, 2052, 2233, 2647, 2757, 3293, 3497, 3878, 4534, 5180, 5747, 6033, 7125, 7345, 7568, 8071, 8346, 8441, 9311, 9407, 10428, 10985, 11745, 12433, 13300]","[0, 207, 532, 897, 1319, 1650, 2124, 2689, 3207, 3453, 3781, 4357, 4638, 5033, 5567, 5752, 6323, 6823, 7105, 7432, 8092, 8501, 9224, 9623, 9997, 10373, 10713, 11050, 11544, 12008, 13412, 13899, 14438, 14970, 15585]","[0, 129, 300, 434, 573, 740, 882, 972, 1230, 1513, 1693, 1921, 2129, 2385, 2525, 2934, 3092, 3658, 4084, 4370, 4575, 5023, 5882, 5977, 6172, 6425, 6602, 6804, 7060, 7454, 8029, 8264, 8687, 9409, 10281]",25333,19378,13300,15585,10281,70,129,43,19,52,"[0, 294, 491, 843, 1249, 1593, 1885, 2530, 2848, 3164, 3732, 4206, 4737, 5427, 6118, 6903, 8006, 8817, 9748, 10528, 11314, 11884, 11978, 13168, 14003, 15059, 16716, 17714, 18972, 19068, 19254, 20366, 21558, 22407, 22620]","[0, 243, 854, 1224, 1548, 2186, 2687, 3016, 3292, 3705, 4163, 4465, 4790, 5149, 5537, 5968, 6736, 6975, 7279, 7665, 8072, 8322, 8519, 9456, 10039, 10357, 11125, 11854, 12607, 12703, 13917, 14593, 15040, 15140, 15540]","[0, 299, 628, 963, 1270, 1674, 2037, 2414, 2710, 3366, 4359, 4612, 5371, 5889, 6504, 6773, 7326, 7856, 8635, 8990, 9460, 9774, 9868, 10699, 11157, 11598, 12411, 12864, 13441, 13655, 13841, 14263, 14610, 14824, 15645]","[100, 309, 563, 653, 743, 910, 1045, 1273, 1412, 1712, 2030, 2120, 2338, 2631, 2846, 2941, 3173, 3268, 3955, 4113, 4208, 4719, 4813, 5320, 5605, 5772, 6535, 6630, 7358, 7577, 8221, 8828, 9482, 9582, 10275]","[0, 209, 299, 406, 565, 704, 842, 1022, 1198, 1500, 1829, 1929, 2146, 2538, 3155, 3426, 3779, 4220, 4432, 4590, 4685, 5035, 5255, 5823, 5990, 6504, 7030, 7125, 7302, 7432, 7948, 8602, 9237, 9656, 10143]",22620,15540,15645,10275,10143,2713,3838,-2345,5310,138,9654,35,dire
7621065719,109,23,69,85,105,"[0, 209, 493, 942, 1318, 1671, 2174, 2715, 3266, 3769, 4579, 4947, 5562, 6318, 7017, 7493, 8375, 9240, 9562, 10278, 11357, 11795, 12813, 13406, 14291, 15444, 16359, 17543, 18560, 19169, 19731, 20768, 21787, 22642, 23476]","[0, 330, 779, 1035, 1478, 1847, 2290, 2810, 3392, 4104, 4771, 5384, 5954, 6523, 7186, 7688, 8509, 9148, 9678, 10498, 11421, 11600, 12515, 13187, 13641, 14391, 14941, 15292, 16184, 16861, 18154, 19400, 20120, 20914, 21441]","[0, 330, 492, 909, 1243, 1784, 2094, 2844, 3216, 3573, 4473, 5206, 5785, 6314, 7020, 7910, 8891, 9492, 9962, 10299, 11639, 12005, 13032, 13582, 14034, 14748, 15154, 15551, 16291, 16592, 17150, 17652, 18420, 19266, 20035]","[0, 170, 260, 350, 526, 616, 829, 1077, 1281, 1565, 1918, 2256, 2484, 2926, 3256, 3360, 3815, 4020, 4177, 4428, 4743, 4849, 5078, 5292, 5393, 5834, 6205, 6375, 6769, 7033, 7934, 8198, 8515, 8935, 9199]","[0, 170, 260, 350, 480, 617, 707, 892, 1249, 1604, 1937, 2138, 2301, 2491, 2809, 2989, 3274, 3691, 4078, 4316, 4940, 5041, 5314, 5658, 5753, 6119, 6213, 6308, 6627, 6933, 7373, 7805, 8040, 8385, 8705]",23476,21441,20035,9199,8705,12,13,129,9,114,"[0, 207, 550, 904, 1151, 1260, 1521, 1740, 2011, 2334, 2810, 2924, 3533, 3907, 4341, 4904, 5426, 5817, 6436, 6962, 7358, 8170, 9298, 9606, 10118, 10602, 11463, 12305, 13196, 13581, 14087, 14995, 16315, 17371, 18204]","[0, 206, 479, 860, 1184, 1437, 1807, 2140, 2414, 3064, 3662, 3930, 4336, 4995, 5415, 5841, 6666, 7536, 8341, 8803, 9288, 9826, 10640, 11276, 11564, 12355, 12837, 13734, 14243, 14587, 15356, 16423, 17212, 18137, 18583]","[0, 170, 445, 571, 815, 1299, 1434, 1721, 1932, 2348, 2847, 3205, 3696, 4217, 4473, 5024, 5641, 6434, 6852, 7639, 8137, 8640, 9338, 10009, 10309, 10758, 11174, 11855, 12491, 12879, 13565, 13966, 14582, 15073, 15336]","[0, 170, 336, 549, 719, 809, 1014, 1529, 1789, 1897, 2183, 2426, 2717, 3025, 3119, 3431, 3813, 4115, 4674, 5263, 5691, 5970, 6358, 6645, 6841, 6936, 7098, 7645, 7995, 8328, 8707, 9231, 9358, 9632, 9822]","[0, 170, 285, 375, 545, 683, 818, 1000, 1234, 1629, 1809, 1987, 2118, 2268, 2425, 2574, 2732, 2958, 3558, 3891, 4061, 4228, 4518, 4802, 4945, 5040, 5134, 5385, 5652, 6412, 6718, 6908, 7008, 7495, 7685]",18204,18583,15336,9822,7685,5272,2858,4699,-623,1020,13226,35,radiant
7621666802,138,96,17,9,65,"[0, 290, 540, 959, 1606, 1984, 2403, 2788, 3269, 3807, 4320, 4591, 5405, 5970, 6651, 7228, 8337, 8834, 9392, 9839, 10901, 11463, 12681, 13388, 14403, 15173, 16429, 17258, 18234, 18983, 19711, 20247, 21101, 22143, 22433]","[0, 255, 585, 865, 1414, 1650, 2000, 2418, 2922, 3307, 4214, 4510, 4939, 5205, 5466, 5659, 6359, 7034, 7638, 7796, 8313, 8479, 9364, 10013, 10877, 11493, 12335, 13191, 14186, 14887, 15397, 16073, 16812, 17278, 18125]","[0, 278, 567, 933, 1154, 1493, 1896, 2094, 2333, 2679, 3212, 3322, 3780, 3984, 4443, 4628, 5422, 6175, 6396, 6683, 6816, 7261, 7863, 8220, 8493, 9073, 9249, 9344, 9521, 10047, 10424, 11012, 11519, 11738, 11945]","[0, 174, 304, 437, 722, 872, 1275, 1468, 1558, 1895, 2238, 2647, 3285, 3393, 3970, 4296, 5494, 5965, 6109, 6267, 6539, 6818, 7612, 7707, 8092, 8534, 8778, 9166, 9512, 9789, 10084, 10245, 11529, 11629, 11729]","[0, 170, 333, 423, 621, 711, 801, 942, 1294, 1429, 1619, 1910, 2259, 2565, 3234, 3397, 3918, 4551, 4646, 4804, 5073, 5283, 5540, 5635, 6289, 6639, 6815, 7275, 7865, 8258, 8587, 8907, 9205, 9382, 9751]",22433,18125,11945,11729,9751,73,70,13,121,79,"[0, 313, 481, 690, 1113, 1731, 2062, 2894, 3281, 4047, 4444, 5470, 6402, 7377, 8243, 9083, 10360, 11267, 12010, 12705, 14298, 15191, 16390, 18003, 18222, 19098, 19950, 20263, 20611, 21194, 21817, 22829, 24602, 25921, 26828]","[0, 302, 556, 813, 1101, 1615, 1990, 2388, 2914, 3258, 3738, 4165, 4868, 5634, 6235, 7047, 7578, 8077, 8975, 9895, 10522, 11325, 12765, 13710, 14302, 15372, 16157, 16872, 18052, 18836, 19398, 20341, 21289, 22468, 22844]","[0, 195, 627, 872, 1217, 1679, 2088, 2602, 3107, 3438, 3768, 4428, 5331, 5635, 6251, 6683, 6911, 7650, 7886, 8677, 9485, 9931, 10656, 11703, 12342, 12778, 13335, 13689, 14600, 15315, 15827, 16131, 16885, 17381, 18113]","[0, 195, 328, 418, 812, 1068, 1158, 1467, 1686, 1821, 2180, 2521, 3235, 3733, 4215, 4310, 4538, 4829, 4957, 5685, 6511, 6680, 7045, 7512, 7681, 8152, 8752, 9144, 9530, 9812, 10142, 10461, 10861, 11230, 11506]","[0, 242, 332, 470, 843, 933, 1331, 1987, 2271, 2656, 2833, 3227, 3460, 3764, 4130, 4410, 4642, 5297, 5396, 5858, 6383, 6478, 7016, 7483, 7902, 8429, 8758, 9026, 9580, 10077, 10575, 11081, 11483, 11658, 11984]",26828,22844,18113,11506,11984,-4395,-4719,-6168,223,-2233,-17292,35,dire
7622335611,41,120,23,27,85,"[0, 330, 592, 822, 1120, 1403, 1863, 2229, 2591, 3396, 3870, 4161, 4464, 5232, 5660, 5888, 6693, 6956, 7576, 8299, 8553, 9246, 9903, 10402, 11422, 12065, 12868, 13509, 14055, 15325, 15791, 16807, 17723, 18256, 18882]","[0, 379, 700, 1028, 1472, 1962, 2350, 2960, 3662, 4378, 4513, 5336, 5927, 6339, 7016, 7506, 8044, 8925, 9528, 9755, 10876, 11569, 12418, 12758, 13103, 13306, 13570, 13882, 14590, 15445, 16019, 17127, 17362, 17635, 18000]","[0, 247, 549, 886, 1206, 1524, 1660, 1786, 2480, 2928, 3100, 3349, 3804, 4357, 5081, 5632, 6332, 6911, 7481, 8009, 8524, 8679, 9291, 9433, 9600, 9895, 10328, 10983, 11344, 12774, 12972, 13287, 14096, 14351, 14563]","[0, 256, 422, 512, 864, 989, 1079, 1492, 1627, 1958, 2093, 2412, 2546, 2748, 3155, 3634, 3995, 4127, 4222, 4912, 5298, 5392, 6001, 6142, 6691, 6785, 6929, 7095, 7317, 7555, 7651, 8283, 8876, 8976, 9076]","[0, 210, 380, 591, 820, 945, 1080, 1174, 1314, 1588, 1895, 2106, 2307, 2555, 2813, 3163, 3502, 3643, 3790, 4068, 4675, 4769, 5133, 5331, 5587, 5717, 6066, 6197, 6423, 7125, 7221, 7321, 7615, 7745, 8077]",18882,18000,14563,9076,8077,48,17,96,123,86,"[0, 130, 435, 680, 1041, 1564, 2062, 2516, 2902, 3444, 4010, 4723, 5326, 5903, 6895, 7355, 8376, 9318, 9898, 10749, 11662, 12109, 12948, 13546, 14468, 15242, 16314, 17024, 17997, 18733, 20311, 21140, 21604, 22079, 23371]","[0, 324, 735, 1102, 1675, 2098, 2512, 3004, 3651, 3824, 4852, 5258, 6001, 6522, 6935, 7414, 8684, 9290, 10080, 10791, 11326, 11922, 12396, 12649, 13109, 13625, 14660, 15659, 16467, 16563, 17306, 17813, 18439, 18652, 19141]","[0, 130, 438, 716, 1099, 1391, 1900, 2269, 2763, 3195, 3571, 4038, 4572, 5060, 5758, 6098, 6581, 6988, 7186, 7883, 8554, 9344, 9756, 9851, 10441, 10925, 11265, 11706, 11964, 12371, 13293, 13781, 14201, 14544, 14844]","[0, 130, 272, 737, 916, 1041, 1180, 1315, 1450, 1913, 2308, 2518, 2888, 3131, 3470, 3588, 4046, 4407, 4548, 4983, 5509, 6139, 6769, 7072, 7484, 8071, 8536, 8918, 9387, 9483, 10495, 10840, 11051, 11308, 11799]","[0, 130, 321, 499, 673, 798, 888, 1068, 1221, 1391, 1916, 2270, 2432, 2663, 3057, 3152, 3537, 4105, 4411, 4847, 5370, 5621, 5810, 5971, 6176, 6497, 7039, 7215, 7473, 7569, 8301, 8646, 9007, 9174, 9474]",23371,19141,14844,11799,9474,-4489,-1141,-281,-2723,-1397,-10031,35,dire
7622509408,109,98,96,105,20,"[0, 207, 453, 762, 1057, 1420, 1813, 2361, 2691, 3099, 3639, 4293, 4791, 5470, 6109, 6969, 7725, 8415, 9065, 9564, 10403, 11267, 12025, 12486, 13055, 13481, 14171, 14775, 15952, 17065, 18146, 20011, 20969, 22361, 22738]","[0, 322, 680, 1179, 1433, 2011, 2434, 3105, 3472, 3941, 4568, 4716, 5806, 6371, 7052, 7897, 8822, 9443, 9568, 10076, 10715, 11290, 11821, 11975, 12476, 13241, 13479, 14137, 15180, 15575, 16007, 16956, 17527, 18283, 19117]","[0, 294, 508, 822, 1485, 1773, 2176, 2741, 3406, 4006, 4466, 4971, 5246, 5826, 6436, 6915, 7529, 8082, 8367, 9391, 9812, 10054, 11028, 11294, 11836, 11931, 12154, 12444, 13205, 13614, 14170, 15035, 15890, 16740, 17564]","[0, 170, 260, 380, 804, 899, 1260, 1531, 1621, 1918, 2141, 2289, 2789, 3095, 3492, 3801, 4051, 4459, 4681, 5236, 5554, 5695, 5862, 6400, 6598, 6890, 7344, 7751, 9009, 9309, 9775, 10419, 10519, 10879, 11184]","[0, 175, 265, 488, 616, 801, 891, 1092, 1440, 1620, 2010, 2153, 2243, 2482, 2696, 2974, 3223, 3381, 3746, 4030, 4399, 4546, 4713, 4808, 4904, 5023, 5118, 5213, 5390, 5700, 5920, 6329, 6429, 6849, 7280]",22738,19117,17564,11184,7280,12,13,129,26,51,"[0, 170, 345, 585, 712, 917, 1092, 1317, 1545, 1962, 2276, 2723, 3374, 3882, 4582, 5173, 5720, 6672, 7397, 8395, 9210, 9521, 9915, 10457, 11869, 12602, 13616, 14992, 15120, 16034, 16572, 17624, 18633, 19394, 20246]","[0, 288, 541, 824, 1153, 1409, 1783, 2036, 2576, 2913, 3357, 4176, 4524, 4849, 5225, 5548, 6069, 6997, 8182, 8690, 9738, 10175, 10433, 11069, 12375, 13116, 14631, 15723, 16221, 17173, 17796, 18794, 19962, 20722, 22403]","[0, 170, 545, 803, 1088, 1529, 1936, 2365, 2779, 3096, 3665, 4557, 4955, 5475, 5998, 6178, 6470, 7183, 8027, 8224, 8963, 9965, 10412, 11033, 11710, 12170, 13439, 14562, 14801, 15387, 15691, 16007, 17113, 17807, 18553]","[0, 170, 260, 350, 440, 601, 943, 1063, 1496, 1586, 1765, 2116, 2206, 2399, 2717, 2864, 2987, 3281, 3693, 3902, 4221, 4481, 4707, 5139, 6123, 6309, 7049, 7484, 7736, 8064, 8221, 8694, 8921, 9362, 9665]","[0, 170, 600, 729, 1057, 1205, 1426, 1516, 1675, 1789, 1924, 2291, 2397, 2597, 2795, 3040, 3134, 3339, 3893, 4090, 4332, 4473, 5056, 5415, 6192, 6536, 7599, 8078, 8174, 8537, 8633, 9068, 9461, 9864, 10123]",20246,22403,18553,9665,10123,2492,-3286,-989,1519,-2843,-3107,35,dire
7622513213,78,32,53,120,85,"[0, 208, 483, 762, 1163, 1413, 1735, 2182, 2632, 3120, 3457, 3977, 4332, 4775, 5115, 5609, 6713, 7646, 8513, 9314, 9868, 11184, 12115, 12723, 13389, 14280, 14998, 15634, 16440, 17684, 19147, 20264, 21434, 22301, 22785]","[0, 326, 628, 953, 1673, 1959, 2417, 2795, 3283, 3882, 4341, 4915, 5212, 5610, 5864, 6399, 7746, 8410, 9300, 10015, 10109, 10608, 11220, 11863, 12383, 13199, 13363, 14123, 15805, 16632, 17592, 18094, 18656, 18971, 19603]","[0, 170, 332, 471, 636, 909, 999, 1089, 1301, 1742, 2022, 2557, 2694, 3090, 3433, 3782, 4689, 5436, 5966, 6668, 6922, 7437, 8028, 8522, 9056, 9358, 9998, 11291, 12421, 13399, 14268, 14858, 15890, 16818, 17254]","[0, 207, 564, 776, 1061, 1773, 2085, 2420, 2918, 3453, 4111, 4781, 5367, 5856, 6142, 6750, 7449, 7631, 8253, 8738, 9130, 9461, 9973, 10349, 10670, 11148, 11876, 12321, 12734, 13859, 14604, 15087, 16000, 16557, 16745]","[0, 170, 260, 350, 562, 709, 802, 892, 1093, 1437, 1558, 1801, 2083, 2318, 2633, 2730, 3505, 3687, 4048, 4377, 4471, 4999, 5166, 5261, 5355, 5933, 6287, 6702, 7262, 7963, 8725, 9387, 9877, 10303, 10403]",22785,19603,17254,16745,10403,7,93,129,86,5,"[0, 294, 630, 1022, 1330, 1610, 2025, 2473, 2890, 3268, 4152, 4730, 5018, 5426, 5841, 6242, 6610, 7526, 7927, 8488, 9251, 9595, 10198, 10621, 11120, 11651, 12094, 12517, 12848, 13892, 13988, 14271, 14670, 15386, 16622]","[0, 208, 520, 901, 1250, 1662, 1911, 2163, 2619, 3000, 3438, 3914, 4567, 5083, 5515, 6040, 6511, 6856, 7515, 7610, 8213, 9293, 9802, 10345, 10697, 11296, 12578, 12944, 13261, 13879, 13975, 14357, 14906, 15879, 16445]","[0, 240, 532, 898, 1261, 1622, 1824, 2348, 2627, 2791, 3341, 3768, 4197, 5055, 5588, 5851, 6803, 7254, 7547, 8044, 8737, 9506, 9863, 10134, 10909, 11204, 11823, 12088, 12687, 13059, 13155, 13630, 14089, 15213, 15916]","[0, 170, 305, 441, 530, 707, 797, 932, 1246, 1348, 1676, 1962, 2088, 2327, 2484, 2907, 3621, 4169, 4264, 4359, 5060, 5389, 5556, 5892, 6081, 6377, 6668, 6896, 7488, 7883, 8085, 8220, 8463, 9475, 9623]","[0, 221, 380, 470, 559, 775, 865, 1000, 1157, 1421, 1890, 2256, 2346, 2737, 3158, 3290, 3501, 3596, 3691, 3786, 4826, 4921, 5639, 5841, 6216, 6471, 6810, 6904, 7415, 7749, 7845, 8165, 8313, 8996, 9279]",16622,16445,15916,9623,9279,6163,3158,1338,7122,1124,18905,35,radiant
7623082102,129,9,72,68,51,"[327, 657, 1101, 1479, 1962, 2334, 2785, 3161, 3765, 3980, 4664, 5151, 5611, 6222, 6759, 7310, 7828, 8731, 9518, 10375, 11017, 11807, 12661, 13603, 14411, 15312, 16334, 17855, 18225, 18975, 19463, 20802, 22104, 23116, 23380]","[59, 349, 608, 948, 1567, 1893, 2614, 3143, 3798, 4251, 5029, 5237, 5693, 6208, 6626, 7494, 8092, 9216, 9560, 9952, 10533, 12470, 13200, 14161, 14513, 14857, 15033, 15783, 15879, 17381, 18010, 18110, 19193, 19293, 20158]","[0, 306, 682, 977, 1186, 1812, 2225, 2499, 3002, 3391, 3873, 4462, 4943, 5529, 6272, 6979, 7601, 8446, 9077, 9588, 10930, 11691, 12769, 13088, 13816, 13959, 15349, 15808, 16158, 17747, 17977, 18458, 18558, 20077, 20177]","[0, 402, 492, 582, 703, 940, 1030, 1246, 1429, 1538, 2048, 2338, 2554, 2703, 3170, 3449, 3544, 3905, 4037, 4551, 4930, 5631, 6264, 7218, 7604, 8175, 8683, 9397, 9568, 11047, 11941, 12111, 12211, 13897, 14491]","[59, 269, 359, 495, 630, 760, 894, 1029, 1212, 1389, 1704, 1933, 2070, 2219, 2313, 2582, 2915, 3156, 3499, 3788, 4067, 4655, 4894, 5413, 5770, 5900, 6484, 6986, 7146, 7630, 7927, 8315, 9261, 10836, 11055]",23380,20158,20177,14491,11055,49,19,21,86,20,"[0, 256, 646, 1094, 1501, 1852, 2401, 2934, 3648, 4340, 5085, 5700, 6430, 7142, 7967, 8867, 9840, 10735, 11676, 12615, 13589, 14669, 15369, 16413, 17083, 17976, 18685, 20441, 21425, 22642, 22738, 23453, 25171, 27514, 27974]","[0, 268, 543, 885, 1126, 1337, 1626, 1914, 2082, 2419, 2543, 3569, 3950, 4530, 4950, 6119, 6963, 7347, 8349, 9100, 9974, 10283, 11369, 12395, 13758, 14758, 15808, 16482, 16688, 17364, 18497, 19364, 21008, 23409, 23869]","[0, 130, 334, 615, 788, 1001, 1320, 1957, 2343, 2698, 3310, 3745, 4526, 4994, 5176, 5603, 6105, 6372, 6765, 7453, 7781, 8214, 8477, 9163, 9666, 10564, 11454, 12071, 12407, 13617, 13989, 14824, 15896, 16670, 18155]","[0, 130, 265, 398, 498, 657, 792, 1044, 1355, 1491, 2018, 2162, 2522, 2671, 2833, 3310, 3706, 4121, 4272, 4520, 4929, 5113, 5419, 5943, 6355, 6736, 7357, 8195, 8401, 9077, 9516, 10170, 10724, 11319, 12185]","[0, 130, 255, 407, 497, 606, 740, 886, 1036, 1250, 1422, 1637, 2049, 2198, 2356, 2750, 2953, 3180, 3275, 3523, 3752, 3936, 4095, 4461, 4873, 5168, 5658, 6768, 6974, 7449, 7943, 8643, 9380, 10553, 11070]",27974,23869,18155,12185,11070,-4594,-3711,2022,2306,-15,-3992,35,dire
7623382418,18,77,23,65,9,"[0, 207, 517, 801, 1120, 1532, 1860, 2328, 2997, 3689, 4208, 4769, 5509, 6153, 6797, 7404, 8061, 8949, 9391, 9839, 10617, 10973, 11418, 12542, 13571, 14453, 15112, 15686, 16233, 16498, 16961, 17724, 18206, 18700, 19442]","[0, 208, 488, 800, 1285, 1655, 1900, 2417, 2968, 3596, 4207, 4592, 5078, 5562, 5946, 6552, 7198, 8273, 8574, 8913, 9885, 9979, 10896, 11612, 12065, 12469, 13458, 13892, 14295, 14501, 14841, 15225, 15668, 16150, 16788]","[0, 321, 628, 994, 1436, 1722, 2170, 2861, 3420, 4158, 4798, 5085, 5738, 6447, 6843, 7230, 7831, 8395, 8637, 9339, 9731, 10123, 10891, 11377, 11917, 12425, 12823, 13549, 13835, 14170, 14397, 14710, 15522, 16108, 16754]","[0, 170, 260, 410, 715, 805, 895, 1030, 1196, 1456, 1737, 1827, 2252, 2592, 2736, 3077, 3844, 4274, 4577, 4807, 5227, 5355, 5819, 5989, 6429, 6875, 7400, 7990, 8249, 8571, 8686, 8844, 9844, 10342, 10877]","[0, 213, 416, 553, 806, 1041, 1216, 1466, 1604, 1838, 2111, 2201, 2705, 3084, 3514, 3705, 4017, 4483, 4578, 4936, 5597, 5691, 5888, 6089, 6309, 6678, 6957, 7254, 7376, 7472, 7568, 7769, 8139, 8239, 8523]",19442,16788,16754,10877,8523,54,52,129,121,26,"[0, 207, 439, 708, 1088, 1367, 1639, 2088, 2597, 2853, 3171, 3619, 4219, 4791, 5380, 5914, 7047, 7756, 8397, 9066, 9583, 10465, 11322, 12518, 13213, 13908, 14581, 15441, 16313, 16746, 17044, 19029, 19565, 20920, 21648]","[0, 243, 532, 859, 1348, 1763, 2049, 2375, 2947, 3394, 4329, 4714, 5553, 6065, 6627, 7021, 7620, 8186, 8783, 9431, 10101, 10994, 11922, 12564, 13693, 14390, 15074, 15169, 16300, 16680, 16776, 18877, 19820, 20333, 21216]","[0, 170, 553, 940, 1350, 1567, 2085, 2503, 2865, 3414, 4014, 4594, 5142, 5680, 6052, 6587, 7432, 7872, 8446, 9200, 9969, 10608, 11503, 12017, 12359, 13186, 13876, 13971, 14562, 14765, 14984, 16500, 16825, 17139, 17439]","[0, 170, 294, 471, 688, 898, 1033, 1123, 1300, 1525, 1868, 1958, 2138, 2335, 2532, 2784, 3032, 3237, 3332, 3599, 3757, 4018, 4264, 4359, 4525, 4983, 5159, 5254, 5687, 5997, 6093, 6504, 7297, 7879, 8179]","[0, 170, 274, 364, 494, 624, 777, 867, 1044, 1134, 1316, 1546, 1863, 2093, 2242, 2337, 2729, 2886, 2981, 3630, 3788, 3882, 3977, 4252, 4592, 4759, 4935, 5030, 5252, 5348, 5444, 5753, 6628, 6728, 7460]",21648,21216,17439,8179,7460,-2206,-4428,-685,2698,1063,-3558,35,dire
7623846810,48,49,23,79,5,"[0, 170, 579, 904, 1193, 1521, 1979, 2278, 2828, 3180, 3582, 4261, 4867, 5605, 6261, 6948, 7579, 8657, 9349, 10443, 11449, 12585, 13239, 14338, 15937, 16615, 17968, 18708, 19658, 20528, 21937, 22388, 23356, 23856, 25007]","[0, 238, 565, 1010, 1466, 1854, 2276, 2699, 3079, 3649, 4259, 4891, 5308, 5847, 6541, 6997, 7419, 8068, 8309, 8921, 9274, 10010, 10567, 11260, 12164, 12563, 13511, 14136, 14965, 15769, 16363, 16739, 16880, 17845, 18156]","[0, 260, 543, 830, 1237, 1442, 1781, 1916, 2299, 2861, 3082, 3538, 4490, 5274, 5976, 6448, 6890, 7993, 8399, 8754, 9162, 9452, 9936, 10477, 10801, 11098, 11563, 11974, 12634, 13376, 14118, 14447, 14639, 15005, 15694]","[0, 170, 260, 384, 519, 649, 789, 924, 1014, 1280, 1893, 1983, 2302, 2635, 2880, 3023, 3298, 3935, 4172, 4534, 4901, 5167, 5525, 6001, 6383, 6684, 7086, 7403, 7763, 8087, 8454, 8756, 8933, 9168, 9562]","[0, 215, 305, 413, 634, 764, 937, 1072, 1201, 1335, 1779, 2050, 2254, 2636, 2934, 3294, 3536, 3976, 4189, 4567, 4661, 4872, 5466, 5830, 6105, 6396, 6882, 7267, 7569, 8025, 8394, 8561, 8731, 9210, 9689]",25007,18156,15694,9562,9689,10,98,17,19,110,"[0, 258, 545, 859, 1213, 1700, 2148, 2529, 2914, 3473, 4106, 4824, 5347, 5873, 6575, 7151, 7903, 8331, 9182, 9775, 10558, 11457, 12417, 13363, 14512, 15367, 16153, 16406, 17295, 18334, 19288, 20362, 21563, 22763, 23779]","[0, 206, 512, 720, 1008, 1253, 1459, 2230, 2805, 3258, 3818, 4170, 4651, 5096, 5630, 6489, 7118, 7729, 8689, 8784, 9865, 10725, 10892, 11366, 12185, 12980, 13739, 14173, 14468, 14666, 15469, 15917, 16066, 16303, 16595]","[0, 321, 608, 1020, 1303, 1576, 1764, 2077, 2646, 2850, 3537, 4011, 4525, 5200, 5730, 6320, 6853, 7429, 7891, 8095, 8496, 9263, 9910, 10546, 11151, 11487, 11687, 12557, 13161, 13637, 14013, 14383, 14673, 15079, 15512]","[0, 216, 341, 431, 605, 733, 823, 1048, 1261, 1484, 1761, 1851, 2032, 2257, 2725, 2920, 3189, 3744, 3940, 4040, 4237, 4404, 5015, 5544, 5844, 6180, 6633, 7064, 7252, 7597, 7909, 8292, 8612, 9256, 9583]","[0, 172, 266, 376, 551, 641, 731, 866, 1190, 1280, 1566, 1656, 1891, 2120, 2484, 2942, 3165, 3385, 3800, 4100, 4299, 4645, 4812, 5106, 5308, 5761, 5937, 6077, 6520, 6616, 6712, 7123, 7271, 7508, 7698]",23779,16595,15512,9583,7698,1228,1561,182,-21,1991,4941,35,radiant
7623881615,36,4,129,86,123,"[0, 235, 596, 1020, 1494, 1993, 2324, 3035, 3421, 3869, 4712, 5185, 5572, 6225, 6812, 7446, 8353, 8728, 8823, 9072, 9502, 9954, 10796, 12027, 12748, 13526, 14360, 16203, 16875, 17479, 18457, 19252, 20069, 20404, 20732]","[0, 192, 424, 625, 784, 874, 1203, 1625, 2023, 2296, 2978, 3400, 4114, 4352, 4780, 5290, 5831, 6467, 6916, 7507, 8181, 8636, 8731, 9201, 9874, 10994, 12039, 13489, 14154, 14839, 15304, 15404, 16431, 16811, 17484]","[0, 263, 693, 976, 1286, 1454, 1913, 2083, 2372, 2822, 3215, 3391, 3840, 4348, 4742, 5207, 5730, 6233, 6365, 6581, 6739, 7044, 7510, 8070, 8376, 9006, 9245, 9656, 10386, 10705, 10801, 11058, 11680, 11780, 12108]","[0, 154, 854, 944, 1184, 1528, 2024, 2431, 2783, 3111, 3389, 3564, 3849, 4210, 4445, 4583, 4880, 4975, 5104, 5198, 5452, 5721, 6347, 7944, 8039, 8746, 9082, 9899, 10212, 10308, 10404, 10717, 11085, 11185, 11513]","[0, 154, 244, 350, 483, 573, 934, 1146, 1381, 1580, 1882, 1972, 2145, 2402, 2637, 2731, 3035, 3130, 3411, 3593, 3751, 4287, 4430, 4900, 5209, 6129, 6419, 7132, 7519, 7717, 7834, 8091, 8373, 8473, 8573]",20732,17484,12108,11513,8573,106,98,93,19,112,"[0, 390, 753, 1042, 1239, 1586, 1833, 2182, 2548, 2819, 3542, 3838, 4419, 4899, 5461, 5727, 6173, 6763, 8117, 9196, 10161, 11268, 12438, 12974, 13196, 13812, 13907, 14524, 15137, 16201, 17101, 18135, 18827, 19535, 21790]","[0, 234, 563, 851, 1027, 1191, 1690, 2096, 2223, 2712, 2997, 3314, 3404, 4451, 5168, 5641, 5886, 6741, 7272, 7649, 8860, 9568, 10118, 10774, 11246, 11638, 12421, 12515, 13454, 14285, 15301, 16191, 16704, 17588, 18115]","[0, 341, 539, 1043, 1438, 1665, 1834, 2475, 2885, 3309, 3731, 4057, 4646, 4976, 5713, 6288, 6547, 7264, 7899, 8466, 9224, 9732, 10478, 10820, 11481, 11714, 12276, 12488, 13402, 13938, 14797, 15359, 15777, 16861, 17658]","[0, 234, 324, 449, 539, 754, 1173, 1468, 1558, 1933, 2113, 2203, 2438, 3149, 3442, 3832, 4017, 4661, 5053, 5604, 6142, 6659, 7401, 7828, 8225, 8825, 8920, 9498, 9960, 10286, 11192, 11604, 11704, 12604, 13730]","[100, 378, 468, 640, 809, 1142, 1277, 1502, 1592, 1794, 2020, 2231, 2367, 2462, 2755, 3129, 3287, 3799, 4422, 5014, 5457, 6632, 7127, 7320, 7597, 7967, 8461, 9078, 9643, 9996, 10321, 10621, 10721, 11005, 11906]",21790,18115,17658,13730,11906,-1058,-631,-5550,-2217,-3333,-12789,35,dire
7623943100,48,22,23,21,62,"[0, 227, 600, 889, 1328, 1496, 1726, 2153, 2641, 3126, 3791, 4343, 4941, 5639, 6060, 6382, 7362, 7945, 8798, 9631, 11413, 12027, 12761, 13719, 14295, 15367, 17065, 17639, 17906, 18389, 19131, 20041, 20614, 21561, 22782]","[0, 337, 838, 1234, 1579, 2063, 2449, 2839, 3328, 3866, 4346, 5004, 5734, 6121, 6524, 7133, 7716, 8420, 8979, 9222, 9897, 10224, 10318, 10564, 11280, 11978, 12458, 13470, 14411, 15483, 16274, 16976, 17621, 18382, 19475]","[0, 227, 465, 837, 1239, 1365, 2109, 2654, 3232, 3719, 4297, 5039, 5257, 5913, 6448, 7060, 7937, 8399, 9239, 9482, 10198, 10702, 10971, 11301, 12334, 12803, 13913, 14471, 14913, 15492, 15798, 16185, 16322, 17379, 18008]","[0, 495, 585, 768, 1119, 1301, 1627, 1807, 1946, 2141, 2371, 2730, 3004, 3153, 3501, 3760, 4303, 5347, 6106, 6621, 7652, 8180, 8386, 8481, 8612, 9252, 10225, 10555, 11175, 11642, 11909, 12661, 12761, 13268, 13458]","[12, 263, 353, 443, 621, 790, 1013, 1251, 1365, 1522, 1672, 1762, 2040, 2201, 2539, 2746, 3002, 3121, 3517, 3902, 4744, 4929, 5112, 5207, 5593, 6503, 7243, 7609, 7876, 7972, 8104, 8838, 8974, 9835, 10025]",22782,19475,18008,13458,10025,95,112,43,88,5,"[0, 292, 535, 779, 1331, 1616, 1912, 2444, 2940, 3497, 4043, 4502, 5012, 5544, 6055, 6763, 7332, 8366, 9436, 10469, 10740, 11076, 11975, 13007, 13789, 14747, 15114, 15792, 16979, 17838, 18548, 20382, 21119, 21309, 21825]","[0, 321, 601, 892, 1360, 1450, 2023, 2402, 2819, 3425, 3726, 4354, 5058, 5354, 5725, 6375, 6888, 7529, 8084, 9223, 9642, 10539, 11162, 12096, 12547, 12994, 13216, 13840, 15006, 15820, 16664, 17208, 18029, 18747, 19574]","[0, 250, 608, 921, 1168, 1624, 2084, 2750, 3156, 3780, 4200, 4722, 5172, 5523, 6350, 6836, 7181, 7765, 8214, 8724, 8921, 9481, 10117, 10853, 10970, 11260, 11355, 12469, 13858, 14135, 14708, 14898, 15354, 16179, 16724]","[0, 170, 260, 394, 524, 782, 872, 1052, 1272, 1543, 1903, 2485, 2924, 3569, 3809, 4012, 4475, 5192, 5541, 5896, 6486, 6822, 7503, 8063, 8646, 9028, 9879, 10276, 10987, 11325, 11528, 12539, 13087, 13797, 13897]","[0, 170, 260, 350, 544, 634, 810, 990, 1080, 1508, 1893, 2173, 2380, 2664, 2995, 3198, 3341, 3887, 4465, 4567, 4669, 4836, 5074, 5726, 5992, 6230, 6762, 7252, 7860, 8143, 8675, 9277, 10094, 10397, 10750]",21825,19574,16724,13897,10750,957,-99,1284,-439,-725,978,35,dire
7624146019,109,13,96,65,79,"[0, 555, 930, 1289, 1637, 1924, 2484, 2871, 3324, 4041, 4684, 5360, 6236, 6840, 7756, 8689, 9551, 10054, 11334, 11748, 12680, 13695, 14931, 15968, 17049, 17216, 18427, 20157, 20692, 21313, 21913, 22665, 23263, 23628, 24982]","[0, 208, 469, 596, 977, 1320, 1701, 2149, 2564, 3339, 3920, 4278, 4566, 5351, 6049, 6658, 7306, 8049, 8450, 8834, 9646, 10162, 10355, 10758, 11215, 12101, 12675, 13591, 14175, 14440, 14876, 15853, 16281, 16734, 17445]","[0, 170, 521, 852, 1217, 1393, 1717, 2312, 2722, 3207, 3504, 4011, 4630, 5026, 5584, 6186, 6892, 7581, 7990, 8307, 9081, 9838, 10562, 10743, 11604, 12327, 13054, 13676, 13772, 13868, 14468, 15046, 15436, 15536, 16355]","[0, 239, 684, 822, 1005, 1502, 1682, 1846, 2030, 2327, 2800, 2944, 3180, 3274, 3669, 4124, 4623, 4983, 5119, 5320, 5732, 5928, 6095, 6608, 6955, 7820, 8169, 8686, 9033, 9129, 9335, 9855, 10004, 10150, 10605]","[0, 170, 290, 428, 558, 648, 828, 963, 1106, 1374, 1667, 1857, 2094, 2372, 2998, 3355, 3924, 4081, 4267, 4468, 4626, 4817, 4984, 5192, 5693, 5860, 5989, 6506, 6676, 6772, 7182, 7718, 7948, 8048, 8990]",24982,17445,16355,10605,8990,18,23,126,5,86,"[0, 202, 499, 754, 1176, 1544, 1911, 2340, 2961, 3586, 4596, 5013, 5524, 6863, 7612, 8394, 8845, 9679, 10397, 12076, 12980, 14232, 15348, 16659, 18076, 18542, 20046, 21416, 22404, 23575, 24085, 25357, 26272, 27041, 29106]","[0, 178, 769, 1098, 1478, 1803, 2036, 2414, 2969, 3238, 3746, 4397, 4883, 5468, 5718, 6242, 7715, 8344, 9038, 9973, 10507, 11170, 11586, 12182, 12848, 13229, 13820, 14184, 14617, 15240, 15860, 16254, 16354, 16454, 17123]","[0, 287, 573, 956, 1322, 1708, 2128, 2829, 3159, 3286, 3672, 4382, 5108, 5960, 6244, 6707, 7267, 7704, 8214, 8877, 9634, 10188, 10734, 11187, 12267, 12794, 13353, 14102, 14767, 15117, 15514, 15951, 16198, 16346, 17307]","[0, 130, 220, 407, 543, 680, 770, 982, 1133, 1301, 1860, 2060, 2540, 2885, 3241, 3438, 4147, 4513, 5026, 5676, 5866, 6171, 6785, 7399, 8268, 8956, 9236, 9770, 10235, 10549, 11015, 11425, 11798, 11898, 12781]","[0, 130, 311, 401, 540, 793, 883, 1018, 1108, 1198, 1435, 1721, 1899, 2437, 2677, 3153, 3925, 4130, 4385, 5144, 5434, 5823, 6301, 6680, 7566, 7767, 7972, 8431, 9036, 9511, 9764, 9954, 10054, 10192, 10802]",29106,17123,17307,12781,10802,-4124,322,-952,-2176,-1812,-8742,35,dire
7624389211,41,120,98,47,105,"[0, 285, 713, 961, 1303, 1522, 1987, 2333, 3038, 3418, 3918, 4298, 4739, 5398, 5699, 6520, 7163, 7774, 8375, 8766, 9041, 10636, 11903, 12554, 13437, 13922, 15306, 16367, 17095, 17525, 18275, 19302, 19801, 21060, 22224]","[0, 297, 620, 931, 1393, 1606, 2025, 2653, 3258, 3854, 4929, 5271, 6304, 7043, 7138, 7943, 8703, 9409, 10270, 10716, 11015, 12241, 12970, 13064, 13489, 14074, 15025, 15936, 16645, 17105, 17888, 18852, 19910, 20405, 21960]","[0, 247, 564, 796, 1519, 1865, 2231, 2656, 3053, 3290, 3659, 4248, 4755, 5669, 6146, 7410, 8131, 8919, 9178, 9713, 10018, 10857, 11708, 12053, 12460, 12555, 13294, 14584, 15293, 15727, 16816, 17943, 18336, 18905, 20432]","[0, 210, 300, 471, 758, 848, 1504, 1684, 2000, 2090, 2727, 3050, 3604, 3933, 4393, 4725, 5410, 6108, 6529, 6874, 7354, 8193, 8790, 9027, 9301, 9396, 9914, 10464, 10789, 11056, 11493, 12125, 12225, 13125, 14950]","[0, 210, 300, 406, 654, 744, 1321, 1501, 1926, 2270, 2581, 2725, 3196, 3525, 4174, 4776, 5266, 5424, 5684, 6024, 6445, 6878, 7308, 7601, 7828, 7954, 8660, 9400, 9577, 9808, 9904, 10998, 11314, 12341, 13432]",22224,21960,20432,14950,13432,10,76,96,52,5,"[60, 229, 656, 880, 1087, 1339, 1851, 2251, 2714, 3059, 3605, 4048, 4694, 5816, 6568, 7030, 7449, 8202, 9061, 10109, 11244, 11647, 12429, 12858, 13965, 15557, 15958, 16052, 16229, 16450, 16829, 17019, 17603, 18033, 18133]","[60, 315, 717, 1171, 1455, 1902, 2427, 2754, 3089, 3269, 3683, 4067, 4720, 5055, 5610, 6166, 6568, 7172, 7828, 8406, 8741, 8836, 9247, 9882, 10486, 10821, 11323, 12066, 12492, 12707, 12979, 13761, 14281, 14461, 14561]","[328, 693, 898, 1287, 1754, 2306, 2586, 3042, 3358, 3794, 4154, 4770, 4979, 5462, 5839, 6279, 6481, 6895, 7455, 8259, 8847, 9017, 9508, 9854, 10564, 11378, 11864, 12033, 12433, 12650, 13003, 13617, 14108, 14208, 14308]","[60, 255, 388, 552, 814, 1108, 1508, 1989, 2116, 2637, 3337, 3748, 4003, 5346, 5456, 5830, 5925, 6281, 6820, 7272, 7617, 7712, 7999, 8600, 9178, 9799, 10156, 10285, 10719, 11239, 11695, 11885, 11985, 12206, 12306]","[160, 355, 445, 552, 642, 751, 1085, 1423, 1513, 1790, 2547, 2667, 2957, 3642, 3807, 4085, 4180, 4324, 4673, 5207, 5758, 5853, 6234, 6505, 7048, 8037, 8371, 8673, 8894, 9119, 9634, 9913, 10219, 10515, 10615]",18133,14561,14308,12306,10615,4091,7399,6124,2644,2817,23075,35,radiant
7624424306,95,19,28,66,9,"[0, 179, 470, 723, 1089, 1296, 1765, 2187, 2525, 2931, 3152, 3622, 4093, 4683, 5308, 5933, 6440, 7092, 7625, 7846, 8640, 9123, 10119, 10358, 11523, 12219, 13042, 14247, 14950, 15567, 16237, 17240, 19437, 20317, 20637]","[0, 169, 442, 772, 1210, 1385, 1681, 2228, 2568, 3289, 3465, 3814, 4265, 4650, 5227, 5656, 6026, 6670, 7012, 7564, 8210, 8550, 9372, 10009, 10201, 11162, 11605, 11835, 12229, 12437, 13261, 13971, 15492, 16582, 17190]","[0, 256, 576, 868, 1164, 1607, 2106, 2705, 3341, 3870, 4439, 4932, 5336, 5431, 5935, 6365, 6685, 7678, 8016, 8708, 9182, 9277, 9749, 10739, 11019, 11390, 12261, 12906, 13116, 13293, 13991, 14942, 16839, 17872, 18449]","[0, 130, 254, 392, 598, 688, 896, 1401, 1604, 1729, 2125, 2449, 2677, 2813, 3022, 3462, 3658, 3947, 4468, 4913, 5546, 5716, 6047, 6632, 7186, 7413, 7947, 8655, 9332, 10285, 11071, 11808, 12947, 13500, 13841]","[0, 130, 220, 310, 528, 1064, 1203, 1537, 1627, 1780, 1915, 2085, 2254, 2632, 2816, 3353, 3475, 4379, 4853, 5497, 5797, 5971, 6688, 7307, 7484, 8234, 8736, 9018, 9114, 9544, 9640, 9895, 11185, 11618, 12270]",20637,17190,18449,13841,12270,18,15,77,65,5,"[0, 210, 595, 799, 1166, 1525, 1773, 2054, 2350, 2736, 3408, 4040, 4774, 6239, 6985, 7475, 8323, 9031, 9672, 10068, 10791, 11320, 12197, 12644, 13402, 14288, 15643, 16342, 16710, 17829, 18674, 19424, 19524, 20546, 21629]","[0, 245, 479, 714, 1076, 1544, 1942, 2569, 2784, 3129, 3965, 4817, 5477, 6163, 6718, 7044, 7471, 8090, 8194, 8996, 10266, 10961, 12505, 12780, 13331, 13766, 14450, 14806, 15283, 16058, 16681, 17709, 17809, 18242, 19650]","[0, 298, 555, 935, 1151, 1482, 1956, 2325, 2780, 3090, 3583, 3941, 4707, 5205, 5578, 6197, 6892, 7388, 7890, 8747, 9829, 10881, 11696, 12260, 12536, 12882, 13609, 14195, 14503, 15064, 15342, 16025, 16125, 16487, 17006]","[0, 210, 338, 428, 518, 905, 995, 1326, 1451, 1681, 2554, 2856, 3163, 3709, 4132, 4809, 5363, 5872, 5966, 6743, 7215, 7431, 8197, 8680, 8974, 9312, 9654, 9911, 10007, 11072, 11303, 11756, 11984, 12382, 13287]","[0, 210, 300, 416, 554, 644, 734, 952, 1171, 1580, 1801, 2219, 2417, 2820, 3082, 3188, 3782, 4148, 4274, 4623, 5003, 5219, 5879, 5974, 6371, 6614, 7072, 7257, 7353, 7970, 8245, 8714, 8927, 9551, 10091]",21629,19650,17006,13287,10091,-992,-2460,1443,554,2179,724,35,radiant
7624763717,10,15,137,86,103,"[0, 276, 634, 984, 1327, 1705, 1987, 2469, 2919, 3138, 3489, 3994, 4424, 5186, 5783, 6345, 7154, 7820, 8508, 9042, 9711, 10343, 11506, 12012, 12995, 13263, 14060, 14575, 15091, 15355, 16252, 16626, 17127, 17227, 17387]","[0, 264, 437, 773, 1332, 1793, 2164, 2509, 2933, 3219, 3887, 4611, 4879, 5126, 5829, 6196, 6815, 7366, 7949, 8267, 8601, 8933, 9900, 10338, 10528, 11329, 11965, 12502, 12884, 12980, 13423, 13890, 14192, 14307, 15019]","[0, 194, 501, 779, 1217, 1458, 1958, 2464, 3041, 3167, 4029, 4222, 4678, 5141, 5577, 5920, 6353, 6985, 7245, 7708, 8395, 8734, 9187, 9481, 10046, 10533, 11100, 11463, 11988, 12240, 12762, 13320, 13843, 13963, 14314]","[0, 248, 390, 518, 750, 840, 1151, 1412, 1533, 1933, 2305, 2771, 3226, 3487, 4014, 4227, 4442, 4745, 4980, 5380, 5775, 5901, 6147, 6505, 6859, 6954, 7154, 7432, 7528, 7682, 7995, 8490, 8590, 8765, 9498]","[0, 194, 284, 374, 522, 616, 706, 888, 978, 1230, 1607, 1996, 2086, 2347, 2693, 2787, 3059, 3217, 3359, 3571, 3800, 3895, 4295, 4389, 5147, 5242, 5538, 5633, 5776, 5920, 6235, 6425, 6594, 6809, 7235]",17387,15019,14314,9498,7235,54,120,69,33,105,"[0, 207, 560, 1040, 1370, 1821, 2232, 2854, 3382, 3930, 4482, 5154, 5867, 6446, 7028, 7812, 8673, 9405, 10146, 11086, 12049, 12857, 13588, 14310, 15417, 16220, 17192, 18204, 18850, 19841, 20896, 21867, 22939, 24132, 25920]","[0, 216, 381, 828, 1165, 1585, 1867, 2200, 2762, 3362, 3885, 4420, 5290, 5938, 6651, 7336, 7787, 8528, 8623, 9077, 9949, 10695, 11013, 11804, 12490, 13665, 14431, 15233, 15870, 16634, 17339, 17730, 18631, 19472, 20911]","[0, 292, 616, 909, 1223, 1556, 2023, 2442, 2887, 3350, 3836, 4443, 4901, 5550, 5858, 6533, 7284, 7719, 8204, 8931, 9593, 9864, 10945, 11566, 12191, 12771, 13330, 14687, 14831, 15603, 16150, 17040, 17790, 18395, 19578]","[0, 219, 309, 480, 673, 937, 1061, 1262, 1580, 1752, 2014, 2290, 2455, 3096, 3329, 3772, 4409, 4708, 4878, 5245, 5490, 5839, 6201, 6677, 6900, 7274, 8149, 8589, 8946, 9430, 10124, 10763, 11412, 12114, 13278]","[0, 169, 259, 719, 857, 947, 1135, 1317, 1456, 1958, 2375, 2734, 2999, 3302, 3477, 3804, 4058, 4265, 4460, 4630, 4875, 5045, 5263, 5624, 6051, 6715, 7017, 7435, 7857, 8219, 8471, 8952, 9342, 9823, 10760]",25920,20911,19578,13278,10760,-8533,-5892,-5264,-3780,-3525,-26994,35,dire
7624854612,18,59,69,5,26,"[0, 294, 534, 982, 1352, 1793, 2284, 2724, 3471, 4094, 4641, 5397, 6282, 6620, 7068, 7707, 8229, 9265, 9840, 10706, 11872, 12328, 13325, 13700, 14714, 15329, 15994, 16866, 18430, 19454, 20268, 20796, 21924, 22566, 23381]","[0, 279, 654, 1076, 1370, 1753, 2452, 2908, 3455, 3786, 3876, 4424, 4961, 5427, 6057, 6643, 7307, 7814, 8386, 8833, 9194, 9568, 10315, 10715, 11229, 11651, 12393, 12841, 13678, 14396, 14920, 15299, 16003, 16733, 17083]","[0, 331, 582, 924, 1623, 1882, 2051, 2376, 2730, 3011, 3771, 3957, 4408, 4944, 5603, 5818, 6430, 7052, 7648, 8160, 8711, 9778, 10573, 11078, 11282, 11671, 11848, 12039, 13114, 13471, 14102, 14476, 14853, 15165, 15785]","[0, 170, 341, 466, 601, 735, 1150, 1269, 1418, 1591, 1681, 1938, 2417, 2512, 2660, 3015, 3366, 3572, 3870, 4448, 4847, 4953, 5434, 5719, 6048, 6441, 6535, 6704, 7314, 7564, 7774, 8072, 8172, 8461, 8891]","[0, 170, 340, 430, 634, 852, 991, 1205, 1340, 1430, 1780, 1870, 2348, 2443, 2638, 2733, 2883, 3254, 3396, 3554, 3739, 4078, 4289, 4601, 4850, 5035, 5129, 5224, 6103, 6289, 6486, 6676, 6823, 7167, 7376]",23381,17083,15785,8891,7376,54,120,129,100,110,"[0, 170, 545, 970, 1302, 2102, 2658, 3285, 3846, 4328, 5080, 5533, 6066, 6518, 7088, 7675, 8547, 9348, 10192, 10959, 11656, 12534, 13263, 14057, 15233, 15757, 16736, 17516, 17856, 18621, 19500, 19757, 20718, 21610, 22458]","[0, 289, 479, 724, 1022, 1200, 1598, 2166, 2608, 3180, 3702, 4063, 4777, 5513, 6298, 6695, 7213, 7686, 8343, 8693, 9131, 9403, 9867, 10353, 11144, 11777, 12118, 12663, 13491, 14389, 14873, 15526, 16125, 16690, 17263]","[0, 170, 593, 867, 1313, 1627, 2033, 2557, 3042, 3511, 4343, 4708, 5271, 5852, 6181, 6515, 7301, 7648, 8263, 8823, 9549, 9644, 10319, 11199, 11678, 11939, 12265, 12771, 13058, 13429, 13927, 14355, 14905, 15303, 15403]","[0, 170, 285, 375, 589, 679, 1053, 1301, 1436, 1665, 2007, 2097, 2346, 2549, 2890, 3191, 3554, 3672, 4059, 4473, 4766, 4936, 5240, 5670, 5950, 6303, 6472, 6818, 7664, 8241, 8657, 8984, 9114, 9517, 9692]","[0, 170, 285, 427, 597, 782, 1234, 1447, 1582, 2004, 2497, 2712, 3083, 3368, 3740, 4309, 4851, 5055, 5544, 5884, 6173, 6268, 6497, 6664, 6895, 7551, 7795, 8104, 8391, 8649, 8961, 9196, 9296, 9571, 9671]",22458,17263,15403,9692,9671,923,-180,382,-801,-2295,-1971,35,dire
7624880815,15,96,112,100,88,"[78, 465, 778, 1041, 1404, 1777, 2102, 2421, 3097, 3489, 3820, 4333, 4517, 5043, 5535, 6129, 7054, 8142, 8840, 9647, 9955, 10891, 12001, 12206, 12983, 13632, 14241, 15098, 15496, 16997, 17831, 19200, 19778, 20419, 20519]","[78, 565, 877, 1194, 1556, 2089, 2563, 2845, 3181, 3509, 3826, 4387, 4925, 5387, 6045, 6815, 7977, 8482, 10085, 10243, 10338, 11030, 11759, 12306, 13680, 14314, 14927, 15660, 16291, 17375, 18175, 19413, 20122, 20460, 21442]","[211, 706, 1147, 1544, 1949, 2524, 2767, 3096, 3643, 3895, 4452, 4770, 5221, 5782, 6690, 7457, 9109, 9914, 10135, 10641, 10736, 11328, 12441, 13980, 14433, 15102, 15732, 15935, 16512, 16874, 17262, 17960, 18406, 18668, 18807]","[78, 360, 501, 817, 907, 1206, 1296, 1719, 1938, 2160, 2334, 2617, 2936, 3064, 3280, 3465, 4513, 4964, 5321, 5581, 5676, 6112, 6599, 6743, 7055, 7844, 8341, 8536, 8860, 10127, 10569, 11270, 11901, 12604, 13815]","[78, 289, 409, 548, 638, 1038, 1128, 1300, 1676, 1899, 2034, 2124, 2675, 2769, 3621, 3974, 4310, 4969, 5719, 6293, 6441, 6881, 7450, 7813, 8545, 9268, 9520, 9715, 10039, 10135, 11072, 12031, 12221, 12483, 12583]",20519,21442,18807,13815,12583,69,63,53,13,65,"[323, 853, 1131, 1537, 1934, 2269, 2711, 3086, 3709, 4090, 4988, 5461, 6033, 6669, 7313, 7898, 8500, 8777, 9707, 10266, 11225, 11471, 11934, 12555, 12761, 13130, 13684, 14702, 15579, 16037, 16720, 17422, 17699, 18435, 19017]","[55, 426, 670, 884, 1329, 1858, 2206, 2836, 3136, 3603, 4058, 4534, 5236, 5892, 6179, 6626, 7062, 7244, 7670, 8607, 9539, 10059, 10275, 11171, 12017, 12456, 13162, 13437, 14911, 15502, 15598, 16322, 16904, 18198, 18940]","[55, 559, 649, 788, 947, 1267, 1357, 1583, 2068, 2263, 2774, 3172, 3514, 3662, 4062, 4581, 5120, 5418, 6675, 7015, 7855, 8588, 9057, 10743, 11287, 11711, 12069, 13004, 13912, 14199, 14480, 15299, 15481, 17216, 17671]","[55, 597, 1002, 1282, 1652, 2030, 2282, 2614, 2831, 3355, 3867, 4453, 4771, 5218, 5741, 6240, 6755, 6920, 7914, 8447, 9111, 10077, 10390, 10784, 11341, 11716, 12594, 12995, 14031, 14318, 14689, 15046, 15146, 16078, 16268]","[55, 559, 649, 739, 962, 1289, 1379, 1767, 1902, 2384, 2618, 2930, 3364, 3765, 4160, 4315, 4665, 5044, 5826, 6189, 6378, 7077, 7300, 8596, 8903, 9259, 9832, 10470, 10922, 11018, 11362, 11905, 12280, 12745, 13021]",19017,18940,17671,16268,13021,1502,2502,1136,-2453,-438,2249,35,radiant
7625161613,15,10,96,123,86,"[0, 285, 722, 1053, 1470, 1937, 2447, 3215, 3570, 4080, 4512, 4970, 5569, 6230, 6648, 7181, 7484, 7792, 8678, 9217, 10186, 10435, 11024, 11571, 11944, 12644, 13419, 13514, 14126, 14878, 15446, 16379, 16989, 17673, 18480]","[0, 214, 373, 703, 1028, 1314, 1549, 1814, 2205, 2600, 2886, 3268, 3712, 4601, 5052, 5401, 5619, 6084, 6454, 7141, 8016, 8315, 8595, 9048, 9720, 10047, 11262, 11835, 12811, 13590, 14261, 14826, 15165, 15655, 15845]","[0, 314, 634, 871, 1246, 1443, 1926, 2323, 2499, 3059, 3465, 3817, 4212, 4567, 5099, 5406, 5741, 6283, 6776, 7038, 7390, 7485, 8336, 8516, 9154, 9378, 9937, 10395, 11006, 11102, 11325, 12085, 12440, 12871, 13734]","[0, 501, 591, 838, 1017, 1107, 1385, 1752, 1842, 1980, 2114, 2577, 2744, 3370, 3637, 3815, 3909, 4232, 4502, 4696, 5011, 5106, 5365, 5797, 6021, 6245, 6581, 6767, 7027, 7192, 7401, 7997, 8518, 8658, 9416]","[0, 233, 368, 635, 864, 1073, 1391, 1778, 2112, 2393, 2529, 3016, 3224, 3654, 4096, 4442, 4536, 4656, 4934, 5130, 5564, 5659, 5812, 6253, 6383, 6478, 6785, 7210, 7759, 7904, 8168, 8357, 8603, 8902, 9092]",18480,15845,13734,9416,9092,54,90,19,9,5,"[0, 280, 442, 794, 1004, 1362, 1700, 2006, 2471, 2928, 3417, 3582, 4189, 4848, 5520, 6303, 6945, 7679, 8321, 8831, 9698, 10839, 11423, 11891, 12609, 13618, 14889, 15847, 17559, 18413, 19254, 20704, 21391, 21791, 22560]","[0, 293, 645, 934, 1502, 1951, 2790, 3154, 3421, 3970, 4276, 4447, 4993, 5334, 5577, 6084, 6816, 7677, 7772, 8096, 8749, 9500, 10439, 10829, 11401, 12134, 13045, 14000, 14763, 14950, 15305, 16519, 17138, 17629, 18383]","[0, 209, 447, 916, 1162, 1890, 2182, 2547, 2939, 3267, 3827, 4042, 4469, 4601, 4957, 5392, 6013, 6562, 6657, 7221, 7665, 8110, 8826, 9495, 10117, 10578, 10967, 11472, 12070, 12533, 12878, 13299, 13879, 14561, 14868]","[0, 219, 355, 571, 661, 938, 1090, 1769, 2160, 2634, 2831, 2957, 3047, 3187, 4138, 4353, 4761, 5266, 5517, 5892, 6282, 7159, 7981, 8546, 8841, 9357, 9746, 10325, 11654, 12202, 12530, 12880, 13149, 13439, 13674]","[0, 170, 260, 492, 582, 748, 1016, 1106, 1196, 1416, 1733, 1861, 2182, 2276, 2635, 3039, 3895, 4271, 4408, 4992, 5230, 5996, 6351, 6581, 6675, 6880, 7085, 7669, 8117, 8320, 8550, 8998, 9223, 9820, 10055]",22560,18383,14868,13674,10055,-4080,-2538,-1134,-4258,-963,-12973,35,dire
7625218507,61,20,36,33,58,"[0, 169, 443, 674, 801, 1020, 1504, 1960, 2050, 2565, 2877, 3206, 4027, 4825, 5466, 5912, 6130, 6542, 7546, 8007, 8347, 9253, 9798, 10494, 11348, 12338, 13084, 15057, 15819, 16405, 17166, 18167, 18914, 19745, 21509]","[0, 328, 647, 1051, 1340, 1876, 2082, 2218, 2513, 3460, 4087, 4708, 5361, 5634, 5974, 6438, 6680, 7188, 7520, 8918, 9548, 10319, 11036, 11475, 12218, 12913, 13232, 14252, 14973, 15752, 16427, 16656, 17359, 18389, 19767]","[0, 290, 649, 897, 1033, 1245, 1612, 1953, 2418, 3007, 3743, 4605, 5339, 6124, 6901, 7295, 7592, 8378, 8979, 9231, 9942, 11052, 11607, 12355, 13063, 13965, 14060, 14749, 15193, 15329, 15490, 15590, 15690, 16308, 16533]","[0, 169, 259, 369, 478, 624, 925, 1102, 1324, 2335, 2673, 3249, 4115, 4319, 4556, 4672, 5135, 5505, 6211, 6704, 7010, 7979, 8400, 8845, 9303, 9942, 10112, 10905, 11375, 11678, 11954, 12732, 13027, 13782, 15244]","[0, 169, 259, 365, 494, 641, 854, 1039, 1129, 1417, 1767, 2089, 2811, 3210, 3477, 3573, 3791, 3969, 4159, 4411, 4721, 5288, 5814, 6314, 6978, 7388, 7936, 8422, 9311, 9690, 9786, 9886, 9986, 10691, 11798]",21509,19767,16533,15244,11798,10,126,49,71,79,"[0, 586, 983, 1236, 1555, 1979, 2491, 2617, 3072, 3541, 4055, 4539, 5330, 5913, 7090, 7631, 8645, 9296, 10164, 11072, 11959, 12376, 13748, 14477, 15197, 17136, 17977, 19192, 19288, 19921, 21072, 22885, 23612, 24711, 24811]","[0, 272, 467, 622, 1035, 1322, 1679, 2052, 2398, 2899, 3346, 3805, 4108, 4345, 4723, 5834, 7235, 8211, 8851, 9162, 9483, 9708, 10521, 10729, 11570, 12148, 13222, 14688, 15226, 15591, 16196, 17435, 17813, 18087, 19178]","[0, 169, 502, 910, 1106, 1442, 1765, 1963, 2674, 3315, 3868, 3958, 4557, 5188, 5446, 5924, 6989, 7374, 7787, 8524, 8619, 9006, 9339, 9783, 10254, 11154, 12199, 12929, 13025, 13284, 13794, 15202, 15814, 16315, 16807]","[0, 235, 377, 515, 605, 784, 1037, 1369, 1631, 2233, 2485, 2666, 2915, 3013, 3365, 3846, 4757, 5487, 5582, 6716, 7155, 7749, 8465, 8734, 9131, 9768, 10184, 10936, 11032, 11185, 12378, 13057, 13817, 14695, 15849]","[0, 169, 279, 399, 528, 790, 1131, 1710, 1935, 2467, 2602, 2728, 2818, 2971, 3260, 3949, 4771, 5290, 5433, 6273, 6591, 7226, 7646, 7788, 8007, 8529, 8898, 9783, 10002, 10402, 11104, 12240, 12536, 12927, 13634]",24811,19178,16807,15849,13634,-3302,589,-274,-605,-1836,-5428,35,dire
7625316506,73,10,37,104,112,"[0, 508, 1167, 1530, 2013, 2426, 3130, 3494, 4197, 4547, 5334, 6112, 6643, 7907, 8572, 9285, 10475, 12036, 12423, 12851, 13975, 15605, 16336, 17134, 17813, 18270, 19193, 20305, 21156, 22013, 22812, 22912, 23490, 24365, 25610]","[0, 312, 621, 942, 1254, 1740, 1987, 2296, 2422, 2761, 3140, 3543, 4064, 4471, 4821, 5166, 5665, 6344, 7130, 7823, 8623, 8982, 10072, 10307, 10596, 11306, 11920, 12829, 13265, 13524, 13808, 14502, 15429, 16201, 17294]","[0, 195, 285, 537, 707, 893, 983, 1140, 1397, 1684, 2215, 2428, 2622, 2860, 3554, 3794, 4530, 5204, 5970, 6288, 6695, 7813, 8240, 9664, 9878, 10293, 10388, 11713, 12042, 12462, 12889, 13642, 14162, 14512, 15246]","[0, 273, 864, 1241, 1879, 2169, 2572, 3165, 3788, 4381, 5115, 5556, 6468, 6768, 7013, 7586, 8120, 8956, 9933, 10173, 10534, 11134, 11594, 11689, 12021, 12726, 13300, 13711, 13806, 14930, 15026, 16126, 16511, 16926, 17885]","[0, 195, 353, 443, 1089, 1365, 1455, 1641, 2048, 2372, 2642, 2907, 3150, 3399, 3605, 3800, 4512, 5268, 5822, 6066, 6456, 6815, 7370, 7465, 7719, 7814, 8068, 8628, 8954, 9288, 9426, 10283, 10383, 10573, 11401]",25610,17294,15246,17885,11401,1,106,29,123,71,"[64, 317, 598, 961, 1186, 1683, 1968, 2292, 2956, 3321, 3707, 4197, 4944, 5604, 6924, 7550, 8385, 9250, 9345, 10163, 11454, 12626, 13428, 14487, 14653, 15974, 16518, 17832, 18471, 19491, 20769, 21882, 23175, 24597, 26028]","[64, 349, 670, 1158, 1482, 1810, 2270, 2699, 3264, 3619, 4189, 4452, 5063, 5425, 5786, 6231, 6782, 7120, 8024, 8636, 9268, 9508, 9840, 11300, 11501, 12365, 12948, 14007, 14524, 15021, 15669, 16642, 17344, 18156, 18909]","[64, 234, 545, 1099, 1504, 1801, 2287, 3044, 3810, 4423, 4820, 5541, 5974, 6453, 7061, 7637, 8057, 8542, 9196, 9833, 10571, 10811, 11150, 12555, 13475, 14065, 14343, 14934, 15139, 15809, 16273, 16802, 17587, 18159, 18761]","[332, 505, 625, 915, 1005, 1219, 1527, 1907, 2204, 2548, 2907, 3193, 3501, 3997, 4716, 4962, 5230, 5519, 6231, 6764, 7471, 7808, 8135, 9085, 9526, 10044, 10274, 11117, 11558, 11816, 12656, 13679, 14239, 14429, 15028]","[64, 234, 354, 479, 569, 1009, 1406, 1852, 2055, 2240, 2330, 2420, 2929, 3221, 4182, 4816, 5036, 5276, 5500, 5834, 6319, 6736, 6831, 7876, 8458, 8809, 9039, 9677, 10016, 10419, 11097, 11601, 11811, 12266, 12826]",26028,18909,18761,15028,12826,-418,-1615,-3515,2857,-1425,-4116,35,radiant
7625543012,13,78,32,19,65,"[0, 212, 528, 929, 1210, 1664, 1996, 2443, 3001, 3343, 3973, 4696, 5213, 5558, 6206, 6499, 7012, 7867, 8641, 9741, 10245, 10841, 11954, 12349, 12813, 13557, 14360, 15161, 15657, 16342, 16917, 18137, 19527, 20474, 21423]","[0, 241, 401, 650, 774, 1137, 1379, 1881, 2435, 2779, 3246, 3978, 4431, 4979, 5548, 5893, 6628, 6991, 7918, 9423, 10017, 11124, 11659, 12210, 12973, 13477, 14211, 15596, 16158, 16735, 17327, 18161, 19140, 20206, 21093]","[0, 253, 554, 922, 1210, 1537, 1863, 2170, 2438, 2683, 3350, 3609, 3757, 4492, 5282, 5555, 5891, 6501, 6843, 7351, 7818, 8451, 9020, 9187, 9384, 10150, 10819, 11470, 12374, 12795, 13503, 14365, 14868, 15404, 16081]","[0, 215, 330, 420, 510, 679, 821, 1392, 1945, 2122, 2324, 2743, 2881, 3118, 3521, 3910, 4178, 4542, 4817, 5405, 5940, 6596, 7140, 7514, 7736, 8189, 8482, 8577, 9049, 9650, 9974, 10530, 11596, 12373, 12763]","[0, 270, 385, 519, 609, 844, 1052, 1363, 1785, 2010, 2228, 2812, 2902, 3087, 3591, 3813, 4046, 4371, 4559, 5237, 5605, 6203, 6616, 6895, 7231, 7689, 8086, 8995, 9172, 9343, 10205, 10657, 11161, 11730, 12038]",21423,21093,16081,12763,12038,48,23,60,79,5,"[0, 243, 475, 719, 1425, 1745, 2067, 2387, 2601, 3128, 3704, 3839, 4400, 4991, 5777, 6519, 7480, 8350, 9056, 9716, 10856, 11560, 12348, 13466, 14222, 15006, 15863, 16481, 18062, 19168, 19772, 20583, 21713, 21813, 22521]","[0, 243, 654, 1107, 1559, 1979, 2559, 3313, 4364, 4795, 5198, 5543, 6338, 6765, 7087, 7182, 8111, 8718, 9160, 9564, 10006, 10778, 10969, 11735, 12191, 12427, 12711, 12806, 13655, 13991, 14217, 14554, 15123, 15873, 16017]","[0, 292, 543, 702, 918, 1215, 1747, 2143, 2625, 2864, 3544, 4016, 4270, 4555, 4900, 5179, 5550, 6151, 6409, 7277, 7617, 8110, 8813, 9386, 9750, 10084, 10711, 11380, 11942, 12334, 12644, 12925, 13025, 13578, 13678]","[0, 169, 259, 349, 439, 564, 768, 948, 1128, 1264, 1737, 2201, 2610, 3021, 3419, 3514, 3970, 4450, 4583, 4778, 4873, 5135, 5229, 5510, 5814, 6195, 6613, 7269, 8174, 8380, 8525, 8686, 9005, 9154, 9300]","[0, 169, 355, 445, 651, 758, 848, 1111, 1336, 1463, 1688, 1823, 2146, 2377, 2623, 2718, 2985, 3268, 3456, 3960, 4233, 4431, 4712, 5135, 5283, 5378, 5593, 5893, 6151, 6620, 6763, 6863, 7118, 7450, 7588]",22521,16017,13678,9300,7588,-1098,5076,2403,3463,4450,14294,35,radiant
7625796211,44,126,97,9,85,"[0, 336, 610, 1009, 1172, 1750, 2201, 2503, 3003, 3506, 3998, 4481, 4935, 5375, 6095, 6926, 7664, 8532, 9159, 9698, 10250, 11238, 12049, 12870, 13262, 14433, 15284, 15886, 16125, 17308, 17762, 18795, 19335, 21465, 21927]","[0, 249, 454, 629, 854, 1140, 1386, 1607, 1901, 2250, 2800, 3331, 3896, 4298, 4615, 5165, 5800, 6076, 6711, 7160, 7573, 8486, 9023, 9818, 10261, 10394, 10992, 11087, 11576, 12437, 12850, 13899, 14583, 15858, 16439]","[0, 327, 492, 790, 998, 1160, 1296, 1592, 1765, 2039, 2383, 2929, 3413, 4358, 5140, 5534, 6021, 6666, 7051, 7248, 7747, 7842, 8832, 9751, 9846, 10299, 10822, 11023, 11291, 11722, 12202, 12351, 12622, 13985, 14666]","[0, 301, 443, 533, 713, 803, 1305, 1405, 1544, 1709, 2015, 2151, 2407, 2648, 2802, 3135, 3425, 3617, 4219, 4651, 4976, 5579, 5788, 6569, 6664, 6759, 6883, 6978, 7074, 7388, 7646, 7924, 8307, 9112, 9564]","[0, 249, 391, 564, 654, 993, 1083, 1173, 1263, 1414, 1603, 1738, 2091, 2583, 2822, 2945, 3320, 3561, 3736, 4039, 4225, 4320, 4621, 5187, 5282, 5496, 5620, 5715, 5880, 6130, 6416, 6666, 6766, 7648, 7960]",21927,16439,14666,9564,7960,109,35,104,110,86,"[0, 138, 495, 912, 1201, 1483, 1928, 2499, 2885, 3488, 4117, 4553, 5170, 5806, 6316, 7004, 7464, 8120, 8891, 9618, 10694, 11034, 11438, 12600, 14013, 14768, 15832, 16813, 17832, 18550, 19682, 20508, 21450, 22109, 22770]","[0, 127, 376, 734, 1110, 1274, 1626, 2234, 2630, 3077, 3856, 4362, 5128, 5672, 6424, 7043, 7733, 8306, 8851, 9352, 9841, 10898, 11582, 12305, 12926, 13633, 14170, 14424, 14756, 15346, 15754, 16223, 17272, 17711, 17811]","[0, 210, 389, 735, 987, 1279, 1992, 2466, 2748, 3240, 3523, 3965, 4440, 4909, 5476, 5807, 6205, 6500, 7261, 7356, 8176, 8499, 9280, 9690, 10766, 11437, 11793, 11950, 12342, 12780, 13156, 13436, 14510, 14871, 14971]","[0, 89, 229, 367, 497, 587, 1041, 1224, 1367, 1482, 1738, 2198, 2727, 3084, 3277, 3781, 4144, 4486, 4856, 4951, 5311, 5704, 6153, 7010, 7469, 8073, 8540, 8750, 9120, 9372, 9820, 10100, 10601, 10995, 11288]","[0, 89, 312, 402, 604, 783, 967, 1102, 1370, 1575, 2016, 2296, 2682, 3085, 3606, 3905, 4427, 4757, 4935, 5178, 5383, 5726, 6005, 6502, 6732, 7159, 7468, 7616, 7906, 8083, 8459, 8739, 9731, 10255, 10355]",22770,17811,14971,11288,10355,-843,-1372,-305,-1724,-2395,-6639,35,dire
7627919905,48,106,60,26,45,"[0, 282, 483, 682, 1078, 1260, 1774, 2301, 2755, 3124, 3666, 4228, 4953, 5767, 6616, 7375, 8253, 9002, 10017, 10111, 11148, 11846, 12681, 13300, 13988, 15122, 15217, 16240, 17523, 18273, 18515, 19356, 20132, 20854, 21808]","[0, 251, 651, 1046, 1487, 1857, 2235, 2992, 3458, 3983, 4814, 5036, 5790, 6381, 6861, 6956, 7124, 7463, 8233, 8366, 8867, 9309, 10160, 10541, 10786, 11911, 12006, 13320, 13930, 14326, 14606, 15197, 16275, 16375, 16652]","[0, 170, 407, 614, 900, 1041, 1296, 1470, 1665, 2137, 2938, 3385, 3728, 4276, 4531, 5000, 5295, 5781, 6140, 6495, 6956, 7332, 7814, 8506, 9091, 9296, 9551, 10747, 11374, 11714, 12053, 12152, 12880, 13558, 13956]","[0, 170, 260, 395, 485, 575, 791, 1052, 1330, 1548, 1978, 2521, 2695, 2924, 3019, 3268, 3362, 3578, 3782, 3876, 4156, 4326, 4496, 4687, 4952, 5727, 5897, 6611, 6809, 7171, 7377, 8728, 8993, 9168, 9433]","[0, 170, 260, 350, 488, 616, 909, 1147, 1493, 1664, 2056, 2218, 2568, 2859, 3010, 3105, 3290, 3478, 4043, 4137, 4386, 4608, 4738, 4993, 5352, 5596, 5743, 6975, 7146, 7546, 7672, 8209, 8660, 8841, 9205]",21808,16652,13956,9433,9205,35,120,96,86,5,"[326, 568, 882, 1167, 1459, 2331, 2715, 3238, 3797, 4275, 4732, 4945, 5609, 6453, 7254, 7886, 9103, 9798, 11075, 11872, 12584, 13115, 14123, 14874, 15635, 17202, 18231, 18325, 18422, 19951, 20911, 22600, 23249, 23484, 24921]","[58, 304, 625, 914, 1292, 1708, 2379, 2634, 3357, 3905, 4664, 5219, 5872, 6653, 7397, 8254, 8954, 9150, 10150, 10499, 11008, 11608, 12180, 12440, 13258, 14661, 15473, 16073, 16827, 17855, 18797, 19517, 19817, 20543, 21301]","[58, 228, 556, 999, 1512, 1877, 2043, 2263, 2841, 3456, 4274, 5221, 5631, 6139, 6878, 7563, 8286, 8628, 9623, 10022, 10670, 10981, 11512, 11957, 12340, 12978, 13918, 14222, 14640, 15026, 15473, 16291, 17231, 17561, 17996]","[58, 228, 318, 666, 1026, 1304, 1480, 1721, 1811, 2057, 2327, 2471, 2561, 2885, 3497, 3646, 3973, 4428, 5399, 5666, 5949, 6749, 7469, 7563, 7782, 8619, 9232, 9326, 9557, 10831, 11337, 12121, 12362, 12746, 13362]","[58, 228, 318, 671, 846, 1107, 1246, 1457, 1547, 1727, 1997, 2210, 2446, 2826, 3089, 3402, 3836, 3970, 4269, 4992, 5330, 5825, 6301, 6663, 6957, 7532, 8216, 8385, 8557, 9465, 10033, 11105, 11421, 11731, 12308]",24921,21301,17996,13362,12308,-3113,-4649,-4040,-3929,-3103,-18834,35,dire
7629210704,123,12,100,47,121,"[0, 235, 524, 878, 1048, 1392, 1741, 2157, 2596, 2936, 3506, 4116, 4555, 4863, 5596, 6306, 7219, 7924, 8753, 9808, 10594, 11027, 11691, 12509, 13437, 14429, 15333, 15746, 16841, 17145, 17498, 18807, 19400, 19610, 20061]","[0, 167, 419, 803, 1478, 1765, 2228, 2777, 3162, 3721, 4468, 4945, 5519, 6197, 7179, 7650, 8354, 9197, 9595, 10560, 11478, 12187, 13208, 13783, 14404, 14956, 15936, 17398, 17979, 18075, 18627, 18997, 19729, 20844, 20944]","[0, 200, 290, 492, 582, 936, 1026, 1244, 1750, 2418, 2972, 3554, 3766, 4331, 4664, 5147, 5660, 6256, 6502, 7834, 8106, 8290, 8495, 9434, 10567, 11416, 11822, 12296, 12948, 13292, 14495, 16182, 17192, 18385, 18485]","[0, 200, 399, 707, 995, 1843, 2088, 2619, 2852, 3179, 3619, 3972, 4569, 5138, 5476, 5742, 6453, 6821, 7658, 8382, 8580, 9195, 9744, 10238, 11343, 11718, 12024, 12364, 12995, 13195, 13968, 14727, 15415, 16065, 16266]","[0, 468, 645, 800, 1336, 1426, 2007, 2181, 2321, 2775, 3345, 3610, 3968, 4117, 4452, 4683, 5020, 5631, 5825, 6794, 7205, 7346, 7484, 7803, 8988, 9155, 9724, 9819, 10386, 10482, 10761, 12144, 12587, 12841, 12941]",20061,20944,18485,16266,12941,129,49,13,58,109,"[0, 444, 875, 1273, 1756, 1966, 2415, 2874, 3546, 3877, 4687, 5162, 5342, 6183, 6781, 7295, 7619, 7939, 8873, 9371, 9629, 10235, 11004, 11378, 12498, 12921, 13369, 14385, 15261, 16192, 17114, 17214, 18922, 20630, 21631]","[0, 209, 550, 862, 1157, 1617, 2145, 2647, 3007, 3378, 4001, 4127, 4906, 5395, 5746, 6233, 6955, 7055, 7745, 8375, 8882, 9276, 9842, 10445, 10813, 11820, 12408, 13089, 13681, 15446, 15869, 16194, 16727, 17076, 18522]","[0, 319, 712, 1056, 1594, 2048, 2416, 2749, 3377, 4033, 4357, 4845, 5270, 5664, 6171, 6911, 7263, 7732, 8698, 9098, 9577, 10049, 11011, 11277, 11919, 12336, 12594, 12689, 13796, 14222, 14988, 15088, 15712, 16201, 16919]","[100, 414, 539, 629, 823, 957, 1093, 1284, 1628, 1962, 2169, 2583, 3084, 3365, 3545, 3957, 4346, 4551, 4928, 5201, 5296, 5475, 6159, 6669, 7032, 7422, 7685, 7780, 8084, 9705, 10041, 10141, 10251, 10600, 12001]","[0, 276, 401, 696, 873, 1037, 1229, 1329, 1797, 1931, 2101, 2323, 2623, 3433, 3639, 3949, 4263, 4756, 5143, 5301, 5468, 5704, 5870, 5965, 6180, 6755, 7369, 7523, 7656, 9325, 10426, 10536, 10676, 11099, 12029]",21631,18522,16919,12001,12029,-1570,2422,1566,4265,912,7595,35,dire
7629875506,76,78,41,65,20,"[0, 287, 503, 667, 976, 1378, 1865, 2339, 2821, 3271, 3651, 3741, 4120, 4469, 4942, 5669, 6319, 6533, 6924, 7233, 7808, 8613, 9450, 10061, 10786, 11784, 12321, 13249, 14020, 15021, 15739, 17342, 18571, 18671, 19864]","[0, 251, 886, 1120, 1410, 1611, 2088, 2212, 2862, 3375, 3947, 4412, 4858, 5257, 5817, 6115, 6637, 7001, 7877, 8222, 8852, 9445, 10077, 10639, 11336, 12004, 13425, 13724, 14358, 14930, 15814, 16617, 17601, 18083, 18722]","[0, 283, 449, 725, 1000, 1280, 1527, 1732, 1971, 2442, 2714, 2899, 3480, 3821, 4254, 4697, 5074, 5670, 6061, 6699, 7310, 7979, 8459, 9578, 10188, 10629, 11682, 12094, 13152, 13754, 14658, 15837, 16985, 17589, 17689]","[0, 170, 333, 423, 559, 660, 1355, 1445, 1794, 2114, 2305, 2576, 2845, 3435, 3886, 4256, 4759, 4853, 5033, 5705, 5868, 6483, 7351, 7509, 7886, 8453, 9084, 9417, 9594, 9690, 10564, 11311, 11818, 12164, 12644]","[0, 170, 304, 515, 605, 695, 913, 1244, 1334, 1529, 1665, 1886, 2248, 2928, 3057, 3423, 3827, 3951, 4342, 4756, 5032, 5894, 6323, 7021, 7169, 7589, 8283, 8644, 9446, 9920, 10261, 11419, 11892, 12221, 12605]",19864,18722,17689,12644,12605,48,22,98,5,21,"[0, 170, 473, 706, 866, 1302, 1774, 2086, 2389, 2891, 3199, 3742, 4356, 4698, 5368, 6152, 6788, 7560, 7894, 8692, 9795, 10558, 11478, 12470, 13324, 13847, 16156, 17069, 17895, 19027, 19902, 20214, 20564, 21524, 23414]","[0, 322, 650, 897, 1360, 1904, 2283, 2696, 3663, 4233, 4794, 5865, 6463, 7328, 7936, 8426, 8953, 10460, 11321, 12166, 13062, 13370, 13992, 14741, 15466, 16040, 16630, 17555, 18652, 19144, 19621, 20141, 21066, 22040, 23960]","[0, 208, 537, 904, 1308, 1743, 2167, 2494, 2858, 3479, 4068, 4590, 5078, 5927, 6562, 7018, 7999, 8545, 9487, 10390, 11398, 11839, 12516, 13463, 14026, 14968, 15612, 16214, 17055, 17968, 18632, 18852, 19299, 19810, 21339]","[0, 170, 310, 619, 886, 1024, 1286, 1530, 1736, 1951, 2086, 2739, 3032, 3630, 3879, 4069, 4381, 4833, 5167, 5640, 5937, 6155, 6436, 6639, 7032, 7175, 7854, 8367, 8798, 9188, 9497, 9907, 10175, 10645, 11647]","[0, 170, 260, 398, 609, 843, 1080, 1170, 1387, 1566, 1777, 2279, 2523, 2725, 2938, 3310, 3733, 4123, 4574, 5329, 5603, 5773, 5981, 6259, 6682, 6952, 7449, 8288, 8794, 9262, 9641, 9797, 9936, 10036, 11037]",23414,23960,21339,11647,11037,-3550,-5238,-3650,997,1568,-9873,35,dire
7630006507,54,69,106,79,5,"[0, 205, 717, 1082, 1557, 1789, 2338, 3048, 3440, 3885, 4288, 4950, 5750, 6418, 6814, 7288, 7726, 8717, 9285, 10194, 10481, 10743, 11897, 13011, 13584, 14058, 14605, 15359, 15937, 17965, 19873, 20785, 21375, 22651, 23446]","[0, 275, 597, 842, 1561, 1852, 2468, 2835, 3249, 3795, 4383, 4980, 5660, 6243, 6905, 7287, 8095, 8922, 9761, 10410, 11015, 11312, 11672, 12329, 13055, 13310, 14106, 15013, 15269, 16544, 17820, 18882, 19833, 20211, 20631]","[0, 295, 661, 1000, 1326, 1735, 2268, 2557, 3056, 3146, 3685, 3946, 4210, 4698, 4792, 5270, 5797, 6562, 7007, 7831, 8295, 8709, 9223, 9467, 9752, 9891, 10480, 10756, 10896, 11660, 12309, 13266, 14022, 14400, 15022]","[0, 213, 527, 617, 854, 944, 1386, 1476, 1809, 1899, 1989, 2219, 2527, 2704, 3141, 3259, 3380, 3917, 4130, 4272, 4485, 4580, 4746, 4939, 5167, 5341, 5435, 5881, 6025, 7456, 7769, 8139, 8302, 8402, 8502]","[0, 169, 382, 472, 647, 737, 930, 1133, 1223, 1362, 1452, 1633, 1960, 2231, 2487, 2582, 2677, 3080, 3293, 3542, 3637, 3783, 3949, 4044, 4139, 4234, 4421, 4942, 5113, 5982, 6325, 6836, 7636, 8014, 8294]",23446,20631,15022,8502,8294,113,13,23,62,21,"[0, 207, 513, 865, 1225, 1518, 1906, 2451, 2763, 3399, 4001, 4352, 4876, 5415, 6168, 7108, 7782, 8740, 9415, 10502, 11409, 12614, 13998, 14617, 15648, 18123, 19326, 20604, 22922, 24686, 25080, 25543, 26481, 26698, 27414]","[0, 257, 513, 880, 1293, 1713, 2063, 2558, 3163, 3873, 4391, 4815, 5426, 5830, 6482, 7115, 7706, 8013, 8504, 8662, 10099, 10845, 11802, 12499, 13162, 14309, 15699, 16739, 17830, 18076, 18218, 19427, 21027, 22243, 23017]","[0, 169, 549, 888, 1337, 1873, 2081, 2393, 2847, 3022, 3338, 4002, 4615, 5043, 5683, 6818, 7771, 7910, 8643, 9246, 10040, 10395, 10996, 11181, 11690, 12953, 13242, 13915, 14428, 15159, 15633, 16295, 17379, 17596, 17921]","[0, 169, 660, 792, 1228, 1758, 1905, 2090, 2225, 2496, 2676, 2766, 3047, 3188, 3640, 3805, 4026, 4133, 4227, 4385, 4741, 5226, 5392, 5487, 5784, 6868, 7349, 7908, 8511, 9472, 9568, 10566, 11369, 12533, 12858]","[0, 169, 360, 693, 943, 1033, 1482, 1827, 1962, 2374, 2652, 2776, 3029, 3234, 3860, 4279, 4671, 4814, 5133, 5649, 6119, 6452, 6618, 6913, 7143, 7864, 8297, 8779, 9147, 9964, 10365, 10580, 10985, 11282, 11642]",27414,23017,17921,12858,11642,-3968,-2386,-2899,-4356,-3348,-16957,35,dire
7630218506,18,74,61,52,91,"[0, 256, 629, 929, 1295, 1585, 1986, 2392, 2873, 3179, 3954, 4424, 4909, 5662, 6407, 6756, 8014, 8802, 9512, 10085, 10791, 11419, 12214, 13055, 13912, 14731, 14964, 15244, 16110, 16286, 16653, 17523, 18279, 18532, 20665]","[0, 209, 569, 901, 1180, 1396, 1679, 2058, 2573, 3208, 3691, 4073, 4389, 4839, 5078, 5251, 5678, 6295, 6825, 7179, 7274, 8191, 9013, 9790, 10401, 11052, 11768, 12828, 13567, 13663, 14335, 15303, 15724, 16097, 18301]","[0, 245, 511, 674, 1070, 1424, 1682, 2164, 2336, 2655, 3162, 4164, 4689, 5266, 5991, 6582, 7316, 7551, 8145, 8384, 8968, 9433, 10718, 11120, 11840, 12402, 12722, 13169, 14120, 14561, 15368, 16478, 17528, 17740, 18758]","[0, 170, 260, 350, 460, 595, 705, 1041, 1300, 1390, 1695, 2023, 2728, 3171, 3371, 3677, 3835, 4295, 4605, 4919, 5194, 5658, 6075, 6336, 6577, 6913, 7132, 7702, 8522, 9011, 9453, 10270, 11015, 11350, 13060]","[0, 170, 260, 350, 574, 746, 910, 1246, 1422, 1759, 1983, 2196, 2522, 2815, 3142, 3272, 3475, 3570, 3711, 3805, 4465, 4676, 5173, 5313, 5456, 5578, 5673, 5857, 6162, 6258, 6625, 6948, 7158, 7258, 8209]",20665,18301,18758,13060,8209,21,2,56,79,100,"[0, 332, 691, 1146, 1564, 1935, 2256, 2692, 2991, 3576, 4004, 4671, 4928, 5415, 5977, 6672, 7240, 7728, 8244, 9009, 9970, 10364, 10651, 10999, 11951, 12367, 13556, 14337, 14904, 15532, 16555, 17267, 17771, 19345, 21334]","[0, 240, 624, 934, 1274, 1527, 1730, 2481, 3134, 3586, 4292, 4852, 5520, 5877, 6188, 7163, 7493, 8184, 9197, 10375, 10688, 11209, 11558, 12745, 13373, 13946, 15748, 16251, 16529, 16909, 18259, 18566, 18777, 19837, 20560]","[0, 170, 404, 656, 873, 1605, 1817, 2252, 2540, 3068, 3659, 3803, 4245, 4700, 5111, 5374, 5648, 5953, 6290, 7137, 7364, 8149, 8542, 9155, 9588, 10071, 11209, 11897, 12451, 12703, 13576, 13775, 14200, 15380, 16569]","[0, 170, 336, 426, 565, 720, 847, 1135, 1353, 1845, 2070, 2523, 2757, 3135, 3343, 3548, 3881, 4242, 4851, 5513, 6168, 6679, 7139, 7357, 7701, 8388, 9334, 9832, 10084, 10255, 10892, 11349, 11803, 12420, 13519]","[0, 170, 298, 435, 525, 685, 832, 1060, 1198, 1473, 1828, 1981, 2161, 2291, 2499, 2923, 3239, 3578, 3789, 4212, 4525, 4620, 5081, 5487, 5784, 5879, 6588, 6907, 7378, 7474, 7940, 8380, 8644, 9764, 10584]",21334,20560,16569,13519,10584,-669,-2259,2189,-459,-2375,-3573,35,dire
7630469716,18,13,31,96,26,"[0, 584, 817, 1308, 1509, 1836, 2374, 2770, 3059, 3840, 4527, 5100, 6056, 6764, 7479, 8027, 9242, 9982, 11745, 12557, 12919, 13759, 14678, 15536, 16170, 16719, 17283, 17631, 17737, 18203, 18626, 19219, 19589, 20302, 21438]","[0, 287, 567, 823, 965, 1370, 1684, 2013, 2435, 3145, 3723, 3948, 4740, 5349, 6495, 6842, 7508, 8193, 9201, 9590, 10182, 10680, 11236, 11577, 12095, 12432, 12607, 13978, 14074, 15228, 15807, 15907, 16223, 16835, 17412]","[0, 234, 324, 414, 550, 658, 831, 1061, 1391, 1740, 1972, 2584, 2835, 3187, 3541, 3697, 4406, 4501, 5270, 5546, 5910, 6153, 6449, 6935, 7346, 7629, 7870, 8321, 8487, 8922, 9255, 9460, 9595, 10480, 10943]","[0, 346, 484, 689, 1190, 1350, 1640, 2184, 2508, 2750, 3248, 3510, 3808, 4075, 4506, 4861, 5467, 5982, 6346, 6834, 7122, 7603, 7844, 8122, 8470, 8700, 8875, 9201, 9297, 9758, 10020, 10253, 10484, 11182, 11561]","[0, 234, 324, 626, 831, 970, 1105, 1240, 1330, 1677, 1856, 2081, 2368, 2808, 3206, 3568, 4313, 4408, 5320, 5541, 5686, 6000, 6238, 6443, 7193, 7423, 7598, 7814, 7910, 8126, 8222, 8494, 8675, 9924, 10234]",21438,17412,10943,11561,10234,52,44,137,121,20,"[0, 209, 582, 767, 1139, 1433, 1969, 2402, 3014, 3318, 3614, 4100, 4357, 4613, 4949, 5257, 6559, 7108, 7208, 7871, 8898, 9546, 10075, 10438, 10925, 11479, 12520, 13021, 14485, 15007, 15729, 16863, 17870, 19437, 20619]","[0, 170, 481, 1218, 1508, 1818, 2152, 2433, 2963, 3391, 3837, 4465, 4811, 5729, 6167, 6803, 7948, 8637, 9524, 10405, 11518, 12446, 13229, 14144, 15000, 15926, 16382, 16751, 19030, 19763, 20445, 21128, 21463, 21850, 22130]","[0, 206, 405, 572, 815, 941, 1215, 1563, 2069, 2192, 2370, 2551, 3083, 3225, 3854, 4113, 5038, 5493, 5587, 6419, 6698, 7226, 7863, 8271, 8924, 9224, 9867, 10520, 11664, 12286, 12580, 13411, 13727, 13987, 14712]","[0, 270, 360, 560, 650, 740, 830, 1010, 1406, 1496, 1679, 1833, 2063, 2292, 2386, 2795, 2953, 3215, 3309, 3467, 3562, 3657, 3751, 3846, 4031, 4258, 4573, 4869, 5619, 5796, 5892, 6257, 6467, 6836, 7116]","[0, 170, 260, 518, 608, 709, 799, 993, 1228, 1414, 1525, 1654, 2064, 2159, 2253, 2348, 2781, 2907, 3001, 3325, 3792, 3947, 4226, 4321, 4506, 4601, 4866, 5073, 5899, 6175, 6374, 6787, 6997, 7255, 7535]",20619,22130,14712,7116,7535,819,-4718,-3769,4445,2699,-524,35,dire
7630871702,41,97,13,9,79,"[0, 287, 533, 975, 1232, 1430, 1848, 2129, 2527, 2827, 3374, 3718, 4194, 4656, 4784, 5418, 6056, 6604, 7544, 8243, 8927, 9369, 10257, 10850, 11700, 12625, 12990, 13918, 14529, 15987, 17030, 17721, 18875, 19449, 19734]","[0, 198, 480, 738, 1109, 1436, 1919, 2363, 2863, 3454, 4069, 4551, 5344, 5684, 6075, 6741, 7679, 8531, 9069, 9670, 10140, 10802, 11177, 11968, 12597, 13601, 13696, 14361, 14766, 16105, 17287, 17754, 18197, 18638, 20050]","[0, 216, 378, 704, 1069, 1360, 1640, 1915, 2207, 2724, 3104, 3551, 3743, 4362, 4745, 5149, 5800, 6257, 6953, 7343, 7859, 8428, 9234, 9957, 10189, 10994, 11613, 11958, 12635, 12731, 13255, 13907, 14480, 14682, 15437]","[0, 130, 255, 345, 687, 827, 961, 1338, 1428, 1650, 1828, 1985, 2120, 2534, 2923, 3370, 3591, 4033, 4281, 4635, 4884, 5296, 5557, 5905, 6239, 6609, 6704, 7108, 7661, 8446, 8993, 9709, 10322, 10506, 10606]","[0, 130, 220, 398, 573, 782, 1005, 1095, 1315, 1513, 1691, 1872, 2187, 2436, 2530, 2812, 3033, 3682, 3825, 3967, 4062, 4468, 4890, 5199, 5366, 5811, 5906, 6094, 6449, 6750, 7063, 7201, 7704, 7804, 7904]",19734,20050,15437,10606,7904,1,52,135,45,138,"[0, 277, 597, 925, 1405, 1650, 1929, 2634, 2964, 3425, 4171, 4614, 5133, 5699, 6457, 7291, 8012, 8778, 9476, 10569, 11750, 12753, 12937, 13888, 14776, 15868, 17844, 18942, 20267, 21389, 21485, 21974, 24363, 25678, 26771]","[0, 397, 764, 1127, 1576, 1794, 2298, 2938, 3457, 3668, 4341, 5082, 5721, 6166, 6889, 7378, 8084, 8711, 9217, 9798, 10464, 11062, 12887, 13280, 13658, 14672, 15563, 16178, 16653, 17254, 17350, 18276, 19416, 20260, 20595]","[0, 277, 442, 696, 990, 1363, 1488, 1989, 2398, 2763, 3598, 4014, 4734, 5047, 5416, 5848, 6375, 6973, 7611, 8557, 9043, 9138, 9948, 10649, 11275, 11830, 12311, 12715, 13061, 13563, 13659, 14475, 15109, 15505, 16320]","[0, 545, 635, 725, 855, 945, 1035, 1260, 1350, 1440, 1737, 2002, 2549, 2644, 2922, 3017, 3454, 3596, 3904, 4217, 4468, 4638, 5284, 5503, 5808, 6303, 6940, 7293, 7589, 7984, 8171, 8419, 9978, 10227, 10741]","[0, 277, 367, 595, 770, 860, 950, 1470, 1560, 1662, 2236, 2425, 2650, 2923, 3193, 3318, 3526, 3660, 3754, 4199, 4375, 4470, 5529, 5697, 5974, 6435, 6632, 6837, 7071, 7391, 7809, 7909, 8608, 8843, 9123]",26771,20595,16320,10741,9123,-7037,-545,-883,-135,-1219,-9819,35,dire
7631440012,53,23,38,65,9,"[0, 257, 516, 898, 1336, 1568, 2014, 2432, 2603, 3163, 3437, 4086, 4561, 5391, 6479, 6891, 7690, 7961, 8383, 8889, 9583, 9919, 10014, 10694, 12039, 12510, 13382, 14391, 14866, 15775, 16761, 17660, 18971, 19567, 20632]","[0, 333, 643, 967, 1459, 1870, 2287, 2470, 2771, 3411, 3826, 4150, 4955, 5434, 5957, 6525, 7260, 7841, 8334, 9030, 9524, 10126, 10548, 11070, 11805, 12491, 12848, 12942, 13249, 13586, 14495, 15020, 15878, 16584, 17117]","[0, 296, 445, 750, 1211, 1576, 1858, 2228, 2480, 3004, 3427, 3988, 4412, 5072, 5506, 5903, 6289, 6560, 6996, 7283, 7485, 7963, 8996, 9507, 9836, 10503, 10881, 11096, 11455, 11767, 13608, 13974, 14443, 15094, 15594]","[0, 553, 668, 758, 940, 1049, 1264, 1399, 1489, 1817, 2159, 2285, 2772, 2942, 3315, 3546, 3812, 4093, 4227, 4410, 4696, 4890, 5391, 5782, 6271, 6717, 7081, 7345, 7642, 8383, 8479, 8939, 9665, 10079, 11148]","[0, 285, 459, 637, 874, 1226, 1568, 2013, 2103, 2273, 2515, 2605, 2889, 3104, 3368, 3737, 4054, 4404, 4499, 4594, 4944, 5220, 5423, 5700, 6098, 6481, 6576, 7086, 7679, 8302, 8398, 8681, 9060, 9578, 9917]",20632,17117,15594,11148,9917,18,15,137,19,121,"[0, 205, 697, 863, 1151, 1661, 2172, 2664, 3394, 3737, 4510, 5189, 6013, 7579, 8232, 8860, 9587, 11432, 12268, 13675, 14890, 16331, 17198, 18497, 19274, 20335, 21460, 22307, 23596, 24393, 25342, 25738, 26080, 26652, 27787]","[0, 209, 530, 792, 956, 1540, 2027, 2282, 2823, 3305, 3749, 3962, 4539, 4891, 5300, 5744, 6560, 7234, 8116, 8546, 9284, 9583, 10239, 11200, 11629, 12137, 12702, 13110, 13585, 14063, 14964, 15597, 16234, 16683, 17449]","[0, 298, 733, 990, 1365, 1650, 2307, 2823, 3550, 3865, 4414, 5353, 5908, 6325, 6854, 7530, 7918, 8362, 9091, 9520, 10311, 10516, 11005, 11352, 11742, 12378, 12997, 13526, 13931, 14694, 15560, 16116, 16665, 16905, 17501]","[0, 170, 306, 396, 519, 751, 1063, 1198, 1943, 2033, 2537, 2855, 2945, 3715, 4176, 4606, 5061, 5953, 6212, 6779, 7481, 7911, 8559, 9469, 9843, 10302, 10676, 11230, 11661, 12199, 13260, 13891, 14673, 15043, 15920]","[0, 170, 421, 562, 680, 810, 1063, 1486, 1722, 1857, 2158, 2570, 3090, 3768, 3958, 4353, 4734, 5602, 6131, 6349, 6862, 7112, 7494, 8052, 8338, 8826, 9309, 9515, 10174, 10841, 11093, 11341, 11516, 11740, 12140]",27787,17449,17501,15920,12140,-7155,-332,-1907,-4772,-2223,-16389,35,dire
7632105811,126,15,43,21,100,"[0, 289, 523, 745, 1145, 1402, 1769, 2245, 2943, 3344, 3653, 4050, 4537, 5519, 6194, 6920, 7527, 7901, 8745, 9058, 9876, 10499, 11203, 11997, 12698, 13117, 13400, 14063, 14240, 14879, 15047, 16890, 19453, 20097, 20783]","[0, 208, 473, 816, 1446, 2016, 2572, 3208, 3584, 4227, 4809, 5286, 5857, 6242, 7125, 7823, 8452, 9065, 9611, 10375, 11204, 11845, 12539, 13292, 13780, 14546, 14747, 15371, 16025, 16662, 16811, 17555, 18123, 18859, 19384]","[0, 416, 751, 1257, 1434, 1921, 2353, 2863, 3373, 3906, 4426, 4806, 5662, 6164, 6815, 7384, 8169, 8479, 8927, 9084, 9649, 9957, 10744, 11180, 11633, 12499, 12693, 13123, 13656, 14288, 14384, 14744, 15818, 16183, 17061]","[0, 244, 334, 505, 595, 732, 1097, 1425, 1641, 1788, 2143, 2561, 2771, 3437, 3803, 4082, 5033, 5684, 6234, 6736, 7089, 7437, 8130, 8872, 9114, 9393, 9577, 10256, 10529, 10625, 10822, 11397, 12467, 12819, 13009]","[100, 270, 395, 529, 691, 901, 1071, 1347, 1481, 1652, 1845, 2196, 2502, 2910, 3193, 3426, 3835, 4005, 4493, 5074, 5307, 5477, 5790, 6118, 6288, 6529, 6699, 7224, 7476, 7861, 8032, 8297, 8789, 9116, 9381]",20783,19384,17061,13009,9381,25,52,96,90,5,"[62, 388, 542, 869, 1130, 1258, 1504, 2179, 2651, 3075, 3661, 4245, 4588, 5131, 5686, 6366, 7117, 8500, 9360, 11129, 12008, 13056, 14094, 14948, 15736, 16208, 16805, 17756, 18784, 19781, 20368, 21117, 21217, 22048, 23451]","[330, 623, 978, 1272, 1644, 2053, 2505, 2640, 3191, 3519, 4117, 5287, 5743, 6240, 6849, 7217, 7657, 8652, 9004, 10469, 10855, 11715, 12304, 13202, 13919, 14559, 15262, 15673, 16951, 17961, 19107, 20469, 20569, 20824, 21449]","[62, 232, 622, 855, 1450, 1586, 1710, 1845, 2157, 2445, 2625, 2760, 3328, 3681, 3922, 4246, 4424, 4685, 4779, 5236, 5798, 6532, 7007, 7268, 7961, 8602, 8874, 9149, 9666, 10098, 10585, 11098, 12049, 12413, 13195]","[162, 332, 447, 584, 847, 937, 1108, 1243, 1333, 1423, 1656, 1887, 2138, 2527, 2806, 3092, 3390, 3933, 4229, 4831, 4970, 5576, 6218, 6533, 6981, 7337, 7636, 7911, 8777, 9402, 10104, 10882, 10982, 11996, 12321]","[62, 232, 347, 482, 572, 662, 786, 1145, 1235, 1325, 1544, 1756, 2007, 2323, 2554, 2649, 2955, 3329, 3423, 4025, 4257, 4735, 4968, 5153, 5655, 6017, 6222, 6317, 6413, 6775, 7337, 7647, 7747, 8309, 8728]",23451,21449,13195,12321,8728,-2668,-2065,3866,688,653,474,35,dire
7632230602,73,98,60,79,119,"[0, 250, 662, 987, 1210, 1494, 2024, 2609, 3138, 3433, 4146, 4895, 5399, 6136, 6736, 7303, 8355, 9768, 11028, 12222, 13691, 14950, 16321, 17354, 18507, 19515, 20790, 22524, 23443, 24521, 25161, 25857, 27195, 28142, 28516]","[0, 281, 567, 726, 1090, 1314, 1492, 2108, 2512, 2926, 3559, 4531, 5122, 5430, 5524, 6327, 6632, 7133, 7383, 7851, 8937, 9762, 9936, 10658, 11658, 12248, 12612, 14303, 14931, 15470, 15905, 16284, 16981, 17195, 17440]","[0, 281, 530, 735, 1145, 1344, 2063, 2187, 2505, 2863, 3743, 4156, 4246, 4564, 4960, 5175, 5550, 5714, 5964, 6369, 7039, 7519, 8329, 8561, 8701, 9075, 9680, 10377, 10884, 10980, 11588, 12082, 12376, 12936, 13450]","[0, 170, 260, 399, 489, 614, 740, 1004, 1109, 1727, 2362, 2452, 2664, 3033, 3248, 3695, 3952, 4500, 4750, 4952, 5469, 5866, 6728, 7012, 7428, 7917, 8057, 8754, 8976, 9072, 9645, 9852, 10062, 10322, 10567]","[0, 170, 260, 350, 485, 616, 844, 968, 1338, 1542, 2216, 2306, 2631, 3233, 3448, 3543, 3764, 3928, 4178, 4372, 5270, 5599, 6084, 6360, 6851, 7092, 7310, 8082, 8621, 8792, 9212, 10289, 10559, 10826, 11143]",28516,17440,13450,10567,11143,114,49,21,75,136,"[0, 209, 490, 871, 1231, 1559, 1935, 2445, 2893, 3521, 3901, 4262, 5001, 5485, 6175, 6900, 7746, 8116, 8820, 9428, 10044, 10513, 11367, 11781, 12700, 13466, 14142, 14275, 14697, 15702, 16561, 17398, 18336, 18979, 20659]","[0, 291, 527, 742, 1065, 1411, 1842, 2356, 3038, 3411, 3956, 4160, 4835, 5412, 6031, 6698, 7489, 8457, 9060, 9517, 9762, 10267, 10555, 10894, 11719, 12165, 13040, 13135, 13543, 14310, 15145, 15783, 15883, 16067, 16964]","[0, 170, 309, 399, 978, 1068, 1421, 1601, 1802, 2217, 2352, 2746, 3049, 3873, 4303, 4836, 5542, 5846, 6208, 6641, 7147, 7493, 8186, 8749, 9469, 10316, 10709, 11234, 11611, 11986, 12741, 13145, 14160, 14260, 15062]","[0, 205, 370, 774, 1310, 1753, 1879, 2752, 3025, 3260, 3473, 3804, 4274, 4644, 5025, 5945, 6773, 7039, 7933, 8451, 8712, 9319, 10129, 10778, 11470, 11891, 12615, 12710, 12936, 13360, 14117, 14786, 15560, 15660, 17278]","[0, 170, 260, 385, 589, 723, 813, 1209, 1299, 1389, 1524, 1614, 1905, 2161, 2334, 2685, 3433, 3870, 4421, 4579, 4674, 4768, 5201, 5402, 5928, 6534, 6934, 7029, 7254, 7741, 8072, 8352, 8452, 8821, 9686]",20659,16964,15062,17278,9686,7857,476,-1612,-6711,1457,1467,35,radiant
7632248708,120,54,123,129,9,"[0, 254, 620, 862, 1226, 1560, 1846, 2136, 2360, 2987, 3605, 3927, 4158, 4686, 5230, 5578, 6134, 6591, 6896, 7700, 8498, 9225, 9928, 10649, 10999, 11309, 12240, 12628, 12724, 13289, 13572, 14150, 14250, 15132, 15850]","[0, 205, 353, 630, 882, 972, 1097, 1337, 1598, 1923, 2530, 2935, 3492, 3815, 4541, 5084, 5772, 6325, 6420, 7106, 7646, 8471, 9150, 9663, 10144, 10834, 11245, 12019, 12691, 12864, 13305, 13613, 13713, 14931, 15308]","[0, 170, 260, 728, 934, 1143, 1336, 1471, 1561, 1721, 1905, 2032, 2215, 2443, 2612, 2801, 3052, 3147, 3242, 3560, 4056, 4668, 5314, 5819, 6222, 7174, 7456, 7729, 7927, 8023, 8475, 9003, 9103, 9521, 10413]","[0, 290, 698, 1090, 1347, 1609, 2076, 2751, 3213, 3713, 4508, 5069, 5531, 6088, 6527, 6675, 7522, 7867, 7986, 8509, 9127, 9710, 10256, 10643, 10738, 11051, 11516, 12278, 12374, 12470, 12862, 13360, 13460, 14071, 14374]","[0, 272, 435, 577, 730, 893, 1304, 1629, 1719, 2076, 2509, 2912, 3121, 3317, 3664, 4082, 4478, 4661, 5063, 5445, 5749, 6225, 6698, 6954, 7211, 7878, 8048, 8344, 8726, 8897, 9287, 9715, 9852, 10246, 10524]",15850,15308,10413,14374,10524,94,137,28,119,5,"[0, 218, 416, 659, 1130, 1371, 1792, 2046, 2540, 3056, 3518, 3961, 4614, 5225, 5926, 6554, 7596, 8308, 9596, 10372, 11080, 11378, 12005, 13041, 13540, 14737, 15729, 16074, 16963, 18097, 18745, 19963, 22139, 22997, 23731]","[0, 281, 564, 859, 1194, 1630, 2139, 2348, 2783, 3080, 3170, 3582, 4063, 4338, 5293, 5602, 6456, 6890, 7864, 8221, 9148, 9614, 10283, 11412, 12676, 13222, 13317, 13924, 14653, 15866, 16267, 16703, 18967, 19650, 20393]","[0, 170, 410, 680, 970, 1593, 1810, 2234, 2730, 3388, 3905, 4473, 4692, 5169, 5636, 5969, 6704, 7136, 8151, 8502, 9044, 9582, 9884, 10424, 11064, 11630, 11750, 11878, 12630, 13408, 13672, 14051, 15014, 15674, 16342]","[0, 170, 310, 443, 533, 934, 1118, 1253, 1392, 1531, 1621, 1909, 2256, 2405, 2872, 3282, 3685, 3866, 4653, 4890, 5073, 5243, 5732, 5916, 6591, 6873, 7370, 8000, 8621, 8925, 9094, 9543, 11193, 11513, 12359]","[0, 204, 294, 384, 490, 600, 820, 1081, 1286, 1376, 1481, 1692, 2161, 2455, 2878, 3037, 3381, 3744, 4375, 5038, 5178, 5358, 5870, 6229, 6719, 7542, 7703, 7797, 8350, 8705, 8846, 9126, 10342, 10577, 10815]",23731,20393,16342,12359,10815,-7881,-5085,-5929,2015,-291,-17171,35,dire
7632470313,90,14,15,86,51,"[0, 259, 549, 910, 1323, 1610, 2066, 2529, 3009, 3577, 4032, 4391, 5133, 5686, 6170, 6792, 7058, 7821, 8314, 8861, 9166, 10144, 10494, 10751, 10846, 14143, 14654, 15203, 16175, 17583, 18765, 19442, 19542, 20576, 22837]","[0, 243, 595, 905, 1144, 1393, 1703, 1958, 2368, 2872, 3381, 3749, 4038, 4479, 4676, 5581, 5847, 6408, 7221, 8010, 8646, 9214, 9800, 10140, 11364, 12638, 13379, 14691, 15385, 16451, 17568, 17668, 18555, 19590, 21519]","[0, 256, 578, 870, 1074, 1376, 1684, 1934, 2320, 3047, 3572, 4212, 4683, 5168, 5359, 5804, 6154, 6911, 7538, 8366, 8700, 9390, 9619, 10152, 10307, 11173, 12197, 13097, 14163, 15585, 17342, 17669, 17769, 19162, 20457]","[0, 170, 325, 499, 855, 1026, 1414, 1504, 1594, 1684, 2064, 2952, 3042, 3136, 3646, 3892, 4347, 4531, 4941, 5201, 5379, 6624, 6719, 7428, 7523, 7751, 8095, 8811, 10125, 11863, 12652, 12936, 13485, 14401, 15958]","[0, 170, 260, 385, 495, 845, 1171, 1312, 1504, 1726, 1861, 2113, 2203, 2341, 2486, 2867, 3022, 3206, 3654, 3860, 3990, 4532, 4627, 4846, 4941, 5768, 6146, 7374, 8630, 9027, 10357, 10641, 12161, 13386, 15230]",22837,21519,20457,15958,15230,48,21,49,79,83,"[0, 208, 332, 630, 969, 1288, 1527, 2145, 2741, 3302, 3918, 4363, 4915, 5650, 6327, 7466, 8629, 9758, 10825, 11962, 13013, 14912, 15668, 16406, 17669, 18334, 19178, 19520, 19921, 20193, 20590, 22821, 23178, 23498, 23598]","[0, 323, 725, 1023, 1400, 1817, 2257, 2536, 2960, 3630, 4133, 4711, 5286, 5745, 6173, 7383, 8159, 8897, 9170, 10480, 11032, 11597, 12476, 13087, 14234, 15112, 15846, 15941, 16037, 16427, 16824, 17223, 17765, 17865, 19121]","[0, 214, 522, 808, 1215, 1472, 1934, 2340, 2699, 2984, 3328, 4072, 4391, 5037, 5553, 5995, 6686, 7355, 8066, 8690, 9370, 9733, 10051, 10825, 11634, 11992, 12464, 13083, 13216, 13891, 14288, 14687, 14912, 15280, 15380]","[0, 170, 260, 350, 485, 823, 1211, 1472, 1701, 1974, 2456, 2769, 2859, 3287, 3822, 4161, 4709, 4943, 5323, 5922, 6242, 7027, 7430, 7956, 9357, 9984, 10266, 10844, 10988, 11380, 12501, 13890, 14453, 14629, 14729]","[0, 170, 260, 694, 784, 874, 964, 1160, 1369, 1592, 1953, 2133, 2223, 2485, 2634, 3047, 3399, 3556, 3768, 4221, 4471, 5384, 5597, 5974, 6464, 7058, 7319, 7681, 7777, 8278, 8675, 9074, 9174, 9313, 9413]",23598,19121,15380,14729,9413,-761,2398,5077,1229,5817,13760,35,radiant
7632526519,25,18,96,123,5,"[0, 630, 914, 1199, 1656, 1984, 2385, 3030, 3471, 3947, 4489, 4618, 5087, 5236, 5946, 6367, 7110, 8042, 8532, 9212, 9939, 10528, 11356, 12056, 13038, 13581, 14367, 15266, 15826, 16658, 17537, 18142, 19941, 20329, 20952]","[0, 272, 509, 797, 1003, 1291, 1728, 2264, 2534, 2986, 3445, 4131, 4992, 5483, 5945, 6762, 7498, 7786, 8420, 9372, 10028, 10598, 11102, 11673, 12559, 13912, 14807, 15471, 16200, 17160, 18022, 18212, 19428, 20180, 21111]","[0, 164, 485, 649, 1106, 1304, 1657, 2377, 2708, 3470, 3605, 4061, 4521, 4869, 5127, 5490, 5957, 6809, 7050, 7457, 7726, 7925, 8334, 9175, 9791, 11374, 11468, 11563, 12416, 13042, 13330, 13802, 14613, 14789, 15438]","[0, 129, 219, 309, 530, 733, 868, 1066, 1156, 1392, 1735, 1950, 2229, 2707, 2899, 3184, 3425, 3986, 4264, 4781, 5208, 5774, 6497, 6894, 7578, 8593, 9263, 10091, 10775, 11153, 12065, 12524, 12721, 13345, 14177]","[0, 252, 386, 476, 601, 973, 1271, 1406, 1496, 1586, 1735, 1949, 2039, 2357, 2454, 2603, 2698, 2919, 3263, 3706, 3968, 4277, 4776, 5036, 6255, 7143, 7422, 7763, 8307, 8606, 8946, 9136, 9953, 10053, 10574]",20952,21111,15438,14177,10574,10,52,23,79,85,"[0, 209, 334, 673, 871, 1247, 1656, 2102, 2556, 2718, 3466, 3868, 4530, 5322, 5962, 6527, 7281, 8169, 8859, 9487, 10565, 11199, 11479, 12197, 12899, 13382, 14684, 15356, 16012, 16553, 17490, 18437, 18840, 19280, 20200]","[0, 330, 683, 1029, 1244, 1492, 1927, 2435, 3155, 3564, 4399, 4828, 5600, 6441, 7032, 7578, 8386, 9511, 10174, 10616, 11409, 11925, 12577, 13152, 14426, 14645, 15698, 16384, 16688, 17787, 18611, 19237, 19892, 19992, 20462]","[0, 248, 518, 791, 1253, 1850, 2065, 2483, 2850, 3581, 4308, 4855, 5361, 5859, 6395, 6633, 7005, 7961, 8332, 8840, 9415, 9648, 9934, 10668, 11449, 11544, 11960, 12384, 12721, 12952, 13301, 13729, 14115, 14637, 15541]","[0, 209, 335, 638, 1038, 1267, 1582, 1717, 1937, 2274, 2586, 2958, 3531, 3732, 4138, 4485, 4690, 4928, 5128, 5391, 5643, 5874, 6232, 6545, 6972, 7067, 7388, 7655, 7832, 8059, 8201, 8489, 8589, 8875, 9065]","[0, 209, 299, 435, 525, 664, 845, 980, 1070, 1160, 1385, 1831, 2128, 2362, 2536, 2630, 2884, 3342, 3577, 4032, 4285, 4547, 4777, 4943, 5416, 5511, 5755, 6155, 6332, 6622, 7325, 7563, 7663, 8093, 8516]",20200,20462,15541,9065,8516,752,649,-103,5112,2058,8468,35,radiant
7632649002,41,19,137,121,110,"[0, 242, 541, 753, 1131, 1401, 1741, 2066, 2469, 2822, 3439, 3718, 3808, 4098, 4560, 4938, 5478, 5960, 6461, 6942, 7485, 7865, 8786, 9681, 11172, 12197, 12921, 14127, 14824, 15978, 16590, 17452, 18460, 19271, 20616]","[0, 329, 665, 1003, 1429, 1808, 2272, 2581, 3004, 3561, 4063, 4694, 4836, 5138, 5754, 6009, 6653, 7256, 7887, 8296, 8738, 9872, 10389, 11273, 11768, 12658, 13065, 14039, 14826, 16243, 16564, 17817, 19047, 19632, 21745]","[0, 250, 607, 977, 1266, 1469, 1760, 2409, 3041, 3390, 3969, 4511, 4601, 4895, 5929, 6155, 7069, 7857, 8618, 8898, 9914, 10294, 11090, 11657, 12615, 13255, 13677, 14439, 14919, 15719, 16223, 16689, 17515, 18358, 19438]","[0, 170, 260, 368, 498, 637, 771, 1139, 1322, 1506, 1839, 2172, 2262, 2474, 3213, 3376, 3783, 4045, 4154, 4362, 4908, 5003, 5185, 5661, 6247, 6700, 6795, 7125, 7348, 8370, 9461, 9865, 10552, 11115, 12430]","[0, 170, 694, 829, 959, 1049, 1215, 1311, 1447, 1659, 2142, 2442, 2532, 2855, 3275, 3370, 3729, 4289, 4652, 5205, 6000, 6445, 6725, 7292, 8156, 8581, 8862, 9282, 9558, 10564, 10795, 11221, 11684, 12192, 13541]",20616,21745,19438,12430,13541,70,129,13,9,79,"[0, 240, 515, 924, 1233, 1623, 2173, 2605, 2825, 3060, 3408, 3949, 4825, 5216, 5906, 6172, 7237, 8124, 8948, 9328, 10155, 10982, 11905, 12848, 13805, 14378, 15500, 16074, 17052, 18175, 18271, 19103, 20042, 20429, 20789]","[0, 207, 592, 943, 1275, 1787, 2078, 2336, 2795, 3297, 3721, 4268, 4923, 5155, 5655, 5750, 6073, 7066, 7316, 7840, 8503, 8976, 9907, 10437, 10986, 11414, 11622, 11869, 12775, 13684, 13879, 14945, 15718, 16023, 16669]","[0, 170, 437, 809, 1102, 1442, 1683, 2181, 2664, 3250, 3717, 4022, 4534, 4952, 5325, 5998, 6649, 7307, 7744, 8342, 8948, 9789, 10653, 11001, 11346, 11722, 12260, 12796, 13214, 14112, 14249, 15448, 15980, 16080, 16440]","[0, 170, 260, 615, 745, 996, 1166, 1301, 1436, 1806, 2046, 2136, 3096, 3327, 3755, 3850, 4038, 4556, 4813, 5057, 5866, 5961, 6455, 6951, 7308, 7729, 8185, 8467, 8943, 9542, 9759, 10050, 10469, 10891, 11251]","[0, 170, 260, 352, 538, 773, 1010, 1425, 1565, 1763, 1961, 2234, 2999, 3094, 3296, 3439, 3741, 4002, 4096, 4294, 5103, 5198, 5482, 5885, 6422, 6627, 6951, 7046, 7223, 7624, 8052, 8337, 8711, 8916, 9561]",20789,16669,16440,11251,9561,-173,5076,2998,1179,3980,13060,35,radiant
7632828213,21,78,23,5,86,"[0, 260, 588, 920, 1243, 1613, 2039, 2516, 2952, 3637, 4218, 4844, 5336, 5974, 6808, 7321, 8179, 8971, 10300, 10778, 11278, 12443, 13347, 14128, 15351, 16225, 16677, 17899, 19155, 20161, 20793, 21073, 22200, 22717, 23941]","[0, 174, 493, 762, 1110, 1418, 1757, 2152, 2671, 2989, 3430, 3901, 4316, 4683, 5045, 5179, 5738, 6292, 7236, 7746, 8384, 9309, 10409, 10796, 12001, 12710, 13569, 14255, 15877, 16535, 17398, 18403, 19211, 20423, 21195]","[0, 292, 623, 993, 1328, 1785, 2176, 2997, 3881, 4799, 5502, 6210, 6756, 7497, 7901, 8257, 9344, 9959, 10562, 10922, 11202, 12300, 12795, 13071, 14211, 14930, 15829, 16922, 17470, 18290, 18820, 19776, 20621, 21516, 22190]","[0, 170, 476, 611, 830, 1024, 1114, 1339, 1499, 1683, 1920, 2214, 2539, 3105, 3586, 3681, 4176, 4449, 4844, 4939, 5133, 6441, 6918, 7271, 7946, 8241, 8521, 9111, 9805, 10373, 10690, 11366, 12052, 12402, 12906]","[0, 218, 308, 398, 539, 692, 782, 1127, 1287, 1455, 1771, 2000, 2582, 2834, 3054, 3236, 3698, 3864, 5047, 5270, 5452, 6586, 7049, 7327, 7877, 8043, 8248, 8642, 8919, 9365, 9657, 10083, 10438, 10788, 11254]",23941,21195,22190,12906,11254,89,52,97,119,51,"[0, 224, 587, 948, 1241, 1520, 1833, 2352, 2767, 3150, 3658, 4295, 4844, 5446, 6172, 7060, 8052, 9068, 9896, 10693, 11376, 11470, 11826, 12905, 14038, 15197, 16282, 17213, 18026, 18122, 19303, 20741, 21579, 23236, 24480]","[0, 262, 595, 1032, 1297, 1640, 2016, 2491, 3043, 3506, 3952, 4217, 4868, 5489, 6086, 6908, 7984, 8292, 8869, 9348, 9750, 9844, 10739, 11522, 11707, 12441, 13050, 13734, 14080, 14472, 16557, 17248, 17969, 18753, 20654]","[0, 287, 534, 934, 1259, 1472, 1788, 2148, 2514, 2962, 3350, 3693, 4458, 4811, 5313, 5956, 6328, 6935, 7980, 8389, 9152, 9246, 9580, 10545, 11083, 11600, 12040, 12484, 12743, 13106, 13821, 14269, 14865, 15641, 16377]","[0, 420, 510, 814, 991, 1081, 1171, 1261, 1540, 1824, 2197, 2287, 2574, 2815, 3098, 3470, 4096, 4368, 4863, 5070, 5228, 5322, 5667, 5942, 6275, 6795, 7217, 7456, 7552, 7648, 8640, 8962, 9268, 9368, 10160]","[0, 492, 582, 737, 867, 1070, 1160, 1566, 1912, 2002, 2265, 2390, 2844, 3140, 3453, 3895, 4204, 4626, 4992, 5458, 5616, 5710, 6159, 6301, 6486, 6887, 7076, 7315, 7579, 7815, 8243, 8564, 8754, 8854, 9556]",24480,20654,16377,10160,9556,-539,541,5813,2746,1698,10259,35,radiant
7632939802,41,120,137,9,66,"[0, 292, 574, 929, 1256, 1571, 1894, 2410, 2611, 2929, 3338, 3884, 4486, 4836, 5590, 6049, 6678, 6903, 8369, 9187, 9447, 10362, 11210, 11922, 12390, 13004, 14136, 14585, 15196, 16430, 18425, 19372, 20125, 21529, 23089]","[0, 330, 639, 1097, 1499, 1824, 2331, 2926, 3492, 4037, 4309, 5136, 5451, 6054, 7039, 7224, 8255, 8769, 9100, 10019, 10165, 10661, 11270, 11999, 12923, 13435, 14395, 14490, 15086, 15654, 17232, 18360, 19581, 20093, 21862]","[0, 206, 470, 860, 1136, 1498, 1744, 2299, 2654, 3520, 4029, 4577, 5206, 5775, 6461, 7195, 8219, 8613, 9570, 10106, 10611, 11319, 12224, 12675, 12999, 13972, 14548, 14839, 14935, 15964, 17086, 17907, 19015, 19767, 20564]","[0, 221, 337, 472, 602, 903, 1094, 1184, 1274, 1511, 1732, 1876, 2056, 2252, 2720, 3045, 3426, 3569, 4306, 4640, 4889, 5081, 5600, 6501, 6948, 7277, 7371, 7580, 7806, 8197, 8745, 9420, 9630, 9987, 10721]","[0, 204, 312, 494, 682, 873, 1040, 1265, 1546, 1887, 2116, 2366, 2672, 2913, 3514, 3915, 4326, 4533, 4986, 5598, 5937, 6103, 6411, 6891, 7143, 7541, 7635, 7730, 7860, 8275, 8958, 9472, 9889, 10209, 10881]",23089,21862,20564,10721,10881,13,18,19,37,20,"[0, 296, 468, 803, 1093, 1453, 1734, 2203, 3052, 3850, 4524, 5095, 5515, 6142, 6584, 7445, 8074, 8885, 9377, 10088, 10905, 11815, 12601, 13545, 13901, 14527, 15274, 16871, 17854, 18097, 18193, 19039, 19985, 20831, 21463]","[0, 204, 378, 761, 958, 1444, 1804, 2426, 2850, 3322, 3628, 4484, 5159, 5794, 5978, 7244, 8196, 9166, 9799, 10646, 11782, 12233, 13112, 13888, 14814, 15079, 15976, 17210, 17836, 18367, 18463, 19026, 19657, 20081, 20356]","[0, 242, 562, 788, 1118, 1521, 1864, 2521, 2927, 3263, 3718, 4305, 4685, 5054, 5361, 5688, 6150, 6643, 6757, 7156, 7559, 7796, 8172, 8777, 8873, 9129, 9571, 10833, 11511, 11941, 12037, 12812, 13295, 13585, 13771]","[0, 169, 259, 349, 439, 625, 729, 954, 1044, 1467, 1651, 1959, 2099, 2349, 2968, 3226, 3447, 3768, 4202, 4532, 4981, 5242, 5515, 6030, 6134, 6305, 6399, 7045, 7553, 7866, 8166, 8310, 8520, 8620, 8720]","[0, 169, 259, 349, 563, 698, 834, 1059, 1305, 1562, 2041, 2532, 2806, 3321, 3590, 3685, 4204, 4900, 5123, 5802, 6087, 6202, 6864, 7350, 7445, 7615, 7779, 8318, 8576, 8785, 8881, 9098, 9401, 9501, 9601]",21463,20356,13771,8720,9601,1626,1506,6793,2001,1280,13206,35,radiant
7633207514,73,22,15,112,65,"[0, 365, 672, 980, 1348, 1726, 2223, 2737, 3466, 4390, 5072, 5874, 6249, 7010, 8533, 9531, 10427, 10920, 11928, 13543, 14500, 15294, 16715, 17395, 17969, 19126, 19890, 20632, 21986, 23099, 23628, 25324, 26015, 26115, 27969]","[0, 444, 774, 1018, 1427, 1752, 2045, 2772, 3307, 3959, 4522, 5036, 5303, 6266, 6899, 7560, 8279, 8596, 8851, 10019, 10531, 11054, 11689, 11866, 11995, 12679, 12995, 13224, 14203, 14851, 15361, 16164, 16421, 17023, 18182]","[0, 573, 825, 1086, 1423, 1703, 2218, 2516, 2820, 3148, 3530, 4111, 4449, 4992, 5624, 6209, 7001, 7455, 7925, 8858, 9302, 10040, 10534, 10898, 10993, 12158, 12498, 13048, 13769, 14262, 14934, 15214, 15653, 16010, 16465]","[0, 209, 299, 389, 528, 618, 870, 960, 1050, 1337, 1594, 1860, 2110, 2509, 2748, 3165, 3782, 4135, 4424, 5468, 6030, 6125, 6757, 7111, 7206, 8008, 8442, 8671, 10076, 10809, 11143, 11618, 11878, 12368, 13912]","[0, 266, 356, 490, 702, 1000, 1540, 1691, 1839, 2326, 2804, 3117, 3299, 4001, 4345, 4836, 5278, 5843, 6295, 6993, 7676, 7803, 8094, 8347, 8442, 9401, 9846, 10075, 10878, 11165, 11433, 11834, 12135, 12571, 13198]",27969,18182,16465,13912,13198,10,137,79,54,83,"[0, 230, 444, 813, 1062, 1285, 1418, 1821, 2239, 2689, 3058, 3491, 3947, 4081, 4895, 5338, 6161, 7095, 7715, 8654, 9199, 10462, 11243, 11844, 13784, 15042, 16573, 17514, 18078, 18174, 18440, 18721, 21292, 22691, 23309]","[0, 206, 366, 737, 999, 1520, 1936, 2198, 2757, 3028, 3423, 4148, 4869, 5448, 6079, 6466, 7396, 7963, 8436, 8916, 9215, 10217, 10688, 10872, 12074, 12359, 12454, 13477, 13948, 14154, 14290, 15040, 17420, 18547, 19528]","[0, 154, 244, 421, 511, 781, 871, 1028, 1229, 1484, 1877, 2263, 2353, 2617, 2983, 3428, 3776, 4275, 4743, 5272, 5394, 6690, 7184, 7532, 8468, 8815, 9622, 10180, 10485, 11129, 11225, 11813, 12023, 13316, 13665]","[0, 239, 561, 809, 1102, 1430, 1805, 2292, 2711, 3089, 3448, 3668, 4146, 4410, 4688, 5135, 5499, 5874, 6413, 6723, 7102, 7543, 7961, 8145, 9588, 9852, 10122, 10382, 10686, 11113, 11563, 12005, 13505, 14269, 14459]","[0, 154, 244, 382, 472, 562, 652, 925, 1015, 1411, 1546, 1776, 1866, 1961, 3043, 3318, 4073, 4495, 4864, 5441, 5535, 6398, 6757, 7469, 8649, 8816, 9298, 9799, 10367, 10765, 11204, 11350, 12979, 14050, 14448]",23309,19528,13665,14459,14448,4660,-1346,2800,-547,-1250,4317,35,dire
7633305505,13,10,137,110,31,"[1, 276, 610, 1177, 1697, 2109, 2542, 3064, 3661, 4186, 4663, 5476, 5780, 6134, 6916, 7682, 8013, 8812, 9426, 10088, 10687, 11613, 12257, 13282, 14061, 14799, 15557, 16111, 16207, 17047, 17752, 18600, 19342, 20018, 20984]","[1, 282, 574, 878, 1169, 1553, 2243, 2614, 2779, 3141, 3666, 4130, 4668, 5130, 5637, 6347, 6930, 7782, 8327, 9006, 9680, 10145, 10906, 11858, 12658, 13198, 13803, 14480, 14787, 16298, 16757, 17590, 18461, 18561, 19431]","[1, 233, 524, 984, 1284, 1666, 2075, 2762, 3196, 3612, 3803, 4665, 5067, 5831, 6182, 7127, 7429, 7524, 7640, 7992, 8365, 8561, 8728, 8939, 9284, 9898, 10095, 10334, 10696, 11838, 12432, 13017, 13481, 13621, 14178]","[1, 196, 286, 445, 570, 660, 1107, 1571, 1661, 1917, 2007, 2268, 2530, 2818, 2993, 3359, 3677, 3948, 4204, 4746, 4971, 5520, 6010, 6185, 6552, 7106, 7201, 7862, 8051, 8356, 8791, 9080, 9579, 10000, 10148]","[1, 196, 286, 445, 535, 661, 851, 1187, 1277, 1367, 1502, 1682, 1910, 2059, 2521, 2616, 2773, 3025, 3189, 3437, 3699, 3995, 4162, 4337, 4771, 5039, 5134, 5496, 5592, 6458, 6603, 7143, 7792, 8169, 8352]",20984,19431,14178,10148,8352,48,90,15,66,19,"[1, 206, 490, 931, 1296, 1627, 1944, 2190, 2447, 3055, 3626, 4256, 5099, 5815, 6460, 7266, 8047, 8927, 9722, 10370, 11539, 12308, 13252, 14128, 15211, 16214, 16983, 17270, 18277, 19602, 20863, 21924, 22770, 23687, 24874]","[1, 375, 766, 1162, 1546, 1887, 2269, 2946, 3496, 3997, 4523, 5079, 5665, 6212, 6516, 6987, 7606, 8169, 8672, 9730, 10252, 11087, 11672, 12182, 12637, 13287, 14041, 14272, 14721, 15506, 15602, 16077, 16503, 17085, 18132]","[1, 207, 417, 705, 1365, 1680, 1960, 2219, 2382, 2776, 3166, 3598, 4365, 4883, 5526, 6013, 6689, 7378, 8092, 8631, 9203, 9461, 9666, 10011, 10222, 11003, 11707, 11945, 12551, 13179, 13704, 13988, 14447, 14913, 15738]","[1, 171, 261, 429, 640, 765, 970, 1472, 1635, 2022, 2380, 2783, 3241, 3585, 3870, 4197, 4847, 5453, 5706, 6114, 6425, 6770, 7072, 7386, 7563, 7817, 8351, 8506, 9204, 9801, 9984, 10285, 10582, 10927, 11507]","[1, 171, 345, 523, 816, 986, 1285, 1478, 1928, 2232, 2551, 2785, 3081, 3255, 3350, 3445, 4266, 4508, 4809, 5156, 5648, 5874, 6400, 6911, 7162, 7367, 7543, 7638, 7901, 8213, 8441, 8726, 8951, 9296, 9666]",24874,18132,15738,11507,9666,-3890,1299,-1560,-1359,-1314,-6824,35,dire
7633546718,10,43,2,27,85,"[0, 292, 644, 963, 1275, 1776, 2068, 2440, 2920, 3351, 3573, 4041, 4613, 5257, 5684, 6036, 6996, 7482, 8389, 9069, 10001, 10900, 11560, 12451, 13313, 13921, 14675, 15351, 15641, 15837, 16128, 16923, 17546, 18233, 18706]","[0, 255, 611, 900, 1157, 1572, 2023, 2720, 2935, 3347, 3859, 4121, 4528, 5104, 5487, 5619, 6486, 6863, 7483, 8216, 8482, 8669, 9240, 9857, 10400, 10761, 11418, 11846, 12252, 12692, 12959, 13415, 13892, 14326, 14619]","[0, 247, 493, 1148, 1433, 1934, 2316, 2760, 3232, 4010, 4856, 5266, 5562, 6259, 6551, 6863, 7919, 8376, 8907, 9738, 9972, 10207, 10665, 10965, 11802, 12270, 13245, 13409, 13553, 13999, 14283, 14563, 14779, 15281, 15690]","[0, 170, 280, 521, 739, 1079, 1214, 1881, 2016, 2149, 2393, 2483, 2711, 3110, 3350, 3444, 4219, 4646, 4890, 5183, 5443, 5667, 6019, 6370, 6611, 7151, 7656, 7908, 8127, 8650, 8902, 9956, 10221, 10750, 11134]","[0, 170, 260, 350, 650, 899, 1034, 1322, 1457, 1600, 1961, 2051, 2224, 2496, 2708, 3006, 3164, 3325, 3691, 4009, 4251, 4410, 4873, 5587, 5729, 6119, 6779, 7240, 7458, 8035, 8261, 8749, 9014, 9189, 9598]",18706,14619,15690,11134,9598,72,137,69,19,121,"[0, 245, 539, 1174, 1535, 2378, 2755, 3243, 3824, 4353, 4751, 5465, 6171, 6786, 7396, 8131, 8815, 9301, 9814, 10409, 10979, 11787, 12590, 13291, 13837, 14669, 15147, 15559, 15717, 16936, 17032, 17514, 18455, 19007, 20096]","[0, 294, 528, 773, 1085, 1383, 1720, 2138, 2589, 2952, 3492, 4346, 4542, 5122, 6019, 6686, 7267, 7816, 8118, 8751, 9346, 9700, 10214, 11105, 11288, 11579, 12278, 12620, 12844, 13836, 14309, 14602, 15796, 16511, 17482]","[0, 170, 399, 637, 916, 1294, 1866, 2335, 2907, 3344, 4012, 4621, 5344, 6127, 6746, 7141, 7579, 8410, 9178, 9578, 9896, 10049, 10571, 10929, 11060, 11431, 11991, 12085, 12341, 14245, 14990, 15704, 16272, 16601, 16979]","[0, 208, 346, 436, 526, 697, 863, 1079, 1214, 1849, 2361, 2545, 2635, 2784, 3102, 3576, 4057, 4152, 4247, 4475, 4790, 4956, 5373, 5618, 5713, 6062, 6335, 6429, 6593, 6689, 7456, 7815, 8529, 8659, 9172]","[0, 215, 305, 530, 729, 1043, 1393, 1618, 1802, 2019, 2350, 2534, 2672, 2857, 3163, 3565, 3751, 3846, 4032, 4224, 4468, 4745, 4912, 5006, 5101, 5286, 5462, 5556, 5652, 6492, 6941, 7234, 7883, 8194, 8763]",20096,17482,16979,9172,8763,-1390,-2863,-1289,1962,835,-2745,35,dire
7633732214,48,114,86,29,109,"[0, 279, 544, 958, 1205, 1697, 1982, 2532, 3278, 3897, 4583, 5130, 6075, 7008, 7869, 9055, 10100, 11249, 11713, 12742, 13899, 15484, 15964, 16636, 17489, 18523, 18958, 19241, 19818, 20116, 22010, 22110, 22749, 23232, 23422]","[0, 353, 734, 998, 1412, 1746, 2444, 2934, 3604, 4020, 4581, 5033, 5714, 6015, 6381, 6802, 7021, 7241, 7445, 8196, 8813, 9296, 9837, 10496, 11087, 11415, 11726, 12119, 12896, 13097, 13425, 13798, 13898, 14133, 14573]","[0, 290, 380, 550, 750, 1204, 1789, 1981, 2385, 2607, 2898, 3057, 3660, 4063, 4195, 5025, 5339, 5830, 6015, 6676, 7142, 7495, 7876, 8680, 9077, 9447, 9542, 9695, 10569, 10985, 11540, 12342, 12442, 12632, 13002]","[0, 327, 527, 927, 1358, 1483, 1922, 2345, 2607, 3243, 3842, 4146, 4731, 5371, 5849, 6498, 7001, 7513, 7915, 8448, 9099, 9461, 9740, 10218, 10752, 11337, 11512, 11785, 11881, 12282, 12837, 13112, 13212, 13450, 13684]","[0, 244, 334, 454, 591, 681, 771, 995, 1375, 1779, 2157, 2616, 2928, 3299, 3716, 4327, 4577, 4889, 5248, 5650, 6343, 6605, 7070, 7556, 8126, 8716, 8868, 9016, 9112, 9635, 9828, 10652, 11088, 11354, 11544]",23422,14573,13002,13684,11544,10,69,106,19,9,"[0, 205, 438, 727, 974, 1395, 1726, 1888, 2486, 2971, 3290, 3909, 4625, 5117, 5641, 6325, 7146, 7700, 8207, 8926, 9399, 9693, 10632, 11227, 11761, 12462, 13525, 14115, 16391, 17594, 18740, 19518, 20250, 21809, 23112]","[0, 243, 457, 734, 1139, 1556, 2293, 2734, 3322, 3751, 4139, 4660, 5282, 5687, 6251, 6923, 7922, 8555, 9313, 10679, 11356, 11623, 12724, 13531, 13831, 14277, 15969, 16517, 17915, 18092, 19376, 19726, 20629, 22145, 22946]","[0, 323, 483, 680, 975, 1256, 1391, 1602, 1813, 2148, 2664, 2958, 3060, 3671, 3976, 4302, 5226, 5514, 5987, 6641, 6854, 7528, 8744, 9354, 9565, 9942, 11176, 11686, 12984, 13817, 14645, 14994, 15391, 17173, 17979]","[0, 169, 306, 426, 650, 839, 1103, 1193, 1677, 1924, 2345, 2541, 2665, 3253, 3557, 3651, 4425, 4713, 4808, 5158, 5259, 5785, 6875, 7123, 7218, 7710, 8396, 8691, 10144, 10472, 11235, 11611, 11824, 12513, 13138]","[0, 220, 358, 478, 703, 809, 944, 1130, 1622, 1987, 2122, 2344, 2434, 2816, 2990, 3175, 3931, 4219, 4423, 4847, 4962, 5272, 5748, 5987, 6336, 6648, 7451, 7803, 8574, 9028, 9523, 10012, 10220, 10976, 11481]",23112,22946,17979,13138,11481,310,-8373,-4977,546,63,-12431,35,dire
7633814106,18,137,98,5,27,"[61, 338, 802, 1218, 1763, 2129, 2297, 2693, 3138, 3782, 4344, 4981, 5675, 6468, 7221, 7871, 9677, 10776, 11215, 12049, 13197, 14040, 15202, 15901, 16389, 17461, 18053, 19009, 19765, 22188, 22807, 23519, 25662, 26824, 27861]","[61, 342, 727, 1127, 1374, 1816, 2144, 2491, 2702, 3260, 3810, 4213, 5032, 5628, 6252, 6685, 7612, 8555, 9229, 10264, 10805, 11092, 12252, 13183, 13430, 14598, 15013, 15818, 16357, 17516, 18376, 18909, 20482, 21223, 21806]","[61, 343, 616, 846, 1212, 1536, 1790, 2148, 2540, 2973, 3880, 4494, 5137, 5634, 6159, 6710, 7387, 7943, 8644, 9485, 10117, 10722, 12082, 12891, 13093, 13457, 14080, 14174, 15244, 16091, 16657, 17311, 18372, 19361, 19956]","[329, 538, 752, 926, 1117, 1252, 1342, 1480, 1570, 2059, 2620, 2754, 2944, 3270, 3541, 3682, 3941, 4356, 4479, 4804, 5062, 5232, 6113, 6797, 7126, 7447, 7617, 7833, 8085, 8732, 8903, 9168, 10057, 10760, 11135]","[61, 270, 360, 495, 660, 750, 840, 964, 1054, 1262, 1650, 1740, 2061, 2347, 2615, 2710, 3391, 3764, 4004, 4513, 4697, 4830, 5526, 5692, 5787, 6347, 6468, 6562, 7052, 7603, 7699, 8269, 9248, 10217, 10653]",27861,21806,19956,11135,10653,94,82,23,72,65,"[0, 129, 429, 806, 1163, 1609, 2168, 2540, 3140, 3556, 4170, 4926, 5604, 6515, 7219, 7937, 8692, 9440, 10180, 11310, 12187, 13447, 14258, 15435, 16656, 18144, 18836, 20052, 20716, 21196, 21292, 22120, 22963, 23063, 24690]","[0, 324, 569, 984, 1476, 1856, 2473, 3234, 3706, 4278, 4793, 4992, 5970, 7483, 8423, 9063, 9220, 10140, 11109, 11876, 12687, 13496, 14329, 14522, 15528, 16364, 16459, 17101, 17987, 18653, 19576, 20429, 20726, 20826, 21811]","[0, 163, 348, 828, 1033, 1337, 1810, 1945, 2850, 3106, 3657, 4089, 4729, 5417, 6033, 6765, 7603, 8062, 8752, 9380, 10090, 10369, 10795, 11128, 11531, 12251, 12923, 13497, 13929, 14153, 14669, 15117, 15217, 16220, 16626]","[0, 129, 219, 358, 502, 637, 1180, 1315, 1569, 1659, 1794, 2103, 2462, 3054, 3196, 3536, 3717, 4054, 4268, 4787, 5128, 5317, 5599, 5693, 6298, 6725, 7456, 7783, 8254, 8395, 8491, 8888, 9315, 9415, 9651]","[0, 129, 219, 309, 439, 619, 1058, 1286, 1495, 1842, 2295, 2639, 2950, 3384, 3610, 4158, 4504, 4739, 5215, 5887, 6071, 6382, 6664, 6869, 7464, 7994, 8299, 8714, 8945, 9041, 9426, 9668, 9768, 9868, 10058]",24690,21811,16626,9651,10058,3171,-5,3330,1484,595,8575,35,radiant
7634024715,94,17,29,27,66,"[0, 243, 539, 889, 1138, 1579, 2192, 2523, 2936, 3379, 4414, 4805, 5374, 5832, 6347, 6858, 7539, 8550, 9389, 10410, 10726, 11697, 12687, 13419, 15293, 16697, 17582, 18214, 18993, 20079, 20175, 20513, 21396, 23154, 24660]","[0, 375, 745, 909, 1238, 1583, 1824, 2368, 2900, 3499, 4182, 5008, 5364, 5806, 6327, 7151, 7795, 8204, 9087, 9409, 9786, 10767, 11247, 11511, 13192, 13910, 14513, 15417, 16567, 17188, 17452, 17895, 18513, 19260, 19672]","[0, 295, 579, 784, 1149, 1470, 1747, 1949, 2280, 2779, 3408, 4077, 4167, 4507, 5070, 5667, 6498, 7270, 7834, 8185, 8373, 8850, 9421, 10251, 11796, 12610, 12910, 13174, 13435, 13996, 14092, 14310, 14741, 15921, 16916]","[0, 170, 260, 350, 489, 628, 752, 842, 978, 1113, 1485, 1828, 2188, 2283, 2669, 3316, 3447, 3668, 4184, 4398, 4974, 5408, 5719, 5889, 6921, 7709, 7878, 8214, 8466, 9068, 9239, 10226, 10388, 11569, 11933]","[0, 170, 278, 368, 495, 629, 798, 1073, 1308, 1518, 1871, 2211, 2358, 2685, 2982, 3264, 3571, 4070, 4453, 4841, 4994, 5317, 5615, 5819, 6386, 6955, 7235, 7429, 8003, 8699, 8904, 9066, 9312, 9978, 10357]",24660,19672,16916,11933,10357,18,137,69,65,62,"[0, 245, 492, 807, 1174, 1456, 2155, 2514, 3142, 3705, 4238, 4785, 5640, 6397, 7398, 8451, 9222, 10212, 11334, 12232, 12752, 13920, 15405, 16106, 16976, 17143, 18221, 18802, 19763, 20506, 22425, 23649, 24122, 25467, 26143]","[0, 250, 612, 1277, 1689, 2056, 2628, 2969, 3318, 3683, 4225, 4621, 5299, 6069, 6939, 7368, 8077, 8652, 9161, 9933, 10773, 11252, 12417, 12809, 13014, 13734, 14468, 15214, 16002, 16426, 17874, 18619, 19715, 20120, 20220]","[0, 208, 602, 806, 989, 1448, 1598, 1868, 2276, 2639, 3405, 3896, 4555, 5226, 5973, 6534, 7136, 7490, 8023, 8511, 9384, 10083, 11050, 12042, 12424, 12973, 13684, 14372, 15409, 15842, 16717, 17750, 18316, 18769, 19221]","[0, 170, 308, 518, 693, 823, 1069, 1159, 1375, 1465, 1770, 2145, 2279, 2892, 3175, 3922, 4162, 4657, 5106, 5516, 6369, 7012, 7400, 7931, 8136, 9142, 9431, 10429, 10754, 11181, 12123, 12990, 13112, 13521, 14137]","[0, 170, 260, 475, 666, 796, 1157, 1535, 1743, 1938, 2416, 2705, 3040, 3461, 3841, 4446, 4541, 4903, 5221, 5672, 6356, 6577, 7758, 7972, 8067, 8301, 8442, 9092, 9318, 9925, 10856, 11311, 11685, 11785, 12017]",26143,20220,19221,14137,12017,-1483,-548,-2305,-2204,-1660,-8200,35,radiant
7634079912,94,38,74,105,5,"[0, 242, 479, 727, 1053, 1346, 1833, 2214, 2674, 3140, 3469, 3893, 4411, 5196, 5793, 6192, 7387, 7924, 8812, 9593, 10836, 11741, 12185, 12685, 13753, 14604, 15399, 16176, 16697, 17986, 19674, 20569, 21115, 21674, 22781]","[0, 191, 519, 814, 1158, 1748, 2095, 2541, 2789, 3283, 3625, 4144, 5065, 5443, 6505, 6965, 7898, 9274, 10216, 11189, 12201, 12863, 13241, 13902, 14553, 15139, 15889, 16584, 16969, 17273, 17863, 19067, 19258, 19583, 20020]","[0, 276, 482, 743, 1157, 1502, 1838, 2299, 2838, 3637, 3888, 4137, 4590, 5090, 5614, 5709, 5932, 6820, 7270, 7406, 7905, 8341, 8885, 9532, 10097, 10630, 11138, 11730, 12166, 13228, 14635, 15496, 16137, 16237, 16588]","[0, 154, 244, 334, 469, 672, 808, 988, 1078, 1266, 1687, 1890, 2292, 2545, 2693, 2793, 2936, 3383, 3567, 4166, 4626, 5003, 5125, 5626, 6038, 6298, 6577, 6950, 7121, 8145, 8743, 9278, 9428, 9571, 10207]","[0, 154, 244, 383, 519, 703, 793, 973, 1237, 1642, 1751, 2070, 2244, 2497, 2645, 2740, 2835, 3611, 3861, 4381, 4798, 5031, 5433, 5663, 5912, 6097, 6348, 6524, 6868, 7572, 8095, 8503, 8647, 8747, 9120]",22781,20020,16588,10207,9120,10,98,55,19,45,"[0, 245, 553, 935, 1262, 1593, 2021, 2489, 2954, 3367, 3835, 4475, 5288, 6248, 6787, 7491, 8423, 8959, 9875, 10341, 11081, 11816, 12884, 13909, 14864, 15372, 16204, 17195, 17985, 18626, 18722, 19570, 20630, 22165, 22740]","[0, 332, 654, 1046, 1536, 1828, 2285, 3071, 3593, 4135, 4718, 5474, 5806, 6245, 6774, 7259, 8228, 8761, 9390, 10272, 10885, 11248, 12214, 12694, 13276, 13916, 14499, 15417, 15998, 16998, 17094, 17889, 18744, 20166, 21149]","[0, 209, 445, 744, 1168, 1593, 1953, 2531, 2754, 3280, 3952, 4497, 5168, 6048, 6495, 7275, 7922, 8654, 9274, 9750, 10427, 10970, 11636, 11900, 12414, 12971, 13348, 13663, 14177, 14994, 15448, 15740, 16318, 17814, 18790]","[0, 312, 402, 604, 770, 1163, 1298, 1668, 1843, 2196, 2430, 2785, 3214, 3781, 3923, 4235, 4629, 5067, 5335, 5667, 6287, 6382, 6976, 7352, 7693, 8260, 8600, 8959, 9490, 9930, 10026, 10287, 11317, 12596, 13275]","[0, 209, 299, 469, 589, 789, 971, 1186, 1392, 1747, 1966, 2274, 2513, 3012, 3110, 3708, 4216, 4382, 4650, 5067, 5431, 5775, 6013, 6157, 6279, 6527, 6728, 7148, 7495, 7935, 8110, 8422, 9160, 10149, 10616]",22740,21149,18790,13275,10616,41,-1129,-2202,-3068,-1496,-7854,35,dire
