match_id,rad_pos1,rad_pos2,rad_pos3,rad_pos4,rad_pos5,rad_pos1_gold,rad_pos2_gold,rad_pos3_gold,rad_pos4_gold,rad_pos5_gold,rad_pos1_last_gold,rad_pos2_last_gold,rad_pos3_last_gold,rad_pos4_last_gold,rad_pos5_last_gold,dire_pos1,dire_pos2,dire_pos3,dire_pos4,dire_pos5,dire_pos1_gold,dire_pos2_gold,dire_pos3_gold,dire_pos4_gold,dire_pos5_gold,dire_pos1_last_gold,dire_pos2_last_gold,dire_pos3_last_gold,dire_pos4_last_gold,dire_pos5_last_gold,pos1_diff,pos2_diff,pos3_diff,pos4_diff,pos5_diff,team_diff,minute,winner
7517586007,46,42,97,50,86,"[0, 205, 463, 746, 1132, 1436, 2130, 2573, 2948, 3718, 4211, 4888, 5658, 5752, 6468, 7653, 7962, 8641, 9989, 10785, 11520, 12630, 13511, 14759, 16136, 16632, 16727, 17468, 18039, 20325, 21075, 23489, 24481, 26132, 26232, 26500, 27846, 28534, 29441, 29811, 30161, 31181, 32862, 33661, 34838]","[0, 223, 526, 1060, 1398, 1820, 2422, 2597, 2906, 3324, 4037, 4355, 4829, 5488, 5912, 6451, 6889, 7340, 7845, 8196, 8663, 9504, 10346, 11098, 11884, 12808, 14042, 14511, 14742, 15813, 16284, 17176, 17473, 18581, 18859, 18959, 19496, 20785, 21456, 21669, 22350, 23046, 23984, 25085, 26058]","[0, 173, 500, 818, 981, 1405, 2047, 2400, 3229, 3728, 4450, 5242, 5604, 6033, 6536, 6949, 7519, 7787, 8474, 8632, 8857, 9215, 9420, 9830, 10160, 10595, 11193, 11803, 12175, 12849, 13080, 13179, 13819, 14399, 14557, 15347, 15668, 16369, 16695, 16959, 17270, 17666, 18333, 18678, 18867]","[0, 356, 689, 992, 1130, 1548, 2128, 2339, 2584, 2825, 3064, 3265, 3628, 3722, 3871, 4317, 4574, 4977, 5189, 5554, 5648, 5851, 6684, 7020, 7353, 7590, 7685, 7908, 8139, 9130, 9442, 10443, 11360, 11936, 12036, 12286, 12386, 12726, 12826, 13171, 13727, 13935, 14619, 14937, 15037]","[0, 169, 259, 395, 564, 762, 947, 1134, 1378, 1859, 2279, 2417, 2653, 2803, 3133, 3612, 3933, 4247, 5069, 5461, 5590, 5948, 6392, 6559, 6729, 6997, 7092, 7315, 7613, 7828, 8111, 8400, 9411, 9991, 10334, 10668, 10891, 11040, 11140, 11240, 11418, 11935, 12698, 13229, 13567]",34838,26058,18867,15037,13567,22,29,71,14,26,"[0, 405, 687, 1095, 1538, 1792, 2021, 2651, 3174, 3539, 4088, 4354, 4744, 5525, 5875, 6498, 7168, 7451, 8231, 9421, 10273, 11154, 11705, 11890, 13081, 14731, 15465, 16647, 17217, 18901, 19800, 20403, 20503, 21127, 21407, 22228, 23402, 24524, 26470, 26906, 27681, 28455, 29760, 30800, 32312]","[0, 616, 865, 1199, 1661, 1957, 2278, 3006, 3441, 3621, 4143, 4233, 5369, 6024, 6695, 7327, 7713, 8214, 8568, 9047, 9958, 10423, 11081, 11266, 11864, 12787, 13927, 14103, 14620, 15242, 15387, 16266, 16366, 17530, 18782, 19150, 20322, 21158, 21641, 22523, 22872, 24024, 24903, 25673, 26404]","[0, 210, 348, 487, 912, 1193, 1328, 1756, 2342, 2564, 3228, 3370, 4225, 5159, 5732, 5917, 6359, 7046, 7750, 8069, 8949, 9666, 10105, 10542, 10836, 11865, 12137, 13036, 13527, 13762, 14430, 15462, 15793, 15893, 16740, 17403, 18247, 19225, 20372, 20972, 21377, 21994, 22584, 23197, 23512]","[0, 328, 526, 798, 1306, 1670, 1985, 2415, 2915, 3466, 3978, 4317, 5107, 6027, 6306, 6600, 7171, 7393, 7739, 8646, 8842, 9686, 9893, 10254, 10790, 11585, 11862, 12262, 13044, 13461, 13821, 14403, 14547, 15426, 16772, 17504, 18041, 18987, 19864, 20477, 20676, 20861, 21532, 21632, 21732]","[0, 268, 358, 587, 762, 852, 1072, 1388, 1478, 1568, 1703, 1793, 2059, 2606, 2701, 3094, 3298, 3393, 3955, 4607, 4800, 5283, 5520, 6003, 6245, 6743, 7093, 7282, 7734, 8151, 8247, 9079, 9566, 10157, 12200, 12381, 12907, 13636, 13897, 14335, 14534, 14796, 15432, 15532, 15692]",32312,26404,23512,21732,15692,2526,-346,-4645,-6695,-2125,-11285,45,radiant
7519118314,53,10,20,136,51,"[0, 250, 378, 653, 1061, 1371, 1809, 2009, 2504, 2909, 3633, 4609, 4871, 5506, 5910, 6332, 7103, 7803, 8659, 9407, 9838, 11044, 11523, 11715, 12567, 13391, 14057, 15242, 16241, 16513, 17260, 17937, 19153, 20266, 20814, 22035, 23492, 25071, 25541, 26629, 27026, 27767, 29865, 30883, 31887]","[0, 291, 568, 865, 1278, 1721, 2135, 2419, 3015, 3438, 4120, 4761, 5247, 5897, 6445, 6612, 7935, 8931, 9392, 9549, 10334, 11280, 11561, 11731, 12167, 12576, 12973, 13642, 13879, 13975, 14885, 15881, 16802, 17746, 18014, 19325, 20299, 21937, 23336, 24139, 25095, 25993, 26494, 26594, 27451]","[0, 239, 368, 723, 1136, 1958, 2287, 2538, 3248, 3515, 3823, 4397, 4870, 5478, 5961, 6191, 6754, 7282, 7930, 8087, 8638, 8993, 9271, 9365, 9795, 10082, 10339, 10532, 11089, 12082, 12632, 13205, 13738, 14549, 14897, 16461, 16829, 18340, 19043, 19626, 20577, 21137, 21708, 21808, 22016]","[0, 230, 320, 410, 592, 859, 1012, 1102, 1603, 1783, 2109, 2537, 2786, 3051, 3146, 3240, 3791, 4138, 4634, 4791, 5175, 5531, 5698, 5792, 6069, 6436, 6603, 6845, 7223, 7992, 8410, 8731, 9157, 9585, 9711, 10729, 11056, 12293, 12851, 13453, 14049, 15212, 15621, 15721, 16203]","[0, 429, 519, 624, 762, 892, 982, 1072, 1236, 1656, 1881, 2214, 2304, 2681, 2776, 2870, 3208, 3616, 4115, 4272, 4455, 4846, 5160, 5329, 5499, 5836, 6078, 6398, 6840, 7221, 7914, 8362, 8717, 8966, 9141, 9316, 10274, 11574, 12490, 13140, 13612, 13841, 14617, 14775, 14983]",31887,27451,22016,16203,14983,48,80,23,112,83,"[0, 209, 450, 657, 851, 1013, 1223, 1708, 1934, 2239, 2655, 2993, 3380, 3974, 4735, 5564, 6105, 6408, 7106, 7887, 8457, 8990, 9649, 10800, 11510, 12298, 13270, 14103, 14996, 15425, 16191, 16647, 17721, 18979, 19631, 20888, 21159, 23115, 23215, 24029, 24597, 25371, 26722, 27160, 28036]","[0, 283, 519, 754, 1151, 1543, 1895, 2243, 2471, 2818, 3231, 3726, 4054, 4594, 5065, 5638, 6187, 6778, 7387, 8250, 8376, 8549, 9108, 10143, 10589, 11168, 11726, 12299, 13283, 15128, 15587, 16314, 16757, 16857, 16957, 17733, 17833, 18123, 18487, 19216, 20040, 20972, 22390, 24026, 25175]","[0, 243, 515, 768, 1050, 1339, 1854, 2438, 2895, 3453, 4263, 4923, 5538, 6159, 6548, 7133, 7828, 8157, 8839, 9794, 10298, 10774, 11284, 12328, 12771, 13037, 13311, 13792, 14613, 16071, 16388, 16668, 17214, 17396, 17788, 18328, 18711, 19691, 19791, 20413, 20696, 21239, 22696, 23320, 23802]","[0, 209, 299, 471, 611, 763, 932, 1022, 1418, 1508, 1839, 2087, 2177, 2794, 2969, 3316, 3411, 3601, 3913, 4647, 5162, 5438, 5706, 6496, 7122, 7716, 8266, 8871, 9312, 9408, 9727, 10007, 10668, 10825, 11054, 11464, 11810, 12597, 12812, 14322, 14796, 14984, 15744, 15952, 16335]","[0, 209, 299, 441, 561, 688, 813, 1142, 1232, 1358, 1794, 2004, 2094, 2382, 2571, 2869, 2964, 3225, 3949, 4357, 4482, 4829, 5377, 6060, 6276, 6654, 6977, 7283, 7735, 8399, 8570, 8908, 9414, 9514, 9683, 10222, 10322, 10639, 10826, 10926, 11384, 11517, 12274, 12754, 12964]",28036,25175,23802,16335,12964,3851,2276,-1786,-132,2019,6228,45,dire
7519735705,10,39,129,79,83,"[0, 288, 573, 892, 1347, 1620, 2031, 2445, 2706, 3241, 3697, 4533, 4659, 5096, 5433, 5985, 6846, 7696, 8434, 8910, 9488, 9887, 11118, 12156, 12772, 13410, 14358, 14617, 15520, 15661, 15879, 16312, 17657, 19679, 20688, 22706, 24588, 27419, 28079, 29546, 30225, 31395, 33341, 35130, 36061]","[0, 290, 543, 797, 1243, 1586, 1919, 2595, 3248, 3692, 4439, 5001, 5091, 5615, 5823, 6149, 6946, 7339, 7905, 8241, 8954, 9458, 9909, 10189, 10639, 11095, 11706, 12226, 12643, 13167, 13822, 14784, 15508, 16275, 17242, 18423, 19080, 20594, 21463, 22501, 23446, 24586, 25375, 26471, 27009]","[0, 258, 642, 923, 1335, 1683, 1975, 2391, 2791, 3201, 3558, 4108, 4375, 4739, 4884, 5257, 5763, 5969, 6316, 6603, 6968, 7726, 8094, 8224, 8647, 9080, 10018, 10453, 11034, 11202, 11665, 11765, 12239, 13783, 14578, 15222, 15853, 16168, 17779, 18014, 18114, 19086, 19639, 20279, 20852]","[0, 170, 260, 398, 534, 624, 714, 976, 1131, 1269, 1775, 1952, 2277, 2846, 3740, 3935, 4084, 4259, 4811, 4906, 5271, 5544, 5851, 6021, 6422, 6889, 7184, 7425, 7727, 7959, 8252, 8427, 8844, 9601, 10079, 10861, 11648, 12402, 13007, 13334, 13584, 13961, 14509, 15185, 15328]","[0, 272, 362, 452, 542, 749, 927, 1151, 1275, 1365, 1455, 1678, 1768, 1907, 2084, 2179, 2488, 2740, 3076, 3171, 3411, 3987, 4154, 4249, 4482, 4625, 4810, 4904, 5382, 5478, 5696, 6065, 6304, 7177, 7869, 8547, 8757, 9803, 10058, 10811, 10911, 11668, 12220, 12798, 12898]",36061,27009,20852,15328,12898,113,22,104,86,102,"[0, 260, 505, 883, 1292, 1416, 1883, 2294, 2674, 3092, 3345, 3806, 4842, 5510, 6546, 7155, 7801, 8798, 9474, 10467, 10984, 11770, 12381, 12850, 13911, 14321, 15228, 15791, 16619, 17676, 18463, 19298, 20794, 22303, 23301, 23715, 25199, 25999, 26099, 27521, 28541, 29835, 30041, 31006, 32137]","[0, 295, 700, 1023, 1324, 1707, 2149, 2413, 2753, 3045, 3620, 4325, 5623, 6062, 7154, 7558, 8240, 8754, 9144, 9912, 10162, 10737, 11451, 12141, 12835, 13402, 14366, 14872, 15504, 15710, 16647, 17360, 17920, 18373, 18473, 18783, 19416, 19856, 20564, 21277, 21476, 21905, 22005, 22844, 23415]","[0, 208, 455, 703, 1033, 1370, 1747, 2063, 2476, 2669, 3145, 3421, 3980, 4798, 5356, 5741, 6112, 6938, 7388, 8117, 8356, 8887, 9170, 9487, 9825, 10313, 10574, 11012, 11576, 12003, 12523, 13300, 13951, 14196, 14382, 14755, 15646, 16174, 16274, 17115, 17727, 17935, 18035, 18321, 19309]","[0, 170, 309, 399, 600, 739, 913, 1094, 1231, 1391, 1481, 1822, 2174, 2485, 3002, 3258, 3550, 3834, 4122, 4614, 5099, 5413, 5795, 6242, 6560, 7114, 7483, 7932, 8893, 9257, 9622, 10578, 11399, 11697, 12066, 12316, 12416, 12745, 12971, 13718, 13917, 14332, 14606, 14892, 15123]","[0, 170, 262, 398, 576, 701, 1149, 1239, 1329, 1453, 1543, 1633, 2142, 2465, 3137, 3322, 3655, 3956, 4085, 4561, 4789, 4956, 5263, 5430, 5812, 6085, 6289, 6599, 7078, 7404, 7645, 7901, 8291, 8536, 8636, 9146, 9246, 9677, 10202, 11340, 11539, 11747, 11897, 12079, 12284]",32137,23415,19309,15123,12284,3924,3594,1543,205,614,9880,45,radiant
7520505806,10,120,78,51,26,"[0, 248, 375, 738, 942, 1352, 1647, 2032, 2227, 2944, 3458, 3985, 4924, 5332, 5806, 6261, 6906, 7917, 8646, 9381, 9813, 10610, 11576, 12424, 13149, 13910, 14907, 15569, 16845, 17601, 18558, 18658, 19515, 19856, 21337, 22353, 23291, 24447, 24882, 25463, 26303, 27771, 29139, 30073, 31723]","[0, 282, 677, 999, 1374, 2096, 2344, 2577, 3225, 3747, 4608, 4942, 5860, 5991, 6784, 7426, 7760, 8718, 9297, 9966, 11323, 11669, 12244, 12786, 13521, 13998, 14724, 15156, 15871, 16322, 16785, 17195, 18269, 18666, 19761, 20884, 20984, 21282, 22064, 22988, 23427, 24720, 25402, 26339, 26936]","[0, 318, 593, 910, 1221, 1555, 1933, 2435, 2952, 3398, 4018, 4519, 4910, 5213, 5990, 6331, 7060, 7700, 8170, 8785, 9044, 9139, 9485, 9725, 10132, 10608, 10933, 11463, 11799, 12081, 12490, 12590, 13274, 13568, 14193, 14624, 15259, 15649, 16522, 17273, 17722, 18075, 18833, 19725, 21130]","[0, 210, 348, 484, 574, 774, 864, 1099, 1334, 1606, 2163, 2541, 2922, 3017, 3522, 3662, 4229, 4773, 5040, 5744, 6186, 6356, 6634, 6961, 7445, 7687, 7857, 8333, 8741, 9127, 9516, 9705, 9895, 10072, 10932, 11533, 11879, 12286, 13089, 13264, 13430, 13530, 14111, 14256, 14824]","[0, 210, 350, 488, 651, 839, 1022, 1451, 1671, 1943, 2078, 2172, 2424, 2721, 3103, 3333, 3880, 4392, 4831, 5340, 5565, 5660, 5872, 6076, 6470, 6728, 6872, 7150, 7481, 7577, 7694, 7794, 8084, 8184, 8809, 9019, 9175, 9473, 9573, 9673, 9773, 10445, 10761, 10861, 11429]",31723,26936,21130,14824,11429,13,41,71,20,68,"[0, 239, 558, 932, 1354, 1630, 2079, 2930, 3395, 3706, 4048, 4497, 5023, 6242, 6408, 7112, 7877, 8133, 8828, 9406, 10055, 10754, 11328, 12218, 12913, 13433, 14111, 14918, 15512, 16148, 16528, 18222, 19102, 19771, 20557, 21792, 22355, 22799, 24637, 25091, 26108, 26510, 28309, 29070, 30390]","[0, 164, 444, 684, 853, 1213, 1444, 1900, 2189, 2608, 3177, 4023, 4548, 4923, 5572, 6284, 6942, 7488, 8045, 8560, 8783, 9512, 10156, 10806, 11688, 12201, 12904, 13211, 13882, 14097, 14555, 15902, 16830, 17213, 17702, 18069, 19571, 19826, 19926, 20751, 21512, 21914, 23643, 24583, 26154]","[0, 164, 397, 595, 1083, 1250, 1830, 2274, 2613, 2779, 2956, 3385, 3693, 4152, 4617, 5183, 5430, 5920, 6510, 7491, 7834, 8628, 9661, 10306, 11168, 11739, 12118, 12561, 12836, 13146, 14163, 15139, 16047, 17174, 17274, 17841, 17941, 18963, 19097, 19232, 20255, 20805, 20987, 21432, 21943]","[0, 130, 402, 492, 746, 870, 1008, 1439, 1750, 1840, 2017, 2161, 2299, 3013, 3526, 3927, 4150, 4335, 4539, 4724, 5015, 5992, 6306, 6610, 6878, 7120, 7372, 7626, 7797, 7968, 8139, 8878, 9340, 9734, 10440, 11100, 11294, 11410, 11510, 11856, 12177, 12430, 13026, 13189, 13862]","[0, 130, 220, 310, 445, 535, 640, 805, 985, 1075, 1252, 1576, 1846, 2198, 2458, 2810, 3147, 3332, 3597, 3867, 3961, 4238, 4477, 4706, 4801, 4968, 5063, 5607, 5703, 5834, 5930, 6734, 6912, 7453, 8241, 9482, 9811, 9955, 10055, 10407, 10678, 11189, 11702, 11802, 12313]",30390,26154,21943,13862,12313,1333,782,-813,962,-884,1380,45,dire
7520723202,76,28,71,58,40,"[0, 169, 560, 877, 1075, 1486, 1824, 2340, 2805, 3206, 3808, 4311, 4809, 5331, 5689, 6204, 6935, 7892, 8745, 9303, 10273, 11093, 11687, 11781, 12289, 13133, 14402, 15223, 16041, 16322, 16676, 18854, 20652, 21701, 23476, 24563, 25196, 26166, 27193, 27485, 28445, 29713, 30562, 32062, 32639]","[0, 215, 574, 947, 1164, 1652, 2014, 2378, 2739, 3517, 4119, 4508, 5488, 6413, 6834, 7364, 7728, 8093, 8863, 9010, 9278, 10460, 11022, 11389, 11885, 11980, 12891, 13381, 13558, 13925, 14616, 14716, 16065, 17057, 18748, 19225, 19724, 20812, 21424, 21595, 22420, 22520, 23040, 24401, 25274]","[100, 299, 603, 864, 1144, 1369, 1672, 2012, 2363, 2920, 3558, 4197, 5027, 5759, 6052, 6610, 7532, 8321, 8812, 9386, 10027, 10632, 11559, 12274, 12440, 13078, 13478, 14274, 14826, 15320, 16313, 16413, 17702, 18169, 18525, 19732, 20494, 21421, 21521, 22430, 23361, 23957, 24602, 25017, 25117]","[78, 207, 297, 400, 501, 666, 813, 1409, 1577, 1667, 1941, 2646, 3171, 3851, 4253, 4408, 4841, 5099, 5574, 5781, 6079, 6514, 6895, 7083, 7245, 7722, 8203, 9370, 9775, 9960, 10648, 13241, 13431, 14540, 16123, 16933, 17521, 18208, 18714, 19150, 20099, 20592, 21233, 22001, 22417]","[211, 340, 430, 566, 656, 910, 1102, 1272, 1491, 1834, 2358, 2768, 3063, 3726, 4062, 4157, 4314, 4913, 5221, 5316, 5489, 5825, 6226, 6427, 6952, 7080, 7338, 7752, 7929, 8025, 8121, 8929, 9139, 10147, 11160, 11483, 11724, 12587, 12766, 13305, 14088, 14188, 14696, 15550, 15650]",32639,25274,25117,22417,15650,10,98,61,79,136,"[62, 271, 509, 819, 1159, 1646, 2238, 2697, 3196, 3536, 3795, 4075, 4514, 5185, 6106, 6477, 7097, 7653, 8162, 8762, 9646, 10453, 11599, 12180, 13021, 14286, 15056, 16859, 17696, 19427, 20973, 23729, 23829, 24464, 24621, 24721, 25532, 27126, 28065, 28775, 29629, 30826, 31519, 33245, 34927]","[330, 695, 982, 1393, 1719, 1929, 2436, 2896, 3320, 4060, 4655, 5410, 6237, 6600, 7252, 8106, 8899, 9621, 10473, 11150, 12015, 12868, 13954, 14735, 15786, 17321, 18036, 18723, 18819, 19416, 20640, 22118, 22218, 22624, 22724, 22824, 23332, 24160, 24951, 25725, 26647, 27502, 27801, 30819, 31342]","[62, 271, 622, 910, 1228, 1380, 1673, 1838, 2038, 2202, 2414, 2758, 3119, 3451, 4012, 4677, 5329, 6160, 6979, 7683, 8591, 8971, 9429, 10052, 10891, 12203, 12935, 13964, 14159, 15264, 16901, 18016, 18116, 18817, 18917, 19196, 19296, 19705, 20122, 20937, 21279, 21487, 22195, 23310, 23410]","[162, 416, 506, 677, 767, 897, 1049, 1236, 1407, 1785, 1905, 2103, 2694, 2989, 3119, 3456, 3814, 4350, 4968, 5126, 5799, 5966, 6771, 7000, 7438, 8173, 8268, 8867, 9325, 10113, 10912, 11924, 12200, 12916, 13016, 13116, 13216, 13830, 14378, 14478, 15399, 15607, 15908, 16966, 17759]","[62, 271, 361, 500, 594, 795, 978, 1068, 1158, 1248, 1592, 1812, 2095, 2513, 2784, 2879, 3036, 3221, 3586, 3744, 4172, 4438, 5093, 5482, 6198, 6728, 6823, 7200, 7437, 8153, 9112, 10125, 10225, 10723, 10823, 10923, 11137, 11493, 11791, 12235, 12779, 12987, 13488, 13802, 13902]",34927,31342,23410,17759,13902,-2288,-6068,1707,4658,1748,-243,45,dire
7521480417,12,107,21,85,138,"[0, 281, 630, 988, 1483, 1718, 1981, 2071, 2224, 2581, 2769, 3497, 4065, 4595, 5251, 5805, 6428, 7439, 8103, 8565, 8891, 9518, 10204, 10976, 11553, 12148, 12898, 14008, 14610, 14944, 16684, 17908, 18439, 19312, 20317, 21090, 21732, 22449, 23393, 24520, 25406, 26867, 27669, 28554, 29037]","[0, 319, 602, 1087, 1448, 1720, 2083, 2483, 2861, 3150, 3361, 3800, 4104, 4532, 5545, 6078, 6873, 7316, 8049, 8443, 9509, 10039, 10609, 11341, 12214, 13177, 13839, 15007, 15637, 16013, 16529, 17218, 18420, 19170, 20043, 20407, 20717, 21084, 21717, 22322, 23281, 23839, 24436, 25473, 25999]","[0, 282, 615, 1019, 1485, 1781, 2206, 2964, 3455, 4059, 4488, 5235, 5764, 6372, 7425, 7602, 8604, 9093, 9842, 9937, 10374, 10641, 11054, 11629, 12079, 12208, 12324, 12852, 12970, 13201, 13401, 14394, 15321, 15516, 16607, 17142, 17459, 17888, 18499, 19204, 20338, 21251, 22399, 22622, 22722]","[0, 170, 260, 397, 532, 628, 763, 952, 1170, 1471, 1787, 2209, 2299, 2533, 2903, 2998, 3189, 3962, 4153, 4421, 4788, 5407, 5682, 6026, 6509, 6949, 7565, 8232, 8513, 8979, 9634, 10407, 11042, 11526, 11961, 12171, 12317, 12767, 12932, 13263, 13707, 14174, 14784, 14884, 15214]","[0, 170, 304, 439, 575, 665, 800, 890, 1141, 1346, 1531, 1999, 2089, 2284, 2941, 3206, 3855, 4607, 4959, 5054, 5211, 5600, 5844, 6157, 6493, 6677, 6867, 7184, 7390, 7928, 8444, 9055, 9532, 9632, 10273, 10579, 10797, 11121, 11492, 11894, 12338, 12710, 13055, 13814, 14556]",29037,25999,22722,15214,14556,10,129,137,26,100,"[0, 285, 589, 871, 1395, 1609, 2078, 2609, 2952, 3503, 4137, 4505, 5043, 5563, 6187, 7078, 7771, 8490, 9184, 10056, 10627, 11593, 12371, 13200, 13931, 14708, 15386, 16554, 17379, 18064, 19896, 20702, 21156, 21662, 22123, 23299, 23700, 24146, 25175, 25996, 26487, 27203, 28227, 29170, 30300]","[0, 240, 562, 824, 1144, 1468, 1938, 2369, 2622, 3151, 3703, 4308, 4864, 5257, 5538, 6015, 6365, 6771, 7465, 8737, 9516, 9745, 10290, 10930, 11250, 11819, 12360, 12544, 12988, 13904, 14193, 14396, 15347, 15707, 16345, 16606, 16706, 17332, 18250, 18765, 20191, 21730, 23517, 24259, 24776]","[0, 170, 420, 741, 996, 1408, 1858, 2717, 3361, 3629, 4248, 4338, 4967, 5489, 6273, 6755, 7181, 7646, 8029, 9306, 9636, 10351, 11436, 11997, 12212, 12838, 13608, 13930, 14216, 14559, 14808, 15626, 16714, 16937, 17037, 17231, 17578, 18255, 18934, 19707, 20060, 20268, 20851, 21957, 23029]","[0, 170, 619, 709, 858, 992, 1082, 1513, 1675, 1765, 2023, 2113, 2220, 2413, 2692, 3047, 3292, 3515, 3735, 4239, 4686, 5030, 5354, 5524, 6031, 6273, 6565, 6824, 7275, 7624, 7795, 7970, 8356, 8768, 8958, 9119, 9544, 9733, 10280, 10533, 10790, 10998, 11226, 11597, 12356]","[0, 170, 260, 350, 572, 676, 766, 946, 1104, 1251, 1431, 1728, 1818, 2217, 2447, 2640, 2797, 3007, 3156, 3628, 3722, 3892, 4307, 4611, 5090, 5350, 5675, 5997, 6380, 6476, 7048, 7148, 7338, 7597, 7697, 7861, 7963, 8211, 8845, 9360, 9713, 10303, 10928, 11328, 11752]",30300,24776,23029,12356,11752,-1263,1223,-307,2858,2804,5315,45,dire
7522384400,95,137,110,97,101,"[0, 262, 575, 803, 1278, 1877, 2253, 2433, 2907, 3359, 3874, 4400, 4978, 5459, 5858, 5952, 6967, 7938, 8930, 9582, 10243, 11650, 12628, 13587, 14921, 15748, 16477, 17593, 18767, 19643, 21057, 22546, 23305, 24216, 25202, 25915, 26582, 27528, 28527, 29506, 29606, 30290, 32058, 34425, 35983]","[0, 158, 317, 558, 801, 1069, 1438, 1892, 2661, 2838, 3312, 3501, 3591, 4391, 5209, 5389, 6617, 7085, 7820, 8585, 8849, 9479, 10296, 10792, 11226, 11507, 12280, 12667, 13349, 13742, 15122, 15899, 16466, 16808, 17303, 17919, 18151, 18350, 18450, 19303, 20069, 20439, 20852, 22402, 24138]","[0, 434, 524, 614, 783, 1179, 1364, 1746, 1836, 2051, 2322, 2558, 2806, 3301, 3666, 4018, 4949, 5306, 6002, 6183, 6370, 6911, 7410, 7851, 8378, 9072, 9428, 9897, 10554, 10746, 12070, 12799, 13068, 13710, 14658, 15236, 15554, 15753, 16504, 17003, 17103, 17789, 18525, 19814, 21113]","[0, 169, 520, 819, 1477, 1768, 2135, 2453, 2852, 3219, 3473, 3775, 4091, 4807, 5258, 5352, 6582, 6852, 7037, 7840, 8187, 8825, 9226, 9995, 10425, 11098, 11192, 11772, 12228, 12469, 13591, 14281, 14516, 14850, 15165, 15711, 15927, 16512, 16743, 16843, 17342, 18300, 18643, 19687, 20806]","[0, 311, 401, 491, 850, 1168, 1393, 1573, 1849, 2074, 2345, 2789, 2924, 3317, 3446, 3540, 4526, 4711, 4896, 5227, 5322, 6051, 6452, 7106, 7201, 7600, 7694, 7789, 8245, 8437, 8874, 9771, 10006, 10106, 10601, 10791, 10891, 11090, 11321, 11756, 11856, 12271, 12683, 13679, 15162]",35983,24138,21113,20806,15162,25,28,135,86,26,"[381, 673, 968, 1446, 1728, 2117, 2523, 3134, 3503, 4097, 4389, 4867, 5373, 5678, 6271, 7202, 7440, 8159, 9114, 9581, 10060, 10229, 10786, 11519, 12025, 13183, 13899, 14427, 15430, 15995, 16091, 17169, 18513, 19472, 20325, 21020, 21591, 22667, 23961, 26496, 27334, 28706, 29620, 30312, 30691]","[246, 565, 850, 1227, 1471, 1969, 2365, 2924, 3419, 3972, 4692, 5245, 5937, 6415, 7266, 8316, 8484, 8685, 9796, 10246, 10884, 11434, 12165, 12259, 12728, 13560, 14343, 14784, 15226, 15446, 15542, 15920, 17315, 18373, 19227, 20734, 21292, 22243, 22836, 24016, 24902, 25679, 25779, 26002, 26102]","[113, 356, 609, 847, 1025, 1199, 1475, 1982, 2397, 3013, 3442, 3962, 4664, 5199, 5627, 6598, 7126, 7384, 7869, 8418, 8892, 9198, 10059, 10391, 10678, 11290, 12032, 12412, 12752, 12903, 12999, 13308, 14121, 14739, 15246, 15346, 16032, 16354, 17170, 17468, 17568, 18660, 19093, 19254, 19595]","[113, 322, 412, 589, 679, 851, 976, 1503, 2322, 2535, 2888, 3126, 3306, 3800, 4168, 4531, 4726, 4971, 5500, 5594, 5794, 5889, 6522, 6973, 7469, 7975, 8204, 8639, 8998, 9266, 9399, 9721, 9995, 10809, 11305, 11492, 11789, 12205, 12362, 13325, 13975, 14530, 14931, 15336, 16105]","[113, 322, 412, 635, 770, 860, 950, 1220, 1518, 1733, 1978, 2305, 2541, 2744, 3250, 3794, 3986, 4128, 4738, 4832, 5032, 5152, 5610, 5763, 6014, 6432, 6682, 6852, 7133, 7304, 7475, 7905, 8229, 8985, 9823, 9998, 10697, 10920, 11292, 12683, 13234, 13863, 14038, 14248, 14664]",30691,26102,19595,16105,14664,5292,-1964,1518,4701,498,10045,45,radiant
7522545002,93,47,110,20,14,"[0, 243, 708, 1421, 1631, 2209, 2632, 2874, 3125, 3502, 3997, 5016, 5342, 6086, 6824, 7451, 7929, 9009, 9928, 10791, 11395, 11894, 12126, 12922, 13555, 14274, 14619, 15114, 16413, 16509, 17651, 18948, 20357, 21197, 22574, 23058, 24213, 25028, 25960, 26087, 26424, 27057, 30272, 31030, 31920]","[0, 583, 819, 1080, 1411, 1647, 1811, 2015, 2563, 2927, 3354, 3698, 4228, 4688, 5081, 5321, 5660, 5966, 6366, 6672, 7025, 7120, 7340, 7732, 8198, 8583, 8723, 8817, 9660, 9931, 10272, 10760, 12030, 12757, 12947, 13226, 13432, 13821, 14206, 14429, 15472, 15756, 17627, 18225, 18838]","[0, 170, 369, 459, 549, 639, 831, 921, 1101, 1514, 2538, 2899, 3034, 3335, 3883, 4064, 4537, 4833, 5371, 5730, 5913, 6199, 6328, 6718, 6915, 7100, 7394, 7624, 9191, 9590, 10033, 10690, 11410, 12206, 12396, 12496, 12596, 13000, 13191, 13360, 13896, 13996, 15905, 16222, 16628]","[0, 277, 690, 1059, 1257, 1458, 1548, 1757, 2143, 2347, 2714, 2980, 3382, 3796, 3977, 4172, 4623, 4992, 5302, 5629, 5905, 6000, 6190, 6565, 6846, 7031, 7126, 7370, 8223, 8747, 9177, 9867, 10657, 10847, 11252, 11640, 11845, 12044, 12215, 12315, 12890, 12990, 13740, 14459, 15047]","[0, 239, 532, 874, 1035, 1222, 1395, 1485, 1795, 1984, 2361, 2541, 3148, 3351, 3646, 4186, 4491, 4649, 5003, 5206, 5405, 5506, 5685, 6319, 6414, 6599, 7114, 7375, 8017, 8288, 8384, 8754, 9946, 10635, 10825, 11192, 11292, 11491, 11711, 12122, 12979, 13079, 14764, 15098, 15487]",31920,18838,16628,15047,15487,25,29,70,27,121,"[0, 222, 592, 924, 1316, 1813, 2531, 3073, 3755, 4175, 4419, 4763, 5279, 5664, 6673, 6842, 7766, 8162, 8739, 9472, 9766, 10896, 12774, 13467, 14280, 14843, 16347, 17127, 18401, 19889, 20326, 21322, 22369, 23494, 24469, 25140, 25416, 26607, 27214, 28269, 30442, 32371, 33229, 33449, 34200]","[0, 241, 478, 1014, 1311, 1514, 1812, 2490, 3043, 3714, 4319, 4556, 4923, 5495, 5886, 6297, 6928, 8345, 9021, 9449, 9965, 10493, 11025, 11682, 12424, 12993, 13980, 14383, 14891, 15194, 15631, 16204, 16466, 17062, 17252, 18094, 18524, 19171, 19896, 20685, 22439, 24533, 25148, 25368, 25820]","[0, 244, 668, 871, 1281, 1516, 1985, 2253, 2795, 2968, 3218, 3523, 4220, 4809, 5432, 5798, 6387, 6769, 7273, 7811, 8487, 9518, 9865, 10366, 10914, 11200, 12465, 12813, 13170, 13459, 13799, 14121, 14381, 14662, 15024, 15631, 16288, 16739, 17197, 17943, 19275, 20096, 20532, 20752, 21116]","[0, 272, 379, 560, 690, 780, 915, 1054, 1198, 1329, 1554, 1644, 1778, 2016, 2692, 2794, 2928, 4044, 4145, 4460, 4844, 5814, 6166, 6526, 6790, 7078, 7653, 7933, 8318, 8414, 8559, 8818, 9055, 9380, 9629, 9864, 9964, 10424, 10524, 11025, 12912, 14077, 14514, 15057, 15206]","[0, 170, 462, 768, 943, 1072, 1345, 1505, 1731, 1857, 2082, 2172, 2409, 2656, 3108, 3340, 3679, 4410, 4666, 5351, 5665, 6195, 6475, 6617, 6847, 7052, 7582, 7877, 8466, 8820, 9100, 9485, 9781, 9904, 10185, 10420, 10633, 10888, 11033, 11503, 12318, 12878, 13268, 13572, 13672]",34200,25820,21116,15206,13672,-2280,-6982,-4488,-159,1815,-12094,45,dire
7522585414,65,48,23,58,112,"[0, 295, 466, 957, 1255, 1782, 2334, 2918, 3661, 4163, 4726, 5616, 6331, 6688, 7566, 7711, 8611, 9283, 10609, 11295, 12299, 13392, 13486, 14456, 14942, 16482, 16751, 17731, 18797, 20072, 20982, 21613, 22838, 23891, 24806, 25080, 25724, 27586, 28858, 29301, 30616, 31228, 32072, 33947, 34645]","[0, 322, 566, 817, 1210, 1385, 1674, 1800, 2036, 2308, 2890, 3386, 4076, 4605, 5356, 5931, 6717, 7281, 8067, 8806, 9966, 10602, 11316, 12273, 12893, 13988, 14082, 14425, 14969, 15969, 16926, 17556, 18545, 18645, 19365, 20312, 20412, 21504, 22751, 23349, 23732, 23832, 24937, 25037, 25340]","[0, 254, 447, 696, 977, 1477, 2034, 2218, 2845, 3157, 3429, 3846, 4282, 4559, 5211, 5716, 6195, 6738, 7159, 7830, 8503, 8890, 10119, 10516, 10995, 11434, 11528, 11638, 12230, 12705, 13206, 13482, 14745, 14845, 15224, 15817, 16168, 17528, 18556, 18828, 19446, 19669, 19769, 21542, 22351]","[0, 169, 363, 536, 889, 1026, 1436, 1777, 1903, 1993, 2253, 2347, 2840, 2935, 3097, 3321, 3639, 3759, 4818, 5223, 6187, 6511, 7076, 7473, 7598, 8152, 8674, 8995, 9149, 9420, 10050, 10460, 11040, 11140, 11490, 11905, 12256, 12356, 12764, 13116, 13817, 14359, 14759, 16353, 17037]","[0, 169, 294, 384, 518, 741, 1003, 1187, 1389, 1838, 2235, 2502, 2706, 2801, 3160, 3341, 3637, 3779, 4627, 4933, 5686, 5883, 6762, 7522, 7617, 7800, 8069, 8439, 8535, 8829, 9384, 9835, 10607, 10707, 10807, 11329, 11429, 12724, 13327, 13427, 14062, 14162, 14549, 15917, 16254]",34645,25340,22351,17037,16254,54,21,20,136,45,"[0, 251, 566, 911, 1186, 1585, 2022, 2530, 3008, 3431, 3925, 4346, 4778, 5047, 5863, 6273, 7081, 7597, 8025, 8883, 9616, 10318, 11055, 11550, 12306, 13697, 14719, 15742, 16439, 17321, 17577, 18650, 19635, 19870, 21164, 22051, 23727, 24463, 25236, 25851, 27542, 28187, 29274, 29652, 29752]","[0, 303, 702, 1026, 1358, 1814, 2360, 2766, 3353, 4114, 4672, 5256, 5756, 6184, 7049, 7860, 8540, 9214, 9418, 10013, 10307, 10554, 11948, 12152, 12778, 13651, 14412, 15071, 15908, 16543, 17100, 17290, 18808, 19472, 20007, 20636, 22191, 22401, 22605, 23294, 25565, 26898, 28237, 28604, 28704]","[0, 542, 791, 1313, 1713, 2108, 2522, 3206, 3931, 4681, 5175, 5524, 5823, 6215, 6666, 7007, 7469, 7850, 8267, 8894, 9303, 9648, 10171, 10811, 11237, 12411, 13132, 13890, 14980, 15224, 15320, 15886, 17075, 17615, 18136, 19353, 21176, 21386, 21486, 21783, 22812, 23157, 23604, 23849, 24135]","[0, 238, 328, 519, 1195, 1367, 2048, 2235, 2588, 2901, 3219, 3367, 4023, 4234, 4472, 4567, 5608, 5752, 5846, 6067, 6242, 6367, 6533, 6737, 6832, 7564, 7997, 9204, 9543, 9639, 9773, 9963, 10752, 10987, 11383, 11483, 12574, 12784, 13073, 13286, 14599, 15133, 15580, 15825, 15925]","[0, 169, 309, 429, 519, 653, 872, 996, 1131, 1303, 1647, 1945, 2295, 2768, 3006, 3421, 4020, 4423, 4627, 5448, 5804, 5899, 6065, 6160, 6366, 6828, 7143, 7734, 8175, 8346, 8799, 9100, 10520, 10912, 11192, 11794, 12762, 13225, 13454, 13712, 15116, 15928, 16471, 16716, 16816]",29752,28704,24135,15925,16816,4893,-3364,-1784,1112,-562,295,45,dire
7522659008,25,74,23,102,45,"[0, 284, 679, 1093, 1541, 2179, 2470, 2946, 3516, 3944, 5308, 5961, 6622, 7458, 8703, 9659, 10252, 10678, 11199, 11703, 12077, 12793, 14278, 15086, 15859, 16889, 17794, 18222, 18987, 19646, 20451, 22311, 22411, 22703, 23526, 24046, 27085, 28415, 29581, 31765, 33808, 34531, 36524, 37291, 37792]","[0, 169, 366, 728, 1002, 1457, 1781, 2225, 2641, 3007, 3695, 4319, 4914, 5286, 5886, 6422, 6580, 7306, 8476, 8704, 9697, 10417, 10943, 12312, 12767, 13330, 13870, 14135, 14849, 15331, 15795, 16492, 17297, 18395, 19581, 20385, 21746, 22863, 23393, 24753, 26152, 27304, 28924, 29024, 29256]","[0, 244, 585, 1148, 1276, 1705, 1839, 2043, 2391, 2597, 2948, 3338, 3517, 4105, 4729, 5374, 5996, 6176, 6489, 6813, 7108, 7604, 8130, 8449, 9101, 9614, 10141, 10236, 10362, 10801, 11098, 12941, 13041, 13370, 13825, 14280, 15645, 16171, 16774, 17945, 19140, 19637, 20745, 20845, 21109]","[0, 169, 284, 422, 530, 926, 1071, 1249, 1347, 1519, 2147, 2417, 2575, 2775, 3245, 3578, 3825, 3920, 4114, 4208, 4420, 4866, 5842, 6130, 6711, 7149, 7338, 7508, 7679, 8023, 8352, 9202, 9377, 9529, 9882, 10057, 11808, 12308, 12763, 13492, 14582, 14908, 15433, 15533, 15633]","[0, 219, 334, 569, 721, 873, 963, 1444, 1534, 1671, 2187, 2608, 2794, 2889, 3391, 3718, 3973, 4235, 4429, 4549, 4819, 5084, 5962, 6129, 6333, 6500, 6705, 6898, 6994, 7531, 7762, 8459, 8615, 8946, 9299, 9399, 10470, 10895, 11275, 12147, 13241, 13694, 14802, 14902, 15134]",37792,29256,21109,15633,15134,52,76,14,71,79,"[58, 349, 725, 1098, 1467, 1882, 2228, 2781, 3214, 3422, 3588, 4348, 4609, 5717, 6397, 7246, 8394, 9753, 10048, 11186, 12127, 12638, 13112, 14169, 14962, 15620, 16652, 17187, 18224, 19235, 19488, 20832, 22341, 23245, 24482, 25009, 25976, 26076, 26824, 27535, 28631, 29293, 31189, 31645, 34630]","[326, 533, 893, 1179, 1481, 1853, 2172, 2699, 3154, 3833, 4067, 4365, 4833, 5232, 6000, 6664, 7626, 8690, 9310, 10635, 11680, 12594, 12770, 13310, 13946, 14864, 15827, 16321, 17504, 17856, 18308, 18527, 19273, 20170, 21117, 21507, 22147, 22247, 22835, 23688, 23788, 24354, 26237, 27326, 29128]","[58, 227, 395, 707, 1158, 1322, 1537, 2317, 2653, 2861, 3196, 3750, 4219, 4562, 4949, 5276, 5869, 6908, 7273, 8266, 8944, 9344, 9536, 9997, 10216, 10537, 10874, 11080, 11438, 11993, 12089, 12422, 13441, 14300, 14847, 14994, 15555, 15655, 15947, 16760, 16860, 17195, 18700, 18800, 20032]","[58, 227, 317, 407, 581, 711, 849, 1087, 1286, 1483, 1814, 2112, 2448, 2723, 2818, 3020, 3742, 4264, 4359, 5162, 5659, 5926, 6073, 6321, 6750, 7363, 7875, 8079, 8580, 8917, 9033, 9983, 11275, 12038, 12365, 12465, 13341, 13441, 13823, 14383, 14483, 14907, 15465, 15591, 16480]","[58, 227, 317, 407, 584, 714, 823, 1148, 1283, 1373, 1463, 1679, 2016, 2586, 2964, 3166, 3690, 3878, 4141, 4827, 5385, 5692, 6045, 6495, 6738, 7091, 8020, 8239, 9009, 9261, 9389, 9722, 10550, 10987, 11177, 11321, 11531, 11802, 12151, 12398, 12654, 12846, 13781, 13915, 15358]",34630,29128,20032,16480,15358,3162,128,1077,-847,-224,3296,45,radiant
7523717218,48,74,129,96,26,"[0, 252, 566, 880, 1161, 1521, 2010, 2518, 2987, 3526, 4069, 4698, 5344, 6018, 6815, 7404, 8184, 9544, 10428, 11761, 12524, 14011, 14550, 15470, 16012, 16959, 18048, 19005, 20223, 21880, 22581, 23572, 24764, 25039, 26074, 27008, 28196, 28919, 29925, 30916, 31820, 32028, 32712, 33296, 33829]","[0, 245, 536, 898, 1629, 2009, 2726, 3271, 3415, 3695, 4125, 4314, 4737, 5235, 5527, 6132, 6473, 6928, 7587, 8061, 8617, 9352, 9597, 10052, 10487, 11205, 11877, 12223, 12783, 13503, 13636, 14420, 15309, 16183, 16684, 17117, 17751, 18729, 18975, 19428, 20262, 21030, 21230, 21644, 22141]","[0, 285, 592, 831, 1254, 1434, 1673, 2131, 2447, 2905, 3190, 3705, 4118, 4649, 4919, 5203, 5827, 6520, 6775, 7157, 7474, 8019, 8272, 8434, 8690, 9104, 10193, 10619, 11100, 11952, 12289, 12590, 13078, 13656, 14042, 14530, 14989, 15348, 16275, 16625, 17618, 18327, 18427, 18942, 19299]","[0, 170, 260, 395, 525, 664, 992, 1417, 1507, 1597, 1918, 2342, 2559, 2980, 3413, 3987, 4245, 4645, 4982, 5364, 5661, 6340, 6567, 6918, 7084, 7896, 8652, 8793, 9472, 10017, 10166, 10266, 10714, 10923, 11203, 11467, 11614, 12354, 12454, 12682, 13700, 14110, 14647, 14747, 15339]","[0, 170, 260, 350, 528, 618, 754, 1071, 1330, 1549, 1684, 1873, 2139, 2317, 2507, 2983, 3562, 4054, 4246, 4628, 4798, 5088, 5258, 5578, 5854, 6256, 6812, 7110, 7445, 8037, 8167, 8329, 8780, 9000, 9324, 9680, 10064, 10382, 10634, 10734, 11719, 11970, 12073, 12173, 12736]",33829,22141,19299,15339,12736,46,17,69,20,45,"[0, 256, 525, 936, 1266, 1663, 2064, 2414, 2940, 3520, 4225, 4824, 5244, 6138, 6875, 7648, 8438, 8984, 9739, 11409, 12236, 12731, 13111, 13785, 14810, 15463, 16377, 17110, 17843, 18463, 19929, 20571, 22754, 23303, 24046, 25017, 25740, 26303, 26624, 27560, 29160, 29639, 30381, 30954, 33248]","[0, 355, 559, 848, 1081, 1304, 1745, 1997, 2468, 3057, 3412, 3930, 4286, 4848, 5706, 6296, 6638, 7415, 7807, 8635, 9305, 10335, 11253, 12035, 12509, 13201, 13296, 13726, 14632, 14818, 15854, 16628, 17123, 17426, 18219, 19245, 19981, 21463, 22009, 22441, 22803, 23080, 23663, 23997, 25201]","[0, 170, 402, 529, 973, 1295, 1618, 1960, 2095, 2377, 2759, 3195, 3550, 4133, 4572, 5086, 5636, 5977, 6774, 7593, 8073, 8419, 8788, 9567, 10045, 10557, 11273, 11956, 12779, 13326, 14208, 14962, 16986, 17708, 18141, 18722, 19160, 19678, 20881, 21441, 21963, 22063, 22395, 22896, 23742]","[0, 170, 260, 471, 787, 927, 1027, 1248, 1657, 2015, 2251, 2462, 3056, 3361, 3745, 4248, 4710, 4950, 5173, 6122, 6291, 6477, 6822, 7217, 7672, 7998, 8201, 8522, 8804, 9239, 9934, 10034, 11975, 12165, 12529, 12801, 12901, 13226, 13382, 13941, 14686, 15804, 16043, 16251, 17206]","[0, 259, 400, 577, 770, 956, 1046, 1136, 1348, 1571, 1708, 2043, 2312, 2661, 2939, 3251, 3439, 3623, 4223, 5044, 5139, 5431, 5526, 5765, 6314, 6879, 7273, 7812, 8147, 8639, 9853, 10127, 10922, 11190, 11944, 12417, 12517, 12788, 13257, 13456, 14201, 14301, 14401, 14739, 15420]",33248,25201,23742,17206,15420,581,-3060,-4443,-1867,-2684,-11473,45,radiant
7523787713,78,41,76,105,110,"[229, 566, 805, 1289, 1604, 1778, 2081, 2334, 2598, 2932, 3398, 3901, 4355, 4449, 4715, 5260, 5913, 6311, 6814, 7443, 7952, 8118, 8801, 9323, 9597, 10335, 10875, 11734, 12632, 13134, 13847, 14350, 14726, 15883, 16487, 17151, 17671, 17771, 20202, 21234, 22354, 23502, 24132, 24906, 25778]","[168, 576, 824, 1310, 1552, 2062, 2616, 3070, 3593, 3909, 4188, 4619, 4942, 5236, 5616, 6024, 6496, 7071, 7398, 7912, 8502, 9190, 10101, 10563, 10995, 12172, 13223, 13945, 14993, 15465, 15987, 17027, 18386, 19098, 19616, 19747, 20519, 20931, 21031, 21728, 22459, 22836, 23112, 23772, 24743]","[300, 461, 840, 1156, 1448, 2000, 2259, 2682, 3091, 3510, 3978, 4305, 4740, 5139, 5566, 5796, 6228, 6731, 7096, 7675, 8039, 9042, 9412, 9876, 9970, 10609, 11405, 11778, 12283, 12838, 13569, 14260, 15079, 15715, 16457, 16693, 17947, 18536, 19975, 20909, 21664, 22323, 22900, 23326, 24071]","[193, 283, 420, 796, 886, 1072, 1532, 1693, 1938, 2028, 2212, 2302, 2450, 2556, 2675, 2981, 3116, 3578, 3723, 4040, 4766, 5188, 5549, 5927, 6096, 6706, 7387, 7779, 7950, 8668, 8941, 9451, 10011, 10557, 10866, 11111, 11918, 12093, 14510, 15675, 17076, 17509, 17806, 18108, 18819]","[461, 551, 641, 820, 910, 1000, 1348, 1748, 1838, 1984, 2210, 2554, 2974, 3323, 3589, 4324, 4654, 5090, 5504, 5973, 6339, 6679, 7309, 7776, 8031, 8689, 9755, 10260, 11641, 11995, 12170, 12552, 13058, 13806, 14340, 14600, 14737, 14868, 15884, 17028, 17941, 18299, 18447, 18867, 19233]",25778,24743,24071,18819,19233,10,120,129,128,51,"[245, 556, 1046, 1565, 1959, 2460, 2977, 3559, 4032, 4579, 5262, 5832, 6561, 7257, 7778, 8824, 9592, 10279, 10761, 11599, 12363, 12809, 13536, 14408, 15145, 15961, 16137, 17174, 18083, 19099, 19528, 19972, 20468, 21602, 22612, 22944, 24566, 26034, 26779, 26879, 27764, 29258, 29958, 31154, 31389]","[291, 580, 929, 1252, 1574, 1827, 2136, 2620, 3096, 3662, 4313, 4706, 5314, 6155, 6818, 7427, 8042, 8885, 9640, 10597, 11141, 12089, 12527, 13347, 14180, 14801, 15697, 16418, 17104, 17794, 18368, 19977, 20740, 21618, 21808, 22518, 23351, 24422, 24580, 25339, 25853, 27008, 28023, 28868, 29582]","[248, 549, 812, 1049, 1338, 1647, 1943, 2340, 2559, 2990, 3295, 3851, 4239, 4768, 5580, 6336, 7010, 7637, 7982, 8535, 8888, 9708, 10201, 10835, 11398, 11810, 12131, 12840, 13551, 13647, 13843, 14404, 14889, 15282, 15951, 16093, 16712, 18033, 18525, 18625, 18874, 19595, 20200, 20591, 20826]","[210, 325, 450, 580, 736, 874, 1058, 1193, 1283, 1556, 1695, 2075, 2387, 2717, 3203, 4185, 4739, 5063, 5911, 6523, 7176, 7547, 7824, 8600, 9324, 10126, 10782, 11141, 11354, 11753, 12016, 12555, 13053, 13445, 13929, 14360, 15510, 16422, 17202, 17302, 17551, 17651, 18192, 18824, 19059]","[210, 325, 415, 591, 711, 817, 1174, 1309, 1399, 1740, 1874, 2284, 2615, 3034, 3399, 3780, 4238, 4737, 5341, 5589, 6247, 6476, 6829, 7303, 8141, 8674, 9182, 9564, 10065, 10771, 11223, 11882, 12154, 12482, 13076, 13492, 14086, 14810, 15277, 15751, 16000, 16852, 17232, 18286, 18779]",31389,29582,20826,19059,18779,-5611,-4839,3245,-240,454,-6991,45,dire
7524401509,13,10,138,30,100,"[0, 239, 415, 728, 818, 1088, 1300, 1644, 2175, 2557, 3052, 3738, 4271, 4786, 5548, 6110, 6680, 7288, 7621, 8169, 9685, 11411, 11577, 12344, 13047, 14170, 16053, 16938, 17522, 17854, 18520, 19983, 20441, 21485, 21851, 22930, 23336, 23635, 24343, 25538, 26387, 27338, 27797, 29083, 29675]","[0, 234, 523, 613, 1017, 1282, 1728, 2019, 2530, 2916, 3399, 3890, 4556, 5102, 5438, 5863, 6567, 7206, 7485, 8889, 9633, 9974, 10712, 11431, 12388, 13177, 14033, 14840, 15017, 15636, 16137, 16814, 16914, 17394, 17749, 17985, 18999, 19553, 20332, 20501, 21686, 23250, 24841, 25921, 28215]","[0, 338, 428, 565, 702, 837, 976, 1439, 1619, 1877, 2217, 3122, 3277, 3472, 3615, 3709, 4067, 4225, 4357, 4667, 5136, 5453, 6250, 6994, 7377, 7778, 8912, 9184, 10354, 10686, 11835, 12487, 12587, 12822, 13216, 13613, 14471, 15100, 15200, 15937, 16284, 16821, 17371, 17653, 18499]","[0, 205, 295, 385, 520, 728, 862, 952, 1181, 1330, 1500, 1798, 1979, 2176, 2319, 2430, 3334, 3492, 3586, 4233, 4385, 5435, 5820, 6558, 6757, 7156, 7899, 8257, 8668, 9075, 9381, 9602, 10196, 10468, 10610, 10972, 12719, 13003, 13284, 13550, 13843, 13985, 14193, 14609, 15988]","[0, 359, 567, 796, 1080, 1384, 1667, 2032, 2318, 2690, 3041, 3509, 4001, 4150, 4612, 5074, 5283, 5735, 5994, 6287, 6790, 7107, 7424, 7519, 8142, 8746, 9482, 10176, 10599, 11224, 11418, 11812, 12073, 12308, 12901, 13136, 13280, 13540, 13723, 14064, 14886, 15472, 15680, 16096, 17632]",29675,28215,18499,15988,17632,1,25,21,112,20,"[60, 308, 617, 973, 1441, 1682, 1932, 2216, 2564, 3253, 3725, 4428, 4983, 5690, 6254, 6719, 7783, 8712, 9511, 10152, 11513, 12799, 13099, 14139, 15065, 16329, 17442, 17537, 17970, 19225, 19895, 21110, 22862, 24019, 24889, 25690, 26233, 26897, 28101, 28775, 29870, 31472, 33097, 33932, 35939]","[328, 857, 1185, 1514, 1960, 2460, 3157, 3612, 3937, 4598, 5103, 5433, 6110, 6702, 7348, 7913, 9119, 9789, 10497, 11946, 12371, 13285, 13778, 14787, 15090, 15860, 16449, 17216, 18243, 20029, 20964, 22219, 23620, 24620, 25362, 27485, 28852, 30609, 31301, 32542, 33629, 33729, 33937, 35101, 36361]","[60, 306, 592, 1235, 1637, 1897, 2379, 2905, 3275, 3655, 3985, 4174, 5046, 5428, 5707, 6240, 6753, 7376, 8129, 8619, 9202, 10052, 10360, 11153, 11712, 12167, 12261, 12489, 12905, 13924, 14509, 15276, 15992, 16603, 17410, 18236, 19365, 20160, 20639, 21146, 21853, 22519, 23392, 24120, 25260]","[60, 269, 359, 449, 873, 963, 1102, 1240, 1449, 1687, 1860, 1987, 2410, 2622, 3171, 3390, 3900, 4074, 4433, 4846, 4977, 5515, 5609, 6030, 6338, 6982, 7076, 7171, 7648, 8797, 9418, 9971, 10598, 10925, 11137, 11507, 12352, 13035, 13135, 13486, 13750, 14274, 14599, 15439, 15926]","[0, 255, 345, 435, 606, 793, 983, 1481, 1571, 1735, 1871, 1961, 2337, 2477, 2626, 2845, 3196, 3370, 3600, 3829, 4003, 4098, 4341, 4602, 4781, 5164, 5306, 5482, 5898, 6302, 6677, 6997, 7509, 8086, 8322, 8745, 8845, 9255, 9771, 10365, 10754, 10854, 11662, 12290, 13054]",35939,36361,25260,15926,13054,-6264,-8146,-6761,62,4578,-16531,45,radiant
7525812113,35,22,69,83,26,"[0, 208, 388, 858, 1260, 1546, 2180, 2386, 2739, 3098, 3792, 4121, 4492, 4729, 5484, 5886, 6674, 7433, 8361, 9356, 9805, 9996, 10671, 11316, 11598, 12178, 12662, 13105, 13686, 14270, 14644, 15463, 16115, 16927, 17564, 18081, 18668, 19497, 19728, 20158, 20738, 21533, 21846, 23243, 24251]","[0, 326, 679, 1083, 1538, 2046, 2544, 2911, 3389, 3980, 4616, 4876, 5365, 5863, 6438, 7032, 7980, 8313, 8838, 9163, 9491, 9979, 10578, 11061, 11490, 11965, 12320, 12511, 12755, 13137, 13388, 14769, 15262, 15558, 15658, 16102, 16681, 17514, 17994, 18580, 19146, 21126, 22678, 23163, 23263]","[0, 274, 712, 1208, 1407, 1810, 2057, 2541, 3142, 3704, 4458, 4765, 5312, 5987, 6602, 7218, 7836, 8253, 8868, 9439, 9603, 10219, 10776, 11282, 11446, 11809, 12686, 13206, 13721, 14165, 14655, 15306, 15972, 16280, 16941, 17201, 17486, 18075, 18398, 19047, 19553, 20779, 21693, 22593, 23260]","[0, 170, 260, 396, 507, 641, 853, 989, 1513, 1980, 2160, 2250, 2340, 2990, 3198, 3467, 3861, 4176, 4361, 4456, 4550, 4645, 5065, 5553, 5647, 5869, 6201, 6296, 6484, 6580, 6714, 7053, 7153, 7404, 7504, 7604, 7817, 7917, 8192, 8292, 8438, 9807, 9907, 10510, 10816]","[0, 170, 351, 529, 619, 803, 1013, 1103, 1332, 1634, 1814, 1904, 2023, 2342, 2624, 2808, 3154, 3339, 3624, 3719, 3813, 4149, 4406, 4501, 4595, 4690, 4785, 4880, 5103, 5373, 5545, 6078, 6262, 6758, 6858, 6958, 7103, 7203, 7303, 7403, 7547, 8342, 8584, 9187, 9287]",24251,23263,23260,10816,9287,6,90,135,136,20,"[330, 577, 894, 1123, 1528, 1728, 2308, 2597, 2915, 3309, 3811, 4502, 5106, 5677, 6245, 6811, 7413, 8004, 8793, 9605, 10286, 10965, 11614, 12581, 13367, 14226, 15059, 16212, 17084, 17925, 18786, 20021, 21099, 22476, 23383, 24110, 24970, 26089, 27192, 28309, 29146, 30830, 31929, 34118, 34909]","[0, 290, 607, 1023, 1383, 1979, 2507, 3123, 3213, 3664, 4259, 4933, 5608, 6004, 6383, 7149, 8343, 9174, 9704, 10132, 10777, 11478, 12237, 12741, 13221, 13847, 14657, 15031, 15900, 16614, 17028, 17742, 18731, 19325, 19802, 20583, 21271, 22175, 23023, 23461, 23964, 25139, 25831, 27365, 28257]","[62, 343, 699, 898, 1185, 1517, 1855, 2670, 3117, 3455, 3688, 4544, 5009, 5769, 6426, 6952, 7767, 8314, 9004, 9503, 10645, 11181, 11398, 12066, 13143, 13911, 14397, 15733, 15978, 16534, 17226, 17900, 18399, 19148, 19676, 20116, 20638, 21000, 21767, 22286, 23092, 23486, 23950, 25113, 26006]","[62, 232, 533, 658, 748, 838, 1019, 1146, 1526, 1741, 2011, 2308, 2466, 3099, 3481, 3652, 4180, 4799, 5238, 5748, 6177, 6272, 6625, 6810, 7495, 8257, 8679, 9011, 9188, 9497, 9879, 10183, 10493, 10981, 11439, 12083, 12183, 12332, 13117, 13804, 14554, 14798, 15006, 16008, 16108]","[62, 276, 576, 666, 820, 957, 1141, 1608, 1742, 1922, 2204, 2534, 2624, 3071, 3195, 3407, 3635, 3793, 3976, 4297, 4726, 4821, 4988, 5173, 5721, 6136, 6356, 6686, 6863, 6959, 7103, 7202, 7392, 7821, 8101, 8336, 8436, 8591, 9066, 9507, 9651, 10028, 10236, 10995, 11095]",34909,28257,26006,16108,11095,-10658,-4994,-2746,-5292,-1808,-25498,45,dire
7526305209,89,96,76,105,68,"[0, 204, 438, 756, 1089, 1559, 1923, 2254, 2719, 3326, 3853, 4252, 5169, 5822, 6517, 6879, 8164, 9182, 10186, 11124, 11730, 12723, 13738, 14594, 15391, 15972, 16689, 18503, 19954, 20706, 21661, 23525, 25082, 25851, 26479, 27464, 28713, 29722, 30304, 31144, 32829, 33634, 33900, 35123, 35535]","[0, 335, 554, 907, 1285, 1572, 2007, 2337, 2924, 3481, 3680, 4179, 4597, 5212, 5532, 6312, 6742, 7135, 7632, 8419, 9000, 9095, 9929, 10458, 10734, 11054, 11418, 12151, 12898, 13296, 13452, 14421, 15685, 15891, 16564, 17045, 17352, 17630, 17865, 18395, 19344, 19632, 19872, 20509, 20873]","[0, 242, 534, 831, 1175, 1494, 1711, 1919, 2339, 2846, 3215, 3711, 3853, 4507, 5004, 5540, 6317, 6499, 6891, 7235, 8157, 8536, 9253, 9529, 10153, 10473, 10568, 10863, 11543, 11952, 12328, 13082, 14339, 14772, 15452, 15729, 15998, 16405, 17001, 17545, 18052, 19091, 19684, 20554, 20787]","[0, 170, 260, 691, 826, 963, 1101, 1428, 1636, 1816, 1906, 2050, 2222, 2416, 2513, 2779, 3421, 3536, 3771, 4314, 4766, 4936, 5178, 5789, 6334, 6950, 7281, 7540, 8270, 8748, 8919, 9510, 10130, 10365, 10696, 10961, 11136, 11311, 11605, 11730, 12069, 12327, 12471, 12726, 13828]","[0, 170, 260, 399, 489, 656, 934, 1215, 1350, 1530, 1649, 1895, 2114, 2312, 2407, 2823, 3194, 3294, 3477, 3849, 4262, 4357, 4616, 4970, 5246, 5819, 5950, 6454, 6806, 7037, 7349, 7865, 8739, 8839, 9134, 9324, 9424, 9572, 10056, 10156, 10713, 11073, 11173, 11381, 12203]",35535,20873,20787,13828,12203,41,43,106,26,110,"[0, 170, 384, 667, 961, 1361, 1779, 2141, 2404, 2591, 3103, 3589, 4051, 4488, 5142, 5693, 6799, 7116, 7651, 8130, 8719, 8978, 9672, 10196, 10406, 11219, 11314, 12535, 13468, 14245, 14943, 15746, 16218, 16540, 17059, 17502, 17962, 18536, 18807, 19691, 20336, 21515, 22213, 22446, 24505]","[0, 242, 578, 895, 1224, 1557, 1870, 2402, 2819, 3228, 3780, 4546, 4989, 5613, 6202, 6795, 7402, 8036, 8454, 9208, 9544, 10852, 11534, 11628, 11894, 12646, 13390, 14705, 15195, 15838, 16365, 16799, 17410, 17786, 18428, 18956, 19539, 19749, 20139, 21031, 21769, 22433, 23224, 23791, 25563]","[0, 325, 636, 886, 1221, 1625, 1940, 2509, 2806, 3271, 3536, 3979, 4945, 5313, 5831, 6177, 7246, 8011, 8812, 9249, 9433, 9901, 10606, 11246, 11511, 11923, 12755, 13617, 14115, 14292, 14657, 15268, 15977, 16825, 17869, 18259, 18937, 19570, 19995, 20503, 21209, 21467, 22270, 22644, 24419]","[0, 174, 266, 360, 542, 638, 996, 1243, 1345, 1575, 1710, 2140, 2498, 2701, 2982, 3178, 3879, 4113, 4256, 4510, 4734, 4999, 5493, 5871, 6069, 6410, 6747, 7744, 8077, 8329, 8536, 8911, 9290, 9855, 10356, 10645, 11101, 11584, 12039, 12621, 13135, 13683, 14336, 14520, 15638]","[0, 170, 260, 350, 498, 607, 955, 1351, 1441, 1579, 1763, 2167, 2442, 2842, 3444, 3609, 4202, 4679, 4820, 5207, 5371, 6083, 6635, 6945, 7040, 7396, 7650, 8118, 8376, 8613, 9019, 9368, 9468, 9568, 9703, 9950, 10163, 10408, 11261, 11460, 11659, 11759, 11908, 12008, 13298]",24505,25563,24419,15638,13298,11030,-4690,-3632,-1810,-1095,-197,45,radiant
7527329500,46,102,21,26,14,"[599, 1041, 1555, 2028, 2547, 2926, 3661, 4162, 4874, 5229, 6112, 6854, 7128, 8038, 8809, 9484, 9974, 10480, 11308, 12092, 12961, 13759, 14710, 15365, 15709, 16455, 17081, 17763, 18181, 19535, 20487, 21300, 22387, 22487, 22587, 23452, 24338, 24748, 25256, 25487, 25587, 27368, 27929, 29425, 31093]","[484, 776, 1057, 1338, 1780, 2347, 2603, 3033, 3922, 4501, 4902, 5508, 5803, 6647, 7251, 7812, 8733, 9394, 9488, 10370, 11216, 11840, 12357, 12763, 13352, 13840, 14546, 14801, 15429, 17236, 18450, 19128, 19637, 19783, 19883, 20630, 21503, 21654, 22244, 22344, 23741, 24706, 24941, 26319, 27433]","[760, 1041, 1305, 1991, 2437, 2942, 3393, 3925, 4563, 4751, 5345, 6114, 6679, 7393, 8150, 8819, 9382, 10289, 11222, 11632, 11837, 11951, 12608, 13389, 13532, 14066, 14752, 15046, 15311, 16188, 16423, 17437, 18237, 18517, 19106, 20063, 20367, 20997, 21196, 21390, 21490, 22193, 22700, 23448, 24873]","[307, 397, 613, 783, 1094, 1229, 1337, 1496, 1631, 1921, 2510, 2860, 2955, 3310, 3730, 4371, 4619, 5472, 5566, 5868, 6073, 6167, 6854, 7118, 7213, 7766, 8024, 8120, 8347, 9228, 9562, 9662, 9852, 9952, 10212, 10607, 10897, 11201, 11400, 11500, 11600, 12640, 13004, 13512, 14432]","[1111, 1311, 1401, 1616, 1770, 1905, 2011, 2364, 2590, 2815, 3145, 3397, 3540, 3991, 4447, 4875, 5123, 5338, 5691, 5993, 6198, 6292, 6660, 7061, 7156, 7596, 7854, 7950, 8192, 8623, 8903, 9194, 9384, 9484, 9584, 9882, 10480, 11264, 11463, 11563, 11663, 12703, 13101, 13739, 14659]",31093,27433,24873,14432,14659,95,13,97,20,86,"[628, 873, 1263, 1626, 1966, 2232, 2653, 3124, 3736, 4041, 4638, 5252, 5721, 6193, 6860, 7557, 7987, 8787, 9202, 9895, 10602, 11992, 12555, 13277, 15119, 15929, 17267, 19163, 20023, 21519, 22346, 22978, 24121, 26289, 27209, 28892, 29309, 30378, 31167, 32413, 34258, 36699, 37336, 38099, 38889]","[588, 959, 1335, 1743, 1923, 2337, 2632, 2886, 3654, 4148, 4793, 5317, 5698, 5834, 6370, 6806, 6929, 7790, 7884, 8190, 8762, 9575, 10196, 10485, 11544, 12290, 12804, 14217, 14961, 15490, 16720, 17563, 18087, 19567, 20130, 20717, 21108, 22005, 22196, 22655, 24026, 24364, 24464, 24564, 24879]","[539, 740, 1148, 1332, 1741, 1927, 2098, 2390, 3074, 3250, 3621, 4122, 4391, 4650, 5409, 5548, 5643, 6184, 6278, 6693, 7259, 8055, 8150, 8747, 10093, 10947, 11213, 11494, 11846, 12527, 12837, 13388, 13488, 14986, 15577, 16383, 16729, 16829, 17145, 17528, 18989, 20494, 20994, 21140, 21539]","[470, 605, 735, 957, 1187, 1370, 1560, 1734, 2182, 2272, 2647, 2836, 2931, 3108, 3265, 3406, 3671, 4388, 4630, 4831, 4998, 5577, 5954, 6158, 7022, 7256, 7723, 9036, 9222, 9769, 10079, 10179, 10513, 11355, 11609, 11918, 12018, 12166, 12266, 12648, 13695, 13931, 14031, 14131, 14410]","[567, 657, 994, 1372, 1509, 1599, 1689, 1824, 2040, 2410, 2698, 2847, 2965, 3292, 3518, 3738, 3833, 5386, 5510, 5766, 6169, 6388, 6640, 7239, 8103, 8287, 8803, 9542, 9860, 10183, 10591, 10691, 10791, 11325, 11535, 11889, 11989, 12089, 12189, 12571, 13638, 13873, 14024, 14124, 15105]",38889,24879,21539,14410,15105,-7796,2554,3334,22,-446,-2332,45,radiant
7529378713,76,53,43,85,19,"[0, 546, 794, 1324, 1862, 2355, 3005, 3385, 4131, 4686, 5365, 6208, 6874, 7433, 7736, 7831, 8132, 8459, 9881, 10562, 11149, 11854, 12968, 13723, 14469, 15453, 16104, 17584, 18184, 19057, 20171, 20872, 22299, 23638, 25034, 26228, 26934, 28023, 29290, 29818, 30883, 32434, 33917, 35438, 36595]","[0, 267, 466, 848, 1223, 1431, 1823, 2347, 2506, 3282, 3834, 4477, 4695, 4976, 5562, 6117, 7026, 7423, 8517, 9071, 9629, 9985, 10345, 11479, 11672, 12326, 12863, 14386, 14982, 15566, 16241, 17271, 17371, 18170, 19074, 20343, 20906, 22375, 23639, 23840, 24923, 25282, 26304, 27383, 28393]","[0, 210, 426, 553, 844, 1007, 1505, 1789, 2391, 3005, 3444, 3920, 4234, 4638, 5162, 5582, 6000, 6133, 6976, 7731, 8173, 8716, 9116, 9886, 10330, 10613, 11304, 12039, 12419, 13040, 13662, 13762, 13885, 14254, 15197, 15664, 15966, 16536, 16985, 17085, 17484, 18259, 19057, 19538, 20533]","[0, 195, 285, 538, 814, 950, 1182, 1678, 1946, 2236, 2627, 2918, 3098, 3646, 3798, 4049, 4282, 5030, 5782, 6229, 6473, 6751, 6953, 7171, 7546, 7775, 8351, 8824, 9041, 9227, 9543, 9827, 10044, 10349, 10854, 11043, 11181, 11650, 12220, 12637, 12879, 13574, 13959, 14706, 15303]","[0, 195, 285, 375, 465, 555, 955, 1115, 1274, 1510, 1906, 2122, 2302, 2538, 2633, 2728, 2823, 2917, 3397, 3862, 3994, 4237, 4332, 4581, 4911, 5119, 5442, 5932, 6109, 6736, 7101, 7201, 7409, 8000, 8608, 8962, 9062, 9699, 9898, 9998, 10098, 10959, 11427, 11806, 12214]",36595,28393,20533,15303,12214,80,23,112,31,26,"[0, 322, 627, 915, 1005, 1305, 1441, 2108, 2915, 3063, 3275, 4015, 4331, 4822, 5493, 6638, 7586, 8712, 8807, 9296, 10218, 11333, 11666, 12356, 13173, 14179, 15056, 15605, 16575, 16974, 17616, 18577, 19808, 20694, 20794, 21786, 22478, 22997, 23225, 23325, 24300, 25809, 27065, 28167, 29036]","[0, 248, 520, 647, 857, 1082, 1299, 1529, 1829, 2288, 2459, 2624, 2920, 3537, 3898, 4670, 5300, 6047, 6688, 6873, 7325, 7898, 8554, 8893, 9526, 10123, 10613, 10708, 11044, 11345, 11765, 12512, 13135, 13647, 14134, 14282, 15066, 15960, 17019, 17544, 17896, 19158, 19958, 20058, 20917]","[0, 400, 572, 1018, 1399, 1730, 2214, 2596, 3181, 3446, 3721, 3940, 4629, 5413, 5834, 6405, 7082, 8051, 8146, 8668, 9039, 9766, 10414, 10937, 11330, 11992, 12516, 12765, 13013, 13228, 13453, 14873, 15764, 16329, 16872, 17239, 18169, 19297, 19724, 20065, 20165, 21162, 21478, 22150, 23290]","[0, 311, 401, 491, 619, 709, 1098, 1278, 1458, 1548, 1939, 2356, 2446, 2714, 2982, 3933, 4389, 5230, 5325, 5461, 5733, 6326, 6493, 7026, 7449, 7615, 8133, 8382, 8803, 9422, 10272, 11470, 12534, 12992, 13092, 13430, 13689, 14372, 14905, 15397, 15537, 16858, 17796, 18433, 18641]","[0, 210, 345, 435, 567, 657, 747, 927, 1107, 1197, 1552, 1957, 2189, 2386, 2806, 3441, 3689, 4815, 4910, 5096, 5274, 5522, 5689, 5991, 6272, 6613, 6852, 7080, 7447, 7662, 7895, 8741, 9429, 9899, 10168, 10550, 10650, 11072, 11549, 12132, 12269, 13423, 13739, 13911, 14862]",29036,20917,23290,18641,14862,7559,7476,-2757,-3338,-2648,6292,45,dire
7529493512,32,82,78,71,58,"[0, 285, 492, 973, 1330, 1459, 1798, 2127, 2445, 2831, 3367, 3794, 4420, 5010, 5105, 6390, 6574, 6731, 7403, 8558, 9257, 10558, 10725, 11097, 11383, 12305, 13208, 13796, 14621, 15298, 15708, 16373, 17569, 18189, 18498, 19031, 19474, 20001, 20802, 21077, 22137, 23079, 23700, 23800, 25937]","[0, 245, 485, 768, 1054, 1370, 1734, 2270, 2688, 3035, 3413, 3728, 4000, 4874, 5818, 6563, 7383, 7953, 8326, 8948, 9809, 10871, 11632, 12235, 12330, 13301, 13772, 14255, 14537, 15183, 16431, 17434, 18440, 18775, 19351, 19798, 20459, 20874, 21777, 22065, 23545, 24221, 24431, 24531, 24964]","[0, 279, 538, 890, 1275, 1495, 1829, 1953, 2264, 2848, 3623, 3838, 4149, 4533, 4873, 5680, 6021, 6293, 6819, 7345, 7766, 8622, 8878, 9108, 9377, 9739, 10249, 11190, 12168, 12731, 13698, 14211, 15093, 15328, 15428, 15984, 16775, 17422, 17762, 18843, 20159, 20566, 20918, 21288, 23025]","[0, 170, 260, 396, 486, 820, 943, 1071, 1290, 1641, 2048, 2263, 2398, 2666, 3094, 3881, 3976, 4752, 5169, 5792, 6105, 6312, 6606, 6836, 7542, 7889, 8416, 8754, 9254, 9688, 10610, 10820, 11395, 11630, 11730, 12097, 12617, 12997, 13755, 14047, 14751, 15341, 15441, 15541, 16846]","[0, 272, 362, 501, 658, 748, 877, 967, 1086, 1221, 1612, 1827, 2039, 2447, 2790, 3029, 3216, 3495, 4160, 4857, 5153, 5761, 5928, 6513, 6787, 7297, 7563, 7698, 7875, 8349, 8722, 9601, 10394, 10629, 10729, 11040, 11140, 11287, 11545, 11718, 12421, 12947, 13047, 13147, 14520]",25937,24964,23025,16846,14520,17,14,21,51,20,"[57, 379, 746, 1119, 1612, 1894, 2358, 2968, 3447, 3752, 4415, 5140, 5777, 6308, 6995, 7507, 8371, 8739, 9742, 9999, 10411, 11550, 12210, 13347, 14023, 14641, 15422, 15784, 16702, 17062, 17750, 18475, 18575, 19800, 20542, 21807, 23503, 23990, 24430, 25724, 26498, 26949, 28268, 30303, 31063]","[57, 266, 557, 754, 1290, 1590, 2038, 2651, 3115, 3360, 3808, 4118, 4742, 5256, 5712, 6092, 7054, 7574, 8006, 8935, 9822, 10761, 11137, 12309, 12872, 13763, 14442, 14819, 15995, 16639, 17754, 18364, 18651, 19958, 20894, 21821, 22602, 22879, 23385, 23725, 23825, 24033, 25718, 27375, 28624]","[57, 266, 1048, 1295, 1579, 1979, 2321, 2886, 3268, 3686, 4531, 5263, 5852, 6298, 6890, 7154, 7991, 8544, 8639, 8797, 9877, 10738, 11202, 12094, 12578, 13099, 13755, 14330, 15382, 15622, 16448, 16548, 16858, 18386, 18800, 19527, 19996, 20197, 20945, 21403, 21503, 21711, 23187, 24827, 26655]","[57, 227, 443, 581, 804, 1160, 1295, 1474, 1738, 2455, 2806, 3093, 3312, 3521, 3956, 4051, 4381, 4882, 5025, 5327, 5788, 5882, 6233, 6762, 7133, 7739, 7834, 8131, 8623, 8945, 9544, 10507, 10628, 11560, 11786, 12626, 13323, 13592, 13850, 14540, 14813, 15447, 16300, 17380, 18141]","[325, 495, 585, 692, 833, 1000, 1169, 1645, 1870, 2183, 2807, 2966, 3393, 3696, 3888, 3983, 4434, 4662, 4757, 5096, 5330, 5572, 5739, 6663, 6950, 7492, 7738, 8035, 8544, 8761, 9010, 9676, 9776, 10198, 10867, 11405, 11739, 11839, 12091, 12381, 12481, 12898, 14131, 15358, 15837]",31063,28624,26655,18141,15837,-5126,-3660,-3630,-1295,-1317,-15028,45,dire
7529670117,41,13,69,86,3,"[446, 648, 975, 1247, 1898, 2297, 2721, 2977, 3625, 4122, 4493, 5013, 5437, 6193, 6936, 7545, 8181, 8951, 9492, 10325, 11506, 12347, 13308, 14115, 15060, 16468, 16918, 17847, 19090, 20940, 21995, 22718, 24766, 25261, 26192, 26928, 27625, 27947, 29940, 31983, 32665, 32981, 34310, 36907, 38955]","[657, 1027, 1478, 1892, 2376, 3172, 3262, 3519, 3991, 4290, 5016, 5165, 5683, 6231, 6561, 6719, 6956, 7340, 7711, 8322, 9016, 9629, 9998, 11203, 11763, 12883, 13640, 14132, 15129, 16631, 17863, 18936, 19812, 20242, 20869, 22010, 22850, 23087, 24225, 25474, 26140, 26752, 27892, 29783, 31232]","[628, 957, 1367, 1659, 1914, 2288, 2634, 2803, 3238, 3563, 4267, 4932, 5442, 5794, 6422, 7258, 8032, 8398, 8689, 9443, 10043, 10581, 11095, 11687, 11993, 13613, 14401, 14849, 15226, 15871, 16927, 17511, 18449, 19068, 19444, 20150, 20760, 21091, 21912, 22822, 23399, 23903, 24632, 26095, 27452]","[334, 441, 575, 749, 919, 1227, 1317, 1444, 1579, 2213, 2303, 2452, 2945, 3544, 4256, 4389, 4939, 5216, 5504, 5757, 6302, 6723, 7325, 7702, 7871, 8754, 9097, 9297, 9574, 10166, 10466, 11060, 11250, 11384, 11546, 11794, 11894, 12103, 13099, 13765, 13865, 14689, 15480, 16857, 18097]","[260, 456, 563, 720, 941, 1256, 1346, 1680, 2052, 2222, 2312, 2507, 2843, 3073, 3459, 3554, 3648, 4326, 4421, 4786, 5024, 5119, 5336, 5638, 5988, 6709, 6880, 7051, 7953, 8817, 9166, 9827, 10346, 10503, 10603, 10849, 11110, 11210, 11666, 12355, 12455, 13039, 13608, 14818, 15693]",38955,31232,27452,18097,15693,114,90,129,20,26,"[524, 853, 1027, 1455, 1867, 2293, 2593, 3133, 3729, 4383, 4939, 5642, 6384, 7137, 7340, 7950, 8504, 9210, 9468, 10168, 11068, 12008, 12776, 13787, 14668, 15288, 16165, 17078, 18123, 18977, 19077, 19457, 19647, 19882, 21085, 22233, 24245, 25373, 25808, 25908, 26214, 26884, 27704, 27804, 28460]","[625, 951, 1408, 1864, 2484, 3020, 3661, 4379, 5020, 5538, 6048, 6866, 7235, 7542, 8161, 9228, 9426, 9851, 10419, 11060, 11930, 12336, 12784, 13427, 13878, 14245, 14956, 15645, 16295, 16642, 17044, 18139, 18329, 18603, 19234, 19775, 20442, 20952, 21547, 22076, 22828, 22997, 23540, 23833, 23939]","[472, 790, 952, 1371, 1658, 2118, 2288, 2923, 3170, 3695, 4232, 5050, 5515, 5914, 6425, 6778, 7240, 7646, 7943, 8765, 9463, 10204, 11218, 12154, 12612, 13561, 14141, 14948, 15634, 16134, 16234, 16931, 17448, 18091, 18648, 19056, 19895, 20323, 20540, 20640, 20740, 21454, 21810, 21910, 22319]","[375, 596, 760, 944, 1116, 1302, 1514, 1910, 2045, 2567, 2808, 3278, 3526, 3979, 4429, 4954, 5048, 5827, 5956, 6104, 6390, 6615, 6904, 7236, 7528, 7803, 8320, 8722, 9170, 9570, 9901, 10001, 10363, 10598, 10698, 10897, 11156, 11256, 11615, 11790, 12030, 12130, 12559, 12659, 12765]","[260, 350, 440, 929, 1066, 1156, 1246, 1548, 1792, 1929, 2263, 2881, 3177, 3302, 3705, 3952, 4046, 4600, 4695, 4790, 4956, 5051, 5146, 5403, 5634, 6001, 6259, 6539, 6878, 7068, 7168, 7268, 7458, 7693, 7793, 7992, 8202, 8302, 8402, 8502, 8868, 8968, 9068, 9168, 9274]",28460,23939,22319,12765,9274,10495,7293,5133,5332,6419,34672,45,radiant
7530159016,41,53,129,97,105,"[326, 530, 728, 1040, 1304, 1818, 2098, 2233, 2532, 3121, 3569, 4017, 4737, 5068, 5710, 6268, 6735, 7456, 7771, 7954, 8459, 9258, 9353, 9592, 10324, 10912, 11412, 11975, 12749, 13555, 14451, 15475, 16542, 17391, 18056, 18356, 19421, 20376, 20986, 21086, 21786, 22598, 23301, 25523, 25623]","[251, 341, 431, 818, 993, 1739, 1950, 2108, 2485, 3121, 3542, 4156, 4641, 4813, 5847, 6068, 7133, 7706, 8180, 8574, 8942, 9612, 9868, 10396, 11109, 11576, 12380, 13065, 13473, 13871, 14217, 15151, 16517, 17789, 18064, 18315, 20243, 20343, 20802, 21357, 21701, 22110, 22357, 23564, 23664]","[511, 762, 1079, 1361, 1562, 1757, 2228, 2515, 3302, 3823, 4251, 4689, 5627, 5829, 6063, 6715, 7421, 7622, 7945, 8173, 8937, 9660, 10132, 10418, 11295, 11954, 12357, 13176, 13513, 13865, 14719, 15570, 16104, 16775, 17597, 17906, 18737, 19279, 19765, 20132, 20707, 20807, 21068, 22116, 22216]","[242, 419, 675, 924, 1415, 2106, 2233, 2695, 3000, 3448, 3963, 4380, 5014, 5146, 5802, 6215, 6566, 7118, 7460, 7678, 8104, 8712, 8963, 9445, 9993, 10168, 10550, 11101, 11662, 12107, 13133, 14212, 14819, 15009, 15637, 16114, 17189, 17880, 18506, 18606, 19679, 20464, 20958, 21754, 22170]","[169, 259, 366, 500, 753, 1147, 1711, 1846, 2329, 2721, 2857, 2996, 3372, 3467, 4121, 4342, 4602, 4865, 5022, 5117, 5280, 5742, 5993, 6232, 6533, 7139, 7398, 7575, 7716, 7861, 8235, 8575, 9113, 9303, 9828, 9928, 11163, 11707, 12242, 12716, 13528, 14134, 14858, 15726, 15826]",25623,23664,22216,22170,15826,25,36,96,100,20,"[264, 652, 1165, 1427, 1811, 2361, 3418, 4010, 4312, 5098, 5439, 6270, 6896, 7946, 8876, 9732, 10515, 11509, 13336, 14319, 15122, 16204, 17785, 19043, 19945, 20949, 21815, 22958, 23776, 24581, 25238, 26096, 27260, 28501, 30431, 31400, 32628, 32728, 32927, 33665, 34218, 34517, 35095, 36164, 37997]","[571, 934, 1275, 1652, 2019, 2477, 2853, 3481, 3938, 4758, 5362, 5982, 6617, 7798, 8168, 9296, 9901, 10687, 11210, 11995, 12620, 13270, 14243, 14930, 15817, 16348, 17135, 18063, 18931, 19621, 20291, 21378, 21717, 22162, 22909, 23643, 24395, 24899, 25657, 26699, 27244, 28104, 29542, 31156, 32601]","[304, 554, 918, 1184, 1669, 1840, 2113, 2772, 3076, 3613, 3823, 4236, 4890, 5342, 5700, 6555, 6997, 7464, 8294, 8774, 9513, 10163, 10998, 11363, 11732, 12450, 13026, 13575, 14003, 14364, 14602, 15009, 15432, 15622, 16129, 16751, 18197, 18487, 19125, 19595, 20690, 20970, 21538, 22738, 23945]","[229, 423, 592, 1015, 1190, 1699, 2135, 2834, 3015, 3335, 3426, 3561, 3826, 4132, 4689, 5210, 5447, 5883, 6476, 7022, 7189, 7529, 8358, 8674, 9069, 9541, 9708, 9965, 10279, 10569, 10759, 10994, 11553, 11743, 12133, 12962, 13459, 13593, 13693, 13991, 14717, 14817, 15204, 16095, 16485]","[229, 319, 457, 593, 777, 867, 957, 1195, 1358, 1956, 2159, 2310, 2597, 2798, 3021, 3542, 3976, 4212, 4804, 5173, 5533, 5950, 6153, 6438, 6760, 7190, 7334, 7515, 7893, 8150, 8340, 8812, 9177, 9641, 10058, 10837, 11396, 11496, 11717, 12150, 12417, 12517, 12617, 14461, 15436]",37997,32601,23945,16485,15436,-12374,-8937,-1729,5685,390,-16965,45,dire
7530771503,38,61,129,90,65,"[1805, 2075, 2680, 3134, 3998, 4309, 5008, 5616, 6158, 6533, 7643, 8297, 8946, 9107, 9633, 10580, 11262, 12108, 13275, 14376, 15055, 15775, 16928, 17973, 19388, 19565, 20264, 21055, 21498, 22408, 23132, 23684, 24886, 25855, 26459, 27296, 27917, 28528, 28857, 29080, 29913, 30948, 31658, 32565, 33487]","[1022, 1417, 1666, 1974, 2314, 2953, 3704, 4132, 4887, 5565, 6345, 7147, 8428, 9041, 9862, 10721, 11375, 11738, 12386, 12981, 13593, 13996, 14555, 15178, 16543, 16850, 17623, 18294, 18586, 18964, 19505, 19989, 21007, 22138, 22921, 23632, 25301, 26050, 26351, 26451, 27309, 28756, 29644, 30201, 30854]","[1559, 2104, 2378, 2811, 3529, 3707, 4646, 5229, 5745, 6315, 6743, 7192, 7776, 8250, 8753, 9323, 9951, 10410, 11045, 11668, 12136, 12932, 13511, 14305, 15637, 16356, 17253, 17799, 18367, 19282, 20299, 20871, 22821, 23629, 24183, 24690, 25311, 26160, 26632, 26732, 27300, 28455, 29693, 30456, 31116]","[797, 905, 1211, 1436, 1743, 2013, 2302, 2392, 2700, 3189, 3524, 3830, 4455, 4614, 5208, 5989, 6214, 6581, 7184, 7583, 8023, 8686, 9300, 10326, 11321, 11878, 12770, 13219, 13394, 13632, 14023, 14185, 15358, 15839, 15984, 16366, 17197, 17480, 17655, 17763, 18072, 19244, 19708, 20234, 21088]","[541, 717, 1039, 1174, 1395, 1485, 1832, 2004, 2518, 2827, 3379, 3784, 4148, 4249, 4617, 5044, 5341, 5481, 6060, 6460, 6662, 7156, 7608, 7973, 8954, 9644, 10150, 10865, 11105, 11385, 11880, 11980, 12942, 13306, 13406, 13636, 14257, 14560, 14741, 14879, 15520, 16863, 17657, 17873, 17979]",33487,30854,31116,21088,17979,48,22,78,119,66,"[1530, 1820, 2395, 2835, 3292, 3819, 4269, 5002, 5607, 6032, 6641, 7314, 7967, 8761, 9541, 10699, 11257, 11954, 12970, 13690, 13937, 14231, 14977, 15280, 15763, 16974, 17804, 18822, 19346, 19623, 19745, 19970, 20070, 20931, 21223, 24299, 25063, 26401, 27098, 27606, 29194, 31125, 32188, 33596, 34475]","[1603, 1935, 2517, 3050, 3721, 4165, 4851, 5432, 5868, 6284, 6802, 7204, 8079, 9086, 9861, 10545, 11108, 11304, 12102, 12565, 13313, 14021, 14783, 15130, 15226, 16028, 16617, 16848, 17126, 17274, 17821, 18794, 19600, 20241, 20877, 22088, 23673, 24510, 25099, 25729, 26257, 26357, 26576, 27035, 27952]","[1153, 1385, 1676, 2099, 2254, 2671, 3327, 3748, 4367, 4676, 5164, 6007, 6408, 7232, 7895, 8200, 8660, 9231, 9526, 10343, 10971, 11286, 11933, 12075, 12174, 13258, 13657, 13757, 14346, 14924, 15753, 16608, 16976, 17632, 17874, 19108, 19605, 20370, 20470, 20838, 21734, 21991, 22268, 22720, 23063]","[502, 774, 904, 1040, 1181, 1278, 1529, 1999, 2285, 2490, 3155, 3379, 3556, 4073, 4231, 4417, 4586, 4777, 5054, 5358, 5537, 5914, 6129, 6298, 6469, 6961, 7286, 7445, 7675, 7775, 8041, 8408, 8717, 8941, 9150, 10145, 11115, 11545, 12043, 12251, 13259, 13787, 13969, 14338, 14521]","[753, 942, 1183, 1315, 1686, 2025, 2422, 2760, 2985, 3313, 3537, 4093, 4560, 4871, 5345, 5851, 6163, 6315, 6682, 7065, 7780, 8375, 8769, 8927, 9084, 9858, 10061, 10356, 10493, 10674, 10869, 11188, 11438, 11581, 11681, 12562, 12837, 12937, 13130, 13375, 13475, 13575, 13794, 14143, 14249]",34475,27952,23063,14521,14249,-988,2902,8053,6567,3730,20264,45,radiant
7531515518,4,102,19,105,45,"[275, 627, 871, 1416, 1726, 2252, 2757, 3151, 3637, 4146, 4789, 5554, 6367, 6932, 7626, 8437, 9220, 9861, 11149, 12183, 13178, 14319, 15274, 15987, 16740, 17850, 19188, 19909, 20731, 21695, 22089, 22376, 23334, 23786, 24504, 25831, 26283, 26418, 26518, 27298, 27398, 28033, 28760, 29326, 30243]","[355, 711, 836, 1198, 1518, 1794, 2215, 2772, 3293, 3778, 4546, 5121, 5669, 6198, 6950, 7356, 7895, 7990, 8377, 9132, 9663, 10194, 11199, 11610, 12147, 12909, 13188, 13565, 14725, 15445, 15545, 16332, 16784, 17304, 17456, 18059, 18159, 18396, 18664, 18830, 19617, 19898, 20456, 21009, 21633]","[345, 677, 1015, 1315, 1615, 1943, 2423, 2660, 3031, 3317, 3734, 4220, 4577, 5038, 5420, 6268, 6474, 6686, 7193, 7767, 8262, 8889, 9615, 10002, 10362, 10950, 11333, 11961, 12681, 13373, 13997, 14154, 15006, 15661, 16012, 16755, 16855, 17495, 17763, 18240, 18636, 19371, 20105, 20588, 21043]","[195, 285, 375, 531, 946, 1088, 1702, 1866, 2234, 2416, 3132, 3436, 3855, 4127, 4225, 4729, 4870, 4965, 5958, 6388, 6605, 7109, 7777, 8220, 8915, 9473, 9892, 10144, 10778, 11399, 11770, 12088, 12436, 12694, 12975, 13899, 14466, 14641, 15245, 15471, 15817, 16442, 16903, 17398, 17742]","[195, 285, 375, 510, 632, 767, 1301, 1391, 1644, 1994, 2505, 2799, 2995, 3347, 3724, 4070, 4389, 4531, 4688, 4820, 4915, 5248, 5706, 5801, 5896, 6321, 6474, 7024, 7723, 8228, 8488, 8754, 8989, 9268, 9826, 10681, 10781, 11270, 11538, 11638, 12034, 12357, 12680, 12869, 13958]",30243,21633,21043,17742,13958,73,21,13,65,100,"[430, 724, 966, 1302, 1786, 2280, 2504, 3042, 3447, 4021, 4781, 5780, 6551, 7524, 8325, 9210, 10800, 11579, 12507, 12728, 13735, 15604, 16653, 17583, 18361, 19354, 19893, 20741, 20977, 21461, 22784, 23383, 24571, 25678, 26922, 28323, 29194, 31289, 32314, 33355, 33903, 34412, 35711, 36220, 36984]","[170, 530, 943, 1361, 1723, 2202, 2579, 2875, 3038, 3885, 4290, 4798, 5514, 6077, 6483, 7247, 7535, 8327, 8822, 9274, 9595, 10363, 11229, 11976, 12629, 13377, 13925, 14553, 14649, 14745, 16110, 16468, 17166, 17910, 18330, 19097, 20063, 20808, 21453, 21852, 22177, 22959, 23363, 23487, 23975]","[289, 517, 829, 1112, 1482, 1743, 2270, 2525, 2912, 3262, 3769, 4025, 4405, 4729, 5212, 5388, 5999, 6975, 7460, 8096, 8800, 9522, 9827, 10334, 10975, 11604, 12193, 12704, 13017, 13113, 14032, 14249, 15235, 15734, 16164, 16488, 17544, 19254, 20057, 20396, 20872, 21925, 22025, 22450, 22814]","[170, 285, 490, 658, 1205, 1295, 1471, 1576, 1693, 1936, 2413, 2768, 2971, 3448, 3542, 4314, 4472, 4896, 5382, 5615, 6025, 6516, 6685, 7034, 7727, 8365, 8534, 8948, 9119, 9520, 10178, 10383, 11059, 11385, 11988, 12981, 13460, 14134, 14630, 14762, 15050, 15150, 15588, 15735, 16000]","[170, 285, 405, 621, 751, 841, 978, 1113, 1203, 1429, 1631, 2034, 2403, 2766, 3131, 3562, 3779, 4083, 4445, 4669, 5017, 5567, 5770, 6189, 6387, 6749, 7338, 7931, 8102, 8239, 9201, 9498, 9763, 10346, 11130, 11806, 12146, 13283, 13832, 14073, 14502, 14757, 15177, 15925, 16056]",36984,23975,22814,16000,16056,-6741,-2342,-1771,1742,-2098,-11210,45,radiant
7531926406,46,13,121,71,5,"[0, 325, 650, 1073, 1355, 1783, 2182, 2864, 3280, 3940, 4798, 5248, 5875, 6566, 7369, 8226, 8987, 10323, 11312, 12309, 13643, 16356, 17780, 18871, 20141, 20774, 21381, 21476, 22368, 22524, 22620, 22900, 23543, 24517, 24861, 25196, 26607, 27145, 27245, 27544, 29462, 29818, 29918, 30684, 31597]","[0, 328, 698, 1147, 1517, 1892, 2562, 3076, 3721, 4269, 4760, 5174, 5889, 6107, 6691, 7637, 7940, 8485, 9100, 9505, 10376, 11051, 12571, 12885, 13106, 14142, 16016, 16111, 16361, 16457, 16786, 18347, 19736, 21169, 21365, 21465, 22719, 22819, 23569, 24076, 24929, 26012, 27004, 27296, 27401]","[0, 169, 259, 779, 943, 1152, 1298, 1434, 1669, 2061, 2151, 2343, 2687, 2782, 3047, 3231, 3528, 3910, 4122, 4366, 4792, 5498, 6207, 6592, 7170, 8851, 9387, 9734, 9905, 10076, 10305, 10948, 11717, 12766, 12941, 13215, 14098, 16115, 17750, 18035, 18721, 19518, 20195, 20486, 20586]","[0, 278, 513, 940, 1127, 1693, 1978, 2197, 3018, 3561, 3889, 4153, 4794, 5052, 5238, 5422, 5517, 5963, 6344, 7080, 7826, 8577, 9338, 9602, 9837, 10927, 11774, 12323, 12553, 12649, 12745, 13364, 14414, 14984, 15084, 15184, 16422, 17298, 17712, 18089, 18643, 18999, 19318, 19418, 19576]","[0, 169, 293, 435, 525, 646, 741, 831, 941, 1072, 1206, 1385, 2091, 2226, 2442, 2795, 2897, 3201, 3296, 3611, 4095, 4331, 4965, 5651, 5807, 6606, 7252, 7347, 7672, 7768, 7864, 8432, 9060, 9593, 9693, 9903, 10579, 11009, 11639, 11739, 11949, 12049, 12149, 12407, 12565]",31597,27401,20586,19576,12565,4,106,55,86,83,"[0, 296, 649, 1098, 1746, 2066, 2563, 3566, 4046, 4364, 5257, 6243, 6805, 7447, 7988, 9062, 10141, 11361, 12292, 13006, 13580, 13675, 14033, 15357, 15654, 15953, 17626, 18904, 21335, 22629, 23294, 24835, 24935, 26139, 28254, 29275, 30283, 30473, 30837, 31522, 32039, 34901, 36622, 38434, 40600]","[0, 326, 776, 1119, 1581, 1990, 2479, 3311, 3827, 4297, 4937, 5338, 5855, 6412, 7195, 8297, 9420, 9758, 10427, 10969, 11282, 11740, 11883, 12321, 13177, 13455, 13716, 14815, 16368, 17222, 17643, 18260, 18624, 19617, 20481, 21057, 22410, 24346, 24446, 24546, 25290, 26576, 26786, 28339, 31817]","[0, 245, 476, 681, 1160, 1487, 1733, 2118, 2422, 2512, 2852, 3114, 3489, 3798, 4603, 5155, 5634, 6506, 6901, 7335, 7522, 7732, 8384, 8515, 10189, 10284, 11622, 12013, 13801, 15036, 15326, 16750, 16860, 17603, 19546, 20208, 22154, 23383, 23483, 24349, 25494, 26455, 27864, 29005, 30636]","[0, 169, 307, 444, 625, 822, 912, 1344, 1434, 1681, 1975, 2323, 2577, 2901, 3070, 3425, 3832, 4336, 4431, 4612, 4996, 5091, 5242, 5917, 6475, 6570, 6664, 7055, 7899, 8195, 8416, 9117, 9217, 9437, 9912, 10185, 11055, 11360, 11460, 11560, 11912, 12945, 13155, 13625, 14920]","[0, 169, 259, 349, 577, 667, 757, 1309, 1518, 1608, 1925, 2198, 2288, 2484, 2602, 2696, 2980, 3318, 3413, 3507, 3636, 3889, 3984, 4285, 4931, 5026, 5721, 5816, 6074, 6370, 6591, 7387, 7487, 7871, 7971, 8419, 8870, 9060, 9160, 9260, 9495, 9916, 10422, 11093, 12203]",40600,31817,30636,14920,12203,-9003,-4416,-10050,4656,362,-18451,45,dire
7532211815,11,17,60,19,102,"[0, 256, 622, 840, 1190, 1461, 1771, 1990, 2355, 2760, 3023, 3543, 3980, 4581, 5283, 6137, 6691, 7230, 8161, 9335, 10037, 10655, 11337, 12262, 13024, 13857, 14441, 14642, 15097, 16028, 16124, 17045, 17871, 18563, 19746, 20682, 20782, 21577, 22135, 22898, 23919, 24794, 26037, 27321, 28909]","[0, 290, 666, 956, 1349, 1773, 2077, 2431, 2934, 3670, 4176, 4653, 4856, 5464, 6090, 7073, 7496, 8021, 9142, 9756, 10273, 11668, 12399, 13322, 13888, 14527, 15509, 15638, 16481, 17719, 18286, 19761, 20178, 21184, 21535, 22352, 23353, 24246, 24996, 25688, 26457, 26949, 28002, 28727, 30199]","[0, 244, 384, 680, 933, 1100, 1344, 1672, 1874, 2211, 2375, 3245, 3736, 4081, 4383, 4844, 5302, 5576, 6078, 6577, 7311, 8434, 8876, 9200, 9638, 10379, 11042, 11265, 11442, 12033, 12169, 13430, 14361, 15001, 15616, 16064, 16164, 16859, 17091, 17481, 18033, 18133, 18343, 18767, 19411]","[0, 170, 298, 418, 548, 678, 768, 1093, 1183, 1468, 1558, 1981, 2071, 2265, 2364, 2745, 2962, 3448, 3684, 3842, 4155, 5386, 5967, 6062, 6157, 6526, 6816, 7045, 7222, 7857, 7953, 8476, 9646, 10212, 10687, 11090, 11727, 12227, 12720, 13145, 13594, 13694, 13904, 14900, 15310]","[0, 170, 260, 380, 549, 679, 791, 881, 991, 1276, 1366, 1720, 1962, 2156, 2416, 2877, 3002, 3264, 3766, 3924, 4109, 4910, 5149, 5276, 5446, 5744, 6353, 6523, 6984, 7473, 7644, 8242, 8978, 9263, 9827, 10492, 10659, 11001, 11351, 11703, 12245, 12345, 12555, 13280, 14034]",28909,30199,19411,15310,14034,76,21,23,79,58,"[60, 303, 521, 882, 1222, 1483, 1857, 2273, 2841, 3214, 4268, 4556, 5180, 5782, 6447, 7122, 7823, 8710, 9863, 10627, 11882, 12467, 13166, 14149, 14631, 14929, 15718, 16028, 16996, 18180, 18276, 19233, 19333, 20092, 20192, 20292, 21190, 22029, 22548, 22867, 24047, 24858, 25822, 26030, 26177]","[328, 569, 850, 1190, 1595, 2049, 2401, 2866, 3394, 3529, 4255, 5186, 5990, 6730, 7218, 7391, 7721, 8300, 8723, 9525, 9933, 10027, 11088, 11588, 11966, 12413, 13448, 14600, 15976, 16783, 17340, 17819, 17919, 19023, 19257, 19357, 20110, 21094, 21581, 22334, 23362, 24685, 26138, 26585, 28210]","[60, 267, 553, 1019, 1318, 1591, 2017, 2369, 2782, 3228, 3756, 4336, 4910, 5847, 6472, 7160, 7622, 8573, 9111, 9774, 10795, 11049, 11660, 11954, 12502, 12900, 13515, 14322, 15086, 15788, 15968, 16243, 16343, 16499, 16599, 18262, 19193, 19676, 20212, 20312, 20902, 21068, 21728, 21982, 22082]","[60, 230, 320, 457, 577, 1104, 1414, 1549, 1729, 1999, 2089, 2377, 2718, 2921, 3316, 3924, 4082, 4288, 4445, 4738, 5018, 5112, 5311, 5406, 5501, 5686, 6204, 6577, 7031, 7387, 7591, 8015, 8115, 8215, 8315, 10366, 10664, 10984, 11130, 11455, 11853, 11953, 12260, 12468, 12842]","[60, 230, 320, 455, 575, 665, 873, 1008, 1143, 1278, 1532, 1858, 2077, 2427, 2770, 2956, 3397, 3556, 4047, 4340, 4691, 4785, 4946, 5333, 5544, 5729, 6122, 6816, 7499, 8084, 8180, 8481, 8581, 8681, 9016, 10436, 10734, 11134, 11234, 11334, 11533, 12042, 12309, 12529, 12629]",26177,28210,22082,12842,12629,2732,1989,-2671,2468,1405,5923,45,radiant
7532553807,10,126,98,86,72,"[0, 205, 523, 731, 1136, 1295, 1706, 1948, 2316, 2665, 3202, 3776, 4430, 4822, 5398, 5770, 6327, 6786, 7655, 8023, 8597, 8997, 9516, 9922, 10413, 11272, 11942, 12643, 13398, 13847, 15016, 16197, 16880, 18193, 18806, 19638, 20264, 22032, 23282, 23953, 24845, 25460, 27169, 28062, 28497]","[0, 280, 497, 823, 1237, 1652, 1941, 2578, 3289, 3663, 4235, 4909, 5544, 6153, 6803, 7628, 7945, 8773, 9275, 9755, 10336, 10554, 11176, 11876, 11971, 12698, 13345, 13976, 14823, 15469, 16222, 17506, 18073, 19079, 19952, 20689, 21526, 22379, 23159, 23358, 23458, 24304, 25186, 25482, 26009]","[0, 167, 569, 1093, 1414, 1592, 1995, 2338, 2863, 3273, 3663, 4016, 4645, 4949, 5854, 6218, 6899, 7530, 7934, 8322, 9196, 9740, 10711, 11678, 11889, 12315, 12928, 13878, 14326, 15123, 15604, 16691, 16971, 17887, 18871, 19442, 19969, 20683, 21742, 22259, 22962, 23300, 24265, 24738, 25979]","[0, 130, 270, 439, 613, 703, 793, 921, 1011, 1231, 1502, 1787, 2044, 2609, 3075, 3345, 3968, 4425, 4519, 4702, 5448, 5977, 6228, 6669, 7112, 7759, 8324, 8600, 9131, 9227, 9506, 10015, 10156, 10763, 11234, 11534, 11724, 12338, 13204, 13447, 13728, 14156, 14679, 14779, 15718]","[0, 130, 220, 330, 509, 636, 726, 912, 1180, 1315, 1786, 1930, 2512, 2812, 3722, 3951, 4465, 5369, 5568, 5751, 6184, 6583, 6799, 7310, 7405, 8159, 8402, 8497, 8925, 9235, 9740, 10350, 10527, 11460, 11695, 11995, 12268, 12847, 13483, 13726, 13924, 14024, 14747, 15040, 15629]",28497,26009,25979,15718,15629,4,13,112,19,26,"[0, 244, 485, 728, 1173, 1591, 2021, 2396, 2676, 3069, 3464, 3997, 4483, 5040, 5399, 5904, 6528, 7123, 7713, 8938, 9402, 9751, 10007, 10819, 12323, 13029, 13569, 14731, 15491, 16688, 17097, 17849, 18889, 19176, 19366, 20127, 20605, 21357, 22252, 23295, 24512, 25318, 25801, 26011, 26894]","[0, 289, 644, 1032, 1274, 1693, 2095, 2384, 2671, 3047, 3485, 3753, 4159, 4834, 4928, 5405, 5605, 6107, 6324, 7449, 8153, 9065, 9845, 10135, 11047, 11142, 11640, 12388, 13271, 13957, 14405, 14505, 14666, 15033, 15869, 16863, 18005, 18309, 19310, 19930, 20914, 21212, 21918, 23084, 23862]","[0, 210, 498, 770, 1061, 1416, 1791, 2155, 2646, 2974, 3354, 3444, 3627, 4075, 4611, 5031, 5513, 5732, 6412, 7310, 7884, 8118, 8826, 8993, 9907, 10757, 11109, 11768, 12292, 13194, 13644, 14252, 14511, 14803, 14993, 15427, 15812, 16127, 16858, 17601, 18848, 19415, 19836, 20046, 20362]","[0, 210, 300, 390, 607, 932, 1067, 1202, 1571, 1915, 2333, 2506, 2632, 3335, 3466, 4350, 4514, 4824, 5566, 6270, 6365, 6734, 7133, 8112, 8663, 9231, 9572, 10225, 10492, 11207, 11303, 11862, 12353, 12640, 12830, 13008, 13857, 14147, 14330, 14430, 14931, 15258, 15757, 15967, 16412]","[100, 310, 442, 583, 708, 1105, 1244, 1430, 1619, 1781, 2144, 2488, 2578, 2781, 3172, 3671, 4255, 4626, 4995, 5449, 5544, 5893, 6093, 6598, 7054, 7558, 7652, 8001, 8268, 8451, 8547, 8647, 8803, 8950, 9248, 9380, 9480, 9914, 10332, 10678, 11223, 11323, 12008, 12218, 12970]",26894,23862,20362,16412,12970,1603,2147,5617,-694,2659,11332,45,radiant
7532722008,63,114,96,110,26,"[674, 1124, 1604, 1943, 2350, 2871, 3477, 3727, 4649, 4977, 5157, 5443, 6303, 6956, 7624, 8319, 8649, 9589, 10330, 11206, 11638, 12317, 12918, 13676, 14892, 15487, 16445, 17319, 18441, 20758, 21984, 23576, 24429, 25171, 26081, 27524, 28714, 29541, 30459, 31585, 31985, 32662, 33275, 34182, 34905]","[730, 1032, 1445, 1778, 2623, 3144, 3620, 3887, 4239, 4803, 5251, 5551, 5979, 6701, 6967, 7508, 7931, 8498, 9090, 9562, 9759, 10429, 11214, 11767, 12429, 12779, 13619, 14398, 14858, 15694, 16404, 17114, 17453, 18125, 19257, 19943, 20416, 21409, 22082, 22727, 24085, 24773, 25621, 26230, 26383]","[709, 942, 1261, 1544, 2013, 2525, 2952, 3388, 3931, 4440, 5060, 5498, 5764, 6353, 6800, 7057, 7683, 8569, 8752, 9220, 9408, 9985, 10748, 11429, 11523, 12042, 12574, 13614, 13903, 15444, 15987, 16424, 16763, 17449, 18169, 19006, 19284, 19453, 19712, 20247, 20998, 21098, 21198, 21626, 22120]","[324, 482, 833, 972, 1107, 1356, 1526, 1661, 1987, 2077, 2556, 2835, 2990, 3481, 3710, 3805, 4063, 4315, 4626, 4870, 4964, 5230, 5610, 5973, 6067, 6207, 6653, 7013, 7199, 8032, 8462, 9127, 9612, 10294, 10976, 11420, 11987, 12193, 12415, 12686, 13245, 13345, 13778, 14035, 14300]","[530, 681, 815, 905, 1181, 1552, 1709, 1967, 2195, 2523, 2703, 2843, 2937, 3542, 3818, 3913, 4171, 4493, 4588, 4683, 4777, 4959, 5296, 5463, 5601, 5696, 6319, 6496, 6682, 7332, 7779, 8035, 8665, 9109, 9308, 9811, 10052, 10152, 10252, 10477, 10793, 10893, 11039, 11139, 11290]",34905,26383,22120,14300,11290,106,54,69,86,58,"[915, 1085, 1329, 1732, 2029, 2516, 2860, 3364, 3781, 4362, 4680, 5544, 6200, 6506, 7385, 8395, 9182, 9599, 9894, 10524, 10913, 11485, 12257, 13067, 13774, 14413, 15125, 15807, 16067, 16639, 16829, 17277, 17805, 18100, 18896, 19833, 20312, 20750, 21265, 22470, 24067, 25023, 25539, 25919, 26837]","[559, 996, 1402, 1806, 2214, 2567, 3379, 3844, 4461, 5174, 5625, 6736, 7320, 7884, 8290, 8984, 9784, 10486, 11164, 11830, 12127, 13278, 13508, 14161, 15099, 15785, 16256, 16884, 17575, 17918, 18406, 18795, 18942, 19514, 19614, 20151, 21248, 21450, 21708, 21996, 23139, 23989, 24522, 24902, 25613]","[508, 598, 926, 1122, 1488, 2083, 2487, 2975, 3301, 3834, 4304, 4827, 5764, 6211, 6821, 7672, 8337, 9390, 9814, 10144, 10551, 11178, 11462, 12073, 12899, 13326, 13744, 13932, 14307, 14696, 14956, 15216, 15364, 15659, 16015, 16716, 16976, 17242, 17547, 17786, 19850, 20271, 20642, 20902, 21422]","[336, 537, 742, 916, 1128, 1313, 1529, 1759, 1992, 2178, 2745, 3136, 3452, 3636, 4084, 4422, 4895, 5191, 5361, 5583, 6041, 6588, 6930, 7536, 7961, 8131, 8464, 8731, 9340, 9882, 10119, 10395, 10495, 10891, 10991, 11289, 11640, 12226, 12709, 13126, 14274, 14846, 15241, 15870, 16093]","[350, 458, 629, 768, 858, 1061, 1280, 1509, 1724, 1947, 2392, 3047, 3318, 3696, 4018, 4356, 4673, 5050, 5524, 5748, 6761, 7177, 7568, 8004, 8546, 8737, 8995, 9342, 9716, 10093, 10638, 10814, 10962, 11293, 11431, 12119, 12322, 12500, 12600, 12700, 13563, 13771, 14025, 14407, 14759]",26837,25613,21422,16093,14759,8068,770,698,-1793,-3469,4274,45,radiant
7532985414,10,25,137,100,26,"[285, 575, 883, 1134, 1340, 1694, 2194, 2612, 3220, 3551, 4067, 4505, 4845, 5061, 5412, 5900, 6081, 6370, 6977, 7624, 8684, 8974, 9442, 9678, 9959, 11352, 12279, 13139, 14197, 14959, 15715, 16779, 17828, 19377, 20191, 20427, 21742, 22915, 23918, 24117, 24788, 25478, 27084, 28689, 29381]","[152, 565, 861, 1321, 1960, 2646, 3166, 3974, 4239, 4417, 5512, 5868, 5958, 6481, 7161, 7512, 7937, 8287, 8750, 9327, 11050, 11508, 11953, 12313, 12902, 13567, 14343, 14868, 15467, 15742, 16303, 16493, 17297, 17925, 18605, 19299, 20071, 21006, 22219, 22648, 23332, 23432, 25385, 26647, 26882]","[285, 563, 800, 967, 1446, 1844, 2246, 2618, 3045, 3423, 3608, 4377, 4774, 5213, 5654, 6262, 6655, 6859, 7869, 8418, 9346, 9765, 10150, 10632, 11261, 12181, 12937, 13031, 13321, 14168, 14761, 14951, 15433, 16036, 16291, 16645, 17148, 17457, 18203, 19207, 19630, 19730, 20870, 21982, 22217]","[106, 316, 450, 540, 753, 892, 1022, 1173, 1358, 1448, 1858, 2037, 2447, 2590, 2685, 2869, 3120, 3381, 3743, 4040, 4408, 4821, 4916, 5387, 5704, 6182, 6406, 6569, 6746, 7021, 7117, 7307, 7407, 7832, 8560, 8706, 8961, 9270, 9554, 9753, 10477, 10577, 12179, 12935, 13218]","[420, 630, 816, 906, 1054, 1192, 1564, 1715, 2062, 2152, 2562, 2875, 2965, 3060, 3332, 3427, 4012, 4107, 4400, 4919, 6457, 6731, 6901, 7142, 7498, 8052, 8393, 8562, 8807, 9107, 9371, 9622, 9926, 10359, 10875, 11121, 11320, 11664, 12253, 12452, 12808, 12983, 13303, 13779, 14014]",29381,26882,22217,13218,14014,96,54,19,65,5,"[0, 282, 590, 876, 1540, 1982, 2337, 2743, 3082, 3996, 4588, 5129, 6140, 6868, 7537, 7967, 9409, 9613, 9944, 10554, 10766, 11831, 12425, 12950, 13626, 13970, 14756, 15436, 15969, 17228, 17852, 18571, 19205, 19844, 20586, 21210, 21992, 22716, 23710, 24689, 25856, 27056, 28154, 29021, 29570]","[0, 314, 517, 772, 1072, 1400, 1689, 2049, 2504, 3153, 3744, 4107, 4671, 5305, 6113, 6873, 8124, 8675, 9211, 9962, 10771, 10866, 11402, 12039, 12803, 12970, 13065, 13835, 14469, 15932, 16567, 17162, 18061, 18653, 19598, 20354, 20842, 21798, 22959, 23552, 24202, 25480, 26394, 26494, 26594]","[0, 155, 403, 844, 1094, 1305, 1605, 1909, 2488, 2960, 3371, 3774, 4356, 5629, 5959, 6354, 7015, 7475, 7942, 8906, 9246, 9759, 10137, 11440, 12062, 12533, 13049, 13583, 13820, 14092, 14298, 14691, 15284, 15856, 16870, 17189, 17526, 18076, 18862, 18962, 19814, 20643, 21722, 22205, 22421]","[0, 155, 245, 384, 831, 1088, 1178, 1303, 1924, 2753, 3334, 3789, 4174, 4712, 5259, 5444, 6369, 7269, 7567, 8284, 8769, 8992, 9280, 9693, 10217, 10880, 11824, 12247, 12746, 13711, 13917, 14318, 14737, 15495, 16436, 16993, 17392, 18342, 18614, 18967, 20202, 20672, 21297, 21840, 21940]","[0, 155, 288, 484, 661, 786, 1262, 1352, 1654, 2357, 2651, 2741, 3107, 3876, 4327, 4512, 5363, 5585, 5776, 6028, 6231, 6515, 6682, 7036, 7241, 7457, 7673, 7974, 8217, 8767, 9204, 9475, 9827, 10609, 10891, 11092, 11671, 11819, 12293, 12830, 14222, 14814, 15545, 15645, 15843]",29570,26594,22421,21940,15843,-189,288,-204,-8722,-1829,-10656,45,radiant
7533042916,10,74,47,96,20,"[0, 249, 494, 1105, 1502, 2176, 2846, 3442, 4117, 4820, 5316, 6080, 6900, 7384, 8199, 8915, 9619, 10344, 10941, 12002, 12710, 13328, 14728, 15549, 17048, 18645, 19810, 21106, 21938, 22286, 23284, 23912, 24641, 26239, 27354, 28170, 29003, 30823, 32014, 33111, 34500, 36925, 37133, 38148, 38248]","[0, 258, 635, 885, 1307, 1397, 1888, 2177, 2517, 2933, 3334, 3772, 4233, 4482, 4721, 5195, 5689, 5875, 6417, 7002, 7265, 7558, 8520, 9010, 9504, 10357, 10803, 11629, 12654, 12830, 13267, 14188, 14629, 15395, 15889, 16471, 16998, 17617, 18264, 19115, 20132, 20877, 21553, 21772, 22042]","[0, 286, 451, 857, 1225, 2021, 2520, 2966, 3378, 3681, 4029, 4512, 5127, 5465, 6058, 6499, 7128, 7741, 8132, 8591, 9009, 9450, 10000, 10412, 11083, 11589, 11864, 12441, 13400, 13496, 13850, 14247, 14768, 15204, 15666, 16054, 16473, 17643, 17803, 18197, 18989, 19789, 20016, 20950, 21122]","[0, 205, 340, 478, 568, 842, 1011, 1101, 1238, 1534, 1738, 2185, 2486, 2581, 2865, 3365, 3690, 4271, 4366, 4622, 4717, 4862, 5338, 5542, 5898, 6487, 6692, 7272, 7760, 7856, 7998, 8229, 8579, 8802, 9154, 9328, 9669, 10294, 10394, 10687, 11142, 12327, 12858, 12958, 13058]","[0, 169, 259, 424, 558, 831, 1008, 1194, 1435, 1802, 2427, 2672, 3075, 3334, 3620, 3854, 4174, 4385, 4527, 4793, 5092, 5237, 5875, 6173, 6704, 7071, 7510, 7909, 8086, 8394, 8534, 8771, 9006, 9282, 9704, 9850, 10020, 10815, 10965, 11226, 11537, 11799, 12007, 12107, 12207]",38248,22042,21122,13058,12207,46,22,69,72,121,"[0, 169, 333, 594, 918, 1008, 1607, 2013, 2405, 2866, 3265, 3682, 4438, 5572, 6459, 8057, 8941, 9797, 10558, 11340, 12093, 13028, 14273, 14761, 15467, 16474, 17295, 18244, 19332, 20735, 21470, 22247, 23208, 24340, 25275, 25755, 26779, 27126, 27662, 27901, 28643, 28943, 29151, 31180, 32647]","[0, 291, 593, 874, 1166, 1646, 2126, 2975, 3225, 3518, 4271, 4620, 5142, 6144, 6239, 7131, 7656, 8064, 8365, 9167, 9446, 9968, 10707, 11096, 11369, 11690, 11908, 12823, 13453, 14221, 14600, 15156, 16377, 16606, 17634, 18545, 19180, 19487, 20235, 20758, 21023, 22131, 23665, 24929, 26020]","[0, 206, 480, 793, 963, 1480, 1599, 1779, 2292, 2543, 2721, 3065, 4048, 4723, 5150, 5735, 6400, 7258, 7831, 8226, 9052, 9794, 10553, 10670, 11108, 11576, 11955, 12280, 12940, 13677, 13943, 14433, 15421, 16102, 16587, 16847, 17261, 17734, 18349, 18875, 19135, 21018, 22221, 23370, 25137]","[0, 169, 346, 436, 606, 969, 1500, 1789, 1951, 2041, 2247, 2542, 3011, 3519, 3813, 4270, 4439, 5043, 5278, 5752, 6200, 6513, 6942, 7169, 7495, 7665, 8084, 8654, 8906, 9168, 9699, 9976, 10742, 10842, 11122, 11222, 11369, 11808, 11908, 12008, 12108, 12823, 13225, 14381, 14591]","[0, 215, 348, 654, 869, 1089, 1179, 1359, 1521, 1764, 2081, 2256, 2396, 3186, 3375, 3896, 4107, 4483, 4578, 4860, 5018, 5218, 5524, 5618, 5827, 5922, 6062, 6350, 6571, 6933, 7044, 7234, 7534, 7751, 8100, 8200, 8693, 9033, 9278, 9378, 9786, 10672, 10914, 11499, 12391]",32647,26020,25137,14591,12391,5601,-3978,-4015,-1533,-184,-4109,45,radiant
7533231811,10,96,11,136,26,"[1, 130, 554, 846, 1368, 1813, 2150, 2843, 3319, 3885, 4333, 4817, 5526, 6130, 6643, 7306, 7923, 8407, 9102, 9923, 10708, 11596, 12380, 12902, 13117, 13452, 14138, 14538, 15041, 15939, 16527, 17724, 18460, 19016, 20931, 21837, 22547, 23742, 24440, 25257, 26176, 27283, 28226, 29600, 30704]","[1, 180, 604, 918, 1589, 2068, 2421, 3239, 3932, 4357, 5013, 5518, 6393, 6716, 7104, 7645, 8568, 9079, 9770, 10033, 10636, 11111, 11854, 12512, 13164, 13846, 14344, 15439, 16259, 16889, 17626, 18895, 19489, 20563, 21950, 22498, 23288, 24380, 24942, 25776, 26889, 27395, 27743, 29639, 30880]","[1, 247, 582, 784, 1065, 1773, 1988, 2236, 2819, 3573, 3993, 4606, 5134, 5332, 5856, 6417, 6747, 7107, 7690, 8673, 9278, 9911, 10826, 11310, 11494, 13046, 14122, 14253, 14876, 15717, 16537, 17246, 18387, 19440, 20158, 20789, 21743, 22866, 23710, 24551, 24957, 25865, 26272, 26872, 27352]","[1, 130, 560, 686, 1077, 1494, 1684, 1855, 2032, 2122, 2395, 2531, 2711, 2806, 2954, 3049, 3383, 3976, 4333, 4858, 5092, 5371, 5707, 5802, 6416, 7222, 7362, 7717, 7911, 8097, 8881, 8981, 9297, 9397, 9677, 10100, 10539, 11282, 11930, 12030, 12325, 12645, 13193, 14206, 14843]","[1, 130, 265, 373, 669, 848, 1188, 1415, 1734, 1908, 2078, 2218, 2997, 3313, 3498, 3878, 3972, 4148, 4346, 4702, 4945, 5172, 5542, 5804, 5942, 6511, 6727, 7027, 7123, 7309, 8131, 8649, 8886, 9093, 9650, 10170, 10370, 10872, 11296, 11565, 11907, 12379, 12992, 13653, 14006]",30704,30880,27352,14843,14006,106,41,19,90,86,"[1, 377, 575, 1180, 1566, 1948, 2545, 2789, 3174, 3388, 3779, 4129, 4521, 5201, 5706, 6536, 7219, 7845, 8470, 9156, 9695, 10468, 11218, 12059, 12461, 13393, 14051, 14749, 15789, 16600, 17213, 17840, 18535, 18976, 19458, 20411, 21277, 22536, 23416, 24242, 25037, 25742, 26981, 28020, 29060]","[1, 210, 458, 783, 1123, 1676, 1838, 2413, 2614, 2986, 3316, 3883, 4088, 4614, 5333, 6052, 6690, 7510, 8462, 9157, 9969, 10792, 12097, 12764, 13430, 14727, 15413, 16308, 18045, 18662, 19230, 20092, 20553, 21304, 22076, 23004, 23790, 24556, 25731, 26488, 27250, 28072, 28670, 29831, 30354]","[1, 244, 485, 655, 988, 1214, 1782, 1989, 2238, 2373, 2542, 2753, 3084, 3558, 3972, 4268, 4825, 5229, 5862, 6352, 6955, 7516, 8109, 9085, 9689, 10515, 11241, 11881, 12791, 13325, 13880, 15035, 15783, 16762, 17217, 18438, 19249, 19949, 20400, 21241, 22491, 23807, 24081, 25186, 26168]","[1, 210, 300, 390, 480, 760, 1014, 1149, 1367, 1715, 1901, 2744, 3422, 3867, 4177, 4734, 5505, 5868, 6359, 6807, 7198, 7509, 8043, 9034, 9595, 10800, 11065, 11839, 13105, 13902, 14104, 14730, 15674, 16046, 16774, 16874, 17473, 17672, 17772, 18127, 18999, 19559, 20619, 21518, 22772]","[1, 249, 383, 518, 682, 1074, 1732, 1954, 2044, 2170, 2552, 2642, 2886, 3071, 3464, 3950, 4216, 4469, 4937, 5305, 5718, 5917, 6501, 6994, 7599, 8270, 8925, 9370, 9827, 10055, 10513, 10793, 11003, 11103, 11203, 11303, 11403, 11741, 11841, 12131, 12445, 13105, 13615, 14310, 14410]",29060,30354,26168,22772,14410,1644,526,1184,-7929,-404,-4979,45,radiant
7533433505,48,43,23,96,119,"[78, 372, 730, 1007, 1486, 1787, 2080, 2547, 2936, 3640, 4003, 4508, 5114, 5708, 5920, 6799, 7679, 8706, 9690, 10944, 11705, 12754, 13763, 14828, 16052, 17077, 18442, 19070, 20181, 21414, 23105, 25194, 25294, 25830, 27212, 27312, 27901, 29362, 29462, 30503, 32713, 34704, 35237, 35749, 37778]","[78, 372, 759, 1105, 1345, 1637, 1990, 2252, 2680, 3175, 3737, 4114, 4623, 5176, 5524, 6196, 6881, 7039, 7275, 8495, 9018, 9432, 10255, 10769, 11310, 11753, 12732, 13274, 13975, 14399, 15188, 16264, 16989, 17434, 19254, 19956, 20362, 21376, 21476, 22090, 23491, 24795, 25558, 25766, 26951]","[211, 450, 681, 1051, 1355, 1565, 2156, 2583, 3268, 3699, 4302, 5277, 5535, 6025, 6445, 7049, 7887, 8274, 8910, 9751, 10505, 10942, 11321, 11649, 12121, 12772, 13578, 13777, 14766, 15217, 15969, 16671, 17409, 18031, 19014, 19350, 19450, 20089, 20189, 20904, 22063, 23071, 23279, 24147, 25332]","[78, 248, 363, 453, 543, 673, 809, 994, 1238, 1645, 2247, 2617, 2707, 3162, 3390, 3699, 4021, 4666, 4868, 5214, 5662, 6340, 6751, 7224, 7838, 8272, 8748, 9180, 9467, 9945, 10846, 11517, 11745, 12223, 13381, 13768, 14012, 14241, 14560, 15203, 16618, 17858, 18066, 18977, 20271]","[78, 348, 463, 598, 704, 834, 942, 1129, 1606, 1900, 2156, 2423, 2513, 3046, 3735, 4014, 4284, 5106, 5226, 5823, 6174, 6473, 6714, 6884, 7054, 7614, 8102, 8950, 9882, 10181, 10646, 11349, 11449, 11660, 12541, 12641, 12741, 13248, 13348, 13755, 14080, 14954, 15245, 15528, 17223]",37778,26951,25332,20271,17223,25,21,129,26,136,"[308, 515, 760, 1030, 1281, 1657, 2126, 2413, 2967, 3428, 3730, 4242, 5189, 5820, 6953, 7444, 8160, 9035, 9667, 10565, 11162, 11645, 12254, 13046, 14084, 14773, 16067, 16766, 17709, 18465, 18755, 21520, 22546, 23820, 25292, 25392, 25816, 28217, 29608, 30524, 30923, 31023, 31882, 33207, 35877]","[308, 566, 763, 1331, 1624, 1943, 2394, 2941, 3150, 3675, 4226, 4536, 5104, 5696, 6469, 7069, 7414, 7932, 8842, 9572, 10193, 10505, 11116, 11706, 12583, 12873, 13437, 13872, 14103, 14315, 14789, 16490, 16996, 17614, 18391, 18661, 19917, 21227, 22115, 22501, 22838, 22977, 23520, 24353, 26124]","[116, 397, 557, 967, 1247, 1584, 2217, 2723, 3479, 3871, 4494, 5050, 5459, 5554, 5923, 6250, 6981, 8299, 9007, 9584, 10103, 10592, 11314, 11674, 12389, 13488, 14103, 14419, 14515, 15234, 15774, 15874, 16282, 16798, 17319, 17419, 17974, 19268, 20439, 21224, 21422, 21522, 22374, 23076, 24660]","[443, 613, 754, 1131, 1221, 1396, 1608, 1760, 1959, 2505, 2761, 2906, 3121, 3263, 3877, 4329, 4580, 5152, 5416, 5692, 5910, 6346, 6619, 6804, 7659, 8436, 8531, 8626, 8899, 9271, 9398, 9498, 9756, 10333, 10675, 10837, 11267, 12225, 13114, 13376, 13476, 13680, 14252, 14641, 15740]","[175, 345, 435, 525, 615, 705, 906, 1058, 1192, 1365, 1500, 1590, 1956, 2145, 2491, 2640, 2877, 3461, 3834, 4199, 4329, 4424, 4653, 4860, 5258, 5352, 5521, 5797, 6076, 6266, 6362, 7389, 7624, 7880, 8532, 8632, 9372, 10978, 11657, 12134, 12234, 12334, 12613, 12956, 14032]",35877,26124,24660,15740,14032,1901,827,672,4531,3191,11122,45,radiant
7533525210,8,23,90,112,66,"[0, 250, 456, 616, 846, 1043, 1422, 1913, 2319, 2790, 3192, 3785, 4151, 4672, 4928, 5700, 6066, 6563, 6952, 7707, 8086, 8364, 9008, 9630, 10283, 10915, 11778, 12251, 12817, 13283, 14968, 15395, 16004, 17013, 18256, 19100, 19738, 20105, 21835, 22004, 22240, 23143, 23243, 23477, 24593]","[0, 203, 403, 748, 1076, 1450, 1613, 1877, 2334, 2781, 3193, 3283, 3572, 4295, 4720, 5403, 5625, 6020, 6527, 6899, 7340, 7772, 8309, 8844, 9481, 10232, 10842, 11376, 11859, 12239, 13123, 13526, 13924, 14631, 15210, 15487, 15967, 16099, 17085, 17439, 18009, 18922, 19552, 20275, 20831]","[0, 216, 388, 698, 989, 1360, 1709, 1889, 2317, 2491, 2982, 3162, 3506, 4110, 4525, 5189, 5482, 5667, 6103, 6558, 6959, 7301, 7887, 8442, 8784, 9102, 9254, 9798, 10257, 10585, 11052, 11535, 11942, 12252, 12829, 13353, 13947, 14422, 15213, 15863, 16099, 17130, 17534, 17852, 18844]","[0, 129, 219, 357, 477, 615, 705, 885, 975, 1065, 1229, 1407, 1727, 1970, 2358, 2795, 2889, 3197, 3504, 3781, 4041, 4531, 4996, 5351, 5724, 6266, 6609, 6810, 7067, 7163, 8085, 8710, 8983, 9083, 9692, 9936, 10219, 10432, 11611, 12196, 12536, 13374, 13474, 14445, 15980]","[0, 129, 219, 414, 573, 714, 924, 1285, 1446, 1612, 1833, 2098, 2654, 2850, 3123, 3314, 3568, 3876, 4093, 4552, 4828, 5248, 5808, 6429, 6804, 7560, 7730, 8210, 8588, 8782, 9249, 9644, 10003, 10201, 10583, 10707, 11384, 11515, 12172, 12387, 12881, 13293, 13474, 13960, 14593]",24593,20831,18844,15980,14593,21,59,60,111,20,"[0, 296, 665, 1047, 1525, 1868, 2246, 2811, 3249, 3960, 4867, 5128, 6172, 6639, 6931, 7286, 8322, 9449, 10308, 11255, 11877, 12709, 13227, 13918, 14143, 14725, 15206, 16353, 17002, 17702, 18355, 19286, 19779, 20199, 20892, 21713, 22345, 23185, 23951, 25446, 26038, 27199, 28437, 29778, 30301]","[0, 299, 651, 999, 1179, 1468, 2062, 2600, 2999, 3524, 4229, 4689, 4857, 5060, 5750, 6632, 7125, 7689, 8230, 9344, 10011, 10994, 11718, 12189, 12580, 13104, 13743, 14949, 15586, 16197, 16374, 16960, 17975, 18645, 19184, 20200, 21191, 21693, 22169, 22269, 23047, 23466, 23676, 24436, 24871]","[0, 245, 484, 823, 1035, 1335, 1678, 2174, 2614, 3250, 3882, 4308, 4960, 5299, 5734, 5977, 6406, 7278, 7655, 8338, 8853, 9326, 9761, 10101, 10302, 10898, 11263, 12165, 12676, 13389, 14022, 14609, 15243, 15688, 16268, 17404, 18034, 18538, 18907, 20653, 20966, 22039, 22568, 23668, 23941]","[0, 209, 632, 805, 895, 1029, 1190, 1486, 1625, 1853, 2115, 2205, 2610, 2961, 3393, 3726, 3883, 4464, 4804, 5115, 5676, 5930, 6146, 6375, 6516, 6788, 7123, 7936, 8142, 8393, 8787, 9148, 9594, 9829, 10390, 10972, 11337, 11631, 11830, 12124, 13069, 13314, 13524, 13749, 13984]","[0, 209, 351, 489, 579, 719, 809, 1158, 1248, 1576, 1832, 2035, 2474, 2768, 3073, 3233, 3583, 3852, 3995, 4340, 4514, 4766, 5025, 5254, 5349, 5596, 5865, 6604, 6810, 6946, 7158, 7465, 7779, 8014, 8204, 8778, 9143, 9422, 9621, 9721, 10041, 10754, 10964, 11631, 11866]",30301,24871,23941,13984,11866,-5708,-4040,-5097,1996,2727,-10122,45,dire
7534334312,70,39,97,51,5,"[0, 286, 536, 744, 1400, 2153, 2402, 3083, 3458, 3968, 4430, 5065, 5540, 6090, 7470, 8384, 9232, 10280, 11297, 12185, 12375, 13375, 13961, 14056, 14632, 15253, 15348, 16058, 16624, 17289, 17928, 18499, 20033, 21159, 22125, 22512, 23063, 23555, 24209, 25632, 26502, 27178, 28440, 29419, 30149]","[0, 361, 648, 991, 1448, 1725, 2213, 2935, 3270, 3509, 4025, 4343, 4663, 5236, 6154, 6508, 7173, 7764, 8341, 9053, 9604, 10313, 11094, 11579, 12259, 12634, 13184, 14143, 15042, 15927, 16832, 17589, 19758, 20293, 21197, 21331, 22016, 22879, 23935, 24978, 25737, 25837, 26446, 27009, 28787]","[0, 291, 574, 807, 1152, 1392, 1482, 1823, 2193, 2732, 2950, 3410, 3979, 4385, 4948, 5428, 6234, 6846, 7247, 7991, 8763, 9544, 10276, 10371, 10667, 11226, 11647, 11929, 12271, 13168, 13619, 14016, 14981, 15568, 16320, 16420, 17312, 18295, 18849, 19955, 20457, 20889, 20989, 21755, 22570]","[0, 210, 300, 602, 772, 862, 952, 1303, 1443, 1697, 2021, 2111, 2255, 2404, 3061, 3619, 3867, 4179, 4575, 4733, 4940, 5244, 5411, 5506, 6112, 6206, 6453, 6910, 7225, 7472, 7749, 8150, 9676, 10057, 10607, 10944, 11424, 11684, 11991, 12696, 12895, 13123, 13342, 14013, 14437]","[0, 210, 300, 390, 701, 887, 1016, 1230, 1370, 1731, 1867, 2077, 2221, 2411, 2796, 3065, 3313, 3543, 3742, 3900, 4090, 4847, 5014, 5234, 5373, 5467, 5562, 5912, 6298, 6509, 6822, 7333, 8164, 8752, 9077, 9416, 9651, 9850, 10157, 10862, 11061, 11509, 11653, 12023, 12642]",30149,28787,22570,14437,12642,10,137,92,110,65,"[0, 174, 504, 817, 1273, 1554, 2084, 2578, 3034, 3650, 4286, 4695, 5347, 5904, 6706, 7945, 8622, 9495, 10175, 10951, 11729, 12150, 13225, 14609, 15432, 15987, 16498, 17879, 18779, 20337, 21593, 21984, 22441, 22541, 23548, 24272, 24921, 25338, 25849, 25949, 27079, 28412, 28730, 30023, 31046]","[0, 293, 589, 883, 1047, 1386, 1756, 2558, 2848, 3215, 3420, 3830, 4535, 5206, 5653, 6130, 6875, 7048, 7445, 8030, 8496, 8892, 9289, 10085, 10993, 11087, 11972, 12157, 13028, 13752, 14595, 15042, 15246, 15850, 16474, 16574, 16845, 17148, 17978, 18858, 19807, 20370, 20714, 20862, 21070]","[0, 504, 832, 1153, 1534, 1770, 1980, 2260, 2667, 2757, 3103, 3547, 4213, 4732, 5095, 5544, 6208, 6559, 6840, 7529, 7713, 7958, 8287, 9204, 9717, 9893, 10428, 11100, 11664, 12340, 13104, 13758, 13956, 14056, 14443, 14628, 14980, 15799, 16018, 16728, 16965, 17607, 17967, 18332, 19574]","[0, 230, 366, 456, 635, 760, 850, 1420, 1544, 1722, 1879, 2049, 2298, 2494, 2729, 3316, 3930, 4257, 4418, 5098, 5720, 6048, 6479, 7223, 7926, 8095, 8517, 9303, 9802, 10439, 11014, 11114, 11221, 11396, 11848, 12023, 12198, 12472, 12784, 13248, 13406, 13809, 13909, 14108, 14316]","[0, 200, 290, 380, 704, 829, 1091, 1410, 1579, 1835, 2313, 2648, 2847, 3545, 3992, 4312, 4733, 5038, 5249, 5821, 6207, 6301, 6468, 7059, 7735, 7829, 8356, 8792, 8969, 9599, 10485, 10585, 10685, 10785, 10885, 10985, 11085, 11284, 11431, 11671, 12245, 12453, 12553, 12653, 12861]",31046,21070,19574,14316,12861,-897,7717,2996,121,-219,9718,45,radiant
7535209904,25,22,23,112,83,"[0, 387, 722, 1300, 1584, 2167, 2968, 3270, 3641, 3930, 4208, 4724, 5657, 6228, 6634, 7089, 7825, 8160, 8836, 8931, 9796, 10555, 10920, 11951, 12531, 12709, 13577, 13672, 14539, 15021, 15688, 17642, 18613, 20316, 21533, 22018, 22118, 22218, 22591, 23940, 24383, 24631, 25162, 25947, 28526]","[0, 281, 608, 952, 1194, 1524, 2025, 2354, 2495, 2806, 3236, 3652, 4065, 5215, 5680, 5800, 6611, 7098, 7576, 7671, 8171, 8711, 8932, 9124, 9410, 9804, 10891, 11417, 11680, 11968, 12471, 14263, 14659, 15512, 15612, 16486, 17592, 17989, 18971, 19759, 20535, 20829, 21189, 22107, 23582]","[0, 265, 546, 845, 1148, 1521, 1821, 2195, 2614, 3094, 3692, 4241, 5114, 5618, 6035, 6958, 7472, 7833, 8511, 9358, 9632, 10243, 10675, 10905, 11322, 11417, 12047, 12142, 12500, 12772, 13021, 14362, 14924, 15851, 16401, 17283, 17728, 17828, 18018, 18209, 18309, 18687, 19231, 19880, 21179]","[0, 265, 355, 445, 535, 714, 889, 979, 1231, 1577, 1759, 2223, 2812, 3503, 3866, 4132, 4428, 4621, 4865, 5160, 5383, 5512, 5606, 5826, 6215, 6310, 6873, 7263, 7526, 7622, 7991, 8864, 9481, 10344, 11002, 11734, 13062, 13717, 14254, 14482, 14582, 14736, 15054, 15629, 16750]","[0, 499, 603, 805, 895, 1069, 1591, 1730, 1925, 2056, 2146, 2282, 2372, 3018, 3149, 3787, 3945, 4148, 4318, 4488, 4962, 5132, 5499, 5873, 6115, 6358, 7033, 7410, 7958, 8139, 8254, 9264, 9364, 10217, 10704, 11887, 12623, 12758, 12948, 13703, 13850, 13950, 14050, 14572, 15297]",28526,23582,21179,16750,15297,46,14,98,121,3,"[0, 324, 702, 1063, 1513, 1793, 2471, 3000, 3547, 4307, 5279, 6076, 6729, 6986, 7437, 8589, 9412, 10389, 11035, 12387, 13577, 14251, 14647, 15278, 16110, 17201, 18044, 19240, 19710, 20406, 21330, 22194, 22294, 23395, 24250, 24718, 24818, 25215, 26214, 26949, 27049, 27642, 28088, 28841, 29848]","[0, 204, 481, 716, 1116, 1253, 1569, 2118, 2504, 3150, 3688, 4139, 4806, 5336, 5917, 6841, 7571, 8083, 8386, 9285, 10126, 10674, 11165, 11583, 12174, 13263, 13788, 14122, 14428, 14961, 15911, 16353, 16939, 17848, 18464, 19053, 19922, 20679, 21503, 21983, 22323, 23055, 23641, 24074, 24390]","[0, 279, 656, 922, 1414, 1713, 2077, 2250, 2537, 2816, 3107, 3742, 4067, 4680, 5398, 5926, 6755, 8015, 8562, 9094, 9832, 10748, 11781, 12452, 12985, 14358, 14853, 15432, 16000, 16573, 17558, 18252, 18352, 19294, 19641, 20495, 21319, 21716, 22296, 22592, 22692, 23519, 23844, 24088, 24464]","[0, 169, 259, 349, 439, 529, 723, 958, 1097, 1395, 2100, 2394, 2624, 2791, 3016, 3201, 3713, 4099, 4358, 4933, 5368, 5860, 6089, 6274, 6764, 7717, 8085, 8924, 9173, 9562, 10196, 10797, 10897, 11350, 11540, 12163, 13297, 13835, 14577, 14738, 14838, 15205, 15521, 15889, 16269]","[0, 169, 259, 349, 751, 868, 1318, 1536, 1626, 1828, 2044, 2185, 2473, 2640, 3118, 3864, 4508, 5162, 5336, 5954, 6475, 6853, 7082, 7729, 8410, 9404, 9653, 9902, 10273, 10498, 11018, 11716, 12140, 13075, 13335, 14030, 14432, 14829, 15610, 16668, 16960, 17367, 17619, 18208, 18524]",29848,24390,24464,16269,18524,-1322,-808,-3285,481,-3227,-8161,45,dire
7535614616,6,49,29,100,31,"[0, 663, 1026, 1573, 1844, 2405, 2615, 2967, 3392, 3544, 4025, 4420, 4896, 5348, 5733, 6266, 6671, 7196, 8480, 9435, 10415, 11422, 12660, 13324, 14249, 14958, 15647, 16295, 16945, 17492, 18065, 19021, 19923, 20746, 20894, 21414, 22070, 22357, 22457, 23251, 23812, 25438, 27289, 27739, 28488]","[0, 315, 789, 1123, 1558, 1933, 2417, 2870, 3410, 4167, 4685, 5092, 5439, 5825, 6288, 6503, 6661, 7524, 8214, 8793, 9672, 10324, 10518, 11119, 11489, 12019, 12737, 13132, 13309, 13528, 13793, 14537, 14952, 15692, 16511, 16611, 17602, 18136, 19457, 19931, 20031, 21088, 22655, 22969, 23174]","[0, 235, 452, 742, 914, 1285, 1733, 1913, 2682, 3051, 3452, 3889, 4601, 5189, 5513, 6162, 6499, 6899, 7555, 8333, 8770, 9305, 9800, 10610, 11040, 11649, 11837, 12074, 12446, 12726, 13535, 14232, 15195, 15884, 16287, 16387, 16879, 16979, 17079, 17637, 17737, 18449, 19850, 20256, 20791]","[0, 235, 390, 579, 699, 950, 1074, 1254, 1567, 2095, 2376, 2529, 3083, 3658, 4088, 4224, 4382, 4612, 5210, 5488, 6183, 6570, 6766, 7100, 7267, 7785, 7956, 8291, 8514, 8733, 8836, 9134, 9693, 10175, 10275, 10375, 10858, 10958, 11182, 11728, 11860, 12684, 13749, 14119, 14296]","[0, 235, 325, 431, 551, 641, 814, 994, 1275, 1500, 1963, 2053, 2316, 2702, 3011, 3109, 3290, 3566, 3833, 4339, 4733, 5183, 5377, 5704, 5995, 6161, 6271, 6511, 6688, 7144, 7255, 7750, 8032, 8257, 8357, 8457, 8734, 8834, 8934, 9034, 9134, 9988, 11084, 11292, 11443]",28488,23174,20791,14296,11443,113,63,22,2,102,"[0, 326, 526, 817, 1382, 1582, 2099, 2472, 2800, 3427, 4198, 4558, 5439, 5805, 6697, 6975, 7533, 8495, 8916, 9600, 10092, 10934, 11705, 12749, 13672, 14537, 15343, 16260, 16724, 18162, 19264, 19868, 20552, 21322, 22812, 24265, 25166, 26371, 27179, 28113, 29127, 29833, 31214, 32540, 33391]","[0, 170, 382, 607, 842, 1754, 2063, 2153, 2288, 2690, 3100, 3290, 3435, 3584, 3872, 4215, 4760, 5286, 5555, 6416, 6565, 7143, 7237, 7476, 8101, 8474, 9544, 9783, 10359, 11533, 12389, 12987, 13619, 13976, 15089, 15789, 16341, 17636, 18473, 19197, 20312, 20537, 20637, 20951, 21642]","[0, 284, 576, 913, 1252, 1705, 2024, 2598, 3082, 3566, 3964, 4268, 4549, 4734, 5113, 5470, 6014, 6675, 6922, 8050, 8145, 8573, 8769, 9300, 9797, 10500, 11398, 11911, 12254, 14106, 14892, 15304, 15893, 16658, 17162, 17567, 17836, 19098, 20019, 20995, 22130, 22824, 22924, 23431, 24295]","[0, 207, 297, 461, 733, 1065, 1569, 1897, 2426, 2754, 3172, 3495, 3822, 4058, 4380, 4729, 5245, 5890, 6324, 6833, 7004, 7337, 7527, 7902, 8262, 8625, 9218, 9516, 9817, 10393, 11282, 11753, 12136, 12413, 12954, 13322, 13533, 15334, 15891, 16203, 17313, 17627, 17727, 17827, 18225]","[0, 170, 260, 350, 567, 657, 841, 1064, 1199, 1470, 1832, 1922, 2058, 2395, 2590, 2685, 2819, 2977, 3071, 3273, 3368, 3623, 3717, 3881, 4123, 4364, 4644, 4892, 5312, 6096, 6564, 6924, 7324, 7651, 8215, 8454, 8554, 9236, 9829, 9929, 10616, 10962, 11111, 11524, 11874]",33391,21642,24295,18225,11874,-4903,1532,-3504,-3929,-431,-11235,45,dire
7535724706,70,86,97,138,110,"[249, 522, 882, 1171, 1572, 1808, 2212, 2302, 2648, 3090, 3408, 3791, 4439, 5386, 6057, 7036, 7470, 8119, 8901, 10191, 11169, 11967, 12563, 13520, 14609, 15700, 16942, 17907, 18686, 19760, 20736, 21906, 22471, 22844, 25019, 25598, 26396, 27762, 29125, 30462, 31669, 31896, 33069, 34153, 35575]","[328, 573, 896, 1295, 1753, 2162, 2500, 2926, 3220, 3710, 4358, 4538, 4803, 5328, 5866, 6544, 6995, 7399, 7575, 7831, 8394, 9145, 9384, 9912, 10587, 11343, 11946, 12510, 12701, 13124, 13850, 14207, 15017, 15746, 16470, 16898, 17264, 18348, 19496, 20146, 20713, 21015, 21372, 22324, 23655]","[169, 440, 696, 1195, 1670, 2162, 2762, 3369, 3929, 4480, 5108, 5698, 6562, 7040, 7777, 8174, 8386, 8711, 8869, 9590, 10081, 10530, 11066, 11701, 12074, 12595, 12785, 13149, 13664, 14087, 14899, 15154, 15364, 15673, 16583, 17344, 17842, 18438, 18935, 19700, 20215, 20494, 20862, 21693, 23001]","[169, 302, 392, 575, 768, 1111, 1436, 1657, 1747, 1972, 2126, 2306, 2510, 2687, 3008, 3525, 4134, 4507, 4745, 4839, 5112, 5680, 5987, 6082, 6819, 7317, 7611, 8455, 8761, 9497, 10070, 10561, 10862, 10962, 11900, 13064, 13234, 13919, 14273, 15152, 15915, 16293, 16702, 17685, 19341]","[169, 259, 431, 521, 747, 1034, 1460, 1550, 1680, 1952, 2270, 2678, 3034, 3153, 3533, 3979, 4727, 5082, 5631, 6105, 6468, 7331, 7699, 8069, 8605, 8843, 9258, 9524, 9943, 10428, 11301, 11735, 11987, 12126, 13240, 13523, 14049, 14896, 15810, 16230, 16715, 16904, 17410, 18189, 19326]",35575,23655,23001,19341,19326,113,56,98,105,100,"[296, 586, 955, 1321, 1720, 2019, 2280, 2605, 3019, 3222, 4025, 4827, 5258, 5632, 5917, 6400, 7531, 7979, 8756, 9180, 9712, 9968, 10309, 11115, 12156, 13314, 14352, 15395, 16013, 16335, 16530, 18036, 18456, 19367, 20701, 21306, 21811, 22939, 23424, 24382, 24705, 24885, 25478, 26388, 26601]","[169, 373, 623, 914, 1337, 1523, 1973, 2377, 2664, 3032, 3577, 4500, 4997, 5588, 5953, 6277, 7039, 7502, 8208, 8802, 9415, 10039, 10357, 10888, 11325, 12062, 12765, 13415, 14024, 14201, 14615, 15259, 15438, 16308, 16569, 17135, 17992, 18336, 18436, 18600, 19497, 20404, 21264, 21857, 22066]","[207, 495, 779, 1049, 1249, 1661, 1857, 2487, 2629, 2998, 3707, 4359, 5070, 5294, 6082, 6602, 7211, 7890, 8373, 8781, 9476, 9904, 10204, 10866, 11273, 11817, 12881, 13799, 14251, 14455, 14943, 15528, 15628, 16583, 16773, 17647, 18188, 18686, 18941, 19307, 19407, 19622, 20092, 21014, 21388]","[169, 259, 431, 591, 681, 771, 906, 1317, 1568, 1834, 2077, 2626, 2874, 3047, 3180, 3382, 4037, 4411, 4833, 5173, 5365, 5559, 6055, 6614, 6933, 7346, 7798, 8925, 9279, 9491, 9711, 9811, 9941, 10415, 11412, 11512, 11838, 12205, 12827, 12927, 13445, 13697, 14088, 14961, 15740]","[169, 259, 394, 591, 681, 832, 967, 1158, 1417, 1507, 1697, 2173, 2345, 2440, 2535, 2741, 3357, 3452, 3710, 3804, 4098, 4193, 4394, 4624, 4829, 5407, 5783, 6261, 6513, 6609, 7102, 7299, 7399, 7820, 8045, 8145, 8355, 8592, 9064, 9259, 9520, 9788, 10105, 10581, 10725]",26601,22066,21388,15740,10725,8974,1589,1613,3601,8601,24378,45,radiant
7535996813,21,80,137,105,26,"[298, 574, 831, 1314, 1694, 2216, 2520, 3312, 3763, 4427, 5185, 5451, 5931, 6479, 7079, 7720, 8979, 10272, 10908, 11609, 12394, 13749, 14541, 15262, 16091, 17250, 17900, 18700, 19142, 20145, 20950, 21684, 22426, 23370, 23470, 23758, 24391, 25241, 25716, 25957, 26596, 27526, 28285, 28889, 29194]","[334, 582, 856, 1259, 1662, 1786, 2318, 2889, 3387, 4157, 4918, 5520, 6142, 6589, 7159, 7458, 7899, 8145, 8303, 8658, 9327, 10202, 10974, 11380, 12461, 13167, 13418, 13986, 14586, 15655, 16241, 16810, 17552, 18508, 18608, 19130, 19891, 20855, 21225, 21603, 21940, 22506, 23415, 23897, 24261]","[371, 660, 997, 1337, 1862, 2025, 2151, 2616, 3028, 3545, 4252, 4815, 5322, 5727, 6090, 6481, 6709, 7446, 8327, 9157, 9411, 9862, 10067, 10471, 11514, 11906, 12607, 13406, 13682, 14235, 14983, 15255, 15864, 16812, 16912, 17524, 18244, 18542, 18892, 18992, 19255, 20079, 20652, 21218, 21318]","[210, 300, 390, 520, 694, 784, 874, 1224, 1362, 1923, 2454, 2563, 3056, 3405, 3744, 3955, 4434, 5633, 5897, 6358, 6527, 6859, 7139, 7511, 7987, 8769, 9559, 10279, 10548, 10941, 11333, 11660, 11886, 12506, 12642, 12742, 13227, 13525, 13625, 14065, 14203, 15440, 16369, 16956, 17181]","[210, 382, 472, 648, 738, 1160, 1524, 1707, 1846, 2150, 2593, 2813, 3301, 3487, 3665, 3963, 4724, 5308, 5606, 5931, 6025, 6549, 6875, 7045, 7715, 8226, 8493, 8959, 9297, 9765, 10030, 10191, 10381, 10980, 11080, 11225, 11581, 11879, 11979, 12079, 12346, 13152, 13474, 13574, 13674]",29194,24261,21318,17181,13674,41,19,38,53,20,"[511, 760, 1403, 1711, 2167, 2746, 3005, 3445, 3699, 3965, 4368, 4732, 5206, 5539, 5997, 6708, 7082, 7670, 8326, 8885, 9511, 10141, 11118, 11659, 12174, 12786, 13828, 14073, 14627, 15294, 16027, 16887, 17375, 18084, 20911, 22781, 23556, 23976, 24691, 25925, 26656, 27474, 28490, 29580, 29738]","[204, 506, 932, 1310, 1653, 2101, 2458, 2871, 3172, 3564, 3906, 4473, 5070, 5410, 6168, 6634, 6987, 7724, 8118, 8540, 8972, 9496, 10423, 10940, 11275, 11801, 12319, 12593, 12830, 13184, 13797, 14574, 15180, 15407, 16951, 18644, 18744, 19024, 19728, 20624, 21802, 22226, 23418, 24238, 24980]","[204, 480, 693, 941, 1071, 1161, 1587, 1847, 2096, 2977, 3617, 3996, 4443, 5347, 6094, 6644, 7700, 8105, 8466, 9063, 9636, 10130, 11322, 11923, 12649, 13136, 14164, 14260, 14573, 15142, 15643, 15743, 15924, 16154, 17333, 18222, 18874, 19196, 19850, 20299, 20522, 20820, 21066, 21274, 21510]","[204, 332, 503, 638, 1041, 1292, 1500, 1873, 2002, 2226, 2417, 2723, 3032, 3455, 3932, 4364, 4549, 5197, 5726, 6171, 6565, 7321, 8156, 8799, 9272, 9528, 10304, 10479, 11114, 12018, 12343, 12870, 13409, 14161, 15231, 16196, 16859, 17386, 18066, 18615, 19427, 19846, 20492, 20905, 21517]","[204, 346, 605, 780, 1148, 1384, 1592, 1806, 1896, 2075, 2436, 2628, 2826, 3090, 3762, 4247, 5762, 6374, 6532, 6717, 6825, 7071, 7462, 8042, 8842, 9178, 9273, 9422, 9805, 10259, 10623, 10783, 10979, 11079, 11345, 12039, 12556, 12825, 13060, 13479, 13687, 13965, 14428, 14816, 14988]",29738,24980,21510,21517,14988,-544,-719,-192,-4336,-1314,-7105,45,dire
7536605901,10,71,120,110,121,"[0, 130, 369, 816, 1226, 1585, 1920, 2362, 2746, 3295, 3715, 4334, 4700, 5292, 5769, 6338, 7231, 7943, 8833, 9900, 10292, 10901, 11887, 12634, 13064, 13924, 14669, 14763, 15301, 15916, 16519, 17584, 18345, 18938, 19422, 21087, 21970, 22648, 23742, 24300, 25012, 26458, 27553, 28634, 29226]","[0, 164, 516, 796, 1101, 1544, 1806, 2331, 3058, 3476, 3883, 4708, 5478, 6054, 6864, 7402, 8372, 8675, 9073, 9772, 10315, 10482, 11456, 12123, 12302, 12795, 13622, 13784, 14359, 14740, 15570, 16118, 16842, 16942, 17431, 18438, 19304, 20553, 21159, 22079, 22213, 22676, 24319, 25978, 26861]","[0, 296, 494, 940, 1336, 1741, 2011, 2500, 2986, 3558, 4051, 4424, 5233, 5896, 6322, 6633, 7359, 7642, 8206, 9098, 9193, 9660, 10267, 10779, 11568, 11898, 12153, 12671, 13371, 13721, 13817, 14181, 14712, 15274, 15552, 16364, 16994, 17474, 17619, 17818, 17918, 19120, 19729, 20185, 20944]","[0, 168, 258, 415, 641, 798, 888, 1205, 1339, 1474, 1702, 1868, 2396, 2725, 2846, 3074, 4286, 4748, 5015, 5323, 5569, 5736, 5865, 5959, 6054, 6221, 7153, 7435, 7821, 7917, 8124, 8434, 8948, 9177, 9277, 9843, 10053, 10252, 11116, 11570, 11782, 12647, 13170, 14305, 14405]","[0, 175, 602, 692, 937, 1122, 1388, 1556, 1869, 2032, 2200, 2466, 2667, 3089, 3259, 3502, 3935, 4133, 4551, 5228, 5474, 5641, 5839, 6139, 6684, 6911, 7392, 7486, 8025, 8228, 8324, 8992, 9252, 9466, 9639, 10253, 10463, 10662, 11068, 11267, 11419, 12650, 13579, 13985, 14130]",29226,26861,20944,14405,14130,89,106,97,105,75,"[0, 209, 566, 1050, 1386, 1748, 2039, 2538, 2791, 3087, 3762, 4244, 5024, 6073, 7018, 7340, 8410, 9387, 10603, 11383, 11613, 12843, 14416, 15627, 16487, 17868, 18608, 19600, 21528, 22505, 23610, 25302, 27290, 28427, 30662, 32149, 32249, 33839, 35578, 37534, 39013, 40803, 41277, 42827, 44386]","[0, 328, 681, 1007, 1368, 1723, 1930, 2668, 3058, 3830, 4396, 4732, 5311, 5758, 6395, 7000, 7427, 8091, 8300, 9205, 9746, 10877, 11281, 11738, 12333, 12760, 13455, 15258, 15598, 16312, 16738, 17316, 17818, 18125, 18748, 19288, 19782, 20402, 21182, 21853, 22988, 23793, 24075, 24228, 25151]","[0, 209, 556, 799, 1245, 1637, 2047, 2445, 2864, 3444, 3959, 4380, 4922, 5180, 6249, 6836, 8042, 8200, 8488, 9446, 10210, 10377, 11073, 11693, 12333, 12930, 13427, 14346, 15082, 15564, 15940, 17241, 17912, 18591, 19093, 19772, 19957, 20145, 20404, 20819, 21708, 22531, 22631, 23241, 24486]","[0, 170, 260, 416, 506, 661, 796, 961, 1096, 1596, 1776, 2293, 2548, 2762, 3173, 3585, 4361, 4605, 4893, 5096, 5744, 6056, 6477, 6902, 7741, 8029, 8435, 9608, 9949, 10304, 10510, 10700, 11201, 11914, 12583, 12773, 13203, 13303, 13562, 14081, 14553, 15211, 15561, 16009, 16419]","[0, 170, 305, 441, 629, 759, 951, 1244, 1397, 1646, 2028, 2278, 2491, 2705, 2911, 3405, 3981, 4139, 4432, 4783, 5169, 5600, 5932, 6190, 6375, 6614, 6981, 7089, 7456, 7977, 8798, 9063, 9348, 9957, 10654, 10919, 11254, 11675, 12149, 12835, 13233, 13756, 13931, 14308, 14590]",44386,25151,24486,16419,14590,-15160,1710,-3542,-2014,-460,-19466,45,dire
7536677705,113,22,96,65,105,"[73, 237, 645, 817, 1189, 1548, 1960, 2368, 2672, 3075, 3953, 4442, 4900, 5522, 6135, 6948, 7696, 8310, 8911, 10263, 11091, 11588, 12789, 13848, 15032, 15828, 17063, 17850, 18711, 18807, 20328, 21733, 22623, 23909, 25376, 26596, 27256, 28039, 28920, 29549, 30862, 31923, 33318, 34477, 35698]","[73, 326, 719, 1125, 1390, 1800, 2373, 2730, 3237, 3697, 4331, 4849, 5336, 6039, 6297, 6943, 7283, 7632, 8087, 8984, 9374, 9768, 10595, 11000, 11900, 12707, 13196, 13372, 13792, 13983, 14957, 15484, 16846, 17161, 18101, 18308, 18538, 18715, 19156, 19391, 19986, 20685, 21823, 22993, 23455]","[73, 285, 566, 1009, 1431, 1796, 2130, 2385, 2763, 3014, 3475, 3950, 4410, 5409, 5962, 6676, 7092, 7729, 8045, 8659, 9189, 9715, 9953, 10138, 10676, 10770, 10994, 11420, 12069, 12165, 13202, 13868, 14983, 15434, 16216, 16738, 16838, 17045, 17235, 17470, 17768, 17978, 18704, 19348, 19991]","[73, 203, 293, 531, 848, 958, 1369, 1836, 2249, 2546, 3061, 3800, 4340, 4903, 5217, 5815, 6110, 6448, 7197, 7645, 7740, 7835, 8368, 8736, 9199, 9293, 9388, 9844, 10458, 10554, 11022, 11335, 12469, 13262, 13773, 13985, 14085, 14185, 14626, 14909, 15207, 15873, 16444, 16959, 17494]","[206, 336, 441, 531, 666, 756, 1174, 2005, 2193, 2705, 3606, 3732, 4070, 4450, 4838, 5289, 6066, 6211, 6417, 6733, 7489, 7584, 7812, 7997, 8284, 8878, 9045, 9717, 10057, 10153, 10721, 11131, 11618, 12079, 12379, 12479, 12856, 12956, 13146, 13566, 13864, 14475, 14575, 14785, 14908]",35698,23455,19991,17494,14908,94,106,69,58,121,"[174, 420, 627, 966, 1287, 1735, 2096, 2474, 3039, 3507, 4174, 4545, 5188, 5790, 6421, 7081, 7831, 8291, 8644, 9565, 10607, 11261, 12368, 12882, 14199, 15194, 16994, 17787, 19006, 19710, 20590, 21912, 22966, 23066, 23735, 24375, 25031, 26838, 27972, 28937, 29867, 31864, 32565, 33328, 34570]","[307, 703, 951, 1246, 1646, 2059, 2592, 2917, 3091, 3447, 3582, 3965, 4636, 4839, 5525, 5922, 6509, 6961, 7717, 8123, 8959, 9499, 10715, 11442, 12295, 13341, 14100, 15021, 16245, 17018, 17641, 18663, 19029, 19870, 20445, 20845, 21137, 22572, 24008, 24655, 25638, 25971, 26699, 27720, 28507]","[174, 420, 774, 1168, 1581, 1973, 2430, 3191, 3576, 3992, 4204, 4843, 5252, 5785, 6170, 6643, 7311, 7718, 8011, 8602, 9048, 9552, 10258, 10886, 11215, 11951, 13231, 13706, 14830, 15599, 16379, 16781, 17209, 17885, 18510, 18770, 18934, 20110, 20255, 21267, 21768, 22225, 22625, 23562, 23997]","[442, 652, 742, 832, 1074, 1288, 1607, 1852, 2099, 2508, 2680, 3104, 3518, 3721, 3990, 4349, 4834, 5495, 5686, 5893, 6306, 6493, 7074, 7321, 7721, 8454, 8804, 9082, 9585, 10043, 10324, 10656, 10818, 10972, 11230, 11440, 11599, 12488, 12652, 13460, 14265, 14501, 15224, 15432, 15532]","[307, 517, 607, 745, 870, 1125, 1287, 1754, 2059, 2219, 2393, 2800, 2980, 3183, 3377, 3500, 3681, 4313, 4407, 4647, 4829, 4924, 5937, 6032, 6171, 6409, 7004, 7234, 7876, 8252, 8474, 8844, 8944, 9044, 9378, 9527, 10264, 11153, 11253, 11691, 11997, 12299, 12399, 12607, 12757]",34570,28507,23997,15532,12757,1128,-5052,-4006,1962,2151,-3817,45,radiant
7537910800,73,120,129,53,79,"[1, 388, 662, 1059, 1328, 1719, 2161, 2928, 3255, 4180, 4807, 5642, 6241, 7749, 8689, 8972, 10258, 11023, 11885, 13207, 14539, 15717, 16338, 17103, 17948, 18965, 19728, 20996, 21928, 22803, 23919, 24834, 25846, 26639, 27087, 27843, 28980, 29818, 30940, 31806, 33177, 34135, 35252, 36608, 38730]","[1, 242, 484, 650, 965, 1368, 1574, 2400, 2646, 3201, 3695, 4168, 4952, 5108, 5552, 6356, 7699, 8548, 9306, 10044, 10565, 10864, 11677, 12446, 12914, 13654, 14310, 15102, 15900, 16558, 17105, 17853, 18615, 19226, 20077, 20452, 21175, 21889, 22886, 24102, 24884, 26197, 26432, 27281, 29168]","[1, 258, 437, 918, 1391, 1809, 2425, 2841, 3292, 3613, 4098, 4250, 4874, 5500, 5801, 6365, 7498, 8261, 8875, 9451, 10092, 11338, 11862, 12480, 13007, 13536, 14270, 14834, 15364, 16258, 16859, 17636, 18521, 19701, 20080, 20779, 21287, 22260, 22600, 23448, 24368, 24830, 25486, 26026, 27562]","[1, 323, 413, 582, 672, 880, 1086, 1266, 1489, 1734, 2054, 2224, 2603, 2934, 3085, 3363, 4201, 4893, 5123, 5610, 5977, 6161, 6684, 7424, 8052, 8664, 8981, 9618, 10261, 10942, 11638, 12176, 12907, 13772, 14238, 15057, 15700, 16198, 17011, 18093, 18453, 18929, 19876, 20761, 22669]","[1, 491, 581, 701, 829, 1145, 1516, 1696, 1803, 2141, 2505, 2885, 3222, 3426, 3799, 4054, 4601, 5225, 5542, 5947, 6479, 6884, 7389, 7816, 8029, 8582, 9100, 9490, 9880, 10635, 11098, 11618, 12273, 12649, 13087, 13277, 13377, 13701, 14005, 14204, 14531, 14631, 14866, 15277, 16256]",38730,29168,27562,22669,16256,47,41,55,51,110,"[1, 256, 544, 804, 1161, 1554, 2242, 2413, 2897, 3529, 3928, 4235, 4837, 5290, 5689, 6051, 6353, 7033, 7278, 7676, 8335, 9066, 9645, 10266, 10439, 10678, 11324, 11807, 12140, 12547, 13115, 13391, 14110, 14595, 15384, 15870, 16926, 17333, 17807, 18684, 19790, 20219, 21796, 22270, 23343]","[1, 171, 387, 595, 978, 1189, 1524, 1820, 2188, 2406, 2918, 3417, 3962, 4391, 5125, 5620, 6116, 6432, 6809, 7491, 8481, 8576, 9036, 9720, 10105, 11068, 11634, 12284, 12631, 13652, 14518, 15259, 15702, 16705, 17428, 17991, 18091, 18886, 19632, 20404, 21027, 21912, 22717, 23003, 23103]","[1, 171, 368, 527, 1033, 1418, 1733, 2257, 2814, 3363, 3837, 4407, 4980, 5380, 6017, 6619, 6981, 7380, 7774, 8224, 9195, 9290, 9902, 10497, 10683, 11322, 11664, 11972, 12204, 12598, 13086, 13853, 14799, 15419, 15639, 15930, 16030, 16556, 16950, 17365, 17633, 18084, 18374, 18810, 19100]","[1, 216, 306, 396, 526, 633, 829, 1045, 1329, 1552, 1687, 2026, 2116, 2412, 2967, 3291, 3439, 3534, 3744, 4109, 4854, 4949, 5354, 5521, 5860, 6551, 6823, 6918, 7105, 7201, 7461, 8011, 8146, 8502, 8636, 9015, 9331, 9502, 9641, 9845, 10084, 10558, 11386, 11862, 11978]","[1, 171, 261, 399, 573, 663, 1026, 1161, 1268, 1366, 1501, 1711, 2014, 2254, 2698, 2809, 3188, 3572, 3908, 4003, 4590, 4964, 5287, 5884, 6317, 6484, 7032, 7127, 7223, 7319, 8024, 8214, 8508, 8839, 8975, 9162, 9488, 9588, 9764, 9864, 10063, 10199, 11091, 11549, 11697]",23343,23103,19100,11978,11697,15387,6065,8462,10691,4559,45164,45,radiant
7538639606,41,15,23,19,65,"[874, 1306, 1651, 2127, 2529, 2814, 3213, 3570, 4058, 4549, 4875, 5372, 5953, 6548, 7108, 7812, 9025, 9717, 10289, 10789, 11173, 12103, 13001, 13492, 13889, 14485, 15722, 16517, 18101, 18663, 19355, 20679, 21019, 21691, 21791, 22036, 23277, 24578, 25330, 26109, 27277, 27485, 30180, 31691, 32687]","[711, 934, 1333, 1554, 1920, 2338, 2896, 3352, 3770, 4365, 5107, 5662, 6481, 7238, 7500, 8325, 9284, 9814, 10493, 11092, 11632, 12052, 12653, 13398, 14204, 14677, 15895, 16596, 17775, 17965, 18775, 19266, 20150, 20710, 21532, 22471, 23832, 24775, 25600, 25812, 28203, 28758, 30464, 31836, 32172]","[1049, 1382, 1743, 2463, 2708, 3317, 3722, 4086, 4781, 5296, 5689, 6134, 6530, 6980, 7565, 7891, 8584, 8914, 9561, 9804, 10302, 10892, 11842, 12372, 13322, 14337, 15153, 15617, 16745, 17317, 18271, 18875, 19265, 20103, 20480, 20973, 21781, 22227, 23349, 24499, 26351, 26990, 28388, 30249, 30911]","[455, 692, 828, 918, 1089, 1179, 1324, 1420, 1596, 1849, 2276, 2625, 2779, 2874, 2968, 3232, 3814, 4296, 4476, 4678, 4951, 5237, 5650, 5831, 6243, 6420, 7168, 7285, 7813, 8324, 9006, 9196, 9541, 9775, 9875, 9975, 10276, 11061, 11864, 12217, 13108, 13316, 15086, 16233, 17122]","[460, 683, 1086, 1205, 1593, 1683, 1896, 2385, 2606, 2973, 3258, 3645, 3807, 4182, 4511, 5058, 5751, 6183, 6372, 6726, 7008, 7149, 7592, 7742, 7949, 8126, 8611, 8992, 9371, 9752, 9987, 10605, 10705, 11093, 11193, 11293, 12129, 12690, 12900, 13298, 14189, 14397, 15531, 16523, 16739]",32687,32172,30911,17122,16739,109,53,129,74,20,"[1257, 1467, 1825, 2667, 3178, 3661, 4031, 4838, 5514, 6062, 7086, 7716, 8603, 9428, 9821, 10626, 11575, 12613, 13591, 14390, 15181, 15999, 17474, 18721, 19631, 20352, 20565, 21460, 22050, 22348, 23291, 24492, 25897, 26816, 27710, 28800, 29172, 30587, 31670, 32687, 33170, 33632, 34032, 34362, 35466]","[641, 766, 1135, 1626, 2040, 2328, 2477, 3117, 3655, 3889, 4673, 5135, 5971, 6573, 7330, 7425, 7785, 8111, 8697, 9406, 9793, 10328, 10957, 11704, 11940, 12618, 13167, 13360, 14600, 15424, 16041, 16652, 17200, 18244, 19106, 20163, 20744, 20943, 21132, 22296, 23254, 23771, 24171, 25175, 25937]","[741, 1072, 1434, 1844, 2338, 2740, 3283, 3835, 4250, 5029, 5633, 6352, 6528, 6997, 7999, 8176, 8402, 9054, 9765, 10159, 10826, 11362, 12185, 12661, 12937, 13530, 14007, 14663, 15508, 16237, 16848, 17038, 17340, 18622, 19534, 19733, 19889, 20476, 20576, 21329, 21904, 22004, 22338, 22443, 22549]","[864, 1159, 1489, 1828, 2039, 2410, 2864, 3328, 3628, 3817, 4358, 4797, 5097, 5647, 5899, 6262, 6593, 6863, 7493, 7723, 8025, 8282, 8603, 8698, 8793, 9414, 9820, 10134, 10521, 11188, 11378, 11924, 12179, 12785, 13582, 14211, 14940, 15484, 15584, 15841, 15941, 16473, 16703, 17097, 17648]","[543, 704, 794, 1133, 1344, 1434, 1524, 1819, 1909, 2408, 2821, 2978, 3223, 3707, 3801, 3896, 4054, 4332, 4791, 5021, 5116, 5387, 5664, 5917, 6012, 6279, 6492, 6842, 7229, 7630, 7934, 8442, 8589, 8996, 9563, 9762, 9862, 10061, 10197, 10619, 10719, 10819, 11049, 11154, 11260]",35466,25937,22549,17648,11260,-2779,6235,8362,-526,5479,16771,45,radiant
7539188102,25,65,62,51,20,"[259, 496, 904, 1397, 1903, 2434, 2942, 3267, 3580, 3937, 4586, 5539, 6261, 6930, 7447, 8736, 9369, 10085, 10547, 11414, 11509, 12188, 12492, 13520, 13730, 13825, 14693, 15952, 16492, 17243, 18190, 19359, 21083, 21675, 23733, 24946, 26141, 26988, 29413, 30837, 31399, 31946, 32389, 33077, 33811]","[250, 483, 764, 932, 1314, 1728, 1863, 2438, 2746, 3609, 4267, 5084, 5695, 6210, 6903, 7787, 8257, 8781, 9144, 9698, 9922, 10570, 10982, 11944, 12601, 13393, 13924, 14596, 14822, 15443, 16075, 16314, 17890, 18924, 19556, 20187, 21537, 21804, 22937, 24314, 24799, 25422, 26498, 26635, 26843]","[249, 599, 897, 1344, 1688, 2134, 2410, 2954, 3445, 3778, 4292, 4928, 5289, 5780, 6165, 6915, 7154, 7285, 7415, 7528, 7939, 8320, 8552, 9025, 9600, 9729, 10014, 10624, 10830, 11432, 11748, 12018, 13112, 13510, 14396, 14665, 15218, 15551, 17002, 17572, 17708, 18021, 18121, 18265, 18401]","[170, 309, 748, 838, 992, 1204, 1387, 1560, 1770, 2118, 2362, 2615, 2854, 3021, 3370, 4043, 4238, 4459, 4579, 4788, 4982, 5261, 5657, 5827, 6639, 6943, 7112, 7358, 7619, 7983, 8348, 8665, 9343, 9658, 10526, 10664, 10962, 11421, 12438, 12889, 13026, 13156, 13392, 13943, 14082]","[170, 306, 449, 634, 771, 861, 996, 1144, 1281, 1524, 2006, 2366, 3083, 3461, 3758, 4134, 4369, 4775, 4888, 5367, 5537, 6100, 6305, 6493, 6828, 6998, 7216, 7684, 7855, 8107, 8357, 8552, 9258, 9648, 10230, 10405, 10857, 11027, 12188, 12660, 12835, 12978, 13153, 13270, 13370]",33811,26843,18401,14082,13370,67,98,106,79,72,"[241, 473, 769, 979, 1344, 1652, 2258, 2597, 3212, 3624, 4140, 4608, 4940, 5626, 6041, 6416, 7463, 8137, 8968, 9602, 10508, 11442, 12631, 12771, 13645, 14612, 15257, 16498, 16984, 17639, 18480, 19661, 20726, 21586, 22430, 23350, 24169, 24957, 25751, 26982, 27796, 29442, 30642, 31662, 33642]","[248, 452, 597, 1026, 1210, 1630, 2171, 2574, 2858, 3870, 4226, 4645, 5614, 6149, 6572, 7689, 8453, 9059, 10323, 10829, 12110, 12746, 13374, 14252, 15218, 16253, 16979, 17464, 18063, 18679, 19508, 20376, 21039, 21961, 22267, 22367, 23159, 23825, 24161, 24261, 25186, 25421, 26689, 27202, 28788]","[278, 565, 848, 1472, 1959, 2289, 2743, 3125, 4013, 4382, 4858, 5179, 5608, 5789, 6169, 6802, 7844, 8180, 8860, 9434, 10115, 11019, 11401, 11695, 12406, 13010, 13329, 13678, 13924, 14618, 15472, 16243, 16426, 16526, 17171, 17663, 18358, 18697, 19414, 19740, 20274, 21608, 22459, 22716, 23677]","[170, 260, 350, 440, 570, 660, 1123, 1231, 1391, 1661, 2312, 3003, 3250, 3621, 3994, 4713, 5115, 5655, 6636, 6946, 7424, 7828, 8329, 8499, 8939, 9190, 9613, 10274, 10543, 11062, 11519, 11958, 12133, 12651, 13098, 13687, 13890, 14152, 14572, 14782, 15264, 15878, 16698, 16873, 17774]","[170, 260, 397, 487, 695, 785, 1121, 1245, 1462, 1732, 1950, 2040, 2362, 2495, 2662, 2896, 3683, 4078, 4736, 5160, 5914, 6318, 7126, 7400, 7961, 8573, 9188, 9734, 10041, 10346, 10775, 11214, 11405, 11697, 12003, 12163, 12387, 12627, 13521, 13708, 14118, 14540, 15423, 15523, 16225]",33642,28788,23677,17774,16225,169,-1945,-5276,-3692,-2855,-13599,45,dire
7540116814,70,21,96,53,26,"[624, 752, 1079, 1537, 1984, 2418, 3111, 3370, 3830, 4345, 4799, 5247, 5924, 6179, 6875, 7831, 8354, 8623, 9397, 10306, 11204, 11834, 12596, 13278, 14186, 15019, 15624, 16918, 17569, 18025, 18603, 20560, 21536, 21833, 22718, 23334, 24338, 25046, 25642, 26430, 26530, 27094, 27851, 29199, 30835]","[664, 911, 1245, 1696, 2194, 2701, 3378, 3468, 4140, 4959, 5274, 5907, 6293, 6719, 7477, 7656, 8081, 8616, 9081, 9605, 10328, 11088, 11337, 11909, 12739, 13321, 14268, 14894, 15205, 15849, 16231, 16444, 17126, 17226, 17646, 17917, 18415, 18515, 18615, 19031, 19741, 20210, 21647, 22059, 23090]","[839, 1072, 1432, 1813, 2239, 2704, 3048, 3309, 3812, 4467, 4937, 5534, 5928, 6360, 7159, 7618, 8169, 8586, 9653, 10213, 10914, 11171, 11511, 12091, 12333, 12428, 12836, 13422, 14279, 14822, 15453, 17092, 17619, 17719, 18017, 18335, 19038, 19184, 19284, 20028, 20705, 21234, 22230, 22330, 23014]","[387, 523, 673, 921, 1011, 1300, 1574, 1740, 2017, 2485, 2710, 2978, 3807, 4043, 4724, 4864, 5453, 5548, 6331, 6614, 7307, 7770, 8217, 8494, 8625, 9280, 10270, 10969, 11200, 11788, 12494, 12978, 13965, 14065, 14363, 15033, 15975, 16440, 16778, 17554, 17897, 18930, 19534, 19634, 20637]","[694, 927, 1017, 1196, 1286, 1636, 1909, 2171, 2655, 2858, 2948, 3144, 3569, 4012, 4387, 4591, 4803, 4898, 5303, 5889, 6307, 6780, 6950, 7120, 7289, 7459, 7942, 8223, 8529, 8884, 9374, 10283, 10635, 10810, 11183, 11457, 11912, 12087, 12197, 12755, 12855, 13602, 14301, 14471, 15155]",30835,23090,23014,20637,15155,41,120,14,119,20,"[577, 912, 1235, 1402, 1897, 2361, 2769, 3449, 3668, 4050, 4325, 4711, 5198, 5599, 5884, 6780, 7209, 8086, 9153, 9413, 10685, 11573, 12162, 12772, 13811, 15128, 16103, 16595, 16733, 17491, 19211, 19495, 19595, 22053, 23208, 23692, 24027, 24194, 24398, 25114, 26426, 27477, 29450, 30095, 30776]","[1093, 1344, 1754, 2081, 2398, 3059, 3536, 4254, 4849, 5521, 5718, 6210, 6736, 7270, 8066, 8630, 9676, 10065, 10640, 11341, 12221, 12757, 13522, 13782, 14473, 15450, 16419, 16784, 17550, 17775, 18904, 19327, 20021, 22092, 23293, 23393, 23856, 24626, 24726, 25756, 26709, 28039, 29358, 29458, 30032]","[474, 919, 1208, 1684, 1842, 2003, 2244, 2431, 2785, 3133, 3658, 3875, 4702, 5430, 6230, 6451, 6783, 7609, 8356, 8502, 9202, 9297, 9943, 10154, 11070, 12148, 12615, 12870, 12969, 13069, 13725, 13825, 13925, 15371, 16422, 16847, 17502, 17606, 17706, 18315, 19068, 20091, 20968, 21068, 21614]","[598, 766, 856, 946, 1036, 1248, 1699, 1871, 2184, 2477, 2686, 3007, 3773, 3921, 4252, 4392, 4924, 5368, 5463, 5671, 6060, 6234, 6494, 6861, 7403, 7809, 8323, 8653, 8909, 9084, 10155, 10312, 10724, 12042, 12823, 12923, 13273, 13376, 13476, 14439, 14757, 15539, 16578, 16678, 16923]","[465, 631, 982, 1105, 1195, 1484, 1771, 2002, 2230, 2477, 2663, 2913, 3277, 3471, 3765, 4072, 4431, 4661, 5060, 5355, 5873, 6087, 6372, 6797, 7307, 8021, 8404, 8561, 9046, 9221, 9782, 9957, 10130, 11354, 11826, 11926, 12026, 12172, 12290, 12794, 13112, 13643, 14439, 14596, 14916]",30776,30032,21614,16923,14916,59,-6942,1400,3714,239,-1530,45,dire
7540902013,72,108,106,20,26,"[0, 580, 908, 1309, 1725, 2168, 2796, 3207, 4013, 4515, 4991, 5982, 6454, 7199, 7968, 8660, 9293, 10027, 10780, 10874, 11765, 12747, 13442, 14347, 15167, 15709, 16810, 17950, 18573, 19286, 20194, 20998, 21613, 23508, 24232, 27108, 28005, 29041, 29589, 29879, 31339, 31547, 31647, 33143, 33378]","[0, 220, 537, 855, 1236, 1656, 1980, 2565, 3312, 3889, 4147, 4674, 4899, 5533, 6081, 6448, 6898, 7489, 7669, 7889, 8115, 8876, 9454, 9841, 10301, 10396, 10724, 11249, 11875, 12314, 12581, 13174, 13458, 14735, 15695, 16949, 17049, 17149, 17355, 18234, 18334, 19674, 19774, 21722, 22249]","[0, 241, 526, 973, 1262, 1607, 2160, 2639, 3144, 3496, 3881, 4398, 4692, 5325, 5884, 6289, 6943, 7301, 7396, 7747, 8226, 8672, 9133, 9425, 10144, 10325, 10703, 11020, 11116, 11670, 12441, 13000, 13398, 14283, 14642, 15287, 15558, 15658, 16079, 16402, 17336, 18324, 18735, 20641, 21153]","[0, 239, 346, 480, 618, 769, 925, 1098, 1445, 1660, 1800, 2355, 2867, 3090, 3559, 3750, 3996, 4140, 4284, 4378, 4733, 4990, 5304, 5399, 6014, 6388, 6526, 6674, 6936, 7245, 7375, 7613, 7723, 8352, 8773, 9880, 10230, 10944, 11254, 11758, 12164, 12886, 13080, 15106, 15341]","[0, 169, 356, 446, 581, 716, 1020, 1223, 1565, 1705, 1910, 2246, 2551, 2793, 3084, 3503, 3852, 3993, 4116, 4226, 4321, 4506, 4672, 4878, 5742, 5837, 5966, 6135, 6249, 6345, 6441, 6631, 6731, 7326, 7685, 8792, 8892, 9037, 9137, 9427, 10060, 10917, 11086, 12400, 12635]",33378,22249,21153,15341,12635,23,25,69,83,121,"[0, 290, 628, 1020, 1316, 1834, 2304, 2758, 3496, 3950, 4757, 5253, 6005, 6455, 7031, 7584, 8362, 8970, 9600, 10519, 11488, 12076, 12666, 13770, 14436, 14864, 15703, 16251, 16835, 17478, 17902, 18221, 18631, 19991, 20604, 20794, 21541, 22451, 22985, 24497, 26010, 26457, 27327, 28578, 29559]","[0, 217, 648, 776, 900, 1272, 1689, 1929, 2131, 2384, 2904, 3310, 3918, 4414, 5101, 5688, 6276, 6840, 7204, 8597, 9257, 9648, 10132, 10847, 11869, 13449, 13712, 14346, 14973, 15515, 15854, 16867, 17184, 18062, 18517, 18707, 20057, 20619, 21078, 24114, 25742, 25842, 25942, 28086, 29114]","[0, 169, 474, 845, 1025, 1233, 1363, 1662, 1880, 2669, 3224, 3493, 4019, 4355, 4980, 5587, 6765, 7203, 7322, 8275, 8871, 9360, 9749, 9981, 10726, 11475, 12124, 12494, 13046, 13494, 13848, 14315, 14586, 15543, 16218, 17460, 18239, 18578, 18838, 20097, 21608, 21708, 21808, 22740, 23272]","[0, 169, 289, 379, 488, 703, 793, 1100, 1488, 1775, 2269, 2413, 2963, 3260, 3570, 3664, 4228, 4372, 4637, 5350, 5580, 5764, 5993, 6206, 6867, 7617, 7711, 7842, 8019, 8409, 8505, 8740, 8942, 9649, 9948, 10527, 10805, 11073, 11173, 12708, 13338, 13647, 13918, 15348, 16318]","[0, 169, 289, 596, 738, 955, 1235, 1370, 1597, 1886, 2264, 2437, 2846, 3131, 3392, 3658, 3906, 4046, 4207, 5037, 5483, 5848, 6077, 6244, 6496, 7056, 7196, 7433, 7682, 7896, 7992, 8227, 8750, 9642, 10050, 11009, 11109, 11209, 11639, 12524, 13403, 13503, 13674, 14546, 15242]",29559,29114,23272,16318,15242,3819,-6865,-2119,-977,-2607,-8749,45,dire
7540945015,46,32,129,20,21,"[286, 538, 839, 1264, 1655, 2031, 2241, 3223, 3752, 4452, 5047, 5787, 6824, 7491, 8019, 8427, 10023, 10793, 11678, 12298, 13148, 14754, 15670, 16649, 17532, 18824, 19287, 19987, 20083, 21352, 22143, 23085, 24057, 24744, 25516, 26500, 26874, 27934, 28866, 29635, 30597, 31405, 32312, 34830, 36834]","[332, 847, 1130, 1423, 1791, 2173, 2618, 2915, 3236, 3763, 4096, 4535, 4997, 5309, 5991, 6462, 7466, 8199, 8842, 9876, 10048, 10741, 11546, 12136, 12603, 13124, 13716, 14839, 15357, 16270, 17083, 17877, 18460, 19131, 19535, 20217, 20317, 21219, 22156, 22937, 23921, 24059, 25746, 27274, 28678]","[246, 455, 621, 783, 1075, 1476, 1861, 2182, 2462, 2972, 3457, 3916, 4588, 5300, 5395, 5610, 6240, 6713, 7114, 7426, 7560, 8224, 9070, 9616, 9782, 10877, 11526, 11837, 12234, 12501, 12691, 12791, 13133, 13497, 13696, 14022, 14244, 14465, 14904, 15048, 15444, 15892, 16823, 17618, 18642]","[310, 841, 993, 1169, 1295, 1433, 1603, 1870, 2148, 2411, 2663, 2790, 3159, 3539, 3790, 3885, 4848, 4942, 5343, 5598, 5768, 6695, 7248, 7575, 7899, 8956, 9244, 9626, 10156, 10728, 11105, 11249, 11349, 11504, 11653, 12322, 12470, 12644, 12889, 13142, 13391, 13623, 14635, 15430, 16353]","[260, 393, 535, 625, 762, 852, 988, 1170, 1296, 1386, 1853, 2067, 2448, 2722, 3307, 3591, 4075, 4169, 4570, 4960, 5075, 6688, 7251, 7504, 7711, 8301, 8769, 9433, 9576, 9843, 10306, 11082, 11407, 11507, 11678, 11917, 12246, 12569, 12835, 12935, 13577, 13794, 14297, 15160, 16246]",36834,28678,18642,16353,16246,10,23,112,58,100,"[285, 520, 849, 1376, 1718, 2134, 2532, 3076, 3738, 4373, 4779, 5218, 5930, 6462, 7470, 8642, 8957, 9915, 10840, 11896, 13000, 13715, 14333, 14946, 15766, 16148, 16855, 18332, 18995, 20204, 21266, 23077, 24366, 24742, 25502, 26749, 28300, 29259, 29943, 31149, 32214, 33513, 34278, 34378, 34503]","[168, 487, 812, 1246, 1537, 2007, 2439, 3025, 3470, 4161, 4750, 5355, 5546, 6383, 7343, 8127, 8222, 8847, 9333, 9850, 10480, 10983, 11078, 11260, 11533, 11740, 12441, 12938, 13338, 14212, 14975, 15701, 16470, 16570, 16832, 17757, 18146, 18344, 19068, 19962, 20197, 20746, 21594, 21987, 22594]","[201, 397, 666, 831, 1327, 1738, 1980, 2435, 2653, 3005, 3528, 3919, 4259, 4701, 5123, 5512, 5663, 6091, 6785, 6880, 7366, 8224, 8723, 9000, 9377, 9472, 9772, 9868, 10212, 11115, 11639, 12242, 12768, 13115, 13585, 14123, 14645, 14813, 15341, 15832, 16259, 16871, 17671, 17771, 17871]","[130, 268, 388, 612, 781, 883, 1106, 1353, 1570, 1965, 2315, 2607, 2716, 2869, 3224, 3613, 3708, 3993, 4560, 4975, 5769, 6025, 6370, 6488, 6908, 7395, 7908, 8409, 8788, 9504, 10314, 10874, 11207, 11522, 11851, 11951, 12548, 13295, 13577, 14017, 14574, 15381, 16116, 16216, 16316]","[130, 220, 443, 573, 703, 793, 1181, 1271, 1659, 2201, 2726, 2870, 3164, 3426, 3848, 4237, 4332, 4552, 4861, 5283, 5783, 6039, 6134, 6359, 6525, 6620, 6940, 7733, 7829, 8420, 8879, 9298, 9580, 9680, 9870, 10433, 11121, 11661, 11860, 12059, 12294, 12843, 13447, 13547, 13647]",34503,22594,17871,16316,13647,2331,6084,771,37,2599,11822,45,radiant
7541784709,38,21,137,65,83,"[0, 168, 471, 772, 1554, 1987, 2387, 2738, 3333, 3929, 4251, 4609, 4984, 5666, 6252, 6939, 7898, 8535, 9243, 9879, 10481, 11068, 11603, 12716, 13755, 14521, 15478, 16787, 17038, 17429, 17789, 18237, 18397, 18880, 19165, 19659, 19921, 20021, 20430, 20945, 21582, 22786, 23486, 23987, 24716]","[0, 243, 533, 750, 1096, 1335, 1785, 2126, 2783, 3331, 3674, 4207, 4599, 5326, 5727, 6320, 7081, 7786, 8380, 8984, 9497, 10015, 10991, 11854, 12647, 13782, 14858, 16472, 17080, 17531, 18082, 18596, 19102, 19394, 20727, 21306, 22070, 22784, 23098, 23271, 24586, 25042, 25433, 26348, 26632]","[0, 198, 518, 886, 1016, 1263, 1752, 1967, 2482, 2899, 3754, 4660, 5222, 5861, 6512, 7076, 7365, 7996, 8756, 9239, 9592, 9710, 10351, 10747, 11265, 12260, 12825, 13713, 14089, 14185, 14488, 15168, 15622, 16397, 16809, 17659, 18090, 18190, 18716, 18816, 19489, 20340, 20957, 21438, 21860]","[0, 130, 220, 310, 558, 648, 1087, 1310, 1706, 1870, 2314, 2667, 3127, 3626, 4199, 4506, 4995, 5153, 5337, 5908, 6580, 6724, 7055, 7443, 8017, 8556, 9117, 10258, 10509, 10650, 10930, 11120, 11220, 11514, 11704, 11963, 12482, 12785, 12885, 12985, 13230, 13686, 14305, 15395, 15853]","[0, 130, 220, 414, 544, 634, 807, 942, 1591, 1807, 2070, 2328, 2551, 2718, 3252, 3393, 3609, 3814, 4004, 4286, 4556, 4651, 4858, 5197, 5561, 6029, 6617, 7484, 7735, 7879, 8431, 8703, 8803, 9494, 9684, 10177, 10597, 10697, 10867, 10967, 11780, 12425, 12713, 12921, 13021]",24716,26632,21860,15853,13021,41,15,96,20,87,"[0, 245, 447, 766, 1016, 1258, 1616, 2017, 2262, 2631, 2990, 3382, 3748, 4178, 4789, 5165, 5634, 5974, 6446, 6768, 7246, 7828, 8287, 9007, 9762, 9857, 10515, 11306, 12858, 13415, 14920, 15795, 16090, 17224, 17920, 18382, 19794, 20105, 20827, 21553, 22599, 23216, 24558, 25717, 26405]","[0, 329, 641, 1003, 1425, 1882, 2184, 3083, 3501, 4149, 4325, 4572, 4833, 5595, 6019, 6630, 7183, 8078, 8744, 9652, 10480, 11055, 11844, 12527, 13097, 13598, 14059, 14568, 14907, 15552, 16679, 17017, 17195, 18119, 18309, 18563, 20082, 20645, 21124, 21950, 23567, 23902, 25311, 25751, 26925]","[0, 210, 406, 582, 906, 1193, 1602, 1985, 2208, 2647, 3063, 3607, 3913, 4392, 4953, 5476, 6313, 6550, 7080, 7811, 8275, 8988, 9718, 10568, 10945, 11290, 11801, 12888, 13498, 13698, 14512, 14984, 15676, 16768, 17600, 17876, 18934, 20092, 20416, 21207, 22310, 23352, 24695, 25735, 26366]","[0, 259, 435, 602, 822, 947, 1161, 1520, 1656, 1830, 2100, 2298, 2803, 3038, 3223, 3318, 4031, 4260, 4575, 5395, 5744, 6071, 6324, 6565, 6760, 6930, 7263, 7476, 7890, 8061, 8602, 9004, 9179, 9354, 10461, 10872, 11578, 11852, 12117, 12825, 13851, 14136, 14792, 15061, 15407]","[0, 247, 371, 461, 691, 816, 1068, 1434, 1568, 1742, 2071, 2546, 2636, 2903, 3297, 3392, 3745, 4191, 4470, 5037, 5270, 5672, 5914, 6297, 6604, 6830, 7259, 8517, 9539, 9996, 10607, 10883, 10983, 11083, 11432, 11690, 12358, 12635, 12900, 13684, 14223, 14632, 15274, 15482, 15828]",26405,26925,26366,15407,15828,-1689,-293,-4506,446,-2807,-8849,45,dire
7541933305,10,23,47,45,19,"[0, 252, 637, 1020, 1387, 1819, 2243, 2647, 3265, 3732, 4194, 5087, 5616, 6053, 6696, 7314, 8006, 8592, 8989, 9930, 10331, 11064, 12511, 13405, 13793, 14795, 15469, 16106, 16884, 17718, 18552, 19022, 20035, 20659, 23382, 24820, 25930, 26387, 26796, 27722, 29018, 30425, 30953, 31208, 31652]","[0, 288, 680, 1080, 1378, 1999, 2323, 2803, 3352, 4003, 4389, 4832, 5264, 5397, 5914, 6467, 7378, 7561, 8104, 8685, 9457, 9978, 11545, 11959, 12730, 13276, 14140, 14864, 15563, 15856, 16434, 17077, 17925, 18515, 19698, 20450, 21119, 21743, 22205, 22841, 24070, 24784, 25352, 25812, 25912]","[0, 429, 668, 955, 1121, 1583, 1960, 2087, 2321, 2710, 2963, 3274, 3449, 4026, 4245, 4384, 4862, 5539, 5762, 6325, 6828, 7499, 8438, 9298, 9784, 10316, 10776, 11063, 11875, 12326, 12668, 13202, 13302, 13828, 14918, 15896, 16585, 17249, 17431, 17688, 18072, 19212, 19772, 20205, 20882]","[100, 270, 385, 566, 885, 1103, 1193, 1407, 1542, 2035, 2170, 2451, 2587, 2693, 2834, 2953, 3303, 3496, 3640, 4216, 4489, 4584, 5331, 5745, 6385, 6480, 6919, 7374, 7552, 7648, 7744, 7843, 7975, 8254, 9614, 9919, 10292, 10757, 11004, 11203, 11804, 12477, 12685, 12831, 12931]","[0, 261, 415, 505, 812, 1236, 1462, 1552, 1774, 2151, 2286, 2666, 2860, 2960, 3100, 3194, 3664, 3887, 4148, 4639, 4819, 5021, 5847, 6411, 6641, 6904, 7144, 7508, 7686, 7799, 7940, 8039, 8139, 8656, 9551, 9786, 10106, 10331, 10431, 10630, 11159, 11825, 12033, 12180, 12280]",31652,25912,20882,12931,12280,12,74,96,65,20,"[60, 288, 776, 987, 1491, 1795, 2212, 2715, 3160, 3735, 4368, 4830, 5607, 6342, 7141, 7767, 8404, 9275, 10069, 10570, 11564, 12247, 12882, 13338, 13994, 15274, 15928, 16488, 17415, 18274, 19572, 20945, 22260, 23105, 24285, 24475, 25292, 26369, 27067, 28175, 29154, 29389, 29666, 30741, 31753]","[328, 593, 864, 1068, 1403, 1528, 1723, 1982, 2361, 2733, 3281, 3850, 4160, 4649, 5435, 6016, 6536, 7060, 8050, 8666, 9201, 10115, 10705, 10951, 11046, 11715, 12430, 12524, 13477, 13925, 14936, 16345, 16942, 17386, 18221, 18795, 19239, 19666, 19829, 20846, 21082, 21643, 22166, 22951, 23541]","[60, 420, 851, 1149, 1513, 1960, 2327, 2712, 2959, 3831, 4852, 5333, 6042, 6369, 6851, 7311, 7863, 8885, 9485, 9833, 10277, 11041, 11324, 11418, 12069, 12503, 13754, 14032, 14454, 14569, 15399, 16424, 16806, 17032, 17609, 18390, 18710, 19142, 19601, 20424, 20734, 21149, 21249, 21640, 21824]","[60, 345, 500, 590, 778, 933, 1368, 1629, 1875, 2061, 2451, 2641, 2949, 3533, 3959, 4112, 4698, 5566, 6346, 6763, 7172, 7394, 7654, 7806, 8084, 8306, 8805, 9096, 9513, 9609, 10088, 10686, 11338, 11553, 12130, 12320, 12420, 12568, 12812, 13088, 13188, 14223, 14438, 14671, 14854]","[60, 528, 721, 811, 1020, 1154, 1614, 1749, 1839, 1977, 2121, 2285, 2375, 2685, 2879, 2973, 3339, 3805, 4388, 4637, 5045, 5177, 5419, 5661, 5925, 6459, 6884, 7259, 7684, 7780, 8672, 9550, 9650, 9860, 10035, 10418, 10518, 10662, 11287, 11817, 11917, 12152, 12252, 12485, 12585]",31753,23541,21824,14854,12585,-101,2371,-942,-1923,-305,-900,45,dire
7544499316,10,13,69,40,123,"[0, 170, 486, 1029, 1386, 1613, 2060, 2717, 3215, 3805, 4372, 4881, 5541, 5956, 6752, 7358, 8149, 8942, 9508, 10351, 11408, 11937, 12827, 14049, 14934, 16409, 17770, 19130, 20198, 20294, 21226, 21455, 22168, 23335, 24151, 25189, 26664, 28051, 28151, 28625, 30714, 32655, 34069, 34668, 35259]","[0, 253, 465, 860, 1175, 1529, 1906, 2346, 2680, 3141, 3407, 3987, 4415, 4510, 5203, 5849, 6701, 6927, 7175, 7783, 8342, 8839, 9481, 9831, 10708, 11272, 12027, 12658, 13054, 13150, 13909, 14282, 14986, 15551, 16580, 17848, 18216, 18709, 19725, 21039, 22149, 22932, 23804, 25070, 26079]","[0, 204, 592, 759, 1005, 1193, 1560, 1738, 1950, 2288, 2761, 3141, 3644, 4195, 5432, 6096, 7207, 8446, 8949, 9559, 10566, 11509, 11960, 13171, 14066, 14611, 15325, 15796, 16087, 16544, 17271, 17660, 17760, 17930, 19261, 19686, 19885, 20159, 20947, 21245, 21826, 22650, 23149, 23357, 24203]","[0, 514, 604, 694, 830, 929, 1126, 1342, 1432, 1522, 1657, 1747, 1947, 2042, 2196, 2356, 2827, 3542, 3932, 4026, 4201, 4642, 5307, 5922, 6017, 6516, 6895, 7513, 8094, 8554, 9389, 9923, 10479, 10762, 11492, 11592, 12190, 12674, 13217, 13767, 14494, 15076, 15667, 16324, 16691]","[100, 316, 625, 715, 854, 1022, 1312, 1402, 1492, 1705, 2050, 2474, 2654, 2749, 2938, 3098, 3597, 4161, 4300, 4679, 5106, 5461, 6334, 6931, 7286, 8063, 8446, 8835, 9341, 9602, 9698, 10164, 10453, 10578, 11338, 11753, 12036, 12249, 12785, 13556, 14136, 14518, 14904, 15112, 15843]",35259,26079,24203,16691,15843,42,20,53,32,21,"[0, 241, 486, 724, 1157, 1433, 1800, 2332, 2606, 2990, 3437, 3806, 4218, 4907, 5317, 5969, 6416, 7071, 7600, 8127, 8730, 9537, 10115, 10670, 11052, 11851, 12207, 12476, 13238, 13789, 14103, 14728, 15891, 16431, 17584, 18905, 19571, 20668, 21456, 22248, 23241, 24011, 24950, 25481, 26065]","[0, 250, 564, 951, 1235, 1690, 2138, 2592, 2930, 3164, 3697, 3948, 4151, 4661, 5317, 5758, 6830, 7125, 7473, 7879, 8212, 8397, 8932, 9489, 10298, 10919, 11381, 11843, 13231, 14702, 14888, 15665, 16244, 16869, 17678, 18478, 19457, 20161, 20925, 21230, 22146, 22685, 22969, 24034, 24791]","[0, 170, 260, 444, 1026, 1165, 1414, 1641, 1852, 2181, 2801, 3062, 3288, 3527, 3886, 4138, 4977, 5072, 5830, 6922, 7143, 7349, 7903, 8230, 8993, 9546, 9787, 10144, 10798, 11427, 11685, 11990, 12570, 12810, 14089, 15131, 15231, 16238, 16397, 17055, 17389, 17489, 18774, 19289, 19821]","[0, 257, 781, 1140, 1513, 1793, 2195, 2617, 3144, 3737, 4410, 4846, 5201, 5578, 5673, 6076, 6741, 6836, 7082, 7586, 7996, 8522, 8844, 9047, 9378, 9642, 9737, 10280, 10724, 11677, 11863, 12881, 13427, 13605, 13839, 14375, 15036, 15136, 15613, 15848, 16374, 17053, 18098, 19254, 19689]","[0, 170, 260, 350, 533, 756, 930, 1210, 1474, 1692, 2042, 2284, 2395, 2931, 3026, 3234, 4299, 4394, 4740, 5136, 5570, 5737, 6370, 6858, 7198, 7564, 7659, 7976, 8709, 9239, 9492, 10246, 10779, 10923, 11523, 11623, 11723, 12719, 12819, 13054, 13264, 13364, 13907, 14297, 14671]",26065,24791,19821,19689,14671,9194,1288,4382,-2998,1172,13038,45,dire
7546267004,74,38,70,21,26,"[0, 295, 577, 946, 1271, 1647, 1935, 2341, 2790, 3630, 3882, 4243, 4872, 5477, 6178, 6568, 6961, 7420, 8507, 8941, 9335, 9975, 10603, 11309, 12135, 12726, 13033, 14085, 14383, 15061, 15801, 16011, 16981, 18118, 18900, 20331, 20467, 21544, 23646, 25124, 26347, 26542, 26642, 28024, 28912]","[0, 283, 518, 879, 1187, 1553, 1853, 2020, 2195, 3011, 3443, 4052, 4453, 5412, 6108, 6904, 7580, 8574, 9486, 10550, 11330, 11864, 12234, 12989, 13518, 14260, 14830, 15395, 15659, 16314, 17460, 17881, 18222, 19928, 20124, 21099, 21856, 22537, 23832, 25267, 25986, 26730, 26830, 26956, 27168]","[0, 209, 523, 768, 1091, 1425, 1620, 2131, 2582, 3015, 3383, 3473, 3686, 4350, 4801, 5352, 6004, 7068, 8095, 8700, 9288, 10239, 10939, 11033, 11760, 12186, 12581, 13447, 13995, 15092, 15904, 16609, 17283, 17640, 17846, 18134, 18856, 19439, 20539, 22185, 23138, 24335, 24884, 25394, 25865]","[0, 209, 299, 483, 635, 802, 969, 1143, 1279, 1612, 1968, 2058, 2260, 2497, 2988, 3165, 3434, 3857, 4271, 4671, 5101, 5697, 5867, 6675, 7281, 7802, 8047, 8538, 8965, 9484, 9963, 10220, 10320, 10859, 11108, 11335, 11435, 11779, 12699, 13780, 14554, 15354, 15454, 15571, 15939]","[0, 209, 341, 431, 541, 675, 765, 855, 990, 1584, 1764, 1996, 2198, 2533, 2747, 2842, 3300, 3501, 4009, 4341, 4600, 5011, 5144, 5497, 5853, 6146, 6328, 6796, 6892, 7240, 8120, 8399, 8499, 8954, 9167, 9267, 9469, 9605, 11462, 12569, 12913, 13294, 13394, 13494, 13594]",28912,27168,25865,15939,13594,25,102,32,58,3,"[0, 234, 569, 952, 1283, 1606, 1978, 2470, 2900, 3128, 3595, 4186, 4779, 6388, 7149, 7776, 8500, 9036, 9669, 10351, 11010, 12158, 13019, 14411, 15595, 16155, 16680, 17968, 18602, 19308, 19627, 20283, 21355, 23392, 25105, 27922, 28628, 29302, 29573, 29673, 30381, 31445, 31545, 31877, 32451]","[0, 220, 485, 885, 1230, 1393, 1837, 2051, 2461, 2717, 3269, 3618, 4481, 4962, 5197, 5780, 6239, 6783, 6878, 7120, 7777, 8233, 8591, 9107, 9485, 10120, 10525, 11246, 11691, 12361, 12553, 12846, 13107, 13883, 14516, 15116, 15872, 16458, 16663, 16763, 17832, 19424, 20349, 20696, 21308]","[0, 168, 330, 457, 744, 962, 1496, 1670, 2197, 2373, 2542, 2893, 3218, 3865, 4047, 4593, 5200, 5682, 5840, 6164, 6933, 7525, 7779, 8373, 8468, 8755, 9076, 9378, 9729, 10159, 10695, 11010, 11271, 11976, 12672, 14016, 14980, 16284, 16702, 16981, 17674, 18063, 19440, 19966, 20468]","[0, 129, 219, 309, 399, 489, 734, 869, 1049, 1186, 1487, 1631, 1923, 2171, 2353, 2806, 3035, 3449, 3882, 4039, 4224, 4611, 4706, 5032, 5127, 5466, 5769, 6436, 6876, 7276, 7372, 7562, 7823, 8328, 8810, 9531, 10024, 10508, 10626, 10762, 11058, 12068, 12495, 12595, 12695]","[0, 129, 219, 354, 559, 649, 1196, 1368, 1458, 1548, 1956, 2100, 2667, 2835, 3017, 3365, 3568, 3815, 3910, 4232, 4477, 4677, 4772, 5098, 5193, 5288, 5498, 5592, 6056, 6242, 6338, 6528, 6628, 7308, 7743, 8195, 8837, 9240, 9340, 9475, 9945, 11143, 11430, 11530, 11650]",32451,21308,20468,12695,11650,-3539,5860,5397,3244,1944,12906,45,radiant
7546718402,89,102,137,26,45,"[0, 251, 418, 777, 1100, 1441, 1696, 2044, 2369, 2871, 3318, 3754, 4183, 5016, 5732, 6477, 7470, 8424, 9536, 10613, 11370, 12017, 13173, 14042, 14863, 15669, 17282, 18079, 19807, 20849, 22029, 23012, 23202, 24130, 24783, 24917, 26198, 27005, 28136, 29409, 30437, 31475, 31958, 32743, 34119]","[0, 212, 488, 903, 1359, 1814, 2413, 2858, 3308, 4075, 4531, 4984, 5623, 6244, 6721, 7078, 7341, 8483, 9006, 9710, 10256, 10759, 11587, 12218, 12407, 12923, 13596, 14244, 14924, 15311, 15936, 16535, 16725, 17153, 17548, 17648, 17853, 18824, 19375, 19658, 19758, 20362, 21262, 21951, 22378]","[0, 249, 611, 1023, 1404, 2006, 2454, 2856, 3285, 3636, 3981, 4564, 5214, 5720, 6387, 6925, 7455, 8051, 8634, 8953, 9454, 10040, 10910, 11527, 11775, 12715, 13534, 13739, 14263, 14730, 15191, 15381, 15852, 16754, 17184, 17284, 17972, 19261, 19465, 19762, 20541, 20705, 21249, 22256, 22703]","[0, 130, 432, 649, 779, 886, 1041, 1221, 1442, 1855, 1990, 2098, 2505, 2957, 3051, 3286, 3572, 3836, 4026, 4268, 4498, 5237, 5612, 5782, 5877, 6237, 6854, 6949, 7445, 7620, 7908, 8098, 8406, 8568, 8758, 8858, 9199, 9670, 9770, 9870, 10069, 10169, 10508, 10934, 11034]","[0, 130, 220, 401, 563, 698, 788, 1013, 1305, 1523, 1704, 2109, 2328, 2835, 3128, 3288, 3383, 3642, 3905, 4147, 4377, 4607, 4994, 5236, 5553, 5829, 6380, 6475, 6978, 7157, 7366, 7556, 7841, 8147, 8337, 8437, 8537, 8637, 8737, 8903, 9064, 9491, 10065, 10408, 10508]",34119,22378,22703,11034,10508,39,93,129,123,119,"[0, 305, 594, 1054, 1406, 1652, 2104, 2637, 3064, 3409, 3971, 4454, 5080, 5746, 6419, 7018, 7746, 8423, 9121, 9453, 10564, 11394, 12302, 12709, 13357, 14041, 14433, 15163, 15427, 15950, 16645, 17694, 18479, 18934, 20351, 20990, 21648, 23061, 23976, 24751, 25823, 26425, 27005, 27807, 29091]","[0, 280, 408, 698, 879, 1083, 1435, 1709, 1983, 2235, 2708, 3219, 3486, 4086, 4806, 5402, 5894, 6461, 7479, 8223, 8823, 9379, 10006, 10511, 11200, 11917, 12260, 12954, 13094, 13810, 14300, 15115, 16021, 16706, 17991, 19294, 19889, 20443, 21692, 23076, 23778, 24038, 24258, 25854, 26242]","[0, 569, 732, 1085, 1371, 1664, 2440, 2775, 3409, 3892, 4272, 4727, 5240, 5766, 6025, 7167, 8086, 8488, 9552, 10041, 10830, 11351, 11806, 12144, 12823, 13153, 13248, 13764, 14187, 14688, 15358, 16155, 16574, 16920, 17686, 18051, 18599, 18883, 19411, 20242, 20540, 20764, 21024, 21286, 21386]","[0, 265, 406, 496, 626, 716, 938, 1111, 1363, 1721, 2088, 2203, 2293, 2499, 2639, 3308, 3865, 4263, 4528, 5018, 5604, 5752, 6364, 6839, 7073, 7816, 8196, 8563, 8863, 9209, 9920, 10624, 11145, 11843, 13222, 13960, 14472, 15068, 15890, 16897, 17476, 17783, 18170, 19052, 19251]","[0, 265, 391, 562, 692, 782, 872, 996, 1086, 1285, 1475, 1650, 1871, 2014, 2261, 2661, 3054, 3251, 3697, 3792, 4296, 4391, 4648, 4743, 4945, 5218, 5313, 5525, 5667, 5763, 6197, 7333, 7792, 7892, 8802, 9167, 9539, 9639, 10138, 10556, 11362, 11462, 11827, 12035, 12135]",29091,26242,21386,19251,12135,5028,-3864,1317,-8217,-1627,-7363,45,dire
7548094003,48,25,47,105,136,"[0, 284, 526, 954, 1284, 1667, 2078, 2478, 2986, 3416, 4000, 4751, 5355, 6147, 6912, 7349, 8430, 8797, 9468, 9661, 10166, 10647, 11291, 11913, 13098, 13419, 14196, 14698, 16071, 17205, 18235, 19231, 20600, 21409, 21509, 22606, 22706, 23486, 24993, 25399, 26253, 27061, 28391, 29627, 30070]","[0, 207, 547, 893, 1234, 1602, 2025, 2594, 3193, 3460, 4047, 4665, 5152, 5520, 5831, 6253, 7184, 8169, 8625, 9342, 10068, 11048, 11850, 12849, 13132, 13733, 14417, 15033, 15622, 16750, 17301, 17947, 18501, 18763, 20194, 21621, 21945, 22989, 23539, 24224, 25116, 25846, 26307, 26802, 27655]","[2, 206, 409, 663, 1004, 1129, 1483, 1702, 2040, 2400, 3104, 3609, 3908, 4103, 4323, 4684, 5259, 5717, 6106, 6615, 7333, 8254, 8716, 9126, 9623, 10072, 10759, 10898, 11396, 11985, 12406, 13189, 13547, 13903, 14049, 15520, 15792, 16399, 16618, 16923, 17117, 17427, 17679, 18604, 19769]","[0, 169, 295, 385, 700, 840, 1215, 1305, 1484, 1741, 2033, 2276, 2366, 2561, 2656, 2794, 3553, 3738, 3908, 4973, 5206, 5618, 5784, 6103, 6483, 6775, 7159, 7536, 7755, 9286, 9625, 9950, 10342, 10870, 11080, 12027, 12328, 12951, 13173, 13931, 14152, 14449, 14935, 15757, 16429]","[0, 169, 259, 527, 617, 862, 1045, 1163, 1345, 1449, 1690, 1933, 2067, 2282, 2377, 2941, 3099, 3359, 3523, 3618, 4453, 4847, 5106, 5414, 5559, 5654, 5796, 6143, 6239, 6425, 6521, 6711, 6945, 7045, 7145, 7539, 7928, 8274, 8672, 8984, 9632, 9781, 10105, 10205, 10423]",30070,27655,19769,16429,10423,114,106,123,96,79,"[60, 229, 790, 1113, 1399, 1827, 2332, 2947, 3289, 3759, 4304, 4923, 5545, 6208, 6542, 7127, 7516, 8126, 9152, 10179, 10932, 11798, 12548, 13148, 14113, 14994, 15441, 16715, 17781, 17958, 18901, 19984, 22108, 23290, 23757, 24538, 25349, 26206, 27198, 28686, 29405, 30641, 31648, 33119, 34192]","[328, 695, 1052, 1267, 1805, 2102, 2432, 3127, 3568, 4413, 5107, 5511, 6209, 7137, 7286, 7664, 8575, 9188, 9978, 10259, 10801, 11186, 12008, 12179, 13045, 13574, 14225, 14804, 15856, 16165, 16593, 17469, 18885, 20326, 20801, 21555, 21655, 22266, 22366, 23261, 24268, 25462, 26256, 27336, 27673]","[60, 229, 319, 644, 780, 1129, 1264, 1401, 1537, 2201, 2574, 2929, 3204, 3623, 4109, 4526, 5346, 5589, 6204, 6485, 7094, 7422, 7714, 7917, 8975, 9316, 9898, 10446, 11127, 11350, 11995, 12314, 12882, 14105, 14761, 15495, 15808, 16714, 17061, 17892, 17992, 19062, 19886, 21381, 21843]","[60, 302, 640, 1068, 1467, 1966, 2056, 2559, 3058, 3607, 4494, 4659, 5273, 5820, 6020, 6334, 6834, 7166, 7726, 8350, 8667, 9358, 9671, 9914, 10530, 10990, 11450, 12162, 12688, 13240, 13529, 13830, 14729, 15413, 16356, 16694, 17278, 17961, 18544, 19666, 20229, 21163, 22140, 23006, 23214]","[60, 229, 383, 526, 616, 805, 1015, 1298, 1447, 1964, 2559, 3010, 3190, 3439, 3639, 4064, 4402, 4831, 5211, 5702, 6488, 6655, 6891, 7115, 7431, 7829, 8179, 8355, 8781, 8958, 9153, 9343, 10511, 10841, 11076, 12281, 12454, 13201, 13349, 14142, 14242, 14886, 14986, 15211, 15721]",34192,27673,21843,23214,15721,-4122,-18,-2074,-6785,-5298,-18297,45,dire
7548252414,67,22,2,40,20,"[0, 291, 700, 948, 1156, 1450, 1707, 2035, 2448, 2981, 3348, 3853, 4247, 4533, 4894, 5067, 5642, 6361, 6651, 7104, 8239, 8617, 9067, 9941, 10236, 11269, 11709, 12343, 13141, 14296, 15160, 15984, 16618, 17046, 17736, 18634, 19395, 20320, 21144, 22718, 23398, 24326, 25394, 25803, 26817]","[0, 219, 622, 1021, 1375, 1772, 2151, 3091, 3710, 4589, 5051, 6038, 6587, 7112, 7531, 7869, 8412, 9236, 9641, 10418, 11828, 12267, 12629, 12998, 13093, 13743, 14218, 14904, 15167, 15677, 16101, 16608, 17278, 18192, 18797, 19169, 19307, 20030, 20369, 22027, 23257, 23658, 23902, 24166, 24453]","[0, 205, 448, 831, 1235, 1491, 1780, 2272, 2657, 3677, 4111, 4647, 5279, 6037, 6949, 7381, 8181, 9513, 10362, 10622, 11773, 12145, 12882, 13306, 14065, 14539, 14634, 14968, 15168, 15734, 16179, 16955, 17235, 17735, 18004, 18247, 18347, 18969, 19069, 20418, 20518, 21077, 21644, 22211, 22833]","[0, 517, 632, 722, 904, 1004, 1141, 1415, 1505, 1845, 2067, 2389, 2908, 3034, 3444, 3640, 3944, 4587, 5079, 5514, 6035, 6419, 6852, 7396, 7888, 8334, 8477, 8816, 9040, 9445, 9805, 10297, 10912, 11430, 11620, 12117, 12514, 12923, 13541, 14911, 15589, 15797, 16122, 16375, 16701]","[0, 169, 284, 374, 464, 601, 691, 781, 919, 1309, 1444, 1604, 1920, 2191, 2338, 2433, 2771, 3600, 3981, 4138, 4412, 4670, 4765, 4968, 5193, 5470, 5565, 5794, 5890, 6459, 6882, 7182, 7664, 7810, 8206, 8526, 8626, 9035, 9522, 10052, 10152, 10360, 10652, 10906, 11006]",26817,24453,22833,16701,11006,8,97,43,27,121,"[0, 205, 472, 799, 1204, 1587, 1995, 2579, 3091, 3333, 3986, 4237, 4754, 5208, 5659, 6371, 7217, 7477, 8184, 9194, 9457, 9816, 10606, 10921, 11389, 12282, 12596, 13119, 13570, 14017, 14113, 14635, 15505, 16953, 17508, 18345, 18649, 19875, 21203, 22206, 22306, 22911, 23497, 24525, 25809]","[0, 216, 579, 938, 1354, 1928, 2276, 2569, 3113, 3619, 4346, 4686, 5284, 5962, 6471, 7163, 8063, 8295, 8912, 9323, 10288, 10832, 11445, 12011, 13251, 13529, 14376, 14636, 15777, 15873, 15969, 16362, 16462, 17204, 17691, 18205, 18416, 18816, 19592, 20255, 20355, 20794, 20894, 21608, 22190]","[0, 237, 486, 816, 1336, 1465, 1555, 1965, 2295, 2626, 3014, 3351, 3496, 3819, 4343, 4547, 5000, 5247, 5757, 6464, 6939, 7635, 8213, 8347, 9207, 9646, 9959, 10264, 10801, 11108, 11342, 12333, 12777, 13314, 13785, 14233, 14928, 15194, 15393, 16061, 16161, 16455, 16745, 17215, 17918]","[100, 269, 359, 449, 652, 817, 953, 1043, 1178, 1529, 1664, 1875, 2150, 2433, 2695, 2893, 3497, 3820, 4008, 4322, 4653, 5090, 5412, 5554, 6807, 7182, 7309, 7512, 7865, 8344, 8668, 8926, 9026, 9374, 9623, 9939, 10240, 10640, 10839, 12099, 12446, 12669, 12804, 13185, 13656]","[0, 169, 259, 397, 610, 775, 910, 1078, 1256, 1346, 1481, 1571, 1661, 2236, 2432, 2546, 2852, 3272, 3537, 3851, 4162, 4329, 4568, 4817, 5401, 5496, 5591, 5685, 5943, 6039, 6135, 6657, 6806, 7154, 7577, 7961, 8151, 8507, 8706, 8951, 9051, 9151, 9251, 9512, 9939]",25809,22190,17918,13656,9939,1008,2263,4915,3045,1067,12298,45,radiant
7548715213,89,128,2,71,105,"[1, 242, 514, 1008, 1399, 1773, 1972, 2387, 2714, 3304, 3920, 4291, 5080, 5769, 6556, 7375, 8347, 9458, 9838, 10831, 11618, 13101, 14026, 15726, 17008, 18137, 18547, 19234, 19671, 20228, 21205, 22389, 22489, 24722, 26928, 27942, 29597, 29697, 29929, 31592, 33213, 34512, 35652, 36846, 38112]","[1, 291, 659, 1002, 1495, 2196, 2681, 3250, 3726, 4534, 5047, 5479, 5822, 6748, 7637, 8214, 8308, 9319, 10052, 10320, 10838, 11741, 12486, 12932, 13098, 13458, 14398, 14695, 15653, 16539, 16765, 17962, 18709, 20598, 21872, 23079, 24312, 24412, 24512, 25238, 25978, 27325, 27795, 29017, 30712]","[1, 247, 513, 753, 1036, 1345, 1975, 2120, 2827, 3525, 4228, 4751, 5153, 5569, 6569, 7091, 7185, 8111, 8695, 9141, 9377, 10731, 11230, 12282, 13063, 13907, 14337, 15034, 15292, 15951, 16542, 17289, 17701, 18074, 18552, 19422, 21109, 21209, 21917, 22621, 23359, 25373, 26054, 26822, 28283]","[1, 171, 261, 351, 487, 678, 808, 1025, 1160, 1365, 1590, 1887, 2142, 2625, 2774, 3174, 3349, 3764, 4047, 4805, 4918, 5403, 6189, 6613, 7217, 7670, 8625, 9108, 10390, 11054, 11402, 11783, 12528, 13690, 15031, 16026, 16849, 17519, 18694, 19435, 20330, 20778, 21248, 22857, 24042]","[1, 171, 261, 785, 923, 1076, 1206, 1389, 1534, 2006, 2231, 2953, 3475, 3839, 4610, 5264, 5960, 6230, 6388, 6882, 7261, 7829, 8148, 8679, 8928, 9106, 9496, 10266, 11025, 11330, 11826, 12953, 14108, 14471, 14866, 15703, 16106, 16622, 17516, 17616, 18038, 18741, 19880, 20781, 21026]",38112,30712,28283,24042,21026,14,69,53,135,121,"[1, 196, 663, 906, 1268, 1686, 2099, 2575, 2820, 3102, 3286, 3715, 4724, 4872, 5107, 6119, 7291, 7795, 8746, 9383, 10236, 10716, 10883, 12358, 12452, 13112, 13676, 16353, 17000, 18500, 18701, 19033, 19566, 19802, 19902, 20241, 21431, 23516, 24327, 24965, 25591, 27356, 27456, 28008, 28583]","[3, 357, 601, 933, 1315, 1525, 1934, 2104, 2433, 2603, 3198, 3496, 4619, 5193, 5716, 6398, 7701, 8097, 8396, 8852, 9686, 10304, 10680, 11446, 11980, 12365, 13125, 14138, 14743, 15961, 16341, 16795, 17676, 17960, 18412, 18870, 19598, 20180, 21070, 21747, 22254, 23142, 23752, 24957, 25057]","[1, 196, 286, 376, 554, 684, 1105, 1292, 1768, 1858, 2179, 2420, 3063, 3211, 3357, 3569, 4236, 4634, 5179, 5555, 6566, 7197, 7364, 8619, 8713, 9012, 9413, 9679, 9779, 10663, 11079, 11536, 13642, 13742, 14199, 14299, 15916, 17383, 17483, 17803, 18028, 18916, 19016, 20236, 20336]","[1, 231, 360, 687, 854, 1354, 1778, 2154, 2639, 3062, 3513, 3819, 4010, 4158, 4253, 4698, 5209, 5534, 6334, 6743, 7111, 7505, 8111, 8566, 8768, 9141, 9483, 10483, 10579, 11182, 11447, 12664, 13486, 13674, 13824, 13924, 14024, 15054, 15385, 15843, 16138, 16238, 16450, 16974, 17161]","[1, 196, 286, 601, 731, 1184, 1605, 1792, 2052, 2177, 2435, 2572, 3087, 3235, 3330, 3561, 3992, 4213, 4714, 4935, 5343, 5810, 5977, 6144, 6238, 6622, 6925, 8682, 8999, 9345, 9575, 10348, 11190, 11334, 11434, 11534, 12065, 12523, 13110, 13328, 13648, 14076, 14314, 14885, 14985]",28583,25057,20336,17161,14985,9529,5655,7947,6881,6041,36053,45,radiant
7549256701,36,120,28,83,121,"[0, 331, 658, 1074, 1415, 1660, 2150, 2493, 3183, 3397, 3952, 4394, 4745, 5230, 5775, 6051, 6590, 7396, 8098, 8681, 9894, 10184, 10507, 11033, 11241, 12047, 13843, 14557, 15058, 16434, 17117, 18242, 18342, 19644, 20891, 22348, 22689, 23485, 24029, 24535, 25759, 25954, 27471, 29275, 29962]","[0, 322, 730, 1097, 1437, 1685, 1894, 2265, 2614, 3435, 3840, 4412, 5009, 5742, 6277, 6444, 7150, 7780, 8107, 8450, 9151, 9674, 9997, 10336, 10903, 11718, 12600, 13279, 13375, 15838, 16747, 17258, 17975, 18926, 19622, 19866, 20042, 21018, 21785, 22196, 23057, 23927, 25426, 26613, 27199]","[0, 335, 499, 627, 952, 1261, 1691, 2059, 2451, 2721, 3201, 3877, 4342, 5105, 5527, 5694, 6211, 6909, 7434, 7815, 8605, 8764, 9422, 9681, 10946, 11489, 12380, 12982, 13650, 13927, 14489, 14785, 14885, 15622, 15908, 16928, 17125, 18362, 18717, 18817, 19373, 19473, 20698, 20977, 21323]","[0, 210, 405, 541, 631, 937, 1075, 1165, 1345, 1589, 2043, 2133, 2387, 2668, 2985, 3360, 3454, 3639, 3734, 4084, 4546, 4690, 5234, 5606, 6192, 6631, 6726, 6858, 7081, 8571, 9016, 9206, 9306, 9836, 9981, 10656, 10889, 11340, 11781, 12191, 12671, 12942, 14062, 14542, 14642]","[0, 210, 345, 435, 922, 1118, 1208, 1342, 1522, 1917, 2214, 2304, 2438, 2725, 3282, 3622, 3793, 3978, 4109, 4311, 4797, 4892, 5215, 5309, 5530, 5769, 6069, 6218, 6954, 7480, 8162, 8352, 8452, 9081, 9599, 9699, 9799, 9998, 10437, 10586, 10849, 10949, 11410, 12279, 12424]",29962,27199,21323,14642,12424,95,74,60,112,26,"[0, 255, 585, 913, 1305, 1694, 1979, 2573, 2927, 3262, 4012, 4433, 5117, 5855, 6449, 7606, 8280, 9172, 9777, 10500, 11258, 12606, 14690, 15354, 15912, 16806, 17760, 19334, 20341, 20763, 20859, 21603, 22510, 23412, 23978, 24793, 26169, 26874, 27617, 28422, 29924, 31246, 31700, 31800, 32937]","[0, 216, 458, 836, 1213, 1613, 2022, 2355, 2647, 2762, 3001, 3525, 4154, 4496, 5066, 6120, 6681, 7278, 7853, 8353, 8883, 9187, 10730, 11897, 12758, 13714, 14304, 14508, 14659, 14882, 15081, 16480, 16938, 17222, 17956, 18523, 19317, 20030, 20657, 21748, 22333, 23188, 23771, 24807, 25979]","[0, 178, 378, 662, 859, 1034, 1161, 1624, 2089, 2522, 3052, 3611, 3982, 4491, 4892, 5107, 5586, 6029, 6743, 7264, 7609, 7943, 8259, 8799, 9369, 9872, 10223, 10845, 11737, 11962, 12303, 12653, 13061, 13669, 14366, 14767, 15147, 15513, 15970, 16749, 17399, 18025, 18389, 18853, 18953]","[0, 130, 264, 354, 444, 534, 629, 854, 1006, 1096, 1556, 1734, 1978, 2127, 2435, 2831, 3193, 3856, 4404, 4871, 5028, 5575, 6510, 7019, 7738, 8204, 8406, 8826, 9174, 9396, 9552, 9756, 9969, 10571, 11033, 11532, 11979, 12341, 12441, 13323, 13423, 13631, 14291, 15162, 15404]","[0, 130, 220, 310, 400, 538, 628, 808, 898, 998, 1346, 1436, 1670, 1853, 2184, 2740, 3057, 3351, 3851, 4431, 4667, 4981, 5919, 6448, 6887, 7359, 7730, 8241, 8556, 9166, 9337, 9734, 10016, 10212, 10601, 10847, 11286, 11875, 12020, 12666, 13145, 13400, 13751, 13851, 14225]",32937,25979,18953,15404,14225,-2975,1220,2370,-762,-1801,-1948,45,radiant
7549265807,28,92,21,51,5,"[0, 210, 668, 1005, 1326, 1719, 2032, 2615, 2982, 3523, 3854, 4212, 4933, 5534, 6102, 6604, 7296, 7881, 8450, 9011, 9342, 9629, 10608, 10904, 11917, 12340, 13490, 14376, 15156, 15919, 16015, 16491, 16974, 17633, 18806, 19280, 20688, 21459, 22746, 23783, 25430, 26095, 26493, 27871, 28758]","[0, 364, 682, 924, 1257, 1548, 1840, 2157, 2498, 3043, 3611, 4092, 4786, 5427, 5909, 6593, 6857, 7454, 8142, 9130, 9809, 10348, 11109, 11296, 11926, 13032, 13627, 14445, 15376, 15633, 16067, 16716, 17453, 18124, 18823, 19918, 20543, 21295, 21884, 22812, 23899, 24435, 24977, 26096, 27023]","[0, 360, 633, 912, 1134, 1632, 1968, 2459, 2986, 3307, 3877, 4385, 4815, 5611, 6033, 6514, 7123, 8048, 8635, 9665, 9960, 10174, 10773, 10903, 11938, 12778, 13395, 13939, 14668, 15244, 15873, 16754, 17349, 18607, 19786, 20456, 21602, 22640, 23532, 24312, 25053, 25558, 26023, 27879, 28716]","[0, 210, 300, 429, 519, 879, 1052, 1187, 1277, 1491, 1740, 1889, 2374, 2750, 3165, 3433, 3776, 3961, 4314, 4770, 4876, 5043, 5310, 5471, 5595, 5850, 6026, 6233, 6497, 6995, 7395, 7585, 7733, 8647, 9120, 9263, 9952, 10823, 11367, 11813, 12349, 12450, 13314, 14079, 14586]","[0, 210, 300, 454, 544, 674, 886, 1021, 1129, 1491, 1758, 2028, 2216, 2521, 2805, 3665, 3850, 4072, 4491, 5069, 5341, 5552, 5814, 5909, 6399, 6689, 6865, 7034, 7324, 7708, 7923, 8599, 8814, 9577, 9915, 10079, 10352, 10811, 11324, 11581, 12281, 12418, 12653, 12861, 13050]",28758,27023,28716,14586,13050,10,106,69,123,110,"[0, 169, 496, 817, 1133, 1378, 1867, 2391, 2833, 3299, 3820, 4314, 4894, 5386, 5886, 6600, 7036, 7637, 8460, 9290, 10240, 11483, 12441, 12698, 13282, 14290, 15139, 16166, 17001, 17964, 19167, 20546, 21128, 21627, 21726, 22477, 22598, 23568, 23829, 24897, 25763, 26039, 27189, 28070, 28482]","[0, 257, 559, 886, 1139, 1380, 1676, 1905, 2457, 2602, 2868, 3182, 3445, 3984, 4652, 4918, 5196, 5931, 6205, 6935, 7271, 8295, 8717, 9325, 9554, 10197, 10718, 11492, 12216, 12897, 13976, 14402, 14964, 15407, 15506, 16604, 16742, 17213, 17528, 17627, 18407, 18968, 19904, 20689, 21064]","[0, 205, 332, 529, 804, 1168, 1758, 2233, 2541, 2887, 3367, 3934, 4428, 4826, 5257, 6018, 6414, 7061, 7566, 7904, 8293, 9178, 9985, 10290, 10804, 11261, 11592, 12326, 12940, 13461, 14517, 15235, 15516, 16116, 16641, 17814, 18073, 18281, 18719, 19248, 19787, 19888, 20238, 20725, 20852]","[0, 178, 307, 469, 908, 1024, 1277, 1412, 1502, 1646, 1970, 2287, 2585, 2987, 3140, 3325, 3419, 3810, 4128, 4331, 4425, 4923, 5536, 5631, 6088, 6382, 6477, 6681, 6969, 7279, 7785, 7975, 8075, 8310, 8409, 8823, 8922, 9022, 9322, 9421, 9732, 9998, 10299, 10814, 11385]","[0, 174, 264, 414, 737, 870, 1101, 1308, 1482, 1621, 1796, 2180, 2402, 2741, 2957, 3142, 3345, 3618, 4011, 4262, 4477, 5198, 5556, 5651, 5914, 6113, 6208, 6491, 6779, 7199, 7295, 7660, 7884, 8119, 8278, 9027, 9408, 9508, 9609, 9708, 9808, 9909, 10045, 10322, 10422]",28482,21064,20852,11385,10422,276,5959,7864,3201,2628,19928,45,radiant
7549846718,19,93,69,45,121,"[0, 359, 700, 1097, 1508, 1795, 2223, 2921, 3339, 4016, 4344, 4586, 5409, 5905, 6077, 6725, 7393, 7534, 8018, 8457, 8663, 9110, 9621, 10286, 10862, 11533, 11918, 12824, 13434, 13587, 14502, 15502, 16490, 16992, 17092, 17882, 18213, 18869, 19270, 19616, 20421, 21536, 22699, 23537, 24170]","[0, 204, 560, 924, 1175, 1389, 1680, 1924, 2184, 2566, 3065, 3751, 4131, 5054, 5432, 5938, 6673, 7199, 7688, 8516, 9075, 9642, 9737, 10243, 11185, 12012, 12840, 13224, 13496, 13706, 14017, 15426, 16091, 16731, 16991, 18093, 18868, 19479, 19879, 20739, 21380, 21699, 22431, 23259, 23489]","[0, 208, 375, 684, 895, 1207, 1612, 1936, 2425, 2705, 3236, 3722, 4346, 5029, 5201, 5471, 5949, 6554, 6960, 7802, 8278, 8827, 9082, 9841, 10161, 10635, 11090, 11780, 12134, 12230, 13014, 15109, 15685, 15863, 16123, 16996, 17417, 17793, 18468, 18568, 18668, 18840, 19498, 20040, 20546]","[0, 269, 405, 540, 718, 808, 1249, 1386, 1601, 1844, 2135, 2426, 2844, 3482, 3982, 4076, 4655, 4803, 5389, 5911, 6006, 6586, 6811, 7081, 7176, 7399, 7694, 7995, 8147, 8410, 8928, 9512, 10065, 10165, 10265, 10753, 11094, 11194, 11782, 11882, 11982, 12262, 12684, 13177, 13277]","[0, 218, 355, 567, 657, 794, 976, 1277, 1367, 1536, 1992, 2136, 2531, 2871, 3090, 3312, 3605, 3700, 3961, 4448, 4543, 4748, 4843, 5326, 5480, 5722, 6345, 6515, 6686, 6857, 7243, 7949, 8412, 8587, 8762, 9213, 9388, 9724, 10147, 10311, 10423, 10570, 11106, 11394, 11569]",24170,23489,20546,13277,11569,25,22,49,123,30,"[0, 280, 997, 1306, 1648, 1979, 2398, 2953, 3253, 3727, 3969, 4491, 4914, 5451, 6441, 6845, 7456, 8221, 8384, 9229, 10120, 10864, 11131, 11663, 12008, 12731, 13449, 14533, 15516, 16883, 17419, 17629, 17729, 18544, 19169, 19429, 21184, 22591, 24069, 24751, 26124, 27121, 28113, 29554, 29888]","[0, 241, 578, 964, 1375, 1788, 2276, 2696, 3065, 3915, 4139, 4827, 5130, 5562, 6485, 6832, 7334, 8064, 8383, 9333, 10176, 10752, 11125, 11724, 12538, 13440, 13730, 14355, 15072, 15678, 16176, 16582, 16682, 16865, 17343, 17637, 18887, 19453, 20843, 20943, 21834, 22534, 22828, 23144, 23550]","[0, 239, 509, 825, 1141, 1685, 2066, 2560, 3129, 3755, 4096, 4384, 4712, 5109, 5576, 5729, 6549, 6987, 7343, 7734, 8221, 8574, 9365, 11037, 11511, 12011, 12393, 12678, 13212, 13977, 14428, 14650, 15052, 15350, 15668, 16059, 16789, 17655, 18484, 18584, 19179, 19936, 20577, 21405, 22005]","[0, 169, 259, 349, 553, 996, 1086, 1266, 1356, 1611, 1766, 2215, 2667, 2762, 3152, 3283, 3776, 4116, 4523, 4904, 5232, 5618, 5713, 6935, 7507, 8010, 8337, 8576, 9189, 9825, 10076, 10618, 10718, 11085, 11365, 11995, 13719, 14433, 15228, 15577, 16217, 16806, 16906, 17582, 17874]","[0, 169, 546, 636, 775, 905, 1041, 1221, 1311, 1566, 1701, 2009, 2144, 2287, 2594, 2971, 3297, 3661, 3756, 4085, 4243, 4448, 4543, 4903, 5195, 5595, 5965, 6170, 6428, 6862, 7158, 7337, 7437, 7934, 8214, 8404, 9631, 10183, 11028, 11383, 12037, 12292, 12392, 13008, 13233]",29888,23550,22005,17874,13233,-5718,-61,-1459,-4597,-1664,-13499,45,dire
7549866219,19,128,69,51,79,"[0, 203, 487, 749, 1082, 1333, 1724, 2226, 2635, 3375, 3738, 4806, 5342, 6128, 6683, 7251, 8366, 9043, 9138, 9944, 10288, 10802, 12246, 13174, 13668, 14369, 14534, 15418, 15968, 16401, 16971, 17646, 18147, 19228, 20443, 21512, 22062, 23222, 24570, 24982, 25400, 26481, 27636, 28607, 30326]","[0, 239, 520, 1076, 1367, 1590, 1862, 2392, 2775, 3321, 3752, 4421, 5060, 5495, 6462, 7148, 7799, 8807, 9119, 9768, 10339, 11100, 11386, 12475, 12795, 13141, 13898, 14595, 15323, 15827, 16817, 17393, 18048, 18334, 19080, 20324, 21143, 23033, 23633, 24427, 25493, 26445, 26997, 27976, 29150]","[0, 253, 774, 1206, 1647, 1988, 2664, 3410, 4188, 4698, 5476, 6319, 7143, 7750, 8256, 8687, 9105, 9854, 10419, 11174, 11854, 12409, 13682, 14182, 14527, 14913, 15624, 16329, 16838, 18727, 19259, 20108, 20597, 21175, 21423, 22350, 22903, 23753, 24018, 24377, 25429, 25797, 26082, 26372, 27178]","[0, 202, 310, 734, 938, 1028, 1192, 1484, 1907, 2267, 2562, 2973, 3293, 3874, 4403, 4497, 4829, 5362, 5457, 5869, 6059, 6330, 7009, 7513, 7683, 8058, 8227, 8924, 9413, 9930, 10101, 10763, 11279, 11590, 12081, 12256, 12887, 13907, 14544, 15063, 15879, 16494, 17367, 17776, 18593]","[0, 169, 617, 1095, 1185, 1552, 1716, 2346, 2819, 2983, 3211, 3757, 4121, 4469, 4716, 4982, 5215, 5545, 5640, 6513, 6708, 6875, 7440, 7678, 7773, 8111, 8316, 8792, 9091, 9671, 9970, 10509, 10755, 10909, 11084, 11264, 11664, 12005, 12528, 12854, 13262, 13605, 13942, 14539, 14887]",30326,29150,27178,18593,14887,12,25,45,38,121,"[0, 358, 817, 907, 1285, 1632, 2372, 2576, 3151, 3640, 3959, 4414, 4897, 5221, 5580, 5938, 6587, 7132, 8703, 9223, 10207, 10850, 11017, 11697, 13008, 14158, 14554, 15357, 16086, 16774, 17236, 18052, 18452, 19333, 20531, 20667, 21277, 22359, 22783, 23506, 24707, 25708, 26672, 27796, 30082]","[0, 349, 718, 1047, 1455, 1905, 2378, 2859, 3258, 3676, 4285, 5061, 5151, 5474, 5959, 6380, 6835, 7020, 8042, 8833, 10000, 10215, 10809, 11501, 12335, 13070, 14536, 15311, 16116, 16340, 16770, 17226, 18220, 18829, 20104, 20711, 21397, 22620, 23392, 23995, 24095, 24675, 25332, 26749, 27799]","[0, 422, 512, 715, 853, 986, 1215, 1579, 1769, 1960, 2233, 2436, 2526, 3067, 3626, 4028, 4471, 5253, 6251, 6345, 7096, 7282, 7433, 7837, 8474, 8991, 9314, 9717, 10281, 10699, 10795, 10895, 11668, 11997, 12525, 12674, 13149, 13660, 13908, 14108, 15191, 15933, 16413, 16780, 17470]","[0, 323, 522, 886, 1174, 1410, 1902, 2148, 2506, 2647, 3125, 3475, 3604, 4075, 4676, 4818, 4976, 5434, 6535, 6708, 6991, 7314, 8548, 8848, 9459, 10402, 10925, 11677, 11977, 12453, 12549, 12649, 12864, 12964, 13718, 14101, 14441, 14674, 15041, 15366, 16087, 16378, 17008, 17859, 18259]","[0, 553, 770, 910, 1092, 1202, 1443, 1773, 1908, 1998, 2191, 2394, 2652, 2837, 3086, 3248, 3431, 3616, 4173, 4283, 4604, 4699, 4794, 5109, 5637, 6167, 6396, 6691, 6912, 7135, 7280, 7419, 7793, 8401, 8852, 8952, 9378, 9889, 9989, 10089, 10189, 10397, 10777, 11144, 11717]",30082,27799,17470,18259,11717,244,1351,9708,334,3170,14807,45,dire
7550266815,46,93,96,105,83,"[243, 606, 958, 1360, 1743, 2277, 2670, 3122, 3451, 4080, 4424, 5142, 6001, 6720, 7024, 7825, 8593, 9240, 9700, 10590, 11832, 12499, 13117, 14008, 14817, 16057, 16682, 17724, 18428, 19520, 20454, 21819, 22686, 23356, 24577, 26375, 26655, 27245, 28106, 29088, 30236, 32506, 33402, 34189, 34958]","[285, 589, 927, 1267, 1590, 2083, 2549, 2961, 3601, 4089, 4576, 5141, 6247, 6755, 6903, 7421, 8399, 8860, 9608, 10198, 10650, 11501, 12134, 12605, 13436, 14014, 14386, 15184, 16034, 16489, 17582, 18094, 18534, 18724, 19779, 20491, 21173, 21806, 22895, 23545, 24486, 26197, 26297, 26590, 27516]","[287, 495, 820, 1103, 1425, 2172, 2262, 2864, 3239, 3901, 4490, 5018, 5717, 6159, 6534, 6989, 7413, 7909, 9051, 9305, 9690, 10652, 11531, 12223, 12783, 13687, 14540, 15132, 15715, 16209, 16830, 17590, 18002, 18192, 19239, 19904, 20826, 21352, 22449, 23375, 23927, 25051, 25151, 25251, 25741]","[169, 259, 349, 483, 926, 1152, 1320, 1495, 1630, 2104, 2323, 2541, 2780, 2964, 3195, 4047, 4646, 5314, 5635, 6114, 6740, 6979, 7437, 7749, 7979, 8435, 8847, 9186, 9449, 9553, 9924, 10449, 10993, 11667, 12251, 13102, 13690, 14036, 15195, 15943, 16625, 18151, 18579, 19091, 20243]","[269, 359, 548, 674, 784, 919, 1009, 1401, 1581, 1884, 2064, 2154, 2497, 2708, 2904, 3541, 3864, 3959, 4643, 4997, 5274, 5691, 6468, 6848, 7113, 7579, 7779, 8174, 8380, 8476, 8711, 9063, 9163, 9353, 9937, 10471, 10755, 10952, 11369, 11810, 12318, 13442, 13913, 14013, 14329]",34958,27516,25741,20243,14329,15,41,13,53,19,"[203, 440, 756, 891, 1285, 1702, 2151, 2449, 2836, 3260, 3828, 4150, 4800, 5537, 6466, 6968, 7481, 8006, 8367, 8711, 9318, 10014, 10502, 10636, 11005, 11660, 12611, 13121, 13764, 14277, 15055, 16070, 16724, 17274, 17464, 17815, 18873, 19583, 19905, 20629, 21260, 22072, 22841, 23366, 23867]","[331, 533, 839, 1230, 1667, 1957, 2554, 2821, 3091, 3560, 4155, 4425, 4735, 5344, 6084, 6662, 7022, 7483, 8309, 8919, 9900, 10662, 11054, 11517, 12126, 13028, 13831, 14585, 14880, 15240, 15516, 16008, 17219, 17561, 17751, 17851, 18695, 19183, 19879, 20548, 20768, 21280, 22501, 23152, 23754]","[239, 488, 810, 1095, 1410, 1710, 2281, 2533, 2835, 3017, 3890, 4217, 4807, 5313, 6397, 6760, 7421, 7731, 8685, 9190, 9702, 10479, 11011, 11362, 12177, 13312, 14034, 14654, 15134, 15754, 15854, 16151, 16506, 16984, 17432, 17949, 19055, 19342, 19769, 19869, 20631, 21300, 21858, 22450, 23291]","[169, 259, 425, 562, 736, 965, 1322, 1412, 1541, 1795, 2191, 2499, 3084, 3445, 3985, 4143, 4496, 4693, 4912, 5007, 5268, 5671, 6152, 6351, 6686, 6971, 7304, 7643, 8214, 8457, 8601, 9200, 10006, 11165, 11430, 11967, 12425, 12688, 12872, 13034, 13493, 14275, 15009, 15887, 16299]","[169, 338, 543, 683, 920, 1055, 1280, 1459, 1549, 1664, 2060, 2150, 2476, 2877, 3348, 3593, 3851, 4194, 4838, 5019, 5114, 5281, 5561, 5771, 6210, 6394, 6525, 6751, 6872, 7182, 7282, 7603, 8083, 8320, 8510, 8610, 9007, 9107, 9252, 9540, 10189, 10995, 11586, 11841, 12246]",23867,23754,23291,16299,12246,11091,3762,2450,3944,2083,23330,45,radiant
7550385619,106,41,7,53,121,"[0, 539, 839, 1251, 1413, 1899, 2268, 2660, 3039, 3496, 3905, 4278, 4903, 5120, 5586, 6081, 6688, 7294, 7552, 8092, 8604, 8933, 9811, 10481, 11168, 12114, 12898, 13524, 14186, 15836, 16726, 17487, 17726, 18537, 18919, 20127, 21059, 21749, 22271, 23798, 26124, 26917, 27521, 27729, 28257]","[0, 278, 475, 726, 1008, 1291, 1604, 1894, 2234, 2399, 3166, 3588, 4161, 4660, 5205, 5676, 6325, 6911, 7452, 8025, 8323, 8786, 9541, 10272, 10704, 11128, 12209, 12976, 13560, 14387, 15062, 15905, 16565, 17505, 17765, 18681, 19289, 19970, 20911, 22288, 23579, 24136, 24959, 26088, 26566]","[0, 244, 474, 784, 1150, 1507, 1753, 2427, 2685, 3112, 3511, 4166, 4681, 5021, 5596, 6158, 7424, 8061, 8155, 8728, 9030, 9894, 10202, 10723, 11131, 11672, 12239, 12747, 13085, 14286, 14819, 16170, 16535, 17697, 18694, 19317, 20790, 20989, 21437, 22071, 23735, 24321, 24794, 25370, 25820]","[0, 271, 361, 734, 941, 1157, 1297, 1867, 2001, 2204, 2538, 2702, 3180, 3322, 3516, 3842, 4870, 5048, 5637, 5831, 5926, 6133, 6317, 6834, 7058, 7291, 8117, 8597, 8840, 9584, 10096, 10606, 10798, 11006, 11473, 12235, 13407, 14035, 14431, 15287, 16691, 17219, 17871, 18079, 18777]","[0, 315, 450, 773, 863, 1079, 1169, 1417, 1541, 2038, 2356, 2730, 3037, 3180, 3274, 3622, 4008, 4103, 4197, 4400, 4620, 4715, 4899, 5158, 5253, 5530, 6129, 6224, 6439, 7504, 7933, 8342, 8608, 9307, 9839, 10319, 11315, 11514, 12075, 12842, 13934, 14281, 14802, 15461, 16261]",28257,26566,25820,18777,16261,49,98,21,58,19,"[0, 202, 523, 837, 1244, 1608, 1909, 2409, 2942, 3236, 3508, 3901, 4565, 5284, 5874, 6376, 6773, 7461, 7851, 8583, 9666, 10230, 11102, 11364, 12201, 13146, 13555, 14504, 15033, 15270, 15636, 16469, 17091, 17823, 18996, 19384, 19528, 19807, 20638, 20900, 21000, 22053, 23493, 24387, 25235]","[0, 287, 531, 949, 1219, 1516, 1753, 1959, 2366, 2845, 3059, 3525, 4245, 4620, 4927, 5460, 6299, 6669, 7261, 8107, 8888, 9573, 9874, 10509, 11284, 11657, 12107, 12202, 12950, 13658, 14269, 15185, 15968, 17548, 18841, 19178, 19466, 20598, 21119, 21946, 22561, 22807, 24912, 25341, 26180]","[0, 248, 478, 725, 1234, 1438, 1775, 1981, 2770, 2958, 3338, 3866, 4152, 5046, 5493, 5923, 6864, 7646, 8288, 8718, 9716, 10242, 10703, 11524, 12252, 12811, 13609, 14197, 14714, 15282, 15438, 16036, 16396, 16831, 17224, 17429, 17636, 19056, 20155, 20925, 21025, 21626, 21726, 21826, 22387]","[0, 130, 263, 390, 525, 769, 859, 1004, 1215, 1420, 1591, 1718, 2344, 2786, 3080, 3422, 4028, 4248, 4595, 4944, 5200, 5463, 5778, 6682, 7383, 7794, 8148, 8514, 8892, 9727, 9862, 10291, 10557, 10657, 11095, 11195, 11295, 11770, 11995, 12293, 12393, 12630, 13733, 14145, 14528]","[0, 130, 269, 359, 604, 1011, 1220, 1402, 1664, 1876, 2252, 2352, 2532, 2825, 3205, 3514, 4105, 4400, 4584, 4742, 5229, 5324, 5684, 5944, 6221, 6426, 6914, 7009, 7186, 7407, 7661, 7897, 8284, 8974, 9299, 9399, 9499, 9928, 10211, 10445, 10610, 10774, 11152, 11287, 11785]",25235,26180,22387,14528,11785,3022,386,3433,4249,4476,15566,45,radiant
7553654119,90,32,97,45,83,"[410, 738, 1073, 1460, 1828, 2350, 2942, 3416, 4021, 4318, 4949, 5523, 6341, 7435, 7873, 8286, 9052, 9750, 10886, 11319, 11821, 12272, 12790, 13593, 14622, 15966, 16494, 17221, 17592, 18360, 18752, 19647, 20379, 20974, 22020, 22503, 22911, 24434, 25447, 26544, 28536, 29520, 30802, 31892, 32981]","[144, 431, 628, 849, 1140, 1492, 1713, 2085, 2363, 2621, 3016, 3310, 3798, 4566, 4935, 5400, 5711, 6614, 7081, 7742, 8169, 8595, 8816, 9279, 9922, 10279, 10858, 12006, 12267, 12826, 12922, 13636, 14774, 15703, 16056, 16716, 17652, 18819, 20004, 21592, 23014, 23851, 25102, 25202, 25582]","[144, 350, 582, 732, 1320, 1582, 2111, 2860, 3294, 3818, 4324, 4782, 5705, 6345, 7065, 7591, 8739, 9343, 9911, 10447, 10811, 11520, 11702, 12311, 12840, 13081, 13730, 14449, 14816, 15187, 15283, 15653, 16047, 16454, 17100, 17200, 17509, 18301, 18401, 19015, 20013, 20534, 20867, 20967, 21556]","[144, 463, 553, 703, 793, 912, 1096, 1383, 1489, 1579, 1971, 2146, 2402, 2658, 2870, 3174, 3731, 4326, 4681, 4954, 5256, 5636, 5731, 5993, 6263, 6620, 7179, 7366, 7462, 7648, 7744, 8194, 8987, 9298, 9853, 10091, 10191, 11322, 11799, 12761, 14021, 14267, 15173, 15393, 15702]","[72, 242, 332, 532, 666, 756, 1024, 1199, 1336, 1426, 1562, 1768, 2002, 2491, 2679, 2939, 3424, 3983, 4494, 4767, 4861, 5064, 5246, 5341, 5611, 5995, 6274, 6369, 6465, 6651, 6747, 7163, 7578, 7678, 7868, 8145, 8245, 9324, 9424, 10435, 11294, 11493, 12399, 12499, 12599]",32981,25582,21556,15702,12599,120,21,51,23,112,"[119, 433, 803, 1048, 1638, 2094, 2586, 2879, 3517, 3973, 4588, 4906, 5611, 6112, 6725, 7247, 8092, 8464, 9323, 10094, 11590, 12556, 13689, 14240, 14754, 15123, 15909, 17102, 17788, 18215, 19420, 20106, 21293, 22007, 23034, 23837, 24625, 25441, 25541, 26669, 27339, 27736, 28663, 30015, 30732]","[119, 386, 754, 1171, 1597, 1910, 2270, 2574, 2748, 3309, 3733, 4047, 4666, 5212, 5614, 6078, 7154, 7371, 7933, 9118, 10011, 10268, 11947, 12699, 12906, 14021, 14363, 15124, 15859, 16413, 17675, 18720, 19205, 19658, 20247, 20725, 21096, 21677, 22052, 22917, 23017, 23304, 24801, 25677, 26214]","[119, 348, 438, 595, 760, 1060, 1158, 1280, 1428, 1518, 1792, 2005, 2272, 2508, 2603, 2907, 3313, 3407, 3666, 4216, 4755, 4850, 5793, 6510, 6713, 7694, 8199, 9310, 9697, 10331, 11666, 11971, 12448, 12548, 13193, 13593, 14131, 14772, 15591, 16306, 16406, 17128, 18055, 19099, 19307]","[252, 382, 764, 1120, 1475, 1761, 2109, 2593, 3290, 3737, 4147, 4634, 5372, 5886, 5981, 6867, 7275, 7538, 7827, 8673, 9256, 9827, 10613, 11241, 11435, 12096, 12878, 13769, 14176, 14362, 15500, 16057, 16413, 16627, 17275, 18168, 18479, 19002, 19102, 19609, 19709, 20012, 21023, 21447, 22310]","[387, 714, 804, 1005, 1180, 1305, 1444, 1582, 1845, 1956, 2400, 2572, 2817, 3291, 3482, 3850, 4374, 4484, 4890, 5487, 6227, 6390, 6996, 7252, 7530, 8895, 9363, 9825, 10419, 10724, 11801, 12441, 12943, 13043, 13906, 14190, 14290, 14390, 15163, 15724, 15824, 15924, 17529, 17953, 18366]",30732,26214,19307,22310,18366,2249,-632,2249,-6608,-5767,-8509,45,dire
7554078113,89,19,14,128,26,"[364, 954, 1083, 1407, 1688, 2004, 2189, 2591, 2826, 3437, 3868, 4605, 5453, 6039, 6976, 8009, 8432, 9137, 9848, 10782, 11646, 12759, 13952, 15293, 16659, 17433, 19158, 20128, 20648, 21183, 22391, 24256, 24971, 25710, 26008, 27697, 27797, 27897, 29385, 30528, 32083, 34021, 35624, 36577, 37037]","[569, 830, 1126, 1491, 2267, 2760, 3172, 3735, 4654, 5351, 5841, 5971, 6616, 6710, 7312, 8165, 9019, 9516, 10102, 10197, 11002, 12472, 13006, 13370, 14027, 14379, 15569, 16846, 17105, 17578, 18132, 20143, 21102, 21649, 21947, 22639, 23460, 24351, 25047, 26235, 26573, 27386, 28463, 29102, 30416]","[365, 812, 1125, 1290, 1773, 2065, 2286, 2687, 3223, 3769, 4320, 5306, 5837, 6030, 6575, 6917, 7848, 8109, 8544, 8823, 9276, 10334, 10612, 11199, 12158, 12755, 13810, 14430, 14801, 15535, 15898, 16820, 17265, 17986, 18459, 18857, 19031, 19131, 19457, 19882, 20178, 20748, 21064, 21373, 22150]","[305, 440, 657, 747, 982, 1168, 1306, 1497, 1843, 2115, 2642, 2990, 3193, 3287, 3542, 3781, 4107, 4266, 4728, 4948, 5181, 5927, 6169, 6411, 7081, 7394, 8080, 8939, 9300, 9569, 9806, 10471, 10709, 11327, 12228, 13061, 13389, 13967, 14475, 15071, 15171, 15757, 15907, 16545, 17060]","[357, 609, 699, 789, 879, 1059, 1324, 1563, 1837, 2117, 2393, 2626, 2829, 2923, 3243, 3474, 3675, 3941, 4099, 4194, 4483, 4758, 4925, 5092, 5571, 5666, 6145, 6689, 6948, 7077, 7316, 7853, 8063, 8485, 8865, 9263, 9500, 9600, 9961, 10157, 10453, 10769, 11064, 11319, 11828]",37037,30416,22150,17060,11828,21,120,102,123,85,"[879, 1163, 1798, 2256, 2721, 3225, 3826, 4488, 5212, 5703, 6210, 6950, 7223, 7855, 8397, 9038, 9505, 9797, 10559, 10897, 11601, 12183, 12497, 12828, 13126, 13332, 13866, 14350, 15080, 15444, 15853, 17185, 17749, 18916, 19963, 21134, 22625, 23390, 24100, 25048, 25603, 26132, 26710, 27128, 29518]","[534, 696, 1032, 1419, 1543, 2360, 2909, 3423, 3894, 4594, 4842, 5516, 5965, 6659, 7709, 8569, 9162, 9605, 10310, 10850, 11432, 11527, 12133, 12546, 13168, 13797, 14118, 14380, 15583, 16136, 16479, 16952, 17443, 18745, 19515, 20089, 21307, 22282, 23168, 23512, 24305, 24847, 25359, 25900, 27324]","[509, 649, 1022, 1244, 1843, 2416, 2926, 3190, 3712, 4313, 4632, 5571, 6302, 6563, 7535, 8125, 8767, 9376, 9921, 10561, 11099, 11376, 11748, 12778, 13530, 14100, 14415, 15136, 17415, 18205, 18731, 18975, 19113, 20072, 20307, 20997, 22351, 23069, 23966, 24640, 25610, 25710, 26772, 27439, 29033]","[370, 460, 887, 1035, 1200, 1521, 1631, 1971, 2177, 2441, 2746, 3478, 3617, 3995, 4599, 4829, 4924, 5018, 5176, 5339, 5617, 5953, 6217, 6447, 6861, 6956, 7169, 7452, 8523, 8905, 9005, 9105, 9759, 10147, 11151, 11587, 11933, 12143, 12855, 13063, 13503, 14013, 14454, 15045, 16533]","[550, 739, 957, 1093, 1476, 1656, 1816, 2052, 2292, 2472, 2708, 3534, 3673, 4470, 4968, 5153, 5351, 5533, 5691, 5887, 6079, 6281, 6644, 7202, 7673, 7843, 8095, 8572, 8743, 9248, 9423, 9598, 9773, 11143, 11699, 11922, 12996, 13481, 13824, 14067, 14319, 14777, 15196, 15342, 16362]",29518,27324,29033,16533,16362,7519,3092,-6883,527,-4534,-279,45,radiant
7555172308,73,90,112,110,97,"[58, 649, 1043, 1412, 1758, 2061, 2670, 3270, 3843, 4562, 5151, 6151, 6790, 7777, 8799, 9817, 10807, 11146, 12656, 13718, 13827, 14784, 15157, 15396, 17095, 18543, 19017, 19112, 20750, 21796, 23517, 24569, 26409, 27727, 29349, 30654, 31302, 31964, 33103, 33873, 35346, 35662, 36432, 37989, 38450]","[58, 430, 631, 1099, 1398, 1658, 1926, 2913, 3366, 3887, 4221, 4692, 5405, 5988, 6276, 6920, 7575, 8398, 9073, 9532, 10088, 10840, 11007, 11749, 12516, 13118, 13377, 13917, 15266, 15885, 16670, 17718, 18391, 18793, 19472, 21006, 21265, 21722, 22759, 23418, 24545, 25183, 27163, 28145, 28542]","[58, 228, 318, 408, 542, 704, 1203, 1562, 2059, 2230, 2616, 2815, 3017, 3848, 4453, 5100, 5407, 5948, 6684, 7582, 7752, 8460, 9150, 9317, 9984, 10582, 10714, 10809, 11168, 11345, 12325, 12847, 13037, 13324, 14197, 15011, 15517, 15866, 16456, 16816, 17328, 17846, 18513, 19338, 19523]","[58, 294, 583, 876, 1172, 1329, 1671, 1984, 2109, 2236, 2616, 2706, 2796, 3194, 3788, 4160, 4836, 5286, 6179, 6852, 7097, 7441, 8072, 8929, 9678, 10280, 10598, 10768, 12108, 12613, 13337, 14050, 14545, 14855, 15433, 16514, 17003, 17184, 17758, 18022, 18736, 19283, 19988, 20491, 20591]","[326, 583, 822, 985, 1263, 1471, 1763, 2185, 2312, 2614, 2812, 3180, 3501, 3976, 4413, 5087, 5316, 5579, 6037, 6481, 6651, 6944, 7455, 8026, 8484, 9338, 9433, 10054, 10746, 11457, 12070, 12814, 13425, 13525, 15182, 16439, 16936, 17083, 17587, 17973, 18404, 18965, 19808, 20196, 20565]",38450,28542,19523,20591,20565,113,98,29,45,47,"[0, 283, 526, 906, 1201, 1530, 2089, 2385, 2924, 3712, 4229, 4883, 5450, 6138, 6675, 7144, 7624, 8497, 8865, 9314, 10046, 10842, 12004, 12466, 13034, 13479, 14946, 15957, 16187, 16443, 17003, 17193, 18221, 18712, 18972, 19162, 19969, 20504, 21140, 21851, 22722, 22822, 23467, 24358, 24965]","[154, 324, 645, 861, 1282, 1804, 2098, 2515, 2922, 3441, 4086, 4837, 5353, 6061, 6495, 6789, 6947, 7759, 7854, 8235, 9776, 10115, 10419, 11242, 11700, 12073, 13176, 13847, 14598, 15126, 15357, 16055, 16675, 16775, 16875, 17980, 18586, 19247, 19717, 20013, 21827, 22880, 23313, 24340, 24655]","[0, 598, 774, 1070, 1486, 1784, 2715, 2839, 3374, 3869, 4597, 5126, 6041, 6516, 6769, 7334, 7776, 8691, 9320, 9875, 10904, 11407, 12234, 12924, 13135, 13329, 14400, 14964, 15433, 15529, 15723, 15913, 16471, 16728, 17037, 17542, 18136, 18828, 19483, 19895, 20606, 21055, 21559, 22226, 22549]","[154, 324, 448, 586, 725, 965, 1233, 1367, 1457, 1593, 2122, 2457, 2754, 2902, 3507, 3662, 3820, 4474, 4768, 5227, 6896, 7089, 7427, 8077, 8171, 8266, 9727, 10522, 10896, 11355, 11523, 11766, 12533, 13077, 13177, 13538, 13838, 14461, 14945, 15299, 16268, 17032, 17279, 17379, 17674]","[0, 332, 422, 512, 602, 692, 1006, 1133, 1350, 1440, 1803, 2138, 2247, 2715, 3179, 3446, 3604, 3885, 3980, 4231, 4605, 4699, 5003, 5630, 5724, 5819, 7185, 7553, 7960, 8180, 8477, 8667, 9225, 9575, 9791, 10179, 10587, 10979, 11274, 11412, 12444, 12899, 13229, 13520, 13620]",24965,24655,22549,17674,13620,13485,3887,-3026,2917,6945,24208,45,radiant
7555314400,46,106,45,123,83,"[523, 734, 1059, 1430, 1846, 2342, 2706, 3376, 3981, 4652, 5226, 6079, 6533, 7500, 7844, 8182, 8629, 9418, 10452, 11327, 11933, 12323, 13379, 14080, 15186, 15890, 16230, 16795, 17554, 17992, 19240, 19890, 20755, 21402, 21502, 22360, 23436, 23749, 24221, 25003, 26716, 27532, 28217, 28730, 29430]","[514, 757, 1075, 1354, 1641, 1892, 2178, 2476, 2942, 3428, 3892, 4291, 4800, 5194, 5932, 6707, 7496, 7793, 8286, 8575, 9334, 9600, 9949, 10686, 11995, 12390, 12747, 13257, 13744, 14187, 14951, 15796, 15896, 16182, 16282, 17281, 17480, 17825, 17999, 18473, 18980, 19678, 20279, 20501, 20963]","[586, 1000, 1683, 1862, 2189, 2618, 3066, 3156, 3871, 4624, 5062, 5822, 6069, 6491, 6966, 7295, 8122, 8613, 9363, 10126, 10476, 10661, 11337, 12384, 12796, 13689, 14035, 14371, 15263, 15691, 16090, 16564, 16812, 17154, 17423, 17714, 18134, 18504, 18640, 19180, 19280, 19602, 19935, 20312, 20967]","[261, 367, 577, 667, 840, 930, 1020, 1287, 1637, 1926, 2016, 2478, 2574, 2846, 3347, 4123, 4767, 4925, 5177, 5541, 6016, 6201, 6410, 7032, 7836, 8012, 8108, 8727, 9312, 9547, 9801, 9991, 10138, 10369, 10762, 10969, 11367, 11501, 11601, 12294, 12881, 13028, 13128, 13228, 13398]","[261, 400, 534, 663, 838, 928, 1018, 1108, 1332, 1651, 1741, 2142, 2266, 2361, 2705, 3119, 3566, 3700, 3998, 4183, 4476, 4706, 4800, 5305, 5720, 5896, 5992, 6433, 6818, 7295, 7552, 7742, 7936, 8663, 8801, 9146, 9246, 9378, 9529, 9961, 10385, 10570, 10670, 10770, 10875]",29430,20963,20967,13398,10875,95,49,97,119,20,"[627, 945, 1458, 1930, 2384, 2913, 3196, 3946, 4356, 4850, 5419, 6029, 6679, 7320, 8137, 8664, 9347, 10237, 10924, 12071, 12579, 13325, 14240, 14811, 15279, 15995, 17033, 17798, 18902, 19926, 21007, 21537, 22342, 25261, 26638, 27126, 28525, 28650, 28877, 29733, 30187, 31831, 33274, 34500, 36197]","[547, 878, 1178, 1669, 2064, 2836, 3128, 3866, 4425, 5005, 5354, 5831, 6361, 6832, 7385, 7480, 7859, 8567, 8897, 10018, 10790, 11151, 12172, 12464, 12646, 13120, 13995, 14537, 15149, 16017, 16442, 16782, 17133, 18114, 19513, 20413, 21305, 22002, 22395, 22978, 23570, 25098, 26095, 26703, 27717]","[568, 888, 1179, 1469, 1655, 1825, 2466, 3085, 3747, 4329, 4814, 5123, 5422, 5813, 6218, 6313, 6512, 7086, 7722, 8091, 9107, 9462, 10120, 10395, 10515, 11257, 11726, 12170, 12530, 12899, 13574, 14006, 14154, 15219, 16441, 16861, 17645, 17867, 17967, 18200, 18300, 19301, 19844, 20081, 20687]","[261, 351, 490, 681, 822, 1035, 1242, 1577, 1807, 1954, 2044, 2256, 2867, 3144, 3414, 3509, 3948, 4440, 4831, 4951, 5214, 5504, 5715, 6407, 6807, 7451, 7889, 8272, 8525, 8715, 8903, 9003, 9284, 9966, 10595, 10695, 11276, 11376, 11547, 11793, 11940, 12607, 12944, 13178, 13786]","[261, 351, 535, 756, 1065, 1278, 1368, 1634, 1814, 1904, 2049, 2143, 2408, 2714, 3123, 3218, 3359, 3580, 4008, 4155, 4452, 4910, 5089, 5364, 5661, 5875, 6260, 6645, 7226, 7416, 7516, 7616, 7716, 8659, 9287, 9733, 10231, 10331, 10983, 11191, 11291, 11983, 12867, 13105, 13710]",36197,27717,20687,13786,13710,-6767,-6754,280,-388,-2835,-16464,45,dire
7556977117,63,126,21,108,26,"[1, 242, 522, 961, 1378, 1680, 2364, 2538, 2799, 3094, 3500, 4155, 4597, 5791, 6152, 6499, 6912, 7160, 7526, 7936, 8201, 8658, 9193, 9380, 9837, 10344, 11133, 12294, 13052, 14025, 15367, 16062, 16594, 17469, 18463, 19495, 20583, 21147, 21357, 22187, 23356, 24119, 24590, 24690, 24923]","[1, 426, 589, 944, 1356, 1712, 2278, 2661, 3132, 3819, 4879, 5428, 6306, 6616, 7163, 7808, 7992, 9162, 9297, 9612, 9988, 10165, 10420, 11009, 11103, 11427, 11685, 12664, 13178, 13355, 14419, 14905, 15662, 16471, 17295, 17936, 18370, 18957, 19792, 19892, 20117, 20615, 20898, 21506, 21970]","[1, 215, 384, 521, 806, 997, 1380, 1552, 2063, 2188, 2635, 2821, 2911, 3560, 3992, 4651, 5310, 6520, 6971, 7257, 7585, 7818, 8020, 8653, 9227, 9679, 9842, 11558, 12316, 13015, 14584, 15047, 15432, 16125, 16634, 16938, 17430, 18050, 18538, 18704, 19144, 19400, 19500, 19959, 20619]","[1, 171, 370, 576, 976, 1264, 1700, 1838, 1980, 2107, 2332, 2871, 3158, 3576, 3935, 4330, 4890, 5781, 6105, 6485, 6678, 6942, 7204, 7709, 8015, 8203, 8298, 9171, 9348, 9663, 10365, 11358, 11940, 12494, 13065, 13362, 13766, 13965, 14466, 14733, 15423, 15523, 15623, 16069, 16269]","[1, 171, 597, 810, 938, 1044, 1332, 1422, 2106, 2215, 2621, 2711, 2801, 3308, 3493, 3889, 4073, 4836, 5123, 5281, 5375, 5470, 5565, 5660, 5754, 5849, 5983, 6963, 7140, 7317, 7633, 8026, 8126, 8316, 8510, 8700, 9126, 9466, 9777, 10003, 10720, 10976, 11076, 11614, 11810]",24923,21970,20619,16269,11810,70,71,22,20,75,"[1, 247, 547, 875, 1326, 1617, 1992, 2739, 3220, 3908, 4434, 4809, 5257, 5656, 6380, 7156, 8303, 8907, 9218, 10696, 11568, 12356, 13344, 14585, 15780, 16656, 18000, 18880, 18976, 19949, 20203, 20689, 21538, 22306, 23037, 23928, 25042, 26156, 26727, 27953, 28973, 30592, 33350, 35105, 37325]","[1, 171, 615, 823, 1146, 1345, 1674, 2006, 2241, 2877, 3054, 3887, 4315, 4573, 5164, 5387, 5846, 6329, 6914, 7573, 8248, 8744, 9001, 9686, 10295, 10975, 11952, 12507, 12673, 13241, 13519, 13931, 14732, 15581, 16075, 16839, 17603, 18127, 18783, 19359, 20030, 20960, 21900, 23321, 24023]","[1, 259, 573, 778, 1117, 1481, 1811, 2569, 2769, 3035, 3606, 4051, 4411, 4982, 5337, 5657, 5944, 7083, 7522, 8276, 8854, 9496, 9853, 10558, 10839, 11431, 11978, 12427, 12927, 13649, 13839, 13939, 14401, 14711, 15081, 15511, 15863, 16671, 16978, 17428, 18055, 18820, 19868, 20580, 21090]","[1, 171, 308, 398, 578, 708, 1340, 1611, 1701, 2028, 2254, 2490, 2669, 3249, 3398, 3597, 3972, 4956, 5396, 6046, 6256, 6530, 6810, 7310, 7523, 8102, 8581, 8913, 9084, 9635, 10038, 10213, 10388, 10753, 11055, 11382, 11803, 12174, 12621, 13004, 13451, 14296, 15347, 15996, 16501]","[1, 171, 567, 657, 831, 1000, 1122, 1412, 1878, 2000, 2177, 2591, 2681, 2939, 3088, 3287, 3709, 4178, 4273, 5042, 5254, 5416, 5707, 6132, 6506, 6855, 7452, 7708, 7804, 8051, 8486, 8586, 8686, 8945, 9180, 9456, 9723, 10028, 10227, 10637, 11163, 11465, 12518, 13294, 13718]",37325,24023,21090,16501,13718,-12402,-2053,-471,-232,-1908,-17066,45,dire
7557160807,10,120,129,65,20,"[814, 1352, 1807, 2318, 2689, 3137, 3607, 4328, 4968, 5588, 6279, 6966, 7713, 8715, 9732, 10795, 11112, 12044, 12587, 13494, 14334, 15266, 16895, 18025, 18551, 19311, 20279, 21612, 21712, 22259, 23133, 24351, 25199, 26352, 27597, 28826, 28926, 29524, 31104, 31914, 32350, 32605, 34037, 35215, 35851]","[958, 1205, 1616, 1955, 2629, 3039, 3289, 3932, 4543, 4950, 5675, 6459, 6831, 7975, 8560, 9283, 9635, 10425, 10772, 11559, 12078, 12502, 13522, 14215, 14737, 15246, 15877, 16818, 16918, 17283, 17905, 18854, 19633, 20153, 20762, 21154, 21254, 21885, 22766, 23470, 23570, 24135, 25043, 25983, 26574]","[956, 1226, 1676, 2185, 2687, 3048, 3584, 4386, 4665, 5129, 5921, 6286, 6701, 7035, 8005, 8398, 8989, 9192, 9969, 10652, 11123, 11724, 12290, 12866, 13382, 13677, 14728, 15210, 15524, 16166, 17572, 18107, 18769, 19168, 19863, 20512, 20612, 20851, 21380, 21508, 21608, 21913, 22336, 22559, 22792]","[619, 714, 804, 1386, 1726, 1816, 2292, 2671, 3237, 3500, 4005, 4138, 4501, 5295, 5909, 6164, 6501, 6888, 7620, 8001, 8332, 8550, 9697, 10065, 10580, 10933, 11220, 11923, 12023, 12485, 13357, 13772, 13872, 14170, 14617, 15036, 15408, 15714, 16077, 16725, 16825, 17080, 17582, 17805, 18586]","[567, 704, 794, 1033, 1316, 1530, 1959, 2346, 2623, 2762, 3077, 3259, 3624, 4117, 4319, 4548, 4688, 4891, 4986, 5516, 5745, 5920, 6677, 7307, 7558, 7735, 8098, 8679, 8779, 8879, 9181, 9596, 9696, 9983, 10565, 10942, 11042, 11383, 11715, 11815, 11915, 12170, 12593, 12936, 13168]",35851,26574,22792,18586,13168,41,74,29,105,45,"[957, 1227, 1462, 1761, 2167, 2662, 2888, 3151, 3805, 4350, 4772, 5279, 5682, 6340, 6900, 7541, 8211, 8825, 9614, 10304, 11098, 11713, 12361, 12754, 13105, 14079, 14670, 16405, 18123, 18889, 19079, 19179, 20063, 20849, 21349, 24026, 25340, 26678, 28130, 28806, 29484, 30487, 31610, 33051, 33516]","[761, 974, 1268, 1611, 1925, 2519, 2927, 3375, 3949, 4057, 4364, 4734, 5284, 5587, 6357, 6831, 7259, 7688, 7945, 8911, 9568, 9996, 10718, 11151, 11317, 11413, 11864, 11995, 13290, 13742, 14279, 14967, 15578, 16144, 16461, 19092, 20366, 21315, 21950, 22324, 22734, 22969, 23815, 25258, 25861]","[1195, 1546, 2017, 2386, 2859, 3335, 3584, 4110, 4565, 5079, 5604, 6380, 6652, 7338, 7692, 8184, 8342, 8995, 9957, 10622, 11190, 11667, 12577, 12671, 12836, 13766, 13897, 14130, 15089, 15376, 15566, 16527, 16880, 17064, 17482, 18935, 19737, 20226, 20716, 21318, 21526, 21761, 22553, 23261, 24183]","[514, 650, 740, 925, 1015, 1278, 1715, 1941, 2312, 2446, 2727, 3091, 3286, 3444, 3683, 3843, 4223, 4448, 4787, 4954, 5092, 5187, 5658, 6018, 6113, 6763, 7055, 7151, 8993, 9143, 10012, 10284, 10541, 10962, 11062, 12516, 12814, 13350, 14001, 14466, 14850, 15162, 16510, 16931, 17564]","[623, 713, 908, 1043, 1133, 1313, 1403, 1638, 1938, 2421, 2608, 2855, 3089, 3247, 3468, 3612, 3819, 4280, 4582, 4895, 5224, 5548, 6056, 6150, 6245, 6524, 6721, 7186, 7990, 8090, 8280, 8478, 8816, 8916, 9063, 10263, 10938, 11267, 11475, 11828, 12036, 12271, 12371, 12704, 12810]",33516,25861,24183,17564,12810,2335,713,-1391,1022,358,3037,45,radiant
7557812714,1,23,97,53,72,"[0, 248, 638, 885, 1271, 1627, 2358, 2935, 3290, 3665, 3951, 4347, 5120, 6188, 6761, 7432, 8547, 9466, 10201, 11098, 11545, 12516, 12904, 13646, 14484, 15230, 15947, 16722, 17018, 17498, 19624, 20859, 22726, 24255, 25237, 25623, 26215, 26315, 27632, 27987, 28522, 29680, 30445, 31006, 33383]","[0, 337, 616, 1071, 1729, 2066, 2679, 3227, 3660, 4255, 4858, 5157, 6423, 7299, 7848, 8112, 8495, 8813, 9630, 9958, 10409, 10918, 11441, 12323, 12866, 13209, 13433, 13528, 14176, 14963, 16050, 16679, 17887, 19193, 20449, 20549, 21280, 22252, 22527, 23193, 24077, 24177, 24775, 25312, 26879]","[0, 292, 613, 947, 1270, 1664, 2046, 2472, 3204, 3545, 4109, 4390, 5100, 5586, 6057, 6381, 6907, 7469, 8481, 9265, 9645, 10185, 10939, 11442, 12197, 12506, 13127, 13222, 13701, 13936, 14497, 15574, 15879, 16294, 17470, 17741, 18460, 18905, 19269, 19626, 20339, 20439, 21097, 22126, 23681]","[0, 209, 299, 389, 568, 704, 853, 1005, 1384, 1474, 1763, 1853, 2536, 2944, 3393, 3801, 4455, 4976, 5362, 6033, 6128, 6466, 6868, 7591, 8116, 8211, 8651, 9089, 9185, 9515, 10467, 11078, 12288, 12875, 13911, 14509, 15101, 16207, 17023, 17123, 18119, 18219, 18643, 18928, 20329]","[0, 209, 629, 765, 992, 1131, 1569, 1757, 1948, 2119, 2347, 2475, 2916, 3277, 3472, 3566, 4082, 4387, 4525, 5060, 5422, 5517, 6035, 6465, 6584, 6781, 7005, 7100, 7741, 8190, 9203, 9573, 9905, 10115, 10763, 10863, 11437, 11537, 11637, 11737, 12418, 12518, 12781, 13174, 14244]",33383,26879,23681,20329,14244,98,41,104,64,26,"[0, 222, 549, 802, 1099, 1465, 1927, 3058, 3606, 4231, 4835, 5527, 5973, 6310, 6678, 6913, 8262, 9067, 9447, 10375, 11341, 11901, 12853, 13817, 14498, 15005, 15450, 16447, 17801, 17972, 18143, 18636, 19321, 19526, 19887, 20072, 21106, 21754, 22304, 22506, 24145, 25043, 25411, 25784, 26624]","[0, 243, 561, 723, 1258, 1573, 1806, 2067, 2326, 2768, 3106, 3461, 4040, 4385, 4747, 5236, 6464, 7207, 7677, 8614, 9725, 10159, 10625, 10972, 11359, 12359, 12705, 13998, 15045, 15432, 15813, 16564, 17765, 17865, 18484, 18584, 19243, 19547, 20144, 20913, 22351, 22855, 24221, 25228, 26413]","[0, 271, 703, 1032, 1372, 1712, 1925, 2513, 2868, 3213, 3699, 4073, 4662, 5013, 5469, 5856, 6454, 6778, 7675, 8570, 8841, 9722, 10397, 10656, 10751, 11163, 11706, 11969, 12577, 12673, 12769, 13068, 13662, 13762, 14672, 14940, 16458, 16657, 16824, 17216, 18411, 19204, 19520, 19705, 20250]","[0, 154, 244, 334, 559, 649, 826, 1293, 1516, 1699, 1971, 2199, 2472, 2687, 2869, 2963, 3537, 3883, 4040, 4646, 5180, 5606, 5972, 6516, 7049, 7618, 7831, 8351, 8660, 8756, 9406, 9506, 10437, 10567, 10667, 10767, 11917, 12374, 12722, 12955, 14904, 15532, 16297, 16656, 17220]","[0, 154, 366, 492, 663, 787, 927, 1393, 1483, 1922, 2101, 2486, 2759, 2937, 3229, 3323, 3418, 3636, 3906, 4741, 5103, 5281, 5746, 6022, 6192, 6434, 6603, 7165, 7305, 7866, 8258, 8365, 9550, 9652, 9808, 9908, 10682, 11368, 11468, 11576, 12663, 12899, 13215, 13315, 14301]",26624,26413,20250,17220,14301,6759,466,3431,3109,-57,13708,45,radiant
7557955707,120,41,102,107,75,"[0, 257, 622, 1092, 1414, 1614, 2057, 2475, 3015, 3105, 3488, 4181, 4434, 5279, 5679, 6066, 6803, 7285, 8116, 8273, 8857, 9617, 10021, 10343, 10880, 11514, 11947, 12203, 12500, 12808, 14182, 15008, 15450, 16939, 17723, 18953, 19053, 19448, 20787, 21744, 22516, 23222, 24104, 25012, 25650]","[0, 294, 490, 762, 1132, 1530, 1858, 2216, 2615, 3243, 3644, 4197, 4680, 5034, 5570, 5856, 6829, 7325, 7934, 8499, 8594, 9125, 9664, 10008, 10698, 11264, 11741, 12060, 13070, 14057, 14814, 15749, 16654, 18286, 18855, 19045, 19693, 20766, 21320, 22225, 23678, 24186, 24286, 26288, 26388]","[0, 208, 519, 804, 1102, 1433, 1523, 1909, 2313, 2968, 3508, 4040, 4284, 4454, 5054, 5401, 6564, 7152, 7502, 7826, 8272, 8716, 9460, 10003, 10264, 10883, 11153, 11835, 12112, 12420, 13046, 14168, 14325, 15513, 16107, 18153, 18544, 19289, 20569, 22092, 23251, 23865, 24795, 25580, 25711]","[0, 217, 359, 690, 780, 949, 1039, 1174, 1264, 1743, 2194, 2485, 2622, 3063, 3231, 3325, 3977, 4348, 4785, 4942, 5097, 5319, 5489, 5658, 5828, 6334, 6504, 6835, 7051, 7434, 8099, 8454, 8629, 9959, 10261, 12054, 12154, 12254, 12552, 13178, 13890, 14360, 14674, 15088, 15188]","[0, 169, 259, 349, 488, 630, 742, 877, 967, 1057, 1250, 1714, 1983, 2340, 2497, 2591, 2910, 3095, 3390, 3547, 3818, 3989, 4198, 4292, 4437, 4532, 4627, 4883, 4979, 5287, 5383, 5663, 5763, 6720, 6820, 7336, 7436, 7536, 7834, 8553, 9185, 9395, 9495, 10180, 10488]",25650,26388,25711,15188,10488,17,93,97,27,26,"[65, 382, 671, 885, 1282, 1832, 2087, 2460, 2771, 3547, 4127, 4954, 5352, 5782, 6133, 6680, 7341, 7895, 8495, 9592, 10522, 11304, 12329, 12955, 13863, 14636, 15577, 16832, 18397, 19100, 19511, 20086, 21111, 21714, 22483, 23041, 23141, 24551, 25450, 26025, 26224, 26454, 27926, 29972, 30968]","[65, 293, 614, 814, 1323, 1525, 1973, 2354, 2606, 2908, 3625, 3969, 4353, 5166, 5949, 6469, 7165, 7952, 8669, 9910, 10573, 11223, 11689, 12863, 13931, 14665, 15306, 16319, 17819, 18871, 19958, 20530, 21086, 21609, 21709, 22254, 23158, 23708, 24360, 24783, 25397, 26162, 26860, 27497, 27597]","[65, 259, 657, 1096, 1496, 1751, 1992, 2209, 2606, 3164, 3771, 4186, 4303, 4589, 5129, 5391, 6009, 6559, 6903, 7240, 7583, 7822, 8091, 8942, 9606, 10148, 10684, 11167, 12242, 12663, 13239, 13494, 14296, 15038, 16050, 16788, 17075, 17467, 17692, 17968, 18619, 19033, 19457, 20716, 20816]","[65, 259, 549, 705, 883, 1364, 1674, 1885, 2246, 2681, 2951, 3395, 3691, 3968, 4199, 4449, 4750, 5019, 5457, 6195, 6412, 6636, 7487, 8308, 8817, 9249, 9419, 10022, 11120, 11624, 11950, 12614, 13337, 14073, 14248, 14503, 14603, 14838, 15063, 15163, 15362, 15777, 16201, 16798, 17252]","[333, 577, 667, 846, 1137, 1227, 1361, 1511, 1898, 2603, 2873, 3263, 3400, 3781, 3975, 4151, 4309, 4538, 4809, 5414, 5789, 5984, 6244, 6912, 7261, 7653, 7748, 8733, 9473, 10147, 10398, 10953, 11253, 11535, 11635, 12188, 12907, 13142, 13616, 13845, 14044, 14175, 14646, 15597, 15791]",30968,27597,20816,17252,15791,-5318,-1209,4895,-2064,-5303,-8999,45,dire
7558127419,48,80,86,51,19,"[657, 906, 1372, 1844, 2148, 2406, 2729, 3432, 4046, 4589, 5101, 6094, 7141, 7589, 8084, 8892, 9848, 10973, 11868, 12805, 13738, 14234, 15021, 15885, 17055, 18079, 19139, 20244, 20931, 22328, 23687, 24666, 25678, 27369, 29093, 29992, 30499, 30884, 31270, 32599, 33945, 35981, 36763, 37724, 37830]","[684, 1174, 1375, 1709, 1981, 2459, 2832, 3336, 4096, 4637, 4732, 5133, 5858, 6062, 6724, 7307, 7851, 8420, 8924, 9120, 9735, 10178, 10632, 11252, 11491, 12021, 12971, 13067, 13533, 14570, 15419, 16196, 16735, 17482, 18161, 18559, 19066, 19265, 19468, 19791, 20817, 21839, 22309, 23073, 23179]","[793, 1294, 1769, 2463, 2877, 3104, 3761, 4461, 5283, 5764, 5949, 6386, 6731, 7399, 7494, 8000, 8711, 9150, 9245, 9477, 9896, 10177, 10824, 10918, 11527, 12045, 12515, 12611, 12841, 13509, 14336, 14847, 15394, 16138, 16818, 17082, 17890, 18437, 18537, 18921, 19167, 19267, 19631, 20078, 20295]","[318, 503, 878, 1278, 1506, 1758, 2004, 2375, 2816, 3152, 3247, 3641, 4011, 4211, 4725, 5019, 5114, 5223, 5393, 5580, 5840, 6010, 6252, 6466, 6922, 7427, 7972, 8143, 8448, 8929, 9447, 10099, 10543, 11430, 11912, 12152, 13165, 14060, 14192, 14292, 15468, 16165, 16373, 17037, 17159]","[269, 399, 625, 951, 1131, 1588, 1692, 1935, 2243, 2478, 2654, 2987, 3537, 4010, 4324, 4669, 4779, 5067, 5486, 5764, 6024, 6249, 6587, 6756, 7318, 7570, 8115, 9014, 9319, 10091, 10424, 10752, 10852, 12171, 12605, 12847, 14335, 14708, 15030, 15607, 16277, 16974, 17182, 17405, 17586]",37830,23179,20295,17159,17586,95,33,90,100,26,"[1171, 1750, 2275, 2523, 3148, 3617, 4221, 4796, 5440, 5910, 7233, 7960, 8618, 9407, 10779, 11442, 12092, 12743, 14137, 15215, 15861, 16799, 17421, 18119, 19139, 19646, 20501, 21738, 22840, 23529, 23990, 24864, 25542, 25856, 25956, 27124, 28938, 29854, 31025, 32617, 33299, 34975, 35075, 37266, 38692]","[1185, 1617, 1861, 2266, 2947, 3267, 4008, 4673, 5204, 5704, 6698, 7281, 7914, 8317, 8982, 9782, 10359, 11172, 11934, 12878, 13739, 14200, 14880, 15587, 15757, 16355, 16890, 18025, 18706, 19307, 20186, 20782, 21112, 21728, 22550, 23435, 24567, 25404, 26190, 26676, 27456, 27556, 28123, 29601, 31252]","[1147, 1469, 1903, 2511, 2941, 3695, 4329, 4733, 5153, 5606, 6530, 7414, 7791, 8370, 8919, 9253, 10038, 10196, 10607, 11451, 12161, 12602, 13020, 13643, 13955, 14363, 14996, 15917, 16841, 17400, 17500, 18027, 18307, 18898, 19738, 21154, 21611, 22347, 22764, 23418, 24012, 25122, 25816, 26966, 28001]","[684, 820, 910, 1076, 1211, 1441, 1666, 1824, 2023, 2113, 2697, 3256, 3666, 3895, 4186, 4518, 4861, 5019, 5389, 5755, 6151, 6357, 6524, 6618, 6857, 6953, 7414, 7682, 8035, 8210, 8385, 9617, 9841, 10153, 10328, 11148, 11715, 13041, 13211, 13359, 13630, 14384, 14544, 15269, 16075]","[937, 1075, 1210, 1300, 1435, 1824, 2050, 2209, 2299, 2389, 3004, 3442, 3635, 4026, 4620, 4849, 5007, 5165, 5535, 5901, 6106, 6296, 6463, 6557, 6796, 6892, 7257, 7858, 8459, 8559, 8659, 8759, 8951, 9188, 9288, 9835, 10565, 10764, 10864, 10964, 11235, 11335, 11460, 12281, 13106]",38692,31252,28001,16075,13106,-862,-8073,-7706,1084,4480,-11077,45,dire
7558405219,48,13,102,21,119,"[2, 287, 594, 932, 1300, 1716, 2094, 2593, 3189, 3663, 4099, 4739, 5309, 6048, 6638, 7262, 8277, 9501, 9942, 10037, 11239, 12165, 13141, 14483, 15119, 15722, 16827, 17493, 18906, 19921, 21632, 22615, 24545, 25483, 26622, 28827, 29862, 29963, 31070, 31482, 32622, 33053, 33826, 35842, 36998]","[0, 279, 545, 908, 1237, 1684, 1984, 2585, 3128, 3659, 4352, 4477, 5085, 5449, 6046, 6517, 7340, 7920, 8140, 8958, 9681, 10016, 10699, 11401, 11776, 12026, 12405, 13058, 13703, 14520, 14756, 15704, 16369, 17485, 18334, 19794, 20509, 20850, 22299, 22862, 23434, 24299, 25387, 27020, 28589]","[0, 248, 533, 780, 1084, 1437, 1634, 1858, 2214, 2909, 3235, 3798, 4278, 4862, 5422, 5633, 6288, 6383, 7187, 7651, 8300, 8395, 8873, 9404, 9944, 10326, 10612, 11225, 11599, 11776, 12604, 12982, 13662, 14317, 14776, 15657, 16006, 16107, 16990, 17734, 17959, 18105, 18205, 18702, 19619]","[2, 176, 270, 360, 456, 635, 795, 928, 1035, 1283, 1418, 1697, 2083, 2274, 2518, 2838, 3022, 3391, 3486, 3823, 4065, 4160, 4462, 4668, 5028, 5249, 5415, 5848, 6323, 6573, 6809, 7166, 7921, 8335, 8708, 9306, 9561, 9700, 10491, 10662, 10887, 10987, 11210, 11777, 12634]","[0, 170, 260, 414, 504, 640, 1022, 1159, 1356, 1585, 1720, 2012, 2493, 2587, 2682, 2777, 3007, 3464, 3934, 4586, 4887, 5024, 5194, 5436, 5645, 5982, 6152, 6658, 7149, 7399, 8051, 8529, 9209, 9640, 9938, 10731, 11113, 11276, 11451, 11861, 12120, 12243, 12717, 13515, 13841]",36998,28589,19619,12634,13841,120,28,89,3,45,"[0, 329, 714, 1085, 1430, 1958, 2353, 3016, 3421, 4051, 4713, 5298, 5661, 6474, 6822, 7588, 8182, 9856, 10410, 11251, 11846, 12517, 13595, 14273, 15634, 15922, 16419, 17101, 17755, 19184, 19702, 20466, 21588, 22859, 23501, 24456, 25778, 26830, 28288, 29335, 30094, 31142, 31564, 32266, 33110]","[0, 220, 481, 775, 1170, 1569, 1950, 2450, 2761, 3267, 3930, 4231, 4997, 5728, 6432, 6970, 7443, 8358, 8778, 9780, 10272, 11019, 11541, 12150, 12523, 12730, 13167, 14036, 14826, 15674, 16042, 16581, 17023, 17421, 18247, 18831, 20140, 20696, 22125, 22886, 23127, 24535, 24839, 25659, 26489]","[0, 309, 638, 886, 1194, 1583, 1845, 2253, 2674, 3010, 3538, 4016, 4818, 5501, 5943, 6630, 7313, 7794, 8647, 9543, 10342, 11164, 12249, 13113, 13564, 14184, 14991, 15765, 16621, 17230, 17919, 18783, 18988, 19339, 20028, 21088, 21188, 21966, 22948, 23048, 23463, 24824, 25393, 26246, 26927]","[0, 220, 335, 517, 647, 753, 1078, 1303, 1717, 1852, 2086, 2640, 2900, 3102, 3318, 3963, 4373, 4748, 4887, 5587, 5996, 6409, 6599, 7147, 7285, 7509, 7815, 8072, 8367, 8520, 8706, 8931, 9031, 9536, 9682, 10140, 10924, 11628, 12332, 12432, 12576, 13508, 14162, 14549, 14936]","[0, 220, 335, 425, 999, 1155, 1245, 1425, 1728, 1921, 2233, 2385, 2696, 2932, 3127, 3562, 3972, 4166, 4412, 4810, 5006, 5727, 6086, 6519, 6716, 6847, 7251, 7508, 7803, 8149, 8335, 8580, 9057, 9351, 9451, 9715, 10777, 11039, 11930, 12110, 12386, 12958, 13520, 13908, 14325]",33110,26489,26927,14936,14325,3888,2100,-7308,-2302,-484,-4106,45,radiant
7558802112,109,13,129,90,100,"[0, 170, 520, 798, 1031, 1319, 1409, 1887, 2118, 2545, 3014, 3554, 3755, 4228, 4754, 5287, 6037, 7123, 8043, 9017, 9973, 10489, 11248, 11973, 12811, 14055, 14467, 14706, 15222, 16028, 16562, 17338, 18484, 19341, 20429, 21522, 22535, 23641, 24851, 26210, 27202, 27860, 28164, 28264, 29693]","[0, 205, 418, 706, 915, 1144, 1603, 1855, 2483, 2929, 4002, 4513, 5024, 5315, 5947, 6149, 6750, 7969, 8528, 8841, 10116, 10705, 11351, 12141, 12842, 13346, 13516, 14055, 14521, 15190, 15796, 16256, 17277, 17965, 19320, 20069, 20368, 21101, 21300, 21510, 22494, 22892, 22992, 23547, 24138]","[0, 170, 555, 957, 1227, 1711, 1997, 2449, 2734, 3414, 4133, 4497, 5054, 5558, 5993, 6721, 7041, 8040, 8635, 8882, 9796, 10473, 11126, 11708, 12296, 12608, 13139, 13379, 13475, 14424, 15140, 15703, 15803, 16013, 16380, 16666, 17725, 18025, 18990, 19578, 20302, 21250, 22543, 23009, 23437]","[0, 219, 405, 540, 630, 837, 927, 1062, 1231, 1526, 2235, 2510, 2636, 2990, 3225, 3365, 3633, 4357, 5146, 5747, 6606, 7197, 7434, 7676, 7991, 8158, 8253, 8347, 8653, 8979, 9455, 10068, 10257, 10467, 11043, 11143, 11485, 11710, 12210, 12562, 13183, 13428, 13601, 14266, 15265]","[0, 170, 260, 394, 484, 620, 829, 1010, 1100, 1568, 1862, 1952, 2129, 2224, 2319, 2413, 2758, 3322, 3677, 3924, 4471, 4863, 5346, 5485, 5580, 5944, 6039, 6492, 6796, 6973, 7101, 7201, 7422, 7632, 7957, 8057, 8399, 8624, 8823, 9067, 9365, 9465, 9565, 9813, 10129]",29693,24138,23437,15265,10129,41,39,137,45,20,"[0, 216, 458, 814, 1219, 1595, 1842, 2122, 2698, 2872, 3511, 4012, 4458, 5076, 5531, 6275, 7035, 7461, 7767, 8350, 8661, 8915, 9811, 10555, 11191, 11669, 12244, 12834, 13261, 14366, 14849, 15903, 16776, 17444, 18274, 19163, 19927, 20201, 21305, 21794, 23002, 24050, 26017, 27358, 28576]","[0, 280, 635, 919, 1325, 1745, 2204, 2696, 3100, 3643, 4271, 4901, 5465, 6007, 6335, 6987, 7744, 8132, 8571, 9079, 9467, 10309, 10973, 11196, 11790, 12886, 13246, 14176, 14630, 15188, 16062, 16584, 16903, 17286, 18387, 18923, 19207, 19895, 20608, 20790, 21490, 22930, 24061, 25197, 25573]","[0, 245, 575, 813, 1137, 1436, 1812, 2192, 3059, 3758, 4552, 5190, 5793, 6225, 6863, 7767, 8872, 9143, 9759, 9988, 10295, 10912, 11657, 12172, 12579, 13149, 13780, 14708, 15001, 15277, 15568, 16376, 16867, 17452, 18670, 19205, 19797, 20114, 21548, 21935, 22170, 23139, 24224, 25047, 25194]","[0, 207, 297, 412, 588, 1141, 1535, 1625, 2092, 2716, 3081, 3321, 3664, 4379, 4709, 5106, 5417, 5696, 5920, 6249, 6458, 6675, 7311, 7848, 8059, 8226, 8381, 9253, 9767, 10102, 10328, 10752, 11232, 11740, 12201, 12371, 12471, 12949, 13494, 13594, 13829, 14204, 14894, 15294, 15436]","[0, 170, 260, 422, 552, 731, 830, 967, 1281, 1457, 1682, 1772, 1970, 2323, 2664, 3162, 3473, 3568, 3692, 3921, 4106, 4324, 4785, 5507, 5602, 5769, 5864, 6581, 6968, 7382, 7584, 7864, 8074, 8346, 8807, 8907, 9250, 9773, 10235, 10588, 11055, 11197, 11801, 12320, 12420]",28576,25573,25194,15436,12420,1117,-1435,-1757,-171,-2291,-4537,45,dire
7559020110,41,69,23,110,26,"[205, 366, 616, 916, 1204, 1452, 1758, 1978, 2106, 2575, 2950, 3511, 4106, 4674, 6180, 6878, 7494, 8160, 8838, 9562, 10202, 11022, 11546, 12708, 13237, 13528, 14404, 15477, 15573, 16703, 17275, 17375, 18267, 19265, 19804, 20688, 21139, 21932, 22909, 25019, 25785, 26918, 27237, 27723, 29247]","[204, 442, 701, 1166, 2060, 2692, 3007, 3832, 4137, 4754, 5080, 5890, 6042, 6656, 7729, 8077, 8489, 8915, 9494, 10277, 10713, 11681, 12451, 13027, 13531, 14377, 15185, 16464, 16833, 17174, 17793, 18451, 19239, 19733, 20101, 20510, 20714, 20974, 21299, 22462, 23360, 23944, 24263, 24443, 25688]","[326, 654, 1102, 1427, 1909, 2347, 2891, 3557, 4160, 4761, 5129, 5609, 6072, 6436, 7304, 7800, 8328, 8973, 9324, 9594, 9885, 10199, 10366, 10967, 11625, 12033, 12429, 13053, 13149, 13908, 14614, 14731, 15440, 16016, 16407, 16749, 17227, 17617, 18000, 18433, 18652, 19139, 19458, 20053, 21058]","[170, 296, 497, 652, 896, 998, 1399, 1640, 1730, 2076, 2462, 2775, 2972, 3157, 3805, 4025, 4418, 4676, 5215, 5416, 5822, 6598, 7212, 7622, 7809, 8060, 8888, 9558, 9654, 9782, 9881, 10036, 10651, 10798, 11124, 11508, 11712, 11957, 12249, 13718, 14253, 15046, 15692, 15826, 16581]","[221, 311, 447, 585, 955, 1161, 1296, 1801, 1910, 2120, 2669, 2967, 3116, 3401, 4271, 4733, 4995, 5335, 5637, 5897, 6067, 6456, 6794, 7198, 7530, 7865, 8230, 8402, 8725, 8975, 9308, 9571, 10202, 10823, 10945, 11177, 11505, 11797, 11897, 12096, 12430, 12784, 13192, 13448, 14247]",29247,25688,21058,16581,14247,94,120,33,123,85,"[288, 465, 745, 1074, 1479, 1814, 2420, 2566, 3102, 3689, 4245, 4593, 5244, 5981, 6877, 8120, 8644, 9769, 10583, 11567, 12534, 12701, 13426, 14365, 15106, 16021, 16992, 18358, 20151, 21073, 21976, 22951, 24209, 25449, 27140, 28450, 30194, 31309, 32195, 33278, 34135, 36476, 38005, 40135, 40527]","[290, 526, 894, 1351, 1691, 2039, 2417, 2873, 3403, 4189, 4881, 5703, 6644, 7723, 8144, 8238, 8823, 9253, 9961, 10725, 11392, 12110, 12374, 12764, 13308, 13975, 14069, 14899, 15643, 16601, 17228, 18303, 18884, 19179, 19877, 20362, 21014, 21666, 21889, 22124, 22418, 22936, 23648, 24739, 25224]","[206, 568, 843, 1247, 1834, 2052, 2704, 3166, 3874, 4875, 5378, 6113, 6462, 6823, 7088, 7280, 7776, 8163, 8636, 9270, 9533, 10432, 10817, 11100, 11267, 11969, 12172, 13060, 14084, 14512, 14967, 15419, 15931, 16293, 16981, 17256, 17806, 18554, 19038, 19273, 19373, 19891, 20900, 22148, 22993]","[170, 260, 372, 591, 764, 941, 1453, 1543, 1855, 2416, 2699, 2987, 3369, 3635, 3800, 3894, 4284, 4872, 5105, 5535, 5705, 6431, 6601, 7090, 7332, 7796, 8208, 9086, 9975, 10149, 10880, 11246, 11755, 12419, 13142, 13768, 14446, 14878, 15277, 15512, 15612, 16130, 17138, 18101, 18397]","[170, 260, 350, 487, 896, 986, 1263, 1435, 1744, 2198, 2983, 3392, 3760, 4075, 4321, 4439, 4680, 5116, 5274, 5566, 5842, 6288, 6681, 6775, 6959, 7401, 7702, 8087, 8318, 8414, 8772, 9184, 9374, 9474, 9755, 9943, 10431, 11085, 11185, 11502, 11865, 12383, 13253, 14219, 14450]",40527,25224,22993,18397,14450,-11280,464,-1935,-1816,-203,-14770,45,dire
7559833511,48,76,97,65,110,"[0, 209, 370, 747, 981, 1187, 1679, 1992, 2301, 2747, 3280, 3675, 4162, 5006, 5614, 6454, 7191, 8168, 8880, 9362, 10839, 11555, 12512, 13493, 14637, 15463, 16734, 17504, 18907, 20219, 20993, 21330, 21955, 22493, 24467, 25903, 27404, 28758, 29680, 31051, 32197, 32297, 33223, 33907, 36466]","[0, 291, 589, 827, 1226, 1576, 1975, 2302, 2827, 3173, 3690, 4161, 4814, 5137, 5750, 6018, 6409, 6754, 7216, 7568, 9012, 9773, 10288, 11085, 11573, 12620, 13915, 14386, 15091, 16016, 16653, 17235, 17837, 18444, 19171, 19760, 20743, 21487, 22319, 22889, 24002, 24102, 24202, 24451, 25892]","[0, 204, 452, 542, 897, 1266, 1442, 1688, 2144, 2605, 2861, 3389, 3891, 4491, 5045, 5140, 5657, 6352, 7075, 7332, 8398, 9141, 9999, 10709, 10894, 11473, 12151, 12777, 13758, 13929, 14332, 14623, 14814, 15161, 15667, 15912, 16484, 16794, 17321, 17880, 18186, 18286, 18763, 18985, 19463]","[0, 170, 260, 458, 885, 1022, 1136, 1283, 1373, 1556, 1992, 2262, 2518, 2681, 3073, 3168, 3414, 3874, 4329, 4424, 5459, 5913, 6201, 6616, 6971, 7383, 7800, 8426, 8953, 9680, 10057, 10282, 10473, 10852, 11445, 12035, 12245, 12444, 12654, 12895, 13201, 13328, 13733, 14283, 15070]","[0, 219, 309, 399, 580, 670, 807, 936, 1026, 1209, 1603, 1804, 1980, 2299, 2710, 2888, 3402, 3496, 3777, 3872, 4192, 4358, 4569, 4923, 5177, 5343, 5724, 5844, 6021, 6763, 6859, 7091, 7310, 7545, 8077, 8590, 8800, 8999, 9571, 10043, 10445, 10545, 10871, 11093, 12862]",36466,25892,19463,15070,12862,25,13,102,3,26,"[0, 326, 600, 845, 1257, 1630, 2122, 2683, 3284, 3876, 4429, 5024, 5380, 6032, 6720, 7539, 8267, 8983, 9461, 9725, 9820, 10653, 11798, 12573, 12843, 13993, 14642, 14737, 15581, 16782, 17592, 18098, 18671, 19540, 20570, 21656, 22735, 23490, 24244, 24857, 25881, 27816, 28682, 29196, 30236]","[0, 242, 430, 758, 1101, 1420, 1581, 1908, 2235, 2639, 3390, 3705, 4114, 4670, 4924, 5100, 5590, 6059, 6700, 6880, 6975, 7476, 8295, 8972, 9204, 9583, 10336, 10669, 11415, 12232, 12611, 13216, 13631, 14707, 15905, 16538, 17248, 18192, 19326, 20283, 20777, 22574, 23897, 24132, 24661]","[0, 209, 591, 758, 1132, 1397, 1757, 2144, 2756, 2960, 3474, 3835, 4544, 4879, 5233, 5566, 6004, 6542, 6796, 7339, 7434, 8098, 8752, 9376, 9865, 10187, 10654, 10855, 11162, 11479, 11613, 12380, 12977, 13863, 14541, 14850, 15160, 15441, 15829, 16242, 16675, 18471, 18763, 19172, 19634]","[0, 170, 285, 375, 505, 595, 706, 967, 1147, 1237, 1372, 1503, 1683, 2093, 2490, 2585, 2806, 2900, 2995, 3380, 3654, 3954, 4352, 4447, 4542, 4708, 4803, 5017, 5238, 5532, 5628, 6021, 6365, 7028, 7502, 7650, 7850, 7950, 8149, 8249, 8607, 9225, 9325, 9560, 10022]","[0, 170, 285, 426, 601, 691, 830, 1457, 1768, 1858, 2126, 2216, 2445, 2593, 2725, 2820, 3041, 3579, 3964, 4366, 4513, 4679, 4846, 5160, 5287, 5593, 5737, 5832, 6009, 6303, 6399, 6792, 7216, 7606, 7796, 8046, 8566, 8666, 9082, 9443, 9635, 9953, 10053, 10384, 10846]",30236,24661,19634,10022,10846,6230,1231,-171,5048,2016,14354,45,radiant
7560138206,73,98,39,123,5,"[0, 371, 802, 1303, 1563, 1817, 2709, 3218, 3729, 4590, 5399, 6373, 7520, 9111, 9959, 11101, 12567, 13677, 14380, 15542, 17369, 18901, 20608, 21633, 22308, 22942, 24111, 25078, 25831, 26259, 26355, 27556, 28559, 29805, 31166, 32945, 33563, 34632, 34902, 35002, 35748, 36397, 37214, 37359, 38949]","[0, 244, 477, 857, 1018, 1433, 1897, 2238, 2472, 2888, 3200, 3641, 4517, 5502, 5948, 6640, 7430, 8000, 8463, 9133, 9790, 10778, 11440, 12231, 12982, 13527, 13941, 15029, 15782, 15965, 16500, 17745, 18428, 19689, 20541, 21192, 21936, 22258, 23094, 23808, 24007, 24896, 25155, 25910, 26243]","[0, 331, 607, 961, 1410, 1822, 2196, 2743, 3213, 3691, 4349, 5160, 5483, 6068, 6619, 7353, 7854, 8333, 9151, 10312, 11068, 11372, 12447, 13330, 13926, 14712, 15800, 16193, 17095, 17483, 17579, 18519, 19313, 20462, 21414, 21762, 22299, 22830, 23313, 23655, 24538, 25341, 25614, 26296, 26396]","[0, 169, 640, 760, 850, 986, 1194, 1398, 1768, 1868, 2266, 2356, 2871, 3254, 3924, 4333, 4702, 4971, 5311, 5588, 6198, 6909, 7612, 8160, 8731, 9248, 9950, 10635, 10950, 11301, 11827, 12371, 13219, 14207, 15568, 15898, 16366, 17343, 17887, 18192, 19189, 19701, 20531, 20727, 20827]","[0, 169, 365, 550, 685, 775, 1003, 1236, 1504, 1865, 2205, 2540, 2870, 3107, 3291, 3636, 4002, 4232, 4503, 4997, 5498, 6142, 6524, 6978, 7284, 7527, 8596, 8984, 9248, 9422, 9518, 9844, 10504, 10998, 11357, 11547, 11647, 11978, 12296, 12843, 13042, 13329, 13548, 13648, 13748]",38949,26243,26396,20827,13748,22,48,29,45,58,"[0, 357, 962, 1254, 1673, 2098, 2470, 3144, 3550, 3855, 4352, 4784, 5396, 5890, 6388, 6665, 7370, 7889, 8885, 9551, 10546, 10887, 11791, 12295, 13002, 13966, 15052, 16257, 16989, 18443, 18836, 20176, 21160, 21528, 21809, 22837, 23563, 24393, 25366, 26041, 26782, 27733, 28243, 29581, 30029]","[0, 257, 658, 1098, 1381, 1791, 2007, 2480, 2905, 3333, 3950, 4390, 5055, 5890, 6098, 6658, 7471, 8516, 9279, 9964, 11056, 11789, 12158, 12545, 13053, 13575, 13866, 14105, 15042, 16395, 17297, 18060, 18907, 19007, 19240, 20376, 21372, 22229, 22694, 24063, 24946, 26291, 27455, 28930, 29774]","[0, 245, 564, 763, 1170, 1689, 2098, 2617, 3019, 3371, 3831, 4077, 4660, 5416, 5929, 6521, 7313, 8084, 8954, 9270, 9988, 10252, 10509, 11032, 11525, 11741, 12032, 12463, 12920, 13704, 14436, 15346, 15754, 16046, 16322, 16422, 16590, 16789, 17312, 17987, 18571, 18726, 19011, 19598, 19869]","[0, 169, 289, 426, 578, 811, 967, 1291, 1504, 1781, 2014, 2104, 2275, 2548, 2823, 3041, 3632, 4004, 4397, 5005, 5655, 5919, 6220, 6385, 6776, 6992, 7468, 7804, 8471, 9466, 9864, 10054, 10296, 10396, 10609, 10709, 11161, 11360, 11883, 13129, 13555, 13784, 14177, 14619, 14994]","[0, 169, 289, 398, 488, 736, 826, 961, 1056, 1146, 1566, 1688, 1880, 2100, 2317, 2448, 2950, 3176, 3462, 3916, 4256, 4825, 5220, 5375, 5642, 5809, 6361, 6582, 7155, 8184, 8505, 8695, 8937, 9083, 9183, 9533, 9756, 10130, 10970, 11928, 12329, 12429, 12844, 13420, 14077]",30029,29774,19869,14994,14077,8920,-3531,6527,5833,-329,17420,45,radiant
7560377202,10,49,61,128,121,"[609, 813, 1117, 1479, 1821, 2279, 2830, 3294, 3928, 4561, 5155, 5376, 6036, 7003, 7911, 9053, 9990, 10925, 11864, 12661, 13228, 13665, 14474, 15712, 16385, 17807, 18731, 19870, 21122, 21715, 21815, 22726, 23843, 24343, 25150, 25831, 28006, 28949, 29902, 31120, 32188, 32811, 34009, 35338, 36190]","[532, 735, 1017, 1355, 1516, 1965, 2161, 2550, 3453, 4054, 4712, 5674, 6162, 6883, 7330, 8177, 8448, 8904, 9510, 10089, 10678, 10843, 11073, 11894, 12347, 13230, 13610, 14454, 15081, 16287, 16387, 17001, 17569, 17949, 18525, 18975, 20361, 21089, 22513, 22732, 23642, 24258, 24919, 25653, 27289]","[904, 1289, 1555, 2178, 2789, 3355, 3832, 4496, 5306, 5751, 7115, 7427, 8009, 9014, 9509, 9996, 10284, 10720, 11109, 11499, 12101, 12426, 13161, 14003, 14334, 15425, 16176, 16703, 17485, 18143, 18374, 19253, 19805, 20049, 20149, 20249, 22129, 23026, 23444, 23626, 23942, 24561, 25075, 25437, 25914]","[541, 677, 767, 998, 1322, 1715, 1883, 2021, 2249, 2751, 3123, 3427, 3522, 4305, 4601, 4909, 5175, 5510, 5672, 5951, 6151, 6366, 6671, 7002, 7305, 7844, 8392, 8685, 8907, 9408, 9940, 10814, 10914, 11014, 11151, 11326, 12195, 12750, 12917, 13017, 13333, 13541, 13919, 14212, 14825]","[350, 490, 624, 714, 1003, 1267, 1435, 1570, 1902, 2076, 2628, 2883, 3165, 3640, 4149, 4351, 4533, 4726, 4821, 5025, 5120, 5215, 5445, 5701, 5796, 6083, 6393, 6714, 6904, 7356, 7570, 7760, 7860, 7960, 8060, 8160, 8954, 9359, 9720, 9820, 10184, 10632, 10732, 11002, 11399]",36190,27289,25914,14825,11399,70,35,129,123,20,"[948, 1196, 1487, 2008, 2434, 2608, 2912, 3425, 4042, 4721, 5256, 5833, 6507, 7235, 8050, 8629, 9387, 9905, 11068, 11669, 12466, 13020, 14279, 14963, 16065, 17077, 17531, 18418, 19659, 21626, 22827, 23812, 24696, 25625, 26193, 27424, 28382, 28482, 29156, 30527, 31672, 32118, 32974, 33782, 35266]","[530, 819, 1282, 1603, 2002, 2744, 3559, 4307, 5102, 5708, 6562, 6832, 7477, 8115, 8290, 8960, 9720, 10354, 11114, 11683, 12219, 12745, 13178, 13510, 14129, 14701, 15364, 16084, 16810, 18736, 19418, 19966, 21019, 21535, 23082, 24066, 24312, 24511, 25518, 26036, 26136, 26349, 27434, 28458, 29663]","[932, 1348, 1848, 2227, 2633, 3139, 4121, 4681, 5098, 5801, 6596, 6700, 6939, 7386, 7561, 8274, 8932, 9460, 10047, 10400, 10758, 10903, 11388, 11799, 12818, 13661, 14172, 14320, 14623, 15416, 15621, 16131, 16443, 16552, 17341, 18092, 18652, 18851, 19130, 19542, 19642, 19878, 20244, 20921, 21262]","[532, 622, 1099, 1189, 1344, 1544, 1812, 2020, 2362, 2801, 3210, 3421, 3767, 4182, 4402, 4769, 4864, 5220, 5615, 5828, 6166, 6404, 6590, 6708, 7364, 7620, 7790, 8225, 8467, 9502, 9602, 10066, 10223, 10332, 10802, 11519, 11796, 12028, 12311, 12556, 12737, 13010, 13645, 14548, 15028]","[829, 966, 1267, 1572, 1920, 2020, 2425, 2873, 3266, 3383, 3700, 4200, 4439, 4732, 4907, 5371, 5585, 5863, 6329, 6570, 6893, 7063, 7351, 7568, 8072, 8288, 8459, 8630, 9088, 9900, 10060, 10325, 10500, 10870, 11585, 11993, 12453, 12834, 13332, 13464, 13835, 13935, 14577, 14800, 15335]",35266,29663,21262,15028,15335,924,-2374,4652,-203,-3936,-937,45,dire
7560629402,49,25,23,123,45,"[0, 287, 601, 868, 1171, 1463, 1787, 2067, 2482, 2746, 3302, 3513, 4183, 4734, 5297, 5736, 6713, 7377, 8238, 9284, 10193, 10694, 11437, 11778, 12564, 13290, 14159, 15009, 16195, 16334, 17406, 18020, 18635, 20301, 21435, 22519, 23945, 24814, 26066, 26404, 26853, 27127, 27600, 28103, 28926]","[0, 293, 545, 787, 1021, 1233, 1323, 1648, 2008, 2286, 2853, 3223, 3857, 4462, 5287, 5823, 6344, 6656, 7707, 8103, 8738, 9319, 10015, 11096, 11716, 12551, 13273, 13699, 14517, 14700, 15432, 15810, 16544, 17924, 19013, 19649, 20363, 20821, 21995, 22304, 22404, 22686, 24078, 25051, 25810]","[0, 243, 408, 842, 1194, 1537, 2144, 2334, 3118, 3747, 4345, 5063, 5582, 6232, 6703, 7190, 7660, 8396, 9022, 9242, 9950, 10132, 10682, 12164, 12427, 12936, 13624, 14083, 14850, 15147, 15581, 15681, 16031, 17120, 17853, 18356, 19052, 19570, 19825, 20047, 20388, 20839, 21184, 21479, 21699]","[0, 215, 390, 480, 640, 730, 867, 1004, 1233, 1456, 1768, 2117, 2374, 2591, 3066, 3494, 3903, 4516, 5490, 6072, 6399, 6823, 6918, 7013, 7604, 7916, 8670, 9294, 9794, 10375, 10664, 10911, 11131, 12097, 12787, 13524, 14046, 14191, 14614, 14828, 15621, 16110, 16210, 16310, 16682]","[0, 205, 295, 385, 610, 769, 865, 955, 1184, 1674, 1980, 2070, 2291, 2434, 2960, 3325, 4185, 4336, 4706, 5138, 5473, 5567, 5662, 5757, 6090, 6258, 6751, 6902, 7189, 7553, 7879, 7979, 8079, 8697, 9384, 9654, 10081, 10181, 10491, 10591, 10737, 10837, 11308, 11408, 11508]",28926,25810,21699,16682,11508,59,15,106,102,105,"[0, 244, 442, 603, 1122, 1467, 2021, 2444, 3023, 3512, 4077, 4961, 5465, 6213, 6779, 7349, 8658, 9094, 9944, 10114, 11312, 12395, 13520, 14560, 14836, 15990, 16630, 17215, 17908, 18543, 20473, 21386, 22364, 23038, 23138, 23788, 24839, 25628, 26220, 26972, 27948, 28812, 29952, 30969, 31794]","[0, 243, 492, 1155, 1452, 1853, 2217, 2545, 2872, 3428, 3649, 4412, 4943, 5309, 5662, 6050, 6839, 7502, 8122, 8607, 9018, 9736, 10452, 11261, 11804, 12226, 12867, 13404, 13930, 14508, 16085, 16535, 17089, 17943, 18579, 19444, 20087, 20824, 21587, 22706, 24177, 25057, 25876, 26719, 27362]","[0, 208, 491, 708, 967, 1333, 1468, 1962, 2160, 2540, 3173, 3448, 3885, 4185, 4633, 5154, 5748, 6357, 7015, 7110, 8037, 8404, 9603, 11107, 11717, 12204, 12597, 13134, 13908, 14145, 14742, 15484, 16437, 16830, 16930, 17670, 17853, 18260, 18697, 19379, 19869, 20959, 21771, 22839, 23205]","[0, 170, 317, 407, 532, 871, 1079, 1321, 1411, 1552, 1733, 1960, 2313, 2748, 3152, 3350, 3691, 3921, 4319, 4414, 4841, 5116, 5714, 6341, 6436, 6710, 6805, 6946, 7177, 7273, 7841, 8361, 8878, 9123, 9476, 9802, 9946, 10413, 10986, 12135, 12698, 13264, 13597, 14155, 14255]","[0, 170, 299, 603, 757, 847, 1220, 1577, 1797, 1887, 2128, 2331, 2421, 2837, 3422, 3637, 4124, 4354, 4621, 4752, 5074, 5759, 6581, 7248, 7418, 7706, 8224, 8394, 8753, 8924, 9695, 9960, 10675, 10985, 11118, 11529, 12072, 12209, 12574, 13174, 13760, 14030, 14363, 14741, 15105]",31794,27362,23205,14255,15105,-2868,-1552,-1506,2427,-3597,-7096,45,radiant
7561212717,94,137,17,123,90,"[0, 154, 481, 857, 1337, 1708, 1833, 2164, 2432, 3001, 3491, 4181, 4591, 5607, 6105, 6785, 7507, 8678, 9560, 10499, 10998, 11093, 12270, 13487, 14640, 15856, 16544, 17322, 18337, 19858, 20531, 21084, 21743, 22343, 23865, 24441, 25963, 26607, 28126, 29558, 31180, 31700, 32642, 33563, 34314]","[0, 191, 434, 706, 945, 1437, 1676, 1854, 2062, 2611, 3165, 3682, 3999, 4623, 5463, 5980, 6974, 7507, 8173, 8496, 9313, 9408, 9736, 10320, 11194, 11780, 12277, 12804, 13050, 13970, 14066, 14166, 14266, 14366, 15205, 16263, 16591, 17167, 17595, 18263, 19152, 19356, 19533, 19761, 20700]","[0, 273, 560, 1014, 1507, 2057, 2463, 3057, 3419, 3836, 4265, 4519, 4923, 5345, 5691, 6290, 6749, 7108, 7579, 8069, 8667, 8982, 9380, 10226, 10625, 11098, 11436, 11885, 12326, 13090, 13186, 13286, 13386, 13486, 14688, 15371, 15871, 16081, 16181, 16825, 17693, 17793, 18457, 18692, 19307]","[0, 154, 244, 514, 644, 779, 905, 1166, 1404, 1518, 1775, 2076, 2215, 2766, 3130, 3342, 3896, 4291, 4478, 4874, 5348, 5443, 5631, 5989, 6164, 6331, 6425, 6620, 6906, 7493, 7670, 7770, 7870, 7970, 9054, 9651, 9909, 10190, 10452, 10832, 11231, 11331, 12137, 12322, 12656]","[0, 154, 244, 381, 596, 780, 903, 1059, 1295, 1406, 1500, 1813, 1953, 2208, 2545, 2758, 3296, 3482, 3952, 4258, 4417, 4512, 4699, 5002, 5211, 5378, 5472, 5661, 5815, 6632, 6728, 6828, 7005, 7470, 8709, 9069, 9574, 9784, 10212, 10638, 11037, 11399, 11499, 11599, 11933]",34314,20700,19307,12656,11933,95,13,96,65,110,"[0, 317, 560, 758, 1227, 1650, 2141, 2672, 3170, 3722, 4308, 4732, 5175, 5722, 6291, 7222, 7620, 8304, 9150, 10066, 10796, 12769, 13695, 14811, 15629, 16694, 17521, 18390, 19537, 20395, 21233, 21790, 22706, 23531, 23884, 24164, 24938, 25895, 27149, 27687, 28005, 29174, 29547, 30495, 32307]","[0, 292, 542, 821, 1227, 1637, 2053, 2614, 3147, 3589, 4166, 4589, 5051, 5895, 6338, 6993, 7534, 7837, 8411, 8772, 9225, 10865, 11409, 12047, 12432, 13032, 13206, 14036, 14427, 14647, 15013, 15151, 15251, 15441, 16224, 17300, 18059, 19259, 20450, 20953, 21300, 22145, 22279, 23056, 23955]","[0, 243, 598, 962, 1321, 1609, 1952, 2244, 2580, 3032, 3556, 4020, 4397, 5073, 5567, 6160, 7040, 7677, 8254, 8858, 9151, 10200, 10908, 11247, 11546, 12269, 12363, 13225, 13928, 14446, 14594, 14772, 14948, 15263, 15728, 16008, 16465, 17668, 18440, 18816, 19033, 20068, 20850, 21784, 22868]","[0, 209, 299, 389, 863, 973, 1203, 1497, 1662, 1828, 2008, 2272, 2602, 3013, 3355, 3787, 4220, 4363, 4655, 4981, 5514, 6503, 7073, 7242, 7579, 7870, 8039, 8386, 8926, 9314, 9434, 9534, 9634, 9824, 9924, 10986, 11761, 12723, 13250, 13513, 13688, 14534, 14642, 15418, 16750]","[0, 255, 345, 455, 668, 803, 1116, 1472, 1605, 2169, 2349, 2483, 2679, 3045, 3348, 3532, 3765, 4059, 4307, 4639, 5035, 5602, 5841, 5935, 6186, 6521, 6615, 7027, 7369, 7709, 7923, 8069, 8207, 8397, 8907, 9187, 9287, 9622, 10149, 10348, 10705, 11129, 11229, 11437, 12192]",32307,23955,22868,16750,12192,2007,-3255,-3561,-4094,-259,-9162,45,dire
7561841307,80,39,129,45,20,"[0, 169, 412, 682, 998, 1353, 1973, 2311, 2607, 3615, 4171, 4636, 4975, 5626, 6243, 6553, 6931, 7541, 7966, 9158, 10233, 10684, 12134, 12943, 13492, 14232, 15161, 15694, 16106, 16605, 17626, 18652, 18927, 19635, 21026, 21900, 22436, 23119, 24183, 25265, 26213, 27771, 28323, 28423, 28631]","[0, 298, 569, 905, 1180, 1512, 1803, 2428, 2704, 2956, 3159, 3712, 4084, 4526, 4901, 5548, 5812, 6316, 6817, 7897, 9122, 9658, 10372, 10822, 11601, 12651, 13546, 13957, 15041, 16219, 16506, 17661, 18106, 18791, 20328, 21129, 21275, 21375, 22594, 23147, 23555, 24015, 24318, 25143, 25556]","[0, 278, 592, 920, 1096, 1575, 1927, 2423, 2905, 3232, 3659, 3957, 4207, 4485, 4860, 5233, 5434, 5831, 6281, 7160, 8153, 8454, 9139, 9677, 10019, 10220, 10693, 11355, 11900, 12337, 12617, 13151, 13251, 13667, 13998, 14208, 14352, 14452, 14907, 15404, 15749, 15849, 16163, 16389, 17071]","[0, 169, 259, 349, 439, 569, 659, 1107, 1197, 1582, 1904, 2094, 2234, 2383, 2948, 3503, 3761, 3981, 4184, 4641, 5532, 5942, 6663, 6944, 7285, 7418, 8112, 8364, 9046, 9248, 9540, 10115, 10302, 10718, 11230, 11694, 12007, 12598, 13300, 13848, 14193, 14324, 14659, 15457, 16048]","[0, 169, 298, 406, 531, 685, 822, 1168, 1258, 1403, 1732, 1822, 2058, 2273, 2548, 3055, 3150, 3260, 3463, 3926, 4988, 5083, 5680, 5962, 6163, 6502, 7029, 7199, 7855, 7951, 8047, 8515, 8615, 9031, 9688, 9898, 9998, 10345, 10701, 10911, 11393, 11493, 11683, 11783, 12321]",28631,25556,17071,16048,12321,10,106,137,21,136,"[0, 169, 334, 567, 1039, 1384, 1787, 2108, 2512, 3080, 3654, 4045, 4552, 5142, 5653, 6421, 7242, 7513, 8387, 9171, 9598, 9775, 10464, 11312, 12301, 12946, 13607, 14190, 14969, 15515, 16404, 17392, 18563, 19462, 19742, 20015, 20677, 21795, 22177, 23259, 23764, 24691, 25991, 27382, 28335]","[0, 278, 638, 889, 1305, 1604, 1953, 2170, 2551, 3153, 3380, 3590, 4307, 4985, 5421, 5773, 6422, 7018, 7547, 8142, 8491, 8978, 9463, 10172, 10638, 11177, 11668, 12287, 12993, 13467, 14230, 14420, 14629, 15815, 16811, 17486, 18215, 19207, 19939, 20822, 21239, 22203, 22904, 24290, 25148]","[0, 267, 720, 964, 1335, 1796, 2029, 2664, 3484, 4017, 4239, 4561, 5374, 5689, 5938, 7076, 7487, 8003, 8595, 9399, 9904, 10343, 10727, 10971, 11366, 11926, 12212, 12388, 13040, 13315, 13990, 14147, 14783, 15322, 15602, 15907, 16261, 16980, 17221, 17365, 17510, 18091, 19016, 20059, 20312]","[0, 501, 638, 778, 1193, 1323, 1511, 1822, 2032, 2465, 2854, 2979, 3355, 3647, 3954, 4301, 4792, 4887, 5279, 5605, 5849, 6270, 6684, 6864, 7003, 7170, 7264, 7635, 7973, 8246, 8393, 8493, 8629, 9037, 9317, 9417, 9662, 10269, 10474, 10860, 10960, 11498, 12126, 13003, 13180]","[0, 233, 429, 749, 872, 1002, 1092, 1354, 1513, 1859, 2326, 2416, 2797, 3343, 3564, 3912, 4414, 4509, 4604, 4761, 5021, 5116, 5418, 5512, 5607, 5774, 5868, 6044, 6526, 7193, 7557, 7657, 7982, 8390, 9169, 9269, 9369, 9667, 9811, 9938, 10038, 10283, 11160, 12010, 12110]",28335,25148,20312,13180,12110,296,408,-3241,2868,211,542,45,dire
7561842010,120,21,28,79,85,"[60, 379, 807, 1057, 1473, 1841, 2180, 2440, 2723, 3181, 3713, 4317, 4569, 4757, 5268, 5998, 7184, 7764, 8290, 8798, 9581, 10426, 11091, 11596, 12733, 13533, 14750, 15562, 16427, 17356, 17961, 18992, 19507, 19811, 20795, 20895, 21591, 22245, 22345, 23154, 23999, 24423, 26167, 27345, 28703]","[60, 394, 623, 1157, 1499, 1828, 2223, 2559, 2958, 3564, 4177, 4722, 4972, 5140, 5516, 6619, 7678, 8120, 8413, 8829, 9576, 10084, 10487, 10991, 11238, 12018, 12933, 13512, 14158, 15168, 15686, 16550, 17038, 18170, 18737, 19375, 20234, 21093, 21487, 22418, 23224, 24156, 24977, 25728, 27020]","[60, 384, 674, 958, 1382, 2111, 2729, 3135, 3575, 4119, 4812, 5318, 5510, 5876, 6573, 7479, 8328, 8822, 9523, 9928, 10306, 11131, 11514, 12235, 12330, 13677, 14291, 14490, 14857, 15670, 16064, 16446, 17088, 17521, 18272, 19195, 19663, 20303, 20403, 20936, 21161, 21585, 22209, 22999, 24397]","[328, 537, 627, 717, 967, 1160, 1315, 1453, 1659, 1913, 2479, 2623, 2915, 3513, 4070, 4477, 5129, 5585, 5961, 6695, 7501, 7911, 8090, 8189, 8596, 8861, 9480, 9815, 10046, 10333, 10478, 11031, 11219, 11450, 11700, 11808, 12783, 13427, 13816, 14148, 14437, 15117, 16100, 16416, 17392]","[60, 269, 406, 680, 987, 1117, 1254, 1426, 1572, 1796, 2379, 2523, 2743, 2933, 3516, 3961, 4357, 5231, 5471, 5777, 6206, 6549, 6716, 6967, 7720, 8007, 8315, 8455, 8757, 9177, 9324, 9840, 10105, 10205, 10780, 10880, 11300, 11888, 12440, 12540, 13207, 13919, 14673, 14893, 15904]",28703,27020,24397,17392,15904,12,39,96,27,112,"[0, 168, 452, 822, 1216, 1486, 1670, 1880, 2090, 2413, 2886, 3257, 4525, 4934, 5531, 6097, 7097, 7516, 7745, 8820, 9336, 10039, 10768, 11539, 12310, 12911, 13934, 14378, 15374, 16098, 16643, 16842, 18026, 18769, 20915, 22240, 23140, 24965, 25968, 27031, 28321, 30035, 31273, 31697, 32218]","[0, 202, 436, 724, 1042, 1458, 1791, 2149, 2797, 3058, 3628, 4537, 4999, 5655, 6132, 6470, 7023, 7902, 8471, 9003, 9293, 9669, 10378, 10823, 11347, 11647, 12492, 12820, 13554, 14307, 14984, 15084, 15372, 16105, 16697, 17190, 17734, 18336, 19080, 19290, 20451, 21241, 22388, 22938, 23615]","[0, 205, 452, 724, 1222, 1431, 1782, 2327, 2818, 3368, 3692, 4036, 4742, 5118, 5849, 6046, 6858, 7161, 7355, 7808, 8080, 8280, 8900, 9224, 9776, 10071, 10272, 10808, 11221, 11595, 11823, 12179, 12708, 13008, 13907, 14410, 14770, 15756, 16189, 16448, 17162, 17389, 18191, 18944, 19090]","[0, 129, 219, 362, 709, 848, 982, 1072, 1492, 1701, 2121, 2477, 3049, 3921, 4127, 4306, 5357, 5795, 6140, 6297, 6392, 6681, 7276, 7677, 8156, 8380, 8588, 9017, 9549, 10149, 10320, 10695, 11096, 11471, 12858, 13158, 13674, 13940, 14705, 15202, 16237, 16753, 17776, 18551, 18676]","[0, 129, 219, 309, 490, 580, 1002, 1186, 1370, 1579, 1849, 2141, 2570, 2725, 2986, 3080, 3643, 4138, 4406, 4866, 5310, 5534, 6334, 6627, 6866, 7285, 7380, 7835, 8437, 9040, 9273, 9373, 9723, 10049, 10932, 11474, 11889, 12180, 13337, 13664, 14883, 15343, 16269, 16693, 17159]",32218,23615,19090,18676,17159,-3515,3405,5307,-1284,-1255,2658,45,dire
7565176702,53,120,40,97,30,"[0, 580, 707, 1055, 1307, 1731, 1840, 2047, 2930, 3236, 4256, 4513, 5191, 5796, 6473, 7012, 8083, 9408, 10376, 10902, 11338, 12191, 12336, 12784, 13683, 14421, 15312, 15882, 17811, 18683, 19615, 20884, 22034, 22627, 23686, 24188, 25389, 26150, 27187, 27890, 28940, 29619, 29854, 30753, 31590]","[0, 346, 616, 867, 1125, 1493, 1687, 2625, 2879, 3231, 3700, 3790, 4192, 4716, 5235, 5612, 5897, 6664, 7600, 8236, 8689, 9127, 9743, 10064, 10876, 11396, 11776, 11871, 12861, 13476, 13875, 14984, 15687, 16031, 16944, 17543, 18270, 19165, 20188, 20724, 21214, 21429, 22187, 23530, 24101]","[0, 192, 492, 661, 924, 1435, 1666, 1801, 2228, 2415, 2706, 2796, 3126, 3429, 3907, 4390, 5219, 5973, 6650, 7262, 7772, 7962, 8494, 8723, 9307, 9782, 10805, 10900, 11635, 12392, 12794, 13229, 13564, 13908, 14628, 14788, 15255, 16270, 17413, 17748, 18162, 18640, 19112, 19897, 20735]","[0, 192, 331, 459, 753, 1097, 1561, 1977, 2155, 2436, 2862, 3036, 3409, 3794, 4181, 4441, 4713, 5179, 5715, 6410, 6658, 7134, 7414, 7509, 8359, 8630, 9074, 9758, 10668, 11626, 12324, 13155, 13641, 14615, 15085, 15941, 17173, 17613, 18325, 18425, 18742, 19090, 19397, 20066, 20276]","[0, 292, 434, 568, 816, 1353, 1566, 1701, 1963, 2232, 2585, 2675, 2765, 2914, 3387, 4116, 4345, 4672, 5220, 5619, 5714, 5893, 5987, 6082, 6965, 7204, 7465, 7765, 8814, 9126, 9576, 10147, 10447, 10547, 11205, 11508, 12156, 12549, 12860, 13006, 13205, 14100, 14519, 15129, 15761]",31590,24101,20735,20276,15761,98,41,69,123,79,"[0, 368, 680, 1004, 1364, 1785, 2200, 2445, 3261, 3490, 4335, 5365, 5597, 6525, 7095, 7881, 8911, 9006, 9530, 10427, 10997, 11442, 12769, 12936, 13218, 13976, 14810, 15589, 16051, 16228, 16724, 17843, 18802, 19175, 20018, 20411, 20787, 21547, 22319, 23160, 24250, 25049, 25239, 25977, 26666]","[0, 247, 495, 700, 996, 1533, 1817, 2322, 2630, 3292, 3747, 4510, 4872, 5169, 5581, 6527, 6983, 7234, 7610, 8233, 9085, 9853, 10266, 10433, 10633, 11113, 11878, 12906, 13803, 14462, 15497, 16228, 16698, 17293, 17669, 18347, 18982, 19082, 20247, 21042, 21815, 23902, 24355, 24730, 25066]","[0, 210, 492, 686, 971, 1147, 1556, 2019, 2163, 2786, 3212, 3606, 3877, 4348, 4607, 5437, 6052, 6620, 7950, 8404, 8813, 9306, 10452, 10720, 10975, 11615, 12310, 12704, 12848, 13200, 13430, 14072, 14509, 15030, 15458, 15821, 16354, 16549, 17083, 17282, 18682, 18942, 19402, 19990, 20465]","[0, 210, 300, 425, 563, 728, 938, 1131, 1221, 1472, 1699, 2201, 2345, 2549, 2730, 3268, 3499, 3895, 4214, 4621, 4956, 5384, 6359, 6948, 7425, 7804, 8229, 8650, 8766, 8943, 9459, 9616, 9987, 10150, 10417, 11255, 12031, 12131, 12893, 13628, 14876, 15675, 16555, 17306, 17621]","[0, 210, 300, 390, 480, 659, 749, 839, 1145, 1539, 1674, 2017, 2213, 2483, 2835, 3457, 3650, 3745, 4310, 4551, 4653, 4913, 5570, 6030, 6200, 6370, 6539, 6848, 7066, 7356, 7527, 7702, 7967, 8186, 8405, 8580, 9072, 9247, 9721, 10184, 10697, 11119, 11513, 12399, 12813]",26666,25066,20465,17621,12813,4924,-965,270,2655,2948,9832,45,radiant
7565603215,113,63,14,72,26,"[0, 282, 621, 901, 1169, 1539, 1937, 2271, 2686, 3149, 3821, 4133, 4439, 4951, 5476, 6020, 6450, 7204, 7672, 8283, 8753, 9183, 9634, 10933, 11643, 12416, 13299, 13609, 14312, 14666, 16270, 17224, 18119, 18514, 19638, 20690, 21994, 22585, 24218, 25163, 26399, 27725, 28917, 30285, 31271]","[0, 245, 561, 970, 1274, 1590, 2017, 2242, 2441, 3141, 3634, 4229, 4669, 5456, 6026, 6711, 7244, 8225, 9300, 9853, 10510, 11617, 12198, 13278, 13923, 14954, 15708, 15802, 16012, 16591, 17660, 18318, 18975, 19909, 21669, 22086, 23193, 23609, 24603, 25786, 26578, 27471, 28434, 29186, 29565]","[0, 290, 604, 855, 1252, 1574, 1852, 1942, 2409, 2977, 3425, 3751, 4296, 4859, 5428, 5732, 6739, 6997, 7182, 7436, 7958, 8160, 8646, 8990, 9194, 9612, 10118, 10212, 10623, 10909, 11584, 12268, 12502, 12722, 14407, 15104, 15621, 16028, 16513, 17090, 17583, 18470, 18707, 19103, 19490]","[0, 261, 351, 489, 856, 1093, 1259, 1408, 1754, 2301, 2679, 2944, 3477, 3835, 3981, 4252, 4496, 4834, 5102, 5356, 5724, 5998, 6541, 6688, 6892, 7223, 7747, 7841, 8150, 8493, 9919, 10367, 10529, 10817, 11690, 11925, 12071, 12220, 12919, 13432, 14151, 15005, 15696, 15966, 16580]","[0, 209, 640, 730, 865, 1073, 1258, 1348, 1874, 2132, 2488, 2624, 2804, 3007, 3187, 3372, 3715, 4037, 4284, 4538, 4809, 5044, 5139, 5278, 5372, 5556, 5804, 5898, 6312, 6485, 6859, 7048, 7172, 7472, 8324, 8843, 8943, 9043, 9462, 10053, 10441, 10997, 11234, 11459, 11961]",31271,29565,19490,16580,11961,21,98,49,105,58,"[0, 237, 484, 890, 1220, 1800, 2285, 2791, 2881, 3595, 4095, 4508, 5201, 5924, 6590, 7101, 7821, 8501, 9193, 10459, 11017, 11112, 11773, 12459, 13058, 13646, 14682, 15970, 17024, 17848, 18260, 18668, 19068, 19942, 20762, 20952, 21245, 21846, 22647, 23606, 24662, 25198, 25807, 26674, 28075]","[0, 287, 499, 907, 1285, 1704, 2435, 3219, 3637, 4355, 4445, 4719, 5613, 6152, 6568, 7219, 7901, 8381, 8959, 9483, 10139, 10437, 11304, 12323, 12821, 13575, 14493, 15341, 16114, 16586, 17123, 18385, 19153, 19539, 20231, 20421, 21366, 21849, 22309, 22865, 23192, 23732, 23967, 24344, 24713]","[0, 248, 558, 769, 1346, 1707, 2240, 2426, 2913, 3369, 3774, 4053, 4657, 5233, 5737, 6088, 6937, 7314, 7677, 8518, 8708, 8928, 9095, 9638, 10461, 10878, 11255, 12306, 13351, 13753, 14302, 15037, 15137, 15905, 16849, 17293, 17659, 18278, 18425, 19230, 19578, 19927, 20680, 21197, 21331]","[0, 129, 219, 309, 796, 930, 1143, 1494, 1584, 1793, 1883, 2009, 2224, 2632, 2727, 2904, 3283, 3697, 3840, 4392, 4702, 4797, 5300, 5717, 5899, 6156, 6533, 7670, 7848, 8205, 8388, 8851, 8951, 9051, 9305, 9495, 9643, 9775, 10006, 10280, 10699, 11137, 11237, 11550, 11650]","[0, 181, 306, 396, 535, 992, 1263, 1614, 1704, 2011, 2141, 2575, 2720, 2972, 3229, 3488, 3891, 4043, 4409, 4782, 5055, 5150, 5589, 5926, 6239, 6736, 6959, 7399, 7767, 8070, 8253, 8493, 8593, 8764, 9105, 9440, 9773, 9888, 10323, 10522, 10840, 10940, 11075, 11346, 11534]",28075,24713,21331,11650,11534,3196,4852,-1841,4930,427,11564,45,radiant
7565753404,49,32,137,121,26,"[1007, 1282, 1696, 1988, 2583, 2882, 3105, 3281, 3796, 4131, 4621, 5421, 6068, 6605, 7236, 8085, 9330, 10229, 11365, 12266, 13168, 13693, 14266, 14739, 15825, 16590, 17425, 18673, 20139, 20638, 21472, 23064, 24117, 25334, 25768, 28545, 29054, 31140, 32119, 33799, 35373, 36721, 37141, 39478, 40306]","[664, 1077, 1400, 1768, 2179, 2701, 2834, 3445, 3875, 4572, 4830, 5161, 5513, 5984, 6810, 7270, 7901, 8600, 9239, 9793, 10032, 10223, 10947, 11359, 11837, 12007, 12479, 13027, 13337, 13695, 13795, 14511, 15111, 15382, 16080, 17201, 18265, 18795, 19111, 19429, 19529, 19629, 20483, 21446, 22059]","[788, 1002, 1332, 1733, 2288, 3095, 3703, 4239, 4410, 5103, 5859, 6279, 6434, 6687, 7209, 7535, 7954, 8369, 9106, 9508, 9843, 10352, 10591, 11055, 11938, 12408, 12651, 13086, 13714, 14264, 14364, 15999, 16468, 16568, 17150, 18442, 18677, 19412, 19611, 20239, 20548, 21463, 21563, 22417, 22768]","[418, 508, 681, 868, 1073, 1396, 1535, 1777, 1912, 2239, 2384, 2569, 2664, 2758, 3216, 3366, 3821, 4092, 4549, 4832, 5146, 5523, 5837, 6216, 6669, 7021, 7192, 7546, 7717, 8194, 8315, 8860, 9178, 9353, 9768, 10171, 10649, 11192, 11466, 11789, 12205, 12611, 13236, 14101, 14684]","[553, 715, 876, 1031, 1471, 1689, 1817, 1907, 2216, 2391, 2619, 3178, 3514, 3608, 3903, 4218, 4666, 5304, 5674, 6160, 6579, 7233, 7472, 7680, 7922, 8016, 8112, 8289, 8385, 8575, 8675, 9227, 9527, 9724, 9887, 11050, 11642, 12643, 12842, 13160, 13260, 13360, 13460, 14360, 14591]",40306,22059,22768,14684,14591,41,78,53,90,20,"[478, 816, 1523, 1767, 2111, 2334, 2693, 3183, 3737, 4160, 4539, 4863, 5377, 5824, 6148, 6716, 7352, 8122, 8663, 9175, 9790, 10788, 12519, 13730, 14208, 15029, 16460, 17301, 17621, 18368, 19361, 20170, 20971, 21733, 22340, 23451, 23650, 24235, 24543, 25644, 26741, 27217, 30304, 30819, 30925]","[372, 708, 798, 1207, 1414, 2048, 2508, 3063, 3699, 4175, 4718, 5249, 5688, 6168, 6702, 7004, 7541, 8081, 8299, 9129, 9709, 10500, 12344, 12793, 13023, 13523, 14309, 14678, 15298, 15875, 16797, 17290, 17939, 18670, 19344, 20264, 20916, 21560, 21660, 22250, 22870, 23637, 24847, 25166, 25272]","[319, 493, 787, 1016, 1384, 1509, 1827, 2366, 2665, 2806, 2896, 3045, 3431, 3742, 3960, 4390, 4659, 4993, 5473, 5806, 5976, 6633, 7629, 7871, 8410, 8579, 9395, 10068, 10301, 11218, 12437, 12892, 13810, 14042, 14480, 15459, 15733, 16020, 16744, 17119, 18144, 19131, 20184, 21306, 21872]","[535, 814, 1052, 1531, 1832, 2344, 2599, 3371, 4301, 4541, 4786, 5225, 5572, 6027, 6449, 6967, 7596, 7951, 8357, 8452, 8924, 9521, 9875, 10357, 10587, 10888, 11781, 12219, 12603, 13102, 13837, 13987, 14481, 14898, 15389, 16137, 17039, 17568, 17790, 18408, 18828, 19556, 20585, 21067, 21628]","[219, 309, 567, 707, 879, 1086, 1324, 1685, 2038, 2334, 2488, 2676, 2874, 2968, 3126, 3332, 4048, 4222, 4317, 4412, 4739, 4936, 5629, 5913, 6143, 6237, 6874, 7079, 7175, 7440, 7775, 7875, 8134, 8477, 8577, 9897, 10096, 10366, 10466, 10909, 11050, 11355, 11455, 11665, 11918]",30925,25272,21872,21628,11918,9381,-3213,896,-6944,2673,2793,45,radiant
7566090506,41,98,97,128,105,"[76, 321, 609, 857, 1142, 1426, 1862, 2493, 2909, 3440, 4218, 4474, 4757, 5427, 5942, 6382, 7037, 7808, 8876, 9463, 10582, 10800, 11407, 11905, 12699, 12794, 13442, 13715, 14627, 15180, 16909, 18035, 18589, 19835, 20482, 20769, 21551, 22389, 22780, 23991, 24091, 25407, 26455, 29344, 31055]","[76, 281, 643, 967, 1287, 1774, 2074, 2584, 2979, 3679, 4216, 4375, 4967, 5294, 5806, 6178, 6725, 7638, 8367, 8501, 9173, 9268, 9680, 10058, 10620, 10786, 11360, 11455, 12031, 12554, 14882, 15404, 16011, 16608, 16908, 17526, 18476, 19077, 19849, 21457, 21557, 22797, 23575, 26282, 27823]","[76, 359, 740, 938, 1288, 1694, 2124, 2341, 2934, 3510, 3764, 4233, 4742, 5202, 5556, 5651, 6263, 7354, 7854, 8216, 8676, 8771, 9336, 9925, 10518, 10803, 11357, 11967, 12845, 13150, 14827, 15672, 16708, 17713, 18114, 18356, 18781, 19280, 19589, 20185, 20285, 20574, 22354, 24218, 25847]","[209, 636, 778, 1019, 1195, 1386, 1565, 1700, 1790, 2118, 2647, 2737, 2873, 2967, 3062, 3206, 3486, 4524, 5090, 5438, 5724, 5819, 6000, 6168, 6262, 6357, 6492, 6765, 7345, 7571, 8750, 9067, 9280, 9885, 10219, 10319, 10554, 10728, 10828, 10928, 12514, 13200, 13737, 15368, 16621]","[76, 246, 469, 589, 807, 1034, 1169, 1304, 1605, 1931, 2111, 2201, 2291, 2400, 2534, 2915, 3072, 3596, 4008, 4359, 4671, 4841, 5528, 5736, 5976, 6271, 6475, 6831, 7082, 7253, 8605, 8794, 8894, 9501, 9704, 9924, 10397, 10595, 11102, 12036, 12887, 13231, 13756, 15099, 15850]",31055,27823,25847,16621,15850,21,137,135,53,19,"[250, 469, 944, 1352, 1796, 2230, 2697, 3140, 3766, 4427, 5016, 5500, 6318, 6956, 7663, 8209, 8702, 9494, 10178, 10679, 11395, 12270, 13320, 14024, 14657, 15582, 16720, 17653, 18286, 18624, 19165, 20068, 21144, 21625, 22178, 23307, 24496, 25658, 25963, 28383, 29447, 30149, 30963, 31645, 31745]","[117, 375, 608, 909, 1463, 1747, 2241, 3031, 3541, 3744, 4164, 4417, 4949, 5440, 5882, 6392, 7365, 7834, 8802, 9544, 10408, 11142, 11889, 12459, 12858, 13628, 14611, 15360, 15911, 16257, 16544, 16733, 17598, 18219, 18799, 19509, 20305, 21464, 21564, 23168, 23990, 24225, 25047, 25147, 25247]","[117, 287, 599, 860, 1233, 1361, 1801, 2205, 2572, 2831, 3227, 3771, 4784, 5074, 5532, 5969, 6474, 6610, 6940, 7710, 8497, 9100, 9526, 10184, 10836, 11509, 12334, 13198, 13893, 14496, 14874, 15244, 15947, 16250, 16532, 17073, 17746, 18708, 19215, 20630, 21010, 21245, 21453, 21599, 21699]","[117, 287, 377, 467, 597, 914, 1004, 1463, 2037, 2332, 2572, 2882, 3448, 3813, 4250, 4753, 5050, 5313, 5658, 6053, 6429, 7373, 7771, 8452, 9310, 9707, 10434, 10887, 11610, 12331, 13067, 13256, 13911, 14465, 14948, 15760, 16504, 17497, 17835, 18492, 18872, 19362, 19570, 20067, 20440]","[385, 555, 765, 855, 985, 1272, 1619, 1906, 2244, 2334, 2667, 2794, 3634, 3935, 4262, 4685, 5260, 5360, 5620, 5913, 6147, 6654, 7007, 7217, 7534, 7914, 8633, 9085, 9262, 9920, 10398, 11114, 11716, 11816, 12041, 12499, 13015, 14107, 14437, 14667, 15047, 15875, 16483, 16583, 16683]",31745,25247,21699,20440,16683,-690,2576,4148,-3819,-833,1382,45,radiant
7566202716,70,21,49,123,75,"[0, 321, 516, 991, 1317, 1589, 2624, 2997, 3087, 3676, 4182, 4836, 5323, 6309, 7003, 7583, 8399, 9805, 9902, 10405, 10889, 11958, 12690, 13258, 14447, 15196, 15834, 16458, 17055, 17256, 17583, 18046, 19336, 20975, 21938, 22038, 22705, 23424, 24523, 25115, 25314, 25414, 25754, 27298, 28801]","[0, 301, 574, 888, 1283, 1389, 1707, 2032, 2417, 2872, 3164, 3732, 4405, 4959, 5534, 6004, 6622, 7409, 7506, 8057, 8616, 9335, 9773, 10490, 10740, 11558, 12509, 12984, 13761, 14754, 15040, 15857, 17031, 17545, 18222, 19046, 19664, 20337, 21539, 22293, 22492, 23201, 24470, 25455, 26916]","[0, 246, 580, 776, 1027, 1446, 1715, 2044, 2447, 2823, 3336, 3696, 4368, 4754, 5269, 5829, 6590, 7211, 7459, 7992, 8626, 8897, 9709, 10268, 11137, 12054, 12591, 12965, 13457, 14329, 15352, 15968, 16831, 18166, 19233, 20062, 20554, 20959, 21814, 22215, 22414, 23069, 23310, 24818, 26685]","[0, 210, 337, 427, 563, 671, 761, 896, 986, 1076, 1256, 1425, 1695, 1906, 2164, 2669, 3144, 3484, 3683, 4183, 4334, 4605, 4764, 5142, 5397, 5564, 5846, 6289, 6488, 6913, 7393, 7684, 8936, 9256, 9928, 10449, 10836, 11228, 12399, 12754, 13251, 13791, 14111, 15534, 16727]","[0, 210, 350, 488, 623, 729, 938, 1073, 1235, 1366, 1501, 1606, 1876, 2270, 2579, 2756, 3112, 3398, 3495, 3924, 4216, 4540, 4820, 5023, 5230, 5397, 5599, 5694, 5957, 6216, 6567, 6885, 7750, 8484, 9382, 9639, 10073, 10385, 11101, 11456, 11655, 12189, 12592, 13450, 14718]",28801,26916,26685,16727,14718,102,98,39,110,26,"[0, 253, 899, 1199, 1655, 2089, 2720, 3374, 3623, 4025, 4545, 5064, 5416, 6058, 6767, 7481, 8434, 8751, 8846, 9229, 10222, 10811, 11410, 11999, 12313, 13045, 14049, 14735, 15518, 16387, 17614, 18530, 19682, 19782, 20222, 20322, 20709, 21800, 22272, 23452, 25174, 25636, 26388, 26536, 26636]","[0, 201, 517, 757, 1061, 1294, 1556, 1941, 2350, 2607, 2778, 3126, 3788, 4504, 5433, 5991, 6467, 7257, 7685, 8487, 9055, 9282, 9887, 10374, 10824, 11444, 12417, 13712, 14429, 14854, 15641, 15831, 17002, 17102, 17306, 18312, 18642, 19352, 20030, 21472, 22935, 23896, 24216, 24316, 24416]","[0, 164, 373, 497, 747, 943, 1152, 1403, 1704, 1916, 2244, 2338, 2644, 3078, 3626, 3833, 4182, 4277, 4687, 5231, 5731, 6336, 7019, 7276, 7706, 7839, 8650, 8933, 9371, 9927, 10665, 11154, 12284, 12524, 13347, 13779, 13914, 14992, 15176, 16055, 17354, 17789, 19037, 19194, 19482]","[0, 130, 295, 385, 554, 932, 1188, 1368, 1749, 2070, 2252, 2393, 2565, 2879, 3186, 3281, 3689, 3784, 4032, 4631, 4788, 5086, 5328, 5598, 6106, 6325, 6697, 7023, 7384, 7994, 8381, 8762, 9209, 9384, 9559, 10053, 10228, 10717, 11140, 11445, 11719, 12084, 12259, 12434, 12784]","[0, 176, 313, 403, 493, 583, 940, 1120, 1437, 1601, 1736, 1886, 1976, 2268, 2546, 2641, 2888, 3013, 3449, 4129, 4395, 4659, 4826, 5107, 5730, 6074, 6345, 6671, 7071, 7539, 7851, 8195, 8443, 8670, 8770, 8958, 9058, 9384, 9576, 10501, 11093, 11351, 11451, 11599, 11699]",26636,24416,19482,12784,11699,2165,2500,7203,3943,3019,18830,45,radiant
7566637019,49,95,107,123,121,"[376, 738, 1053, 1261, 1714, 2316, 2815, 3482, 3886, 4635, 5577, 5867, 6674, 7170, 7645, 8368, 9200, 9986, 10588, 11007, 11660, 12955, 13586, 14135, 14890, 15743, 16675, 17208, 17863, 18691, 19344, 20141, 20619, 20953, 22173, 22856, 24837, 25804, 26383, 26842, 27477, 28298, 29287, 30051, 30804]","[240, 522, 719, 1019, 1459, 1654, 2386, 3053, 3304, 3661, 4056, 4660, 5159, 5584, 6201, 6974, 7949, 8730, 9006, 9930, 10345, 11486, 12163, 12943, 13815, 14256, 14872, 16211, 16857, 18276, 19216, 20769, 22535, 23018, 23238, 23338, 24734, 24834, 25310, 25751, 25851, 26615, 27234, 27812, 28677]","[506, 870, 1157, 1494, 1794, 2128, 2691, 3515, 4037, 4716, 5351, 5937, 6280, 7383, 7678, 7822, 8511, 9598, 9977, 11330, 11583, 12959, 13261, 13624, 14117, 15243, 15779, 16528, 16749, 17814, 17910, 18410, 18937, 19258, 20143, 20445, 22268, 23146, 23653, 23938, 24038, 24621, 25117, 25768, 26208]","[373, 583, 673, 763, 940, 1351, 1896, 2378, 2468, 2648, 3113, 3366, 3608, 4112, 4297, 4392, 4612, 5181, 5453, 5967, 6062, 6157, 6459, 6824, 7183, 7806, 8274, 8866, 9467, 9843, 10133, 10873, 11397, 11544, 11876, 11976, 12211, 12311, 12677, 12969, 13268, 13709, 14111, 14582, 15060]","[108, 318, 408, 498, 707, 797, 1127, 1418, 1553, 1786, 2057, 2362, 2982, 3474, 3661, 3775, 4169, 4836, 4931, 5645, 5740, 6336, 6638, 6914, 7209, 7768, 7992, 8251, 8730, 9339, 9435, 10075, 10709, 10928, 11260, 11597, 11832, 12252, 12670, 12909, 13263, 13749, 14484, 15412, 15778]",30804,28677,26208,15060,15778,82,126,69,64,45,"[154, 309, 630, 1149, 1396, 1603, 1812, 2030, 2478, 2856, 3207, 3764, 4356, 4672, 5160, 5897, 6570, 6776, 7574, 8252, 9094, 9732, 10324, 11198, 12182, 12990, 13735, 14135, 14438, 15669, 16833, 18722, 18822, 19322, 20986, 22087, 23260, 23360, 24166, 25811, 26823, 27714, 28601, 30126, 31554]","[287, 564, 818, 1217, 1504, 1956, 2526, 3122, 3794, 4089, 4857, 5020, 5460, 5997, 6181, 6672, 7193, 7343, 7682, 8174, 9097, 9768, 9863, 10331, 10729, 11350, 11571, 11988, 12084, 13171, 13719, 14697, 15098, 16104, 17203, 17642, 18477, 18622, 19155, 19921, 20213, 20700, 21658, 22136, 22534]","[154, 378, 499, 900, 1128, 1577, 1856, 2173, 2425, 2750, 3446, 3907, 4287, 4873, 5326, 5969, 6473, 7434, 7773, 8332, 8427, 8968, 9089, 9652, 10622, 11398, 12091, 12601, 12857, 13279, 13482, 14308, 14640, 14839, 16619, 17011, 17830, 18205, 18577, 19303, 19673, 19773, 20436, 21089, 21305]","[154, 309, 486, 606, 993, 1183, 1396, 1639, 1833, 2166, 2991, 3156, 3246, 3494, 3589, 4256, 4511, 4651, 4840, 5731, 6011, 6945, 7247, 7979, 8517, 8924, 9198, 9292, 9508, 10097, 10349, 11000, 11272, 11793, 12237, 12592, 13655, 13960, 14609, 15489, 16104, 16306, 17078, 17637, 18040]","[287, 691, 781, 992, 1160, 1285, 1421, 1601, 1795, 1979, 2413, 2503, 2593, 2878, 3127, 3823, 3917, 4057, 4152, 4357, 4452, 4737, 4832, 5169, 5646, 5847, 5942, 6223, 6746, 8201, 8433, 9045, 9379, 10019, 11392, 11709, 12368, 12626, 12774, 13868, 14222, 14322, 14815, 15198, 15298]",31554,22534,21305,18040,15298,-750,6143,4903,-2980,480,7796,45,radiant
7566638207,97,107,136,72,100,"[0, 323, 574, 1002, 1402, 1737, 2817, 3119, 3846, 4493, 5159, 5620, 6265, 7050, 7351, 8186, 8931, 9252, 10089, 11022, 11371, 11868, 13070, 13670, 13991, 14085, 15033, 15642, 16124, 16370, 17097, 17725, 18233, 19140, 20672, 22253, 23519, 24466, 25001, 25101, 25737, 27149, 28532, 28965, 29214]","[0, 279, 498, 859, 1179, 1383, 1761, 2022, 2452, 2914, 3361, 3780, 4252, 4985, 5796, 5982, 6871, 7480, 8264, 9050, 9277, 10147, 10751, 11347, 11962, 12334, 12900, 13389, 14024, 15029, 15684, 15874, 16558, 17713, 18603, 19255, 20148, 21165, 21476, 21576, 23315, 23893, 24980, 25421, 26326]","[0, 204, 439, 1015, 1348, 1879, 2389, 2992, 3930, 4209, 5367, 6136, 6989, 7365, 8131, 8408, 8792, 9707, 10423, 10779, 11441, 11960, 12558, 13287, 13961, 14228, 15481, 15658, 16339, 16683, 17355, 18027, 18895, 20459, 20649, 21464, 23407, 24302, 24597, 24888, 24988, 25857, 26064, 26345, 26567]","[100, 270, 663, 922, 1056, 1233, 1399, 1579, 1879, 1991, 2544, 2871, 3139, 3345, 3630, 4114, 4567, 4881, 5062, 5610, 5828, 6503, 6861, 7171, 7266, 7526, 7621, 8322, 8844, 9224, 9463, 9726, 10529, 10832, 11682, 13002, 14329, 14906, 15191, 15291, 15923, 16636, 17034, 17458, 17682]","[100, 270, 411, 576, 716, 862, 1040, 1258, 1616, 1706, 2378, 2623, 2992, 3332, 3796, 3982, 4603, 4777, 4913, 5251, 5407, 5885, 6211, 6576, 6969, 7144, 7539, 7749, 8175, 8597, 9382, 9597, 10104, 10606, 11622, 12405, 13241, 14010, 14404, 14632, 14732, 15503, 15603, 15703, 15851]",29214,26326,26567,17682,15851,49,21,78,53,86,"[0, 363, 699, 1094, 1466, 2010, 2644, 2898, 3344, 3639, 3950, 4129, 4710, 5251, 5650, 6277, 6832, 7901, 9056, 9747, 10674, 10971, 11548, 12417, 12598, 13386, 13565, 14101, 15203, 16086, 16569, 17915, 18334, 18748, 19103, 19203, 19935, 21046, 22793, 24042, 25911, 26879, 28255, 28827, 30438]","[0, 287, 562, 682, 1186, 1386, 1646, 2256, 2609, 3079, 3630, 3850, 4554, 5204, 5736, 7154, 7592, 7941, 8450, 8930, 9576, 10460, 11106, 12202, 12596, 13186, 13748, 13917, 14414, 15564, 16067, 16949, 17844, 18465, 19449, 19549, 19649, 20170, 22273, 24055, 24880, 25105, 25970, 26552, 27517]","[0, 260, 500, 774, 1134, 1260, 1779, 2110, 2200, 2669, 3341, 4122, 4284, 5273, 5390, 5901, 6380, 6870, 7378, 7583, 8227, 8691, 9217, 9418, 9706, 9902, 10457, 10633, 11224, 11722, 12029, 12541, 13063, 13163, 13710, 13810, 13910, 14284, 15961, 16481, 17354, 17845, 18229, 18329, 18987]","[0, 170, 260, 415, 505, 595, 1063, 1425, 1515, 1706, 2078, 2222, 2723, 3358, 3569, 4035, 4391, 4675, 4985, 5319, 5905, 6192, 6562, 6788, 7087, 7707, 8121, 8251, 8653, 9163, 9259, 9630, 10422, 10522, 10684, 10898, 11300, 12131, 13121, 14277, 15108, 15688, 16188, 16288, 17138]","[0, 170, 605, 725, 861, 994, 1302, 1437, 1571, 1741, 2225, 2531, 2655, 3027, 3211, 3558, 3806, 3901, 4208, 4476, 4817, 4912, 5251, 5393, 5488, 5654, 5749, 5965, 6237, 6435, 6531, 6995, 7277, 7585, 8269, 8369, 8650, 8880, 9990, 10310, 11061, 11505, 11727, 11827, 12440]",30438,27517,18987,17138,12440,-1224,-1191,7580,544,3411,9120,45,dire
7566717109,82,55,63,123,112,"[0, 376, 732, 1020, 1501, 1815, 2095, 2476, 3107, 3832, 4273, 4938, 5560, 6245, 7172, 7432, 7572, 8123, 8485, 8887, 9757, 10490, 11609, 12256, 13008, 13915, 14897, 15958, 16647, 16847, 17196, 18486, 18811, 19761, 20549, 21720, 22878, 23728, 25321, 25864, 26635, 27908, 28967, 29748, 31199]","[0, 331, 916, 1201, 1580, 2268, 2754, 3304, 3881, 4393, 4630, 5060, 6082, 6986, 7473, 8126, 8817, 9570, 10318, 10815, 11415, 12091, 12418, 12647, 13156, 14392, 14985, 15670, 16252, 16431, 16527, 18070, 19120, 19674, 20395, 21243, 22861, 23023, 24647, 25685, 26138, 26655, 27308, 28169, 29638]","[0, 205, 416, 592, 1029, 1373, 1698, 1990, 2412, 2688, 3147, 3471, 3877, 4464, 4975, 5443, 6091, 6480, 7173, 7921, 8713, 9390, 10284, 10379, 11449, 11823, 12158, 13063, 13446, 14097, 14736, 16138, 17019, 17706, 18884, 19504, 19674, 20131, 21688, 21943, 22837, 23624, 23724, 24664, 25469]","[0, 170, 335, 522, 652, 1107, 1209, 1299, 1461, 1839, 2146, 2505, 3031, 3508, 3761, 3946, 4169, 4550, 4900, 5388, 5732, 6035, 6373, 6805, 7054, 7578, 7693, 8197, 8405, 8752, 9001, 10324, 11228, 11484, 11809, 12189, 13232, 13452, 14419, 14674, 15262, 15577, 15858, 17317, 17417]","[0, 170, 260, 350, 590, 844, 934, 1060, 1240, 1449, 1905, 2038, 2321, 2618, 2888, 2982, 3171, 3432, 3743, 4051, 4904, 5188, 5525, 5989, 6243, 6576, 6670, 7394, 7834, 7930, 8074, 8565, 9242, 9567, 9757, 10137, 10298, 10654, 11621, 12574, 12773, 13309, 13538, 13912, 14143]",31199,29638,25469,17417,14143,1,13,102,20,101,"[0, 247, 461, 928, 1160, 1398, 1900, 2314, 2790, 3097, 3731, 4058, 4374, 4693, 5027, 5554, 6209, 6922, 7501, 8393, 9086, 9715, 10901, 11254, 12073, 12560, 13360, 14306, 15332, 16623, 17310, 17707, 18637, 20063, 21032, 22316, 23357, 24790, 25773, 26759, 27695, 28624, 29827, 30708, 32735]","[0, 255, 660, 1067, 1364, 1713, 2238, 2884, 3328, 3626, 3996, 4511, 5333, 5740, 6649, 7483, 8334, 8858, 9242, 9763, 10164, 10880, 11964, 12698, 13670, 14930, 15554, 16423, 17059, 18521, 19357, 20319, 20419, 21522, 22159, 22771, 24546, 24804, 25414, 26164, 27518, 29424, 30737, 31352, 32826]","[0, 287, 446, 716, 1033, 1287, 1411, 1856, 1980, 2366, 2659, 2834, 3301, 3650, 4088, 4459, 5200, 5646, 6219, 6713, 7274, 7545, 8647, 9074, 9554, 9760, 10242, 10604, 10951, 11578, 12503, 12905, 13040, 13268, 13959, 14979, 15200, 15399, 17059, 17159, 17856, 18924, 19594, 20270, 22382]","[0, 307, 397, 788, 976, 1066, 1263, 1803, 1932, 2115, 2403, 2585, 3110, 3297, 3743, 4145, 4971, 5231, 5427, 5732, 6258, 6739, 7213, 7465, 7803, 8119, 8340, 8606, 9286, 9765, 10285, 10682, 10971, 11161, 11379, 11839, 12012, 12211, 13346, 13446, 13570, 14588, 14904, 15112, 16615]","[0, 170, 260, 380, 517, 652, 849, 1150, 1240, 1330, 1465, 1848, 2265, 2656, 2891, 3174, 3522, 3617, 3774, 3869, 4160, 4409, 5114, 5318, 5606, 6118, 6367, 6627, 7149, 7920, 8172, 8644, 8977, 9213, 9367, 9730, 9895, 10125, 10685, 10860, 11808, 12316, 12632, 12897, 13527]",32735,32826,22382,16615,13527,-1536,-3188,3087,802,616,-219,45,radiant
7568353308,4,22,69,110,121,"[0, 204, 561, 915, 1403, 1790, 2248, 2679, 3018, 3163, 3465, 3895, 4582, 5018, 5757, 6387, 6862, 7433, 8163, 8845, 9679, 10294, 10691, 12334, 13129, 13668, 14316, 15068, 15802, 16295, 18465, 19124, 19802, 20805, 21234, 21334, 21863, 22164, 22641, 23007, 23640, 24485, 25481, 25752, 26755]","[0, 326, 723, 1046, 1453, 1780, 2194, 2706, 2988, 3420, 4181, 4491, 5034, 5492, 6375, 6479, 7122, 7823, 8097, 9051, 9789, 10043, 10306, 10994, 11327, 11924, 12146, 12240, 12748, 12967, 13959, 14533, 15364, 15758, 16282, 17465, 17788, 18344, 18779, 19463, 20302, 20846, 21381, 21481, 21836]","[0, 206, 333, 423, 634, 1050, 1140, 1266, 1737, 2199, 2581, 2765, 3665, 4155, 4363, 4667, 5147, 5592, 6264, 6840, 8372, 8627, 9208, 10095, 10591, 11069, 11324, 11522, 11817, 12132, 13377, 14034, 15222, 15616, 15774, 16162, 16636, 17694, 18056, 18536, 18917, 19395, 19970, 20272, 21472]","[0, 170, 260, 417, 555, 896, 1776, 1866, 2213, 2498, 2623, 3109, 3508, 3773, 4120, 4217, 4477, 4913, 5464, 5559, 5978, 6586, 6866, 7554, 8003, 8222, 8317, 8411, 8646, 8787, 9834, 10416, 10789, 11414, 11968, 12068, 12168, 12448, 12654, 12838, 12988, 13088, 13188, 13421, 15344]","[0, 170, 260, 422, 512, 788, 1136, 1226, 1360, 1495, 1748, 1885, 2335, 2484, 2867, 3071, 3587, 3691, 4222, 4645, 5682, 5956, 6182, 6990, 7266, 7473, 7643, 8089, 8475, 8781, 10057, 10445, 10691, 11018, 11272, 11372, 11853, 12213, 12404, 12991, 13091, 13300, 13641, 13865, 15110]",26755,21836,21472,15344,15110,21,120,129,53,136,"[0, 251, 864, 1647, 2173, 2614, 3224, 3865, 4392, 4517, 5611, 6303, 6843, 7293, 8064, 8572, 9695, 10158, 11227, 11819, 12584, 12679, 13482, 13872, 14705, 15581, 16743, 17789, 18563, 19131, 20032, 20879, 21685, 21785, 23781, 24541, 25741, 26798, 27475, 28067, 28409, 29553, 30360, 31528, 32627]","[0, 329, 682, 1095, 1548, 1923, 2525, 2828, 3700, 4182, 5106, 5776, 6095, 6707, 7388, 8095, 8252, 9014, 10058, 10955, 12313, 12808, 13523, 13759, 14437, 15214, 15750, 16868, 17501, 17828, 18186, 18556, 19684, 20064, 20164, 21155, 22403, 23444, 24258, 24628, 24970, 26438, 26716, 27441, 28518]","[0, 274, 585, 746, 914, 1294, 1747, 2118, 2600, 3206, 3751, 3985, 4237, 4484, 5052, 5429, 6115, 6970, 7847, 8380, 8935, 9030, 9698, 10063, 10720, 11186, 11617, 12831, 13400, 13706, 14540, 14988, 15390, 15490, 16050, 16727, 17160, 17656, 18232, 18742, 18941, 19280, 19747, 20858, 21497]","[0, 170, 344, 591, 776, 1128, 1567, 1930, 2284, 2507, 3313, 3916, 4208, 4467, 4719, 5006, 5576, 5901, 6744, 7512, 8058, 8153, 8592, 9075, 9717, 10226, 11383, 12127, 12549, 12845, 13245, 13735, 14729, 14829, 16237, 17043, 17544, 18399, 18965, 19694, 20036, 20896, 21257, 22099, 22830]","[0, 170, 673, 921, 1106, 1444, 1718, 1853, 2110, 2200, 2452, 2770, 2933, 3241, 3640, 3735, 4517, 4722, 5424, 5681, 6512, 7029, 7394, 7634, 7779, 8035, 8466, 9346, 9885, 10261, 10745, 10985, 11262, 11489, 11628, 12427, 12855, 13846, 14034, 14429, 15086, 15357, 15499, 16131, 16503]",32627,28518,21497,22830,16503,-5872,-6682,-25,-7486,-1393,-21458,45,dire
7568433407,114,71,2,123,121,"[62, 303, 502, 703, 912, 1283, 1578, 2057, 2457, 2835, 3689, 4158, 4573, 4810, 5385, 5840, 6416, 6910, 7570, 8383, 8996, 9469, 9699, 10034, 10646, 11588, 12775, 13251, 14319, 14842, 15549, 16271, 17454, 17554, 19054, 20073, 20847, 21082, 22888, 23664, 24498, 24734, 24834, 25521, 26361]","[60, 353, 667, 914, 1078, 1293, 1706, 2235, 2574, 2916, 3839, 4144, 4789, 5350, 5711, 6249, 7161, 7346, 7755, 8226, 8408, 8675, 9242, 9662, 10040, 10262, 10744, 11158, 11836, 12279, 12839, 13063, 13719, 13819, 14779, 16021, 16554, 17041, 18288, 18388, 19212, 19743, 19843, 20345, 20988]","[328, 534, 880, 1105, 1338, 1743, 2326, 2873, 3267, 3471, 4127, 4845, 5271, 5668, 6156, 6895, 7560, 7844, 8281, 8745, 9213, 9969, 10575, 10814, 11088, 11527, 13190, 13641, 14184, 14280, 14618, 14718, 15903, 16099, 17041, 17850, 18608, 19376, 19476, 20104, 20501, 20769, 20869, 21395, 22046]","[60, 229, 319, 615, 705, 1070, 1324, 1586, 1721, 2113, 2332, 2737, 3087, 3430, 3961, 4359, 4731, 5256, 5580, 6079, 6209, 6520, 6785, 7034, 7376, 7870, 8956, 9279, 9990, 10086, 10708, 11386, 12222, 12643, 13273, 13902, 14362, 14947, 15929, 16470, 17248, 17764, 18216, 18597, 19517]","[60, 229, 337, 472, 664, 895, 1032, 1744, 2014, 2220, 2662, 2904, 3200, 3386, 3550, 3744, 4261, 4356, 4885, 5197, 5292, 5484, 5650, 5828, 6369, 6536, 7695, 8095, 8473, 8569, 8665, 8765, 9448, 9615, 10371, 10969, 11356, 11591, 12191, 12291, 12947, 13047, 13350, 13605, 13952]",26361,20988,22046,19517,13952,63,65,29,100,79,"[0, 250, 559, 876, 1232, 1445, 1689, 2003, 2317, 2726, 3299, 3389, 3817, 4348, 4745, 5159, 5603, 5875, 6401, 6819, 7872, 8348, 9029, 9792, 10634, 11138, 11407, 12419, 13134, 13929, 14787, 16054, 17212, 18033, 19107, 19207, 19591, 20534, 22052, 22587, 23515, 25944, 27599, 28005, 29211]","[0, 274, 562, 894, 1173, 1543, 2070, 2501, 2942, 3350, 3566, 3829, 4225, 4392, 4764, 5407, 5838, 6343, 6778, 7677, 8078, 8739, 9024, 9504, 10784, 11833, 12256, 12556, 13157, 13627, 14079, 14705, 16359, 16459, 16664, 16764, 17413, 18730, 19637, 19737, 20337, 22051, 22935, 23376, 23937]","[0, 169, 375, 704, 1154, 1591, 1911, 2261, 2652, 2742, 2926, 3253, 3540, 4242, 4692, 5466, 5665, 6249, 6663, 7277, 7647, 8082, 8546, 9025, 9587, 10268, 10733, 10914, 11390, 11675, 12598, 13321, 14339, 14645, 14927, 15027, 15379, 15562, 15761, 15996, 16589, 18191, 18816, 19211, 19506]","[0, 169, 259, 435, 565, 703, 793, 883, 1060, 1430, 1520, 1610, 1700, 2002, 2143, 2328, 2602, 2697, 2883, 3041, 3136, 3566, 3749, 4453, 5313, 5902, 6543, 6847, 7169, 7265, 7603, 8100, 8951, 9051, 9560, 10091, 10313, 10614, 11277, 11486, 11866, 12463, 13297, 13798, 13898]","[0, 169, 259, 397, 572, 799, 972, 1325, 1425, 1622, 2027, 2117, 2207, 2614, 2985, 3205, 3691, 3933, 4374, 4744, 4839, 5111, 5388, 5865, 6675, 7128, 7382, 7477, 7654, 7875, 7971, 8406, 8897, 8997, 9146, 9246, 9346, 9808, 10249, 10349, 10919, 12022, 12712, 12853, 13000]",29211,23937,19506,13898,13000,-2850,-2949,2540,5619,952,3312,45,dire
7568469704,93,97,47,19,112,"[0, 237, 582, 791, 1116, 1447, 1748, 1924, 2246, 2573, 2875, 3262, 3543, 4185, 4666, 5398, 6104, 6653, 7354, 8167, 9580, 10191, 10733, 11677, 12495, 13374, 13989, 14907, 15086, 15866, 16433, 17618, 17980, 19258, 20114, 21390, 22068, 22872, 23306, 23590, 23891, 24744, 26148, 27365, 27890]","[0, 316, 720, 965, 1263, 1586, 1808, 1993, 2370, 2645, 2998, 3444, 4426, 4824, 5085, 5594, 6019, 6584, 7005, 7163, 7693, 8176, 8353, 8930, 9334, 9868, 10223, 10901, 11200, 12020, 12530, 13013, 13378, 14479, 15009, 16087, 16223, 16529, 17467, 18310, 18809, 19207, 19876, 20312, 20647]","[0, 268, 495, 831, 1171, 1460, 1901, 2266, 2735, 2825, 3034, 3859, 4213, 4437, 4995, 5533, 5926, 6335, 6701, 7167, 7647, 8407, 8669, 8809, 8904, 9241, 9688, 10708, 10970, 11728, 11905, 12491, 12927, 13569, 15205, 15834, 16141, 16717, 16963, 17272, 17654, 17933, 18741, 19676, 20341]","[0, 194, 434, 524, 625, 760, 1094, 1184, 1681, 1855, 1975, 2218, 2512, 2813, 3424, 3938, 4339, 4684, 4994, 5152, 5859, 6278, 6791, 6886, 6981, 7358, 7686, 8410, 8506, 9278, 9455, 9860, 10139, 10239, 10591, 11588, 11688, 12312, 12820, 13234, 13619, 13719, 13819, 14272, 14529]","[0, 194, 284, 485, 623, 774, 864, 1069, 1375, 1534, 1754, 2042, 2205, 2457, 2718, 2896, 3054, 3326, 3420, 3712, 4479, 4911, 5015, 5255, 5447, 5717, 6244, 6339, 6435, 6924, 7318, 7997, 8673, 9450, 9933, 10516, 10616, 10716, 10997, 11434, 11674, 11774, 12587, 13004, 13261]",27890,20647,20341,14529,13261,102,76,96,121,26,"[0, 205, 1023, 1149, 1681, 1914, 2280, 2889, 3346, 3644, 4123, 4786, 5300, 6149, 6567, 7095, 7698, 8662, 9042, 9541, 9699, 10547, 11774, 12705, 13385, 13926, 14763, 15644, 15831, 16331, 16810, 17732, 18642, 18742, 19001, 19720, 20743, 21641, 22350, 22863, 23808, 24436, 25812, 26143, 27175]","[0, 285, 571, 734, 1023, 1156, 1400, 1672, 2017, 2587, 2945, 3331, 3791, 4336, 4897, 5567, 6243, 6937, 7802, 8367, 9032, 9809, 9975, 11398, 12262, 12888, 14000, 14548, 14739, 15886, 16536, 17162, 17918, 18400, 19064, 19434, 20269, 21096, 21758, 22161, 22704, 23978, 25174, 25274, 25742]","[0, 244, 605, 1045, 1505, 1795, 2188, 2770, 3147, 3631, 3934, 4298, 4864, 5445, 5847, 6352, 6799, 7279, 7894, 8160, 8426, 8658, 9273, 9741, 10243, 10685, 11032, 12049, 12145, 12736, 13149, 13541, 13914, 14518, 14759, 15327, 15803, 16355, 17278, 17617, 18236, 18492, 19224, 19633, 19916]","[0, 169, 259, 488, 672, 795, 977, 1293, 1716, 1892, 2378, 2468, 2793, 3080, 3282, 3553, 4067, 4351, 5208, 5686, 5844, 6245, 6635, 7254, 7548, 7753, 8060, 8526, 8735, 9212, 9308, 9821, 10639, 10848, 11389, 11759, 12191, 12643, 13378, 13478, 13883, 14327, 15350, 15450, 15909]","[0, 169, 540, 634, 844, 934, 1113, 1293, 1453, 1629, 1747, 1837, 2017, 2179, 2286, 2972, 3153, 3635, 4284, 4528, 4686, 5139, 5567, 6035, 6733, 6977, 7284, 7456, 7552, 7945, 8155, 8710, 9142, 9242, 9582, 10003, 10158, 10467, 10801, 10901, 11100, 11200, 11885, 12020, 12400]",27175,25742,19916,15909,12400,715,-5095,425,-1380,861,-4474,45,radiant
7568521216,41,128,47,19,112,"[0, 618, 780, 1177, 1373, 1834, 2032, 2715, 3189, 3439, 3615, 4140, 4944, 5386, 5590, 6154, 6804, 7429, 7814, 8443, 8573, 8909, 11387, 12124, 12939, 13553, 14272, 15366, 16379, 17057, 17711, 18260, 18360, 18770, 20269, 21744, 22057, 22592, 23243, 23874, 24304, 25039, 25966, 26683, 27371]","[0, 374, 720, 1122, 1284, 1751, 2198, 3095, 3185, 3814, 3904, 4537, 5128, 5580, 6233, 6373, 6804, 7175, 7805, 7985, 8628, 8894, 9252, 9842, 10511, 10902, 11517, 12209, 13373, 13878, 14644, 15051, 15228, 15648, 17213, 18422, 19077, 19838, 20716, 21742, 22765, 23500, 24067, 24383, 25197]","[0, 247, 483, 731, 903, 1029, 1365, 1949, 2039, 2241, 2571, 3084, 3486, 3911, 4464, 5311, 6153, 6892, 7544, 7702, 8273, 8738, 9989, 10270, 11048, 11515, 12020, 13096, 13785, 14417, 15018, 15506, 15606, 16134, 16619, 17029, 17994, 18094, 18483, 19115, 19572, 20092, 21425, 22061, 22676]","[0, 210, 300, 481, 571, 756, 893, 1193, 1516, 1606, 1696, 2080, 2682, 2878, 2973, 3246, 3449, 3761, 4023, 4553, 4693, 4877, 5916, 6405, 6882, 7159, 7309, 7711, 8557, 8734, 9462, 10645, 10745, 10845, 11660, 12107, 12638, 12738, 12838, 13664, 13913, 14630, 15243, 15624, 15834]","[0, 273, 397, 534, 624, 759, 849, 1301, 1624, 1889, 1979, 2311, 2876, 3344, 3582, 3902, 4220, 4488, 4673, 4831, 5279, 5606, 6337, 6432, 6634, 6806, 7166, 7568, 8028, 8258, 8650, 8892, 9069, 9397, 9882, 10292, 10482, 10738, 11089, 11323, 11495, 11741, 12479, 12857, 13067]",27371,25197,22676,15834,13067,21,96,137,45,26,"[0, 167, 467, 870, 1272, 1726, 2048, 2261, 2828, 3336, 3847, 4363, 4979, 5332, 5909, 6738, 7619, 8397, 9076, 10042, 11430, 12663, 13092, 13515, 13977, 15027, 15833, 16437, 16533, 17266, 18490, 18836, 19187, 20763, 21156, 21256, 22548, 23538, 24566, 25356, 26612, 28084, 28833, 29632, 30749]","[0, 130, 374, 656, 1101, 1420, 1840, 2050, 2628, 2973, 3338, 3652, 4128, 4319, 4971, 5421, 5877, 6465, 6835, 7636, 7893, 8380, 8591, 8932, 9479, 10083, 10517, 11058, 11892, 12396, 12980, 14079, 14732, 15428, 15656, 15756, 16768, 17179, 17768, 18135, 19061, 19680, 20645, 22256, 22727]","[0, 285, 546, 921, 1499, 1661, 2026, 2116, 3046, 3516, 4306, 5066, 5231, 5422, 5617, 6062, 7294, 7759, 8471, 9113, 9670, 10127, 10551, 11062, 11537, 11881, 12472, 12850, 12946, 13639, 14168, 15192, 15580, 16148, 16674, 17271, 18838, 19326, 19845, 20253, 20839, 21171, 21716, 22289, 23367]","[0, 180, 270, 406, 581, 727, 866, 956, 1323, 1452, 1773, 2015, 2345, 2860, 3719, 4121, 4671, 5207, 5851, 6560, 6870, 7078, 7455, 7834, 8264, 9042, 9883, 10148, 10319, 10586, 10851, 12540, 12798, 13632, 13869, 13969, 14401, 14983, 15272, 15707, 16306, 17048, 17148, 17575, 17970]","[0, 130, 220, 310, 488, 626, 799, 889, 1191, 1449, 1632, 2017, 2107, 2201, 2620, 3158, 3413, 3660, 3951, 4665, 4947, 5117, 5403, 5801, 6144, 6678, 7205, 7544, 7715, 8332, 8593, 9534, 9709, 10146, 10411, 10586, 11563, 11873, 12147, 12492, 12781, 13006, 13106, 13206, 13612]",30749,22727,23367,17970,13612,-3378,2470,-691,-2136,-545,-4280,45,dire
7569050306,41,13,97,50,87,"[0, 241, 589, 986, 1403, 1770, 2134, 2521, 2924, 3181, 3425, 3913, 4496, 4782, 5179, 6101, 6680, 7511, 8088, 8875, 10039, 10543, 11055, 11448, 12304, 14132, 14739, 15484, 15962, 16610, 17905, 18005, 18105, 18378, 18869, 19303, 19608, 19956, 20056, 20156, 20256, 21256, 22031, 24921, 25728]","[0, 169, 503, 826, 1096, 1351, 1646, 2092, 2419, 2672, 2919, 3120, 3946, 4397, 5481, 6301, 6484, 6732, 7123, 7675, 7860, 8038, 8249, 8689, 9176, 9566, 9854, 10276, 10539, 11073, 12061, 12253, 12464, 12705, 12965, 13550, 13916, 14263, 14363, 14594, 15007, 15994, 16435, 18084, 19303]","[0, 320, 448, 794, 1328, 1812, 2352, 3082, 3326, 3739, 4156, 4380, 4638, 5119, 5573, 5942, 6278, 6570, 6712, 7318, 7548, 7726, 8095, 8429, 8853, 9653, 10023, 10828, 11390, 11961, 12057, 12359, 12489, 12784, 13472, 13965, 14552, 15134, 15709, 16096, 16217, 17037, 17643, 18997, 19820]","[0, 169, 259, 427, 552, 876, 966, 1104, 1263, 1353, 1849, 2022, 2382, 2631, 3288, 3604, 3968, 4261, 4669, 5010, 5415, 5709, 5920, 6114, 6433, 7645, 8454, 8694, 8943, 9195, 10020, 10562, 10662, 11034, 11134, 11505, 11740, 11985, 12085, 12278, 12378, 13236, 13625, 15290, 15807]","[0, 169, 272, 452, 621, 794, 1101, 1428, 1518, 1675, 1765, 1960, 2320, 2628, 3014, 3385, 3568, 3816, 3957, 4226, 4411, 4625, 4836, 5197, 5292, 6027, 6211, 6306, 6402, 6579, 6675, 6775, 6964, 7220, 7371, 7893, 7993, 8119, 8219, 8319, 8493, 8936, 9340, 10191, 10834]",25728,19303,19820,15807,10834,113,102,81,40,27,"[0, 326, 526, 951, 1617, 1958, 2299, 2706, 3037, 3731, 4092, 4218, 5381, 6264, 6359, 7101, 7625, 8034, 8925, 9519, 9801, 9896, 11768, 12147, 12639, 13168, 13934, 14445, 15358, 16217, 17798, 18547, 20529, 22586, 23377, 24108, 24945, 26043, 26302, 26714, 27334, 27849, 28432, 28956, 29376]","[0, 208, 470, 693, 1012, 1409, 1556, 1782, 1987, 2179, 2269, 2619, 3209, 3919, 4077, 5129, 5591, 6045, 6400, 6892, 7384, 7479, 9110, 9638, 10224, 10823, 11390, 12027, 12639, 13203, 15357, 15914, 16793, 17578, 17991, 18251, 19127, 19635, 20100, 20200, 20648, 20993, 21454, 22079, 22179]","[0, 204, 425, 784, 914, 1125, 1574, 1830, 2269, 2645, 2894, 3144, 3519, 3986, 4343, 4933, 5302, 5493, 5960, 6537, 7099, 7266, 8651, 9200, 9659, 10628, 10929, 11253, 11638, 12107, 12509, 13258, 15112, 16134, 16553, 16982, 17775, 18204, 18619, 18959, 19118, 19262, 19362, 20527, 20763]","[0, 169, 259, 395, 559, 748, 883, 1066, 1294, 1431, 1608, 1698, 2568, 2753, 2848, 3314, 3509, 3604, 3836, 4274, 4423, 4593, 5515, 5682, 6011, 6453, 6731, 6826, 7138, 7516, 8287, 8816, 9957, 10841, 10991, 11451, 11940, 12274, 12409, 12509, 12735, 13582, 13924, 14090, 14190]","[0, 169, 259, 459, 634, 805, 895, 1030, 1159, 1306, 1537, 1790, 2042, 2790, 2885, 3386, 3544, 3805, 4034, 4191, 4336, 4431, 5435, 5616, 5711, 5940, 6416, 6511, 6823, 6948, 7134, 7434, 8955, 9882, 10087, 10543, 10950, 11284, 11384, 11597, 11697, 11883, 11983, 12545, 12771]",29376,22179,20763,14190,12771,-3648,-2876,-943,1617,-1937,-7787,45,dire
7569069818,25,63,28,20,31,"[0, 291, 875, 1409, 1895, 2146, 2702, 3413, 3946, 4666, 5604, 6378, 7244, 8273, 8983, 9940, 10596, 11017, 11788, 12643, 14026, 15164, 15527, 16828, 17440, 17534, 17966, 18611, 19341, 19999, 20743, 21591, 22351, 22451, 23084, 23974, 24767, 25675, 26189, 26965, 27065, 27976, 29902, 31308, 32063]","[0, 286, 569, 810, 1100, 1371, 1820, 2378, 2540, 3066, 3651, 3991, 4375, 5050, 5690, 6248, 6548, 7149, 7818, 8312, 8920, 9853, 10236, 11178, 11683, 11958, 12438, 13150, 13470, 13949, 14466, 15237, 15855, 15955, 16932, 17032, 17721, 18097, 18617, 20034, 20134, 20795, 23414, 25825, 25925]","[0, 205, 587, 786, 1328, 1453, 1891, 2312, 3070, 3601, 4294, 4921, 5279, 6047, 6591, 7083, 7498, 8258, 8595, 9296, 9978, 10724, 11285, 11445, 11996, 12339, 12923, 13177, 13273, 13526, 13965, 14847, 15114, 15680, 16275, 16375, 17022, 17756, 17961, 19886, 20098, 20703, 21956, 23984, 24084]","[0, 130, 384, 474, 949, 1155, 1846, 2120, 2545, 3014, 3431, 3767, 4292, 4685, 5048, 5564, 5984, 6429, 6689, 7218, 7487, 7864, 8212, 8539, 8731, 8825, 9055, 9357, 9797, 10385, 10987, 11267, 11412, 11512, 11852, 11952, 12149, 12489, 12623, 13313, 13413, 13809, 14989, 16158, 16258]","[0, 130, 220, 358, 488, 578, 1208, 1433, 1634, 1724, 2141, 2637, 2877, 3225, 3373, 4005, 4428, 4709, 4969, 5263, 5568, 5945, 6128, 6571, 6867, 6961, 7191, 7493, 7589, 7685, 7781, 8183, 8328, 8428, 8700, 8800, 8900, 9099, 9199, 10110, 10210, 10530, 11723, 12581, 12681]",32063,25925,24084,16258,12681,93,13,102,107,30,"[0, 210, 373, 987, 1165, 1542, 1737, 1976, 2976, 3145, 3271, 3716, 3944, 4354, 4948, 5287, 5491, 5620, 6125, 6629, 6724, 8141, 8484, 9000, 11195, 12080, 13090, 14341, 15091, 15187, 15660, 16219, 17919, 19775, 20493, 21350, 22071, 23122, 23752, 25032, 26293, 27092, 27708, 28819, 29451]","[0, 321, 611, 854, 1225, 1507, 1672, 1957, 2283, 2864, 3098, 3622, 3819, 4402, 4638, 4886, 5296, 5391, 5590, 5794, 5982, 6431, 6737, 7328, 10062, 11277, 12333, 13563, 14809, 15367, 15685, 16190, 17377, 18346, 19544, 20480, 20961, 21778, 22896, 23630, 25441, 25995, 26095, 26195, 27577]","[0, 247, 411, 617, 937, 1139, 1435, 1602, 2103, 2316, 2742, 3179, 3303, 3485, 3656, 4101, 4196, 4422, 4551, 4646, 4920, 5236, 5464, 5826, 6262, 7023, 7993, 8912, 9519, 9795, 10080, 10622, 11521, 11915, 13273, 13463, 13960, 14696, 15152, 15538, 15638, 16684, 16784, 17826, 18437]","[0, 269, 359, 479, 666, 756, 846, 1271, 1659, 1943, 2033, 2339, 2429, 2795, 2936, 3184, 3279, 3423, 3648, 3780, 3988, 4630, 4942, 5386, 6215, 6925, 7596, 9200, 9773, 10083, 10306, 10496, 11361, 12237, 12996, 13401, 13591, 14205, 14512, 15123, 15223, 15891, 15991, 17504, 17820]","[0, 537, 627, 821, 911, 1049, 1401, 1601, 1840, 1969, 2093, 2238, 2328, 2563, 2811, 3059, 3154, 3286, 3380, 3513, 3692, 4103, 4197, 4645, 5047, 5357, 6028, 6301, 6696, 6878, 7104, 7396, 8295, 8779, 9018, 9423, 9657, 10074, 10174, 10391, 10723, 11195, 11295, 12024, 12340]",29451,27577,18437,17820,12340,2612,-1652,5647,-1562,341,5386,45,radiant
7570740708,49,35,28,53,123,"[0, 170, 547, 788, 999, 1303, 1687, 2162, 2612, 3049, 3327, 3942, 4473, 5001, 5729, 6306, 6939, 7120, 7433, 8301, 8652, 8855, 9481, 9989, 10345, 11172, 12143, 12238, 14099, 14844, 15876, 16294, 17134, 17730, 18369, 19176, 19819, 20577, 21460, 22020, 22498, 22868, 24264, 24995, 25206]","[0, 297, 487, 893, 1120, 1518, 1745, 1967, 2383, 2732, 3242, 3879, 4599, 5168, 5701, 6348, 7029, 7518, 8134, 8516, 9138, 9465, 10370, 10952, 11953, 12589, 13356, 14245, 15861, 16449, 16683, 17615, 18707, 19482, 19804, 20107, 20855, 21705, 22546, 22833, 23078, 23703, 24021, 24770, 25071]","[0, 284, 572, 986, 1542, 2333, 2868, 3512, 4115, 4407, 5695, 5903, 6869, 7602, 8199, 8350, 9019, 9700, 10034, 10285, 10848, 10943, 11948, 12176, 12638, 13336, 13896, 14303, 14719, 15031, 15555, 16145, 16890, 17426, 17819, 17919, 18128, 18648, 19367, 19647, 19846, 21048, 21935, 22853, 23571]","[0, 170, 285, 375, 549, 729, 1031, 1242, 1625, 1806, 1986, 2326, 2659, 3168, 3653, 4277, 4823, 5378, 6098, 6361, 6632, 6760, 7040, 7536, 8072, 8528, 9324, 9897, 11337, 11761, 12016, 13099, 13850, 14871, 15140, 15763, 16208, 17176, 17422, 17946, 18543, 19489, 20072, 21445, 22553]","[0, 170, 285, 375, 559, 864, 1041, 1243, 1359, 1969, 2149, 2281, 2695, 2987, 3291, 3441, 4009, 4364, 4631, 4822, 5171, 5266, 5572, 5849, 6232, 6740, 7302, 8223, 8596, 9240, 9547, 10052, 10395, 10719, 10819, 11544, 11751, 12428, 12745, 12845, 13091, 13629, 14255, 14463, 14563]",25206,25071,23571,22553,14563,73,43,29,105,20,"[0, 289, 695, 1056, 1442, 1678, 2215, 3180, 3346, 3634, 3892, 4578, 5036, 5819, 6782, 7867, 8714, 10024, 10778, 12231, 13680, 14428, 15838, 16996, 18668, 19831, 21336, 21431, 22039, 22135, 22992, 24310, 25590, 25896, 27429, 28963, 30388, 31618, 33375, 34074, 34556, 35556, 36780, 37639, 38058]","[0, 291, 653, 1028, 1413, 1938, 2514, 3220, 3749, 4598, 5457, 5973, 6194, 6715, 7242, 7893, 8402, 9003, 9168, 9963, 10580, 10849, 11774, 12294, 12830, 13376, 14059, 14581, 15557, 15677, 16088, 16663, 17210, 17608, 19090, 19901, 20614, 21199, 22131, 22674, 22774, 24179, 25223, 25905, 26292]","[0, 291, 612, 935, 1360, 1724, 2040, 2577, 2725, 3254, 3790, 4302, 4784, 5381, 5932, 6208, 6664, 7315, 7847, 8440, 8793, 9194, 9956, 10604, 11272, 11367, 11894, 12300, 12594, 12765, 13449, 14109, 14486, 14719, 15960, 16613, 17108, 17315, 18577, 18851, 18997, 20049, 20938, 22220, 23001]","[0, 170, 260, 703, 958, 1048, 1221, 1615, 2014, 2277, 2542, 2772, 3177, 3451, 3722, 3871, 4035, 4472, 4813, 5124, 5320, 6199, 6649, 6972, 7274, 7369, 8024, 8538, 9211, 9881, 10398, 10773, 11768, 11868, 13084, 13388, 13640, 13756, 14197, 14538, 14646, 15441, 15740, 16052, 16152]","[100, 322, 412, 549, 639, 959, 1116, 1412, 1578, 1834, 2044, 2229, 2326, 2566, 2761, 2955, 3236, 3415, 3511, 3779, 4195, 4468, 4665, 4760, 5054, 5149, 5435, 5574, 6002, 6098, 6194, 6738, 6838, 6938, 7631, 7911, 8011, 8405, 9154, 9490, 9633, 10302, 10857, 11065, 11210]",38058,26292,23001,16152,11210,-12852,-1221,570,6401,3353,-3749,45,dire
7570812500,10,17,123,38,21,"[0, 242, 521, 717, 1095, 1546, 1893, 2256, 2796, 3431, 3763, 4589, 5462, 6242, 6650, 7328, 8143, 8777, 10206, 10812, 11424, 12149, 13245, 14177, 14977, 15895, 16910, 17004, 17660, 18971, 19974, 21741, 22765, 23562, 23842, 24185, 25738, 26934, 27702, 28316, 28779, 29694, 30796, 31608, 32589]","[0, 277, 602, 970, 1370, 1682, 2193, 2752, 3351, 3889, 4443, 4780, 5879, 6597, 6958, 7546, 8444, 9044, 9845, 10200, 10899, 11675, 12381, 13027, 14038, 14426, 15105, 15802, 16173, 16378, 16773, 17086, 17650, 17750, 18487, 18631, 18731, 19328, 19836, 20405, 21232, 21422, 22096, 22813, 23597]","[0, 317, 407, 595, 798, 1019, 1352, 1536, 1626, 1716, 1851, 2253, 3065, 3550, 4066, 4450, 4890, 5316, 5720, 6282, 7246, 8070, 8684, 9156, 9747, 10677, 11502, 11813, 12372, 13056, 13914, 14548, 15568, 15877, 16600, 16700, 17079, 17844, 18062, 18894, 19877, 20067, 20855, 21629, 22396]","[0, 239, 505, 788, 1338, 1719, 1944, 2325, 2887, 3069, 3416, 4088, 4722, 5421, 5806, 6725, 7603, 7788, 8436, 8831, 9558, 10050, 10796, 11212, 11610, 11985, 13097, 13191, 13747, 14123, 14333, 14851, 15458, 15767, 16773, 17131, 17231, 17915, 18622, 19045, 19471, 19771, 20091, 20299, 21073]","[0, 221, 360, 453, 717, 891, 1142, 1325, 1545, 1804, 2006, 2308, 2959, 3297, 3493, 4119, 4480, 4748, 5259, 5517, 6401, 6729, 7186, 7473, 7638, 7869, 8267, 8661, 8919, 9015, 9410, 9915, 10540, 10640, 11038, 11138, 11480, 12196, 12296, 12396, 12752, 12942, 13377, 13933, 14282]",32589,23597,22396,21073,14282,95,57,98,37,86,"[0, 209, 561, 975, 1173, 1578, 1811, 2659, 3034, 3332, 3894, 4211, 4844, 5431, 5942, 6485, 7265, 7649, 8580, 9179, 10210, 10970, 11445, 12381, 12956, 13678, 14333, 16444, 18210, 18764, 19416, 20154, 20862, 22465, 23641, 25122, 26116, 26652, 27320, 28010, 29795, 31515, 33072, 33585, 34451]","[0, 294, 623, 1036, 1373, 1672, 1879, 2425, 2826, 3174, 3662, 4171, 4380, 4740, 5005, 5194, 5616, 6266, 6746, 7499, 7731, 7955, 8217, 8529, 9128, 9544, 9917, 10294, 10873, 11337, 11557, 11903, 12373, 13701, 14404, 15832, 16241, 16727, 17412, 18244, 19386, 19985, 20417, 20729, 21391]","[0, 258, 458, 820, 1093, 1420, 1802, 2013, 2229, 2546, 2935, 3202, 3292, 3630, 4341, 4604, 4858, 5510, 6615, 7175, 7704, 8421, 8825, 9239, 9529, 9808, 10078, 10602, 11203, 11656, 12131, 12273, 12488, 14180, 14997, 16307, 16733, 17794, 18815, 19210, 19778, 20909, 21230, 22396, 22804]","[0, 170, 260, 398, 528, 618, 727, 817, 952, 1077, 1304, 1443, 1667, 1875, 2214, 2498, 2676, 3041, 3586, 3947, 4041, 4375, 4617, 4787, 5007, 5901, 6159, 6895, 7606, 7912, 8240, 8500, 9423, 9952, 10809, 12620, 13142, 13547, 13795, 14149, 14946, 15222, 15655, 15863, 16130]","[0, 170, 260, 395, 573, 953, 1095, 1309, 1488, 1613, 1901, 2065, 2155, 2295, 2443, 2584, 2854, 3220, 3966, 4116, 4507, 5004, 5246, 5692, 6006, 6372, 6856, 7568, 8343, 8779, 9366, 9844, 10389, 11071, 11510, 12682, 12981, 13330, 13900, 14294, 14899, 15619, 16129, 16468, 16614]",34451,21391,22804,16130,16614,-1862,2206,-408,4943,-2332,2547,45,dire
7573302602,46,29,39,121,31,"[0, 213, 685, 1282, 1711, 2166, 2830, 3352, 3993, 4508, 4995, 5530, 6134, 6852, 7607, 8112, 8645, 9245, 9507, 9743, 10389, 11533, 13060, 13154, 14062, 15905, 17447, 18279, 18456, 19292, 20850, 22110, 22909, 24551, 25994, 26094, 27429, 27907, 29747, 29957, 30057, 30282, 31882, 31982, 34904]","[0, 203, 481, 678, 1197, 1478, 1907, 2185, 2596, 3188, 3974, 4546, 5206, 5754, 6061, 6533, 6905, 7758, 8019, 8484, 8876, 9244, 10298, 10392, 10898, 11705, 12423, 12778, 13423, 14158, 14548, 15393, 16264, 17422, 17646, 18149, 19257, 19647, 20421, 20986, 22387, 22900, 23916, 24541, 25935]","[0, 241, 576, 1035, 1360, 1736, 2167, 2613, 3108, 3715, 4365, 4699, 5791, 6101, 6362, 6804, 7251, 7697, 7826, 8163, 8523, 8778, 9799, 9893, 10148, 10499, 10976, 11553, 11835, 12543, 12933, 13521, 14262, 15187, 15957, 16158, 16258, 16468, 17615, 18616, 20807, 21544, 22779, 22913, 23655]","[0, 130, 220, 310, 492, 630, 801, 938, 1076, 1263, 1882, 1972, 2152, 2403, 2498, 2870, 3011, 3241, 3336, 3626, 4421, 4602, 5122, 5382, 5805, 6326, 6829, 7492, 7708, 8527, 8917, 9386, 9811, 11252, 11352, 11853, 12196, 12497, 12895, 13404, 14695, 15538, 16282, 16382, 16482]","[0, 130, 575, 742, 898, 1037, 1171, 1436, 1573, 1760, 2086, 2623, 3056, 3369, 3464, 3668, 3763, 4038, 4133, 4369, 4464, 4631, 5252, 5421, 5591, 6148, 6590, 6759, 7046, 7754, 8219, 8656, 9081, 9325, 9425, 9525, 10216, 10349, 10854, 11205, 12340, 12729, 14322, 14460, 15935]",34904,25935,23655,16482,15935,95,16,71,23,101,"[0, 364, 564, 868, 1394, 1703, 2119, 2631, 3048, 3219, 3655, 4043, 4737, 5105, 5628, 6405, 7170, 7833, 8764, 9243, 10685, 11325, 12152, 12356, 13296, 13638, 14362, 15957, 17209, 18582, 18678, 19077, 20207, 21078, 21268, 22204, 23696, 25790, 25890, 27097, 28110, 28210, 29027, 29585, 30388]","[0, 291, 537, 1255, 1671, 1918, 2148, 2500, 2881, 3090, 3572, 3991, 4838, 5557, 5885, 6896, 7482, 7768, 8100, 9046, 9635, 9898, 10749, 11789, 12318, 12718, 12894, 13865, 14673, 15269, 16053, 16866, 17942, 18807, 20085, 20824, 22336, 22733, 22833, 23554, 24883, 24983, 26169, 26655, 27813]","[0, 210, 300, 407, 603, 732, 979, 1110, 1245, 1910, 2221, 2311, 2401, 2765, 3144, 3880, 4380, 4801, 5323, 6172, 7223, 7807, 8988, 9387, 10050, 10518, 11264, 11873, 12736, 13101, 13306, 14012, 14312, 14817, 15658, 15758, 16726, 17616, 17821, 19227, 19866, 19966, 20512, 20612, 22215]","[0, 377, 728, 1126, 1584, 1997, 2362, 2751, 3091, 3478, 3869, 4067, 4251, 5083, 5794, 7416, 8140, 8657, 8889, 9438, 9759, 10546, 11159, 11253, 11881, 12244, 12487, 12679, 13253, 14250, 14568, 14963, 15555, 16491, 17105, 17324, 18325, 18921, 19021, 19459, 19906, 20263, 21302, 21888, 22661]","[0, 210, 300, 508, 638, 792, 882, 1275, 1410, 1632, 2234, 2609, 2745, 3074, 3277, 3857, 4245, 4340, 4521, 5308, 5466, 5645, 6486, 6580, 6957, 7226, 7610, 8074, 8648, 9244, 9696, 9796, 10096, 10196, 10573, 10740, 11656, 12222, 12322, 12760, 13523, 13623, 14201, 14301, 15757]",30388,27813,22215,22661,15757,4516,-1878,1440,-6179,178,-1923,45,dire
7573544108,89,43,96,58,26,"[209, 450, 888, 1142, 1426, 1882, 2251, 2764, 2924, 3104, 3364, 4269, 4983, 5741, 6330, 7249, 8161, 8901, 10064, 11531, 12544, 13319, 13751, 14755, 15192, 15892, 17053, 18215, 18741, 19806, 20886, 21491, 22567, 24046, 25518, 26842, 27159, 28102, 29070, 29942, 31637, 32398, 32498, 33105, 34725]","[322, 740, 1024, 1598, 2012, 2442, 3053, 3589, 4061, 4577, 5040, 5675, 6042, 6555, 7055, 7392, 7995, 8480, 9330, 9892, 10700, 10929, 11260, 11541, 12065, 12490, 12947, 13576, 14077, 14830, 14930, 15115, 15821, 16538, 16945, 17689, 18299, 18640, 19053, 19353, 19773, 21032, 21917, 22360, 22837]","[260, 497, 942, 1142, 1495, 1882, 2229, 2788, 3114, 3895, 4442, 4657, 5280, 5642, 6077, 6656, 6931, 7295, 7886, 8391, 8928, 9319, 9618, 10297, 10778, 11142, 11553, 11835, 12251, 12622, 12867, 12967, 13691, 14549, 15180, 15791, 16290, 16390, 16624, 16724, 16875, 17975, 18443, 18649, 18787]","[209, 299, 433, 523, 646, 769, 1066, 1212, 1500, 1763, 1962, 2178, 2894, 3422, 3731, 4220, 4407, 4861, 5085, 5748, 6056, 6526, 6991, 7559, 8229, 8687, 9033, 9210, 9345, 9819, 10222, 10322, 10557, 11953, 12143, 12924, 13241, 13526, 13679, 13918, 14082, 14833, 15687, 15938, 16257]","[209, 342, 823, 980, 1117, 1223, 1488, 1641, 2075, 2255, 2391, 2589, 2956, 3110, 3259, 3527, 3622, 3716, 3948, 4428, 4687, 4991, 5161, 5632, 5802, 6279, 6633, 6917, 7088, 7592, 7790, 7926, 8292, 8818, 9077, 9371, 9779, 9955, 10055, 10188, 10398, 10753, 11021, 11315, 11559]",34725,22837,18787,16257,11559,48,49,137,27,105,"[209, 375, 618, 982, 1109, 1488, 1888, 2234, 2753, 3398, 3938, 4803, 6112, 6944, 7655, 8254, 9148, 9981, 10418, 11545, 12413, 13294, 13961, 15006, 15882, 16398, 17031, 18152, 19089, 19750, 20060, 20801, 21839, 22347, 22863, 23548, 25015, 25856, 26789, 28219, 28860, 29644, 31015, 32024, 32772]","[207, 483, 825, 1276, 1484, 1963, 2551, 3313, 3740, 4454, 5159, 5361, 5911, 6306, 6850, 7517, 7748, 8389, 8989, 9391, 9543, 9780, 10073, 10559, 12115, 12708, 13442, 13691, 14408, 14898, 15381, 16132, 16841, 17616, 18409, 18659, 21227, 22336, 22792, 23968, 24524, 25185, 26290, 26714, 27906]","[200, 445, 845, 1052, 1568, 1785, 2240, 2634, 2769, 3593, 3809, 4229, 4681, 5155, 5547, 6233, 6851, 7374, 7961, 8500, 9165, 9259, 9607, 10059, 11961, 12771, 13114, 13725, 14355, 14792, 15186, 15702, 16748, 17455, 17555, 17890, 19566, 20257, 20593, 21424, 21604, 22440, 24038, 25327, 25536]","[177, 312, 406, 634, 797, 977, 1067, 1316, 1500, 2089, 2196, 2521, 3018, 3255, 3719, 4184, 4369, 4625, 4854, 5233, 5433, 5602, 5844, 6060, 6919, 7594, 8093, 8424, 8556, 8733, 9129, 9497, 9597, 10152, 10634, 10883, 12786, 13850, 14093, 14755, 15021, 15737, 16295, 17546, 17798]","[129, 254, 344, 575, 665, 884, 1204, 1294, 1685, 1993, 2130, 2519, 3205, 3346, 3600, 3868, 4110, 4557, 4908, 5077, 5232, 5326, 5626, 5805, 6450, 7097, 7484, 7883, 8704, 8921, 9229, 9446, 10191, 10881, 11019, 11119, 11219, 11616, 12070, 12524, 12690, 13323, 14119, 14844, 15471]",32772,27906,25536,17798,15471,1953,-5069,-6749,-1541,-3912,-15318,45,dire
7573878007,48,106,47,26,100,"[0, 202, 399, 775, 939, 1125, 1487, 1957, 2138, 2969, 3396, 3889, 4398, 4948, 5703, 6695, 7587, 8030, 8642, 9035, 10907, 11382, 12155, 13062, 14174, 15337, 16718, 17658, 18676, 19400, 20701, 22500, 24513, 25331, 25431, 26211, 27079, 28144, 28532, 28632, 29787, 30163, 30919, 31875, 32132]","[0, 228, 392, 687, 816, 906, 1119, 1260, 1813, 2168, 2559, 3037, 3468, 4161, 4572, 5288, 6033, 7332, 7856, 8541, 9218, 9490, 9766, 10099, 11072, 11608, 12460, 13437, 14322, 14975, 15387, 16632, 17694, 18024, 18672, 19401, 19815, 20570, 21124, 21224, 21324, 21865, 22336, 24002, 24635]","[0, 189, 487, 855, 1103, 1724, 1971, 2871, 3109, 3520, 4469, 4665, 5018, 5751, 6312, 6990, 7796, 8645, 8859, 9519, 10065, 10770, 11259, 11916, 12303, 12515, 12719, 13077, 13628, 14084, 14521, 14939, 15995, 16402, 16624, 17447, 18143, 18729, 19025, 19385, 19714, 20106, 20206, 20522, 20892]","[100, 298, 388, 478, 568, 756, 893, 1304, 1523, 1925, 2950, 3040, 3448, 3633, 3875, 4602, 4961, 5954, 6257, 6638, 7327, 7744, 8109, 8782, 9197, 9416, 9695, 10185, 10518, 10689, 11632, 12380, 13116, 13291, 13597, 13928, 14379, 14851, 15243, 15467, 15846, 16021, 16227, 16631, 16817]","[0, 154, 244, 378, 468, 583, 718, 1277, 1367, 1663, 2001, 2125, 2215, 2857, 3154, 3672, 4242, 4485, 4985, 5559, 6069, 6307, 6769, 6978, 7364, 7719, 8083, 8440, 8698, 8794, 9191, 10265, 10973, 11296, 11396, 11915, 12291, 12732, 12876, 13273, 13577, 13677, 13806, 14305, 14846]",32132,24635,20892,16817,14846,73,114,49,123,79,"[0, 368, 819, 1102, 1438, 1571, 2059, 2149, 2541, 3279, 3642, 4206, 5037, 6395, 6965, 7844, 8960, 9810, 10654, 11987, 12688, 13408, 14369, 15365, 16354, 17569, 19000, 20372, 21585, 22162, 23715, 23815, 23915, 25334, 26463, 27319, 27793, 28106, 30114, 32014, 32534, 33132, 33582, 34603, 35333]","[0, 327, 693, 1069, 1443, 2074, 2450, 2905, 3355, 3903, 4166, 4502, 5120, 5412, 5594, 5883, 6392, 6846, 7185, 7279, 8219, 8638, 9190, 9285, 10254, 10783, 11479, 11869, 12244, 13042, 13325, 13425, 14150, 15497, 16610, 16845, 16945, 17045, 19253, 20495, 21311, 22169, 22778, 23291, 23619]","[0, 294, 581, 791, 953, 1543, 1994, 2373, 2950, 3245, 3884, 4567, 5115, 5542, 6067, 6227, 6461, 7074, 7465, 8167, 8609, 8867, 9312, 9540, 10160, 10835, 11100, 11768, 12054, 12230, 12513, 12613, 13221, 14069, 14169, 14835, 15284, 15773, 16451, 17740, 18248, 18669, 19240, 20046, 20684]","[0, 209, 299, 389, 479, 676, 812, 902, 1141, 1406, 1702, 1792, 1882, 2197, 2292, 2386, 2691, 3453, 3635, 3863, 4103, 4361, 4527, 4866, 5373, 6194, 6680, 7468, 7879, 8132, 8618, 8718, 9681, 10711, 10997, 11402, 11765, 11957, 13870, 15783, 16488, 16827, 17305, 17672, 17772]","[0, 209, 299, 442, 870, 960, 1281, 1371, 1521, 1830, 2055, 2156, 2282, 2549, 2664, 2787, 2950, 3427, 4244, 4338, 4588, 5262, 5428, 5727, 5912, 6128, 6488, 6808, 6904, 7196, 7341, 7441, 7928, 8776, 9367, 9772, 9872, 10216, 11440, 12317, 12516, 12855, 12955, 13163, 13528]",35333,23619,20684,17772,13528,-3201,1016,208,-955,1318,-1614,45,radiant
7575788217,120,97,80,119,58,"[0, 241, 491, 869, 1293, 1681, 1975, 2584, 2986, 3409, 4030, 5116, 5596, 6273, 6901, 7284, 8327, 8524, 9276, 10118, 10364, 10459, 11111, 11710, 12330, 12604, 13380, 13947, 15007, 15242, 15434, 16252, 16910, 17703, 18657, 18905, 19579, 20396, 21092, 21690, 22376, 23301, 24609, 24969, 25362]","[0, 217, 574, 877, 1413, 1579, 2027, 2279, 2566, 3032, 3578, 4283, 4837, 5203, 5966, 6236, 7167, 7615, 8338, 9146, 9431, 9578, 10466, 11561, 12014, 12832, 13586, 14631, 15526, 15895, 15991, 16091, 16737, 17045, 17619, 18242, 19539, 19879, 20492, 20770, 21424, 21524, 21969, 22786, 23038]","[0, 207, 528, 931, 1416, 1716, 2114, 2618, 2900, 3371, 3636, 3983, 4288, 5106, 5649, 6170, 6663, 7680, 8031, 9091, 9457, 9552, 10060, 10661, 11122, 11924, 13150, 13468, 13963, 14553, 15035, 15135, 15495, 16142, 16413, 16585, 17098, 17450, 18404, 18809, 19275, 19707, 20102, 20452, 21425]","[0, 170, 595, 700, 961, 1098, 1330, 1465, 1606, 1933, 2255, 2860, 2950, 3283, 3468, 3563, 4128, 4418, 4637, 5024, 5695, 5976, 6385, 6692, 7021, 7309, 8007, 8716, 9250, 9581, 9797, 9968, 10303, 10653, 10879, 10979, 11357, 11793, 12254, 12460, 12897, 13081, 13961, 14278, 14691]","[0, 207, 297, 435, 605, 695, 975, 1232, 1483, 1675, 1912, 2219, 2421, 2926, 3263, 3373, 3913, 4312, 4584, 4991, 5275, 5370, 5704, 5923, 6347, 6548, 7712, 8406, 9393, 9572, 9933, 10033, 10420, 11138, 11792, 11950, 12367, 12576, 12862, 12997, 13207, 13341, 13667, 13767, 14188]",25362,23038,21425,14691,14188,25,54,129,5,100,"[0, 366, 743, 1123, 1560, 2030, 2451, 3019, 3462, 4198, 4686, 5404, 5773, 6172, 6784, 7446, 8098, 9625, 10336, 10747, 11310, 12694, 13179, 13917, 14612, 15152, 15968, 16531, 17113, 17379, 18171, 19888, 20757, 21418, 22366, 23485, 24193, 25197, 26001, 26832, 28091, 28924, 29667, 30233, 30743]","[0, 170, 409, 569, 1121, 1492, 1839, 2323, 2856, 3439, 4006, 4597, 5086, 5669, 6239, 6862, 7608, 8181, 8657, 9282, 9772, 10765, 11359, 11868, 12815, 13221, 14308, 14946, 15580, 15888, 16505, 17320, 18543, 19377, 20451, 21427, 21527, 21982, 22873, 23273, 24016, 25722, 26638, 28047, 28765]","[0, 258, 432, 804, 1243, 1498, 1972, 2300, 2806, 3264, 4031, 4781, 5215, 5676, 6083, 6663, 7252, 7924, 8706, 9384, 9478, 10839, 11540, 12274, 12813, 13039, 13381, 13732, 14537, 14819, 15462, 16748, 17695, 18392, 18872, 19257, 19702, 20547, 20861, 21167, 22233, 23025, 23583, 24146, 24561]","[0, 219, 309, 413, 670, 878, 968, 1125, 1270, 1360, 1495, 2067, 2277, 2535, 2812, 3223, 3607, 4124, 4463, 4930, 5346, 5844, 6104, 6274, 6781, 7719, 8307, 8797, 9088, 9381, 9853, 10298, 10668, 11048, 11692, 12067, 12242, 12624, 13231, 13594, 13877, 14667, 15154, 15814, 16220]","[0, 170, 260, 350, 568, 658, 856, 991, 1081, 1331, 1466, 1646, 1736, 1928, 2199, 2562, 2831, 3398, 3976, 4522, 4928, 5770, 6166, 6261, 6499, 6890, 7326, 7785, 7962, 8155, 8535, 8980, 9411, 9666, 10103, 10488, 10931, 11606, 11892, 12209, 12611, 13324, 13559, 14064, 14209]",30743,28765,24561,16220,14209,-5381,-5727,-3136,-1529,-21,-15794,45,dire
7577870703,10,49,53,97,26,"[0, 204, 473, 802, 1170, 1394, 1899, 2400, 2900, 3260, 4074, 4663, 5294, 5798, 5927, 6371, 7051, 7611, 8159, 9201, 9296, 10612, 11800, 12781, 13592, 13867, 15275, 15441, 15938, 16754, 17092, 17192, 17697, 18851, 19586, 20543, 21593, 24251, 26093, 27095, 27924, 28592, 29096, 30317, 30853]","[0, 314, 604, 1085, 1251, 1496, 2090, 2553, 3137, 3599, 4274, 4618, 5115, 5884, 6284, 6478, 6663, 6994, 7495, 8075, 8615, 9557, 10482, 10967, 11622, 12337, 13142, 14220, 14316, 15049, 15485, 16133, 16818, 18175, 18765, 19229, 19937, 21097, 21756, 22600, 23122, 24046, 24926, 26160, 27747]","[0, 170, 260, 350, 528, 656, 1122, 1245, 1479, 1569, 1905, 2748, 2972, 3298, 3495, 3783, 4169, 4563, 4947, 5542, 6063, 6804, 7444, 7960, 8460, 8913, 9892, 9986, 10248, 10477, 11133, 11233, 11687, 12548, 13081, 13370, 13999, 15458, 16977, 17948, 18679, 19015, 19781, 21009, 21889]","[0, 242, 489, 774, 1059, 1360, 1616, 1958, 2225, 2614, 3051, 3653, 3887, 4466, 4827, 5014, 5528, 6206, 6410, 6783, 7745, 8355, 8671, 9629, 9813, 9908, 10296, 10764, 11304, 11850, 12490, 12943, 13099, 13743, 14240, 14754, 15037, 15904, 16487, 17450, 17862, 18385, 18679, 19262, 19798]","[0, 170, 358, 492, 622, 712, 880, 970, 1060, 1150, 1389, 1562, 1817, 2201, 2466, 2584, 2961, 3056, 3293, 3508, 3906, 4590, 4946, 5246, 5416, 5654, 6220, 6481, 6652, 6877, 7034, 7270, 7706, 8972, 9236, 9455, 9759, 11395, 12072, 12316, 13051, 13351, 13575, 14158, 14694]",30853,27747,21889,19798,14694,48,65,96,20,79,"[0, 294, 572, 736, 1107, 1349, 1928, 2365, 2894, 3660, 4318, 5094, 5821, 6668, 7318, 8029, 8984, 10139, 10957, 11966, 12347, 13198, 14454, 15116, 15955, 16644, 17768, 19200, 20583, 21705, 23434, 24781, 26390, 26892, 27377, 28952, 30185, 31798, 31898, 32082, 32753, 33947, 35975, 37149, 38952]","[0, 209, 497, 829, 1135, 1404, 1747, 2280, 2869, 3665, 3983, 4503, 5004, 5905, 6282, 7145, 7803, 8401, 8967, 9853, 10479, 10752, 11467, 11749, 11954, 12413, 13355, 14137, 14969, 15707, 16528, 17138, 17608, 18368, 18468, 19296, 20856, 21827, 21927, 22640, 22933, 23281, 23928, 24854, 25908]","[0, 255, 611, 899, 1301, 1671, 2044, 2479, 2820, 3279, 3877, 4458, 4979, 5521, 6311, 6992, 7537, 8523, 8859, 9468, 10169, 10599, 10914, 11277, 11774, 12462, 13066, 13465, 14107, 14997, 15690, 16152, 17148, 17635, 18098, 18564, 19865, 20210, 20696, 21375, 21475, 21675, 22125, 23005, 24186]","[0, 170, 260, 445, 940, 1084, 1507, 1687, 1834, 2090, 2380, 2614, 3032, 3531, 3680, 4081, 4440, 5125, 5320, 5966, 6233, 6608, 6999, 7373, 7661, 8107, 8669, 8995, 9590, 10190, 10528, 10948, 11518, 11826, 12083, 12348, 12911, 13331, 13506, 13661, 13857, 14486, 14802, 15452, 16361]","[0, 170, 279, 422, 641, 731, 821, 1050, 1314, 1633, 2210, 2822, 3088, 3409, 3766, 4423, 5086, 5686, 6025, 6535, 6860, 7387, 7626, 7910, 8429, 8596, 8827, 9356, 9777, 9873, 10309, 10777, 11263, 11804, 11938, 12136, 12706, 13363, 13551, 13925, 14025, 14199, 14515, 14923, 15158]",38952,25908,24186,16361,15158,-8099,1839,-2297,3437,-464,-5584,45,radiant
7578531212,41,120,98,65,121,"[0, 239, 441, 570, 947, 1099, 1298, 1756, 2094, 2453, 2854, 3279, 3656, 4129, 4972, 5313, 5574, 6838, 7717, 8311, 9065, 9997, 10463, 10674, 11618, 12074, 12586, 12846, 13287, 14297, 15054, 15556, 15656, 16039, 17050, 17994, 19002, 20836, 22832, 24272, 25623, 26508, 27998, 29712, 30728]","[0, 247, 499, 822, 1135, 1386, 1574, 1995, 2171, 2729, 3313, 3502, 4479, 4971, 5972, 6540, 6850, 8236, 8875, 9822, 10694, 11228, 11530, 11970, 12204, 12651, 13450, 13740, 14329, 14804, 15202, 15783, 16589, 17496, 17764, 19557, 20333, 21100, 22433, 23055, 23969, 24286, 26081, 27399, 27996]","[0, 206, 333, 648, 872, 1117, 1315, 1915, 2158, 2774, 3686, 4255, 4421, 5405, 6027, 6624, 7213, 8047, 8851, 9291, 10027, 10647, 11601, 11812, 12253, 12401, 12692, 13147, 13563, 14237, 14333, 14548, 14648, 15429, 15759, 16540, 17023, 18422, 19228, 19990, 21023, 21785, 23773, 25452, 26008]","[0, 170, 341, 526, 898, 1074, 1164, 1631, 1721, 1858, 2253, 2460, 2864, 3246, 3815, 4119, 4509, 5462, 6177, 6503, 7092, 7262, 7639, 7992, 8604, 9022, 9388, 10014, 10185, 10535, 11033, 11223, 11790, 12712, 12812, 13390, 14054, 14778, 15170, 16235, 16933, 17380, 18209, 19268, 19973]","[0, 170, 310, 419, 593, 736, 860, 1257, 1347, 1572, 2041, 2131, 2489, 2728, 3292, 3505, 3645, 4187, 4542, 4779, 5164, 5259, 5586, 5860, 6129, 6224, 6515, 6634, 6876, 7151, 7247, 7549, 7649, 7839, 7939, 8517, 8716, 9790, 10314, 10940, 11562, 12099, 12939, 13887, 14313]",30728,27996,26008,19973,14313,46,23,96,68,26,"[0, 323, 667, 868, 1356, 1660, 2218, 2701, 3203, 3783, 4268, 4915, 5757, 6474, 7195, 7881, 8527, 9574, 10099, 10686, 11056, 11431, 12280, 13706, 15169, 16452, 17986, 18680, 19387, 20128, 20742, 20842, 21521, 21756, 23011, 23789, 23889, 24296, 24495, 24595, 24695, 24903, 25638, 25738, 25838]","[0, 294, 619, 1029, 1318, 1734, 2157, 2549, 3065, 3689, 4128, 4582, 4821, 5476, 5684, 6032, 6386, 6906, 7648, 8436, 9179, 9655, 10171, 10860, 11212, 12021, 13251, 14049, 14964, 16030, 16579, 16828, 17918, 18684, 19366, 19843, 21063, 21227, 21426, 21949, 22373, 22914, 23014, 24079, 25046]","[0, 241, 482, 695, 1114, 1435, 1716, 2107, 2462, 2879, 3014, 3390, 3605, 4200, 4334, 4846, 5521, 5901, 6369, 7034, 7337, 7984, 8828, 9097, 9790, 10546, 11483, 12396, 12962, 13374, 13692, 13865, 14659, 15027, 16052, 16916, 17985, 18128, 18473, 19360, 19460, 19668, 19958, 20058, 20539]","[0, 170, 260, 350, 440, 610, 918, 1172, 1262, 1505, 1852, 2212, 2408, 2730, 2825, 2920, 3249, 3917, 4310, 4657, 5260, 5515, 6024, 6798, 7273, 7960, 9213, 9918, 10492, 10809, 11227, 11666, 12598, 13561, 14228, 14767, 14942, 15255, 15563, 15842, 16051, 16850, 17215, 17390, 17565]","[0, 170, 593, 683, 922, 1012, 1293, 1473, 1590, 1722, 1867, 2003, 2181, 2388, 2521, 2616, 2773, 2997, 3199, 3467, 3562, 3710, 4026, 4950, 5572, 6135, 6506, 6951, 7284, 7455, 8051, 8226, 9237, 9547, 10012, 10349, 10561, 10736, 11250, 11415, 11824, 12032, 12236, 12390, 12535]",25838,25046,20539,17565,12535,4890,2950,5469,2408,1778,17495,45,radiant
7578647418,1,63,120,105,100,"[0, 241, 572, 863, 1194, 1357, 1688, 1896, 2073, 2458, 3084, 3875, 4580, 4986, 5220, 5788, 6624, 7116, 7944, 8039, 8970, 9849, 10941, 11994, 12639, 13681, 14674, 15490, 16430, 17306, 18257, 19106, 20091, 20529, 21528, 22069, 22294, 22982, 23414, 24192, 26688, 27671, 28833, 29122, 29222]","[0, 221, 386, 748, 1246, 1819, 2487, 2879, 3444, 4109, 4467, 5322, 5808, 6447, 6761, 7126, 7472, 7979, 8637, 9288, 10181, 10741, 11685, 12271, 12847, 13304, 13719, 14369, 14911, 15750, 15947, 16504, 17293, 18096, 19509, 19841, 20152, 20351, 20880, 21132, 22288, 23062, 24351, 25112, 25278]","[0, 279, 563, 1008, 1409, 1772, 2185, 2518, 3042, 3672, 4056, 4576, 5086, 5478, 5824, 5919, 6713, 7317, 7917, 8313, 8985, 9692, 10392, 11021, 11941, 12623, 13128, 13772, 14225, 14750, 15542, 16066, 16533, 16871, 18165, 18581, 19141, 19950, 20504, 21016, 22587, 23179, 24055, 24580, 26265]","[0, 170, 278, 413, 543, 711, 880, 1015, 1135, 1643, 1778, 2316, 2447, 2865, 3089, 3188, 3693, 3938, 4212, 4496, 4956, 5225, 5796, 6073, 6425, 6906, 7365, 7577, 8352, 8535, 9011, 9591, 9850, 10221, 11168, 11417, 11723, 12087, 12690, 13034, 13497, 14696, 15213, 15701, 15801]","[0, 208, 298, 424, 691, 856, 1093, 1482, 1618, 1909, 2081, 2579, 2808, 3215, 3309, 3404, 3608, 3905, 4179, 4470, 4837, 5439, 6116, 6531, 6799, 7138, 7399, 7662, 7875, 8163, 8401, 8726, 8826, 9463, 10135, 10325, 10599, 10798, 10933, 11078, 11386, 11884, 12446, 12880, 13075]",29222,25278,26265,15801,13075,94,98,106,65,86,"[0, 389, 559, 981, 1143, 1433, 1821, 2216, 2599, 3018, 3303, 3972, 4423, 5044, 5850, 6517, 7556, 8156, 8810, 9511, 10564, 10892, 11671, 12474, 13265, 14211, 14920, 15607, 16702, 17107, 17896, 18923, 19483, 20239, 21298, 23200, 23801, 24898, 25853, 26366, 27357, 28396, 28641, 29672, 30140]","[0, 305, 601, 1055, 1221, 1628, 2165, 2590, 3188, 4051, 4547, 5227, 5940, 6681, 7220, 7867, 8433, 9020, 9698, 10399, 10950, 11542, 12323, 12960, 13324, 14206, 15220, 15748, 16749, 17575, 18823, 19267, 20766, 21371, 21972, 23549, 24034, 24989, 25828, 26853, 27181, 27328, 27573, 28613, 28913]","[0, 688, 931, 1437, 1730, 2109, 2582, 3394, 3724, 4172, 4549, 5284, 5870, 6236, 6790, 7370, 7834, 8100, 8766, 9333, 9776, 9942, 10746, 10951, 11596, 11996, 12599, 13066, 13773, 14378, 14987, 15177, 16059, 16401, 16756, 17921, 18414, 18869, 19161, 19733, 19904, 20062, 21069, 22381, 22619]","[0, 232, 322, 459, 549, 719, 1110, 1403, 1519, 1813, 1950, 2442, 2806, 3180, 3457, 3946, 4462, 4906, 5501, 5769, 6215, 6381, 6687, 7005, 7193, 7625, 8336, 8636, 9137, 9653, 9965, 10447, 10723, 11426, 11651, 12446, 12706, 13337, 13481, 13628, 13776, 13915, 14589, 15268, 15568]","[0, 232, 358, 497, 736, 906, 1342, 1639, 1787, 2159, 2563, 2759, 3412, 3655, 3940, 4162, 4625, 4771, 5190, 5877, 6142, 6308, 6622, 6920, 7343, 7765, 8090, 8185, 8472, 8998, 9208, 9398, 9678, 9888, 10159, 10299, 10559, 11110, 11232, 11840, 12077, 12177, 13263, 14245, 14345]",30140,28913,22619,15568,14345,-918,-3635,3646,233,-1270,-1944,45,radiant
7580525516,109,7,97,65,20,"[0, 216, 462, 965, 1240, 1590, 1874, 2667, 3127, 3569, 3890, 4369, 5011, 5928, 6579, 7172, 8471, 9011, 10241, 11020, 11688, 12525, 12761, 13245, 13830, 15282, 16303, 17536, 18722, 19156, 20070, 21252, 22237, 23837, 24661, 25249, 26769, 28035, 29040, 29893, 30751, 32094, 33481, 34759, 34859]","[0, 205, 621, 956, 1487, 1781, 2266, 2763, 3063, 3601, 4146, 4813, 4903, 5579, 5805, 6075, 6696, 7366, 7769, 8099, 8911, 9051, 9292, 9859, 10444, 11106, 11583, 12405, 13033, 13426, 14101, 14663, 15149, 16238, 16599, 17401, 17994, 19004, 20233, 21225, 21989, 22471, 22832, 23469, 24149]","[0, 241, 606, 732, 1383, 1820, 2431, 2777, 3567, 3953, 4320, 4979, 5436, 6538, 6982, 7598, 8062, 8519, 8952, 9109, 10100, 10790, 11069, 11348, 12099, 12884, 13429, 14109, 14467, 14599, 15093, 15827, 16709, 16899, 17189, 17925, 18485, 18880, 19886, 20342, 20808, 21803, 22315, 23194, 23294]","[0, 130, 220, 462, 552, 669, 759, 1105, 1195, 1469, 1718, 1863, 1953, 2950, 3045, 3190, 3724, 4011, 4357, 4698, 4981, 5257, 5352, 5518, 5956, 6499, 6893, 7098, 7336, 7432, 8045, 8898, 9322, 9957, 10057, 10292, 10438, 10789, 11946, 12046, 12266, 13045, 13482, 14163, 14263]","[0, 130, 270, 452, 729, 914, 1129, 1264, 1354, 1444, 1797, 2149, 2262, 2843, 2966, 3337, 3582, 4061, 4334, 4499, 4773, 4988, 5232, 5586, 5913, 6356, 6661, 6989, 7276, 7447, 7848, 8070, 8595, 9294, 9469, 9923, 10098, 10766, 11319, 11778, 11985, 12437, 12571, 13178, 13380]",34859,24149,23294,14263,13380,12,120,43,100,31,"[0, 284, 592, 867, 1153, 1543, 1793, 2243, 2415, 2896, 3292, 3842, 4349, 4759, 5153, 5918, 6581, 7319, 7894, 8695, 9143, 10198, 10485, 11764, 12423, 13281, 14289, 14981, 15666, 16731, 17302, 17973, 18567, 19480, 20060, 20913, 21876, 22581, 23857, 24666, 25494, 26822, 27391, 30502, 32228]","[0, 282, 526, 860, 1250, 1923, 2250, 2628, 3413, 3904, 4341, 4724, 5276, 5425, 6215, 6585, 7430, 7955, 8306, 9282, 9470, 10158, 10590, 11442, 12072, 12698, 13579, 14039, 14235, 15009, 15342, 15876, 17085, 17476, 18259, 18859, 19565, 20217, 20723, 21683, 22431, 23041, 23773, 24994, 25579]","[0, 246, 336, 674, 956, 1291, 1932, 2187, 2752, 3363, 3889, 3979, 4433, 4941, 5635, 6191, 6433, 6882, 7356, 7997, 8092, 8978, 9340, 9959, 10300, 10910, 11253, 11765, 12275, 12904, 13118, 13557, 14445, 14674, 14864, 15860, 16618, 17051, 17199, 17472, 18075, 18450, 19041, 19466, 20217]","[0, 210, 334, 590, 680, 953, 1238, 1328, 2012, 2504, 2683, 2773, 2944, 3039, 3408, 3784, 4195, 4574, 4716, 4963, 5081, 5420, 5515, 6302, 6502, 6715, 7009, 7214, 7310, 7707, 7803, 8029, 8580, 8706, 9130, 9654, 9933, 10132, 10304, 10598, 11405, 11505, 11730, 13117, 13631]","[0, 210, 300, 390, 480, 627, 844, 1014, 1197, 1790, 1925, 2389, 2634, 2729, 3060, 3208, 3808, 4070, 4412, 4812, 4954, 5169, 5339, 6033, 6372, 6542, 6911, 7191, 7362, 8126, 8507, 8807, 9256, 9413, 9644, 9886, 10085, 10356, 10531, 10673, 10872, 10972, 11072, 12293, 12763]",32228,25579,20217,13631,12763,2631,-1430,3077,632,617,5527,45,dire
7580560302,49,43,129,128,121,"[0, 207, 598, 761, 1223, 1703, 2238, 2698, 3001, 3515, 4076, 4592, 5374, 5841, 6412, 6722, 6817, 7387, 8323, 9216, 10231, 11060, 12217, 12888, 13191, 13830, 14661, 15261, 15918, 16194, 16290, 17137, 17818, 18311, 18963, 20009, 20558, 20781, 21735, 24365, 25435, 26226, 28416, 29410, 31008]","[0, 362, 628, 845, 1141, 1418, 1774, 2171, 2761, 3647, 4118, 4411, 5196, 5579, 6025, 6459, 6640, 7076, 7623, 9072, 9816, 10071, 10489, 10894, 11586, 12925, 13020, 13198, 14021, 14981, 15354, 15988, 16467, 16567, 16915, 17105, 17594, 17988, 18341, 19522, 20223, 20801, 21314, 21524, 22944]","[0, 252, 450, 974, 1227, 1521, 1911, 2310, 2803, 3109, 3424, 3893, 4480, 4938, 5415, 5516, 5981, 6460, 6948, 7551, 8073, 8255, 8350, 8731, 9261, 9749, 9844, 10249, 10622, 11189, 11580, 12301, 12696, 12908, 13541, 13731, 14162, 14419, 14722, 16186, 16633, 17041, 18400, 19649, 20374]","[0, 170, 353, 711, 861, 991, 1196, 1405, 1540, 1764, 2014, 2152, 2415, 2509, 2704, 3080, 3175, 3318, 3614, 3890, 4060, 4154, 4415, 4653, 4747, 5343, 5569, 5909, 6201, 6297, 6596, 7300, 7743, 7843, 8191, 8597, 8697, 8889, 9600, 10498, 10807, 11176, 11958, 12168, 13102]","[0, 170, 600, 690, 857, 1080, 1250, 1459, 1594, 2061, 2607, 2697, 2991, 3119, 3433, 3616, 3962, 4199, 4582, 4677, 4870, 4964, 5328, 5471, 5565, 5927, 6022, 6163, 6385, 7189, 7440, 7686, 8130, 8266, 8614, 9259, 9407, 9507, 9826, 11122, 11476, 11576, 11676, 12232, 12719]",31008,22944,20374,13102,12719,47,93,106,123,110,"[0, 241, 522, 858, 1206, 1618, 1818, 2393, 2828, 3203, 3734, 4254, 4530, 5472, 5986, 6682, 7723, 8384, 8847, 9550, 10459, 11552, 12488, 13050, 13656, 14080, 14271, 15099, 15958, 16959, 17665, 18699, 19548, 20010, 21198, 22180, 22781, 23664, 24709, 24966, 25265, 25811, 26410, 27015, 27628]","[0, 170, 483, 700, 1195, 1534, 1838, 1991, 2361, 2852, 3390, 3809, 4596, 5607, 6245, 7047, 7590, 8782, 9679, 10033, 10645, 11069, 11983, 12927, 13640, 14708, 15312, 15855, 16737, 17366, 17623, 18964, 19502, 19779, 20328, 20428, 20623, 20900, 21328, 22273, 22782, 23121, 23419, 23627, 24195]","[0, 170, 440, 719, 1049, 1299, 1795, 2070, 2447, 2707, 3042, 3265, 3441, 4091, 4573, 5563, 6125, 6577, 6950, 7544, 8282, 8617, 9077, 9678, 10208, 10918, 11441, 12425, 13124, 13925, 14702, 15397, 16636, 16736, 17383, 18073, 18173, 18454, 18952, 19097, 19646, 20645, 21211, 21859, 22662]","[100, 270, 360, 497, 856, 1029, 1205, 1373, 1463, 1553, 1741, 1831, 1923, 2125, 2368, 2833, 3814, 4423, 4594, 5047, 5365, 5788, 6245, 6939, 7454, 8199, 8694, 8870, 9346, 10576, 10723, 11159, 11970, 12296, 12980, 13436, 13631, 14189, 14484, 15035, 15752, 16274, 16572, 17109, 17958]","[0, 170, 260, 350, 526, 700, 1062, 1230, 1365, 1455, 1643, 1843, 1946, 2202, 2450, 3012, 3403, 3751, 4078, 5208, 5497, 6116, 6589, 7047, 7421, 7861, 8322, 8498, 8830, 9469, 9582, 9987, 11064, 11177, 11765, 12184, 12379, 12614, 12824, 12924, 13238, 13626, 13726, 14238, 14568]",27628,24195,22662,17958,14568,3380,-1251,-2288,-4856,-1849,-6864,45,dire
7581196114,34,41,28,20,101,"[0, 214, 500, 906, 1289, 1632, 1851, 2111, 2447, 2732, 3010, 3453, 3543, 3638, 3918, 4594, 5207, 5587, 5908, 6286, 6381, 7099, 7559, 8062, 8736, 9064, 9650, 9945, 10236, 10862, 11559, 13968, 14987, 16100, 17439, 18101, 18662, 20374, 20474, 20966, 22355, 24163, 24547, 25724, 27248]","[0, 243, 415, 789, 1193, 1492, 1655, 2041, 2414, 2917, 3271, 4062, 4407, 4698, 5254, 5810, 6157, 6492, 7098, 7574, 7954, 8637, 9518, 10205, 10472, 11329, 12079, 13135, 13749, 14309, 14940, 15040, 15901, 16632, 16908, 17278, 17978, 19321, 20103, 20795, 21941, 22041, 22359, 23214, 25025]","[0, 239, 599, 689, 813, 1348, 1607, 2104, 2399, 2617, 2927, 3174, 3420, 3640, 3872, 4468, 5068, 5289, 5579, 5775, 6051, 6588, 7473, 7614, 8166, 8260, 8436, 8569, 9327, 9849, 10308, 10408, 10831, 11330, 11430, 11921, 12201, 13022, 13347, 13696, 14855, 15089, 15428, 17661, 18379]","[0, 170, 260, 434, 611, 838, 928, 1018, 1152, 1552, 1702, 2053, 2143, 2387, 2666, 3289, 3548, 3642, 3988, 4146, 4290, 5048, 5215, 5330, 5847, 5941, 6117, 6292, 6628, 6897, 7299, 7399, 7589, 7970, 8246, 8381, 8481, 8581, 8767, 8935, 9873, 10057, 10157, 10257, 10781]","[0, 170, 260, 350, 440, 577, 667, 804, 943, 1033, 1183, 1273, 1411, 1506, 1937, 2371, 2690, 2784, 3230, 3388, 3483, 3963, 4130, 4225, 4578, 4672, 4892, 4987, 5278, 5547, 5733, 6314, 6504, 6789, 6889, 7045, 7145, 7504, 7604, 7739, 8063, 8209, 8309, 8897, 9421]",27248,25025,18379,10781,9421,94,25,98,86,26,"[61, 315, 644, 1148, 1465, 1589, 1982, 2368, 2810, 3258, 3874, 4720, 5292, 5688, 6355, 6796, 7224, 8125, 8583, 9768, 10478, 11630, 12830, 13694, 13903, 14695, 15182, 16334, 17066, 17539, 18279, 19623, 20626, 21506, 23035, 23721, 24712, 27587, 28612, 29656, 31614, 33466, 34783, 36211, 36936]","[61, 268, 394, 518, 762, 1050, 1303, 1685, 2064, 2403, 3195, 3934, 4554, 4996, 5090, 5409, 5731, 5990, 6648, 7806, 8365, 8539, 8959, 9362, 9825, 10492, 11150, 11472, 12230, 12774, 13493, 14483, 15147, 16157, 17336, 18079, 18974, 19246, 19661, 20260, 20588, 21080, 22015, 22115, 22582]","[61, 307, 785, 949, 1229, 1789, 2252, 2509, 2909, 3188, 3918, 4262, 4792, 5274, 5474, 5667, 6174, 6868, 7093, 7666, 8107, 8281, 8742, 9379, 9691, 10316, 10971, 11587, 12123, 12219, 12953, 13574, 13980, 14295, 14703, 15379, 15959, 17395, 17805, 18204, 19078, 19396, 19876, 20386, 20486]","[61, 231, 518, 608, 747, 960, 1099, 1189, 1361, 1523, 2187, 2493, 2673, 2912, 3041, 3324, 3762, 4080, 4265, 4738, 4920, 5291, 5555, 5650, 5915, 6248, 6538, 6793, 7314, 7573, 7921, 8268, 8458, 8773, 9570, 10068, 10168, 10268, 10752, 11034, 11388, 11751, 12044, 12564, 13075]","[329, 499, 589, 753, 1021, 1111, 1291, 1381, 1519, 1609, 2025, 2331, 2627, 2866, 3131, 3535, 3737, 3870, 4055, 4779, 5227, 5401, 5568, 5663, 6123, 6570, 6665, 6760, 7173, 7269, 7617, 8441, 8631, 8946, 9246, 9436, 9776, 10024, 10322, 10585, 11072, 11650, 11943, 12463, 12563]",36936,22582,20486,13075,12563,-9688,2443,-2107,-2294,-3142,-14788,45,dire
7582264918,93,106,96,123,26,"[0, 320, 551, 831, 1100, 1428, 1636, 2241, 2415, 2786, 3252, 3687, 4270, 4410, 5078, 5602, 6316, 6927, 8005, 8099, 9301, 10002, 10767, 11548, 12204, 12803, 12898, 14070, 14841, 15391, 16025, 16948, 17845, 19612, 20986, 21549, 22463, 23843, 24781, 24881, 25313, 26541, 27263, 27891, 28053]","[0, 293, 661, 1020, 1345, 1784, 2430, 2845, 3142, 3839, 4303, 4895, 5375, 5961, 6257, 6527, 7073, 7594, 8235, 8497, 8969, 9382, 9568, 9806, 10450, 11054, 11773, 12621, 13245, 13862, 14494, 15496, 15981, 18375, 18765, 19341, 20224, 20688, 22102, 22202, 22415, 23137, 24450, 24860, 25268]","[0, 209, 490, 872, 1111, 1610, 1811, 2254, 2673, 3543, 3853, 4555, 4827, 5076, 5646, 5891, 6205, 7038, 7641, 7982, 8840, 8935, 9268, 9506, 9792, 10325, 10686, 12796, 13001, 13475, 13571, 14135, 15056, 16210, 16600, 17178, 17278, 17623, 19116, 19216, 19783, 20324, 21041, 21392, 21492]","[0, 252, 342, 534, 711, 847, 937, 1433, 1637, 2110, 2245, 2462, 2907, 3610, 3818, 3948, 4253, 4526, 5010, 5460, 6221, 6316, 6456, 7361, 8145, 8240, 8666, 9094, 9647, 10164, 10525, 11335, 12224, 13767, 14859, 15468, 16317, 16952, 17302, 17402, 18914, 19493, 20095, 20808, 20908]","[0, 356, 834, 1017, 1171, 1310, 1411, 1750, 1886, 2091, 2312, 2521, 2735, 2990, 3139, 3233, 3999, 4184, 4528, 4670, 5041, 5184, 5279, 5517, 5612, 5904, 6096, 7138, 7234, 7411, 7507, 8024, 8124, 8967, 9357, 9457, 10034, 10244, 11117, 11217, 11629, 11910, 12120, 12471, 12571]",28053,25268,21492,20908,12571,18,97,23,105,45,"[0, 245, 532, 948, 1398, 1728, 2147, 2905, 3534, 4123, 4541, 5059, 5609, 7071, 7689, 8671, 9650, 10386, 11418, 12408, 13313, 14311, 15426, 16201, 17461, 18492, 19697, 19791, 20358, 21058, 21792, 22781, 22881, 24087, 24187, 24808, 25415, 25786, 26988, 27187, 27599, 28545, 29194, 32463, 34116]","[0, 167, 568, 906, 1268, 1936, 2219, 2771, 3487, 4170, 4588, 5172, 5819, 6262, 6911, 7464, 8103, 8771, 9150, 9935, 10538, 11292, 12166, 13043, 13514, 13954, 15108, 15653, 15846, 16853, 17082, 18060, 18778, 19606, 19706, 20223, 20576, 21218, 22123, 23600, 24309, 24841, 25041, 26203, 27839]","[0, 250, 602, 984, 1345, 1752, 1925, 2394, 2753, 3675, 4168, 4677, 5245, 6058, 6336, 6765, 7282, 7776, 8364, 8757, 8852, 9141, 9984, 10165, 11128, 11747, 12702, 12963, 13872, 14348, 14742, 15572, 15997, 16677, 16973, 17257, 17561, 17947, 18829, 20140, 20762, 21054, 21940, 23416, 25088]","[0, 129, 377, 467, 604, 861, 951, 1131, 1325, 1983, 2261, 2351, 2639, 2816, 3064, 3339, 3615, 3893, 4683, 5284, 5379, 5767, 6651, 6924, 7244, 8220, 8487, 8581, 8677, 9052, 9351, 10000, 10280, 11216, 11316, 11610, 11872, 12738, 14225, 14850, 15397, 15849, 16190, 17507, 18542]","[0, 129, 270, 386, 745, 986, 1081, 1307, 1397, 1798, 1955, 2262, 2406, 3068, 3217, 3810, 4391, 4666, 5254, 5743, 6148, 6570, 7097, 7895, 8335, 9313, 9667, 9761, 9857, 10115, 10308, 10911, 11354, 11454, 12000, 12549, 12811, 12960, 13697, 14149, 14605, 14705, 14909, 15525, 16240]",34116,27839,25088,18542,16240,-6063,-2571,-3596,2366,-3669,-13533,45,dire
7582691602,25,93,65,51,110,"[0, 276, 604, 1052, 1342, 1797, 2291, 2626, 3484, 4065, 4567, 4952, 5405, 5750, 6354, 7505, 8569, 9236, 9875, 10979, 11933, 12604, 13849, 13944, 14765, 15746, 16646, 18701, 19956, 22234, 23060, 23948, 25820, 26288, 26388, 28139, 29767, 29867, 31407, 32723, 33877, 34622, 35648, 35856, 36246]","[0, 326, 697, 1124, 1377, 1761, 2008, 2357, 2648, 2970, 3320, 3689, 4441, 5197, 5809, 7079, 7843, 8440, 9206, 9851, 10576, 10671, 11785, 12609, 13245, 14178, 14463, 15100, 15361, 15779, 16383, 17184, 18231, 18604, 19030, 20446, 21036, 21465, 22542, 23327, 24128, 25215, 25881, 26400, 26697]","[0, 208, 384, 511, 985, 1137, 1351, 1548, 1824, 2077, 2589, 3132, 3385, 4355, 4527, 5202, 6115, 6290, 6677, 7235, 7936, 8031, 8301, 8783, 9040, 9685, 10413, 10753, 10959, 11258, 11769, 12586, 13194, 13294, 13394, 14812, 15181, 15613, 16483, 17069, 17828, 18373, 19399, 20067, 20340]","[0, 170, 301, 435, 525, 655, 794, 929, 1019, 1154, 1617, 1751, 2003, 2856, 2951, 3659, 4032, 4660, 5088, 5759, 6142, 6497, 7066, 7445, 7650, 8002, 8337, 9338, 9783, 10788, 11103, 11395, 12077, 12252, 12484, 13490, 13687, 14345, 15193, 15684, 16433, 16749, 17276, 17484, 17945]","[0, 170, 260, 464, 657, 826, 952, 1086, 1211, 1383, 1605, 1695, 1948, 2136, 2384, 3084, 3518, 4131, 4556, 5352, 5706, 5954, 6720, 6815, 7184, 7738, 7927, 8867, 9073, 10129, 10631, 10877, 11447, 12213, 12421, 12877, 13221, 14096, 14907, 15377, 15972, 16481, 17250, 17713, 17813]",36246,26697,20340,17945,17813,70,14,129,119,111,"[0, 332, 677, 1114, 1485, 2130, 2595, 2956, 3945, 4509, 5113, 5606, 6138, 6604, 6936, 7131, 8023, 8740, 9826, 10193, 10287, 11577, 12945, 13785, 14604, 15259, 15678, 16562, 16794, 17129, 17434, 18447, 19764, 20671, 21612, 22416, 22906, 24531, 25316, 25416, 25516, 26339, 28050, 28850, 29387]","[0, 277, 545, 905, 1319, 1652, 1932, 2303, 2516, 3123, 3808, 3898, 4388, 4977, 5741, 5836, 6387, 7074, 7721, 8125, 8443, 10000, 10765, 11922, 12393, 12843, 13102, 13512, 14257, 14398, 14746, 15720, 16765, 17116, 17655, 18142, 18377, 20444, 21066, 21365, 21734, 22183, 23657, 24419, 25018]","[0, 204, 535, 862, 1143, 1475, 1962, 2423, 2912, 3259, 3877, 4291, 4563, 5069, 5527, 6197, 6898, 7384, 7639, 7734, 8481, 9398, 10538, 10833, 11224, 12040, 12265, 12675, 13422, 13564, 13952, 14585, 15720, 16368, 17072, 17730, 17965, 20041, 20918, 21018, 21299, 22025, 23733, 24355, 24682]","[0, 170, 671, 1008, 1564, 1818, 2143, 2278, 2793, 2922, 3377, 3724, 3814, 3909, 4103, 4279, 4463, 5057, 5447, 5542, 5998, 6546, 6931, 7662, 7966, 8318, 8618, 9298, 10443, 10650, 10821, 11260, 12079, 13372, 13873, 14138, 14474, 14933, 15818, 16463, 17199, 17932, 19176, 19835, 19935]","[0, 170, 260, 464, 668, 772, 1036, 1434, 1573, 1707, 2182, 2321, 2411, 2545, 2640, 2770, 3181, 3538, 3903, 4218, 4440, 4886, 5478, 6063, 6387, 6916, 7060, 7470, 8633, 8907, 9003, 9673, 10854, 11724, 12148, 12567, 12802, 14398, 15061, 15161, 15446, 15671, 16864, 17216, 17595]",29387,25018,24682,19935,17595,6859,1679,-4342,-1990,218,2424,45,radiant
7583012200,89,106,137,112,105,"[0, 321, 625, 1048, 1256, 1628, 2355, 2621, 3145, 3698, 4447, 5148, 5565, 6279, 7260, 8132, 8969, 9596, 10353, 10867, 11270, 12003, 12378, 13626, 14775, 15272, 16077, 16726, 17576, 18442, 19057, 20115, 20781, 21083, 21429, 22389, 24130, 25298, 25398, 26240, 26625, 27897, 29237, 30190, 31162]","[0, 243, 446, 536, 735, 934, 1522, 1867, 2158, 2611, 2985, 3584, 4215, 4748, 4847, 5388, 5919, 6517, 7075, 7736, 8064, 8819, 9845, 10554, 11534, 12074, 12416, 12887, 13515, 14326, 15482, 16477, 17106, 17460, 17701, 17801, 18390, 19168, 19620, 20809, 21395, 21919, 22360, 22693, 22918]","[0, 296, 533, 977, 1172, 1512, 2129, 2566, 3072, 3331, 4207, 4703, 5176, 5976, 6071, 6624, 7360, 7798, 8158, 8861, 9316, 9615, 10227, 11091, 12102, 12681, 12943, 13461, 13724, 14005, 14855, 15459, 15757, 16042, 16433, 16533, 17075, 17610, 17760, 18558, 18921, 19232, 19711, 20194, 20971]","[0, 209, 299, 389, 479, 697, 1075, 1291, 1381, 1507, 1717, 1841, 2217, 2511, 2825, 3093, 3407, 3891, 4582, 4739, 5144, 5484, 5746, 6159, 6351, 6985, 7270, 7466, 7691, 8059, 8593, 9012, 9313, 9682, 9817, 10184, 10503, 10797, 10922, 11671, 11906, 12184, 12561, 12894, 13119]","[0, 209, 299, 389, 479, 657, 1035, 1170, 1322, 1489, 1705, 1795, 2010, 2159, 2254, 2599, 2864, 3574, 4056, 4252, 4460, 4660, 5035, 5523, 6028, 6590, 6962, 7105, 7201, 7432, 7638, 8086, 8290, 8523, 8623, 8907, 9007, 9301, 9401, 9980, 10215, 10315, 10977, 11335, 11798]",31162,22918,20971,13119,11798,73,46,50,19,111,"[0, 263, 527, 991, 1528, 2095, 2284, 2623, 2982, 3638, 4502, 5049, 6274, 7237, 8104, 9160, 10104, 10489, 11444, 12027, 12989, 13420, 14662, 15414, 15887, 17075, 18134, 19501, 21099, 22274, 23397, 24097, 25034, 25790, 27144, 28181, 29118, 30078, 31183, 31779, 32110, 33109, 34338, 35182, 36336]","[0, 205, 530, 693, 1212, 1577, 1902, 2423, 2918, 3550, 4162, 4733, 5490, 6408, 6984, 7727, 8391, 9060, 9830, 10439, 11072, 11644, 12896, 13284, 13568, 14104, 14937, 15819, 16941, 17756, 18715, 19156, 19793, 20369, 21076, 22297, 23220, 24524, 25264, 25720, 26430, 27245, 29046, 30454, 31638]","[0, 166, 479, 971, 1422, 1913, 2523, 2929, 3605, 4063, 4402, 5049, 5517, 6023, 6649, 7173, 8228, 8458, 8981, 9399, 10233, 10573, 10914, 11663, 12089, 12961, 13626, 14134, 15056, 15729, 16217, 16751, 17056, 17287, 18087, 18691, 19592, 20520, 21010, 21308, 21943, 22640, 23220, 24145, 25450]","[0, 168, 334, 588, 762, 913, 1070, 1323, 1503, 1633, 2028, 2240, 2584, 2939, 3173, 3673, 4094, 4324, 4508, 4932, 5090, 5188, 5983, 6149, 6548, 7073, 7214, 7395, 7653, 8301, 8642, 8819, 8919, 9116, 9683, 10180, 10530, 11422, 11522, 11622, 11839, 11939, 12742, 13276, 13793]","[0, 229, 349, 439, 529, 619, 917, 1007, 1187, 1367, 1568, 1851, 2090, 2239, 2646, 2831, 3334, 3564, 3734, 3967, 4127, 4222, 4527, 4693, 4898, 5083, 5178, 5272, 5530, 5716, 5812, 5912, 6012, 6437, 6690, 6938, 7265, 7904, 8004, 8104, 8204, 8304, 8739, 9074, 9630]",36336,31638,25450,13793,9630,-5174,-8720,-4479,-674,2168,-16879,45,dire
7584193705,78,46,13,86,58,"[0, 207, 370, 751, 1075, 1165, 1623, 1890, 2433, 2742, 3064, 3711, 4543, 4940, 5354, 5935, 6816, 7318, 7571, 8145, 9016, 10013, 11066, 11196, 11738, 12110, 12826, 13666, 14178, 14957, 15693, 16116, 17443, 18500, 19564, 20797, 21758, 22774, 23571, 24465, 25231, 26290, 27118, 27728, 30518]","[0, 247, 421, 736, 935, 1378, 1505, 2012, 2529, 3053, 3541, 4408, 4992, 5700, 6455, 6974, 7873, 8644, 8988, 9841, 10395, 10717, 11584, 11731, 12509, 12604, 13621, 14473, 15210, 16067, 17021, 17534, 18776, 18986, 20255, 21194, 22109, 23079, 23881, 24643, 25711, 26665, 27383, 27894, 29898]","[0, 370, 612, 896, 1142, 1362, 1495, 1818, 1951, 2347, 2814, 3251, 3791, 4326, 4904, 5704, 6180, 6903, 7661, 8364, 9047, 9519, 10012, 10106, 10727, 10822, 11551, 12080, 12720, 13112, 14146, 14941, 16790, 17842, 18445, 19579, 20476, 21374, 22087, 22941, 23677, 24491, 25470, 26601, 29730]","[0, 169, 306, 430, 555, 703, 841, 982, 1163, 1433, 1663, 1887, 2112, 2868, 3053, 3630, 4046, 4204, 4610, 4842, 5012, 5794, 6950, 7119, 7289, 7459, 7710, 8157, 8772, 9192, 9983, 10434, 11360, 11602, 11792, 12017, 12494, 13011, 13547, 14103, 14537, 14637, 14894, 15657, 17809]","[0, 169, 259, 349, 474, 564, 654, 822, 984, 1294, 1578, 1896, 2270, 2672, 2900, 3589, 3897, 4236, 4679, 5206, 5346, 5788, 6256, 6350, 6913, 7046, 7262, 7356, 7576, 8046, 8776, 8986, 10502, 10760, 11161, 11410, 12196, 12465, 12730, 12854, 13106, 13282, 13772, 14254, 16257]",30518,29898,29730,17809,16257,67,47,137,19,110,"[0, 244, 625, 944, 1144, 1631, 1919, 2356, 2683, 2979, 3333, 3701, 3958, 4592, 5010, 5629, 6049, 6616, 7338, 7866, 8752, 10336, 10973, 12855, 13354, 14585, 15086, 15644, 16594, 17271, 18043, 19052, 19714, 19961, 20700, 21163, 22034, 22720, 23339, 24002, 24713, 25524, 26013, 27162, 27380]","[0, 250, 722, 1103, 1417, 1940, 2608, 2998, 3496, 4039, 4675, 5183, 5797, 6289, 6807, 7058, 7459, 7654, 8215, 8956, 9559, 10269, 10411, 11089, 11717, 12054, 12466, 13168, 13896, 14604, 15274, 16296, 17110, 17771, 18614, 19207, 20355, 21253, 21850, 22492, 23346, 24236, 24698, 25710, 25810]","[0, 169, 674, 990, 1323, 1583, 2102, 2557, 2806, 3341, 3844, 4213, 4509, 5080, 5961, 6270, 6666, 7199, 7586, 8155, 8777, 9505, 9705, 10764, 11441, 12164, 12498, 13326, 13891, 14295, 14915, 15710, 17128, 17318, 18247, 19119, 20164, 21095, 21725, 22678, 23521, 23866, 24276, 25224, 25324]","[0, 169, 284, 419, 597, 722, 1186, 1321, 1493, 1677, 1857, 2102, 2364, 2877, 3279, 3499, 3931, 4130, 4497, 4855, 5196, 5819, 6329, 7507, 7729, 8604, 8699, 9414, 9893, 10531, 10731, 10921, 11591, 11781, 12321, 12614, 12714, 13209, 13839, 14659, 15514, 16266, 17502, 18619, 18940]","[0, 169, 325, 797, 982, 1125, 1315, 1523, 1673, 1933, 2484, 2838, 3066, 3398, 3493, 3588, 3980, 4276, 4628, 5193, 5648, 6375, 6630, 7541, 8334, 9731, 10268, 10750, 11765, 11886, 12260, 12450, 13224, 13486, 14125, 14832, 15131, 15534, 16001, 16353, 17198, 17504, 17920, 18653, 18900]",27380,25810,25324,18940,18900,3138,4088,4406,-1131,-2643,7858,45,radiant
7588655005,94,96,106,123,112,"[0, 289, 647, 936, 1334, 1748, 2028, 2505, 2985, 3422, 3884, 4345, 4882, 5476, 5749, 6617, 7310, 8232, 9271, 10610, 11038, 12192, 13016, 13305, 13915, 14825, 15904, 16569, 17761, 19566, 20606, 21612, 22365, 23464, 24309, 25206, 26831, 27406, 28295, 29141, 29499, 30692, 31809, 33718, 34465]","[0, 277, 519, 939, 1312, 1654, 1977, 2402, 2845, 3197, 4376, 5133, 5650, 6225, 7102, 7685, 8098, 8301, 8729, 9217, 9827, 10189, 10886, 11343, 12001, 12258, 13333, 13789, 14483, 15314, 15582, 16763, 17178, 17353, 17837, 18625, 19494, 20079, 20179, 20279, 20964, 21770, 22002, 23294, 25528]","[0, 322, 650, 922, 1411, 1801, 2152, 2614, 3019, 3468, 3935, 4253, 4704, 5140, 5372, 5585, 6421, 7274, 8420, 8740, 8835, 9277, 10021, 10962, 11633, 11970, 12146, 12240, 12336, 13377, 14148, 14645, 15375, 16184, 16654, 17687, 18841, 19139, 19239, 19802, 20229, 20329, 21045, 21865, 22917]","[0, 170, 260, 398, 553, 927, 1017, 1157, 1632, 1812, 2246, 2912, 3053, 3148, 3243, 3460, 3645, 4263, 4583, 4952, 5129, 5395, 5667, 5908, 6233, 6475, 6726, 7011, 7846, 8529, 8793, 9493, 10308, 10840, 11498, 12268, 12782, 13641, 14074, 14194, 14840, 15093, 15378, 15960, 17206]","[0, 170, 260, 714, 804, 894, 984, 1124, 1329, 1619, 1891, 2246, 2421, 2561, 2911, 3210, 3494, 3893, 3988, 4317, 4678, 4773, 5104, 5679, 5774, 5941, 6819, 6953, 7084, 7710, 8028, 8444, 8659, 9133, 9733, 10224, 10800, 11098, 11198, 11552, 11891, 11991, 12188, 12770, 13341]",34465,25528,22917,17206,13341,120,10,69,33,20,"[0, 295, 458, 824, 1138, 1465, 1849, 2255, 2937, 3442, 3967, 4635, 5218, 5789, 7206, 7592, 8772, 9522, 10259, 11066, 11457, 12194, 12865, 13912, 14694, 15852, 17015, 17292, 18083, 18349, 18618, 19092, 19974, 20640, 21223, 21961, 22061, 23229, 24121, 24918, 26052, 27387, 27502, 27880, 27980]","[0, 170, 440, 763, 1087, 1251, 1852, 2333, 2602, 3011, 3252, 3787, 4181, 4844, 5827, 6369, 7240, 7477, 8009, 9275, 9801, 10572, 11135, 12030, 12449, 13317, 14633, 15847, 16786, 17309, 18019, 18685, 19727, 20519, 21314, 21552, 22707, 23598, 24184, 24464, 26095, 26953, 27730, 28379, 28479]","[0, 242, 482, 1236, 1527, 1813, 2107, 2638, 3201, 3614, 4115, 4821, 5359, 6021, 7389, 7754, 8442, 9046, 9468, 10496, 11133, 11661, 12283, 12972, 13618, 14594, 14925, 15546, 16143, 16582, 17651, 18442, 19450, 19932, 20592, 20964, 21778, 22436, 22905, 23696, 24403, 25067, 25431, 26087, 28131]","[0, 170, 260, 350, 566, 745, 1071, 1243, 1431, 1625, 2140, 2537, 2746, 3406, 3900, 4413, 4908, 5356, 5733, 6499, 7239, 7797, 8319, 9044, 9750, 10403, 10883, 11400, 12102, 12273, 12626, 13052, 14037, 14602, 15185, 15397, 15789, 16064, 16860, 17174, 17919, 19112, 19355, 19859, 19959]","[0, 271, 413, 658, 826, 956, 1277, 1456, 1671, 1933, 2398, 2627, 2762, 3158, 3563, 3831, 4249, 4792, 5075, 5379, 5657, 6106, 6456, 6758, 7126, 7666, 8121, 8858, 9601, 9886, 10054, 10229, 10839, 11264, 11542, 11886, 12322, 12655, 12792, 13012, 13379, 13820, 14207, 14566, 14795]",27980,28479,28131,19959,14795,6485,-2951,-5214,-2753,-1454,-5887,45,radiant
7589043306,17,14,43,19,20,"[329, 619, 960, 1288, 1628, 2146, 2620, 3004, 3498, 3913, 4473, 4846, 5372, 5771, 5876, 6012, 6658, 7616, 8918, 9252, 9796, 10266, 10462, 11643, 12290, 12812, 13214, 14710, 14806, 15824, 16555, 16961, 17450, 18782, 19245, 20578, 20851, 21934, 22587, 24016, 24379, 25906, 26948, 27074, 27622]","[61, 340, 853, 1172, 1699, 2026, 2406, 2768, 2903, 3435, 3693, 4003, 4545, 4911, 5042, 5489, 6592, 7293, 7502, 8653, 9224, 9750, 9845, 9939, 11060, 11400, 12123, 12604, 13347, 14094, 14865, 15435, 16451, 17725, 18298, 19038, 19358, 20323, 20423, 20812, 21295, 22403, 23192, 23676, 24319]","[0, 170, 531, 793, 1364, 1699, 1987, 2154, 2497, 3386, 3802, 3976, 4404, 4535, 5130, 5563, 6820, 7561, 8145, 8650, 9638, 10045, 10140, 10447, 10885, 11741, 12228, 13113, 13334, 14069, 14647, 15352, 15452, 16182, 16674, 17747, 18953, 19979, 20079, 20808, 21152, 22511, 22879, 23530, 23968]","[61, 231, 321, 711, 933, 1367, 1457, 1552, 1735, 2018, 2404, 2494, 2584, 2717, 2968, 3154, 3855, 4407, 4845, 5368, 5793, 5888, 5983, 6265, 6711, 6878, 7296, 8176, 8272, 8792, 9092, 9699, 10170, 10318, 10494, 11008, 11529, 12010, 12110, 13097, 13810, 14718, 15323, 15564, 15785]","[61, 231, 389, 568, 739, 929, 1403, 1493, 1628, 2063, 2198, 2288, 2422, 2829, 2924, 3177, 3720, 4151, 4341, 4773, 5198, 5341, 5436, 5709, 6125, 6292, 6433, 6914, 7010, 7364, 7460, 7740, 8439, 9207, 9307, 9783, 10304, 10771, 11201, 11715, 11815, 12789, 13077, 13177, 13314]",27622,24319,23968,15785,13314,42,98,80,72,26,"[0, 285, 642, 964, 1380, 1899, 2180, 2816, 3265, 3727, 4298, 4634, 5369, 5978, 6576, 6950, 7829, 8633, 9660, 10221, 10618, 11634, 12648, 13827, 14510, 15951, 17073, 18400, 19506, 20194, 21257, 22032, 23290, 23743, 24306, 25143, 25870, 27967, 28673, 29937, 30689, 30836, 30936, 32308, 33014]","[0, 454, 859, 1154, 1396, 1988, 2078, 2444, 3077, 3566, 4320, 4957, 5614, 6102, 6662, 7069, 7226, 7839, 9393, 10306, 10583, 11333, 12377, 13639, 14023, 14684, 15523, 16338, 16697, 17633, 18089, 18998, 20189, 21225, 22138, 22780, 23217, 24802, 25836, 26225, 26424, 27450, 27977, 28925, 29737]","[0, 291, 559, 964, 1138, 1418, 1865, 2511, 3022, 3349, 4080, 4615, 5169, 6528, 7089, 7394, 7776, 8219, 8671, 9080, 9765, 10426, 11349, 12405, 13022, 13934, 14699, 15272, 15981, 16731, 17307, 18160, 19228, 20524, 21393, 22025, 22694, 23829, 24338, 25013, 25654, 26126, 27408, 28240, 29273]","[0, 252, 342, 432, 571, 741, 846, 1277, 1810, 1990, 2466, 2643, 2899, 3192, 3879, 4325, 4482, 4735, 5096, 5803, 5898, 6526, 7036, 7959, 8126, 8493, 8882, 9231, 9841, 10007, 10103, 10682, 11298, 12188, 12591, 12726, 12826, 13743, 14303, 14729, 15232, 15332, 15432, 15918, 16361]","[0, 170, 260, 350, 440, 610, 797, 1116, 1206, 1386, 1673, 2145, 2408, 2942, 3411, 3695, 3868, 4207, 4494, 4968, 5229, 5987, 6486, 7208, 7449, 8173, 8452, 8546, 8842, 9020, 9366, 9827, 10256, 10457, 11129, 11229, 11506, 12900, 13209, 13553, 13825, 13925, 14174, 14858, 14958]",33014,29737,29273,16361,14958,-5392,-5418,-5305,-576,-1644,-18335,45,dire
7590356016,73,90,106,86,26,"[0, 553, 1016, 1400, 1604, 1932, 2362, 2711, 3305, 3860, 4499, 4874, 5524, 6155, 7154, 8331, 9356, 10092, 10851, 11584, 12685, 14491, 15355, 15996, 17018, 17499, 18477, 19058, 19264, 19560, 20019, 20633, 21822, 24217, 25818, 26522, 27340, 27947, 29863, 30531, 30631, 31466, 31566, 32828, 33420]","[0, 722, 1158, 1488, 1831, 2121, 2539, 3287, 3977, 4529, 5107, 5662, 6286, 6891, 7432, 7841, 8561, 8997, 9417, 9793, 10379, 10874, 11367, 12374, 12988, 13477, 13849, 14172, 14453, 15034, 15543, 16363, 16805, 17780, 18862, 19582, 20075, 20850, 21728, 22595, 22695, 24371, 26841, 27603, 28051]","[0, 416, 795, 1164, 1620, 1911, 2430, 2882, 3305, 3811, 4225, 4723, 4999, 5390, 6174, 6808, 7337, 7929, 8401, 9171, 9844, 10754, 11293, 11507, 12015, 12603, 13265, 13602, 14060, 14951, 15335, 16041, 17024, 18466, 19281, 19920, 20612, 21552, 22257, 23229, 23329, 24608, 25664, 26178, 26774]","[0, 297, 588, 678, 882, 1281, 1460, 1660, 1927, 2062, 2152, 2315, 2563, 2818, 3314, 3644, 4258, 4353, 4448, 4724, 5401, 5757, 6115, 6634, 7069, 7239, 7521, 7758, 8039, 8448, 8619, 8883, 9109, 9915, 10617, 10794, 11673, 12533, 13123, 13223, 13323, 13648, 13911, 14032, 14234]","[0, 297, 387, 486, 583, 711, 941, 1141, 1406, 1733, 1836, 1970, 2286, 2523, 2708, 2803, 3309, 3485, 3727, 4032, 4967, 5344, 5761, 5969, 6269, 6488, 6983, 7177, 7706, 7958, 8129, 8303, 8729, 8904, 9355, 9455, 9721, 10403, 11177, 11337, 11476, 12322, 12497, 12794, 13158]",33420,28051,26774,14234,13158,18,28,43,19,20,"[0, 324, 842, 1180, 1633, 1963, 2251, 2565, 3171, 3767, 4374, 5837, 6497, 7275, 7876, 8354, 8988, 9820, 10608, 11819, 12756, 13077, 15220, 15931, 17101, 17842, 19014, 19795, 21622, 22607, 24124, 25457, 26742, 29144, 29334, 29883, 31027, 31262, 31362, 33264, 34903, 38062, 38162, 38478, 39626]","[0, 395, 725, 1011, 1497, 2021, 2543, 2826, 3346, 3769, 4273, 4916, 5805, 6264, 6636, 6961, 7308, 7869, 8319, 8992, 9191, 9536, 10465, 10853, 11645, 12368, 13100, 13301, 14097, 14702, 15170, 16287, 16931, 17892, 19353, 19787, 20020, 20968, 21958, 23475, 24343, 26849, 26983, 27549, 28773]","[0, 296, 497, 799, 958, 1245, 1614, 1961, 2399, 2731, 3281, 3978, 4290, 4726, 5161, 5698, 6258, 7125, 7364, 8071, 8578, 8835, 9740, 9916, 10410, 11023, 11538, 11750, 12825, 13112, 13465, 14155, 14545, 15150, 15750, 15850, 15950, 16185, 16901, 17405, 18206, 19715, 20011, 20665, 21558]","[0, 239, 329, 509, 682, 807, 970, 1060, 1150, 1375, 1510, 1941, 2329, 2535, 2935, 3160, 3639, 3824, 3919, 4314, 4456, 4982, 5546, 5835, 6031, 6496, 6762, 6972, 7856, 8270, 8516, 9282, 9555, 9999, 10189, 10440, 10578, 11051, 11446, 12547, 13252, 14321, 14421, 14921, 15345]","[0, 372, 555, 739, 829, 988, 1123, 1213, 1303, 1438, 1620, 2149, 2425, 2608, 2703, 2954, 3223, 3529, 3761, 4156, 4250, 4345, 4624, 4909, 5264, 5540, 5716, 5811, 7032, 7319, 7415, 7778, 7879, 8510, 8700, 8942, 9042, 9277, 9587, 10454, 11159, 12392, 12492, 12808, 13232]",39626,28773,21558,15345,13232,-6206,-722,5216,-1111,-74,-2897,45,dire
7594024404,12,13,96,123,128,"[0, 245, 715, 994, 1322, 1798, 2214, 2515, 2754, 3056, 3571, 3989, 4260, 4606, 5131, 5315, 5528, 5703, 6105, 7982, 9023, 9712, 10362, 10831, 11124, 11730, 11997, 13747, 14466, 14562, 14893, 18172, 18911, 19615, 19940, 21949, 22540, 23317, 26918, 27682, 28389, 29458, 30497, 31718, 33938]","[0, 283, 614, 900, 1192, 1413, 1705, 1958, 2328, 2963, 3156, 3841, 4031, 4299, 4817, 5247, 5733, 5828, 6503, 6808, 7256, 7748, 8096, 8522, 9164, 9578, 9986, 10834, 10931, 11027, 11418, 12222, 12412, 12789, 12889, 13099, 13442, 13591, 14051, 14277, 14483, 14621, 14880, 15366, 16578]","[0, 208, 573, 789, 1115, 1324, 1710, 2090, 2487, 3171, 3261, 3492, 3937, 4162, 4907, 5094, 5498, 5593, 5968, 6231, 6831, 7260, 7547, 7752, 8033, 8226, 8321, 8749, 9044, 9140, 9236, 10787, 11655, 11890, 12037, 13233, 13849, 14110, 16371, 17104, 17354, 17704, 17804, 18152, 19477]","[0, 170, 260, 350, 485, 575, 757, 895, 985, 1325, 1462, 1814, 1910, 2397, 2537, 2711, 2805, 2900, 3067, 3540, 4464, 4886, 5222, 5418, 5789, 5991, 6086, 7188, 7358, 7454, 7718, 8168, 8358, 8835, 9617, 10919, 11427, 11741, 12269, 12370, 12661, 12897, 13187, 13868, 15163]","[0, 170, 339, 478, 730, 820, 1001, 1091, 1181, 1350, 1478, 1665, 1755, 1850, 1990, 2104, 2319, 2414, 2524, 3175, 3588, 3865, 3960, 4055, 4149, 4244, 4339, 4954, 5220, 5316, 5412, 6540, 6930, 7200, 7346, 9071, 9444, 9653, 9848, 10471, 10571, 10671, 10771, 11258, 11358]",33938,16578,19477,15163,11358,93,71,120,110,20,"[0, 218, 529, 1096, 1312, 1737, 2223, 2651, 3077, 3336, 3932, 4573, 5181, 5756, 6222, 6856, 7397, 8295, 8803, 9528, 10345, 11174, 11836, 12526, 13115, 13770, 14615, 15021, 15911, 16583, 17664, 18583, 18683, 19416, 20716, 21367, 23395, 24095, 24397, 25026, 26026, 27587, 28140, 29013, 29556]","[0, 247, 602, 981, 1313, 1675, 2042, 2409, 3399, 3895, 4517, 5123, 6014, 6347, 6870, 7623, 7959, 8470, 9150, 9566, 9957, 10583, 11092, 11731, 12460, 13021, 13841, 15128, 15591, 16454, 17070, 17825, 17925, 19466, 20664, 21091, 21389, 22493, 24145, 24246, 25084, 26147, 27720, 28281, 28744]","[0, 245, 506, 677, 1016, 1213, 1623, 2032, 2449, 2955, 3896, 4226, 4443, 5039, 5516, 5906, 6441, 7241, 7840, 8239, 8503, 9171, 10015, 10121, 11160, 12027, 12938, 13387, 14279, 15092, 15592, 16871, 16971, 17614, 18861, 19852, 20357, 21203, 22468, 22569, 23116, 24214, 25111, 26052, 26403]","[0, 170, 629, 766, 902, 1221, 1631, 1745, 2242, 2509, 2925, 3108, 3377, 4176, 4592, 4856, 5090, 5770, 6555, 6943, 7110, 7418, 7834, 8157, 8598, 9391, 10374, 10846, 11323, 11849, 12332, 12938, 13049, 13405, 14157, 14778, 15148, 15305, 16004, 16175, 16350, 16936, 17036, 17538, 17638]","[0, 170, 285, 422, 512, 724, 951, 1088, 1269, 1441, 1668, 1812, 2361, 2694, 2987, 3250, 3852, 4769, 5203, 5467, 5769, 5936, 6108, 6406, 6772, 7131, 7934, 8491, 8750, 9186, 9409, 9885, 10086, 10222, 10846, 11294, 11592, 11692, 12292, 12393, 12493, 13025, 13125, 13470, 13570]",29556,28744,26403,17638,13570,4382,-12166,-6926,-2475,-2212,-19397,45,dire
7598302418,21,19,53,96,100,"[0, 213, 574, 911, 1111, 1495, 2012, 2588, 3340, 4047, 4866, 5892, 6214, 6693, 7547, 9026, 9446, 10061, 10373, 12081, 12619, 12714, 13137, 13819, 14601, 15165, 15260, 15800, 16699, 18032, 19659, 20192, 20292, 21461, 22832, 24028, 26070, 26170, 27062, 28357, 28684, 28784, 29012, 29257, 31349]","[0, 242, 526, 935, 1347, 1606, 2105, 2829, 3596, 4022, 4366, 5005, 5312, 5638, 6497, 7069, 7725, 8148, 8529, 9520, 10228, 10834, 11680, 11959, 12631, 13123, 13264, 13929, 14533, 15323, 15943, 16316, 17001, 18575, 20028, 20933, 22557, 22657, 23769, 24443, 25087, 26429, 27100, 27308, 27786]","[0, 169, 476, 566, 656, 873, 1370, 1586, 1948, 2303, 2621, 3363, 3669, 3818, 4327, 4761, 5247, 5939, 6438, 7240, 8045, 8908, 9575, 9915, 10966, 12246, 12341, 13013, 13672, 14505, 14935, 15325, 15544, 16427, 17559, 17967, 19535, 20704, 21516, 22427, 22626, 22726, 23586, 23794, 24592]","[0, 169, 422, 666, 921, 1169, 1760, 2171, 2710, 2881, 3387, 3712, 4048, 4595, 4969, 5582, 6147, 6242, 6337, 6836, 7201, 7633, 8222, 9218, 9698, 9967, 11027, 11351, 11803, 12478, 12930, 13277, 13737, 15068, 15977, 16492, 17598, 17698, 18425, 19204, 19966, 20779, 21401, 21647, 22105]","[0, 169, 259, 394, 484, 623, 1035, 1359, 1494, 1711, 2186, 2516, 2606, 3026, 3475, 4063, 4319, 4948, 5081, 5422, 5662, 6070, 6402, 6890, 7527, 7739, 8076, 8282, 8569, 9067, 9346, 9446, 9604, 10568, 11143, 11368, 11858, 12579, 13002, 13102, 13429, 13529, 14021, 14229, 14930]",31349,27786,24592,22105,14930,25,10,123,129,20,"[0, 626, 918, 1291, 1633, 2033, 2645, 3081, 3616, 4050, 4653, 5089, 5635, 6126, 6859, 7594, 8171, 9262, 9879, 10427, 11307, 13155, 13789, 14616, 15244, 18597, 18854, 19590, 20951, 21047, 21748, 23583, 23870, 24124, 24224, 25006, 25822, 25922, 26859, 27716, 27816, 28170, 28601, 30111, 30943]","[0, 270, 579, 989, 1319, 1728, 2105, 2601, 3135, 3694, 4244, 4910, 5583, 6052, 6813, 7141, 7328, 7883, 8400, 9106, 9601, 10106, 10382, 11315, 11577, 12275, 13157, 13633, 14172, 14875, 16071, 17039, 17664, 17764, 18426, 18526, 20567, 20667, 21351, 22366, 23910, 24857, 25913, 27273, 28465]","[0, 234, 324, 682, 861, 1015, 1105, 1822, 2034, 2124, 2401, 2491, 2721, 2906, 3046, 3403, 3737, 3882, 4208, 4867, 5014, 5109, 5615, 6256, 6447, 8158, 8740, 8834, 9230, 9334, 10185, 11044, 11144, 12085, 12600, 12700, 15414, 16600, 17483, 18092, 19195, 19939, 20772, 22342, 23514]","[0, 254, 571, 900, 1244, 1564, 2044, 2378, 2699, 2965, 3100, 3383, 3681, 3944, 4341, 4436, 4610, 4962, 5827, 6105, 6822, 7021, 7362, 7922, 8302, 8843, 9878, 10257, 10434, 10787, 11258, 11960, 12304, 12566, 13049, 13149, 14266, 14366, 15480, 16015, 16764, 17298, 18495, 19679, 20255]","[0, 234, 324, 421, 556, 780, 882, 1315, 1479, 1746, 1881, 1971, 2587, 2772, 3046, 3289, 3703, 3986, 4278, 4641, 5189, 5792, 5887, 6099, 6193, 6495, 6775, 6943, 7315, 7602, 7908, 8098, 8206, 8721, 9136, 9236, 10856, 11157, 11950, 12401, 12789, 13107, 14007, 14864, 15277]",30943,28465,23514,20255,15277,406,-679,1078,1850,-347,2308,45,radiant
7598355413,70,23,69,123,79,"[1, 282, 637, 952, 1361, 1773, 2370, 2809, 3108, 3415, 3646, 4229, 4749, 5859, 6330, 7100, 7726, 8815, 9542, 10315, 10985, 11080, 11655, 12398, 12902, 13827, 14524, 15399, 15747, 16954, 18076, 18176, 18729, 19788, 20273, 22726, 23814, 24501, 25452, 26128, 26871, 27431, 28595, 31518, 32968]","[1, 402, 695, 1185, 1681, 2013, 2182, 2477, 3097, 3749, 4267, 5226, 5837, 6544, 7076, 7243, 7783, 8086, 8624, 9133, 9527, 10100, 10729, 11066, 11333, 11849, 12216, 12618, 12977, 13183, 14412, 14905, 15413, 16148, 16573, 18906, 19138, 19406, 19864, 19991, 21060, 21366, 22121, 24196, 25142]","[1, 247, 405, 855, 1075, 1311, 1912, 2272, 2692, 2859, 3134, 3264, 3720, 4131, 4810, 5057, 5383, 5940, 6080, 6487, 6735, 7122, 8004, 8467, 8721, 9537, 10075, 11458, 11832, 11928, 12485, 13354, 13937, 14583, 14773, 16849, 17310, 17570, 18078, 18383, 18911, 19443, 19679, 21286, 22130]","[1, 171, 291, 500, 659, 789, 1134, 1270, 1360, 1633, 1984, 2123, 2361, 2802, 2897, 2992, 3499, 3699, 4206, 4971, 5352, 5618, 6449, 6675, 6790, 7639, 7800, 8202, 8402, 9053, 9721, 9821, 10005, 10219, 10720, 11726, 12759, 13181, 13758, 13858, 14464, 14672, 15485, 17308, 18064]","[1, 171, 291, 461, 597, 1042, 1262, 1665, 1769, 1859, 2402, 2492, 2708, 3265, 3499, 3744, 4195, 4493, 4676, 5281, 5686, 6013, 6470, 6810, 7019, 7417, 7678, 8155, 8664, 8835, 9840, 10071, 10230, 10330, 10639, 11396, 11606, 12037, 12346, 12627, 12772, 13240, 13340, 14780, 15689]",32968,25142,22130,18064,15689,21,97,40,96,85,"[1, 327, 657, 1031, 1629, 2141, 2404, 2880, 3372, 3791, 4491, 5034, 5633, 6180, 6702, 7906, 8702, 9010, 9716, 10252, 11187, 12138, 12467, 13086, 13972, 14527, 15330, 16929, 17865, 18404, 20216, 21120, 22045, 22874, 23584, 24110, 24529, 25348, 25948, 26683, 27955, 28502, 29150, 29406, 29506]","[1, 210, 571, 1102, 1521, 2038, 2412, 2917, 3540, 3903, 4185, 4466, 4916, 5156, 5420, 5713, 6168, 6812, 7702, 8389, 9463, 9946, 10625, 11063, 11892, 12094, 12705, 12800, 13372, 14075, 14171, 15009, 16369, 17277, 17838, 18059, 18442, 19206, 19838, 20458, 21004, 22379, 22479, 22579, 22808]","[1, 244, 574, 751, 999, 1410, 1839, 2027, 2411, 3004, 3336, 3879, 4085, 4179, 4519, 5394, 6040, 6637, 7533, 8128, 8994, 9411, 9859, 10287, 10766, 11220, 11315, 12069, 13124, 13767, 13863, 14245, 15491, 16012, 16196, 16571, 17090, 17491, 17808, 18342, 19199, 19665, 20291, 20723, 20823]","[1, 171, 261, 387, 524, 722, 961, 1051, 1305, 1495, 2180, 2669, 2924, 3194, 3632, 4074, 4644, 5249, 5832, 6053, 6522, 7186, 7410, 8214, 8398, 8944, 9039, 9345, 9603, 9787, 9883, 10715, 11116, 12040, 12443, 12664, 13314, 13950, 14700, 15463, 16233, 16333, 17643, 17743, 17843]","[1, 510, 600, 735, 1003, 1217, 1402, 1538, 1797, 1887, 2245, 2810, 2949, 3043, 3292, 3851, 4281, 4464, 4932, 5281, 6085, 6180, 6347, 6442, 6626, 6793, 6888, 7252, 7555, 7651, 7747, 7990, 8530, 8720, 8883, 9104, 9439, 9638, 9738, 9884, 10118, 10478, 10615, 10997, 11097]",29506,22808,20823,17843,11097,3462,2334,1307,221,4592,11916,45,radiant
7600037606,4,129,126,31,27,"[0, 287, 666, 1028, 1313, 1533, 1794, 2239, 2526, 3291, 3771, 4161, 4730, 5238, 5709, 6577, 7596, 8514, 9382, 10283, 11038, 12222, 13039, 14012, 14836, 15340, 16097, 16297, 16447, 17323, 17840, 18230, 18788, 19745, 20405, 21118, 22051, 22935, 23849, 24430, 25344, 26371, 27443, 27866, 28387]","[0, 217, 739, 967, 1410, 1609, 2030, 2542, 2833, 3250, 3826, 4502, 5030, 5472, 6210, 6668, 7176, 7437, 7705, 8551, 9223, 9538, 10456, 11260, 11895, 12742, 13208, 13621, 14195, 14439, 15046, 15794, 16167, 16840, 17730, 18463, 18864, 20449, 20549, 21337, 22693, 23137, 24039, 24666, 25127]","[0, 362, 565, 788, 1202, 1488, 1945, 2523, 2905, 3571, 3751, 4395, 4700, 5489, 6128, 6623, 6922, 7297, 7630, 8180, 8678, 8773, 9271, 9920, 10208, 10530, 10760, 10960, 11273, 11706, 12374, 12880, 13621, 14153, 14630, 15079, 15564, 16389, 16905, 17311, 18234, 18473, 18573, 19188, 19503]","[0, 169, 329, 419, 509, 600, 739, 930, 1020, 1349, 1529, 1854, 2348, 2443, 2678, 2911, 3276, 3481, 3793, 4380, 4518, 4688, 5341, 6018, 6222, 6574, 6879, 7154, 7542, 8009, 8246, 8789, 9191, 9595, 9860, 10125, 10410, 11371, 11592, 11940, 12373, 12808, 13043, 13413, 13631]","[0, 169, 326, 416, 599, 689, 824, 1049, 1139, 1383, 1563, 1861, 2187, 2282, 2517, 3028, 3347, 3500, 3925, 4285, 4427, 4522, 4914, 5008, 5103, 5951, 6181, 6275, 6371, 6548, 6644, 7198, 7335, 7435, 7625, 7815, 8025, 8125, 8270, 8505, 8803, 8903, 9003, 9103, 9203]",28387,25127,19503,13631,9203,34,41,96,110,86,"[0, 243, 583, 967, 1251, 1511, 2013, 2257, 2664, 3024, 3759, 4010, 4315, 5173, 5894, 6464, 6841, 7291, 7483, 7819, 8155, 8400, 8741, 8835, 9553, 10485, 11194, 12389, 12663, 13196, 13925, 14920, 16318, 17214, 17920, 18454, 19029, 19675, 20705, 21559, 22637, 22984, 23406, 24722, 25226]","[0, 207, 493, 829, 1188, 1508, 1666, 2063, 2465, 2748, 3199, 3435, 4017, 4525, 5277, 5936, 6589, 7183, 7778, 8278, 9075, 9642, 10013, 10894, 11510, 12275, 12786, 14136, 14595, 15087, 15504, 16352, 17412, 18181, 18959, 20018, 20737, 20910, 21010, 21558, 22100, 22763, 23405, 23991, 24326]","[0, 207, 861, 1138, 1637, 2002, 2324, 2632, 3261, 3657, 4106, 4600, 5400, 6044, 6398, 7529, 8278, 8856, 9286, 9707, 10137, 10700, 11373, 11467, 11562, 11833, 11967, 13394, 13632, 13820, 14244, 14941, 15767, 16260, 16698, 17035, 17542, 18035, 18135, 18922, 19464, 19928, 20343, 21019, 21774]","[0, 169, 259, 426, 574, 710, 848, 938, 1073, 1236, 1581, 1671, 1846, 2088, 2731, 3054, 3376, 3832, 4265, 4748, 5092, 5314, 5501, 5888, 6271, 6456, 6760, 7734, 7914, 8204, 8300, 9247, 9790, 10098, 10372, 11045, 11145, 11460, 11720, 12373, 12832, 13592, 14336, 14741, 15321]","[0, 169, 336, 426, 652, 795, 885, 975, 1284, 1447, 1898, 2032, 2675, 3136, 3676, 3999, 4367, 4618, 4767, 5274, 5369, 5464, 5651, 5745, 6232, 6417, 6750, 7632, 8023, 8519, 8829, 9292, 9752, 10188, 10398, 10885, 11040, 11708, 12155, 12841, 13327, 13427, 13527, 13842, 14067]",25226,24326,21774,15321,14067,3161,801,-2271,-1690,-4864,-4863,45,radiant
7601831103,10,76,96,53,100,"[0, 239, 566, 844, 1128, 1530, 1735, 2282, 2849, 3591, 4023, 4741, 5483, 6039, 6454, 6820, 7735, 8297, 8713, 10640, 11397, 12847, 14018, 14562, 14974, 15250, 16381, 17321, 17747, 19278, 20305, 22782, 23271, 24737, 25584, 25838, 26058, 27628, 28739, 29461, 31074, 32537, 33441, 33950, 35421]","[0, 207, 455, 737, 991, 1403, 1727, 2135, 2350, 3308, 3555, 3788, 3950, 4614, 5350, 5653, 6366, 6803, 7122, 7571, 7942, 8299, 8803, 9061, 9543, 9768, 10714, 10809, 11981, 12511, 13393, 14263, 14993, 15632, 16959, 17344, 17517, 18990, 19610, 19909, 21063, 21936, 22517, 22896, 23947]","[0, 170, 368, 732, 1195, 1406, 1694, 2111, 2492, 2848, 3285, 3605, 3951, 4923, 5273, 5685, 6186, 6527, 6755, 7577, 7782, 8245, 9011, 9307, 9648, 10796, 11324, 11691, 12450, 13197, 13771, 14594, 14852, 15459, 16064, 16339, 16478, 16652, 17326, 17553, 18986, 20039, 20488, 20847, 22183]","[0, 170, 260, 394, 528, 864, 1226, 1449, 1539, 1752, 1842, 2074, 2369, 2765, 2984, 3235, 3456, 3751, 4136, 4934, 5115, 5828, 6213, 6673, 7702, 7797, 8542, 9366, 10363, 10630, 11700, 12155, 13058, 14101, 14962, 15438, 15760, 17126, 17984, 18141, 18996, 20059, 20388, 20669, 21619]","[0, 170, 260, 350, 478, 695, 785, 1066, 1156, 1381, 1471, 1561, 1785, 2144, 2363, 2494, 2803, 2898, 3160, 3691, 3965, 4305, 4543, 4638, 5171, 5677, 6177, 6772, 7237, 7718, 8330, 9036, 9249, 9610, 10150, 10250, 10350, 11029, 11622, 11722, 12081, 12835, 13201, 13466, 14508]",35421,23947,22183,21619,14508,48,137,43,123,21,"[0, 205, 748, 980, 1220, 1680, 2199, 2686, 3173, 3401, 3929, 4577, 5392, 5542, 6821, 7316, 8169, 9274, 10584, 11505, 12584, 13702, 14382, 15171, 16790, 17789, 18871, 20345, 20989, 21585, 22282, 23162, 23262, 23406, 24434, 26426, 27965, 28065, 28165, 29284, 29772, 29872, 30326, 30920, 31737]","[0, 243, 577, 919, 1196, 1532, 1843, 2595, 3233, 3622, 4136, 4423, 5563, 5771, 6420, 7383, 8069, 8421, 8830, 9694, 9862, 10207, 10471, 11115, 11514, 12585, 13168, 13467, 14112, 14571, 15031, 15574, 16195, 16341, 17301, 18346, 19038, 19643, 20020, 20651, 21234, 21334, 21995, 22751, 23114]","[0, 207, 467, 756, 1082, 1461, 1865, 2028, 2676, 2923, 3512, 3813, 4204, 4646, 5465, 6061, 6846, 7817, 8481, 8639, 9268, 9495, 9589, 10048, 11212, 12326, 12984, 13851, 14028, 14375, 14508, 14608, 15110, 15634, 16328, 17639, 18462, 18562, 18662, 19082, 19636, 19866, 19990, 20482, 21115]","[0, 170, 309, 399, 519, 920, 1089, 1507, 1940, 2157, 2842, 3001, 3502, 3870, 4701, 5125, 5793, 6058, 6214, 6930, 7428, 7926, 8020, 8428, 9637, 10097, 10576, 12046, 12563, 12882, 13265, 13365, 13850, 14058, 14796, 15717, 16498, 16807, 17659, 18598, 19007, 19107, 19549, 20009, 20375]","[0, 170, 319, 409, 575, 700, 1054, 1144, 1346, 1475, 1733, 1877, 2191, 2656, 3407, 3556, 3714, 4156, 4482, 4911, 5006, 5101, 5195, 5470, 6131, 6578, 6865, 7506, 8175, 8271, 8383, 8978, 9213, 9357, 9769, 10970, 11967, 12155, 12811, 13231, 13537, 13669, 13901, 14136, 14416]",31737,23114,21115,20375,14416,3684,833,1068,1244,92,6921,45,radiant
7605720616,120,129,114,40,26,"[0, 326, 689, 1013, 1347, 1862, 2191, 2559, 3048, 3462, 3949, 4329, 4802, 5378, 5981, 6244, 6787, 7294, 8148, 9229, 9712, 10143, 10609, 10806, 11199, 12016, 12323, 13144, 13316, 13905, 14483, 14884, 15726, 16476, 17113, 17562, 18259, 19571, 20215, 21395, 22231, 22523, 23273, 23674, 23936]","[0, 284, 651, 1016, 1230, 1796, 2202, 2620, 3136, 3794, 4351, 4865, 5337, 6049, 6344, 6438, 7150, 7498, 7843, 8733, 9210, 9597, 10042, 10239, 10334, 10501, 11065, 12015, 12538, 13044, 13340, 13551, 15028, 15128, 15896, 16748, 17726, 18723, 19640, 20577, 20818, 21030, 21285, 21548, 21953]","[0, 289, 456, 828, 1234, 1474, 1740, 2226, 2586, 3071, 3466, 3835, 4140, 4943, 5274, 5719, 6662, 7424, 7685, 8342, 8914, 9610, 10120, 10317, 10597, 10764, 10978, 11787, 11986, 12321, 12517, 13143, 14147, 14513, 15338, 16150, 16940, 17239, 17869, 18601, 19202, 19862, 20571, 20966, 21066]","[0, 169, 259, 399, 489, 619, 831, 1398, 1488, 1681, 1816, 1953, 2043, 2346, 2514, 2608, 3141, 3326, 3451, 4227, 4515, 4668, 5154, 5595, 5794, 6380, 6761, 7484, 7655, 8043, 8480, 8684, 9993, 10226, 10722, 11117, 11691, 12111, 12728, 13241, 13621, 13789, 14071, 14279, 14379]","[0, 169, 259, 349, 524, 745, 835, 974, 1064, 1448, 1629, 1729, 1819, 2102, 2235, 2377, 3096, 3325, 3540, 3904, 4257, 4762, 5532, 5804, 5974, 6216, 6386, 6555, 6726, 7290, 7386, 7486, 7892, 8563, 8976, 9076, 9852, 10345, 11109, 11564, 11973, 12073, 12173, 12381, 12481]",23936,21953,21066,14379,12481,73,43,137,19,121,"[0, 330, 663, 1098, 1528, 1658, 2058, 2703, 3600, 3952, 4307, 4998, 5824, 6732, 7551, 7943, 8937, 10654, 11336, 11928, 12566, 13456, 14367, 15821, 17216, 18288, 19826, 21741, 23169, 23559, 24327, 24980, 26267, 27262, 27981, 28701, 29321, 30584, 31234, 32063, 32269, 33244, 33765, 34626, 35585]","[0, 203, 735, 1122, 1680, 2061, 2477, 2952, 3404, 4168, 4563, 5036, 6179, 6509, 7090, 7744, 7975, 8133, 9182, 9734, 10256, 10722, 11757, 13267, 13902, 14159, 14998, 16248, 16968, 17948, 18449, 19316, 19775, 19983, 20308, 21184, 21963, 23097, 23838, 24276, 24824, 25585, 26023, 27892, 29153]","[0, 333, 702, 1064, 1343, 1695, 2148, 2558, 3006, 3242, 3760, 4434, 5176, 5921, 6302, 6497, 6871, 7462, 7909, 8561, 9087, 9682, 9958, 11094, 11722, 12472, 13043, 14043, 14220, 14525, 15070, 15419, 16994, 17301, 17726, 17980, 18697, 19203, 19402, 19592, 19692, 20010, 20373, 21373, 22619]","[0, 169, 324, 414, 675, 765, 855, 1184, 1324, 1767, 1966, 2165, 2588, 2885, 3131, 3421, 3516, 3952, 4459, 4769, 5203, 5463, 5824, 6660, 7234, 7629, 8055, 8736, 9003, 9203, 10004, 10311, 11133, 11372, 11697, 12081, 12379, 12885, 13084, 13274, 13632, 14024, 14563, 15074, 15755]","[0, 169, 298, 501, 746, 853, 1051, 1445, 1585, 1725, 1859, 2003, 2401, 2837, 3026, 3221, 3316, 3942, 4205, 4417, 4798, 4992, 5306, 5879, 6049, 6753, 7258, 7709, 8020, 8429, 8825, 9071, 9912, 10164, 10489, 10721, 11164, 11670, 11985, 12175, 12275, 12485, 12728, 13759, 14402]",35585,29153,22619,15755,14402,-11649,-7200,-1553,-1376,-1921,-23699,45,dire
7606260002,73,21,28,45,26,"[0, 366, 833, 1212, 1631, 2058, 2379, 3066, 3338, 3772, 4976, 5667, 6517, 7868, 8460, 9172, 9648, 11106, 12452, 12932, 13842, 14862, 15886, 16405, 17852, 18685, 19936, 21950, 23217, 24239, 25463, 26203, 26407, 26507, 28022, 29199, 30616, 32076, 33070, 33340, 33903, 34756, 35589, 36883, 37820]","[0, 260, 591, 1000, 1708, 2038, 2467, 2557, 3314, 4208, 4779, 5686, 6178, 6736, 7257, 7643, 8086, 8346, 9424, 9827, 10165, 10490, 11034, 11797, 12419, 13360, 13536, 14649, 15290, 15941, 16680, 17045, 17528, 18485, 18585, 19654, 20189, 22150, 22848, 23118, 23218, 23940, 25018, 25374, 26142]","[0, 369, 497, 972, 1319, 1611, 1990, 2151, 2432, 2649, 3085, 3669, 4016, 4662, 5158, 5572, 6139, 6365, 6710, 7180, 7671, 7818, 8048, 8376, 8686, 9617, 9991, 10417, 10594, 11005, 11511, 11746, 11950, 12565, 13325, 13892, 14295, 14986, 15244, 15514, 15903, 16802, 18049, 18612, 18712]","[0, 364, 454, 544, 681, 771, 1131, 1337, 1427, 1945, 2463, 2706, 3171, 3904, 4279, 4595, 4831, 5006, 5270, 5864, 6031, 6524, 7027, 7194, 7335, 7786, 8362, 8970, 9147, 9474, 10095, 10628, 10832, 11444, 11770, 12464, 12610, 13012, 13364, 13634, 13848, 14475, 15155, 15512, 15869]","[0, 210, 344, 434, 572, 708, 798, 937, 1340, 1677, 2204, 2702, 2888, 3138, 3415, 3817, 4199, 4632, 4922, 5283, 5432, 6287, 6742, 6924, 7018, 7713, 7889, 8258, 8481, 8621, 8876, 9066, 9496, 10557, 10657, 11351, 11451, 11696, 11906, 12469, 12878, 13613, 14436, 14915, 15273]",37820,26142,18712,15869,15273,98,15,106,65,83,"[0, 503, 830, 1131, 1452, 1652, 2019, 2487, 3053, 3600, 4069, 4691, 5136, 5816, 6259, 6750, 7468, 8475, 9111, 10536, 11092, 12477, 12806, 14066, 14953, 16029, 16737, 17891, 18698, 18985, 19346, 20019, 22085, 23358, 23548, 23696, 24209, 24969, 26593, 27772, 28571, 29664, 30587, 30951, 31893]","[0, 198, 420, 630, 765, 1002, 1328, 1577, 2048, 2471, 2852, 3268, 3433, 3863, 4225, 4541, 4848, 5875, 6263, 6786, 7762, 8313, 9212, 9885, 10359, 11666, 11853, 12410, 12506, 12769, 13084, 13638, 15124, 16452, 17031, 18718, 19466, 19764, 20953, 22735, 23539, 24588, 24688, 24928, 26273]","[0, 322, 572, 1034, 1159, 1531, 2019, 2614, 3345, 3509, 4136, 4646, 5029, 5473, 5622, 5858, 6296, 7269, 7534, 7813, 8253, 8761, 9708, 10350, 11337, 11504, 11934, 12573, 12983, 13549, 14574, 14993, 15513, 15881, 16071, 16746, 16846, 17561, 18371, 19120, 20026, 20639, 20739, 21125, 21478]","[0, 198, 288, 412, 825, 955, 1568, 1835, 1973, 2063, 2312, 2678, 2942, 3281, 3790, 4515, 4909, 5498, 5593, 6047, 6433, 7326, 7655, 8267, 8994, 9418, 9513, 9832, 10591, 11200, 11570, 11956, 13124, 13881, 14584, 14864, 15320, 16013, 16281, 17069, 18246, 18747, 18847, 19269, 19754]","[0, 198, 288, 423, 513, 643, 733, 880, 1288, 1421, 1654, 1834, 2054, 2317, 2601, 2696, 2853, 3187, 3282, 3592, 3749, 4364, 4740, 4962, 5360, 5799, 5952, 6733, 7040, 7217, 7313, 7503, 8247, 8602, 8792, 9736, 9908, 10206, 10852, 12086, 12418, 12518, 12882, 12982, 13467]",31893,26273,21478,19754,13467,5927,-131,-2766,-3885,1806,951,45,dire
7606980009,67,36,20,53,105,"[0, 169, 575, 894, 1286, 1491, 1878, 2292, 2751, 3011, 3469, 3643, 4603, 5029, 5568, 6135, 6638, 6989, 7564, 7991, 9606, 10023, 11394, 12223, 12895, 13393, 14606, 15463, 16753, 17373, 17469, 17951, 18896, 19703, 20589, 21217, 23010, 23666, 24084, 25479, 26358, 27473, 27573, 29423, 31074]","[0, 165, 456, 775, 1022, 1146, 1307, 1561, 1651, 2248, 2447, 3154, 3904, 4211, 4931, 6282, 6961, 7741, 8050, 8145, 8615, 9122, 9841, 10316, 10457, 10949, 11472, 12076, 13038, 13440, 14086, 14479, 15079, 16463, 16852, 17771, 19387, 19943, 20409, 20822, 21265, 21516, 22895, 23765, 23865]","[0, 242, 549, 825, 1328, 1759, 1957, 2554, 2778, 3083, 3306, 3568, 4133, 4227, 5083, 5756, 5878, 6459, 6868, 7485, 8269, 8539, 9335, 9607, 9702, 10153, 10577, 10820, 11497, 11963, 12454, 13230, 13898, 14511, 15050, 15376, 15476, 16280, 16547, 16767, 17048, 17196, 20039, 20453, 20614]","[0, 130, 220, 465, 677, 811, 1150, 1471, 1605, 1695, 1868, 2292, 2644, 2821, 3453, 3829, 4086, 4281, 4905, 5000, 6267, 6537, 6796, 7027, 7663, 8075, 8605, 9282, 9869, 10004, 10100, 10223, 10628, 11113, 11382, 11798, 13283, 13920, 14020, 14276, 14810, 15561, 16299, 17257, 17357]","[0, 130, 586, 713, 1262, 1598, 1722, 2440, 2594, 2763, 2853, 2943, 3510, 3719, 4115, 4682, 4777, 4871, 5102, 5447, 6207, 6328, 6498, 6668, 6838, 7332, 7998, 8168, 9285, 9555, 9898, 10073, 10570, 11018, 11193, 12057, 13716, 13990, 14165, 14860, 15222, 15540, 17002, 17356, 17456]",31074,23865,20614,17357,17456,43,21,92,19,100,"[0, 374, 820, 1073, 1562, 2201, 2550, 3216, 4002, 4379, 4938, 5532, 5914, 6859, 7317, 7566, 8137, 9548, 10869, 11485, 11690, 12614, 12934, 13658, 14637, 15919, 16964, 17375, 17999, 18095, 18892, 19547, 20322, 20766, 21236, 21885, 21985, 22156, 22859, 23922, 24637, 25385, 26135, 26235, 27516]","[0, 267, 567, 783, 1069, 1159, 1625, 1817, 2466, 2889, 3772, 4202, 4852, 5634, 6405, 7001, 7783, 8596, 10015, 10407, 10612, 11044, 11557, 12739, 13757, 14289, 15590, 16196, 17256, 17352, 18277, 19168, 19501, 19641, 20461, 21394, 21943, 22043, 23020, 24084, 24635, 25224, 25388, 27152, 27252]","[0, 305, 593, 863, 1173, 1592, 1977, 2366, 2672, 3050, 3628, 4350, 5052, 5692, 6038, 6395, 7292, 7585, 8240, 9018, 9715, 10808, 11162, 11659, 12039, 12779, 13378, 13554, 13776, 14202, 14553, 15194, 16064, 16339, 17261, 18011, 18299, 18580, 19667, 20728, 21096, 23089, 23487, 23587, 24649]","[0, 246, 373, 463, 597, 807, 1027, 1117, 1333, 1778, 2158, 2649, 2778, 3095, 3319, 3753, 4576, 4900, 5657, 6016, 6221, 6682, 7141, 7864, 8450, 8802, 9527, 10081, 10258, 10451, 10819, 11242, 11773, 12601, 13217, 13694, 13982, 14926, 15634, 16444, 16993, 17610, 17930, 18030, 18854]","[0, 636, 1020, 1205, 1295, 1385, 2076, 2166, 2465, 2665, 3236, 3604, 3694, 4066, 4471, 4620, 5221, 5598, 6254, 6412, 6689, 7691, 8163, 9093, 9612, 10128, 10726, 11268, 11653, 11749, 12190, 12603, 12793, 12893, 13218, 13712, 13812, 13990, 14494, 15074, 15530, 16090, 16433, 16999, 17750]",27516,27252,24649,18854,17750,3558,-3387,-4035,-1497,-294,-5655,45,radiant
7607899304,129,22,41,105,112,"[0, 210, 542, 788, 1343, 1589, 1897, 2379, 2625, 3014, 3397, 3637, 4064, 4494, 4912, 5426, 6362, 6794, 7597, 8036, 8609, 9394, 10483, 11519, 11972, 13051, 14548, 15031, 15703, 16720, 17616, 18995, 19673, 20594, 21842, 22186, 22286, 22662, 23122, 23791, 24666, 24974, 25448, 27225, 28186]","[0, 333, 753, 1163, 1451, 1947, 2683, 2945, 3471, 4176, 4655, 5502, 6065, 7261, 7669, 8328, 8704, 8951, 9468, 10110, 10883, 11645, 12884, 13559, 14489, 14995, 15665, 16200, 16697, 17591, 18439, 18853, 19437, 19863, 20564, 21150, 22741, 23816, 24382, 24706, 25225, 25927, 26115, 27323, 28637]","[0, 217, 620, 865, 1171, 1497, 1825, 2496, 2813, 3486, 3812, 4089, 4624, 5372, 5687, 5945, 6437, 7010, 7439, 7791, 8163, 8594, 10382, 11246, 11808, 12880, 13753, 14181, 14958, 15690, 16159, 16259, 16667, 17155, 17674, 18312, 19988, 20088, 20505, 21267, 21867, 22390, 22714, 23956, 25648]","[0, 170, 260, 350, 480, 617, 833, 1230, 1320, 1805, 1940, 2287, 2695, 2951, 3506, 3601, 3822, 3917, 4550, 4820, 5263, 5537, 5758, 6214, 6672, 7072, 7628, 7784, 8061, 8401, 8804, 8928, 9073, 9427, 10053, 10153, 12466, 13247, 13347, 13858, 14253, 14505, 14712, 16029, 16627]","[0, 170, 260, 350, 572, 662, 966, 1101, 1191, 1843, 1978, 2176, 2362, 2607, 2878, 3071, 3413, 3642, 3848, 3943, 4185, 4280, 4374, 4913, 5168, 5734, 6000, 6095, 6375, 6623, 6891, 6991, 7091, 7344, 7444, 7616, 8526, 8626, 8726, 9014, 9312, 9664, 9764, 10281, 10491]",28186,28637,25648,16627,10491,49,45,32,21,37,"[0, 218, 521, 1122, 1571, 2022, 2586, 3124, 3619, 3867, 4258, 5094, 5693, 6100, 6414, 7389, 7962, 8673, 9792, 10189, 11053, 11359, 11834, 11929, 13155, 13805, 15044, 15364, 16138, 16592, 17141, 17933, 18949, 19839, 21141, 22070, 22630, 22829, 23403, 23731, 24877, 25423, 25828, 26618, 27985]","[0, 254, 502, 873, 1199, 1541, 1960, 2406, 3112, 3293, 3624, 4195, 4664, 4922, 5475, 5980, 6637, 7396, 8694, 9685, 10175, 11058, 11714, 11809, 12506, 12824, 13836, 14407, 14851, 15498, 16200, 16942, 17479, 18207, 18802, 19534, 20826, 21410, 22172, 22815, 23174, 23707, 24834, 25189, 25289]","[0, 279, 548, 684, 890, 1307, 1604, 1929, 2534, 2850, 3352, 3697, 4066, 4247, 4801, 5421, 5840, 6401, 6582, 7135, 7569, 8340, 8514, 8867, 9405, 9629, 10693, 11153, 11934, 12324, 13092, 13552, 14697, 16037, 17153, 17343, 18058, 18257, 18923, 19572, 20258, 20892, 21296, 21504, 21604]","[0, 518, 608, 867, 1020, 1202, 1508, 1775, 1865, 2087, 2428, 2608, 2783, 3214, 3308, 3485, 3905, 4196, 4701, 5486, 5850, 6168, 6539, 7063, 7591, 7954, 9125, 9713, 10291, 10468, 11318, 11543, 11885, 12514, 12832, 13401, 14052, 14251, 14904, 15289, 15873, 16204, 16304, 16547, 16647]","[0, 170, 260, 350, 730, 865, 1002, 1137, 1528, 1755, 2085, 2544, 2781, 2941, 3139, 3398, 3641, 3882, 4569, 4961, 5146, 5613, 6098, 6193, 6481, 6575, 7499, 7729, 9003, 9560, 9978, 10372, 10562, 10993, 11183, 11611, 12459, 12658, 12758, 13199, 13578, 13854, 13954, 14340, 14440]",27985,25289,21604,16647,14440,201,3348,4044,-20,-3949,3624,45,radiant
7608021100,52,93,129,9,112,"[0, 289, 577, 950, 1285, 2007, 2382, 3007, 3309, 3616, 4105, 4633, 5595, 6679, 7031, 7449, 8326, 8902, 9623, 10280, 11291, 11899, 12422, 13102, 13734, 14307, 14881, 16269, 17029, 17210, 17909, 18683, 18871, 20080, 20937, 21494, 22331, 23357, 25308, 26224, 27921, 28472, 29182, 30378, 30795]","[0, 286, 605, 821, 985, 1453, 1902, 2291, 2861, 3349, 3695, 4370, 5065, 5707, 6159, 6760, 7002, 7500, 8203, 8931, 9579, 9923, 10636, 11550, 12386, 13312, 13782, 14357, 15140, 15827, 16827, 17735, 18304, 19629, 19954, 20658, 21319, 22067, 23063, 24313, 25188, 25875, 26153, 26253, 27222]","[0, 283, 531, 807, 1122, 1412, 1695, 1996, 2365, 2869, 3336, 3848, 4588, 5128, 5859, 6227, 6939, 7559, 8065, 8707, 9050, 9714, 10636, 11212, 12054, 12501, 12733, 13647, 15038, 15527, 16282, 17279, 17379, 18872, 19757, 20396, 20666, 21413, 22784, 24006, 24570, 25132, 25566, 25666, 25766]","[0, 222, 361, 555, 741, 1062, 1214, 1502, 1592, 1682, 1868, 2297, 2604, 3122, 3498, 3593, 3913, 4059, 4372, 4666, 4930, 5024, 5737, 5965, 6060, 6390, 6609, 7602, 8056, 8346, 9179, 9457, 9645, 10549, 10971, 11119, 11219, 11418, 11989, 12906, 13419, 13747, 13847, 14325, 14425]","[100, 270, 404, 494, 584, 767, 857, 947, 1109, 1199, 1455, 1703, 1996, 2427, 2686, 2781, 3118, 3454, 3548, 3781, 4305, 4399, 4494, 4661, 5091, 5327, 5713, 6292, 6768, 6949, 8038, 8448, 8548, 9169, 9822, 10228, 10328, 11297, 11942, 12042, 12532, 13124, 13224, 13595, 13695]",30795,27222,25766,14425,13695,48,106,97,123,105,"[0, 251, 654, 1021, 1473, 2091, 2457, 3008, 3604, 4108, 4830, 5463, 6136, 6599, 7079, 8030, 9544, 10496, 11289, 12028, 13593, 14590, 15369, 16517, 17577, 18607, 19802, 20403, 20823, 21636, 21732, 22927, 23640, 25490, 25590, 26513, 27105, 28060, 28943, 29964, 30710, 31899, 33478, 33988, 34123]","[0, 324, 539, 986, 1279, 1602, 1856, 2109, 2684, 3207, 3677, 3871, 4362, 4885, 5421, 5887, 6285, 7065, 7272, 7762, 8599, 8911, 9473, 9813, 10510, 11014, 11424, 11786, 11882, 12382, 12531, 13086, 13609, 13966, 14954, 15674, 16403, 17135, 17765, 18039, 18139, 18452, 19093, 19503, 19603]","[0, 278, 602, 972, 1381, 1711, 1992, 2519, 3018, 3594, 4164, 4866, 5725, 5921, 6471, 6716, 7422, 7750, 8150, 8417, 8879, 9632, 10468, 10766, 11311, 11560, 12039, 12355, 12769, 13455, 13551, 13853, 14358, 14715, 14815, 15280, 15837, 16022, 16200, 16350, 16450, 16763, 17482, 17582, 17682]","[0, 170, 310, 430, 560, 688, 826, 1068, 1346, 1575, 1710, 1865, 2198, 2552, 2819, 3013, 3616, 3892, 4111, 4434, 5003, 5356, 6090, 6466, 6899, 7341, 7671, 8100, 8498, 8837, 8933, 9170, 9401, 9501, 9688, 10193, 10468, 11011, 11431, 11531, 12076, 12491, 13116, 13216, 13316]","[0, 170, 260, 380, 555, 764, 854, 1036, 1194, 1397, 1532, 1676, 1805, 1915, 2226, 2321, 2695, 2790, 2977, 3259, 3574, 3668, 3970, 4175, 4460, 4712, 5161, 5451, 5798, 6021, 6117, 6307, 6455, 6849, 6949, 7049, 7149, 7249, 7349, 7449, 7588, 7901, 8303, 8403, 8503]",34123,19603,17682,13316,8503,-3328,7619,8084,1109,5192,18676,45,radiant
7608734818,94,90,129,9,26,"[0, 243, 482, 740, 915, 1222, 1750, 2242, 2658, 3161, 3660, 3950, 4537, 5265, 5946, 6541, 7235, 8077, 8728, 9251, 9789, 10596, 11870, 12479, 12984, 13271, 14227, 14614, 15579, 16137, 16668, 17294, 18406, 19349, 19975, 21036, 21413, 22492, 23537, 23875, 24727, 25487, 26022, 26735, 26900]","[0, 289, 615, 1144, 1403, 1951, 2623, 2919, 3483, 3842, 4775, 5161, 5712, 6330, 7063, 7674, 8265, 9157, 9872, 10551, 10808, 11017, 11596, 11927, 12177, 12591, 13354, 14004, 14352, 15000, 15516, 16605, 17591, 18125, 18520, 19357, 19826, 20787, 21341, 21559, 22073, 22866, 23444, 24386, 25453]","[0, 254, 578, 792, 1276, 1527, 1757, 2204, 2412, 2799, 3151, 3758, 4353, 4851, 5183, 5539, 5912, 6826, 7363, 7934, 8519, 8935, 9731, 9989, 10479, 10850, 11048, 11426, 11522, 11901, 12097, 13165, 13632, 13732, 14189, 14652, 15242, 15683, 16321, 17587, 18445, 18867, 19875, 20311, 20632]","[0, 218, 357, 909, 1076, 1166, 1446, 1941, 2072, 2741, 3528, 3678, 3961, 4187, 4602, 4886, 5028, 5466, 6063, 6479, 6906, 7203, 7621, 7806, 8011, 8106, 8482, 8822, 9049, 9362, 9675, 10480, 10862, 11200, 11300, 12047, 12407, 13227, 13532, 13950, 14425, 14525, 15232, 16229, 16329]","[0, 170, 332, 422, 600, 690, 780, 1088, 1178, 1478, 1871, 1961, 2141, 2290, 2578, 2727, 2911, 3456, 3738, 3958, 4053, 4243, 4455, 4550, 4755, 4964, 5058, 5443, 5539, 5635, 5731, 6089, 6471, 6571, 6706, 7004, 7347, 7725, 8109, 8209, 8643, 9038, 9427, 9863, 9963]",26900,25453,20632,16329,9963,95,106,96,105,21,"[0, 229, 527, 1004, 1203, 1694, 2010, 2205, 2778, 3276, 3839, 4172, 5019, 5463, 6161, 7164, 8147, 8984, 9926, 10719, 11653, 12785, 13643, 14450, 16000, 16824, 17787, 18613, 19500, 20640, 21265, 21643, 21779, 22940, 23978, 24786, 26353, 27600, 28110, 28901, 29965, 30445, 30629, 31995, 33390]","[0, 232, 502, 869, 1357, 1647, 2101, 2510, 2922, 3664, 4175, 4590, 5168, 5429, 5864, 6351, 6877, 7017, 7762, 8061, 8956, 9556, 10029, 10575, 11445, 12365, 13107, 13331, 13735, 14104, 14455, 14845, 15216, 16598, 17260, 17666, 18487, 18686, 19119, 19383, 19815, 20511, 20839, 22602, 23622]","[0, 232, 592, 916, 1276, 1559, 1937, 2351, 2635, 3060, 3375, 3866, 4386, 4638, 4948, 5546, 5767, 6331, 7230, 7324, 8036, 8705, 9397, 9816, 10526, 11110, 11650, 12274, 13015, 13485, 13732, 15046, 15498, 16158, 17080, 17180, 17390, 18524, 18918, 19216, 19755, 20380, 20951, 22312, 22745]","[0, 195, 285, 419, 509, 689, 824, 950, 1186, 1723, 1963, 2138, 2326, 2566, 2958, 3344, 3586, 3726, 4250, 4344, 4692, 5106, 5824, 6153, 6666, 7521, 7861, 8658, 9086, 9551, 9860, 10125, 10667, 11970, 12766, 12941, 13685, 13959, 14134, 14309, 14552, 14698, 14798, 15552, 16701]","[0, 246, 336, 683, 819, 909, 1128, 1218, 1426, 1713, 2036, 2155, 2346, 2588, 2817, 3605, 3826, 4301, 4795, 5287, 5688, 6174, 6762, 7213, 8011, 8587, 8953, 9263, 9567, 10028, 10316, 10877, 11059, 11681, 12397, 12497, 13092, 13291, 13500, 13807, 14191, 14469, 14691, 15445, 15961]",33390,23622,22745,16701,15961,-6490,1831,-2113,-372,-5998,-13142,45,radiant
7609245218,95,15,52,19,9,"[0, 216, 644, 993, 1243, 1413, 1744, 2039, 2341, 2738, 3173, 4032, 4367, 5068, 5523, 6195, 6770, 7261, 7987, 8891, 9546, 10103, 10614, 11234, 12110, 12936, 13562, 13925, 14485, 15445, 16139, 16528, 16628, 17312, 18402, 19202, 20215, 20570, 20670, 21473, 22247, 22531, 22947, 23221, 23962]","[0, 206, 435, 683, 877, 1273, 1923, 2391, 2737, 3245, 3678, 4031, 4631, 5532, 5908, 6003, 6645, 7328, 7535, 8136, 8617, 9265, 9549, 9644, 10182, 11040, 11848, 12576, 12884, 13661, 14148, 14587, 15628, 16950, 17348, 17819, 18552, 18819, 18919, 19700, 20253, 20475, 20637, 20972, 21699]","[0, 254, 631, 998, 1244, 1647, 2213, 2393, 2717, 3254, 3888, 4448, 4971, 5760, 6247, 6703, 7590, 7829, 8128, 8708, 9295, 9886, 10538, 10843, 11024, 11745, 11840, 12396, 13066, 13902, 14524, 14867, 14967, 15238, 15428, 16084, 16350, 16644, 16976, 17076, 17773, 18436, 19284, 20019, 20855]","[0, 234, 349, 439, 576, 794, 977, 1237, 1560, 1688, 2417, 2612, 2990, 3632, 3944, 4206, 4605, 4814, 5017, 5294, 5388, 6367, 6896, 7309, 7524, 8591, 8733, 8828, 9225, 9585, 9796, 9996, 10775, 11361, 11599, 11699, 11939, 12039, 12524, 13254, 13540, 13640, 13776, 14021, 14222]","[0, 502, 617, 755, 879, 1049, 1339, 1683, 1857, 2109, 2624, 2804, 3132, 3852, 4067, 4605, 5008, 5408, 5923, 6439, 6644, 7108, 7203, 7488, 7834, 8055, 8150, 8427, 8587, 9154, 9302, 9520, 10095, 10671, 10885, 11299, 11645, 11990, 12090, 13198, 13298, 13744, 13844, 14059, 14159]",23962,21699,20855,14222,14159,18,13,65,53,51,"[0, 245, 490, 680, 1168, 1258, 1531, 1704, 2024, 2438, 2988, 3836, 4418, 4862, 5919, 6543, 6791, 7660, 8896, 9781, 10780, 11279, 12325, 13059, 14081, 15181, 15980, 17910, 18618, 18876, 19408, 20195, 21309, 21867, 23039, 24162, 25102, 26206, 28057, 29079, 29797, 30844, 31611, 32677, 34201]","[0, 297, 546, 990, 1286, 1660, 2029, 2534, 2817, 3243, 3646, 3893, 4458, 4831, 5613, 6405, 6727, 7396, 7874, 8513, 9118, 9600, 10496, 11354, 12095, 12668, 13658, 14353, 14984, 15626, 15934, 16807, 17303, 17653, 18377, 19126, 20024, 20687, 22108, 22696, 23523, 24213, 24429, 25203, 26093]","[0, 329, 619, 905, 1187, 1935, 2192, 2596, 2851, 3200, 3371, 4137, 4292, 4666, 5370, 5894, 6734, 7553, 8221, 9175, 9467, 9837, 10768, 11360, 11923, 12271, 12492, 13107, 13578, 14419, 14658, 15607, 16514, 16832, 17372, 18318, 18952, 20201, 21261, 21719, 21819, 22181, 22348, 23086, 23571]","[0, 170, 260, 350, 530, 783, 873, 1008, 1098, 1357, 1555, 1664, 1995, 2323, 2634, 3200, 4007, 4119, 4214, 4738, 4832, 5257, 6583, 6750, 6979, 7480, 7862, 8270, 8524, 9269, 9402, 10024, 10563, 10663, 11309, 12126, 12472, 13502, 14666, 15688, 16347, 16666, 16766, 17641, 18553]","[0, 170, 295, 481, 618, 871, 961, 1134, 1224, 1314, 1592, 1972, 2218, 2750, 3033, 3415, 4038, 4241, 4439, 5037, 5465, 6023, 7031, 7911, 8265, 8477, 8662, 9020, 9226, 9544, 10015, 10537, 10934, 11034, 11430, 11530, 11630, 12589, 13769, 14231, 14368, 14873, 15110, 15561, 16436]",34201,26093,23571,18553,16436,-10239,-4394,-2716,-4331,-2277,-23957,45,dire
7609332606,49,29,120,123,5,"[0, 204, 487, 696, 978, 1466, 1866, 2148, 2635, 2832, 3380, 4044, 4647, 5243, 5719, 6455, 7370, 8361, 8716, 9913, 11145, 11710, 12871, 13635, 14014, 15010, 15814, 16551, 17891, 18460, 19817, 20654, 21887, 22346, 23408, 24285, 25187, 25921, 26711, 27280, 27809, 28838, 29810, 30977, 31836]","[0, 295, 579, 1001, 1250, 1534, 1821, 2193, 2573, 3073, 3464, 3921, 4471, 5196, 5979, 6834, 7808, 8395, 9007, 10092, 11450, 11856, 12443, 13081, 13610, 14245, 14678, 15129, 15673, 16403, 17235, 17910, 18597, 19495, 20225, 20916, 21243, 21470, 22185, 22810, 23399, 24302, 24629, 25392, 26675]","[0, 288, 498, 941, 1346, 1727, 2138, 2590, 3029, 3336, 3590, 4059, 4753, 5258, 5604, 6480, 6974, 7341, 7697, 8285, 9169, 10111, 10926, 11470, 11889, 12224, 12976, 13819, 14504, 15256, 15845, 17013, 18024, 18214, 18456, 18797, 19893, 20474, 20917, 21271, 21735, 22368, 23461, 24401, 25124]","[0, 390, 480, 570, 660, 750, 887, 977, 1067, 1411, 1826, 1965, 2224, 2557, 2750, 3001, 3351, 4068, 4327, 4717, 5292, 5891, 6289, 6796, 6936, 7263, 7467, 7740, 8128, 8405, 9040, 9703, 10187, 11106, 11656, 12105, 12474, 12703, 12803, 13228, 13395, 14049, 14376, 15387, 16235]","[0, 214, 353, 498, 765, 904, 994, 1131, 1243, 1368, 1599, 1845, 2012, 2141, 2248, 2758, 3013, 3322, 3469, 3735, 4227, 4400, 4800, 5092, 5296, 5733, 5979, 6367, 7127, 7579, 8133, 8582, 9152, 9807, 10018, 10243, 10442, 10632, 11031, 11287, 11387, 11760, 12426, 12786, 13722]",31836,26675,25124,16235,13722,90,93,109,96,65,"[327, 740, 908, 1218, 1512, 1907, 2305, 2972, 3679, 4200, 5070, 5523, 6025, 6708, 7233, 7452, 8447, 8911, 9163, 9303, 9581, 10174, 10958, 11840, 12412, 13097, 13393, 14097, 14576, 15083, 15717, 16635, 17321, 17421, 18050, 18426, 19269, 20090, 20524, 20797, 21449, 21967, 22730, 23371, 24266]","[0, 220, 420, 792, 1034, 1397, 1859, 2450, 2750, 3180, 3769, 4270, 4958, 5646, 6336, 6955, 7575, 8143, 8690, 9619, 9890, 10196, 10711, 11260, 11757, 12211, 12790, 13348, 13907, 14797, 15374, 15474, 15945, 16489, 17126, 17636, 18848, 19736, 20678, 21095, 21584, 22543, 23043, 24328, 24504]","[59, 229, 319, 409, 543, 673, 1068, 1294, 1660, 1948, 2278, 2368, 2624, 2856, 3075, 3169, 3477, 4064, 4221, 4905, 5395, 5588, 5977, 6182, 6561, 7113, 7816, 8209, 8685, 9235, 9992, 10430, 11138, 12084, 12982, 13855, 15026, 16408, 16980, 18003, 19184, 20298, 21353, 22544, 23487]","[59, 229, 644, 932, 1305, 1542, 1877, 2331, 2719, 3067, 3774, 4067, 4503, 5132, 5298, 5749, 6344, 7024, 7441, 7888, 8154, 8752, 9190, 9743, 10211, 11053, 11592, 12044, 12184, 12949, 13562, 14211, 14311, 14616, 14830, 15275, 16345, 17304, 18488, 19020, 19851, 20438, 20719, 20927, 21027]","[59, 229, 333, 423, 513, 688, 858, 1056, 1448, 1789, 2300, 2537, 2827, 3450, 3929, 4023, 4448, 4622, 4928, 5075, 5374, 5469, 5612, 5779, 5874, 6131, 6225, 6637, 6733, 6910, 7006, 7312, 7412, 7740, 7867, 8163, 8560, 10125, 10423, 10523, 10722, 10822, 11299, 11507, 11607]",24266,24504,23487,21027,11607,7570,2171,1637,-4792,2115,8701,45,radiant
7610750910,1,23,28,19,110,"[0, 266, 568, 827, 1039, 1289, 1621, 2052, 2494, 2794, 3462, 3755, 4022, 4263, 4792, 5373, 5665, 6094, 7576, 8547, 9558, 10440, 11321, 12101, 13372, 14207, 15492, 16510, 17459, 18498, 19555, 20936, 22172, 23546, 25200, 26224, 27406, 28756, 29670, 30819, 32161, 33328, 34418, 35640, 36538]","[0, 270, 775, 1073, 1277, 1659, 2039, 2746, 3099, 3690, 4102, 4410, 5361, 5867, 6489, 6687, 7521, 8143, 8472, 8970, 9662, 10079, 10694, 11626, 12099, 12586, 12893, 13562, 13829, 14302, 15026, 15591, 16463, 17132, 17810, 18593, 19011, 19844, 20614, 21634, 22964, 23308, 23408, 24184, 24599]","[0, 230, 431, 764, 1121, 1484, 1770, 2401, 2947, 3560, 4149, 4701, 4855, 5400, 5829, 6385, 6896, 7290, 8131, 8608, 8972, 9253, 9669, 10540, 11167, 12171, 12311, 12576, 13156, 13476, 13858, 14042, 14232, 14612, 15592, 15837, 16667, 17257, 17552, 17735, 18314, 19362, 19917, 20506, 20858]","[0, 195, 285, 375, 465, 555, 739, 1040, 1291, 1546, 1912, 2062, 2153, 2458, 3087, 3325, 3859, 4102, 4609, 4889, 5376, 5549, 5790, 6348, 6655, 7005, 7282, 7803, 8055, 8335, 9053, 9207, 9556, 10059, 10483, 10875, 11403, 12392, 12908, 13315, 14046, 14221, 14321, 14668, 15042]","[0, 195, 285, 375, 465, 620, 797, 1036, 1126, 1272, 1825, 1915, 2147, 2242, 2729, 2993, 3153, 3394, 4207, 4559, 5094, 5379, 5634, 5801, 6263, 6442, 6536, 6716, 7017, 7113, 7627, 8000, 8239, 8910, 9010, 9110, 9562, 9851, 9951, 10097, 10661, 10761, 11424, 11742, 11842]",36538,24599,20858,15042,11842,15,54,33,100,87,"[0, 208, 529, 912, 1283, 1690, 2192, 2525, 2943, 3663, 3804, 4315, 4893, 5681, 5831, 6842, 7562, 8260, 8449, 9581, 10180, 10664, 11433, 12191, 12396, 13052, 13676, 14538, 15371, 15928, 16462, 17159, 17702, 18495, 19251, 19929, 20682, 21303, 21901, 22464, 23398, 25210, 25797, 26301, 27071]","[0, 244, 479, 675, 1010, 1172, 1421, 1933, 2328, 2656, 2957, 3493, 3864, 4325, 4915, 5762, 6483, 6969, 7064, 7955, 8647, 9143, 9605, 10252, 11323, 11892, 12425, 13024, 13986, 14628, 14875, 15326, 15609, 15947, 16770, 17114, 17512, 18905, 19497, 20173, 21522, 23032, 23489, 24045, 24710]","[0, 331, 531, 767, 1183, 1443, 1854, 2342, 2842, 3367, 3851, 4757, 5398, 6134, 6434, 6958, 7778, 8061, 8450, 8982, 9455, 10075, 11217, 11650, 12203, 12626, 13175, 13577, 14080, 14869, 15316, 15912, 16348, 17139, 17847, 18322, 18763, 19567, 20110, 20802, 21462, 22329, 22873, 23401, 24048]","[0, 170, 305, 395, 565, 690, 830, 945, 1531, 1731, 1821, 2134, 2389, 2690, 2959, 3262, 3428, 3650, 3952, 4373, 4962, 5248, 5505, 5747, 6238, 6566, 6815, 6985, 7486, 7872, 8043, 8274, 8557, 9314, 9504, 9639, 9841, 10202, 10377, 10601, 11196, 11333, 11575, 11736, 12165]","[0, 170, 260, 360, 494, 636, 726, 1071, 1321, 1521, 1611, 1923, 2370, 2754, 2849, 3071, 3377, 3646, 3741, 3898, 4056, 4249, 4869, 5036, 5385, 5587, 5727, 5822, 6253, 6566, 6662, 6965, 7750, 7985, 8175, 8275, 8474, 8673, 8887, 9242, 9585, 10315, 10670, 11128, 11591]",27071,24710,24048,12165,11591,9467,-111,-3190,2877,251,9294,45,dire
7611209103,44,28,121,62,85,"[0, 239, 647, 961, 1447, 1658, 2205, 2607, 2879, 3441, 3737, 4149, 4925, 5376, 5809, 6004, 6816, 7496, 8267, 9110, 9738, 10753, 11605, 11808, 12962, 13975, 15177, 15914, 16390, 17088, 17877, 18495, 19153, 20112, 21423, 22684, 25126, 25900, 28791, 28891, 29389, 30395, 31901, 32546, 34026]","[0, 290, 652, 1122, 1488, 2017, 2437, 2753, 3377, 3750, 4369, 4739, 5533, 6038, 6563, 6763, 7277, 8048, 8713, 8870, 9247, 9538, 9800, 10321, 11111, 11790, 11885, 12351, 12836, 13296, 13737, 14096, 14936, 15360, 16250, 17280, 19213, 19997, 20886, 21284, 22449, 22975, 23960, 24675, 25940]","[0, 170, 260, 616, 746, 974, 1183, 1273, 1493, 1823, 2258, 2384, 2932, 3489, 3876, 4312, 4570, 5066, 6021, 6226, 6618, 7079, 7421, 7670, 8482, 9027, 9299, 9874, 10813, 11208, 11586, 11881, 12129, 12415, 13207, 14697, 15809, 16536, 17824, 17924, 18228, 19035, 19537, 19805, 20263]","[0, 368, 630, 990, 1345, 1745, 1880, 2259, 2750, 3337, 3977, 4181, 4856, 5332, 5593, 5942, 6357, 6957, 7472, 8011, 8241, 8754, 9029, 9363, 9565, 9861, 10099, 10550, 10850, 11123, 11341, 11511, 11720, 12031, 12297, 13226, 15053, 15383, 18260, 18593, 18792, 19096, 19372, 19507, 19999]","[0, 170, 260, 565, 775, 865, 1077, 1266, 1356, 1482, 1662, 1845, 2465, 2845, 2940, 3542, 3981, 4686, 5114, 5632, 6046, 6731, 7008, 7174, 7509, 7947, 8042, 8317, 8713, 8973, 9152, 9309, 9576, 9775, 10401, 10984, 12885, 13293, 13604, 13704, 14182, 14417, 14632, 14904, 15437]",34026,25940,20263,19999,15437,109,120,129,101,5,"[0, 295, 536, 820, 1019, 1347, 1653, 2059, 2502, 3555, 4122, 4635, 5015, 5658, 6321, 7417, 8154, 9067, 10276, 11491, 12159, 13224, 14029, 15467, 16534, 17540, 19260, 20912, 21999, 22776, 24269, 25036, 25878, 26944, 28267, 29290, 29500, 30276, 32455, 32555, 33439, 34624, 35571, 36723, 37972]","[0, 366, 664, 1084, 1338, 1680, 2008, 2461, 2827, 3154, 3661, 4222, 4946, 5394, 5961, 6652, 7448, 7642, 8175, 8838, 9289, 9505, 10117, 10691, 11746, 12254, 13290, 14014, 14697, 14793, 15321, 15859, 16131, 16745, 17404, 18036, 18136, 18370, 18960, 19172, 19898, 20416, 21356, 21944, 22248]","[0, 267, 357, 557, 836, 1411, 1538, 1834, 2179, 2641, 3002, 3480, 4095, 4662, 5264, 6222, 6849, 7187, 7371, 7878, 8170, 8510, 8931, 9336, 9659, 9995, 10984, 11744, 12295, 12391, 12822, 13146, 13410, 13771, 13981, 14394, 14494, 14769, 15405, 16127, 16622, 16812, 17417, 17921, 18573]","[0, 526, 616, 745, 835, 1236, 1326, 1461, 1596, 1979, 2399, 2642, 2822, 3011, 3499, 3878, 4165, 4260, 4746, 5333, 5823, 5918, 6198, 6689, 7031, 7363, 8138, 8677, 9039, 9173, 9529, 9629, 9729, 10044, 10144, 10386, 10486, 10586, 11623, 11792, 12066, 12331, 12702, 12910, 13010]","[0, 302, 437, 652, 806, 1027, 1389, 1670, 1805, 2120, 2602, 2848, 3303, 3485, 3870, 4348, 4675, 4780, 5084, 5681, 5909, 6077, 6366, 6566, 6821, 7100, 8201, 8872, 9159, 9255, 9829, 9974, 10074, 10389, 10489, 10626, 10894, 10994, 11614, 12014, 12213, 12403, 12503, 12822, 13031]",37972,22248,18573,13010,13031,-3946,3692,1690,6989,2406,10831,45,radiant
7611956203,113,28,120,105,20,"[0, 272, 668, 954, 1547, 2071, 2335, 2816, 3245, 3601, 3974, 4492, 4967, 5912, 6625, 7291, 8192, 8722, 9663, 10372, 11095, 12016, 12784, 13629, 14516, 15544, 16188, 17306, 18310, 19515, 20203, 21190, 22400, 22786, 24426, 25690, 26489, 27767, 29142, 30109, 30900, 31045, 31729, 32604, 33697]","[0, 130, 506, 753, 1162, 1424, 1803, 2222, 2587, 2973, 3482, 3930, 4508, 5492, 6126, 7151, 7541, 8495, 8712, 9201, 9603, 10166, 10650, 10994, 11324, 12537, 13115, 13467, 13786, 14096, 14290, 14523, 14841, 15494, 15594, 16320, 16420, 17109, 17626, 18126, 18795, 19290, 20104, 20293, 21638]","[0, 238, 588, 965, 1328, 1703, 2419, 2985, 3549, 3962, 4523, 5038, 5309, 5919, 6383, 6869, 7130, 7960, 8705, 8925, 9823, 10513, 11250, 11720, 12043, 12435, 12897, 12992, 13450, 13760, 14187, 15106, 15588, 16048, 16148, 16889, 17425, 17933, 18347, 18695, 19207, 19490, 19590, 20236, 21001]","[0, 467, 557, 691, 829, 969, 1342, 1574, 1878, 2271, 2573, 2713, 2938, 3549, 3899, 4292, 4580, 4920, 5119, 5770, 6167, 6690, 7335, 7642, 7879, 8551, 8722, 8865, 9042, 9352, 9448, 9801, 9991, 10355, 10497, 10741, 10841, 11109, 11412, 12189, 12539, 12639, 12739, 12839, 13371]","[0, 199, 289, 533, 911, 1125, 1419, 1778, 1925, 2285, 2800, 3016, 3480, 3988, 4280, 4705, 5178, 5484, 5695, 5853, 5999, 6154, 6321, 6487, 6724, 7237, 7498, 7639, 7816, 8126, 8222, 8643, 8890, 9076, 9176, 9764, 9864, 10106, 10316, 10660, 10942, 11042, 11142, 11280, 11824]",33697,21638,21001,13371,11824,63,137,23,72,121,"[0, 243, 495, 888, 1263, 1623, 1965, 2520, 2888, 3518, 3879, 4371, 4731, 4879, 5387, 5924, 6240, 6978, 7394, 8330, 9191, 10220, 10864, 11647, 12447, 12623, 13076, 14321, 15185, 16161, 16994, 18330, 18830, 19609, 21438, 22530, 23890, 24681, 26121, 26796, 28366, 30170, 31233, 32253, 33616]","[0, 323, 584, 912, 1203, 1529, 1799, 1979, 2157, 2359, 3060, 3515, 4506, 4884, 5862, 6108, 6891, 7346, 7963, 9480, 10198, 10971, 11720, 11905, 12650, 12983, 13835, 14381, 14891, 16430, 17015, 17355, 17645, 18562, 19830, 20509, 21684, 22245, 22968, 23068, 23662, 24541, 25450, 25682, 25917]","[0, 280, 488, 858, 1541, 1650, 2265, 2695, 3070, 3513, 3658, 4153, 4568, 5101, 5870, 6447, 6942, 7520, 7949, 9007, 9289, 9550, 10340, 10574, 10950, 11044, 12282, 12768, 13029, 13650, 14063, 14163, 14797, 15160, 16523, 17000, 18076, 18531, 18860, 19366, 19791, 20671, 20967, 21067, 21898]","[0, 170, 260, 350, 526, 668, 758, 972, 1062, 1264, 1409, 1499, 2227, 2380, 2735, 2830, 2988, 3082, 3323, 4311, 4454, 4779, 5018, 5251, 5775, 6331, 7004, 7099, 7379, 7781, 7927, 8250, 8441, 8561, 9426, 9706, 10538, 10757, 10967, 11067, 11460, 12029, 12378, 12478, 12713]","[0, 170, 490, 669, 965, 1055, 1267, 1447, 1704, 1906, 2188, 2278, 2491, 2703, 2924, 3170, 3364, 3458, 3555, 4062, 4377, 5022, 5336, 5596, 6292, 6606, 7036, 7206, 7458, 7866, 8039, 8407, 8672, 8797, 9931, 10211, 10795, 11069, 11360, 11460, 11769, 12035, 12193, 12293, 12528]",33616,25917,21898,12713,12528,81,-4279,-897,658,-704,-5141,45,dire
7612109715,109,38,106,85,27,"[0, 322, 520, 841, 1203, 1575, 2018, 2286, 2766, 3199, 3701, 4233, 4981, 5732, 6377, 7325, 8325, 9203, 10140, 11202, 12159, 13183, 14442, 15421, 16099, 16567, 17858, 19108, 20007, 20808, 21521, 21703, 22810, 24254, 25299, 26966, 28482, 28946, 30260, 31376, 32991, 33091, 33490, 34309, 35742]","[0, 367, 577, 1026, 1187, 1775, 1987, 2681, 3165, 3484, 4274, 4867, 5350, 6170, 6664, 7390, 8055, 8727, 10020, 10777, 11564, 11824, 12306, 13172, 13580, 14106, 14877, 15417, 15851, 16223, 17220, 17350, 18610, 18899, 19166, 19816, 20490, 20639, 21780, 22266, 22635, 23987, 24379, 25190, 25878]","[0, 372, 658, 917, 1286, 1661, 2051, 2824, 3169, 3463, 3943, 4408, 4745, 5077, 5433, 5867, 6628, 7132, 7624, 8170, 8806, 9031, 9862, 10358, 10937, 11275, 11480, 11670, 12104, 12367, 12908, 13392, 13908, 14778, 15222, 15520, 15971, 16109, 16679, 17035, 17747, 18933, 19490, 20181, 20921]","[0, 210, 338, 517, 656, 786, 876, 1410, 1641, 1731, 1988, 2263, 2421, 2594, 2724, 3057, 3350, 3445, 3799, 4160, 4394, 4545, 4821, 4916, 5196, 5501, 5708, 5852, 5948, 6044, 6426, 6526, 7062, 7317, 7417, 7690, 7790, 7996, 8523, 8869, 9292, 9757, 9872, 10130, 10338]","[0, 210, 334, 468, 558, 771, 861, 1070, 1301, 1436, 1645, 1735, 2139, 2486, 2617, 2839, 3132, 3227, 3594, 3925, 4148, 4243, 4565, 4956, 5311, 5691, 5860, 6079, 6250, 6420, 6726, 6946, 7326, 7555, 7754, 7930, 8105, 8434, 8534, 8634, 9107, 9541, 9641, 9849, 10057]",35742,25878,20921,10338,10057,12,13,129,9,123,"[0, 252, 574, 827, 1429, 1762, 2323, 2506, 3076, 3379, 3886, 4440, 5190, 5597, 6259, 6805, 7444, 7722, 8801, 9198, 9717, 10699, 11457, 11810, 13179, 13742, 14440, 15124, 16052, 16381, 17636, 18987, 19351, 20184, 21016, 21559, 22526, 23642, 24462, 25628, 26934, 27691, 28500, 29511, 30460]","[0, 245, 520, 808, 1098, 1188, 1520, 1655, 2171, 3071, 3744, 3962, 4646, 5092, 5607, 6093, 6967, 7356, 8082, 8575, 8877, 9580, 10567, 11266, 12603, 13153, 14000, 15028, 15480, 15827, 16924, 18320, 18718, 18873, 19481, 19999, 20099, 21395, 23364, 25155, 26453, 27614, 28596, 28847, 29340]","[0, 532, 696, 893, 1299, 1722, 1922, 2411, 2849, 3326, 3963, 4534, 5138, 5712, 6285, 6535, 6990, 7599, 8049, 8144, 8826, 9631, 10171, 10840, 11949, 13069, 14118, 14402, 15015, 15490, 16146, 16973, 17752, 18400, 19060, 19444, 19609, 19975, 20667, 21086, 21565, 22538, 22746, 22885, 22985]","[0, 192, 282, 459, 973, 1063, 1654, 1891, 2376, 2709, 2889, 3238, 4024, 4317, 4524, 4842, 5065, 5616, 5953, 6086, 6453, 7053, 7349, 7767, 8270, 8614, 8826, 9359, 9952, 10093, 10495, 10775, 11225, 11646, 11994, 12094, 12194, 12516, 13128, 13722, 14393, 14881, 15254, 15354, 15580]","[0, 192, 282, 455, 630, 756, 1003, 1138, 1370, 1538, 1718, 2052, 2530, 2794, 3033, 3128, 3411, 3861, 4153, 4537, 5083, 5665, 5870, 6340, 6684, 7487, 7581, 8044, 8568, 8822, 9431, 10267, 10486, 10950, 11570, 11797, 11957, 12458, 13187, 13859, 15102, 15633, 16084, 16490, 17289]",30460,29340,22985,15580,17289,5282,-3462,-2064,-5242,-7232,-12718,45,dire
7612131018,49,78,21,58,9,"[0, 213, 437, 681, 1137, 1457, 2006, 2400, 2947, 3320, 4012, 4651, 5665, 6397, 7223, 8085, 8678, 9956, 10535, 11124, 11219, 11762, 12916, 13699, 14385, 15530, 16137, 16674, 17468, 18024, 19179, 19895, 20376, 20476, 21311, 21785, 22125, 22447, 22646, 22785, 23115, 24188, 25825, 26206, 26581]","[0, 250, 527, 847, 1096, 1502, 1954, 2265, 2665, 3127, 3683, 4153, 4622, 4956, 5564, 6104, 6478, 7659, 8275, 9448, 9697, 10110, 10623, 10717, 11325, 12078, 12631, 13366, 14209, 14648, 15010, 15569, 16034, 16493, 17051, 17598, 17698, 18604, 19505, 20145, 20245, 21281, 21945, 22529, 23889]","[0, 325, 700, 1155, 1458, 1752, 2229, 2600, 3050, 3639, 3940, 4630, 5204, 6003, 6807, 7161, 7523, 7896, 8259, 9105, 9481, 10318, 10859, 11310, 11405, 12055, 12584, 13146, 13780, 13876, 14509, 15574, 15674, 16331, 17020, 17489, 17687, 17787, 17986, 19052, 19951, 20857, 21781, 23043, 23641]","[0, 474, 564, 698, 852, 959, 1049, 1435, 1574, 1688, 1904, 2221, 2611, 2856, 3313, 3580, 3889, 4356, 4590, 4773, 4868, 5016, 5452, 5628, 5896, 6226, 6449, 6696, 6954, 7050, 7500, 7888, 7988, 8410, 9032, 9520, 9863, 10514, 10815, 11008, 11588, 11927, 12668, 12986, 13331]","[0, 166, 304, 474, 665, 800, 966, 1192, 1282, 1372, 1741, 1923, 2358, 2554, 2818, 3087, 3227, 3570, 3665, 4073, 4583, 4723, 4890, 4984, 5079, 5246, 5406, 5543, 5801, 6020, 6627, 6967, 7220, 7320, 7645, 7835, 8175, 8275, 8474, 8574, 8674, 8899, 9388, 9706, 10077]",26581,23889,23641,13331,10077,73,69,137,5,65,"[0, 366, 1039, 1509, 1853, 2149, 2672, 3186, 3695, 4112, 4866, 5255, 5669, 6375, 7039, 7777, 8699, 9573, 10719, 11581, 13195, 14172, 14702, 15863, 17208, 17955, 18692, 19325, 20791, 21875, 22807, 23679, 25716, 27502, 28252, 28396, 28518, 29400, 31794, 32772, 34905, 35779, 37116, 38377, 40828]","[0, 210, 539, 687, 1083, 1502, 1664, 2201, 2734, 3147, 3764, 3971, 4620, 5053, 5771, 6519, 7537, 8083, 8390, 9291, 9564, 10066, 10858, 11274, 12360, 12662, 13278, 13558, 14402, 15051, 15468, 16025, 17101, 17361, 17760, 18262, 18585, 19878, 20530, 21444, 22646, 23428, 24651, 25708, 27456]","[0, 293, 501, 834, 1077, 1364, 1663, 2007, 2308, 2930, 3467, 4034, 4737, 5386, 5872, 6274, 6989, 7862, 8315, 8819, 9159, 9883, 10402, 10778, 11683, 11985, 12641, 12965, 13151, 13907, 14676, 14866, 15522, 15977, 16661, 16985, 17105, 18575, 19163, 19697, 20556, 21140, 21705, 22395, 23993]","[0, 210, 372, 538, 742, 832, 1014, 1504, 1639, 2077, 2593, 2761, 2851, 3113, 3208, 3454, 3701, 4167, 4464, 4811, 5487, 5885, 6199, 6784, 7303, 7807, 7977, 8304, 8902, 9862, 10392, 10700, 12029, 12129, 12319, 12693, 12793, 13612, 14752, 15619, 16510, 16818, 17264, 17742, 18993]","[0, 210, 367, 543, 713, 850, 1297, 1652, 1787, 2219, 2642, 2732, 3220, 3569, 4017, 4565, 4913, 5125, 5321, 5937, 6735, 7119, 7547, 8079, 8271, 8894, 9363, 9457, 9763, 10643, 10893, 11083, 11441, 11955, 12324, 12554, 12674, 13093, 13418, 14674, 15643, 16017, 16278, 16953, 18763]",40828,27456,23993,18993,18763,-14247,-3567,-352,-5662,-8686,-32514,45,dire
7612171311,89,23,60,9,45,"[0, 130, 331, 691, 984, 1261, 1609, 1974, 2389, 2863, 3531, 4156, 4734, 5458, 6141, 6921, 7871, 8813, 9820, 11128, 12106, 13043, 14089, 15155, 16488, 17350, 17748, 18688, 19427, 20372, 20549, 21993, 23350, 24971, 26457, 27463, 28550, 28902, 29931, 30197, 31429, 32778, 34659, 35604, 36188]","[0, 237, 594, 1083, 1342, 1649, 2235, 2547, 3370, 3933, 4726, 5633, 6004, 6822, 7076, 7171, 7586, 8089, 8752, 9710, 10155, 10596, 11043, 11294, 11957, 12628, 12887, 13714, 14288, 14930, 15397, 15967, 16271, 16931, 17790, 18059, 18264, 18616, 19163, 19561, 19661, 20233, 21043, 21724, 21943]","[0, 214, 486, 770, 1100, 1390, 1915, 2306, 2867, 3333, 4193, 4675, 5327, 5782, 6123, 6735, 7414, 8013, 8499, 9780, 10526, 10860, 11136, 11538, 12248, 12597, 13008, 13300, 14358, 15003, 15775, 15984, 16386, 17083, 17749, 17849, 17995, 18592, 18969, 19069, 19169, 19876, 20791, 21571, 21671]","[0, 130, 220, 421, 544, 680, 826, 1054, 1184, 1871, 2307, 2702, 2933, 3268, 3573, 3668, 3953, 4433, 4746, 5372, 5612, 5738, 5891, 6259, 6489, 6804, 6899, 7145, 7630, 8042, 8410, 8769, 9036, 9449, 9915, 10080, 10420, 10772, 11282, 11833, 12542, 13260, 13880, 14269, 14390]","[100, 230, 368, 488, 693, 783, 873, 1001, 1292, 1584, 2056, 2371, 2655, 2883, 3298, 3393, 3686, 3834, 4409, 5138, 5624, 5838, 6225, 6478, 6751, 6993, 7329, 7544, 7796, 8058, 8355, 8574, 9045, 9647, 10160, 10394, 10692, 11245, 11741, 11960, 12292, 12814, 13313, 13926, 14078]",36188,21943,21671,14390,14078,73,49,13,128,85,"[0, 371, 827, 1139, 1599, 1897, 2376, 3278, 4156, 5108, 6095, 6405, 7474, 8500, 10294, 11321, 11996, 13212, 14522, 15027, 15431, 15999, 16586, 17933, 18976, 20043, 21651, 23306, 24498, 25904, 26925, 28733, 29487, 30090, 30417, 30880, 31462, 31802, 32546, 33233, 34110, 35521, 36641, 37585, 38935]","[0, 300, 628, 892, 1274, 1601, 2059, 2580, 3041, 3320, 3983, 4553, 5160, 5634, 6392, 6842, 7176, 7596, 8290, 8858, 9442, 10105, 10606, 11690, 12152, 12840, 14108, 14941, 15778, 16501, 17243, 17811, 18315, 18785, 19645, 21252, 21352, 21572, 22197, 23701, 24898, 26264, 26524, 27557, 28362]","[0, 330, 650, 943, 1362, 1563, 1812, 2137, 2463, 3043, 3223, 3751, 4336, 4707, 5495, 6144, 7016, 7769, 8669, 8799, 9485, 9718, 10572, 11415, 12167, 12926, 14000, 14717, 15436, 15707, 16332, 17102, 17733, 17833, 17973, 18655, 19365, 19505, 20694, 21941, 22957, 23475, 23575, 24000, 24556]","[0, 214, 402, 545, 750, 895, 1034, 1124, 1509, 2057, 2391, 2578, 2855, 3103, 3627, 3933, 4091, 4452, 4875, 4970, 5307, 5401, 5788, 6337, 6951, 7481, 8348, 8657, 9092, 9949, 10338, 10702, 10996, 11128, 11323, 11520, 11703, 11803, 12025, 12461, 12886, 13400, 13623, 13844, 14233]","[2, 212, 302, 439, 1019, 1109, 1248, 1468, 1626, 1868, 2104, 2194, 2421, 2642, 2965, 3060, 3303, 3397, 3622, 3717, 3812, 3977, 4233, 4590, 4808, 5024, 5553, 5783, 6306, 6790, 7170, 7406, 7733, 7833, 7933, 8033, 8133, 8233, 8944, 9632, 10023, 10671, 10816, 11186, 11580]",38935,28362,24556,14233,11580,-2747,-6419,-2885,157,2498,-9396,45,dire
7613436713,13,93,55,85,19,"[0, 207, 480, 760, 1088, 1379, 1780, 2214, 2786, 3222, 3751, 4202, 4352, 4953, 5548, 6537, 7699, 8426, 9410, 10226, 10892, 11828, 12577, 13156, 14091, 14912, 15674, 16734, 17046, 17237, 18242, 19032, 19923, 21577, 23495, 24502, 26597, 27548, 27876, 28897, 29995, 30417, 31106, 31974, 32074]","[0, 200, 519, 846, 1059, 1574, 1935, 2378, 2732, 3090, 3411, 4010, 4529, 5346, 5913, 6402, 7215, 7594, 8468, 9411, 9719, 10434, 11677, 12171, 12591, 13566, 13756, 13851, 14179, 14546, 15704, 16524, 16953, 17869, 18505, 19999, 20864, 21612, 22448, 22824, 22924, 23893, 24821, 26035, 27478]","[0, 239, 544, 897, 1356, 1590, 1983, 2143, 2518, 3066, 3289, 3807, 4403, 4813, 5464, 5917, 6776, 7275, 8096, 8687, 9097, 9625, 10471, 10795, 11498, 12136, 12615, 12710, 13080, 13249, 13972, 14443, 14848, 15735, 17328, 17949, 19080, 19351, 19855, 20360, 20927, 21710, 22095, 22836, 23770]","[0, 132, 247, 381, 488, 626, 753, 939, 1119, 1397, 1670, 1760, 1886, 2047, 2151, 2619, 3479, 3663, 4730, 5033, 5128, 5266, 5505, 5724, 5983, 6426, 7068, 7315, 7704, 7929, 9342, 9602, 9930, 11080, 11842, 12169, 12865, 12965, 13236, 13610, 13710, 13970, 14486, 14760, 15384]","[0, 132, 627, 772, 1123, 1257, 1347, 1437, 1796, 2010, 2234, 2351, 2469, 2617, 2783, 3209, 3908, 4462, 4995, 5369, 5464, 5602, 6111, 6262, 6405, 7003, 7253, 7412, 7643, 8165, 8762, 9385, 9691, 10364, 11565, 12037, 12586, 12825, 13345, 13673, 13773, 14033, 14259, 14531, 14731]",32074,27478,23770,15384,14731,89,59,129,65,52,"[0, 331, 571, 896, 1202, 1610, 1900, 2357, 2689, 3068, 3450, 4152, 4675, 5363, 6056, 6747, 7804, 8545, 9821, 10991, 12039, 12922, 14524, 15780, 16834, 17901, 18741, 20089, 20968, 21722, 22587, 24083, 24895, 25710, 25810, 26652, 27881, 29917, 31038, 32051, 33220, 34801, 35548, 37977, 39260]","[0, 282, 583, 946, 1156, 1490, 1852, 2633, 3022, 3767, 4286, 5140, 5655, 6190, 6929, 7533, 7799, 8291, 8454, 8612, 9270, 9516, 10093, 10638, 11187, 11645, 11740, 12875, 13198, 13689, 13890, 15125, 16045, 16672, 16772, 16872, 17494, 17594, 18695, 19526, 20448, 20899, 20999, 22113, 22912]","[0, 257, 419, 647, 944, 1303, 1598, 2008, 2468, 3195, 3905, 4451, 5293, 5958, 6475, 7029, 7259, 7662, 7825, 8014, 8525, 9144, 9577, 10485, 10926, 11356, 11466, 12215, 12752, 13063, 13977, 14735, 15072, 15994, 16094, 16845, 17331, 17431, 17890, 19098, 19485, 20046, 20388, 21132, 21450]","[100, 310, 400, 539, 773, 925, 1147, 1659, 2021, 2428, 2925, 3418, 3593, 3777, 4405, 4613, 4879, 4973, 5173, 5331, 5795, 6060, 6762, 7102, 7799, 8076, 8452, 9016, 9112, 9377, 9573, 10128, 10343, 10732, 10832, 10932, 11131, 11231, 11766, 11866, 11966, 12504, 12604, 13415, 13733]","[0, 210, 300, 390, 480, 619, 754, 987, 1125, 1415, 1939, 2279, 2436, 2669, 2928, 3229, 3600, 3694, 3852, 4112, 4270, 4535, 4952, 5047, 5210, 5449, 5591, 6187, 6283, 6975, 7352, 7835, 8045, 8700, 8800, 9021, 9220, 9320, 10127, 10808, 10908, 11359, 11459, 12021, 12387]",39260,22912,21450,13733,12387,-7186,4566,2320,1651,2344,3695,45,dire
7614970519,41,28,76,110,114,"[0, 232, 577, 802, 1302, 1542, 1860, 2382, 2978, 3511, 3962, 4411, 5012, 5451, 6060, 6475, 7274, 8061, 8828, 9607, 10102, 10724, 11058, 11667, 12410, 13036, 13551, 14026, 15144, 15824, 16270, 17625, 18173, 19177, 19277, 19687, 20552, 21823, 22366, 23397, 24320, 25166, 26453, 27363, 28510]","[0, 231, 518, 840, 1290, 1611, 1964, 2724, 3171, 3593, 4152, 4761, 5320, 5722, 6467, 6786, 7644, 8221, 8800, 8894, 9094, 9870, 10521, 10942, 11537, 11775, 12116, 12682, 13329, 13930, 14782, 15451, 16411, 17296, 18161, 18572, 19646, 20590, 20978, 22207, 22776, 23195, 24228, 24749, 26189]","[0, 305, 624, 950, 1341, 1669, 2087, 2624, 3155, 3704, 4073, 4693, 5335, 5888, 6567, 6750, 7072, 7699, 8170, 8662, 9225, 9771, 10523, 11166, 11709, 12401, 13206, 13300, 13894, 13990, 14458, 15474, 16112, 16854, 17594, 18198, 18628, 18827, 19036, 19592, 20391, 20858, 21711, 22378, 23162]","[100, 294, 419, 509, 685, 882, 1100, 1273, 1648, 1930, 2175, 2361, 2673, 2954, 3375, 3661, 4162, 4718, 5123, 5521, 5795, 5996, 6555, 6886, 7078, 7584, 7935, 8066, 8990, 9651, 9828, 10514, 10707, 11333, 11540, 11859, 12710, 13113, 13437, 14964, 15641, 15741, 16377, 16725, 17596]","[0, 194, 319, 409, 539, 704, 1042, 1310, 1445, 1604, 1694, 1844, 2034, 2183, 2278, 2651, 2951, 3182, 3412, 3697, 4155, 4250, 4918, 5386, 5481, 5648, 5918, 6260, 6527, 7413, 7590, 8371, 8471, 8763, 9106, 9959, 10059, 10258, 10464, 11690, 12259, 12498, 12926, 14438, 14917]",28510,26189,23162,17596,14917,95,13,96,105,103,"[0, 350, 670, 989, 1395, 1904, 2239, 2786, 3285, 3763, 4308, 4963, 5582, 5849, 6455, 7195, 8194, 9031, 9908, 10997, 11743, 12264, 13028, 13761, 14214, 15491, 16279, 17027, 17844, 18230, 18326, 19247, 19958, 21066, 22103, 23202, 23760, 25033, 25403, 25702, 25802, 27126, 27321, 27421, 28016]","[0, 301, 540, 839, 1175, 1492, 1793, 2057, 2426, 2792, 3309, 3837, 4355, 4709, 4976, 5739, 6447, 7241, 8053, 8446, 9164, 9928, 10451, 10804, 11249, 12022, 13042, 13915, 14566, 15796, 16242, 17070, 17942, 18569, 19960, 20302, 21216, 22145, 22739, 23107, 23321, 24584, 25795, 26680, 27174]","[0, 531, 849, 1223, 1739, 2141, 2510, 2795, 3309, 3600, 4184, 4602, 5006, 5396, 5538, 6008, 6615, 7205, 7808, 8615, 9365, 9509, 9859, 10332, 10427, 10736, 11246, 11759, 12329, 12841, 13294, 13529, 14094, 14482, 14762, 15172, 15272, 15750, 15850, 16186, 16400, 16992, 17872, 18262, 19090]","[0, 363, 453, 586, 716, 925, 1015, 1105, 1243, 1333, 1468, 1752, 2066, 2682, 3030, 3498, 3756, 4055, 4150, 4982, 5420, 5981, 6515, 7056, 7151, 7656, 8457, 8551, 8920, 9849, 10034, 10425, 10733, 11075, 11441, 11762, 11862, 12475, 12949, 13600, 14522, 14730, 14872, 15375, 15475]","[0, 194, 284, 374, 504, 765, 900, 990, 1208, 1582, 1717, 1861, 1972, 2067, 2266, 2577, 3095, 3596, 3812, 4730, 5024, 5119, 5343, 5437, 5532, 5794, 6503, 6631, 6937, 8602, 8698, 8933, 9033, 9419, 9934, 10144, 10244, 10443, 10543, 11666, 11933, 12141, 12241, 12341, 12479]",28016,27174,19090,15475,12479,494,-985,4072,2121,2438,8140,45,radiant
7616158604,67,109,112,137,100,"[0, 89, 417, 674, 799, 923, 1262, 1721, 2110, 2348, 2808, 3231, 3947, 5218, 5821, 6194, 6803, 7885, 8546, 9097, 9913, 10878, 11811, 12281, 13352, 14279, 14600, 15596, 16734, 17869, 18957, 19537, 19637, 20776, 21266, 21366, 21926, 22652, 23225, 23325, 24509, 25546, 26070, 26278, 28598]","[0, 169, 259, 349, 439, 529, 709, 1282, 1514, 1719, 1985, 2187, 2879, 3312, 3765, 3970, 4466, 4759, 5480, 5877, 6423, 7039, 7628, 8013, 8713, 9632, 10486, 11264, 11633, 12373, 13110, 14153, 15031, 15802, 16048, 16246, 16571, 17213, 17614, 18575, 20015, 20999, 22004, 23164, 24731]","[0, 474, 716, 930, 1570, 1765, 1983, 2271, 2813, 3237, 3793, 4217, 4663, 4938, 5502, 5932, 6153, 7263, 7943, 8954, 9636, 10362, 10783, 11240, 11434, 11765, 12276, 12927, 13409, 14373, 14689, 14879, 15333, 15548, 15648, 16121, 16754, 16953, 17468, 17774, 19235, 20160, 20381, 20766, 22183]","[0, 240, 416, 747, 873, 1086, 1372, 1633, 2021, 2426, 2677, 3068, 3694, 4394, 4764, 5247, 6174, 6521, 6895, 7160, 7957, 8311, 8750, 9234, 10188, 10996, 11226, 11813, 12537, 13213, 13773, 14828, 14928, 15028, 15166, 15553, 15996, 16871, 17255, 17355, 18229, 18826, 19205, 19943, 21529]","[0, 169, 259, 349, 603, 693, 873, 1008, 1098, 1370, 1550, 1928, 2447, 2865, 3332, 3836, 4423, 4751, 5447, 5645, 6316, 6547, 6714, 6808, 7167, 7648, 7878, 8268, 8670, 9456, 9867, 10407, 10507, 10607, 10789, 11005, 11167, 11508, 12165, 12265, 13385, 13664, 14158, 14516, 15732]",28598,24731,22183,21529,15732,49,21,76,9,65,"[0, 409, 606, 885, 1336, 1708, 2234, 2738, 3127, 3900, 4563, 5118, 5327, 5568, 6546, 7139, 7555, 8157, 9017, 9832, 10184, 10502, 11254, 11833, 12558, 12725, 13420, 14308, 15063, 15159, 15649, 17025, 18068, 18270, 20054, 21139, 22558, 23272, 24773, 25495, 25705, 25805, 26681, 26997, 29111]","[0, 324, 748, 1121, 1462, 1787, 2253, 2766, 3055, 3572, 4013, 4517, 4657, 5290, 5631, 6075, 6336, 6803, 6898, 7055, 7749, 8468, 8964, 9058, 10164, 10446, 11170, 11817, 12553, 12649, 13205, 14732, 15919, 16303, 18279, 19591, 21286, 21956, 22332, 24163, 25192, 26022, 27320, 28185, 29841]","[0, 337, 703, 1049, 1503, 1802, 2263, 2718, 3530, 3850, 4288, 4687, 4962, 5111, 5445, 5809, 6102, 6596, 6709, 7254, 7540, 7759, 8651, 9019, 9718, 9885, 10852, 10983, 11443, 11700, 12246, 13941, 14423, 15076, 17245, 18145, 18711, 19386, 20083, 21179, 21482, 22023, 23004, 23682, 25388]","[0, 249, 339, 476, 706, 963, 1165, 1394, 1591, 1980, 2323, 2628, 2988, 3528, 3861, 4441, 4599, 4782, 4877, 5245, 5558, 5661, 6316, 6527, 6873, 7115, 7352, 7573, 7890, 8024, 8120, 9888, 10346, 10886, 12025, 12460, 13114, 13718, 14140, 15229, 15439, 15539, 16083, 16450, 17802]","[0, 249, 339, 429, 612, 826, 979, 1223, 1383, 1636, 1891, 2468, 2866, 3142, 3907, 4001, 4321, 4795, 5083, 5240, 5335, 5430, 6223, 6548, 6803, 6970, 7446, 7711, 8146, 8242, 8626, 9739, 9929, 10230, 11525, 12290, 12657, 12982, 13967, 14768, 14978, 15078, 15693, 15901, 17115]",29111,29841,25388,17802,17115,-513,-5110,-3205,3727,-1383,-6484,45,dire
7616192306,73,21,78,45,20,"[328, 692, 1121, 1323, 1699, 2528, 3005, 3825, 4499, 5641, 6409, 7047, 7998, 8624, 9124, 10364, 10933, 11869, 12734, 13841, 15187, 16129, 17386, 18547, 19661, 20514, 21921, 22288, 23509, 24660, 25249, 26607, 27709, 28330, 29250, 31073, 31604, 32643, 34024, 34710, 35421, 35825, 36276, 37197, 37476]","[58, 633, 874, 1296, 1707, 2069, 2784, 3392, 3938, 5024, 5314, 5933, 6735, 6830, 7830, 8342, 9121, 9873, 10602, 11101, 11690, 12160, 12409, 12959, 13256, 14149, 14581, 14965, 15630, 16452, 16663, 17696, 18692, 19366, 20109, 21286, 22150, 23382, 23716, 24290, 24611, 25342, 25790, 26347, 26719]","[58, 314, 601, 802, 1160, 1489, 2052, 2525, 3249, 3793, 4255, 4382, 4788, 5355, 6351, 6630, 7112, 7819, 8074, 8445, 9241, 9782, 10163, 10708, 11114, 11800, 12129, 12223, 12698, 13846, 14128, 15004, 15664, 15874, 16277, 17133, 17438, 18111, 18874, 19390, 19650, 20100, 20380, 21066, 21296]","[58, 415, 697, 787, 923, 1659, 1794, 2163, 2405, 2752, 3015, 3392, 3688, 4088, 4799, 5182, 5883, 6455, 6964, 7496, 8117, 8230, 8815, 9047, 9569, 9997, 10349, 10518, 10855, 11325, 11596, 11826, 12091, 12613, 12803, 13463, 13773, 14568, 15093, 15613, 15788, 16544, 16672, 17115, 17878]","[58, 576, 666, 756, 846, 1006, 1217, 1408, 1578, 1790, 1970, 2132, 2312, 2484, 2723, 2939, 3266, 3593, 3688, 3845, 4255, 4350, 4517, 4797, 4896, 5444, 5729, 5870, 6170, 6639, 6850, 7040, 7456, 7666, 7856, 8179, 8900, 10236, 10435, 10670, 10770, 11005, 11105, 11313, 11750]",37476,26719,21296,17878,11750,48,29,106,100,64,"[0, 205, 490, 990, 1245, 1796, 2038, 2200, 2362, 2730, 3206, 3856, 4472, 5115, 5878, 6562, 7009, 8071, 8804, 9534, 10477, 11911, 12817, 14087, 15175, 16251, 17167, 18025, 18865, 19953, 20937, 21783, 23205, 23789, 25126, 26017, 27122, 27678, 27778, 28339, 29588, 31347, 32951, 33619, 34650]","[0, 243, 509, 925, 1217, 1396, 1800, 2369, 3005, 3651, 4165, 4990, 5475, 5942, 6446, 6840, 7121, 7875, 8225, 9223, 10060, 10477, 11205, 12257, 12794, 13357, 13737, 14696, 15022, 15721, 16093, 16714, 17595, 17887, 18514, 19555, 21298, 22446, 23198, 24079, 24698, 26532, 26676, 27175, 28439]","[0, 473, 746, 1029, 1286, 1673, 1763, 2104, 2513, 2693, 3073, 3228, 3487, 3827, 4394, 4694, 4942, 5618, 5713, 6055, 6449, 6909, 7004, 8116, 8518, 8879, 9116, 10012, 10499, 11031, 11247, 11457, 11725, 12354, 12791, 13636, 15635, 16403, 16683, 17511, 18422, 19849, 20320, 21496, 22709]","[0, 254, 381, 755, 915, 1067, 1340, 2078, 2321, 2501, 2791, 3190, 3280, 3960, 4921, 5061, 5555, 5871, 5966, 6350, 6652, 7136, 7695, 8153, 8534, 9107, 9298, 10008, 10267, 10518, 10782, 11158, 11258, 11696, 11983, 12628, 13043, 13710, 13810, 14329, 14874, 16246, 16670, 16903, 17653]","[0, 254, 344, 676, 766, 1045, 1135, 1225, 1403, 1583, 1964, 2475, 2565, 2969, 3364, 3557, 3838, 4068, 4333, 4545, 4909, 5547, 5717, 6802, 6972, 7426, 7596, 8425, 8950, 9265, 9556, 10007, 10230, 10405, 10580, 11549, 13237, 14153, 14578, 14926, 15224, 15488, 15588, 15796, 16266]",34650,28439,22709,17653,16266,2826,-1720,-1413,225,-4516,-4598,45,dire
7617881416,126,95,96,121,101,"[332, 724, 1039, 1237, 1535, 1950, 2400, 2867, 3484, 4080, 4375, 5047, 5646, 6121, 6297, 6726, 7487, 7990, 8583, 9600, 10491, 10857, 11852, 12610, 13172, 13773, 14158, 14253, 14560, 15627, 16344, 16946, 17660, 17877, 18334, 18844, 20000, 21010, 21581, 22313, 23135, 23763, 25170, 25994, 26789]","[64, 310, 568, 1017, 1262, 1511, 1855, 2066, 2345, 2542, 2984, 3974, 4327, 4828, 5279, 5905, 7152, 7523, 8241, 9151, 9523, 9980, 10356, 11898, 12813, 13389, 14098, 14193, 14594, 15296, 15979, 17433, 18316, 18614, 19843, 19943, 20287, 20945, 21439, 22145, 22967, 23939, 24396, 25081, 25837]","[64, 351, 677, 996, 1327, 1867, 2260, 2606, 2942, 3492, 3966, 4329, 4959, 5157, 5696, 6076, 7398, 8034, 8355, 8797, 9344, 10590, 11145, 12100, 12974, 13249, 14041, 14584, 14962, 15733, 16487, 18017, 18959, 19471, 20050, 20150, 20891, 21266, 21799, 22318, 22980, 23556, 24069, 24516, 25122]","[64, 325, 415, 572, 708, 831, 1054, 1144, 1500, 1696, 1838, 2299, 2532, 2800, 3115, 3292, 4064, 4222, 4426, 4584, 5159, 5525, 5778, 6523, 6798, 6892, 7285, 7380, 7476, 7902, 7998, 9170, 9417, 9640, 10496, 10596, 11130, 11365, 11465, 11675, 11935, 12082, 12214, 12426, 13258]","[64, 274, 364, 490, 629, 882, 1105, 1321, 1549, 1729, 1864, 2228, 2597, 2795, 2889, 2984, 3590, 3784, 3934, 4433, 4740, 5106, 6111, 6503, 6778, 7068, 7819, 7914, 8010, 8632, 8828, 9839, 10056, 10156, 10770, 10870, 11209, 11444, 11544, 11754, 12011, 12156, 12318, 12418, 12657]",26789,25837,25122,13258,12657,70,53,135,104,123,"[0, 216, 559, 845, 1125, 1475, 1727, 2198, 2613, 2900, 3541, 4321, 4546, 6171, 6788, 7520, 7809, 8319, 8856, 9762, 10591, 11243, 11645, 12226, 12634, 13262, 14528, 15770, 16487, 17210, 17815, 18801, 18901, 19397, 21509, 22866, 22966, 23931, 25161, 26249, 27060, 27283, 27995, 28495, 29478]","[0, 130, 220, 606, 776, 1176, 1704, 1908, 2074, 2723, 2878, 3358, 3675, 4178, 4688, 5035, 5388, 6210, 6801, 7124, 7505, 8046, 8448, 8877, 9112, 9724, 10626, 11822, 12604, 13251, 13347, 14149, 14249, 15134, 16306, 17256, 17889, 18937, 19365, 20233, 21420, 22362, 22854, 23718, 24256]","[0, 206, 447, 741, 1028, 1451, 1762, 2059, 2268, 2449, 2754, 3280, 3503, 4222, 4616, 4933, 5210, 5780, 6497, 6941, 7343, 7695, 8334, 8748, 9163, 9919, 10095, 11240, 11951, 12183, 12658, 13560, 13958, 14460, 15632, 17107, 17487, 18226, 18637, 19113, 19501, 20226, 20775, 21210, 21955]","[0, 239, 592, 867, 1124, 1564, 1777, 1907, 2457, 2699, 3113, 3642, 4141, 4891, 5177, 5528, 6081, 6904, 7124, 7514, 8083, 8640, 9201, 9561, 9910, 10293, 10621, 11329, 11891, 11987, 12465, 13106, 13206, 13414, 14238, 15601, 16212, 17237, 17695, 17952, 18454, 18945, 19334, 19886, 20252]","[0, 130, 220, 418, 611, 845, 1511, 1678, 1768, 1996, 2387, 2720, 2893, 3554, 3875, 4215, 4922, 5414, 5775, 6151, 6710, 7037, 7341, 8021, 8762, 9111, 9945, 10769, 11194, 11617, 12373, 12730, 13272, 13588, 14111, 15329, 15429, 15925, 16179, 16389, 16588, 17401, 17716, 17995, 18378]",29478,24256,21955,20252,18378,-2689,1581,3167,-6994,-5721,-10656,45,dire
7618866208,113,12,29,31,75,"[0, 295, 619, 1077, 1489, 1842, 2218, 2342, 2592, 3700, 4115, 4997, 5179, 6105, 6712, 7537, 8350, 9341, 9751, 10982, 11292, 12071, 13242, 13650, 14888, 16529, 17797, 18550, 18646, 19458, 21389, 22715, 23418, 23518, 24487, 25153, 26270, 26715, 26815, 27365, 28573, 29167, 29850, 30348, 31473]","[0, 248, 485, 771, 1020, 1345, 1668, 1914, 2243, 2645, 2991, 3225, 3716, 4211, 4999, 5358, 5849, 6389, 6795, 7625, 8012, 8889, 9559, 9967, 10616, 11154, 12053, 12429, 13289, 14802, 16668, 17356, 18382, 18482, 18727, 19497, 20053, 20438, 20645, 21072, 21844, 22530, 23391, 24723, 25076]","[0, 246, 526, 852, 1208, 1532, 1936, 2290, 2538, 3005, 3516, 3808, 4003, 4430, 5181, 5276, 5896, 6628, 6965, 7536, 7914, 8129, 9142, 10424, 10948, 12058, 12849, 13415, 13714, 14278, 15132, 15232, 15332, 15618, 16044, 16530, 16865, 17028, 17208, 17526, 18340, 18661, 19075, 19175, 19820]","[0, 210, 330, 420, 628, 763, 898, 988, 1209, 1389, 1498, 1732, 1822, 2310, 3238, 3486, 3852, 3946, 4157, 4315, 4446, 4540, 4883, 5780, 5993, 6216, 6575, 6709, 6805, 7505, 8477, 8577, 8719, 8819, 9314, 9831, 10115, 10215, 10315, 10498, 10796, 10896, 11310, 11808, 12056]","[0, 210, 330, 466, 591, 725, 815, 953, 1062, 1262, 1690, 1924, 2014, 2634, 3131, 3434, 3964, 4261, 4444, 4772, 4867, 4961, 5372, 5467, 5689, 6046, 6422, 6614, 6710, 6954, 7530, 7630, 7730, 7830, 8310, 8590, 8825, 8971, 9071, 9215, 9513, 9613, 10027, 10127, 10375]",31473,25076,19820,12056,10375,28,95,114,7,79,"[51, 219, 498, 806, 1024, 1396, 1813, 2082, 2592, 2858, 3172, 4119, 4624, 4773, 5601, 6105, 6563, 7098, 7821, 8300, 10206, 10896, 11527, 11884, 12833, 13502, 14142, 15992, 16703, 17167, 17263, 18959, 20609, 20819, 21134, 22008, 22358, 23554, 24889, 25709, 26959, 27690, 28193, 28676, 28776]","[319, 501, 819, 1018, 1262, 1509, 1637, 1880, 2204, 2332, 2550, 2928, 3202, 3502, 4133, 4629, 4938, 5417, 5745, 6457, 6981, 7714, 8402, 9085, 9524, 9944, 10539, 11096, 12037, 12740, 12851, 13337, 14720, 15692, 16767, 17519, 18314, 18758, 20836, 21442, 22098, 22825, 24453, 25079, 25408]","[51, 219, 466, 608, 865, 1107, 1339, 1624, 2277, 2804, 2983, 3391, 4072, 4426, 4914, 5274, 5462, 5556, 5973, 6583, 7268, 7539, 8063, 8654, 8955, 9049, 9755, 10185, 10726, 11083, 11217, 12824, 14791, 15627, 16354, 17006, 17300, 17855, 19189, 19552, 19998, 20569, 22028, 22445, 22677]","[51, 181, 271, 361, 451, 632, 810, 970, 1153, 1253, 1425, 2219, 2647, 2869, 3357, 3452, 3659, 4079, 4302, 4697, 5133, 5227, 5439, 6161, 6401, 6942, 7118, 7441, 7810, 7987, 8161, 8746, 9294, 9694, 10009, 10140, 10321, 10785, 11714, 12236, 12459, 12855, 13644, 13744, 13954]","[51, 181, 271, 361, 495, 669, 796, 931, 1100, 1226, 1316, 1568, 1997, 2146, 2580, 2818, 2913, 3226, 3455, 3703, 4300, 4394, 4671, 5175, 5454, 6104, 6326, 6421, 6790, 7252, 7353, 7633, 7765, 8209, 8658, 8815, 9008, 9279, 9821, 10096, 10295, 10600, 11001, 11101, 11201]",28776,25408,22677,13954,11201,2697,-332,-2857,-1898,-826,-3216,45,radiant
7619853714,18,90,138,106,121,"[0, 206, 707, 997, 1393, 1917, 2263, 2455, 3005, 3626, 4100, 5029, 5635, 6454, 6973, 8168, 8974, 10045, 11264, 12141, 13081, 13332, 14619, 15134, 16208, 17193, 17888, 18946, 19469, 20577, 21654, 22587, 23296, 23805, 25333, 26492, 26966, 27772, 29010, 29643, 29743, 29985, 30688, 30933, 31434]","[0, 209, 543, 915, 1354, 1800, 2401, 2839, 3882, 4464, 4698, 5234, 5723, 6801, 7458, 8380, 8939, 9395, 10163, 10812, 11437, 12377, 13383, 14176, 14470, 15094, 15342, 15914, 16299, 16977, 17664, 18346, 18775, 18875, 19378, 20062, 21008, 21267, 22109, 22609, 22746, 23292, 23970, 24544, 25260]","[0, 129, 219, 309, 475, 565, 910, 1154, 1380, 1705, 1885, 2052, 2233, 2647, 2757, 3293, 3497, 3878, 4534, 5180, 5747, 6033, 7125, 7345, 7568, 8071, 8346, 8441, 9311, 9407, 10428, 10985, 11745, 12433, 13300, 14593, 15541, 15749, 16609, 16849, 17477, 18232, 19245, 19490, 19989]","[0, 207, 532, 897, 1319, 1650, 2124, 2689, 3207, 3453, 3781, 4357, 4638, 5033, 5567, 5752, 6323, 6823, 7105, 7432, 8092, 8501, 9224, 9623, 9997, 10373, 10713, 11050, 11544, 12008, 13412, 13899, 14438, 14970, 15585, 16180, 16473, 16608, 17295, 18295, 19051, 19684, 20366, 20611, 20711]","[0, 129, 300, 434, 573, 740, 882, 972, 1230, 1513, 1693, 1921, 2129, 2385, 2525, 2934, 3092, 3658, 4084, 4370, 4575, 5023, 5882, 5977, 6172, 6425, 6602, 6804, 7060, 7454, 8029, 8264, 8687, 9409, 10281, 10925, 11025, 11125, 11664, 11888, 12210, 12310, 12545, 12790, 12890]",31434,25260,19989,20711,12890,70,129,43,19,52,"[0, 294, 491, 843, 1249, 1593, 1885, 2530, 2848, 3164, 3732, 4206, 4737, 5427, 6118, 6903, 8006, 8817, 9748, 10528, 11314, 11884, 11978, 13168, 14003, 15059, 16716, 17714, 18972, 19068, 19254, 20366, 21558, 22407, 22620, 23159, 25181, 26167, 26462, 28118, 29898, 30443, 31212, 32639, 33733]","[0, 243, 854, 1224, 1548, 2186, 2687, 3016, 3292, 3705, 4163, 4465, 4790, 5149, 5537, 5968, 6736, 6975, 7279, 7665, 8072, 8322, 8519, 9456, 10039, 10357, 11125, 11854, 12607, 12703, 13917, 14593, 15040, 15140, 15540, 15969, 16386, 17785, 18205, 19815, 20764, 21715, 21907, 23543, 24594]","[0, 299, 628, 963, 1270, 1674, 2037, 2414, 2710, 3366, 4359, 4612, 5371, 5889, 6504, 6773, 7326, 7856, 8635, 8990, 9460, 9774, 9868, 10699, 11157, 11598, 12411, 12864, 13441, 13655, 13841, 14263, 14610, 14824, 15645, 16082, 17223, 17943, 18320, 20493, 21277, 21851, 22582, 23721, 24479]","[100, 309, 563, 653, 743, 910, 1045, 1273, 1412, 1712, 2030, 2120, 2338, 2631, 2846, 2941, 3173, 3268, 3955, 4113, 4208, 4719, 4813, 5320, 5605, 5772, 6535, 6630, 7358, 7577, 8221, 8828, 9482, 9582, 10275, 10761, 11446, 11827, 11973, 13285, 13639, 13847, 13980, 15062, 15682]","[0, 209, 299, 406, 565, 704, 842, 1022, 1198, 1500, 1829, 1929, 2146, 2538, 3155, 3426, 3779, 4220, 4432, 4590, 4685, 5035, 5255, 5823, 5990, 6504, 7030, 7125, 7302, 7432, 7948, 8602, 9237, 9656, 10143, 10243, 10817, 11278, 11378, 12307, 12616, 13087, 13187, 14842, 15284]",33733,24594,24479,15682,15284,-2299,666,-4490,5029,-2394,-3488,45,dire
7621666802,138,96,17,9,65,"[0, 290, 540, 959, 1606, 1984, 2403, 2788, 3269, 3807, 4320, 4591, 5405, 5970, 6651, 7228, 8337, 8834, 9392, 9839, 10901, 11463, 12681, 13388, 14403, 15173, 16429, 17258, 18234, 18983, 19711, 20247, 21101, 22143, 22433, 24059, 25350, 26193, 28119, 29798, 31175, 32457, 32557, 33444, 35167]","[0, 255, 585, 865, 1414, 1650, 2000, 2418, 2922, 3307, 4214, 4510, 4939, 5205, 5466, 5659, 6359, 7034, 7638, 7796, 8313, 8479, 9364, 10013, 10877, 11493, 12335, 13191, 14186, 14887, 15397, 16073, 16812, 17278, 18125, 19156, 19981, 20552, 21733, 23143, 24553, 25805, 25905, 26562, 27645]","[0, 278, 567, 933, 1154, 1493, 1896, 2094, 2333, 2679, 3212, 3322, 3780, 3984, 4443, 4628, 5422, 6175, 6396, 6683, 6816, 7261, 7863, 8220, 8493, 9073, 9249, 9344, 9521, 10047, 10424, 11012, 11519, 11738, 11945, 12700, 13326, 13530, 14726, 16209, 17009, 18088, 18522, 18802, 19130]","[0, 174, 304, 437, 722, 872, 1275, 1468, 1558, 1895, 2238, 2647, 3285, 3393, 3970, 4296, 5494, 5965, 6109, 6267, 6539, 6818, 7612, 7707, 8092, 8534, 8778, 9166, 9512, 9789, 10084, 10245, 11529, 11629, 11729, 12429, 13005, 13105, 14007, 14840, 15440, 16241, 16800, 17461, 17884]","[0, 170, 333, 423, 621, 711, 801, 942, 1294, 1429, 1619, 1910, 2259, 2565, 3234, 3397, 3918, 4551, 4646, 4804, 5073, 5283, 5540, 5635, 6289, 6639, 6815, 7275, 7865, 8258, 8587, 8907, 9205, 9382, 9751, 10178, 10325, 10425, 11038, 11424, 11968, 12551, 12651, 13000, 13717]",35167,27645,19130,17884,13717,73,70,13,121,79,"[0, 313, 481, 690, 1113, 1731, 2062, 2894, 3281, 4047, 4444, 5470, 6402, 7377, 8243, 9083, 10360, 11267, 12010, 12705, 14298, 15191, 16390, 18003, 18222, 19098, 19950, 20263, 20611, 21194, 21817, 22829, 24602, 25921, 26828, 27203, 28295, 29005, 29692, 30225, 30325, 31588, 31904, 33064, 34412]","[0, 302, 556, 813, 1101, 1615, 1990, 2388, 2914, 3258, 3738, 4165, 4868, 5634, 6235, 7047, 7578, 8077, 8975, 9895, 10522, 11325, 12765, 13710, 14302, 15372, 16157, 16872, 18052, 18836, 19398, 20341, 21289, 22468, 22844, 23670, 24394, 25390, 26209, 26979, 27079, 28461, 30753, 31988, 34296]","[0, 195, 627, 872, 1217, 1679, 2088, 2602, 3107, 3438, 3768, 4428, 5331, 5635, 6251, 6683, 6911, 7650, 7886, 8677, 9485, 9931, 10656, 11703, 12342, 12778, 13335, 13689, 14600, 15315, 15827, 16131, 16885, 17381, 18113, 18464, 19082, 19633, 20155, 20255, 20736, 22404, 23809, 24775, 26095]","[0, 195, 328, 418, 812, 1068, 1158, 1467, 1686, 1821, 2180, 2521, 3235, 3733, 4215, 4310, 4538, 4829, 4957, 5685, 6511, 6680, 7045, 7512, 7681, 8152, 8752, 9144, 9530, 9812, 10142, 10461, 10861, 11230, 11506, 11857, 11986, 12222, 12425, 12661, 13005, 13730, 14356, 14647, 15544]","[0, 242, 332, 470, 843, 933, 1331, 1987, 2271, 2656, 2833, 3227, 3460, 3764, 4130, 4410, 4642, 5297, 5396, 5858, 6383, 6478, 7016, 7483, 7902, 8429, 8758, 9026, 9580, 10077, 10575, 11081, 11483, 11658, 11984, 12294, 12469, 12743, 12918, 13093, 13268, 14002, 14529, 14922, 15690]",34412,34296,26095,15544,15690,755,-6651,-6965,2340,-1973,-12494,45,dire
7623846810,48,49,23,79,5,"[0, 170, 579, 904, 1193, 1521, 1979, 2278, 2828, 3180, 3582, 4261, 4867, 5605, 6261, 6948, 7579, 8657, 9349, 10443, 11449, 12585, 13239, 14338, 15937, 16615, 17968, 18708, 19658, 20528, 21937, 22388, 23356, 23856, 25007, 25678, 26369, 27311, 28068, 29086, 30232, 31090, 31679, 32758, 33739]","[0, 238, 565, 1010, 1466, 1854, 2276, 2699, 3079, 3649, 4259, 4891, 5308, 5847, 6541, 6997, 7419, 8068, 8309, 8921, 9274, 10010, 10567, 11260, 12164, 12563, 13511, 14136, 14965, 15769, 16363, 16739, 16880, 17845, 18156, 18861, 19533, 20302, 21148, 21973, 22475, 23293, 23393, 23722, 24116]","[0, 260, 543, 830, 1237, 1442, 1781, 1916, 2299, 2861, 3082, 3538, 4490, 5274, 5976, 6448, 6890, 7993, 8399, 8754, 9162, 9452, 9936, 10477, 10801, 11098, 11563, 11974, 12634, 13376, 14118, 14447, 14639, 15005, 15694, 16055, 16361, 17265, 17557, 18411, 18847, 19055, 19915, 20882, 21645]","[0, 170, 260, 384, 519, 649, 789, 924, 1014, 1280, 1893, 1983, 2302, 2635, 2880, 3023, 3298, 3935, 4172, 4534, 4901, 5167, 5525, 6001, 6383, 6684, 7086, 7403, 7763, 8087, 8454, 8756, 8933, 9168, 9562, 9923, 10059, 10483, 10583, 10892, 11091, 11646, 12014, 12632, 13438]","[0, 215, 305, 413, 634, 764, 937, 1072, 1201, 1335, 1779, 2050, 2254, 2636, 2934, 3294, 3536, 3976, 4189, 4567, 4661, 4872, 5466, 5830, 6105, 6396, 6882, 7267, 7569, 8025, 8394, 8561, 8731, 9210, 9689, 10507, 11058, 11658, 11758, 11986, 12277, 12586, 12686, 13206, 13600]",33739,24116,21645,13438,13600,10,98,17,19,110,"[0, 258, 545, 859, 1213, 1700, 2148, 2529, 2914, 3473, 4106, 4824, 5347, 5873, 6575, 7151, 7903, 8331, 9182, 9775, 10558, 11457, 12417, 13363, 14512, 15367, 16153, 16406, 17295, 18334, 19288, 20362, 21563, 22763, 23779, 23923, 25145, 26046, 27645, 28554, 29331, 30188, 30670, 31532, 32130]","[0, 206, 512, 720, 1008, 1253, 1459, 2230, 2805, 3258, 3818, 4170, 4651, 5096, 5630, 6489, 7118, 7729, 8689, 8784, 9865, 10725, 10892, 11366, 12185, 12980, 13739, 14173, 14468, 14666, 15469, 15917, 16066, 16303, 16595, 16695, 17363, 17872, 18211, 18652, 19371, 20109, 20900, 21351, 21693]","[0, 321, 608, 1020, 1303, 1576, 1764, 2077, 2646, 2850, 3537, 4011, 4525, 5200, 5730, 6320, 6853, 7429, 7891, 8095, 8496, 9263, 9910, 10546, 11151, 11487, 11687, 12557, 13161, 13637, 14013, 14383, 14673, 15079, 15512, 15683, 16061, 16628, 16976, 17656, 18108, 18419, 18802, 19213, 19601]","[0, 216, 341, 431, 605, 733, 823, 1048, 1261, 1484, 1761, 1851, 2032, 2257, 2725, 2920, 3189, 3744, 3940, 4040, 4237, 4404, 5015, 5544, 5844, 6180, 6633, 7064, 7252, 7597, 7909, 8292, 8612, 9256, 9583, 9683, 9783, 9966, 10150, 10572, 10733, 11019, 11440, 11540, 11640]","[0, 172, 266, 376, 551, 641, 731, 866, 1190, 1280, 1566, 1656, 1891, 2120, 2484, 2942, 3165, 3385, 3800, 4100, 4299, 4645, 4812, 5106, 5308, 5761, 5937, 6077, 6520, 6616, 6712, 7123, 7271, 7508, 7698, 7922, 8022, 8166, 8517, 8666, 8896, 9106, 9550, 9650, 9750]",32130,21693,19601,11640,9750,1609,2423,2044,1798,3850,11724,45,radiant
7624424306,95,19,28,66,9,"[0, 179, 470, 723, 1089, 1296, 1765, 2187, 2525, 2931, 3152, 3622, 4093, 4683, 5308, 5933, 6440, 7092, 7625, 7846, 8640, 9123, 10119, 10358, 11523, 12219, 13042, 14247, 14950, 15567, 16237, 17240, 19437, 20317, 20637, 20778, 22026, 23041, 23141, 23678, 24054, 26390, 27399, 28655, 29817]","[0, 169, 442, 772, 1210, 1385, 1681, 2228, 2568, 3289, 3465, 3814, 4265, 4650, 5227, 5656, 6026, 6670, 7012, 7564, 8210, 8550, 9372, 10009, 10201, 11162, 11605, 11835, 12229, 12437, 13261, 13971, 15492, 16582, 17190, 17290, 17714, 19997, 20765, 20985, 21085, 22326, 22753, 23534, 24812]","[0, 256, 576, 868, 1164, 1607, 2106, 2705, 3341, 3870, 4439, 4932, 5336, 5431, 5935, 6365, 6685, 7678, 8016, 8708, 9182, 9277, 9749, 10739, 11019, 11390, 12261, 12906, 13116, 13293, 13991, 14942, 16839, 17872, 18449, 18549, 19035, 20274, 21483, 21891, 22149, 22728, 23527, 24247, 24882]","[0, 130, 254, 392, 598, 688, 896, 1401, 1604, 1729, 2125, 2449, 2677, 2813, 3022, 3462, 3658, 3947, 4468, 4913, 5546, 5716, 6047, 6632, 7186, 7413, 7947, 8655, 9332, 10285, 11071, 11808, 12947, 13500, 13841, 14390, 14729, 15661, 16697, 16965, 17147, 18029, 18382, 18748, 19320]","[0, 130, 220, 310, 528, 1064, 1203, 1537, 1627, 1780, 1915, 2085, 2254, 2632, 2816, 3353, 3475, 4379, 4853, 5497, 5797, 5971, 6688, 7307, 7484, 8234, 8736, 9018, 9114, 9544, 9640, 9895, 11185, 11618, 12270, 12608, 12743, 13916, 14016, 14116, 14472, 15262, 15362, 15881, 16153]",29817,24812,24882,19320,16153,18,15,77,65,5,"[0, 210, 595, 799, 1166, 1525, 1773, 2054, 2350, 2736, 3408, 4040, 4774, 6239, 6985, 7475, 8323, 9031, 9672, 10068, 10791, 11320, 12197, 12644, 13402, 14288, 15643, 16342, 16710, 17829, 18674, 19424, 19524, 20546, 21629, 22197, 22810, 23779, 23879, 23979, 24079, 24179, 24495, 25329, 26299]","[0, 245, 479, 714, 1076, 1544, 1942, 2569, 2784, 3129, 3965, 4817, 5477, 6163, 6718, 7044, 7471, 8090, 8194, 8996, 10266, 10961, 12505, 12780, 13331, 13766, 14450, 14806, 15283, 16058, 16681, 17709, 17809, 18242, 19650, 20409, 20931, 21949, 22049, 22253, 22353, 22925, 23958, 25160, 25894]","[0, 298, 555, 935, 1151, 1482, 1956, 2325, 2780, 3090, 3583, 3941, 4707, 5205, 5578, 6197, 6892, 7388, 7890, 8747, 9829, 10881, 11696, 12260, 12536, 12882, 13609, 14195, 14503, 15064, 15342, 16025, 16125, 16487, 17006, 17150, 17689, 18674, 19103, 19473, 19672, 20155, 20733, 21376, 21476]","[0, 210, 338, 428, 518, 905, 995, 1326, 1451, 1681, 2554, 2856, 3163, 3709, 4132, 4809, 5363, 5872, 5966, 6743, 7215, 7431, 8197, 8680, 8974, 9312, 9654, 9911, 10007, 11072, 11303, 11756, 11984, 12382, 13287, 13434, 13633, 14243, 14343, 14443, 14543, 14643, 14959, 15683, 16050]","[0, 210, 300, 416, 554, 644, 734, 952, 1171, 1580, 1801, 2219, 2417, 2820, 3082, 3188, 3782, 4148, 4274, 4623, 5003, 5219, 5879, 5974, 6371, 6614, 7072, 7257, 7353, 7970, 8245, 8714, 8927, 9551, 10091, 10283, 10691, 11604, 11704, 11804, 11904, 12004, 12320, 12852, 12983]",26299,25894,21476,16050,12983,3518,-1082,3406,3270,3170,12282,45,radiant
7624854612,18,59,69,5,26,"[0, 294, 534, 982, 1352, 1793, 2284, 2724, 3471, 4094, 4641, 5397, 6282, 6620, 7068, 7707, 8229, 9265, 9840, 10706, 11872, 12328, 13325, 13700, 14714, 15329, 15994, 16866, 18430, 19454, 20268, 20796, 21924, 22566, 23381, 23992, 24383, 25293, 26406, 27447, 28344, 28702, 30110, 30678, 31343]","[0, 279, 654, 1076, 1370, 1753, 2452, 2908, 3455, 3786, 3876, 4424, 4961, 5427, 6057, 6643, 7307, 7814, 8386, 8833, 9194, 9568, 10315, 10715, 11229, 11651, 12393, 12841, 13678, 14396, 14920, 15299, 16003, 16733, 17083, 17415, 18375, 19039, 19404, 19976, 20355, 20648, 20998, 21749, 22052]","[0, 331, 582, 924, 1623, 1882, 2051, 2376, 2730, 3011, 3771, 3957, 4408, 4944, 5603, 5818, 6430, 7052, 7648, 8160, 8711, 9778, 10573, 11078, 11282, 11671, 11848, 12039, 13114, 13471, 14102, 14476, 14853, 15165, 15785, 16081, 16341, 16895, 17641, 18282, 18642, 19002, 19133, 19617, 20300]","[0, 170, 341, 466, 601, 735, 1150, 1269, 1418, 1591, 1681, 1938, 2417, 2512, 2660, 3015, 3366, 3572, 3870, 4448, 4847, 4953, 5434, 5719, 6048, 6441, 6535, 6704, 7314, 7564, 7774, 8072, 8172, 8461, 8891, 9567, 9910, 10333, 10614, 11404, 11693, 11793, 11996, 12789, 13091]","[0, 170, 340, 430, 634, 852, 991, 1205, 1340, 1430, 1780, 1870, 2348, 2443, 2638, 2733, 2883, 3254, 3396, 3554, 3739, 4078, 4289, 4601, 4850, 5035, 5129, 5224, 6103, 6289, 6486, 6676, 6823, 7167, 7376, 7522, 7622, 8170, 8270, 8751, 9040, 9185, 9285, 9612, 9822]",31343,22052,20300,13091,9822,54,120,129,100,110,"[0, 170, 545, 970, 1302, 2102, 2658, 3285, 3846, 4328, 5080, 5533, 6066, 6518, 7088, 7675, 8547, 9348, 10192, 10959, 11656, 12534, 13263, 14057, 15233, 15757, 16736, 17516, 17856, 18621, 19500, 19757, 20718, 21610, 22458, 23017, 24369, 25094, 25779, 26209, 26408, 26897, 28011, 29003, 30135]","[0, 289, 479, 724, 1022, 1200, 1598, 2166, 2608, 3180, 3702, 4063, 4777, 5513, 6298, 6695, 7213, 7686, 8343, 8693, 9131, 9403, 9867, 10353, 11144, 11777, 12118, 12663, 13491, 14389, 14873, 15526, 16125, 16690, 17263, 17601, 18182, 18550, 19446, 20422, 21771, 22003, 22103, 22740, 23163]","[0, 170, 593, 867, 1313, 1627, 2033, 2557, 3042, 3511, 4343, 4708, 5271, 5852, 6181, 6515, 7301, 7648, 8263, 8823, 9549, 9644, 10319, 11199, 11678, 11939, 12265, 12771, 13058, 13429, 13927, 14355, 14905, 15303, 15403, 15898, 16744, 17053, 17480, 17910, 18914, 19157, 19257, 20342, 21065]","[0, 170, 285, 375, 589, 679, 1053, 1301, 1436, 1665, 2007, 2097, 2346, 2549, 2890, 3191, 3554, 3672, 4059, 4473, 4766, 4936, 5240, 5670, 5950, 6303, 6472, 6818, 7664, 8241, 8657, 8984, 9114, 9517, 9692, 9977, 10487, 10662, 11659, 11979, 13220, 13408, 13693, 13928, 14138]","[0, 170, 285, 427, 597, 782, 1234, 1447, 1582, 2004, 2497, 2712, 3083, 3368, 3740, 4309, 4851, 5055, 5544, 5884, 6173, 6268, 6497, 6664, 6895, 7551, 7795, 8104, 8391, 8649, 8961, 9196, 9296, 9571, 9671, 9929, 10253, 10353, 10552, 10982, 11356, 11456, 11665, 11900, 12146]",30135,23163,21065,14138,12146,1208,-1111,-765,-1047,-2324,-4039,45,dire
7625316506,73,10,37,104,112,"[0, 508, 1167, 1530, 2013, 2426, 3130, 3494, 4197, 4547, 5334, 6112, 6643, 7907, 8572, 9285, 10475, 12036, 12423, 12851, 13975, 15605, 16336, 17134, 17813, 18270, 19193, 20305, 21156, 22013, 22812, 22912, 23490, 24365, 25610, 26268, 26662, 27081, 27230, 27869, 28238, 29237, 29551, 32667, 34500]","[0, 312, 621, 942, 1254, 1740, 1987, 2296, 2422, 2761, 3140, 3543, 4064, 4471, 4821, 5166, 5665, 6344, 7130, 7823, 8623, 8982, 10072, 10307, 10596, 11306, 11920, 12829, 13265, 13524, 13808, 14502, 15429, 16201, 17294, 17609, 18300, 19027, 19171, 19479, 19579, 19943, 20633, 22914, 24391]","[0, 195, 285, 537, 707, 893, 983, 1140, 1397, 1684, 2215, 2428, 2622, 2860, 3554, 3794, 4530, 5204, 5970, 6288, 6695, 7813, 8240, 9664, 9878, 10293, 10388, 11713, 12042, 12462, 12889, 13642, 14162, 14512, 15246, 16164, 16590, 17246, 17752, 19144, 19520, 19674, 20273, 23111, 24190]","[0, 273, 864, 1241, 1879, 2169, 2572, 3165, 3788, 4381, 5115, 5556, 6468, 6768, 7013, 7586, 8120, 8956, 9933, 10173, 10534, 11134, 11594, 11689, 12021, 12726, 13300, 13711, 13806, 14930, 15026, 16126, 16511, 16926, 17885, 18749, 19043, 19545, 19974, 20337, 20621, 21151, 21323, 22615, 24074]","[0, 195, 353, 443, 1089, 1365, 1455, 1641, 2048, 2372, 2642, 2907, 3150, 3399, 3605, 3800, 4512, 5268, 5822, 6066, 6456, 6815, 7370, 7465, 7719, 7814, 8068, 8628, 8954, 9288, 9426, 10283, 10383, 10573, 11401, 12305, 12960, 13282, 13538, 14001, 14643, 14965, 15833, 17491, 18862]",34500,24391,24190,24074,18862,1,106,29,123,71,"[64, 317, 598, 961, 1186, 1683, 1968, 2292, 2956, 3321, 3707, 4197, 4944, 5604, 6924, 7550, 8385, 9250, 9345, 10163, 11454, 12626, 13428, 14487, 14653, 15974, 16518, 17832, 18471, 19491, 20769, 21882, 23175, 24597, 26028, 27457, 29618, 30448, 31447, 33087, 34407, 34931, 36371, 37649, 37749]","[64, 349, 670, 1158, 1482, 1810, 2270, 2699, 3264, 3619, 4189, 4452, 5063, 5425, 5786, 6231, 6782, 7120, 8024, 8636, 9268, 9508, 9840, 11300, 11501, 12365, 12948, 14007, 14524, 15021, 15669, 16642, 17344, 18156, 18909, 19009, 19873, 20822, 21050, 21767, 22438, 22868, 23559, 25413, 25513]","[64, 234, 545, 1099, 1504, 1801, 2287, 3044, 3810, 4423, 4820, 5541, 5974, 6453, 7061, 7637, 8057, 8542, 9196, 9833, 10571, 10811, 11150, 12555, 13475, 14065, 14343, 14934, 15139, 15809, 16273, 16802, 17587, 18159, 18761, 19465, 20059, 20602, 20911, 21779, 22176, 22276, 22606, 23195, 23295]","[332, 505, 625, 915, 1005, 1219, 1527, 1907, 2204, 2548, 2907, 3193, 3501, 3997, 4716, 4962, 5230, 5519, 6231, 6764, 7471, 7808, 8135, 9085, 9526, 10044, 10274, 11117, 11558, 11816, 12656, 13679, 14239, 14429, 15028, 15333, 16884, 17427, 17652, 18236, 19263, 20031, 21018, 22437, 22701]","[64, 234, 354, 479, 569, 1009, 1406, 1852, 2055, 2240, 2330, 2420, 2929, 3221, 4182, 4816, 5036, 5276, 5500, 5834, 6319, 6736, 6831, 7876, 8458, 8809, 9039, 9677, 10016, 10419, 11097, 11601, 11811, 12266, 12826, 13131, 13231, 13774, 13999, 14633, 15220, 15561, 15661, 16253, 16353]",37749,25513,23295,22701,16353,-3249,-1122,895,1373,2509,406,45,radiant
7625796211,44,126,97,9,85,"[0, 336, 610, 1009, 1172, 1750, 2201, 2503, 3003, 3506, 3998, 4481, 4935, 5375, 6095, 6926, 7664, 8532, 9159, 9698, 10250, 11238, 12049, 12870, 13262, 14433, 15284, 15886, 16125, 17308, 17762, 18795, 19335, 21465, 21927, 22402, 23048, 23346, 23875, 25248, 26144, 28309, 29068, 29727, 31665]","[0, 249, 454, 629, 854, 1140, 1386, 1607, 1901, 2250, 2800, 3331, 3896, 4298, 4615, 5165, 5800, 6076, 6711, 7160, 7573, 8486, 9023, 9818, 10261, 10394, 10992, 11087, 11576, 12437, 12850, 13899, 14583, 15858, 16439, 16856, 17953, 18556, 19117, 19940, 20552, 22361, 23505, 24574, 26039]","[0, 327, 492, 790, 998, 1160, 1296, 1592, 1765, 2039, 2383, 2929, 3413, 4358, 5140, 5534, 6021, 6666, 7051, 7248, 7747, 7842, 8832, 9751, 9846, 10299, 10822, 11023, 11291, 11722, 12202, 12351, 12622, 13985, 14666, 14830, 15164, 15400, 15622, 16462, 16889, 17475, 18566, 19090, 19909]","[0, 301, 443, 533, 713, 803, 1305, 1405, 1544, 1709, 2015, 2151, 2407, 2648, 2802, 3135, 3425, 3617, 4219, 4651, 4976, 5579, 5788, 6569, 6664, 6759, 6883, 6978, 7074, 7388, 7646, 7924, 8307, 9112, 9564, 9664, 10006, 10260, 10418, 10704, 10988, 11212, 11760, 12145, 12489]","[0, 249, 391, 564, 654, 993, 1083, 1173, 1263, 1414, 1603, 1738, 2091, 2583, 2822, 2945, 3320, 3561, 3736, 4039, 4225, 4320, 4621, 5187, 5282, 5496, 5620, 5715, 5880, 6130, 6416, 6666, 6766, 7648, 7960, 8094, 8194, 8528, 8756, 8886, 9085, 9667, 9891, 10353, 11287]",31665,26039,19909,12489,11287,109,35,104,110,86,"[0, 138, 495, 912, 1201, 1483, 1928, 2499, 2885, 3488, 4117, 4553, 5170, 5806, 6316, 7004, 7464, 8120, 8891, 9618, 10694, 11034, 11438, 12600, 14013, 14768, 15832, 16813, 17832, 18550, 19682, 20508, 21450, 22109, 22770, 23736, 24184, 25196, 26016, 27125, 28068, 28535, 28754, 30440, 30930]","[0, 127, 376, 734, 1110, 1274, 1626, 2234, 2630, 3077, 3856, 4362, 5128, 5672, 6424, 7043, 7733, 8306, 8851, 9352, 9841, 10898, 11582, 12305, 12926, 13633, 14170, 14424, 14756, 15346, 15754, 16223, 17272, 17711, 17811, 18024, 18647, 18985, 19807, 20139, 20352, 20613, 20713, 21115, 21532]","[0, 210, 389, 735, 987, 1279, 1992, 2466, 2748, 3240, 3523, 3965, 4440, 4909, 5476, 5807, 6205, 6500, 7261, 7356, 8176, 8499, 9280, 9690, 10766, 11437, 11793, 11950, 12342, 12780, 13156, 13436, 14510, 14871, 14971, 15071, 15438, 15741, 16594, 17002, 17102, 17319, 17562, 18009, 18172]","[0, 89, 229, 367, 497, 587, 1041, 1224, 1367, 1482, 1738, 2198, 2727, 3084, 3277, 3781, 4144, 4486, 4856, 4951, 5311, 5704, 6153, 7010, 7469, 8073, 8540, 8750, 9120, 9372, 9820, 10100, 10601, 10995, 11288, 11388, 11623, 12159, 12951, 13328, 13428, 13676, 13776, 13984, 14468]","[0, 89, 312, 402, 604, 783, 967, 1102, 1370, 1575, 2016, 2296, 2682, 3085, 3606, 3905, 4427, 4757, 4935, 5178, 5383, 5726, 6005, 6502, 6732, 7159, 7468, 7616, 7906, 8083, 8459, 8739, 9731, 10255, 10355, 10455, 10690, 11239, 11702, 11912, 12050, 12150, 12354, 12618, 12843]",30930,21532,18172,14468,12843,735,4507,1737,-1979,-1556,3444,45,dire
7630469716,18,13,31,96,26,"[0, 584, 817, 1308, 1509, 1836, 2374, 2770, 3059, 3840, 4527, 5100, 6056, 6764, 7479, 8027, 9242, 9982, 11745, 12557, 12919, 13759, 14678, 15536, 16170, 16719, 17283, 17631, 17737, 18203, 18626, 19219, 19589, 20302, 21438, 22496, 22762, 23913, 24551, 24843, 26236, 26848, 27968, 28530, 28808]","[0, 287, 567, 823, 965, 1370, 1684, 2013, 2435, 3145, 3723, 3948, 4740, 5349, 6495, 6842, 7508, 8193, 9201, 9590, 10182, 10680, 11236, 11577, 12095, 12432, 12607, 13978, 14074, 15228, 15807, 15907, 16223, 16835, 17412, 17675, 18046, 19026, 19603, 20067, 21203, 21968, 22650, 23182, 23693]","[0, 234, 324, 414, 550, 658, 831, 1061, 1391, 1740, 1972, 2584, 2835, 3187, 3541, 3697, 4406, 4501, 5270, 5546, 5910, 6153, 6449, 6935, 7346, 7629, 7870, 8321, 8487, 8922, 9255, 9460, 9595, 10480, 10943, 11761, 11861, 12313, 12749, 13264, 13996, 14120, 14345, 14607, 14822]","[0, 346, 484, 689, 1190, 1350, 1640, 2184, 2508, 2750, 3248, 3510, 3808, 4075, 4506, 4861, 5467, 5982, 6346, 6834, 7122, 7603, 7844, 8122, 8470, 8700, 8875, 9201, 9297, 9758, 10020, 10253, 10484, 11182, 11561, 12143, 12351, 12586, 13281, 13518, 14468, 14568, 14905, 15122, 15337]","[0, 234, 324, 626, 831, 970, 1105, 1240, 1330, 1677, 1856, 2081, 2368, 2808, 3206, 3568, 4313, 4408, 5320, 5541, 5686, 6000, 6238, 6443, 7193, 7423, 7598, 7814, 7910, 8126, 8222, 8494, 8675, 9924, 10234, 10497, 10597, 10939, 11085, 11185, 11384, 11484, 11891, 12113, 12328]",28808,23693,14822,15337,12328,52,44,137,121,20,"[0, 209, 582, 767, 1139, 1433, 1969, 2402, 3014, 3318, 3614, 4100, 4357, 4613, 4949, 5257, 6559, 7108, 7208, 7871, 8898, 9546, 10075, 10438, 10925, 11479, 12520, 13021, 14485, 15007, 15729, 16863, 17870, 19437, 20619, 21747, 22630, 23892, 25226, 26048, 27726, 28964, 30057, 30629, 31876]","[0, 170, 481, 1218, 1508, 1818, 2152, 2433, 2963, 3391, 3837, 4465, 4811, 5729, 6167, 6803, 7948, 8637, 9524, 10405, 11518, 12446, 13229, 14144, 15000, 15926, 16382, 16751, 19030, 19763, 20445, 21128, 21463, 21850, 22130, 22687, 23217, 24261, 25099, 26120, 26517, 26904, 27613, 28990, 31320]","[0, 206, 405, 572, 815, 941, 1215, 1563, 2069, 2192, 2370, 2551, 3083, 3225, 3854, 4113, 5038, 5493, 5587, 6419, 6698, 7226, 7863, 8271, 8924, 9224, 9867, 10520, 11664, 12286, 12580, 13411, 13727, 13987, 14712, 15250, 15849, 16557, 16949, 17566, 18149, 18825, 18925, 19441, 20908]","[0, 270, 360, 560, 650, 740, 830, 1010, 1406, 1496, 1679, 1833, 2063, 2292, 2386, 2795, 2953, 3215, 3309, 3467, 3562, 3657, 3751, 3846, 4031, 4258, 4573, 4869, 5619, 5796, 5892, 6257, 6467, 6836, 7116, 7760, 8137, 8545, 8801, 8901, 9298, 9836, 9936, 10264, 10781]","[0, 170, 260, 518, 608, 709, 799, 993, 1228, 1414, 1525, 1654, 2064, 2159, 2253, 2348, 2781, 2907, 3001, 3325, 3792, 3947, 4226, 4321, 4506, 4601, 4866, 5073, 5899, 6175, 6374, 6787, 6997, 7255, 7535, 7658, 8023, 8632, 8959, 9059, 9530, 9738, 9838, 10236, 10867]",31876,31320,20908,10781,10867,-3068,-7627,-6086,4556,1461,-10764,45,dire
7632105811,126,15,43,21,100,"[0, 289, 523, 745, 1145, 1402, 1769, 2245, 2943, 3344, 3653, 4050, 4537, 5519, 6194, 6920, 7527, 7901, 8745, 9058, 9876, 10499, 11203, 11997, 12698, 13117, 13400, 14063, 14240, 14879, 15047, 16890, 19453, 20097, 20783, 22021, 23165, 24215, 24315, 24994, 25728, 27103, 27827, 28818, 30393]","[0, 208, 473, 816, 1446, 2016, 2572, 3208, 3584, 4227, 4809, 5286, 5857, 6242, 7125, 7823, 8452, 9065, 9611, 10375, 11204, 11845, 12539, 13292, 13780, 14546, 14747, 15371, 16025, 16662, 16811, 17555, 18123, 18859, 19384, 20175, 20558, 21149, 21763, 22538, 23632, 25330, 25430, 25992, 26861]","[0, 416, 751, 1257, 1434, 1921, 2353, 2863, 3373, 3906, 4426, 4806, 5662, 6164, 6815, 7384, 8169, 8479, 8927, 9084, 9649, 9957, 10744, 11180, 11633, 12499, 12693, 13123, 13656, 14288, 14384, 14744, 15818, 16183, 17061, 17721, 18137, 18530, 19123, 19607, 21063, 22085, 22946, 23833, 24629]","[0, 244, 334, 505, 595, 732, 1097, 1425, 1641, 1788, 2143, 2561, 2771, 3437, 3803, 4082, 5033, 5684, 6234, 6736, 7089, 7437, 8130, 8872, 9114, 9393, 9577, 10256, 10529, 10625, 10822, 11397, 12467, 12819, 13009, 13219, 13478, 13688, 14037, 14468, 15547, 17137, 17565, 19459, 20371]","[100, 270, 395, 529, 691, 901, 1071, 1347, 1481, 1652, 1845, 2196, 2502, 2910, 3193, 3426, 3835, 4005, 4493, 5074, 5307, 5477, 5790, 6118, 6288, 6529, 6699, 7224, 7476, 7861, 8032, 8297, 8789, 9116, 9381, 9703, 9878, 10163, 10586, 11023, 11875, 12946, 13449, 14176, 14846]",30393,26861,24629,20371,14846,25,52,96,90,5,"[62, 388, 542, 869, 1130, 1258, 1504, 2179, 2651, 3075, 3661, 4245, 4588, 5131, 5686, 6366, 7117, 8500, 9360, 11129, 12008, 13056, 14094, 14948, 15736, 16208, 16805, 17756, 18784, 19781, 20368, 21117, 21217, 22048, 23451, 24317, 24828, 25945, 26356, 27202, 28267, 30067, 30606, 30706, 30806]","[330, 623, 978, 1272, 1644, 2053, 2505, 2640, 3191, 3519, 4117, 5287, 5743, 6240, 6849, 7217, 7657, 8652, 9004, 10469, 10855, 11715, 12304, 13202, 13919, 14559, 15262, 15673, 16951, 17961, 19107, 20469, 20569, 20824, 21449, 22205, 22475, 23631, 24977, 25985, 26283, 28108, 28748, 29044, 29282]","[62, 232, 622, 855, 1450, 1586, 1710, 1845, 2157, 2445, 2625, 2760, 3328, 3681, 3922, 4246, 4424, 4685, 4779, 5236, 5798, 6532, 7007, 7268, 7961, 8602, 8874, 9149, 9666, 10098, 10585, 11098, 12049, 12413, 13195, 14224, 14839, 15546, 16564, 17212, 17601, 18273, 18788, 18888, 18988]","[162, 332, 447, 584, 847, 937, 1108, 1243, 1333, 1423, 1656, 1887, 2138, 2527, 2806, 3092, 3390, 3933, 4229, 4831, 4970, 5576, 6218, 6533, 6981, 7337, 7636, 7911, 8777, 9402, 10104, 10882, 10982, 11996, 12321, 12955, 13055, 13765, 14080, 14656, 15070, 15357, 15582, 15682, 15782]","[62, 232, 347, 482, 572, 662, 786, 1145, 1235, 1325, 1544, 1756, 2007, 2323, 2554, 2649, 2955, 3329, 3423, 4025, 4257, 4735, 4968, 5153, 5655, 6017, 6222, 6317, 6413, 6775, 7337, 7647, 7747, 8309, 8728, 9111, 9454, 9898, 10461, 10931, 11229, 11996, 12221, 12321, 12482]",30806,29282,18988,15782,12482,-413,-2421,5641,4589,2364,9760,45,dire
7632230602,73,98,60,79,119,"[0, 250, 662, 987, 1210, 1494, 2024, 2609, 3138, 3433, 4146, 4895, 5399, 6136, 6736, 7303, 8355, 9768, 11028, 12222, 13691, 14950, 16321, 17354, 18507, 19515, 20790, 22524, 23443, 24521, 25161, 25857, 27195, 28142, 28516, 29359, 30887, 31722, 32977, 33861, 34949, 36698, 38272, 39411, 41314]","[0, 281, 567, 726, 1090, 1314, 1492, 2108, 2512, 2926, 3559, 4531, 5122, 5430, 5524, 6327, 6632, 7133, 7383, 7851, 8937, 9762, 9936, 10658, 11658, 12248, 12612, 14303, 14931, 15470, 15905, 16284, 16981, 17195, 17440, 17540, 17686, 18273, 18843, 19411, 20009, 20590, 21911, 22829, 24844]","[0, 281, 530, 735, 1145, 1344, 2063, 2187, 2505, 2863, 3743, 4156, 4246, 4564, 4960, 5175, 5550, 5714, 5964, 6369, 7039, 7519, 8329, 8561, 8701, 9075, 9680, 10377, 10884, 10980, 11588, 12082, 12376, 12936, 13450, 13756, 13939, 14311, 15218, 15666, 15865, 15965, 16655, 16865, 17002]","[0, 170, 260, 399, 489, 614, 740, 1004, 1109, 1727, 2362, 2452, 2664, 3033, 3248, 3695, 3952, 4500, 4750, 4952, 5469, 5866, 6728, 7012, 7428, 7917, 8057, 8754, 8976, 9072, 9645, 9852, 10062, 10322, 10567, 10935, 11396, 11687, 12195, 12406, 12605, 13215, 14231, 14441, 15804]","[0, 170, 260, 350, 485, 616, 844, 968, 1338, 1542, 2216, 2306, 2631, 3233, 3448, 3543, 3764, 3928, 4178, 4372, 5270, 5599, 6084, 6360, 6851, 7092, 7310, 8082, 8621, 8792, 9212, 10289, 10559, 10826, 11143, 11579, 11724, 12262, 12599, 12803, 13115, 13448, 13548, 13758, 14931]",41314,24844,17002,15804,14931,114,49,21,75,136,"[0, 209, 490, 871, 1231, 1559, 1935, 2445, 2893, 3521, 3901, 4262, 5001, 5485, 6175, 6900, 7746, 8116, 8820, 9428, 10044, 10513, 11367, 11781, 12700, 13466, 14142, 14275, 14697, 15702, 16561, 17398, 18336, 18979, 20659, 21609, 22026, 22903, 23523, 24107, 25037, 25573, 25673, 26341, 27289]","[0, 291, 527, 742, 1065, 1411, 1842, 2356, 3038, 3411, 3956, 4160, 4835, 5412, 6031, 6698, 7489, 8457, 9060, 9517, 9762, 10267, 10555, 10894, 11719, 12165, 13040, 13135, 13543, 14310, 15145, 15783, 15883, 16067, 16964, 17255, 17897, 19177, 19675, 19775, 20221, 21428, 22241, 23019, 25186]","[0, 170, 309, 399, 978, 1068, 1421, 1601, 1802, 2217, 2352, 2746, 3049, 3873, 4303, 4836, 5542, 5846, 6208, 6641, 7147, 7493, 8186, 8749, 9469, 10316, 10709, 11234, 11611, 11986, 12741, 13145, 14160, 14260, 15062, 15987, 16646, 17355, 18003, 18973, 19495, 20722, 21198, 21923, 24194]","[0, 205, 370, 774, 1310, 1753, 1879, 2752, 3025, 3260, 3473, 3804, 4274, 4644, 5025, 5945, 6773, 7039, 7933, 8451, 8712, 9319, 10129, 10778, 11470, 11891, 12615, 12710, 12936, 13360, 14117, 14786, 15560, 15660, 17278, 17788, 18506, 19243, 19871, 20670, 21589, 22559, 23124, 23332, 23764]","[0, 170, 260, 385, 589, 723, 813, 1209, 1299, 1389, 1524, 1614, 1905, 2161, 2334, 2685, 3433, 3870, 4421, 4579, 4674, 4768, 5201, 5402, 5928, 6534, 6934, 7029, 7254, 7741, 8072, 8352, 8452, 8821, 9686, 9857, 10627, 11488, 11588, 12171, 12636, 13419, 13743, 14214, 15573]",27289,25186,24194,23764,15573,14025,-342,-7192,-7960,-642,-2111,45,radiant
7632248708,120,54,123,129,9,"[0, 254, 620, 862, 1226, 1560, 1846, 2136, 2360, 2987, 3605, 3927, 4158, 4686, 5230, 5578, 6134, 6591, 6896, 7700, 8498, 9225, 9928, 10649, 10999, 11309, 12240, 12628, 12724, 13289, 13572, 14150, 14250, 15132, 15850, 16188, 17686, 18081, 18621, 18836, 19275, 20213, 20313, 20692, 21627]","[0, 205, 353, 630, 882, 972, 1097, 1337, 1598, 1923, 2530, 2935, 3492, 3815, 4541, 5084, 5772, 6325, 6420, 7106, 7646, 8471, 9150, 9663, 10144, 10834, 11245, 12019, 12691, 12864, 13305, 13613, 13713, 14931, 15308, 16012, 17424, 17889, 18913, 19182, 19456, 19682, 20263, 20841, 21475]","[0, 170, 260, 728, 934, 1143, 1336, 1471, 1561, 1721, 1905, 2032, 2215, 2443, 2612, 2801, 3052, 3147, 3242, 3560, 4056, 4668, 5314, 5819, 6222, 7174, 7456, 7729, 7927, 8023, 8475, 9003, 9103, 9521, 10413, 11028, 13045, 14015, 14672, 14772, 15164, 16446, 16849, 16949, 17917]","[0, 290, 698, 1090, 1347, 1609, 2076, 2751, 3213, 3713, 4508, 5069, 5531, 6088, 6527, 6675, 7522, 7867, 7986, 8509, 9127, 9710, 10256, 10643, 10738, 11051, 11516, 12278, 12374, 12470, 12862, 13360, 13460, 14071, 14374, 14880, 14980, 15678, 16500, 16600, 16749, 17970, 18949, 19049, 19683]","[0, 272, 435, 577, 730, 893, 1304, 1629, 1719, 2076, 2509, 2912, 3121, 3317, 3664, 4082, 4478, 4661, 5063, 5445, 5749, 6225, 6698, 6954, 7211, 7878, 8048, 8344, 8726, 8897, 9287, 9715, 9852, 10246, 10524, 11065, 11212, 11312, 11554, 11724, 12213, 12924, 13056, 13156, 13790]",21627,21475,17917,19683,13790,94,137,28,119,5,"[0, 218, 416, 659, 1130, 1371, 1792, 2046, 2540, 3056, 3518, 3961, 4614, 5225, 5926, 6554, 7596, 8308, 9596, 10372, 11080, 11378, 12005, 13041, 13540, 14737, 15729, 16074, 16963, 18097, 18745, 19963, 22139, 22997, 23731, 24812, 25600, 26932, 28248, 29021, 31211, 31738, 33288, 35049, 36856]","[0, 281, 564, 859, 1194, 1630, 2139, 2348, 2783, 3080, 3170, 3582, 4063, 4338, 5293, 5602, 6456, 6890, 7864, 8221, 9148, 9614, 10283, 11412, 12676, 13222, 13317, 13924, 14653, 15866, 16267, 16703, 18967, 19650, 20393, 21182, 21809, 21909, 22507, 22810, 23846, 24782, 25789, 26501, 28082]","[0, 170, 410, 680, 970, 1593, 1810, 2234, 2730, 3388, 3905, 4473, 4692, 5169, 5636, 5969, 6704, 7136, 8151, 8502, 9044, 9582, 9884, 10424, 11064, 11630, 11750, 11878, 12630, 13408, 13672, 14051, 15014, 15674, 16342, 16741, 16841, 17434, 17911, 18490, 19425, 19995, 20513, 21082, 21616]","[0, 170, 310, 443, 533, 934, 1118, 1253, 1392, 1531, 1621, 1909, 2256, 2405, 2872, 3282, 3685, 3866, 4653, 4890, 5073, 5243, 5732, 5916, 6591, 6873, 7370, 8000, 8621, 8925, 9094, 9543, 11193, 11513, 12359, 12909, 13193, 13293, 13711, 14003, 14994, 15637, 16775, 17187, 17721]","[0, 204, 294, 384, 490, 600, 820, 1081, 1286, 1376, 1481, 1692, 2161, 2455, 2878, 3037, 3381, 3744, 4375, 5038, 5178, 5358, 5870, 6229, 6719, 7542, 7703, 7797, 8350, 8705, 8846, 9126, 10342, 10577, 10815, 11801, 11946, 12138, 12615, 12800, 14042, 14599, 14915, 15341, 16384]",36856,28082,21616,17721,16384,-15229,-6607,-3699,1962,-2594,-26167,45,dire
7632649002,41,19,137,121,110,"[0, 242, 541, 753, 1131, 1401, 1741, 2066, 2469, 2822, 3439, 3718, 3808, 4098, 4560, 4938, 5478, 5960, 6461, 6942, 7485, 7865, 8786, 9681, 11172, 12197, 12921, 14127, 14824, 15978, 16590, 17452, 18460, 19271, 20616, 21983, 22614, 23937, 25309, 25810, 26257, 26357, 27054, 27553, 28390]","[0, 329, 665, 1003, 1429, 1808, 2272, 2581, 3004, 3561, 4063, 4694, 4836, 5138, 5754, 6009, 6653, 7256, 7887, 8296, 8738, 9872, 10389, 11273, 11768, 12658, 13065, 14039, 14826, 16243, 16564, 17817, 19047, 19632, 21745, 22869, 23539, 24065, 24927, 25328, 25848, 26737, 27363, 27896, 27996]","[0, 250, 607, 977, 1266, 1469, 1760, 2409, 3041, 3390, 3969, 4511, 4601, 4895, 5929, 6155, 7069, 7857, 8618, 8898, 9914, 10294, 11090, 11657, 12615, 13255, 13677, 14439, 14919, 15719, 16223, 16689, 17515, 18358, 19438, 20024, 20357, 20867, 21698, 21798, 22212, 22756, 23342, 23442, 23674]","[0, 170, 260, 368, 498, 637, 771, 1139, 1322, 1506, 1839, 2172, 2262, 2474, 3213, 3376, 3783, 4045, 4154, 4362, 4908, 5003, 5185, 5661, 6247, 6700, 6795, 7125, 7348, 8370, 9461, 9865, 10552, 11115, 12430, 12992, 13128, 13408, 13980, 14880, 14980, 15080, 15578, 15678, 16051]","[0, 170, 694, 829, 959, 1049, 1215, 1311, 1447, 1659, 2142, 2442, 2532, 2855, 3275, 3370, 3729, 4289, 4652, 5205, 6000, 6445, 6725, 7292, 8156, 8581, 8862, 9282, 9558, 10564, 10795, 11221, 11684, 12192, 13541, 13950, 14087, 14431, 15003, 15264, 15477, 15577, 16075, 16411, 16511]",28390,27996,23674,16051,16511,70,129,13,9,79,"[0, 240, 515, 924, 1233, 1623, 2173, 2605, 2825, 3060, 3408, 3949, 4825, 5216, 5906, 6172, 7237, 8124, 8948, 9328, 10155, 10982, 11905, 12848, 13805, 14378, 15500, 16074, 17052, 18175, 18271, 19103, 20042, 20429, 20789, 21164, 21843, 22042, 22701, 23190, 24623, 26508, 27433, 28600, 30497]","[0, 207, 592, 943, 1275, 1787, 2078, 2336, 2795, 3297, 3721, 4268, 4923, 5155, 5655, 5750, 6073, 7066, 7316, 7840, 8503, 8976, 9907, 10437, 10986, 11414, 11622, 11869, 12775, 13684, 13879, 14945, 15718, 16023, 16669, 17494, 18092, 18670, 19908, 20399, 21312, 22484, 23088, 23653, 24677]","[0, 170, 437, 809, 1102, 1442, 1683, 2181, 2664, 3250, 3717, 4022, 4534, 4952, 5325, 5998, 6649, 7307, 7744, 8342, 8948, 9789, 10653, 11001, 11346, 11722, 12260, 12796, 13214, 14112, 14249, 15448, 15980, 16080, 16440, 16540, 17245, 18099, 18948, 19409, 20676, 22028, 22606, 23492, 24718]","[0, 170, 260, 615, 745, 996, 1166, 1301, 1436, 1806, 2046, 2136, 3096, 3327, 3755, 3850, 4038, 4556, 4813, 5057, 5866, 5961, 6455, 6951, 7308, 7729, 8185, 8467, 8943, 9542, 9759, 10050, 10469, 10891, 11251, 11400, 11883, 12315, 13160, 13391, 14176, 14855, 15135, 15588, 16135]","[0, 170, 260, 352, 538, 773, 1010, 1425, 1565, 1763, 1961, 2234, 2999, 3094, 3296, 3439, 3741, 4002, 4096, 4294, 5103, 5198, 5482, 5885, 6422, 6627, 6951, 7046, 7223, 7624, 8052, 8337, 8711, 8916, 9561, 9766, 10381, 10703, 11523, 11761, 12462, 13249, 13760, 14113, 14738]",30497,24677,24718,16135,14738,-2107,3319,-1044,-84,1773,1857,45,radiant
7632828213,21,78,23,5,86,"[0, 260, 588, 920, 1243, 1613, 2039, 2516, 2952, 3637, 4218, 4844, 5336, 5974, 6808, 7321, 8179, 8971, 10300, 10778, 11278, 12443, 13347, 14128, 15351, 16225, 16677, 17899, 19155, 20161, 20793, 21073, 22200, 22717, 23941, 25956, 27026, 27126, 27913, 28861, 28961, 29139, 29958, 31142, 32303]","[0, 174, 493, 762, 1110, 1418, 1757, 2152, 2671, 2989, 3430, 3901, 4316, 4683, 5045, 5179, 5738, 6292, 7236, 7746, 8384, 9309, 10409, 10796, 12001, 12710, 13569, 14255, 15877, 16535, 17398, 18403, 19211, 20423, 21195, 21717, 22443, 23074, 23501, 24286, 24985, 25567, 27310, 28260, 28633]","[0, 292, 623, 993, 1328, 1785, 2176, 2997, 3881, 4799, 5502, 6210, 6756, 7497, 7901, 8257, 9344, 9959, 10562, 10922, 11202, 12300, 12795, 13071, 14211, 14930, 15829, 16922, 17470, 18290, 18820, 19776, 20621, 21516, 22190, 23048, 23648, 23922, 24686, 24979, 25270, 25370, 26116, 27065, 28121]","[0, 170, 476, 611, 830, 1024, 1114, 1339, 1499, 1683, 1920, 2214, 2539, 3105, 3586, 3681, 4176, 4449, 4844, 4939, 5133, 6441, 6918, 7271, 7946, 8241, 8521, 9111, 9805, 10373, 10690, 11366, 12052, 12402, 12906, 13764, 14112, 14326, 14783, 15083, 15478, 15834, 16117, 16598, 17335]","[0, 218, 308, 398, 539, 692, 782, 1127, 1287, 1455, 1771, 2000, 2582, 2834, 3054, 3236, 3698, 3864, 5047, 5270, 5452, 6586, 7049, 7327, 7877, 8043, 8248, 8642, 8919, 9365, 9657, 10083, 10438, 10788, 11254, 12217, 12654, 12856, 13560, 13785, 13929, 14029, 14237, 15045, 15645]",32303,28633,28121,17335,15645,89,52,97,119,51,"[0, 224, 587, 948, 1241, 1520, 1833, 2352, 2767, 3150, 3658, 4295, 4844, 5446, 6172, 7060, 8052, 9068, 9896, 10693, 11376, 11470, 11826, 12905, 14038, 15197, 16282, 17213, 18026, 18122, 19303, 20741, 21579, 23236, 24480, 24580, 25034, 26019, 27761, 28243, 29911, 30711, 31597, 32346, 33123]","[0, 262, 595, 1032, 1297, 1640, 2016, 2491, 3043, 3506, 3952, 4217, 4868, 5489, 6086, 6908, 7984, 8292, 8869, 9348, 9750, 9844, 10739, 11522, 11707, 12441, 13050, 13734, 14080, 14472, 16557, 17248, 17969, 18753, 20654, 21484, 22502, 23211, 23736, 24911, 25916, 26623, 27109, 28532, 29848]","[0, 287, 534, 934, 1259, 1472, 1788, 2148, 2514, 2962, 3350, 3693, 4458, 4811, 5313, 5956, 6328, 6935, 7980, 8389, 9152, 9246, 9580, 10545, 11083, 11600, 12040, 12484, 12743, 13106, 13821, 14269, 14865, 15641, 16377, 16477, 16973, 17490, 18014, 18452, 19529, 20374, 20867, 21684, 22348]","[0, 420, 510, 814, 991, 1081, 1171, 1261, 1540, 1824, 2197, 2287, 2574, 2815, 3098, 3470, 4096, 4368, 4863, 5070, 5228, 5322, 5667, 5942, 6275, 6795, 7217, 7456, 7552, 7648, 8640, 8962, 9268, 9368, 10160, 10563, 11109, 11651, 11751, 12309, 13634, 14288, 14546, 14948, 15839]","[0, 492, 582, 737, 867, 1070, 1160, 1566, 1912, 2002, 2265, 2390, 2844, 3140, 3453, 3895, 4204, 4626, 4992, 5458, 5616, 5710, 6159, 6301, 6486, 6887, 7076, 7315, 7579, 7815, 8243, 8564, 8754, 8854, 9556, 9656, 9756, 10054, 10261, 10736, 11381, 11589, 11927, 12293, 12820]",33123,29848,22348,15839,12820,-820,-1215,5773,1496,2825,8059,45,radiant
7633546718,10,43,2,27,85,"[0, 292, 644, 963, 1275, 1776, 2068, 2440, 2920, 3351, 3573, 4041, 4613, 5257, 5684, 6036, 6996, 7482, 8389, 9069, 10001, 10900, 11560, 12451, 13313, 13921, 14675, 15351, 15641, 15837, 16128, 16923, 17546, 18233, 18706, 19576, 19922, 20830, 21439, 22429, 23186, 24496, 24770, 25380, 26296]","[0, 255, 611, 900, 1157, 1572, 2023, 2720, 2935, 3347, 3859, 4121, 4528, 5104, 5487, 5619, 6486, 6863, 7483, 8216, 8482, 8669, 9240, 9857, 10400, 10761, 11418, 11846, 12252, 12692, 12959, 13415, 13892, 14326, 14619, 14809, 15470, 16111, 16729, 17128, 18045, 18635, 19543, 20506, 21513]","[0, 247, 493, 1148, 1433, 1934, 2316, 2760, 3232, 4010, 4856, 5266, 5562, 6259, 6551, 6863, 7919, 8376, 8907, 9738, 9972, 10207, 10665, 10965, 11802, 12270, 13245, 13409, 13553, 13999, 14283, 14563, 14779, 15281, 15690, 16061, 16161, 16360, 16659, 17139, 17455, 18037, 18609, 19251, 19674]","[0, 170, 280, 521, 739, 1079, 1214, 1881, 2016, 2149, 2393, 2483, 2711, 3110, 3350, 3444, 4219, 4646, 4890, 5183, 5443, 5667, 6019, 6370, 6611, 7151, 7656, 7908, 8127, 8650, 8902, 9956, 10221, 10750, 11134, 11636, 11926, 12200, 12650, 13488, 14021, 14924, 15376, 16009, 16606]","[0, 170, 260, 350, 650, 899, 1034, 1322, 1457, 1600, 1961, 2051, 2224, 2496, 2708, 3006, 3164, 3325, 3691, 4009, 4251, 4410, 4873, 5587, 5729, 6119, 6779, 7240, 7458, 8035, 8261, 8749, 9014, 9189, 9598, 9946, 10430, 10978, 11564, 11987, 12623, 13139, 13636, 14185, 14889]",26296,21513,19674,16606,14889,72,137,69,19,121,"[0, 245, 539, 1174, 1535, 2378, 2755, 3243, 3824, 4353, 4751, 5465, 6171, 6786, 7396, 8131, 8815, 9301, 9814, 10409, 10979, 11787, 12590, 13291, 13837, 14669, 15147, 15559, 15717, 16936, 17032, 17514, 18455, 19007, 20096, 21017, 21688, 22341, 22546, 23529, 23877, 24371, 24701, 25003, 26190]","[0, 294, 528, 773, 1085, 1383, 1720, 2138, 2589, 2952, 3492, 4346, 4542, 5122, 6019, 6686, 7267, 7816, 8118, 8751, 9346, 9700, 10214, 11105, 11288, 11579, 12278, 12620, 12844, 13836, 14309, 14602, 15796, 16511, 17482, 18165, 18523, 19041, 19225, 20226, 20808, 21395, 21649, 22880, 24279]","[0, 170, 399, 637, 916, 1294, 1866, 2335, 2907, 3344, 4012, 4621, 5344, 6127, 6746, 7141, 7579, 8410, 9178, 9578, 9896, 10049, 10571, 10929, 11060, 11431, 11991, 12085, 12341, 14245, 14990, 15704, 16272, 16601, 16979, 18201, 18608, 19143, 19647, 20812, 21129, 21424, 21684, 22098, 22601]","[0, 208, 346, 436, 526, 697, 863, 1079, 1214, 1849, 2361, 2545, 2635, 2784, 3102, 3576, 4057, 4152, 4247, 4475, 4790, 4956, 5373, 5618, 5713, 6062, 6335, 6429, 6593, 6689, 7456, 7815, 8529, 8659, 9172, 9669, 9919, 10228, 10328, 10769, 11112, 11212, 11416, 11799, 12563]","[0, 215, 305, 530, 729, 1043, 1393, 1618, 1802, 2019, 2350, 2534, 2672, 2857, 3163, 3565, 3751, 3846, 4032, 4224, 4468, 4745, 4912, 5006, 5101, 5286, 5462, 5556, 5652, 6492, 6941, 7234, 7883, 8194, 8763, 8973, 9260, 9569, 9793, 10003, 10103, 10203, 10303, 10403, 11210]",26190,24279,22601,12563,11210,106,-2766,-2927,4043,3679,2135,45,dire
7633814106,18,137,98,5,27,"[61, 338, 802, 1218, 1763, 2129, 2297, 2693, 3138, 3782, 4344, 4981, 5675, 6468, 7221, 7871, 9677, 10776, 11215, 12049, 13197, 14040, 15202, 15901, 16389, 17461, 18053, 19009, 19765, 22188, 22807, 23519, 25662, 26824, 27861, 28795, 29443, 29712, 30142, 30856, 31253, 32072, 33266, 34774, 36403]","[61, 342, 727, 1127, 1374, 1816, 2144, 2491, 2702, 3260, 3810, 4213, 5032, 5628, 6252, 6685, 7612, 8555, 9229, 10264, 10805, 11092, 12252, 13183, 13430, 14598, 15013, 15818, 16357, 17516, 18376, 18909, 20482, 21223, 21806, 22593, 23357, 23893, 24885, 25787, 27012, 27373, 28010, 29417, 30106]","[61, 343, 616, 846, 1212, 1536, 1790, 2148, 2540, 2973, 3880, 4494, 5137, 5634, 6159, 6710, 7387, 7943, 8644, 9485, 10117, 10722, 12082, 12891, 13093, 13457, 14080, 14174, 15244, 16091, 16657, 17311, 18372, 19361, 19956, 20185, 20776, 21129, 21653, 22218, 23062, 24060, 25339, 27086, 28298]","[329, 538, 752, 926, 1117, 1252, 1342, 1480, 1570, 2059, 2620, 2754, 2944, 3270, 3541, 3682, 3941, 4356, 4479, 4804, 5062, 5232, 6113, 6797, 7126, 7447, 7617, 7833, 8085, 8732, 8903, 9168, 10057, 10760, 11135, 11439, 11669, 11939, 12252, 12606, 13329, 13925, 14592, 15437, 15845]","[61, 270, 360, 495, 660, 750, 840, 964, 1054, 1262, 1650, 1740, 2061, 2347, 2615, 2710, 3391, 3764, 4004, 4513, 4697, 4830, 5526, 5692, 5787, 6347, 6468, 6562, 7052, 7603, 7699, 8269, 9248, 10217, 10653, 11099, 11338, 11534, 11733, 11968, 12478, 12890, 13391, 14628, 15147]",36403,30106,28298,15845,15147,94,82,23,72,65,"[0, 129, 429, 806, 1163, 1609, 2168, 2540, 3140, 3556, 4170, 4926, 5604, 6515, 7219, 7937, 8692, 9440, 10180, 11310, 12187, 13447, 14258, 15435, 16656, 18144, 18836, 20052, 20716, 21196, 21292, 22120, 22963, 23063, 24690, 25751, 26218, 26879, 27837, 28951, 29707, 30790, 31528, 32149, 34239]","[0, 324, 569, 984, 1476, 1856, 2473, 3234, 3706, 4278, 4793, 4992, 5970, 7483, 8423, 9063, 9220, 10140, 11109, 11876, 12687, 13496, 14329, 14522, 15528, 16364, 16459, 17101, 17987, 18653, 19576, 20429, 20726, 20826, 21811, 22981, 23458, 23942, 25309, 26003, 26664, 27880, 28895, 29921, 32607]","[0, 163, 348, 828, 1033, 1337, 1810, 1945, 2850, 3106, 3657, 4089, 4729, 5417, 6033, 6765, 7603, 8062, 8752, 9380, 10090, 10369, 10795, 11128, 11531, 12251, 12923, 13497, 13929, 14153, 14669, 15117, 15217, 16220, 16626, 16726, 17430, 17783, 18909, 19766, 20124, 20224, 20690, 21207, 21307]","[0, 129, 219, 358, 502, 637, 1180, 1315, 1569, 1659, 1794, 2103, 2462, 3054, 3196, 3536, 3717, 4054, 4268, 4787, 5128, 5317, 5599, 5693, 6298, 6725, 7456, 7783, 8254, 8395, 8491, 8888, 9315, 9415, 9651, 9751, 9851, 9951, 10758, 11073, 11173, 11386, 11780, 12319, 12419]","[0, 129, 219, 309, 439, 619, 1058, 1286, 1495, 1842, 2295, 2639, 2950, 3384, 3610, 4158, 4504, 4739, 5215, 5887, 6071, 6382, 6664, 6869, 7464, 7994, 8299, 8714, 8945, 9041, 9426, 9668, 9768, 9868, 10058, 10340, 10440, 10540, 11115, 11330, 11613, 11713, 11813, 12347, 12447]",34239,32607,21307,12419,12447,2164,-2501,6991,3426,2700,12780,45,radiant
